well id,# of raw HiC read pairs,# of uniquely mapped HiC read pairs,# of uniquely mapped nonwalk HiC read pairs,# of uniquely mapped walk HiC read pairs,# of dedup HiC read pairs,# of HiC contacts hg38,# of HiC contacts mm10,# of HiC contacts,# of HiC cis-contacts,# of HiC trans-contacts,# of HiC cis:trans,# of HiC walk contacts,# of raw RNA reads,# of uniquely mapped RNA reads,# of unique RNA molecules,# of unique RNA molecules hg38,# of unique RNA molecules mm10,# of genes hg38,# of genes mm10,% of mitochondrial mRNA molecules hg38,% of mitochondrial mRNA molecules mm10,species,library
"A1,A1",13107,13420,9944,3476,7303,0,3389,3400,2447,953,2.567681007,1608,1012,573,280,0,280,0,94,0,0.032142857,empty,mBC-0716-1
"A1,A2",16483,16458,12666,3792,8904,0,3902,3911,2737,1174,2.331345826,1831,1274,769,405,1,404,1,124,0,0.108910891,empty,mBC-0716-1
"A1,A3",14141,14923,10718,4205,8037,0,3875,3877,2774,1103,2.514959202,1925,7347,2351,1173,2,1171,1,232,0,0.023057216,empty,mBC-0716-1
"A1,A4",963864,1071789,665498,406291,564095,2,335615,336016,261223,74793,3.492612945,187751,30051,19409,9344,1,9343,1,1194,0,0.002354704,mm10,mBC-0716-1
"A1,A5",14617,15406,11170,4236,8225,3,3813,3823,2652,1171,2.264730999,1868,1302,837,415,0,415,0,127,0,0.01686747,empty,mBC-0716-1
"A1,A6",476859,509195,352601,156594,276597,0,139084,139315,118769,20546,5.780638567,72122,93961,61373,29260,5,29255,1,2541,0,0.002905486,mm10,mBC-0716-1
"A1,A7",14139,14454,10858,3596,7801,0,3580,3587,2531,1056,2.396780303,1662,901,576,295,1,294,1,98,0,0.142857143,empty,mBC-0716-1
"A1,A8",895369,1041417,603884,437533,566433,1,360047,360478,273671,86807,3.15263746,211845,144208,104270,49442,23,49419,1,3343,0,0.00078917,mm10,mBC-0716-1
"A1,A9",747805,783202,562406,220796,416478,0,203159,203514,169152,34362,4.92264711,101685,70010,48551,23257,7,23250,3,2030,0,0.002365591,mm10,mBC-0716-1
"A1,A10",13587,13907,10293,3614,7495,0,3370,3376,2324,1052,2.209125475,1588,1333,582,308,0,308,0,86,0,0.022727273,empty,mBC-0716-1
"A1,A11",458180,490214,340304,149910,267010,0,131940,132174,113233,18941,5.978195449,68246,104399,70323,33541,11,33530,2,2655,0,0.003429764,mm10,mBC-0716-1
"A1,A12",18042,18383,13785,4598,9694,0,4316,4323,3006,1317,2.282460137,1993,2375,1512,698,0,698,0,174,0,0.055873926,empty,mBC-0716-1
"A1,B1",16839,16898,12674,4224,9032,0,3995,4001,2814,1187,2.370682393,1896,8557,2684,1381,0,1381,0,266,0,0.07096307,empty,mBC-0716-1
"A1,B2",16929,16973,12990,3983,9217,1,4052,4069,2802,1267,2.211523283,1850,443,250,129,0,129,0,47,0,0.093023256,empty,mBC-0716-1
"A1,B3",16053,16355,12286,4069,8959,0,4099,4110,2920,1190,2.453781513,1894,1083,658,338,0,338,0,104,0,0.094674556,empty,mBC-0716-1
"A1,B4",14475,14941,11016,3925,8060,0,3660,3670,2595,1075,2.413953488,1780,1060,642,342,1,341,1,121,0,0.049853372,empty,mBC-0716-1
"A1,B5",7963,4931,3420,1511,3390,0,1653,1676,1167,509,2.292730845,913,5386,1573,798,2,796,1,170,0,0.069095477,empty,mBC-0716-1
"A1,B6",10402,10708,7968,2740,5768,0,2631,2636,1815,821,2.210718636,1239,889,483,251,0,251,0,87,0,0.035856574,empty,mBC-0716-1
"A1,B7",1298409,1389423,963089,426334,732763,2,374501,375046,319472,55574,5.748587469,193779,120290,85960,40418,11,40407,1,3040,0,0.001064172,mm10,mBC-0716-1
"A1,B8",11771,12265,9074,3191,6598,0,3038,3059,2137,922,2.317787419,1434,2123,1168,650,0,650,0,152,0,0.049230769,empty,mBC-0716-1
"A1,B9",1514138,1660946,1091504,569442,863510,0,487193,487891,398372,89519,4.450139077,262522,57172,39539,18819,7,18812,1,1950,0,0.00042526,mm10,mBC-0716-1
"A1,B10",14458,14324,10698,3626,8097,0,3731,3736,2571,1165,2.206866953,1780,515,334,180,0,180,0,64,0,0.044444444,empty,mBC-0716-1
"A1,B11",512000,530452,375365,155087,287566,1,144671,144877,112483,32394,3.472340557,73899,4611,2336,1155,2,1153,2,245,0,0.063313096,mm10,mBC-0716-1
"A1,B12",15895,16632,12107,4525,8935,0,4133,4142,2954,1188,2.486531987,2054,1517,741,345,0,345,0,116,0,0.12173913,empty,mBC-0716-1
"A1,C1",19243,19380,14886,4494,10444,0,4335,4347,2982,1365,2.184615385,2001,401,297,144,0,144,0,72,0,0.013888889,empty,mBC-0716-1
"A1,C2",16897,17233,12699,4534,9328,0,4336,4343,3060,1283,2.385035074,2083,3605,1489,768,0,768,0,203,0,0.049479167,empty,mBC-0716-1
"A1,C3",17532,18108,13317,4791,9649,0,4428,4437,3077,1360,2.2625,2195,548,260,149,0,149,0,63,0,0.020134228,empty,mBC-0716-1
"A1,C4",15131,15444,11478,3966,8506,0,3876,3884,2769,1115,2.483408072,1869,1297,829,400,0,400,0,124,0,0.035,empty,mBC-0716-1
"A1,C5",14034,14243,10728,3515,7710,0,3438,3438,2416,1022,2.363992172,1633,1036,628,308,0,308,0,95,0,0,empty,mBC-0716-1
"A1,C6",747811,835125,506199,328926,462128,2,283236,283567,217754,65813,3.308677617,161609,50701,35004,16538,5,16533,1,1770,0,0.001088732,mm10,mBC-0716-1
"A1,C7",14981,15592,11249,4343,8454,0,3980,3987,2830,1157,2.445980985,1974,377,217,127,0,127,0,49,0,0.031496063,empty,mBC-0716-1
"A1,C8",12846,13175,9850,3325,7251,0,3372,3376,2354,1022,2.30332681,1660,1394,931,481,0,481,0,127,0,0.03950104,empty,mBC-0716-1
"A1,C9",10811,11235,8173,3062,6027,1,2810,2817,1979,838,2.361575179,1366,597,338,182,0,182,0,71,0,0.021978022,empty,mBC-0716-1
"A1,C10",11692,11816,8738,3078,6530,0,2964,2978,2070,908,2.279735683,1407,2404,983,483,1,482,1,127,0,0.116182573,empty,mBC-0716-1
"A1,C11",10342,10933,7706,3227,5948,0,2821,2824,1960,864,2.268518519,1417,716,455,225,0,225,0,69,0,0,empty,mBC-0716-1
"A1,C12",454934,463994,351511,112483,252930,0,110539,110718,78479,32239,2.434287664,52956,20415,10757,5123,1,5122,1,853,0,0.008004686,mm10,mBC-0716-1
"A1,D1",9796,10167,7397,2770,5640,0,2684,2688,1902,786,2.419847328,1263,518,352,173,1,172,1,51,0,0,empty,mBC-0716-1
"A1,D2",17370,17607,13563,4044,9536,0,4083,4090,2819,1271,2.217938631,1826,1958,1199,625,2,623,1,181,0,0.041733547,empty,mBC-0716-1
"A1,D3",11973,12456,9068,3388,6803,0,3180,3181,2217,964,2.299792531,1554,910,520,271,0,271,0,96,0,0.140221402,empty,mBC-0716-1
"A1,D4",12501,13037,9485,3552,7058,0,3244,3246,2294,952,2.409663866,1634,1174,838,388,0,388,0,107,0,0.079896907,empty,mBC-0716-1
"A1,D5",809356,915839,544039,371800,490567,0,308726,309079,224279,84800,2.644799528,178234,51824,34424,16333,7,16326,1,1805,0,0.00061252,mm10,mBC-0716-1
"A1,D6",10941,11304,8158,3146,6158,0,2895,2900,2023,877,2.30672748,1429,1199,815,425,0,425,0,118,0,0.075294118,empty,mBC-0716-1
"A1,D7",11466,11910,8678,3232,6505,0,3109,3115,2142,973,2.201438849,1547,1192,836,434,0,434,0,143,0,0.034562212,empty,mBC-0716-1
"A1,D8",13499,14210,10247,3963,7718,0,3644,3656,2566,1090,2.35412844,1813,881,530,297,0,297,0,102,0,0.033670034,empty,mBC-0716-1
"A1,D9",202980,220124,140775,79349,122850,0,69070,69160,58876,10284,5.725009724,38545,119138,77585,37175,10,37165,3,2803,0,0.003713171,mm10,mBC-0716-1
"A1,D10",624030,663315,462482,200833,355584,1,178176,178452,153881,24571,6.26270807,91565,41770,29368,14092,3,14089,2,1620,0,0.001916389,mm10,mBC-0716-1
"A1,D11",11636,12029,8922,3107,6420,0,2903,2921,2063,858,2.404428904,1377,1218,792,378,0,378,0,125,0,0.037037037,empty,mBC-0716-1
"A1,D12",17739,18321,13506,4815,9666,0,4360,4376,3030,1346,2.251114413,2054,2594,1629,837,0,837,0,214,0,0.052568698,empty,mBC-0716-1
"A1,E1",18979,19348,14481,4867,10405,0,4613,4627,3187,1440,2.213194444,2192,1589,989,483,0,483,0,164,0,0.002070393,empty,mBC-0716-1
"A1,E2",799897,912474,529178,383296,486431,0,312373,312777,225515,87262,2.584343701,182012,56100,38253,18449,10,18439,3,1905,0,0.000813493,mm10,mBC-0716-1
"A1,E3",10555,10893,8241,2652,6002,1,2691,2696,1822,874,2.084668192,1223,1580,1060,492,1,491,1,149,0,0.00203666,empty,mBC-0716-1
"A1,E4",13536,13794,10375,3419,7351,0,3279,3299,2289,1010,2.266336634,1527,6840,2243,1108,1,1107,1,246,0,0.045167118,empty,mBC-0716-1
"A1,E5",18550,19031,14353,4678,10074,0,4418,4436,3135,1301,2.409684858,2041,1568,975,509,0,509,0,140,0,0.055009823,empty,mBC-0716-1
"A1,E6",1950397,2069603,1404684,664919,1074580,1,586160,587070,469258,117812,3.983108682,309201,253617,165229,78381,36,78345,6,4463,0,0.004633352,mm10,mBC-0716-1
"A1,E7",12638,12949,9740,3209,7009,0,3124,3129,2216,913,2.427163198,1460,1273,810,409,0,409,0,107,0,0.083129584,empty,mBC-0716-1
"A1,E8",15141,15408,11574,3834,8158,0,3550,3560,2473,1087,2.275068997,1623,1579,972,503,1,502,1,158,0,0.049800797,empty,mBC-0716-1
"A1,E9",8390,8677,6359,2318,4771,0,2165,2172,1540,632,2.436708861,1088,1980,829,402,1,401,1,119,0,0.072319202,empty,mBC-0716-1
"A1,E10",11405,11744,8755,2989,6342,1,2936,2941,2053,888,2.311936937,1398,1448,912,432,0,432,0,121,0,0.055555556,empty,mBC-0716-1
"A1,E11",693811,759060,493493,265567,408808,6,229473,229784,191818,37966,5.05236264,124671,79826,54499,25956,14,25942,4,2401,0,0.000424023,mm10,mBC-0716-1
"A1,E12",13782,14273,10383,3890,7881,0,3682,3684,2601,1083,2.40166205,1880,5458,1974,914,1,913,1,204,0,0.071193866,empty,mBC-0716-1
"A1,F1",15314,15865,11860,4005,8354,0,3773,3780,2623,1157,2.267070009,1803,1132,731,377,0,377,0,100,0,0.103448276,empty,mBC-0716-1
"A1,F2",19169,19697,14580,5117,10745,0,5029,5038,3554,1484,2.394878706,2408,3377,1872,941,1,940,1,262,0,0.09893617,empty,mBC-0716-1
"A1,F3",14440,14885,10852,4033,8204,1,3859,3871,2705,1166,2.319897084,1933,3036,1442,735,0,735,0,209,0,0.093877551,empty,mBC-0716-1
"A1,F4",15118,15545,11308,4237,8586,0,4016,4021,2863,1158,2.472366149,1993,479,304,173,0,173,0,79,0,0.005780347,empty,mBC-0716-1
"A1,F5",20858,21194,15830,5364,11394,0,5207,5213,3670,1543,2.378483474,2462,5047,1995,1019,1,1018,1,220,0,0.044204322,empty,mBC-0716-1
"A1,F6",20509,21253,15402,5851,11506,0,5293,5306,3665,1641,2.233394272,2584,1831,1111,539,0,539,0,176,0,0.038961039,empty,mBC-0716-1
"A1,F7",17190,17542,13245,4297,9690,0,4387,4400,3056,1344,2.273809524,2034,858,513,256,0,256,0,91,0,0.08984375,empty,mBC-0716-1
"A1,F8",967901,1121824,629153,492671,592850,1,393404,393909,300517,93392,3.217802381,232997,10862,7039,3291,1,3290,1,572,0,0.00212766,mm10,mBC-0716-1
"A1,F9",13386,13993,10133,3860,7634,0,3540,3547,2492,1055,2.362085308,1811,3466,1332,722,0,722,0,217,0,0.020775623,empty,mBC-0716-1
"A1,F10",17556,18000,13643,4357,9670,0,4236,4244,2986,1258,2.373608903,1922,962,600,323,0,323,0,110,0,0.027863777,empty,mBC-0716-1
"A1,F11",9968,10128,7655,2473,5457,0,2327,2338,1570,768,2.044270833,1082,886,549,315,0,315,0,100,0,0.136507937,empty,mBC-0716-1
"A1,F12",11937,12162,9191,2971,6482,0,2918,2931,2083,848,2.456367925,1329,57,39,17,0,17,0,12,0,0,empty,mBC-0716-1
"A1,G1",8754,8855,6818,2037,4843,0,2089,2096,1473,623,2.364365971,945,1723,1098,564,0,564,0,132,0,0.083333333,empty,mBC-0716-1
"A1,G2",17580,18208,13562,4646,9609,0,4237,4245,2975,1270,2.342519685,2045,498,349,183,0,183,0,57,0,0.005464481,empty,mBC-0716-1
"A1,G3",16956,17563,12928,4635,9392,0,4240,4249,3001,1248,2.404647436,2007,1826,1249,640,0,640,0,175,0,0.0640625,empty,mBC-0716-1
"A1,G4",23691,24247,18230,6017,13135,0,5916,5924,4238,1686,2.513641756,2842,70,35,24,0,24,0,16,0,0.041666667,empty,mBC-0716-1
"A1,G5",913613,964995,674127,290868,518831,1,265151,265527,206138,59389,3.470979474,137203,58519,41502,19819,2,19817,2,2061,0,0.003179089,mm10,mBC-0716-1
"A1,G6",659418,688879,498609,190270,368292,0,175974,176294,131496,44798,2.935309612,88034,3970,2852,1383,0,1383,0,310,0,0.000723066,mm10,mBC-0716-1
"A1,G7",17180,17295,13374,3921,9352,0,4063,4075,2884,1191,2.421494542,1799,1641,1009,526,0,526,0,152,0,0.076045627,empty,mBC-0716-1
"A1,G8",12457,13222,9402,3820,7038,1,3348,3360,2408,952,2.529411765,1656,1365,864,456,0,456,0,126,0,0.11622807,empty,mBC-0716-1
"A1,G9",503104,547791,368793,178998,297286,2,155766,156012,128676,27336,4.707199298,82930,129741,88341,41026,12,41014,1,3065,0,0.000853367,mm10,mBC-0716-1
"A1,G10",11598,11665,8879,2786,6302,0,2824,2828,1929,899,2.145717464,1273,1089,702,379,0,379,0,109,0,0.137203166,empty,mBC-0716-1
"A1,G11",11051,11366,8521,2845,6063,0,2708,2713,1890,823,2.296476306,1291,2699,928,463,0,463,0,104,0,0.045356371,empty,mBC-0716-1
"A1,G12",10515,10875,8017,2858,5993,0,2775,2783,1946,837,2.324970131,1342,1088,762,418,1,417,1,105,0,0.002398082,empty,mBC-0716-1
"A1,H1",18396,18735,13871,4864,10278,0,4640,4656,3287,1369,2.401022644,2296,3079,1214,605,0,605,0,149,0,0.044628099,empty,mBC-0716-1
"A1,H2",20340,21001,15476,5525,11181,0,5076,5084,3676,1408,2.610795455,2415,2269,1314,669,1,668,1,175,0,0.049401198,empty,mBC-0716-1
"A1,H3",17527,18231,13245,4986,9855,0,4573,4583,3255,1328,2.451054217,2246,3090,1357,665,1,664,1,189,0,0.052710843,empty,mBC-0716-1
"A1,H4",12014,12313,9122,3191,6641,0,3100,3102,2143,959,2.234619395,1437,128,62,37,0,37,0,22,0,0.216216216,empty,mBC-0716-1
"A1,H5",15842,16461,12072,4389,8911,0,4129,4143,2912,1231,2.365556458,1964,1102,675,355,0,355,0,127,0,0.03943662,empty,mBC-0716-1
"A1,H6",537461,580977,377958,203019,314776,0,174380,174617,147684,26933,5.483384695,94619,116887,78084,37287,19,37268,3,2850,0,0.000590319,mm10,mBC-0716-1
"A1,H7",14902,15270,11339,3931,8543,0,3882,3894,2774,1120,2.476785714,1824,1413,909,471,0,471,0,172,0,0.029723992,empty,mBC-0716-1
"A1,H8",12181,12733,9169,3564,6838,0,3212,3220,2311,909,2.542354235,1595,1338,786,397,0,397,0,131,0,0.040302267,empty,mBC-0716-1
"A1,H9",13900,14042,10449,3593,7656,0,3479,3483,2423,1060,2.285849057,1666,979,656,343,0,343,0,99,0,0.008746356,empty,mBC-0716-1
"A1,H10",12617,13139,9522,3617,7275,0,3441,3454,2491,963,2.586708204,1752,5915,1920,1015,1,1014,1,217,0,0.038461538,empty,mBC-0716-1
"A1,H11",1353987,1502666,962882,539784,797756,2,456514,457181,362723,94458,3.840045311,253701,6030,3941,1882,0,1882,0,386,0,0.009032944,mm10,mBC-0716-1
"A1,H12",5460,5648,4095,1553,3036,0,1406,1406,980,426,2.300469484,686,774,517,270,0,270,0,75,0,0.059259259,empty,mBC-0716-1
"A2,A1",13958,14395,10471,3924,7947,0,3793,3804,2755,1049,2.626310772,1822,1581,1018,448,0,448,0,127,0,0.051339286,empty,mBC-0716-1
"A2,A2",18889,18997,14432,4565,10060,0,4504,4516,3250,1266,2.5671406,2097,1591,998,483,0,483,0,116,0,0.122153209,empty,mBC-0716-1
"A2,A3",16314,16626,12391,4235,8916,0,4045,4059,2852,1207,2.362883181,1870,907,595,337,1,336,1,95,0,0.032738095,empty,mBC-0716-1
"A2,A4",2122366,2235430,1566417,669013,1126084,2,590103,591106,490225,100881,4.859438348,300706,75768,53002,25007,18,24989,3,2252,0,0.001760775,mm10,mBC-0716-1
"A2,A5",16436,16966,12631,4335,9117,0,4139,4145,2934,1211,2.422791082,1954,1805,939,512,0,512,0,127,0,0.087890625,empty,mBC-0716-1
"A2,A6",18265,19180,13575,5605,10560,0,5209,5222,3916,1306,2.998468606,2670,2268,1404,724,0,724,0,180,0,0.064917127,empty,mBC-0716-1
"A2,A7",15745,16106,11970,4136,8645,0,3882,3889,2713,1176,2.306972789,1845,7904,2437,1260,0,1260,0,286,0,0.023809524,empty,mBC-0716-1
"A2,A8",812259,894243,550805,343438,471376,1,288783,289185,240011,49174,4.88085167,159632,165914,105028,48775,27,48748,4,3482,0,0.010031181,mm10,mBC-0716-1
"A2,A9",18127,18437,14065,4372,9668,0,4163,4174,2982,1192,2.501677852,1911,4637,1734,880,1,879,1,191,0,0.023890785,empty,mBC-0716-1
"A2,A10",15435,15869,11802,4067,8517,0,3824,3832,2705,1127,2.400177462,1849,379,247,126,0,126,0,53,0,0.103174603,empty,mBC-0716-1
"A2,A11",17626,17944,13655,4289,9545,0,4182,4188,2956,1232,2.399350649,1905,1381,810,428,0,428,0,124,0,0.030373832,empty,mBC-0716-1
"A2,A12",20007,20409,15390,5019,10734,0,4697,4707,3372,1335,2.525842697,2189,3150,1789,936,0,936,0,193,0,0.126068376,empty,mBC-0716-1
"A2,B1",18427,18605,14145,4460,9944,0,4361,4375,3012,1363,2.209831255,2029,1240,769,381,0,381,0,108,0,0.070866142,empty,mBC-0716-1
"A2,B2",19297,19678,14888,4790,10427,0,4602,4617,3119,1498,2.082109479,2140,481,273,146,0,146,0,55,0,0.01369863,empty,mBC-0716-1
"A2,B3",783822,907152,529549,377603,485346,1,309022,309407,235586,73821,3.191314125,180888,25131,17531,8213,2,8211,1,1068,0,0.004627938,mm10,mBC-0716-1
"A2,B4",16272,16519,12513,4006,8940,0,4077,4079,2862,1217,2.35168447,1894,1809,877,448,1,447,1,131,0,0.194630872,empty,mBC-0716-1
"A2,B5",8584,5435,3820,1615,3742,0,1783,1797,1234,563,2.191829485,965,1255,661,345,0,345,0,87,0,0.063768116,empty,mBC-0716-1
"A2,B6",791554,844455,584656,259799,454380,2,230612,231024,186441,44583,4.181885472,120687,94777,64085,31002,7,30995,2,2817,0,0.001548637,mm10,mBC-0716-1
"A2,B7",15006,15554,11552,4002,8318,0,3789,3801,2608,1193,2.186085499,1795,1212,758,378,0,378,0,101,0,0.074074074,empty,mBC-0716-1
"A2,B8",12458,12911,9429,3482,6918,0,3131,3134,2239,895,2.501675978,1509,1124,672,334,0,334,0,119,0,0.047904192,empty,mBC-0716-1
"A2,B9",14420,14950,10942,4008,7965,0,3619,3626,2470,1156,2.136678201,1767,457,256,137,0,137,0,58,0,0.094890511,empty,mBC-0716-1
"A2,B10",16249,16224,11821,4403,8924,6,4170,4202,2884,1318,2.188163885,2054,526,341,186,0,186,0,54,0,0.032258065,empty,mBC-0716-1
"A2,B11",16049,16381,12273,4108,8733,0,3975,3987,2915,1072,2.719216418,1908,83,63,41,0,41,0,28,0,0,empty,mBC-0716-1
"A2,B12",18043,18238,13788,4450,9755,0,4373,4382,3049,1333,2.28732183,2061,2739,1274,724,1,723,1,180,0,0.164591978,empty,mBC-0716-1
"A2,C1",22155,22115,16874,5241,11443,0,4852,4856,3413,1443,2.365211365,2173,5246,1912,925,2,923,2,206,0,0.084507042,empty,mBC-0716-1
"A2,C2",780539,818205,570975,247230,430754,1,216390,216731,187991,28740,6.541092554,111243,139722,96930,46301,9,46292,1,3319,0,0.004017973,mm10,mBC-0716-1
"A2,C3",18954,19730,14427,5303,10310,0,4727,4741,3402,1339,2.540702016,2290,541,261,148,0,148,0,46,0,0.02027027,empty,mBC-0716-1
"A2,C4",696618,730782,515706,215076,388817,0,191702,191996,153022,38974,3.926258531,97345,47751,26837,12324,4,12320,1,1677,0,0.002597403,mm10,mBC-0716-1
"A2,C5",17422,17991,13194,4797,9518,0,4359,4365,3132,1233,2.540145985,2094,3857,1474,735,2,733,1,155,0,0.001364256,empty,mBC-0716-1
"A2,C6",17597,18052,13324,4728,9943,0,4635,4644,3283,1361,2.412196914,2228,1960,1088,471,0,471,0,141,0,0.016985138,empty,mBC-0716-1
"A2,C7",15598,16372,11744,4628,8713,0,4091,4101,2866,1235,2.320647773,2028,363,228,112,0,112,0,53,0,0,empty,mBC-0716-1
"A2,C8",14717,14868,11301,3567,8062,0,3728,3733,2662,1071,2.485527544,1691,1736,1039,551,1,550,1,155,0,0.038181818,empty,mBC-0716-1
"A2,C9",12067,12463,9101,3362,6506,0,2977,2984,2055,929,2.212055974,1457,869,508,276,1,275,1,80,0,0.061818182,empty,mBC-0716-1
"A2,C10",645395,685300,463593,221707,367956,0,203960,204256,159026,45230,3.515940747,107497,1146,657,318,0,318,0,103,0,0.028301887,empty,mBC-0716-1
"A2,C11",11839,12133,8848,3285,6512,4,3121,3131,2136,995,2.146733668,1548,18329,5446,2762,1,2761,1,469,0,0.023180007,empty,mBC-0716-1
"A2,C12",19368,20110,14602,5508,10787,0,4974,4983,3533,1450,2.436551724,2453,1063,664,332,0,332,0,102,0,0.021084337,empty,mBC-0716-1
"A2,D1",11770,12138,8838,3300,6580,0,3137,3145,2248,897,2.50613155,1556,2020,704,343,0,343,0,82,0,0.032069971,empty,mBC-0716-1
"A2,D2",886491,970263,631822,338441,510883,2,285488,285932,221057,64875,3.407429672,155908,203445,138153,65163,28,65135,4,3958,0,0.000890458,mm10,mBC-0716-1
"A2,D3",496616,531470,366206,165264,287857,1,142732,142955,121629,21326,5.703319891,74387,115947,80976,37890,11,37879,1,3014,0,0.000422398,mm10,mBC-0716-1
"A2,D4",14027,14296,10812,3484,7527,0,3444,3452,2394,1058,2.262759924,1627,9839,3095,1551,1,1550,1,267,0,0.102580645,empty,mBC-0716-1
"A2,D5",14171,14810,10727,4083,7784,0,3547,3554,2506,1048,2.391221374,1753,1418,839,435,0,435,0,118,0,0.025287356,empty,mBC-0716-1
"A2,D6",425542,446405,318030,128375,241801,1,116151,116335,79177,37158,2.130819743,60889,23596,16319,7777,2,7775,1,1020,0,0.013247588,mm10,mBC-0716-1
"A2,D7",13287,13810,10125,3685,7438,0,3565,3576,2475,1101,2.247956403,1704,2039,1151,541,0,541,0,166,0,0.020332717,empty,mBC-0716-1
"A2,D8",16109,17039,12214,4825,9087,0,4299,4305,3082,1223,2.520032706,2176,1566,814,381,0,381,0,98,0,0.01312336,empty,mBC-0716-1
"A2,D9",5512,5775,4000,1775,3234,0,1591,1601,1140,461,2.472885033,822,2278,1183,606,0,606,0,137,0,0.118811881,empty,mBC-0716-1
"A2,D10",16143,16527,12173,4354,9010,0,4251,4259,3037,1222,2.485270049,2027,777,425,241,0,241,0,85,0,0.053941909,empty,mBC-0716-1
"A2,D11",13068,13377,9882,3495,7022,0,3194,3204,2317,887,2.612175874,1511,4512,1887,921,3,918,3,199,0,0.08496732,empty,mBC-0716-1
"A2,D12",19517,20099,14695,5404,10582,0,4791,4802,3307,1495,2.212040134,2326,1765,1131,550,0,550,0,165,0,0.023636364,empty,mBC-0716-1
"A2,E1",599434,609363,448706,160657,327548,2,153420,153683,120839,32844,3.679180368,74999,62439,29719,14402,8,14394,3,1754,0,0.018063082,mm10,mBC-0716-1
"A2,E2",16195,16836,12282,4554,9065,0,4243,4248,3003,1245,2.412048193,2075,1747,1051,548,0,548,0,138,0,0.136861314,empty,mBC-0716-1
"A2,E3",12049,12723,9236,3487,6670,0,3062,3066,2135,931,2.293233083,1499,1627,1022,489,1,488,1,156,0,0.055327869,empty,mBC-0716-1
"A2,E4",15405,15715,11597,4118,8221,0,3722,3731,2621,1110,2.361261261,1802,9164,3094,1502,0,1502,0,305,0,0.028628495,empty,mBC-0716-1
"A2,E5",933341,1003557,699839,303718,527268,0,272472,272918,186632,86286,2.16294648,140853,40999,28044,13331,7,13324,1,1499,0,0.001801261,mm10,mBC-0716-1
"A2,E6",14212,14339,10606,3733,7582,0,3439,3442,2396,1046,2.290630975,1642,36237,11433,5944,8,5936,5,841,0,0.11708221,empty,mBC-0716-1
"A2,E7",607780,661127,435525,225602,353737,1,196474,196734,154836,41898,3.695546327,105440,59898,41401,19577,6,19571,1,1989,0,0.005773849,mm10,mBC-0716-1
"A2,E8",16739,16962,12799,4163,9167,0,4037,4048,2854,1194,2.390284757,1869,2064,1193,548,1,547,1,179,0,0.0511883,empty,mBC-0716-1
"A2,E9",9606,9916,7365,2551,5256,0,2421,2425,1700,725,2.344827586,1181,1194,700,377,1,376,1,113,0,0.04787234,empty,mBC-0716-1
"A2,E10",12964,13141,10027,3114,7114,0,3179,3182,2214,968,2.287190083,1480,1308,812,434,0,434,0,119,0,0.092165899,empty,mBC-0716-1
"A2,E11",9178,9571,6989,2582,5163,0,2388,2393,1760,633,2.780410742,1157,977,637,302,0,302,0,108,0,0.026490066,empty,mBC-0716-1
"A2,E12",14688,15329,11080,4249,8144,0,3781,3791,2654,1137,2.334212841,1777,8696,2933,1473,1,1472,1,287,0,0.03736413,empty,mBC-0716-1
"A2,F1",878320,1005732,588795,416937,529840,0,336732,337096,274886,62210,4.418678669,195365,117600,81587,37985,9,37976,2,2928,0,0.0009743,mm10,mBC-0716-1
"A2,F2",21983,22993,16632,6361,12178,3,5595,5604,3999,1605,2.491588785,2728,2929,1750,872,0,872,0,206,0,0.068807339,empty,mBC-0716-1
"A2,F3",16575,17463,12398,5065,9287,0,4527,4537,3184,1353,2.353288987,2295,1348,767,412,0,412,0,147,0,0.033980583,empty,mBC-0716-1
"A2,F4",622974,644940,466498,178442,351011,0,165148,165446,141224,24222,5.830402114,82242,31702,21301,10044,5,10039,1,1280,0,0.001095727,mm10,mBC-0716-1
"A2,F5",23570,24382,18070,6312,12704,0,5778,5793,4027,1766,2.280294451,2749,3124,1436,718,2,716,1,174,0,0.005586592,empty,mBC-0716-1
"A2,F6",23079,23771,17655,6116,12756,0,5871,5892,4216,1676,2.515513126,2764,3026,1577,769,0,769,0,198,0,0.046814044,empty,mBC-0716-1
"A2,F7",793184,904061,534248,369813,491060,0,309482,309891,215611,94280,2.286921935,183218,14341,5540,2696,2,2694,2,487,0,0.033036377,mm10,mBC-0716-1
"A2,F8",752053,801984,558083,243901,424389,1,211451,211767,164483,47284,3.47861856,110719,11034,7445,3599,1,3598,1,580,0,0.000277932,mm10,mBC-0716-1
"A2,F9",14978,15327,11412,3915,8273,0,3809,3815,2707,1108,2.443140794,1800,2030,1266,629,0,629,0,180,0,0.020667727,empty,mBC-0716-1
"A2,F10",19872,20188,15379,4809,10711,0,4622,4631,3303,1328,2.487198795,2150,1434,890,464,0,464,0,135,0,0.081896552,empty,mBC-0716-1
"A2,F11",11066,11311,8537,2774,6127,0,2726,2744,1912,832,2.298076923,1290,1068,711,379,0,379,0,110,0,0.044854881,empty,mBC-0716-1
"A2,F12",534314,553361,391398,161963,295672,1,147260,147488,118964,28524,4.170663301,75228,2832,1520,746,4,742,1,171,0,0.006738544,empty,mBC-0716-1
"A2,G1",9618,10144,7379,2765,5457,0,2483,2487,1754,733,2.392905866,1232,1761,1142,513,0,513,0,138,0,0.019493177,empty,mBC-0716-1
"A2,G2",19784,20322,15194,5128,10713,0,4877,4885,3450,1435,2.404181185,2284,323,188,108,0,108,0,39,0,0.064814815,empty,mBC-0716-1
"A2,G3",19455,19884,14833,5051,10692,0,4870,4884,3419,1465,2.333788396,2308,2076,1238,577,0,577,0,169,0,0.032928943,empty,mBC-0716-1
"A2,G4",1022014,1085059,748759,336300,561739,1,286391,286860,236152,50708,4.657095527,148081,1326,938,459,0,459,0,106,0,0.002178649,empty,mBC-0716-1
"A2,G5",13149,13756,10025,3731,7292,1,3453,3470,2423,1047,2.314231137,1657,3292,1441,752,1,751,1,189,0,0.062583222,empty,mBC-0716-1
"A2,G6",23831,24611,18572,6039,12879,0,5693,5699,4052,1647,2.460230723,2633,123,89,53,0,53,0,29,0,0,empty,mBC-0716-1
"A2,G7",19612,19993,15046,4947,10559,0,4725,4735,3278,1457,2.249828415,2190,5791,2004,990,1,989,1,244,0,0.077856421,empty,mBC-0716-1
"A2,G8",14316,14918,10855,4063,7913,0,3703,3710,2654,1056,2.513257576,1781,9232,3020,1464,2,1462,2,299,0,0.032147743,empty,mBC-0716-1
"A2,G9",10622,11154,7976,3178,5950,1,2828,2837,2008,829,2.422195416,1438,1104,706,396,0,396,0,136,0,0.025252525,empty,mBC-0716-1
"A2,G10",13235,13929,10037,3892,7288,0,3355,3363,2377,986,2.410750507,1602,1261,884,449,0,449,0,138,0,0.026726058,empty,mBC-0716-1
"A2,G11",12496,12453,9536,2917,6691,0,2980,2987,2124,863,2.461181924,1402,491,342,182,0,182,0,76,0,0,empty,mBC-0716-1
"A2,G12",11251,11783,8606,3177,6391,0,2948,2957,2045,912,2.242324561,1418,1389,792,353,0,353,0,114,0,0.050991501,empty,mBC-0716-1
"A2,H1",1781159,1874246,1320370,553876,977559,2,501833,502657,399560,103097,3.875573489,257861,126438,89250,41444,14,41430,1,3210,0,0.003065412,mm10,mBC-0716-1
"A2,H2",25959,26531,19697,6834,14058,0,6465,6474,4596,1878,2.447284345,3142,9669,3575,1772,0,1772,0,321,0,0.050225734,empty,mBC-0716-1
"A2,H3",21504,22504,16449,6055,12011,1,5556,5563,3989,1574,2.534307497,2734,2090,1382,682,0,682,0,167,0,0.046920821,empty,mBC-0716-1
"A2,H4",13385,13998,10091,3907,7502,0,3597,3603,2469,1134,2.177248677,1747,178,115,46,0,46,0,22,0,0,empty,mBC-0716-1
"A2,H5",18194,19133,13683,5450,10146,0,4866,4873,3522,1351,2.606957809,2431,4003,1767,895,0,895,0,198,0,0.109497207,empty,mBC-0716-1
"A2,H6",15024,15363,11232,4131,8327,0,3868,3875,2763,1112,2.48471223,1905,1834,1196,592,1,591,1,160,0,0.094754653,empty,mBC-0716-1
"A2,H7",17673,18058,13161,4897,9796,0,4608,4618,3298,1320,2.498484848,2277,1627,1033,514,0,514,0,172,0,0.007782101,empty,mBC-0716-1
"A2,H8",13901,14309,10407,3902,7655,0,3612,3624,2528,1096,2.306569343,1742,10017,3587,1760,0,1760,0,347,0,0.053409091,empty,mBC-0716-1
"A2,H9",774143,845059,528932,316127,449962,1,267212,267611,216816,50795,4.268451619,148943,75779,45909,21906,15,21891,2,2228,0,0.005481705,mm10,mBC-0716-1
"A2,H10",15115,15353,11462,3891,8269,0,3774,3785,2682,1103,2.431550317,1809,1536,826,431,0,431,0,140,0,0.030162413,empty,mBC-0716-1
"A2,H11",16908,17659,12743,4916,9494,0,4506,4513,3173,1340,2.367910448,2246,139,100,62,0,62,0,36,0,0,empty,mBC-0716-1
"A2,H12",6242,6551,4761,1790,3528,0,1676,1676,1209,467,2.588865096,828,436,229,146,0,146,0,55,0,0.212328767,empty,mBC-0716-1
"A3,A1",16262,17031,12240,4791,9280,0,4400,4406,3173,1233,2.573398216,2171,991,635,348,0,348,0,110,0,0.109195402,empty,mBC-0716-1
"A3,A2",21403,21725,16240,5485,11490,0,5147,5158,3610,1548,2.332041344,2408,3928,1756,858,0,858,0,193,0,0.152680653,empty,mBC-0716-1
"A3,A3",17948,18426,13606,4820,9986,0,4621,4628,3199,1429,2.238628411,2206,1083,726,384,0,384,0,128,0,0.020833333,empty,mBC-0716-1
"A3,A4",811751,873848,601780,272068,460090,0,231052,231459,191075,40384,4.731453051,119970,67830,49182,23314,6,23308,2,2138,0,0.001029689,mm10,mBC-0716-1
"A3,A5",18754,19336,14352,4984,10395,0,4693,4709,3328,1381,2.409847936,2235,1170,691,365,0,365,0,130,0,0.02739726,empty,mBC-0716-1
"A3,A6",14691,15043,11109,3934,8150,0,3764,3770,2687,1083,2.481071099,1768,1894,938,444,0,444,0,136,0,0.02027027,empty,mBC-0716-1
"A3,A7",18543,19062,14291,4771,10073,0,4570,4579,3111,1468,2.119209809,2093,1021,591,331,0,331,0,127,0,0.114803625,empty,mBC-0716-1
"A3,A8",12711,12929,9608,3321,7029,0,3265,3272,2329,943,2.469777306,1549,1529,929,512,0,512,0,153,0,0.05078125,empty,mBC-0716-1
"A3,A9",19715,19715,15257,4458,10473,0,4501,4513,3194,1319,2.421531463,2032,894,530,252,0,252,0,103,0,0,empty,mBC-0716-1
"A3,A10",17372,17739,13230,4509,9636,0,4477,4484,3141,1343,2.338793745,2163,420,222,98,0,98,0,56,0,0.020408163,empty,mBC-0716-1
"A3,A11",19521,19974,15123,4851,10868,0,4832,4842,3380,1462,2.311901505,2271,981,593,324,0,324,0,111,0,0.074074074,empty,mBC-0716-1
"A3,A12",959430,1059847,658364,401483,555056,0,340669,341180,271808,69372,3.918122585,189756,44399,30120,14654,8,14646,1,1747,0,0.005735354,mm10,mBC-0716-1
"A3,B1",21132,21614,15997,5617,11286,0,5184,5191,3652,1539,2.372969461,2495,12402,4139,2097,1,2096,1,356,0,0.159351145,empty,mBC-0716-1
"A3,B2",21477,22135,16390,5745,11622,0,5251,5258,3644,1614,2.257744734,2472,569,340,189,0,189,0,69,0,0.063492063,empty,mBC-0716-1
"A3,B3",21269,22118,16179,5939,11914,0,5505,5517,3923,1594,2.461104141,2768,1155,782,409,1,408,1,119,0,0.075980392,empty,mBC-0716-1
"A3,B4",17948,18639,13814,4825,9868,0,4514,4515,3242,1273,2.546739984,2175,1131,637,363,0,363,0,112,0,0.033057851,empty,mBC-0716-1
"A3,B5",17075,14109,9284,4825,8643,0,4585,4593,3469,1124,3.086298932,2511,615,403,229,0,229,0,82,0,0.03930131,empty,mBC-0716-1
"A3,B6",13097,13805,9822,3983,7377,0,3612,3615,2458,1157,2.12445981,1815,1054,674,369,0,369,0,99,0,0.021680217,empty,mBC-0716-1
"A3,B7",17596,17995,13552,4443,9747,0,4322,4328,3023,1305,2.316475096,2045,4106,1918,983,1,982,1,160,0,0.293279022,empty,mBC-0716-1
"A3,B8",14580,14780,11041,3739,7857,0,3579,3589,2614,975,2.681025641,1662,888,595,289,0,289,0,131,0,0.01384083,empty,mBC-0716-1
"A3,B9",16096,16427,12436,3991,8626,0,3791,3806,2642,1164,2.26975945,1742,685,426,218,0,218,0,74,0,0.073394495,empty,mBC-0716-1
"A3,B10",2152014,2138083,1403637,734446,1138764,11,634683,637981,507476,130505,3.888555994,347491,73047,50897,24372,6,24366,2,2354,0,0.000820816,mm10,mBC-0716-1
"A3,B11",21996,23131,16629,6502,12290,0,5940,5951,4422,1529,2.892086331,2900,243,177,95,0,95,0,36,0,0.010526316,empty,mBC-0716-1
"A3,B12",19136,19730,14377,5353,10702,0,4993,5001,3528,1473,2.395112016,2484,4271,1701,852,0,852,0,184,0,0.04342723,empty,mBC-0716-1
"A3,C1",1246838,1332946,914252,418694,685548,5,365101,365680,276417,89263,3.09665819,191077,37536,26579,12596,5,12591,1,1377,0,0.001350171,mm10,mBC-0716-1
"A3,C2",22534,23389,16843,6546,12442,0,5914,5926,4252,1674,2.540023895,2969,5861,2583,1298,1,1297,1,260,0,0.199691596,empty,mBC-0716-1
"A3,C3",22141,22866,16860,6006,11991,0,5414,5424,3837,1587,2.417769376,2546,944,564,309,0,309,0,89,0,0.045307443,empty,mBC-0716-1
"A3,C4",983587,1055412,698905,356507,560456,3,313696,314140,228449,85691,2.665962587,168683,37035,26276,12590,5,12585,1,1445,0,0.001589193,mm10,mBC-0716-1
"A3,C5",989902,1044358,729066,315292,548171,2,274564,275025,241922,33103,7.308159381,141066,140338,101221,48566,11,48555,3,3245,0,0.001318093,mm10,mBC-0716-1
"A3,C6",1040023,1153794,697997,455797,628411,4,390442,391003,293149,97854,2.995779426,222392,56419,40483,19151,7,19144,1,1976,0,0.000992478,mm10,mBC-0716-1
"A3,C7",18114,18754,13642,5112,10023,0,4755,4764,3339,1425,2.343157895,2312,286,167,91,0,91,0,40,0,0.010989011,empty,mBC-0716-1
"A3,C8",16739,17361,12670,4691,9285,0,4299,4309,2934,1375,2.133818182,2090,15385,4840,2450,0,2450,0,432,0,0.050612245,empty,mBC-0716-1
"A3,C9",13853,14526,10447,4079,7646,0,3581,3585,2484,1101,2.25613079,1817,4895,1810,894,0,894,0,159,0,0.085011186,empty,mBC-0716-1
"A3,C10",14800,15375,11177,4198,8233,1,3813,3827,2665,1162,2.293459552,1857,856,552,301,0,301,0,93,0,0.03986711,empty,mBC-0716-1
"A3,C11",1614265,1866356,1092317,774039,981288,3,625357,626170,466171,159999,2.91358696,365144,117122,83519,39244,16,39228,1,3050,0,0.000611808,mm10,mBC-0716-1
"A3,C12",745622,824518,524443,300075,437007,3,250256,250658,202042,48616,4.155874609,139292,39047,25422,12250,7,12243,2,1432,0,0.001796945,mm10,mBC-0716-1
"A3,D1",13376,13944,10029,3915,7434,0,3523,3536,2493,1043,2.390220518,1733,444,289,150,0,150,0,51,0,0.06,empty,mBC-0716-1
"A3,D2",21931,21958,16900,5058,11879,0,5127,5143,3603,1540,2.33961039,2369,1994,1313,669,0,669,0,185,0,0.065769806,empty,mBC-0716-1
"A3,D3",15313,16248,11464,4784,8858,0,4300,4310,3044,1266,2.404423381,2225,883,570,302,0,302,0,114,0,0.009933775,empty,mBC-0716-1
"A3,D4",774523,833882,567784,266098,445359,2,234762,235070,184324,50746,3.632286289,123025,69793,49518,24069,11,24058,2,2319,0,0.002327708,mm10,mBC-0716-1
"A3,D5",15900,16527,12266,4261,8767,0,4060,4076,2879,1197,2.405179616,1981,1133,764,397,0,397,0,127,0,0.002518892,empty,mBC-0716-1
"A3,D6",13689,14213,10276,3937,7814,1,3716,3724,2611,1113,2.34591195,1882,1014,654,339,0,339,0,114,0,0.026548673,empty,mBC-0716-1
"A3,D7",677970,739710,479445,260265,394021,1,210972,211260,182580,28680,6.366108787,115081,287127,200180,95668,40,95628,6,4766,0,0.000564688,mm10,mBC-0716-1
"A3,D8",17365,18093,13167,4926,9712,0,4526,4535,3126,1409,2.218594748,2208,743,446,249,0,249,0,93,0,0.052208835,empty,mBC-0716-1
"A3,D9",6601,6917,4851,2066,3902,0,2001,2006,1477,529,2.792060491,1061,1268,861,407,0,407,0,117,0,0.103194103,empty,mBC-0716-1
"A3,D10",14694,15413,11234,4179,8419,0,3992,3995,2798,1197,2.337510443,1931,2576,1000,541,0,541,0,140,0,0.049907579,empty,mBC-0716-1
"A3,D11",2190044,2390409,1559671,830738,1238910,1,719006,720020,556861,163159,3.412995912,391739,184461,126089,60312,27,60285,4,3798,0,0.002571121,mm10,mBC-0716-1
"A3,D12",22395,22925,16961,5964,12080,0,5506,5522,3899,1623,2.402341343,2623,7216,3171,1650,1,1649,1,332,0,0.184354154,empty,mBC-0716-1
"A3,E1",24839,24718,18569,6149,13145,0,5929,5941,4283,1658,2.583232811,2770,25835,8165,4308,4,4304,1,636,0,0.18169145,empty,mBC-0716-1
"A3,E2",18087,18084,13664,4420,9972,0,4396,4408,3125,1283,2.435697584,2080,1404,907,504,0,504,0,140,0,0.007936508,empty,mBC-0716-1
"A3,E3",12932,13229,9863,3366,7164,0,3237,3242,2302,940,2.44893617,1551,1291,751,403,0,403,0,143,0,0.042183623,empty,mBC-0716-1
"A3,E4",17037,17453,12975,4478,9330,0,4291,4301,3066,1235,2.482591093,2038,1368,867,426,0,426,0,136,0,0.028169014,empty,mBC-0716-1
"A3,E5",22150,22529,17016,5513,12185,0,5488,5492,3878,1614,2.402726146,2585,1121,745,402,0,402,0,123,0,0.042288557,empty,mBC-0716-1
"A3,E6",1491539,1632917,1043082,589835,856618,0,511751,512477,354328,158149,2.240469431,282970,79554,38162,18812,10,18802,2,2186,0,0.027497075,mm10,mBC-0716-1
"A3,E7",15893,16375,12086,4289,8592,0,3844,3853,2661,1192,2.23238255,1854,10121,3445,1723,1,1722,1,329,0,0.117305459,empty,mBC-0716-1
"A3,E8",772368,789040,577681,211359,420320,2,198607,198978,130137,68841,1.890399617,100731,20985,14164,6932,3,6929,1,1045,0,0.002886419,mm10,mBC-0716-1
"A3,E9",10431,10556,7946,2610,5682,0,2668,2673,1935,738,2.62195122,1206,1126,741,353,0,353,0,106,0,0.053824363,empty,mBC-0716-1
"A3,E10",14201,14621,10960,3661,7778,0,3610,3610,2482,1128,2.20035461,1722,2516,1222,627,0,627,0,159,0,0.012759171,empty,mBC-0716-1
"A3,E11",490017,521415,366953,154462,283230,0,137108,137336,114741,22595,5.078158885,70187,115683,80270,38665,18,38647,1,2909,0,0.000310503,mm10,mBC-0716-1
"A3,E12",16606,17334,12528,4806,9403,0,4411,4422,3097,1325,2.337358491,2189,1042,676,371,0,371,0,119,0,0.018867925,empty,mBC-0716-1
"A3,F1",19136,19717,14460,5257,10536,0,4763,4766,3408,1358,2.509572901,2325,3984,1700,855,1,854,1,186,0,0.12529274,empty,mBC-0716-1
"A3,F2",24449,25021,18652,6369,13294,0,6054,6075,4242,1833,2.314238953,2870,2192,1409,673,0,673,0,219,0,0.050520059,empty,mBC-0716-1
"A3,F3",760901,823061,556570,266491,438853,1,230087,230451,195415,35036,5.577548807,122113,116034,79795,38061,12,38049,2,2901,0,0.001130122,mm10,mBC-0716-1
"A3,F4",20072,20630,15096,5534,11526,0,5343,5354,3834,1520,2.522368421,2685,557,353,185,0,185,0,77,0,0,empty,mBC-0716-1
"A3,F5",538059,565724,402954,162770,306332,1,147984,148264,97976,50288,1.948297805,78409,13417,8017,3725,2,3723,1,663,0,0.024711254,mm10,mBC-0716-1
"A3,F6",370630,356616,293872,62744,194777,0,66282,66439,53115,13324,3.986415491,28160,11622,8106,3935,1,3934,1,792,0,0.004321301,mm10,mBC-0716-1
"A3,F7",21163,21722,16119,5603,11846,0,5379,5389,3834,1555,2.465594855,2588,802,540,269,0,269,0,100,0,0.037174721,empty,mBC-0716-1
"A3,F8",1054983,1190321,720296,470025,625974,0,382976,383530,316105,67425,4.688246199,217737,14344,9737,4720,0,4720,0,738,0,0.000211864,mm10,mBC-0716-1
"A3,F9",1482799,1589426,1064518,524908,839609,2,466581,467241,379272,87969,4.311427889,247519,112932,81647,38704,8,38696,1,3167,0,0.001524705,mm10,mBC-0716-1
"A3,F10",21853,22546,16843,5703,11936,0,5267,5279,3691,1588,2.324307305,2481,1474,781,391,1,390,1,130,0,0.005128205,empty,mBC-0716-1
"A3,F11",12282,12371,9350,3021,6667,0,2944,2946,2040,906,2.251655629,1376,932,637,274,0,274,0,86,0,0.127737226,empty,mBC-0716-1
"A3,F12",15682,15674,11799,3875,8490,0,3904,3915,2802,1113,2.517520216,1806,883,316,143,0,143,0,38,0,0.041958042,empty,mBC-0716-1
"A3,G1",10789,10972,8279,2693,5937,0,2661,2665,1869,796,2.34798995,1223,2309,1247,625,1,624,1,142,0,0.049679487,empty,mBC-0716-1
"A3,G2",22145,22610,17129,5481,11892,0,5213,5228,3634,1594,2.279799247,2389,422,260,137,1,136,1,42,0,0,empty,mBC-0716-1
"A3,G3",22843,23132,17218,5914,12466,0,5681,5690,4002,1688,2.370853081,2757,1867,1163,639,0,639,0,186,0,0.03599374,empty,mBC-0716-1
"A3,G4",1200203,1340770,805911,534859,699058,1,433626,434171,367107,67064,5.473980079,246302,1197,806,440,0,440,0,113,0,0.027272727,empty,mBC-0716-1
"A3,G5",14349,14791,10972,3819,7975,0,3617,3620,2568,1052,2.441064639,1763,1010,698,403,0,403,0,128,0,0.022332506,empty,mBC-0716-1
"A3,G6",26022,26730,20025,6705,14216,0,6293,6301,4414,1887,2.339162692,3038,321,162,95,0,95,0,36,0,0,empty,mBC-0716-1
"A3,G7",21190,21822,16586,5236,11490,0,5092,5098,3635,1463,2.484620643,2276,1693,1087,594,0,594,0,158,0,0.052188552,empty,mBC-0716-1
"A3,G8",608123,641549,461951,179598,342762,0,162739,163023,139059,23964,5.802829244,81707,137072,93387,45270,19,45251,3,3278,0,0.001038651,mm10,mBC-0716-1
"A3,G9",11765,12003,9010,2993,6481,0,2951,2954,2091,863,2.422943221,1410,6513,2313,1175,1,1174,1,262,0,0.022998296,empty,mBC-0716-1
"A3,G10",14581,14653,11159,3494,7884,0,3526,3535,2507,1028,2.438715953,1594,1182,753,396,0,396,0,141,0,0.025252525,empty,mBC-0716-1
"A3,G11",13325,13879,10122,3757,7453,0,3430,3436,2338,1098,2.129326047,1719,461,268,145,0,145,0,73,0,0,empty,mBC-0716-1
"A3,G12",12803,13597,9746,3851,7321,0,3457,3461,2451,1010,2.426732673,1734,1066,638,314,0,314,0,107,0,0.050955414,empty,mBC-0716-1
"A3,H1",23001,23566,17512,6054,12597,0,5831,5859,4182,1677,2.493738819,2750,860,515,286,0,286,0,107,0,0.003496503,empty,mBC-0716-1
"A3,H2",29251,30061,22305,7756,16162,0,7573,7594,5401,2193,2.462836297,3675,1982,1238,676,1,675,1,165,0,0.072592593,empty,mBC-0716-1
"A3,H3",22501,23118,17008,6110,12289,0,5716,5726,4029,1697,2.374189747,2744,10458,3553,1701,4,1697,2,303,0,0.084266352,empty,mBC-0716-1
"A3,H4",749711,820101,532949,287152,435785,1,242631,243001,207560,35441,5.856493891,132524,5434,3707,1715,1,1714,1,341,0,0.001166861,mm10,mBC-0716-1
"A3,H5",20088,20749,15174,5575,11128,0,5138,5150,3609,1541,2.341985724,2541,2119,1101,565,0,565,0,182,0,0.069026549,empty,mBC-0716-1
"A3,H6",598156,620129,428859,191270,335172,0,177551,177801,139873,37928,3.687855938,92298,10346,7426,3630,2,3628,1,702,0,0.00137817,mm10,mBC-0716-1
"A3,H7",19588,19986,14995,4991,11049,0,5099,5108,3609,1499,2.40760507,2405,1539,983,542,0,542,0,190,0,0.020295203,empty,mBC-0716-1
"A3,H8",440814,458382,327651,130731,249354,0,122668,122885,92360,30525,3.025716626,62170,16421,11482,5672,0,5672,0,906,0,0.003878702,mm10,mBC-0716-1
"A3,H9",681639,728059,476229,251830,394254,0,227344,227670,182922,44748,4.087825154,123149,6582,4625,2229,1,2228,1,478,0,0.00448833,mm10,mBC-0716-1
"A3,H10",831840,922028,552545,369483,485034,0,299663,300076,253282,46794,5.412702483,170188,95286,64878,30797,11,30786,1,2633,0,0.001331774,mm10,mBC-0716-1
"A3,H11",19552,20562,14730,5832,11023,0,5199,5202,3675,1527,2.406679764,2639,197,127,77,0,77,0,42,0,0.012987013,empty,mBC-0716-1
"A3,H12",6989,7179,5286,1893,3881,0,1757,1762,1257,505,2.489108911,842,715,391,205,0,205,0,79,0,0.009756098,empty,mBC-0716-1
"A4,A1",14338,14841,10956,3885,8048,0,3848,3854,2671,1183,2.257819104,1841,5279,2132,1035,1,1034,1,227,0,0.023210832,empty,mBC-0716-1
"A4,A2",19989,20206,15333,4873,10475,0,4554,4566,3222,1344,2.397321429,2115,21248,6566,3330,1,3329,1,504,0,0.046260138,empty,mBC-0716-1
"A4,A3",602124,618766,447120,171646,330498,1,161814,162085,122414,39671,3.08573013,79990,30572,18329,8780,2,8778,1,1177,0,0.011392117,mm10,mBC-0716-1
"A4,A4",21945,22258,16887,5371,11643,0,5094,5111,3611,1500,2.407333333,2397,586,349,184,0,184,0,55,0,0,empty,mBC-0716-1
"A4,A5",17052,17578,13091,4487,9216,0,4142,4153,2848,1305,2.182375479,1990,1470,814,406,0,406,0,136,0,0.04679803,empty,mBC-0716-1
"A4,A6",13209,13871,10064,3807,7311,0,3377,3383,2378,1005,2.366169154,1668,1679,1086,522,0,522,0,148,0,0.124521073,empty,mBC-0716-1
"A4,A7",753494,840151,534107,306044,444322,3,255152,255522,206582,48940,4.221127912,141362,89207,57186,27098,8,27090,3,2306,0,0.006164636,mm10,mBC-0716-1
"A4,A8",11190,11327,8574,2753,6049,0,2739,2747,1909,838,2.278042959,1288,1395,845,455,0,455,0,154,0,0.043956044,empty,mBC-0716-1
"A4,A9",19924,20387,15469,4918,10527,0,4627,4634,3285,1349,2.435137139,2126,1531,867,413,1,412,1,125,0,0.04368932,empty,mBC-0716-1
"A4,A10",1348358,1439357,978066,461291,751669,1,403007,403628,327986,75642,4.336030248,211761,44024,30760,14099,7,14092,1,1574,0,0.001490207,mm10,mBC-0716-1
"A4,A11",652924,712182,467250,244932,377720,1,205186,205460,179645,25815,6.958938602,110239,131172,93055,43729,15,43714,1,2915,0,0.000503271,mm10,mBC-0716-1
"A4,A12",713170,776054,520556,255498,406299,0,215820,216188,181975,34213,5.318884634,114360,261543,183943,86638,25,86613,4,4442,0,0.003625322,mm10,mBC-0716-1
"A4,B1",766398,842161,547917,294244,444658,0,251584,251968,208411,43557,4.784787749,136981,90989,58931,27832,10,27822,2,2401,0,0.001617425,mm10,mBC-0716-1
"A4,B2",20832,21311,15946,5365,11122,0,4947,4963,3531,1432,2.465782123,2340,539,321,154,0,154,0,53,0,0.084415584,empty,mBC-0716-1
"A4,B3",19481,20259,14929,5330,10532,0,4674,4693,3278,1415,2.316607774,2266,1263,791,426,0,426,0,126,0,0.084507042,empty,mBC-0716-1
"A4,B4",16743,17299,12815,4484,9162,0,4106,4113,2876,1237,2.32497979,1948,1192,667,343,0,343,0,107,0,0.099125364,empty,mBC-0716-1
"A4,B5",9105,5693,4048,1645,3886,0,1822,1835,1255,580,2.163793103,984,921,502,240,0,240,0,68,0,0.016666667,empty,mBC-0716-1
"A4,B6",12104,12418,9175,3243,6631,0,3081,3087,2184,903,2.418604651,1500,1089,650,348,0,348,0,101,0,0.074712644,empty,mBC-0716-1
"A4,B7",16588,17041,12639,4402,8949,0,4068,4075,2852,1223,2.331970564,1937,969,638,339,0,339,0,100,0,0.076696165,empty,mBC-0716-1
"A4,B8",13609,14099,10544,3555,7496,0,3377,3387,2323,1064,2.183270677,1578,1329,850,416,0,416,0,132,0,0.0625,empty,mBC-0716-1
"A4,B9",15407,15559,11740,3819,8113,0,3640,3652,2511,1141,2.200701139,1708,728,339,179,0,179,0,62,0,0.005586592,empty,mBC-0716-1
"A4,B10",17100,16819,12415,4404,9165,0,4196,4225,2917,1308,2.230122324,2059,638,367,184,0,184,0,60,0,0.032608696,empty,mBC-0716-1
"A4,B11",17634,17752,13020,4732,9115,0,4243,4250,2908,1342,2.166915052,2041,1102,445,231,0,231,0,55,0,0,empty,mBC-0716-1
"A4,B12",18734,19214,14366,4848,9992,0,4483,4493,3094,1399,2.2115797,2126,1328,811,398,0,398,0,122,0,0.095477387,empty,mBC-0716-1
"A4,C1",23039,23489,17986,5503,12015,0,5188,5197,3671,1526,2.405635649,2362,661,392,192,0,192,0,86,0,0.03125,empty,mBC-0716-1
"A4,C2",691641,681022,546046,134976,362644,2,132751,133036,105652,27384,3.858165352,60993,39343,25292,12222,6,12216,1,1762,0,0.008022266,mm10,mBC-0716-1
"A4,C3",20023,20474,15317,5157,10833,0,4894,4907,3445,1462,2.356361149,2320,5214,1638,805,1,804,1,160,0,0.034825871,empty,mBC-0716-1
"A4,C4",18070,18599,13635,4964,9723,0,4296,4308,3044,1264,2.408227848,2045,1280,832,449,1,448,1,133,0,0.075892857,empty,mBC-0716-1
"A4,C5",16753,17355,12734,4621,8946,0,4060,4072,2837,1235,2.297165992,2010,1397,857,396,0,396,0,104,0,0.063131313,empty,mBC-0716-1
"A4,C6",16973,17052,12729,4323,9371,0,4323,4339,3024,1315,2.299619772,2047,1598,979,533,0,533,0,149,0,0.110694184,empty,mBC-0716-1
"A4,C7",17008,17715,13006,4709,9336,0,4323,4334,3022,1312,2.303353659,2136,465,332,170,2,168,1,61,0,0.077380952,empty,mBC-0716-1
"A4,C8",15446,16175,11792,4383,8536,0,3920,3930,2661,1269,2.096926714,1872,1600,1066,559,1,558,1,143,0,0.069892473,empty,mBC-0716-1
"A4,C9",12657,13221,9700,3521,6958,0,3189,3200,2305,895,2.575418994,1573,777,444,216,0,216,0,56,0,0.050925926,empty,mBC-0716-1
"A4,C10",1660646,1789542,1182506,607036,924534,4,521578,522407,426822,95585,4.465365905,278811,187631,129281,61060,29,61031,1,3902,0,0.001622126,mm10,mBC-0716-1
"A4,C11",12095,12620,9107,3513,6559,0,3045,3048,2098,950,2.208421053,1474,3530,1355,626,0,626,0,141,0,0.011182109,empty,mBC-0716-1
"A4,C12",571389,606260,426685,179575,320739,0,158994,159287,128173,31114,4.119463907,81771,64916,46525,22008,7,22001,2,2092,0,0.001363574,mm10,mBC-0716-1
"A4,D1",11805,12318,8835,3483,6527,0,3054,3062,2074,988,2.099190283,1500,775,460,200,0,200,0,70,0,0.08,empty,mBC-0716-1
"A4,D2",888251,947723,681171,266552,495001,1,241100,241515,153944,87571,1.757933562,121239,82165,50347,23634,13,23621,2,2241,0,0.003513822,mm10,mBC-0716-1
"A4,D3",14124,14252,10575,3677,7531,0,3496,3499,2462,1037,2.37415622,1687,1251,828,417,0,417,0,118,0,0.074340528,empty,mBC-0716-1
"A4,D4",15014,15463,11511,3952,8055,0,3675,3686,2504,1182,2.118443316,1725,2478,1141,549,1,548,1,142,0,0.072992701,empty,mBC-0716-1
"A4,D5",14272,15037,10970,4067,8005,0,3660,3672,2568,1104,2.326086957,1818,1393,936,464,0,464,0,133,0,0.043103448,empty,mBC-0716-1
"A4,D6",12869,13324,9727,3597,6857,0,3174,3183,2278,905,2.517127072,1532,2760,1417,735,0,735,0,140,0,0.221768707,empty,mBC-0716-1
"A4,D7",13347,13622,10110,3512,7191,0,3317,3320,2331,989,2.356926188,1554,2486,1182,599,1,598,1,165,0,0.048494983,empty,mBC-0716-1
"A4,D8",16149,17023,12353,4670,8984,0,4215,4224,2902,1322,2.19515885,2071,752,453,265,0,265,0,93,0,0.075471698,empty,mBC-0716-1
"A4,D9",4810,4953,3522,1431,2735,0,1271,1275,906,369,2.455284553,651,1501,918,443,0,443,0,122,0,0.079006772,empty,mBC-0716-1
"A4,D10",14607,15195,11079,4116,8098,0,3868,3875,2715,1160,2.340517241,1852,843,564,276,0,276,0,91,0,0.065217391,empty,mBC-0716-1
"A4,D11",878734,1028746,576804,451942,540770,0,356768,357267,259110,98157,2.639750604,213588,141453,82798,38654,24,38630,3,3024,0,0.009603935,mm10,mBC-0716-1
"A4,D12",20982,21504,16166,5338,11149,0,4995,5005,3506,1499,2.338892595,2280,2685,1568,801,0,801,0,227,0,0.056179775,empty,mBC-0716-1
"A4,E1",1029395,1095244,742524,352720,572583,0,314924,315391,230004,85387,2.693665312,166076,41259,29533,13978,5,13973,1,1563,0,0.003793029,mm10,mBC-0716-1
"A4,E2",16267,16589,12447,4142,8747,0,3959,3969,2760,1209,2.282878412,1861,1954,1160,503,0,503,0,138,0,0.057654076,empty,mBC-0716-1
"A4,E3",12672,12972,9904,3068,6878,1,2988,3000,2103,897,2.344481605,1372,1568,1003,536,1,535,1,170,0,0.026168224,empty,mBC-0716-1
"A4,E4",15351,15717,11719,3998,8151,0,3693,3696,2557,1139,2.244951712,1768,1333,816,411,1,410,1,129,0,0.031707317,empty,mBC-0716-1
"A4,E5",21378,21667,16653,5014,11359,0,4981,4989,3459,1530,2.260784314,2227,1420,925,481,1,480,1,151,0,0.029166667,empty,mBC-0716-1
"A4,E6",13519,13713,10224,3489,7171,0,3215,3220,2223,997,2.229689067,1535,1678,1135,572,0,572,0,159,0,0.090909091,empty,mBC-0716-1
"A4,E7",13998,14197,10643,3554,7517,0,3368,3377,2318,1059,2.188857413,1613,6236,2207,1131,0,1131,0,239,0,0.028293546,empty,mBC-0716-1
"A4,E8",944581,1043344,659218,384126,546027,1,314217,314660,265590,49070,5.412471979,173217,195561,136099,63685,19,63666,1,3828,0,0.002795841,mm10,mBC-0716-1
"A4,E9",9526,9725,7142,2583,5144,0,2428,2440,1691,749,2.257676903,1199,1122,683,342,0,342,0,117,0,0.081871345,empty,mBC-0716-1
"A4,E10",13197,13849,10054,3795,7263,0,3336,3346,2286,1060,2.156603774,1688,2116,1087,560,0,560,0,127,0,0.169642857,empty,mBC-0716-1
"A4,E11",9446,9828,7200,2628,5181,0,2381,2387,1625,762,2.132545932,1154,1282,713,362,0,362,0,106,0,0.008287293,empty,mBC-0716-1
"A4,E12",15552,15931,11680,4251,8509,0,3962,3968,2707,1261,2.146708961,1960,1232,801,400,0,400,0,114,0,0.0975,empty,mBC-0716-1
"A4,F1",18407,19112,14275,4837,9896,0,4442,4451,3043,1408,2.161221591,2155,1134,727,356,0,356,0,124,0,0.056179775,empty,mBC-0716-1
"A4,F2",22774,23733,17447,6286,12469,0,5698,5711,3930,1781,2.206625491,2771,3204,2063,1119,0,1119,0,262,0,0.067024129,empty,mBC-0716-1
"A4,F3",16312,16926,12390,4536,8986,0,4241,4251,3001,1250,2.4008,2040,1641,983,500,0,500,0,160,0,0.028,empty,mBC-0716-1
"A4,F4",17100,17625,12985,4640,9430,0,4263,4278,2992,1286,2.32659409,2086,581,333,188,0,188,0,84,0,0.026595745,empty,mBC-0716-1
"A4,F5",620341,624801,467224,157577,330885,1,148847,149136,108905,40231,2.706992121,73585,26709,18234,8714,2,8712,1,1175,0,0.002640037,mm10,mBC-0716-1
"A4,F6",24689,25810,18783,7027,13358,0,6132,6138,4388,1750,2.507428571,2983,2434,1520,754,1,753,1,206,0,0.023904382,empty,mBC-0716-1
"A4,F7",20697,21179,15997,5182,11345,0,5117,5132,3522,1610,2.18757764,2399,1120,687,352,1,351,1,108,0,0.094017094,empty,mBC-0716-1
"A4,F8",23277,23875,17795,6080,12488,0,5669,5686,4030,1656,2.433574879,2717,225,155,94,0,94,0,45,0,0,empty,mBC-0716-1
"A4,F9",1634238,1779820,1171934,607886,926062,2,527971,528741,382395,146346,2.612951499,284935,170434,122631,58195,24,58171,3,3731,0,0.001770642,mm10,mBC-0716-1
"A4,F10",20484,20707,15852,4855,10920,1,4633,4645,3285,1360,2.415441176,2089,1333,842,408,0,408,0,126,0,0.056372549,empty,mBC-0716-1
"A4,F11",11572,11868,8798,3070,6398,0,2810,2820,1913,907,2.109151047,1391,2304,987,511,0,511,0,127,0,0.080234834,empty,mBC-0716-1
"A4,F12",14585,14980,11046,3934,7705,0,3545,3549,2517,1032,2.438953488,1665,134,94,39,0,39,0,15,0,0,empty,mBC-0716-1
"A4,G1",10330,10600,7953,2647,5611,0,2469,2475,1693,782,2.164961637,1120,1754,1223,615,0,615,0,151,0,0.047154472,empty,mBC-0716-1
"A4,G2",20977,21641,16248,5393,11233,0,4915,4933,3461,1472,2.351222826,2311,546,286,151,0,151,0,49,0,0.026490066,empty,mBC-0716-1
"A4,G3",21067,21540,16001,5539,11207,0,5064,5081,3572,1509,2.36713055,2381,2645,1467,774,0,774,0,203,0,0.102067183,empty,mBC-0716-1
"A4,G4",1157388,1253476,822846,430630,648079,2,364144,364700,293491,71209,4.121543625,196680,585,381,190,0,190,0,66,0,0,empty,mBC-0716-1
"A4,G5",524555,564638,383024,181614,303207,1,161808,162079,123718,38361,3.225098407,85422,65507,36934,17750,11,17739,3,1881,0,0.006201026,mm10,mBC-0716-1
"A4,G6",923005,973623,694155,279468,507113,0,248765,249229,193022,56207,3.434127422,125231,7006,5076,2418,0,2418,0,398,0,0,mm10,mBC-0716-1
"A4,G7",20480,20935,15647,5288,10978,0,4839,4847,3375,1472,2.292798913,2301,1848,1179,570,0,570,0,148,0,0.101754386,empty,mBC-0716-1
"A4,G8",14481,14999,11158,3841,8019,1,3687,3694,2609,1085,2.404608295,1761,1883,1218,568,1,567,1,148,0,0.028218695,empty,mBC-0716-1
"A4,G9",10969,11403,8386,3017,6093,0,2819,2823,1973,850,2.321176471,1362,1344,798,423,0,423,0,130,0,0.04964539,empty,mBC-0716-1
"A4,G10",14033,14306,10725,3581,7487,0,3405,3411,2395,1016,2.357283465,1549,1570,929,442,0,442,0,117,0,0.056561086,empty,mBC-0716-1
"A4,G11",12480,12784,9605,3179,6807,0,3127,3133,2201,932,2.361587983,1444,4818,1911,940,0,940,0,206,0,0.040425532,empty,mBC-0716-1
"A4,G12",11960,12219,9148,3071,6377,1,2892,2906,1974,932,2.118025751,1375,1256,785,352,0,352,0,105,0,0.0625,empty,mBC-0716-1
"A4,H1",636025,667901,466786,201115,355735,1,181591,181836,145493,36343,4.003329389,93814,17390,11132,5150,0,5150,0,798,0,0.01223301,mm10,mBC-0716-1
"A4,H2",25367,25588,19128,6460,13268,0,6068,6081,4260,1821,2.33937397,2880,23117,7826,4002,1,4001,1,647,0,0.129467633,empty,mBC-0716-1
"A4,H3",20966,21709,15862,5847,11262,0,5167,5178,3574,1604,2.228179551,2579,1661,1020,470,0,470,0,147,0,0.031914894,empty,mBC-0716-1
"A4,H4",13740,13842,10587,3255,7233,0,3133,3141,2221,920,2.414130435,1419,115,55,32,0,32,0,20,0,0,empty,mBC-0716-1
"A4,H5",18272,19011,13898,5113,9971,0,4627,4634,3278,1356,2.41740413,2232,6254,2203,1104,1,1103,1,259,0,0.02175884,empty,mBC-0716-1
"A4,H6",14230,14662,10743,3919,7776,0,3538,3543,2525,1018,2.480353635,1740,2017,1313,649,0,649,0,170,0,0.026194145,empty,mBC-0716-1
"A4,H7",17553,18040,13410,4630,9594,0,4350,4361,3009,1352,2.225591716,2049,1507,950,499,0,499,0,184,0,0.022044088,empty,mBC-0716-1
"A4,H8",13994,14062,10519,3543,7502,0,3460,3474,2478,996,2.487951807,1599,13789,4744,2386,4,2382,2,430,0,0.042401343,empty,mBC-0716-1
"A4,H9",16966,17781,12545,5236,9225,0,4389,4393,3086,1307,2.361132364,2174,1211,773,386,0,386,0,127,0,0.093264249,empty,mBC-0716-1
"A4,H10",15272,15698,11652,4046,8262,0,3761,3768,2665,1103,2.416137806,1807,3177,1327,656,0,656,0,172,0,0.053353659,empty,mBC-0716-1
"A4,H11",248121,306791,162768,144023,161900,0,111275,111441,44612,66829,0.667554505,69367,727,411,171,0,171,0,74,0,0.105263158,empty,mBC-0716-1
"A4,H12",6317,6477,4876,1601,3488,0,1584,1588,1120,468,2.393162393,729,984,691,301,0,301,0,80,0,0.086378738,empty,mBC-0716-1
"A5,A1",12484,13104,9362,3742,7105,0,3442,3444,2418,1026,2.356725146,1707,933,612,269,0,269,0,83,0,0.026022305,empty,mBC-0716-1
"A5,A2",639962,677426,460352,217074,360893,0,190776,191103,162827,28276,5.758487763,99902,77537,53440,25870,9,25861,1,2344,0,0.001662735,mm10,mBC-0716-1
"A5,A3",13733,13978,10493,3485,7566,0,3563,3565,2531,1034,2.447775629,1687,812,504,249,0,249,0,76,0,0.040160643,empty,mBC-0716-1
"A5,A4",1192106,1230105,890210,339895,645995,1,318288,318902,242677,76225,3.183693014,158584,49984,30887,14749,6,14743,2,1796,0,0.003255782,mm10,mBC-0716-1
"A5,A5",13655,13941,10411,3530,7534,0,3406,3410,2348,1062,2.210922787,1625,1134,653,293,0,293,0,83,0,0.058020478,empty,mBC-0716-1
"A5,A6",837615,916208,598821,317387,492837,0,274290,274662,194059,80603,2.407590288,151895,46358,31956,15272,3,15269,1,1965,0,0.004126007,mm10,mBC-0716-1
"A5,A7",13269,13923,10108,3815,7450,0,3427,3432,2341,1091,2.145737855,1682,1044,644,325,0,325,0,89,0,0.089230769,empty,mBC-0716-1
"A5,A8",9307,9413,7111,2302,5179,0,2369,2380,1668,712,2.342696629,1166,926,616,318,0,318,0,100,0,0.01572327,empty,mBC-0716-1
"A5,A9",14758,15050,11514,3536,8022,0,3487,3494,2460,1034,2.379110251,1610,1866,845,393,0,393,0,99,0,0.1043257,empty,mBC-0716-1
"A5,A10",470875,520110,332405,187705,282482,0,160050,160303,133910,26393,5.073693782,88411,9860,6268,2985,0,2985,0,516,0,0.002680067,mm10,mBC-0716-1
"A5,A11",14700,15039,11281,3758,8166,0,3541,3551,2531,1020,2.481372549,1677,3232,1262,666,0,666,0,132,0,0.082582583,empty,mBC-0716-1
"A5,A12",17071,17473,13005,4468,9104,0,4022,4041,2841,1200,2.3675,1916,3581,1828,960,1,959,1,183,0,0.257559958,empty,mBC-0716-1
"A5,B1",15195,15966,11559,4407,8368,0,3852,3857,2659,1198,2.219532554,1894,865,549,300,0,300,0,77,0,0.1,empty,mBC-0716-1
"A5,B2",15746,16104,12200,3904,8571,0,3699,3704,2534,1170,2.165811966,1721,378,215,90,0,90,0,40,0,0.011111111,empty,mBC-0716-1
"A5,B3",15344,15864,11819,4045,8411,0,3832,3838,2672,1166,2.291595197,1764,723,488,265,0,265,0,87,0,0.052830189,empty,mBC-0716-1
"A5,B4",13371,13660,10188,3472,7418,0,3327,3332,2370,962,2.463617464,1637,958,604,306,0,306,0,83,0,0.003267974,empty,mBC-0716-1
"A5,B5",7586,4744,3306,1438,3280,0,1607,1615,1116,499,2.236472946,875,504,299,137,0,137,0,52,0,0.065693431,empty,mBC-0716-1
"A5,B6",9964,10590,7454,3136,5617,0,2679,2692,1836,856,2.144859813,1389,1587,727,357,0,357,0,93,0,0.151260504,empty,mBC-0716-1
"A5,B7",12828,13099,9967,3132,7037,0,3061,3066,2111,955,2.210471204,1443,815,522,276,0,276,0,69,0,0.010869565,empty,mBC-0716-1
"A5,B8",11288,11682,8503,3179,6207,0,2935,2941,2076,865,2.4,1409,9081,2685,1359,3,1356,2,260,0,0.06120944,empty,mBC-0716-1
"A5,B9",11936,12303,9113,3190,6476,0,2925,2932,1976,956,2.066945607,1422,618,342,169,2,167,2,55,0,0.179640719,empty,mBC-0716-1
"A5,B10",13382,13334,9604,3730,7484,0,3575,3593,2527,1066,2.37054409,1769,408,240,124,0,124,0,43,0,0,empty,mBC-0716-1
"A5,B11",1224767,1353259,855793,497466,713406,1,420095,420696,318442,102254,3.11422536,233276,9267,6423,3026,3,3023,1,526,0,0,mm10,mBC-0716-1
"A5,B12",14502,15013,11076,3937,8029,0,3660,3669,2547,1122,2.270053476,1775,1050,556,264,0,264,0,87,0,0.022727273,empty,mBC-0716-1
"A5,C1",17760,17793,13784,4009,9356,0,3954,3967,2746,1221,2.248976249,1840,935,436,208,0,208,0,69,0,0.038461538,empty,mBC-0716-1
"A5,C2",533844,562430,392530,169900,302625,0,154299,154538,123646,30892,4.002524926,79214,51353,33814,16287,8,16279,1,1730,0,0.001842865,mm10,mBC-0716-1
"A5,C3",16169,16285,12296,3989,8792,0,3983,3989,2743,1246,2.201444623,1860,840,361,170,0,170,0,50,0,0.035294118,empty,mBC-0716-1
"A5,C4",14718,15066,11369,3697,7966,0,3534,3536,2513,1023,2.456500489,1605,929,491,238,1,237,1,87,0,0.008438819,empty,mBC-0716-1
"A5,C5",1249296,1334199,889189,445010,709771,1,397436,397988,302413,95575,3.164143343,214002,43140,28318,13657,1,13656,1,1687,0,0.005711775,mm10,mBC-0716-1
"A5,C6",14485,14828,10926,3902,8266,0,3898,3902,2760,1142,2.416812609,1933,890,566,277,1,276,1,93,0,0.032608696,empty,mBC-0716-1
"A5,C7",13068,13333,9898,3435,7203,0,3372,3377,2329,1048,2.222328244,1601,384,281,143,0,143,0,39,0,0,empty,mBC-0716-1
"A5,C8",12345,12993,9340,3653,7061,0,3319,3324,2338,986,2.371196755,1669,1251,738,370,0,370,0,105,0,0.12972973,empty,mBC-0716-1
"A5,C9",10141,10694,7646,3048,5669,0,2667,2668,1825,843,2.164887307,1348,627,332,170,0,170,0,57,0,0.011764706,empty,mBC-0716-1
"A5,C10",10887,11090,8108,2982,6149,0,2837,2846,1997,849,2.352179034,1401,706,452,212,0,212,0,60,0,0.103773585,empty,mBC-0716-1
"A5,C11",9742,10047,7205,2842,5379,0,2521,2525,1749,776,2.253865979,1246,711,404,185,0,185,0,61,0,0.016216216,empty,mBC-0716-1
"A5,C12",16051,16676,12202,4474,8888,0,4065,4077,2832,1245,2.274698795,1976,1045,687,345,1,344,1,92,0,0.122093023,empty,mBC-0716-1
"A5,D1",10073,10603,7477,3126,5790,0,2828,2832,2019,813,2.483394834,1414,1457,418,185,0,185,0,42,0,0,empty,mBC-0716-1
"A5,D2",540458,572574,410849,161725,309404,1,150696,150920,112521,38399,2.930310685,75895,63302,43051,20919,8,20911,1,2084,0,0.002630195,mm10,mBC-0716-1
"A5,D3",11520,12067,8634,3433,6576,0,3127,3133,2156,977,2.206755374,1595,979,550,279,0,279,0,83,0,0.064516129,empty,mBC-0716-1
"A5,D4",550823,585510,404294,181216,317778,1,165858,166099,133892,32207,4.1572329,85873,52698,38488,18040,3,18037,2,1869,0,0.001441481,mm10,mBC-0716-1
"A5,D5",11789,12025,9036,2989,6571,0,3004,3008,2111,897,2.353400223,1413,810,533,282,0,282,0,86,0,0.117021277,empty,mBC-0716-1
"A5,D6",10134,10326,7697,2629,5649,0,2598,2609,1764,845,2.087573964,1242,800,520,249,0,249,0,76,0,0.13253012,empty,mBC-0716-1
"A5,D7",11294,11632,8513,3119,6289,0,2924,2925,2058,867,2.373702422,1424,1102,700,342,0,342,0,100,0,0.01754386,empty,mBC-0716-1
"A5,D8",573790,616194,425958,190236,332225,0,170374,170655,119772,50883,2.353870644,89285,26665,19211,9169,6,9163,1,1177,0,0.005347594,mm10,mBC-0716-1
"A5,D9",4818,5060,3489,1571,2811,0,1458,1460,1051,409,2.569682152,773,956,535,273,0,273,0,93,0,0.007326007,empty,mBC-0716-1
"A5,D10",12086,12504,9233,3271,6731,0,3174,3186,2206,980,2.251020408,1518,464,279,132,0,132,0,48,0,0.053030303,empty,mBC-0716-1
"A5,D11",10799,11009,8225,2784,6059,0,2787,2791,1942,849,2.287396938,1325,1280,884,414,0,414,0,102,0,0.060386473,empty,mBC-0716-1
"A5,D12",15868,16131,12000,4131,8583,1,3893,3903,2692,1211,2.222956235,1879,1829,1071,598,0,598,0,159,0,0.036789298,empty,mBC-0716-1
"A5,E1",18057,18315,13688,4627,9762,1,4238,4247,3027,1220,2.481147541,2032,3140,1124,572,0,572,0,146,0,0.054195804,empty,mBC-0716-1
"A5,E2",566973,641900,393161,248739,345803,0,206183,206477,153295,53182,2.882460231,117964,75444,50998,24916,5,24911,1,2148,0,0.001565573,mm10,mBC-0716-1
"A5,E3",9988,10333,7733,2600,5593,0,2476,2480,1683,797,2.111668758,1181,1834,979,519,0,519,0,130,0,0.1522158,empty,mBC-0716-1
"A5,E4",12397,12665,9391,3274,6695,0,3062,3066,2165,901,2.402885683,1402,2926,1090,577,0,577,0,133,0,0.012131716,empty,mBC-0716-1
"A5,E5",16829,17091,12868,4223,9049,0,4023,4031,2885,1146,2.517452007,1868,3257,1311,594,0,594,0,135,0,0.153198653,empty,mBC-0716-1
"A5,E6",11370,12155,8654,3501,6362,0,2970,2971,1969,1002,1.96506986,1551,1203,787,376,0,376,0,87,0,0.069148936,empty,mBC-0716-1
"A5,E7",12393,13012,9338,3674,7047,0,3366,3374,2308,1066,2.165103189,1705,2344,984,513,1,512,1,115,0,0.068359375,empty,mBC-0716-1
"A5,E8",14068,14402,10862,3540,7706,0,3405,3412,2368,1044,2.268199234,1555,1415,948,469,0,469,0,137,0,0.025586354,empty,mBC-0716-1
"A5,E9",7683,7949,5800,2149,4299,0,2038,2043,1418,625,2.2688,996,771,464,213,0,213,0,74,0,0.009389671,empty,mBC-0716-1
"A5,E10",11123,11501,8297,3204,6102,0,2858,2860,1979,881,2.24631101,1414,21754,6395,3239,4,3235,2,524,0,0.119319938,empty,mBC-0716-1
"A5,E11",7758,7717,5889,1828,4263,0,1919,1921,1349,572,2.358391608,879,611,416,210,0,210,0,71,0,0,empty,mBC-0716-1
"A5,E12",12416,12806,9185,3621,6966,0,3325,3330,2345,985,2.38071066,1634,3352,1424,708,1,707,1,157,0,0.079207921,empty,mBC-0716-1
"A5,F1",13994,14345,10601,3744,7744,0,3491,3499,2427,1072,2.263992537,1703,1198,680,307,0,307,0,97,0,0.061889251,empty,mBC-0716-1
"A5,F2",18384,19318,13756,5562,10284,0,4943,4949,3460,1489,2.323707186,2529,1920,1240,585,1,584,1,148,0,0.089041096,empty,mBC-0716-1
"A5,F3",14018,14992,10516,4476,8028,0,3933,3944,2759,1185,2.328270042,2003,4814,1870,954,2,952,2,226,0,0.071428571,empty,mBC-0716-1
"A5,F4",15108,15255,11132,4123,8334,0,3829,3839,2698,1141,2.364592463,1861,373,218,129,0,129,0,63,0,0,empty,mBC-0716-1
"A5,F5",19962,20937,15389,5548,11079,0,4982,4987,3468,1519,2.283080974,2449,1372,892,425,0,425,0,122,0,0.065882353,empty,mBC-0716-1
"A5,F6",20053,20535,15031,5504,11013,0,5142,5148,3725,1423,2.617709065,2507,1834,1079,534,1,533,1,142,0,0.069418386,empty,mBC-0716-1
"A5,F7",416113,421284,327014,94270,232992,1,97395,97606,71957,25649,2.805450505,45497,5338,3574,1832,0,1832,0,353,0,0.008187773,mm10,mBC-0716-1
"A5,F8",19472,20309,14854,5455,10945,0,5098,5111,3515,1596,2.202380952,2492,186,122,67,0,67,0,30,0,0,empty,mBC-0716-1
"A5,F9",12666,13021,9588,3433,7105,0,3256,3266,2306,960,2.402083333,1572,1315,766,368,0,368,0,113,0,0.081521739,empty,mBC-0716-1
"A5,F10",16506,16819,12622,4197,8929,0,3895,3904,2783,1121,2.482604817,1822,1076,691,346,0,346,0,90,0,0.028901734,empty,mBC-0716-1
"A5,F11",619955,647354,463677,183677,344167,1,166853,167166,139107,28059,4.957660644,83033,92461,64315,30845,14,30831,2,2546,0,0.002270442,mm10,mBC-0716-1
"A5,F12",11524,12199,8827,3372,6393,0,2975,2982,1991,991,2.009081736,1456,320,151,76,0,76,0,22,0,0,empty,mBC-0716-1
"A5,G1",7994,8116,6119,1997,4402,0,1939,1945,1386,559,2.479427549,904,1177,791,381,0,381,0,101,0,0.023622047,empty,mBC-0716-1
"A5,G2",16737,16885,12926,3959,8948,0,3928,3942,2713,1229,2.207485761,1811,425,289,153,0,153,0,44,0,0.137254902,empty,mBC-0716-1
"A5,G3",16470,16910,12430,4480,8986,0,4097,4107,2936,1171,2.507258753,1954,9321,3020,1496,3,1493,1,307,0,0.062960482,empty,mBC-0716-1
"A5,G4",22963,23194,17721,5473,12309,0,5376,5386,3880,1506,2.576361222,2408,74,50,35,0,35,0,19,0,0,empty,mBC-0716-1
"A5,G5",10576,11001,8060,2941,5984,0,2726,2730,1962,768,2.5546875,1310,624,433,213,0,213,0,74,0,0.051643192,empty,mBC-0716-1
"A5,G6",19985,20375,15464,4911,10994,0,4857,4866,3409,1457,2.33973919,2226,423,173,91,0,91,0,33,0,0.021978022,empty,mBC-0716-1
"A5,G7",775792,817665,579934,237731,434111,0,215693,216000,182581,33419,5.46338909,108244,118351,79988,38133,17,38116,3,2820,0,0.000472243,mm10,mBC-0716-1
"A5,G8",12284,12848,9381,3467,6740,0,3096,3102,2153,949,2.268703899,1545,1863,879,416,0,416,0,129,0,0.098557692,empty,mBC-0716-1
"A5,G9",8790,9206,6545,2661,4940,0,2380,2387,1611,776,2.076030928,1215,1074,668,344,0,344,0,89,0,0.029069767,empty,mBC-0716-1
"A5,G10",11350,11710,8627,3083,6237,0,2851,2861,2006,855,2.34619883,1370,1050,627,302,0,302,0,79,0,0.049668874,empty,mBC-0716-1
"A5,G11",10273,10250,7935,2315,5546,0,2490,2495,1782,713,2.499298738,1074,636,457,232,0,232,0,69,0,0,empty,mBC-0716-1
"A5,G12",9520,9733,7342,2391,5321,0,2372,2378,1670,708,2.358757062,1138,787,502,268,1,267,1,85,0,0.059925094,empty,mBC-0716-1
"A5,H1",626343,664501,454441,210060,356577,0,191892,192214,140424,51790,2.711411469,100952,12249,6108,2932,1,2931,1,525,0,0.008188332,mm10,mBC-0716-1
"A5,H2",19126,19834,14694,5140,10301,0,4673,4676,3257,1419,2.295278365,2193,1919,888,495,0,495,0,140,0,0.032323232,empty,mBC-0716-1
"A5,H3",16896,17351,12704,4647,9333,0,4365,4378,3062,1316,2.32674772,2188,6545,2322,1158,2,1156,1,239,0,0.077854671,empty,mBC-0716-1
"A5,H4",11564,11683,8618,3065,6448,0,3011,3016,2120,896,2.366071429,1438,30,15,11,0,11,0,8,0,0,empty,mBC-0716-1
"A5,H5",15289,15840,11495,4345,8625,0,4063,4078,2886,1192,2.42114094,2002,779,460,243,0,243,0,103,0,0.008230453,empty,mBC-0716-1
"A5,H6",12618,13101,9371,3730,7153,0,3412,3421,2403,1018,2.360510806,1714,6670,2789,1350,1,1349,1,274,0,0.116382506,empty,mBC-0716-1
"A5,H7",14396,15180,10841,4339,8130,0,3811,3822,2695,1127,2.391304348,1848,7423,2630,1387,1,1386,1,272,0,0.036796537,empty,mBC-0716-1
"A5,H8",11624,11869,8731,3138,6252,0,2863,2865,2046,819,2.498168498,1356,1123,763,385,0,385,0,113,0,0.025974026,empty,mBC-0716-1
"A5,H9",13426,13840,10222,3618,7376,0,3338,3344,2429,915,2.654644809,1581,943,586,293,0,293,0,90,0,0.105802048,empty,mBC-0716-1
"A5,H10",1244618,1315394,882239,433155,701015,0,388876,389399,278377,111022,2.507403938,207182,54591,38128,18275,6,18269,1,2132,0,0.002517927,mm10,mBC-0716-1
"A5,H11",14639,15169,10970,4199,8112,0,3867,3874,2695,1179,2.285835454,1935,589,191,75,0,75,0,25,0,0.066666667,empty,mBC-0716-1
"A5,H12",5077,5283,3781,1502,2881,0,1347,1351,961,390,2.464102564,705,571,368,183,0,183,0,58,0,0.043715847,empty,mBC-0716-1
"A6,A1",589286,649869,413309,236560,346084,2,198395,198649,152930,45719,3.344998797,109738,34031,23384,11191,4,11187,2,1452,0,0.001787789,mm10,mBC-0716-1
"A6,A2",14360,14366,11090,3276,7546,0,3303,3305,2332,973,2.396711202,1465,982,614,289,0,289,0,92,0,0.038062284,empty,mBC-0716-1
"A6,A3",12261,12607,9352,3255,6585,0,2985,2997,2112,885,2.386440678,1415,474,266,167,0,167,0,64,0,0,empty,mBC-0716-1
"A6,A4",814152,875330,597753,277577,448776,0,231993,232357,199667,32690,6.107892322,120204,33802,23678,11217,3,11214,1,1315,0,0.001070091,mm10,mBC-0716-1
"A6,A5",12637,13061,9665,3396,6916,0,3222,3228,2246,982,2.287169043,1572,1208,709,384,0,384,0,97,0,0.065104167,empty,mBC-0716-1
"A6,A6",9726,10243,7461,2782,5385,0,2544,2550,1712,838,2.042959427,1241,966,610,319,0,319,0,123,0,0.043887147,empty,mBC-0716-1
"A6,A7",12425,12764,9589,3175,6702,0,2993,3001,2094,907,2.308710033,1389,2043,788,437,0,437,0,121,0,0.034324943,empty,mBC-0716-1
"A6,A8",8540,8722,6620,2102,4616,0,2047,2050,1479,571,2.590192644,908,1322,776,398,0,398,0,137,0,0.01758794,empty,mBC-0716-1
"A6,A9",14882,15304,11430,3874,8020,0,3594,3603,2505,1098,2.281420765,1713,756,471,229,0,229,0,90,0,0.030567686,empty,mBC-0716-1
"A6,A10",1278234,1367562,941692,425870,703678,2,370286,370893,294368,76525,3.846690624,192507,23723,16461,7624,4,7620,1,1038,0,0.000787402,mm10,mBC-0716-1
"A6,A11",13466,13551,10237,3314,7290,0,3270,3274,2339,935,2.501604278,1539,2296,835,418,2,416,1,123,0,0.024038462,empty,mBC-0716-1
"A6,A12",15732,16024,12147,3877,8205,0,3618,3622,2547,1075,2.369302326,1651,1177,750,375,0,375,0,111,0,0.066666667,empty,mBC-0716-1
"A6,B1",14247,14575,11014,3561,7533,0,3343,3352,2374,978,2.427402863,1540,738,474,255,0,255,0,88,0,0.050980392,empty,mBC-0716-1
"A6,B2",14896,14922,11299,3623,7992,0,3551,3557,2450,1107,2.213188799,1653,5862,1779,912,1,911,1,185,0,0.029637761,empty,mBC-0716-1
"A6,B3",566904,599855,413055,186800,318082,1,168591,168915,120518,48397,2.490195673,87890,12864,8897,4299,0,4299,0,688,0,0.00628053,mm10,mBC-0716-1
"A6,B4",12509,13035,9506,3529,6869,0,3078,3082,2167,915,2.368306011,1562,892,548,272,0,272,0,87,0,0.047794118,empty,mBC-0716-1
"A6,B5",393159,231323,155537,75786,160454,5,81071,81617,67090,14527,4.618296964,45581,61532,35094,16732,15,16717,4,1740,0,0.00915236,mm10,mBC-0716-1
"A6,B6",8753,9062,6626,2436,4869,0,2293,2297,1573,724,2.172651934,1087,910,588,267,0,267,0,74,0,0.007490637,empty,mBC-0716-1
"A6,B7",12200,12409,9271,3138,6535,0,2870,2878,2002,876,2.285388128,1334,566,368,184,0,184,0,59,0,0.190217391,empty,mBC-0716-1
"A6,B8",9476,9733,7147,2586,5193,0,2309,2317,1554,763,2.036697248,1111,500,300,177,0,177,0,84,0,0.056497175,empty,mBC-0716-1
"A6,B9",11222,11420,8612,2808,5957,0,2643,2648,1847,801,2.305867665,1230,420,262,129,0,129,0,58,0,0.046511628,empty,mBC-0716-1
"A6,B10",12178,11843,8882,2961,6611,0,3013,3022,2032,990,2.052525253,1498,1081,429,215,0,215,0,57,0,0,empty,mBC-0716-1
"A6,B11",580867,634219,385115,249104,326267,0,200061,200342,142651,57691,2.472673381,113030,6279,4253,2049,2,2047,1,366,0,0,mm10,mBC-0716-1
"A6,B12",591546,627164,435731,191433,330600,0,166371,166618,145046,21572,6.723808641,85718,104222,70578,33635,9,33626,2,2729,0,0.00080295,mm10,mBC-0716-1
"A6,C1",17221,17336,13270,4066,8940,0,3843,3848,2691,1157,2.325842697,1745,4864,1560,785,0,785,0,186,0,0.011464968,empty,mBC-0716-1
"A6,C2",14195,14501,10654,3847,7692,0,3588,3596,2473,1123,2.202137133,1724,1112,719,387,0,387,0,130,0,0.03875969,empty,mBC-0716-1
"A6,C3",780930,898167,532030,366137,465852,2,284971,285384,225720,59664,3.783185841,165658,35965,25443,11915,3,11912,1,1378,0,0.001259234,mm10,mBC-0716-1
"A6,C4",595760,603184,432201,170983,319683,2,162190,162445,128370,34075,3.767278063,81700,20046,10330,5039,4,5035,2,832,0,0.03714002,mm10,mBC-0716-1
"A6,C5",12163,12608,9178,3430,6698,0,3082,3087,2195,892,2.460762332,1559,933,562,286,0,286,0,94,0,0.006993007,empty,mBC-0716-1
"A6,C6",13197,13480,9872,3608,7306,0,3431,3439,2390,1049,2.278360343,1668,871,596,315,0,315,0,90,0,0.06984127,empty,mBC-0716-1
"A6,C7",445044,456495,324190,132305,244394,0,124812,124999,101544,23455,4.329311447,63426,2164,1431,680,0,680,0,158,0,0,empty,mBC-0716-1
"A6,C8",11199,11380,8532,2848,5985,0,2692,2694,1843,851,2.165687427,1272,1158,764,398,1,397,1,124,0,0.0302267,empty,mBC-0716-1
"A6,C9",9598,9779,7251,2528,5132,1,2299,2309,1618,691,2.341534009,1072,560,348,176,0,176,0,64,0,0.073863636,empty,mBC-0716-1
"A6,C10",10100,10438,7670,2768,5474,0,2487,2498,1688,810,2.083950617,1213,826,559,262,0,262,0,80,0,0.057251908,empty,mBC-0716-1
"A6,C11",8421,8827,6388,2439,4607,0,2123,2127,1469,658,2.232522796,1017,467,302,155,0,155,0,64,0,0.051612903,empty,mBC-0716-1
"A6,C12",14882,15264,11285,3979,8027,0,3592,3599,2463,1136,2.168133803,1724,5860,2115,1047,2,1045,2,199,0,0.031578947,empty,mBC-0716-1
"A6,D1",8297,8556,6201,2355,4596,0,2175,2181,1523,658,2.314589666,1054,5558,1704,818,1,817,1,154,0,0.030599755,empty,mBC-0716-1
"A6,D2",14897,14854,11451,3403,8017,0,3390,3407,2291,1116,2.052867384,1552,1539,898,449,1,448,1,146,0,0.069196429,empty,mBC-0716-1
"A6,D3",10165,10754,7640,3114,5659,0,2710,2718,1908,810,2.355555556,1366,732,491,265,0,265,0,87,0,0.022641509,empty,mBC-0716-1
"A6,D4",11444,11691,8685,3006,6256,0,2832,2842,1952,890,2.193258427,1378,828,546,281,0,281,0,97,0,0.039145907,empty,mBC-0716-1
"A6,D5",597245,651951,414801,237150,343935,1,199453,199728,164915,34813,4.73716715,109413,85179,59627,28239,12,28227,2,2425,0,0.000495979,mm10,mBC-0716-1
"A6,D6",9365,9832,6959,2873,5234,0,2480,2481,1693,788,2.148477157,1244,1805,720,367,0,367,0,105,0,0.100817439,empty,mBC-0716-1
"A6,D7",9681,10119,7266,2853,5347,2,2529,2540,1741,799,2.178973717,1261,1050,717,372,0,372,0,119,0,0.061827957,empty,mBC-0716-1
"A6,D8",11793,12137,8997,3140,6448,0,2985,2990,2115,875,2.417142857,1445,501,298,172,0,172,0,72,0,0.046511628,empty,mBC-0716-1
"A6,D9",130520,138992,90257,48735,75751,0,41450,41507,31354,10153,3.088151285,22756,51588,36935,17288,4,17284,2,1815,0,0.001388567,empty,mBC-0716-1
"A6,D10",10849,11581,8160,3421,6181,0,2945,2953,2082,871,2.390355913,1534,385,238,122,0,122,0,62,0,0.032786885,empty,mBC-0716-1
"A6,D11",9821,10449,7371,3078,5446,0,2572,2577,1765,812,2.17364532,1285,1544,936,504,0,504,0,131,0,0.273809524,empty,mBC-0716-1
"A6,D12",15054,15299,11494,3805,8001,0,3584,3589,2520,1069,2.357343312,1663,1470,856,424,0,424,0,139,0,0.016509434,empty,mBC-0716-1
"A6,E1",636967,689130,460168,228962,363844,0,197210,197512,160838,36674,4.385613786,105588,56512,34070,16553,7,16546,1,1800,0,0.01293364,mm10,mBC-0716-1
"A6,E2",933787,1051695,630842,420853,558747,3,351888,352307,272818,79489,3.432147844,201111,76982,55013,26423,14,26409,1,2373,0,0.001817562,mm10,mBC-0716-1
"A6,E3",9473,9826,7237,2589,5167,0,2322,2324,1610,714,2.254901961,1143,1067,678,360,0,360,0,122,0,0.063888889,empty,mBC-0716-1
"A6,E4",1165878,1312551,805077,507474,681712,1,412061,412585,327091,85494,3.825894215,234112,106078,74397,35783,10,35773,1,2854,0,0.000475219,mm10,mBC-0716-1
"A6,E5",1225230,1334592,884178,450414,695366,2,386386,386983,295124,91859,3.212793521,206477,95461,65332,30817,16,30801,3,2692,0,0.002142788,mm10,mBC-0716-1
"A6,E6",929076,992554,679276,313278,518173,5,270471,270920,213978,56942,3.75782375,142257,141276,91946,44426,17,44409,4,3300,0,0.00099079,mm10,mBC-0716-1
"A6,E7",9928,10293,7525,2768,5402,0,2373,2377,1654,723,2.28769018,1103,848,515,295,0,295,0,93,0,0.115254237,empty,mBC-0716-1
"A6,E8",13043,13199,10012,3187,7018,0,3108,3112,2241,871,2.572904707,1464,2314,1125,564,0,564,0,149,0,0.069148936,empty,mBC-0716-1
"A6,E9",6564,6693,4884,1809,3582,0,1663,1666,1152,514,2.241245136,814,670,480,246,0,246,0,83,0,0.085365854,empty,mBC-0716-1
"A6,E10",9826,10209,7666,2543,5349,0,2487,2491,1714,777,2.205920206,1130,666,423,226,0,226,0,93,0,0.004424779,empty,mBC-0716-1
"A6,E11",6921,7060,5352,1708,3864,0,1811,1812,1275,537,2.374301676,822,6406,1932,962,0,962,0,211,0,0.032224532,empty,mBC-0716-1
"A6,E12",11309,11764,8415,3349,6375,0,3016,3018,2108,910,2.316483516,1512,850,533,298,0,298,0,86,0,0.053691275,empty,mBC-0716-1
"A6,F1",521322,538077,405151,132926,282863,0,119840,120090,100806,19284,5.227442439,57418,89404,59006,28573,15,28558,2,2475,0,0.001225576,mm10,mBC-0716-1
"A6,F2",16577,16966,12504,4462,9113,0,4282,4289,3038,1251,2.428457234,2047,8864,3328,1658,7,1651,2,340,0,0.024833434,empty,mBC-0716-1
"A6,F3",443543,474353,330251,144102,252748,0,123010,123260,103873,19387,5.357868675,64223,120500,79940,38229,10,38219,2,3024,0,0.00062796,mm10,mBC-0716-1
"A6,F4",12696,12875,9449,3426,6925,0,3170,3176,2258,918,2.459694989,1527,422,227,137,0,137,0,71,0,0.02919708,empty,mBC-0716-1
"A6,F5",18397,18908,14004,4904,9797,0,4424,4429,3105,1324,2.345166163,2147,1077,643,310,0,310,0,109,0,0.038709677,empty,mBC-0716-1
"A6,F6",17524,18264,13443,4821,9702,0,4432,4445,3115,1330,2.342105263,2200,1415,939,521,0,521,0,148,0,0.053742802,empty,mBC-0716-1
"A6,F7",1052783,1134449,760865,373584,603409,1,326857,327370,271200,56170,4.828200107,173732,59809,40847,19554,6,19548,1,2060,0,0.002353182,mm10,mBC-0716-1
"A6,F8",16775,17081,12946,4135,9081,0,4092,4105,2928,1177,2.487680544,1912,129,79,56,0,56,0,37,0,0,empty,mBC-0716-1
"A6,F9",11386,11440,8629,2811,6066,0,2697,2706,1924,782,2.460358056,1310,1272,756,382,0,382,0,132,0,0.023560209,empty,mBC-0716-1
"A6,F10",15375,15665,12018,3647,8195,0,3572,3582,2533,1049,2.414680648,1631,827,507,275,0,275,0,84,0,0.050909091,empty,mBC-0716-1
"A6,F11",497455,537953,362072,175881,285257,0,150732,150967,122599,28368,4.321735759,79837,29365,17576,8818,3,8815,2,1216,0,0.001701645,mm10,mBC-0716-1
"A6,F12",10293,10686,7810,2876,5580,0,2580,2587,1774,813,2.18204182,1273,75,53,31,0,31,0,14,0,0,empty,mBC-0716-1
"A6,G1",7711,8002,5988,2014,4294,0,1929,1933,1329,604,2.200331126,950,3043,1311,688,0,688,0,146,0,0.082848837,empty,mBC-0716-1
"A6,G2",679482,702590,511406,191184,366157,0,168615,168878,143742,25136,5.718570974,83372,35048,23499,11287,5,11282,1,1345,0,0.002215919,mm10,mBC-0716-1
"A6,G3",14848,15275,11156,4119,7970,0,3668,3675,2556,1119,2.284182306,1771,2631,1198,666,1,665,1,169,0,0.040601504,empty,mBC-0716-1
"A6,G4",873926,927559,628499,299060,478743,3,257335,257737,213835,43902,4.870734818,134911,629,413,199,0,199,0,60,0,0,empty,mBC-0716-1
"A6,G5",590895,648563,418487,230076,340095,1,194876,195134,162302,32832,4.943408869,105837,41411,29443,14155,6,14149,2,1543,0,0.00077744,mm10,mBC-0716-1
"A6,G6",19107,19077,14209,4868,9869,0,4387,4402,3037,1365,2.224908425,2110,719,275,163,0,163,0,54,0,0.300613497,empty,mBC-0716-1
"A6,G7",531173,566074,399656,166418,300195,0,147273,147531,108532,38999,2.782943152,75055,68103,49725,23524,5,23519,1,2162,0,0.000595263,mm10,mBC-0716-1
"A6,G8",10743,10917,8085,2832,5784,0,2673,2680,1895,785,2.414012739,1298,905,626,353,0,353,0,122,0,0.031161473,empty,mBC-0716-1
"A6,G9",7958,8468,6039,2429,4511,0,2071,2077,1466,611,2.399345336,1064,1180,683,362,0,362,0,124,0,0.093922652,empty,mBC-0716-1
"A6,G10",688829,747977,491635,256342,391612,0,218863,219169,173916,45253,3.843192717,117453,66355,46152,22331,7,22324,1,2214,0,0.002822075,mm10,mBC-0716-1
"A6,G11",9376,9595,6998,2597,5190,1,2426,2433,1636,797,2.052697616,1194,3537,1186,617,0,617,0,169,0,0.030794165,empty,mBC-0716-1
"A6,G12",8362,8664,6300,2364,4640,0,2163,2174,1494,680,2.197058824,1055,5819,1909,921,2,919,1,196,0,0.064200218,empty,mBC-0716-1
"A6,H1",567066,596332,405059,191273,315678,1,171336,171549,129679,41870,3.097181753,90732,2500,1751,886,0,886,0,221,0,0.013544018,empty,mBC-0716-1
"A6,H2",17311,17505,13171,4334,9168,0,4091,4096,2873,1223,2.349141455,1927,1258,802,417,0,417,0,110,0,0.100719424,empty,mBC-0716-1
"A6,H3",659918,700288,477302,222986,366706,0,193848,194140,161255,32885,4.903603467,101338,83044,51564,24882,10,24872,2,2295,0,0.00707623,mm10,mBC-0716-1
"A6,H4",470437,504219,347787,156432,267459,0,136752,136948,101556,35392,2.869462025,71194,2144,1475,655,1,654,1,161,0,0.012232416,empty,mBC-0716-1
"A6,H5",13699,14021,10344,3677,7277,0,3399,3408,2389,1019,2.344455348,1632,1053,644,352,0,352,0,109,0,0.059659091,empty,mBC-0716-1
"A6,H6",10998,11314,8266,3048,6053,0,2795,2795,1928,867,2.223760092,1350,2193,1204,635,0,635,0,177,0,0.047244094,empty,mBC-0716-1
"A6,H7",13038,13346,9720,3626,7179,0,3384,3392,2384,1008,2.365079365,1685,1067,716,386,1,385,1,149,0,0.064935065,empty,mBC-0716-1
"A6,H8",10282,10528,7792,2736,5608,0,2625,2633,1868,765,2.441830065,1256,1130,617,322,0,322,0,107,0,0.02173913,empty,mBC-0716-1
"A6,H9",11668,12153,8864,3289,6455,0,2904,2911,2098,813,2.580565806,1436,786,442,236,0,236,0,90,0,0.008474576,empty,mBC-0716-1
"A6,H10",11485,11367,8478,2889,6031,0,2833,2835,2082,753,2.764940239,1310,14642,4535,2396,4,2392,3,399,0,0.149665552,empty,mBC-0716-1
"A6,H11",13123,13636,9871,3765,7291,0,3520,3522,2404,1118,2.150268336,1724,520,174,89,0,89,0,43,0,0.033707865,empty,mBC-0716-1
"A6,H12",4594,4742,3428,1314,2558,0,1231,1233,853,380,2.244736842,624,359,186,95,0,95,0,44,0,0.073684211,empty,mBC-0716-1
"A7,A1",9883,10307,7449,2858,5658,0,2729,2737,1911,826,2.313559322,1345,684,418,247,0,247,0,73,0,0.052631579,empty,mBC-0716-1
"A7,A2",13514,13589,10319,3270,7161,0,3173,3188,2277,911,2.499451153,1479,899,516,277,0,277,0,104,0,0.079422383,empty,mBC-0716-1
"A7,A3",11308,11562,8576,2986,6275,0,2880,2884,2001,883,2.266138165,1381,801,509,243,0,243,0,86,0,0.037037037,empty,mBC-0716-1
"A7,A4",14300,14418,11253,3165,7613,0,3297,3304,2268,1036,2.189189189,1502,1840,579,296,0,296,0,74,0,0.081081081,empty,mBC-0716-1
"A7,A5",11300,11491,8729,2762,6277,0,2820,2834,1932,902,2.141906874,1345,969,619,303,0,303,0,88,0,0.04620462,empty,mBC-0716-1
"A7,A6",460159,517157,309542,207615,276562,0,172122,172317,138563,33754,4.105083842,98325,45925,29678,14229,10,14219,3,1657,0,0.00267248,mm10,mBC-0716-1
"A7,A7",11187,11622,8551,3071,6279,0,2906,2918,2089,829,2.519903498,1397,846,483,280,0,280,0,87,0,0.021428571,empty,mBC-0716-1
"A7,A8",266694,286697,197443,89254,155943,0,77875,78024,57931,20093,2.883143383,40551,75668,53297,25435,12,25423,2,2353,0,0.001573378,mm10,mBC-0716-1
"A7,A9",861942,905915,639764,266151,475728,4,242094,242513,202696,39817,5.090689906,122532,65711,44342,21170,6,21164,3,2150,0,0.004016254,mm10,mBC-0716-1
"A7,A10",10796,11262,8291,2971,5963,0,2730,2739,1894,845,2.241420118,1324,327,164,90,0,90,0,37,0,0.044444444,empty,mBC-0716-1
"A7,A11",12164,12215,9336,2879,6632,0,2928,2934,2049,885,2.315254237,1330,2833,957,524,0,524,0,133,0,0.036259542,empty,mBC-0716-1
"A7,A12",13803,14168,10632,3536,7492,0,3380,3384,2289,1095,2.090410959,1612,1802,1167,552,0,552,0,141,0,0.086956522,empty,mBC-0716-1
"A7,B1",13083,13358,10037,3321,7080,0,3101,3112,2134,978,2.18200409,1478,754,427,210,1,209,1,76,0,0.009569378,empty,mBC-0716-1
"A7,B2",13688,13776,10619,3157,7298,0,3208,3217,2295,922,2.489154013,1460,1848,630,311,1,310,1,72,0,0.070967742,empty,mBC-0716-1
"A7,B3",14006,14437,10598,3839,7831,0,3643,3651,2539,1112,2.283273381,1767,955,627,335,0,335,0,104,0,0.134328358,empty,mBC-0716-1
"A7,B4",2421685,2659625,1722090,937535,1369737,1,802716,803861,619740,184121,3.365938703,439733,150123,102225,49321,24,49297,3,3744,0,0.00194738,mm10,mBC-0716-1
"A7,B5",6557,4027,2846,1181,2799,0,1317,1326,938,388,2.417525773,686,1694,586,303,0,303,0,86,0,0.00330033,empty,mBC-0716-1
"A7,B6",8035,8475,6067,2408,4536,0,2154,2154,1470,684,2.149122807,1067,782,506,275,0,275,0,83,0,0.058181818,empty,mBC-0716-1
"A7,B7",10719,11022,8224,2798,5921,0,2599,2609,1796,813,2.209102091,1239,729,427,191,0,191,0,62,0,0,empty,mBC-0716-1
"A7,B8",9208,9626,7076,2550,5066,0,2320,2324,1635,689,2.373004354,1135,891,577,269,0,269,0,90,0,0.026022305,empty,mBC-0716-1
"A7,B9",10382,10664,8093,2571,5557,0,2470,2476,1733,743,2.33243607,1142,361,227,112,0,112,0,47,0,0,empty,mBC-0716-1
"A7,B10",11362,11237,8373,2864,6336,0,2899,2907,1998,909,2.198019802,1383,310,140,77,0,77,0,37,0,0,empty,mBC-0716-1
"A7,B11",11111,11349,8481,2868,6065,0,2802,2804,1964,840,2.338095238,1304,123,80,46,0,46,0,18,0,0,empty,mBC-0716-1
"A7,B12",12080,12383,9323,3060,6680,0,3078,3085,2176,909,2.393839384,1409,774,524,258,0,258,0,83,0,0.100775194,empty,mBC-0716-1
"A7,C1",15603,15562,12075,3487,7991,0,3371,3382,2389,993,2.405840886,1500,595,354,189,0,189,0,58,0,0.037037037,empty,mBC-0716-1
"A7,C2",519704,565673,365162,200511,301030,1,168916,169162,140255,28907,4.851938977,92653,73772,51886,24585,7,24578,1,2329,0,0.001627472,mm10,mBC-0716-1
"A7,C3",13660,14208,10315,3893,7583,0,3549,3553,2563,990,2.588888889,1762,471,301,159,0,159,0,39,0,0.201257862,empty,mBC-0716-1
"A7,C4",11650,11878,8996,2882,6472,0,2906,2917,2044,873,2.341351661,1378,806,444,238,0,238,0,95,0,0.096638655,empty,mBC-0716-1
"A7,C5",10971,11050,8285,2765,5884,0,2671,2678,1887,791,2.385587863,1243,586,376,199,0,199,0,81,0,0.201005025,empty,mBC-0716-1
"A7,C6",12092,12421,8941,3480,6842,0,3217,3225,2288,937,2.441835646,1592,870,522,297,0,297,0,117,0,0.033670034,empty,mBC-0716-1
"A7,C7",1278276,1409822,914424,495398,744700,1,416498,417100,344023,73077,4.707678202,227688,71667,51285,24506,7,24499,1,2250,0,0.000163272,mm10,mBC-0716-1
"A7,C8",10274,10677,7700,2977,5563,0,2519,2529,1764,765,2.305882353,1261,1016,619,333,0,333,0,114,0,0.024024024,empty,mBC-0716-1
"A7,C9",8898,9215,6794,2421,4946,0,2290,2296,1654,642,2.576323988,1112,479,307,161,0,161,0,54,0,0.136645963,empty,mBC-0716-1
"A7,C10",9397,9484,7224,2260,5073,0,2218,2226,1566,660,2.372727273,1004,645,375,203,0,203,0,66,0,0.093596059,empty,mBC-0716-1
"A7,C11",7794,8330,5844,2486,4398,0,2049,2050,1410,640,2.203125,1070,550,340,179,0,179,0,60,0,0.039106145,empty,mBC-0716-1
"A7,C12",508012,574376,346960,227416,303628,2,185331,185608,148883,36725,4.053995916,106061,37461,26610,12690,2,12688,1,1479,0,0.002127995,mm10,mBC-0716-1
"A7,D1",8262,8806,6219,2587,4680,0,2274,2278,1622,656,2.472560976,1150,521,301,146,0,146,0,44,0,0.095890411,empty,mBC-0716-1
"A7,D2",1188739,1348452,808241,540211,709166,2,440946,441493,344254,97239,3.540287333,252308,183736,126487,59277,26,59251,4,3962,0,0.001434575,mm10,mBC-0716-1
"A7,D3",9277,9800,7047,2753,5361,0,2587,2590,1789,801,2.233458177,1322,725,445,219,0,219,0,82,0,0.00456621,empty,mBC-0716-1
"A7,D4",9497,9708,7180,2528,5172,0,2379,2382,1661,721,2.303744799,1164,870,605,310,0,310,0,92,0,0.061290323,empty,mBC-0716-1
"A7,D5",9943,10416,7565,2851,5494,0,2514,2519,1796,723,2.484094053,1228,843,564,287,0,287,0,97,0,0.045296167,empty,mBC-0716-1
"A7,D6",8551,8970,6405,2565,4778,0,2285,2285,1568,717,2.186889819,1136,900,563,257,0,257,0,75,0,0.007782101,empty,mBC-0716-1
"A7,D7",9054,9193,6922,2271,4964,0,2240,2240,1580,660,2.393939394,1035,1226,859,426,0,426,0,128,0,0.042253521,empty,mBC-0716-1
"A7,D8",12417,13311,9289,4022,7209,0,3516,3522,2504,1018,2.459724951,1810,641,412,227,0,227,0,85,0,0.176211454,empty,mBC-0716-1
"A7,D9",3923,4090,2913,1177,2234,0,1109,1113,796,317,2.511041009,569,935,591,274,0,274,0,96,0,0.051094891,empty,mBC-0716-1
"A7,D10",10800,11368,8031,3337,6095,0,3020,3023,2139,884,2.419683258,1523,17240,4840,2488,2,2486,1,377,0,0.100160901,empty,mBC-0716-1
"A7,D11",323690,334966,234004,100962,183288,0,95118,95263,78301,16962,4.616259875,49150,49769,18448,9033,7,9026,1,1287,0,0.079104808,mm10,mBC-0716-1
"A7,D12",808335,867996,587792,280204,462876,1,245357,245769,198401,47368,4.188502787,130327,127336,86516,40061,16,40045,1,3182,0,0.001198652,mm10,mBC-0716-1
"A7,E1",1297696,1446025,896899,549126,758328,1,458026,458653,360286,98367,3.662671424,257032,128545,87097,41357,12,41345,2,3198,0,0.003700568,mm10,mBC-0716-1
"A7,E2",11263,11727,8674,3053,6338,0,2842,2848,2005,843,2.378410439,1393,1133,758,379,0,379,0,117,0,0.015831135,empty,mBC-0716-1
"A7,E3",8344,8671,6431,2240,4600,0,2093,2097,1483,614,2.415309446,955,1057,680,325,0,325,0,101,0,0.107692308,empty,mBC-0716-1
"A7,E4",10659,11123,7975,3148,5810,0,2686,2687,1903,784,2.427295918,1320,13668,4380,2229,3,2226,2,455,0,0.046271339,empty,mBC-0716-1
"A7,E5",14419,14816,11142,3674,7789,0,3430,3440,2442,998,2.446893788,1686,1797,763,373,0,373,0,123,0,0.067024129,empty,mBC-0716-1
"A7,E6",9625,9856,7315,2541,5260,0,2415,2424,1664,760,2.189473684,1143,1090,610,338,0,338,0,90,0,0.133136095,empty,mBC-0716-1
"A7,E7",10034,10081,7621,2460,5410,0,2433,2439,1744,695,2.509352518,1164,963,526,299,0,299,0,84,0,0.050167224,empty,mBC-0716-1
"A7,E8",11682,11934,9138,2796,6384,0,2787,2793,1913,880,2.173863636,1267,1249,757,429,0,429,0,127,0,0.090909091,empty,mBC-0716-1
"A7,E9",304423,327776,216803,110973,176300,0,94121,94265,80157,14108,5.681669974,50599,126869,89327,42247,16,42231,3,3065,0,0.000734058,mm10,mBC-0716-1
"A7,E10",8799,9159,6640,2519,4875,0,2226,2234,1571,663,2.369532428,1096,909,556,281,0,281,0,97,0,0.021352313,empty,mBC-0716-1
"A7,E11",6466,6754,4839,1915,3699,0,1747,1749,1212,537,2.25698324,842,882,521,283,1,282,1,93,0,0.017730496,empty,mBC-0716-1
"A7,E12",10084,10653,7673,2980,5833,0,2682,2687,1885,802,2.350374065,1390,849,531,265,0,265,0,89,0,0.045283019,empty,mBC-0716-1
"A7,F1",11738,12042,8987,3055,6578,0,2971,2974,2100,874,2.402745995,1435,1488,879,449,8,441,1,122,0,0.10430839,empty,mBC-0716-1
"A7,F2",15477,15951,11660,4291,8355,0,3802,3807,2636,1171,2.251067464,1835,14718,4886,2535,3,2532,2,476,0,0.036334913,empty,mBC-0716-1
"A7,F3",11557,11947,8581,3366,6480,1,3088,3095,2157,938,2.299573561,1526,3786,1434,757,1,756,1,205,0,0.052910053,empty,mBC-0716-1
"A7,F4",12149,12362,9167,3195,6858,0,3077,3078,2214,864,2.5625,1476,420,267,153,0,153,0,66,0,0.052287582,empty,mBC-0716-1
"A7,F5",16226,16392,12319,4073,8842,0,4022,4033,2798,1235,2.265587045,1897,1547,921,488,0,488,0,141,0,0.086065574,empty,mBC-0716-1
"A7,F6",479861,498760,361370,137390,266101,0,129170,129397,91777,37620,2.439580011,64445,28809,14106,6990,5,6985,1,1048,0,0.010737294,mm10,mBC-0716-1
"A7,F7",13594,14318,10366,3952,7715,0,3522,3530,2430,1100,2.209090909,1769,656,414,204,0,204,0,75,0,0.068627451,empty,mBC-0716-1
"A7,F8",15595,16296,11796,4500,8730,0,4101,4116,2921,1195,2.444351464,1991,425,187,112,0,112,0,48,0,0,empty,mBC-0716-1
"A7,F9",968646,1006802,715573,291229,533482,1,267759,268188,222545,45643,4.875775037,134978,120629,82649,40029,8,40021,2,3184,0,0.002073911,mm10,mBC-0716-1
"A7,F10",14278,14361,11048,3313,7613,0,3297,3303,2320,983,2.360122075,1512,1032,678,328,0,328,0,96,0,0.030487805,empty,mBC-0716-1
"A7,F11",7918,8260,6182,2078,4334,0,1900,1903,1338,565,2.368141593,884,561,373,211,0,211,0,82,0,0,empty,mBC-0716-1
"A7,F12",9533,9939,7320,2619,5190,0,2422,2425,1684,741,2.272604588,1181,105,70,39,0,39,0,16,0,0,empty,mBC-0716-1
"A7,G1",7337,7559,5654,1905,3935,0,1704,1705,1177,528,2.229166667,803,7012,2493,1220,4,1216,1,240,0,0.038651316,empty,mBC-0716-1
"A7,G2",567522,627311,401704,225607,335107,1,191087,191323,155317,36006,4.313642171,105109,17575,9353,4721,2,4719,2,734,0,0.000635728,mm10,mBC-0716-1
"A7,G3",13712,14038,10521,3517,7476,0,3427,3430,2399,1031,2.326867119,1592,1560,780,416,1,415,1,128,0,0.055421687,empty,mBC-0716-1
"A7,G4",19292,19498,14716,4782,10415,0,4610,4616,3298,1318,2.502276176,2217,80,45,24,0,24,0,13,0,0.041666667,empty,mBC-0716-1
"A7,G5",9424,9570,7115,2455,5120,0,2385,2398,1697,701,2.420827389,1126,752,470,253,0,253,0,78,0,0.059288538,empty,mBC-0716-1
"A7,G6",16546,17067,12812,4255,9085,0,3981,3987,2818,1169,2.410607357,1901,108,69,40,0,40,0,24,0,0,empty,mBC-0716-1
"A7,G7",13530,13479,10521,2958,7295,0,3137,3140,2166,974,2.223819302,1376,1574,946,468,0,468,0,134,0,0.096153846,empty,mBC-0716-1
"A7,G8",10058,10590,7801,2789,5704,0,2608,2619,1835,784,2.340561224,1280,837,474,286,1,285,1,111,0,0.070175439,empty,mBC-0716-1
"A7,G9",401160,449122,284134,164988,241560,0,140267,140452,117240,23212,5.050835775,77576,48921,34682,16979,9,16970,1,1746,0,0.003123159,mm10,mBC-0716-1
"A7,G10",9438,9906,7178,2728,5183,0,2340,2347,1639,708,2.314971751,1163,746,422,250,0,250,0,80,0,0.04,empty,mBC-0716-1
"A7,G11",8760,8951,6646,2305,4798,0,2176,2186,1548,638,2.426332288,1053,2344,770,428,0,428,0,98,0,0.039719626,empty,mBC-0716-1
"A7,G12",7971,8290,6091,2199,4548,0,2079,2088,1492,596,2.503355705,1028,960,613,278,0,278,0,89,0,0.028776978,empty,mBC-0716-1
"A7,H1",562881,630109,391032,239077,336236,2,201699,201997,163155,38842,4.200478863,112752,35918,24413,11551,5,11546,1,1393,0,0.000779491,mm10,mBC-0716-1
"A7,H2",16158,16718,12249,4469,8680,0,3914,3921,2686,1235,2.174898785,1884,1401,952,484,0,484,0,138,0,0.05785124,empty,mBC-0716-1
"A7,H3",14653,14874,10872,4002,7789,1,3624,3631,2541,1090,2.331192661,1752,32368,10525,5330,6,5324,2,693,0,0.185199098,empty,mBC-0716-1
"A7,H4",9325,9682,7141,2541,5215,0,2464,2470,1773,697,2.543758967,1178,65,49,28,0,28,0,17,0,0,empty,mBC-0716-1
"A7,H5",12727,13179,9643,3536,6997,1,3266,3274,2385,889,2.682789651,1606,985,644,318,0,318,0,119,0,0.01572327,empty,mBC-0716-1
"A7,H6",10549,10971,7994,2977,5882,0,2722,2729,1951,778,2.507712082,1381,1014,593,344,0,344,0,116,0,0.005813953,empty,mBC-0716-1
"A7,H7",488013,518438,350632,167806,278588,1,148214,148436,123232,25204,4.889382638,78257,56520,39513,19081,2,19079,1,1895,0,0.000943446,mm10,mBC-0716-1
"A7,H8",14275,14818,10584,4234,8035,0,3938,3947,3031,916,3.308951965,1969,991,604,302,0,302,0,106,0,0.01986755,empty,mBC-0716-1
"A7,H9",11252,11571,8538,3033,6138,0,2808,2814,2036,778,2.616966581,1348,1085,576,295,0,295,0,99,0,0.115254237,empty,mBC-0716-1
"A7,H10",331285,353530,240598,112932,190604,0,98005,98155,81353,16802,4.841864064,51666,57229,38515,18271,6,18265,1,1850,0,0.000821243,mm10,mBC-0716-1
"A7,H11",11657,11903,8809,3094,6444,0,2949,2957,2079,878,2.367881549,1386,132,85,46,0,46,0,26,0,0,empty,mBC-0716-1
"A7,H12",4159,4447,3076,1371,2385,0,1166,1170,813,357,2.277310924,599,463,311,160,0,160,0,55,0,0.1625,empty,mBC-0716-1
"A8,A1",14316,14473,10487,3986,7744,0,3674,3685,2477,1208,2.050496689,1798,28084,8908,4541,4,4537,1,704,0,0.047388142,empty,mBC-0716-1
"A8,A2",18506,18615,14343,4272,9888,0,4274,4283,2925,1358,2.153902798,2001,844,508,266,0,266,0,75,0,0.116541353,empty,mBC-0716-1
"A8,A3",16209,16821,12337,4484,8935,0,4061,4067,2893,1174,2.464224872,1966,653,329,178,0,178,0,61,0,0.033707865,empty,mBC-0716-1
"A8,A4",20858,21364,16140,5224,11360,0,5102,5115,3589,1526,2.351900393,2374,306,195,106,0,106,0,42,0,0.08490566,empty,mBC-0716-1
"A8,A5",17132,17491,12984,4507,9234,1,4281,4290,2879,1411,2.040396882,1975,10864,3587,1819,1,1818,1,358,0,0.052805281,empty,mBC-0716-1
"A8,A6",12230,12758,9319,3439,6850,0,3176,3191,2239,952,2.351890756,1547,1203,757,370,0,370,0,116,0,0.02972973,empty,mBC-0716-1
"A8,A7",478062,505600,354674,150926,276682,1,141863,142047,111150,30897,3.597436644,72899,13100,7063,3510,1,3509,1,605,0,0.017953833,mm10,mBC-0716-1
"A8,A8",11092,11543,8496,3047,6227,0,2888,2894,2066,828,2.495169082,1430,1134,776,397,0,397,0,125,0,0.115869018,empty,mBC-0716-1
"A8,A9",17765,17935,13794,4141,9633,0,4216,4229,2941,1288,2.283385093,1935,993,615,332,0,332,0,94,0,0.060240964,empty,mBC-0716-1
"A8,A10",15176,15684,11600,4084,8295,0,3728,3734,2685,1049,2.559580553,1762,365,212,119,0,119,0,40,0,0,empty,mBC-0716-1
"A8,A11",17390,17448,13231,4217,9557,1,4270,4286,2951,1335,2.210486891,1975,3967,1494,717,0,717,0,152,0,0.094839609,empty,mBC-0716-1
"A8,A12",19835,20174,15456,4718,10574,0,4545,4556,3195,1361,2.347538575,2075,1959,1247,627,0,627,0,146,0,0.055821372,empty,mBC-0716-1
"A8,B1",18488,18959,14242,4717,10043,0,4485,4496,3100,1396,2.220630372,2091,936,598,293,0,293,0,103,0,0.037542662,empty,mBC-0716-1
"A8,B2",20008,20380,15421,4959,10730,0,4767,4776,3216,1560,2.061538462,2263,388,240,135,0,135,0,45,0,0.074074074,empty,mBC-0716-1
"A8,B3",18845,19385,14301,5084,10341,0,4762,4769,3293,1476,2.23102981,2341,822,499,261,0,261,0,89,0,0.042145594,empty,mBC-0716-1
"A8,B4",546108,576709,404306,172403,313216,1,161036,161261,123798,37463,3.30454048,82948,32117,14582,7229,6,7223,1,1055,0,0.027827772,mm10,mBC-0716-1
"A8,B5",520670,321187,202880,118307,223092,0,123689,124329,92460,31869,2.901252,72314,63759,38662,18397,7,18390,1,1898,0,0.018760196,mm10,mBC-0716-1
"A8,B6",561951,595968,402013,193955,320862,0,171896,172172,121003,51169,2.364771639,93135,21247,13428,6468,1,6467,1,967,0,0.026751198,mm10,mBC-0716-1
"A8,B7",16004,16177,12223,3954,8672,0,3802,3812,2654,1158,2.291882556,1836,900,542,281,0,281,0,88,0,0.074733096,empty,mBC-0716-1
"A8,B8",12796,12915,9884,3031,7113,0,3182,3188,2199,989,2.223458038,1509,1179,749,352,0,352,0,97,0,0.073863636,empty,mBC-0716-1
"A8,B9",15181,15427,11648,3779,8087,0,3617,3627,2499,1128,2.215425532,1674,430,269,136,1,135,1,47,0,0,empty,mBC-0716-1
"A8,B10",16472,16194,11999,4195,8927,0,4108,4128,2800,1328,2.108433735,1999,430,275,152,0,152,0,47,0,0.032894737,empty,mBC-0716-1
"A8,B11",738879,800663,533342,267321,423051,0,229603,229993,179976,50017,3.598296579,122894,3906,2703,1347,0,1347,0,246,0,0.001484781,mm10,mBC-0716-1
"A8,B12",18359,18808,13844,4964,9892,1,4524,4528,3150,1378,2.285921626,2101,4292,1934,1021,0,1021,0,175,0,0.316356513,empty,mBC-0716-1
"A8,C1",22042,22536,16923,5613,11701,0,5017,5036,3515,1521,2.310979619,2391,477,288,184,0,184,0,62,0,0.076086957,empty,mBC-0716-1
"A8,C2",18505,18791,14201,4590,10090,0,4521,4529,3215,1314,2.446727549,2117,1920,1246,641,0,641,0,151,0,0.060842434,empty,mBC-0716-1
"A8,C3",963360,1071583,689801,381782,564267,1,320461,320950,241051,79899,3.016946395,177433,27307,18703,8942,3,8939,2,1198,0,0.003020472,mm10,mBC-0716-1
"A8,C4",17145,17624,13025,4599,9560,0,4266,4278,2955,1323,2.233560091,2095,993,639,290,0,290,0,98,0,0.017241379,empty,mBC-0716-1
"A8,C5",16771,17080,12880,4200,9132,0,4131,4147,2874,1273,2.257659073,1918,1571,685,339,0,339,0,89,0,0.073746313,empty,mBC-0716-1
"A8,C6",17613,18348,13211,5137,9934,1,4689,4706,3303,1403,2.354240912,2326,1316,870,429,0,429,0,131,0,0.081585082,empty,mBC-0716-1
"A8,C7",15957,16409,12073,4336,8754,0,4036,4043,2756,1287,2.141414141,1998,297,173,93,0,93,0,45,0,0.086021505,empty,mBC-0716-1
"A8,C8",14598,15084,11022,4062,8238,0,3879,3889,2614,1275,2.050196078,1950,1246,786,420,0,420,0,140,0,0.045238095,empty,mBC-0716-1
"A8,C9",12322,12511,9358,3153,6759,0,3129,3133,2238,895,2.500558659,1458,727,470,249,0,249,0,71,0,0.060240964,empty,mBC-0716-1
"A8,C10",634622,676096,471150,204946,363355,0,183390,183723,147445,36278,4.064308948,95013,56344,38379,18293,6,18287,2,1880,0,0.001421775,mm10,mBC-0716-1
"A8,C11",11434,11855,8666,3189,6285,0,2898,2904,1987,917,2.166848419,1389,555,383,213,0,213,0,73,0,0.056338028,empty,mBC-0716-1
"A8,C12",19653,20101,14887,5214,10669,0,4769,4778,3355,1423,2.357695011,2286,938,536,256,0,256,0,75,0,0.0703125,empty,mBC-0716-1
"A8,D1",11023,11449,8204,3245,6265,0,2977,2977,2116,861,2.457607433,1448,554,351,167,1,166,1,56,0,0,empty,mBC-0716-1
"A8,D2",20643,21172,16130,5042,11216,0,4866,4868,3419,1449,2.359558316,2201,2597,1289,646,2,644,1,172,0,0.096273292,empty,mBC-0716-1
"A8,D3",1042654,1112148,763634,348514,599390,1,316538,316962,230985,85977,2.6865906,166721,41363,24584,11573,3,11570,2,1568,0,0.027139153,mm10,mBC-0716-1
"A8,D4",779202,939160,487211,451949,502112,0,347509,347885,210318,137567,1.528840492,219395,13920,10123,4891,3,4888,1,772,0,0.003273322,mm10,mBC-0716-1
"A8,D5",14098,14501,10605,3896,7751,0,3651,3658,2530,1128,2.242907801,1831,23825,7441,3746,7,3739,3,599,0,0.075421236,empty,mBC-0716-1
"A8,D6",12020,12733,9104,3629,6774,0,3209,3213,2216,997,2.222668004,1622,2307,908,443,0,443,0,128,0,0.063205418,empty,mBC-0716-1
"A8,D7",12741,13084,9524,3560,6943,0,3191,3198,2236,962,2.324324324,1546,1731,1072,498,0,498,0,126,0,0.052208835,empty,mBC-0716-1
"A8,D8",15810,16256,12071,4185,8561,0,3933,3942,2696,1246,2.163723917,1853,631,413,180,0,180,0,82,0,0.022222222,empty,mBC-0716-1
"A8,D9",196734,208963,136116,72847,115462,0,62776,62860,51932,10928,4.752196193,34594,98451,63916,30533,18,30515,5,2443,0,0.003604785,mm10,mBC-0716-1
"A8,D10",674109,756785,466898,289887,405780,1,245674,245974,173153,72821,2.377789374,138888,21445,11868,5684,1,5683,1,872,0,0.003871195,mm10,mBC-0716-1
"A8,D11",13826,13901,10275,3626,7289,0,3330,3339,2355,984,2.393292683,1602,27746,8396,4211,8,4203,3,625,0,0.093742565,empty,mBC-0716-1
"A8,D12",20472,21097,15779,5318,10934,0,4932,4942,3394,1548,2.19250646,2280,1993,1360,635,0,635,0,163,0,0.034645669,empty,mBC-0716-1
"A8,E1",21948,21616,16596,5020,11606,0,5131,5139,3627,1512,2.398809524,2353,22427,7066,3492,4,3488,2,558,0,0.086295872,empty,mBC-0716-1
"A8,E2",613968,651533,451574,199959,349925,1,178910,179191,151218,27973,5.405855647,92474,105411,70931,33696,13,33683,2,2610,0,0.001514117,mm10,mBC-0716-1
"A8,E3",12285,12325,9574,2751,6557,0,2793,2796,1904,892,2.134529148,1214,979,605,317,1,316,1,117,0,0.003164557,empty,mBC-0716-1
"A8,E4",14930,15369,11457,3912,8119,0,3627,3633,2550,1083,2.354570637,1711,1181,744,389,0,389,0,122,0,0.038560411,empty,mBC-0716-1
"A8,E5",20749,20935,16019,4916,11183,0,4795,4820,3274,1546,2.117723157,2229,1705,765,402,1,401,1,121,0,0.029925187,empty,mBC-0716-1
"A8,E6",13320,13603,10263,3340,7325,0,3289,3302,2313,989,2.338725986,1529,1091,603,285,1,284,1,87,0,0.007042254,empty,mBC-0716-1
"A8,E7",13739,13969,10628,3341,7360,0,3273,3280,2264,1016,2.228346457,1501,1006,684,360,0,360,0,102,0,0.025,empty,mBC-0716-1
"A8,E8",17434,17735,13372,4363,9406,0,4114,4117,2880,1237,2.32821342,1938,1399,854,424,1,423,1,134,0,0.023640662,empty,mBC-0716-1
"A8,E9",8770,9224,6597,2627,4918,0,2289,2295,1618,677,2.389955687,1133,929,619,298,0,298,0,90,0,0.070469799,empty,mBC-0716-1
"A8,E10",13034,13547,10010,3537,7095,0,3188,3204,2329,875,2.661714286,1466,1054,639,332,0,332,0,102,0,0.021084337,empty,mBC-0716-1
"A8,E11",442632,458562,316247,142315,252419,0,134988,135192,82494,52698,1.565410452,70736,34534,12756,6309,8,6301,2,994,0,0.04729408,mm10,mBC-0716-1
"A8,E12",14876,15351,11374,3977,8406,0,3873,3886,2727,1159,2.352890423,1820,793,513,250,0,250,0,86,0,0.092,empty,mBC-0716-1
"A8,F1",17973,18362,13636,4726,9726,0,4390,4404,3042,1362,2.233480176,2052,5016,2037,1003,0,1003,0,201,0,0.029910269,empty,mBC-0716-1
"A8,F2",22821,23667,17317,6350,12639,0,5898,5912,4116,1796,2.291759465,2847,2181,1424,686,2,684,1,196,0,0.045321637,empty,mBC-0716-1
"A8,F3",15679,16181,11849,4332,8833,0,4117,4128,2854,1274,2.240188383,1992,1952,1026,524,0,524,0,158,0,0.059160305,empty,mBC-0716-1
"A8,F4",16594,16809,12395,4414,9111,0,4198,4201,2981,1220,2.443442623,2026,379,253,137,0,137,0,64,0,0.02189781,empty,mBC-0716-1
"A8,F5",617690,610669,467036,143633,328807,0,144777,145067,120121,24946,4.81524092,67683,8010,5625,2580,0,2580,0,554,0,0.002325581,mm10,mBC-0716-1
"A8,F6",22723,22935,17259,5676,12300,0,5557,5576,3934,1642,2.395858709,2595,4082,1775,928,0,928,0,228,0,0.019396552,empty,mBC-0716-1
"A8,F7",739643,814907,533225,281682,446976,0,249638,249993,189474,60519,3.130818421,136650,19847,14228,6779,0,6779,0,933,0,0.001475144,mm10,mBC-0716-1
"A8,F8",22096,22447,16949,5498,12136,0,5476,5487,3832,1655,2.315407855,2558,246,145,85,0,85,0,43,0,0,empty,mBC-0716-1
"A8,F9",747156,801478,546035,255443,429456,1,230369,230749,172381,58368,2.953347725,120436,59943,42947,20674,8,20666,2,2048,0,0.002661376,mm10,mBC-0716-1
"A8,F10",21017,21589,16197,5392,11362,0,4989,5002,3512,1490,2.35704698,2356,10053,3641,1780,1,1779,1,334,0,0.056773468,empty,mBC-0716-1
"A8,F11",11399,11355,8740,2615,6096,0,2673,2684,1810,874,2.070938215,1209,10684,3289,1675,1,1674,1,281,0,0.060334528,empty,mBC-0716-1
"A8,F12",13944,14617,10516,4101,7620,0,3511,3517,2415,1102,2.191470054,1685,73,34,24,0,24,0,10,0,0,empty,mBC-0716-1
"A8,G1",465690,499262,348198,151064,269648,1,133359,133577,110899,22678,4.890157862,68334,99972,66328,31653,25,31628,3,2653,0,0.002750727,mm10,mBC-0716-1
"A8,G2",20138,20426,15420,5006,10792,0,4830,4850,3309,1541,2.147306944,2261,454,222,127,0,127,0,47,0,0.118110236,empty,mBC-0716-1
"A8,G3",20397,20762,15431,5331,11192,0,5195,5209,3633,1576,2.305203046,2475,3124,1383,669,1,668,1,189,0,0.028443114,empty,mBC-0716-1
"A8,G4",27719,28114,21611,6503,14752,1,6397,6422,4497,1925,2.336103896,2870,55,37,28,0,28,0,21,0,0,empty,mBC-0716-1
"A8,G5",13268,13704,10071,3633,7270,0,3313,3322,2344,978,2.396728016,1610,827,550,309,1,308,1,110,0,0.074675325,empty,mBC-0716-1
"A8,G6",23822,24167,18561,5606,12938,0,5557,5565,3919,1646,2.380923451,2568,208,133,69,0,69,0,33,0,0.028985507,empty,mBC-0716-1
"A8,G7",20007,20055,15411,4644,10846,0,4721,4734,3344,1390,2.405755396,2216,6427,2210,1154,1,1153,1,244,0,0.075455334,empty,mBC-0716-1
"A8,G8",14630,15115,11224,3891,7973,0,3687,3692,2551,1141,2.235758107,1748,1351,833,393,0,393,0,133,0,0.020356234,empty,mBC-0716-1
"A8,G9",10327,10608,7917,2691,5677,0,2612,2612,1836,776,2.365979381,1215,918,518,267,1,266,1,90,0,0.026315789,empty,mBC-0716-1
"A8,G10",1021459,1141812,694015,447797,600449,1,368179,368662,308970,59692,5.176070495,207212,138281,93359,44919,22,44897,3,3168,0,0.001870949,mm10,mBC-0716-1
"A8,G11",12434,12538,9366,3172,6688,0,3054,3057,2166,891,2.430976431,1435,536,362,186,0,186,0,63,0,0,empty,mBC-0716-1
"A8,G12",11419,11745,8732,3013,6364,0,2890,2896,1982,914,2.168490153,1385,1145,728,335,0,335,0,101,0,0.03880597,empty,mBC-0716-1
"A8,H1",20730,21294,15868,5426,11137,0,5083,5090,3613,1477,2.446174678,2367,856,482,248,1,247,1,78,0,0.044534413,empty,mBC-0716-1
"A8,H2",25358,26378,19237,7141,13714,1,6159,6170,4441,1729,2.568536726,3049,1795,1146,593,0,593,0,146,0,0.035413153,empty,mBC-0716-1
"A8,H3",19517,20264,14881,5383,10748,0,4942,4954,3429,1525,2.24852459,2422,2450,1209,554,0,554,0,131,0,0.045126354,empty,mBC-0716-1
"A8,H4",1241507,1334133,883177,450956,704489,2,394043,394574,284024,110550,2.569190412,211620,8462,5417,2535,1,2534,1,443,0,0,mm10,mBC-0716-1
"A8,H5",1005980,1132432,694778,437654,591239,2,356502,356971,282475,74496,3.791814326,201611,133135,86302,41419,12,41407,1,3048,0,0.003067114,mm10,mBC-0716-1
"A8,H6",486801,504370,360343,144027,274560,1,133692,133912,108723,25189,4.316288856,67872,67388,46905,22162,10,22152,1,2119,0,0.002257133,mm10,mBC-0716-1
"A8,H7",17056,17768,12991,4777,9587,0,4372,4378,3067,1311,2.339435545,2183,5694,2299,1164,1,1163,1,227,0,0.147033534,empty,mBC-0716-1
"A8,H8",13205,13677,10101,3576,7337,0,3439,3453,2413,1040,2.320192308,1613,1123,640,332,0,332,0,116,0,0.003012048,empty,mBC-0716-1
"A8,H9",687864,708709,504316,204393,380617,1,190665,190981,149871,41110,3.645609341,97291,13043,7648,3944,1,3943,1,633,0,0.010398174,mm10,mBC-0716-1
"A8,H10",731232,791764,494578,297186,421401,0,250921,251207,190103,61104,3.111138387,139960,47891,28959,13519,7,13512,1,1658,0,0.011619301,mm10,mBC-0716-1
"A8,H11",16878,17306,12697,4609,9308,0,4372,4383,3032,1351,2.244263509,2126,111,58,41,0,41,0,30,0,0,empty,mBC-0716-1
"A8,H12",5970,6251,4437,1814,3377,0,1605,1605,1099,506,2.171936759,817,519,299,159,0,159,0,54,0,0.050314465,empty,mBC-0716-1
"A9,A1",10689,10834,8004,2830,5858,0,2718,2723,1903,820,2.320731707,1285,1066,747,369,0,369,0,100,0,0.01897019,empty,mBC-0716-1
"A9,A2",14477,14721,10996,3725,7788,0,3341,3356,2346,1010,2.322772277,1582,906,556,282,0,282,0,90,0,0.04964539,empty,mBC-0716-1
"A9,A3",13120,13495,10072,3423,7229,0,3285,3292,2276,1016,2.24015748,1597,718,498,257,0,257,0,74,0,0.035019455,empty,mBC-0716-1
"A9,A4",770385,820564,562212,258352,426417,0,227696,228053,184575,43478,4.245250472,118116,13109,8235,4001,2,3999,1,611,0,0.004501125,mm10,mBC-0716-1
"A9,A5",13446,13933,10298,3635,7401,0,3314,3319,2256,1063,2.12229539,1620,1511,635,348,0,348,0,104,0,0.077586207,empty,mBC-0716-1
"A9,A6",14035,14677,10423,4254,7951,0,3976,3986,2752,1234,2.230145867,2032,993,685,355,0,355,0,119,0,0.084507042,empty,mBC-0716-1
"A9,A7",12908,13238,10044,3194,7155,0,3151,3154,2214,940,2.355319149,1491,918,593,339,0,339,0,99,0,0.017699115,empty,mBC-0716-1
"A9,A8",8918,9239,6705,2534,4889,0,2248,2257,1569,688,2.280523256,1100,1101,709,349,0,349,0,122,0,0.008595989,empty,mBC-0716-1
"A9,A9",1170239,1248015,844656,403359,653715,0,358103,358645,287631,71014,4.050342186,187887,42029,29244,13825,4,13821,1,1672,0,0.001664134,mm10,mBC-0716-1
"A9,A10",509697,573089,344635,228454,305209,1,186713,186999,155880,31119,5.009158392,105650,15288,8973,4403,3,4400,2,708,0,0.009318182,mm10,mBC-0716-1
"A9,A11",14678,14931,11255,3676,8050,0,3632,3645,2563,1082,2.368761553,1739,1027,664,331,0,331,0,94,0,0.021148036,empty,mBC-0716-1
"A9,A12",16495,16652,12580,4072,8780,0,3865,3879,2780,1099,2.529572338,1810,5066,2161,1060,0,1060,0,211,0,0.044339623,empty,mBC-0716-1
"A9,B1",15603,15946,11918,4028,8459,1,3803,3812,2694,1118,2.409660107,1792,854,528,276,0,276,0,90,0,0.018115942,empty,mBC-0716-1
"A9,B2",16360,16515,12512,4003,8714,0,3819,3823,2663,1160,2.295689655,1773,374,235,127,0,127,0,50,0,0.11023622,empty,mBC-0716-1
"A9,B3",15653,15942,12003,3939,8486,0,3833,3841,2737,1104,2.479166667,1773,1125,697,349,0,349,0,108,0,0.071633238,empty,mBC-0716-1
"A9,B4",639509,720002,447596,272406,384325,0,229236,229534,181122,48412,3.741262497,128405,40964,27970,13476,5,13471,3,1465,0,0.007200653,mm10,mBC-0716-1
"A9,B5",7031,4342,3115,1227,2968,0,1381,1390,970,420,2.30952381,739,2156,857,433,0,433,0,107,0,0.057736721,empty,mBC-0716-1
"A9,B6",9697,10147,7376,2771,5252,0,2408,2416,1626,790,2.058227848,1148,6107,1970,1053,0,1053,0,193,0,0.048433048,empty,mBC-0716-1
"A9,B7",13507,14005,10474,3531,7408,0,3338,3341,2339,1002,2.334331337,1582,690,372,210,0,210,0,66,0,0.09047619,empty,mBC-0716-1
"A9,B8",10817,10811,8327,2484,5779,0,2560,2564,1731,833,2.078031212,1169,3065,1027,522,1,521,1,132,0,0.103646833,empty,mBC-0716-1
"A9,B9",12526,13087,9795,3292,6770,0,3016,3022,2123,899,2.361512792,1471,1158,621,301,0,301,0,72,0,0.003322259,empty,mBC-0716-1
"A9,B10",13132,12698,9536,3162,6944,0,3120,3132,2161,971,2.22554068,1447,346,221,101,0,101,0,41,0,0.069306931,empty,mBC-0716-1
"A9,B11",762712,811908,557948,253960,420219,0,216205,216536,181181,35355,5.124621694,112487,3379,2377,1135,0,1135,0,238,0,0,mm10,mBC-0716-1
"A9,B12",722461,790010,500861,289149,419501,0,250163,250521,192719,57802,3.334123387,137393,12051,8283,3866,0,3866,0,670,0,0.011898603,mm10,mBC-0716-1
"A9,C1",18995,19284,14821,4463,9923,0,4205,4218,2948,1270,2.321259843,1926,445,308,153,0,153,0,61,0,0.058823529,empty,mBC-0716-1
"A9,C2",15240,15383,11555,3828,8120,0,3683,3695,2549,1146,2.22425829,1777,1463,986,522,0,522,0,138,0,0.151340996,empty,mBC-0716-1
"A9,C3",1060009,1104744,786346,318398,580555,1,286072,286591,225303,61288,3.676135622,148324,18460,12401,6022,0,6022,0,930,0,0.002656925,mm10,mBC-0716-1
"A9,C4",13964,14317,10745,3572,7540,0,3337,3346,2313,1033,2.23910939,1566,924,552,300,0,300,0,117,0,0.04,empty,mBC-0716-1
"A9,C5",594279,621036,430105,190931,332215,1,174921,175163,127831,47332,2.700731007,90791,13907,6911,3297,0,3297,0,645,0,0.030330604,mm10,mBC-0716-1
"A9,C6",528972,573109,376029,197080,316203,0,176490,176749,137157,39592,3.464260457,95916,31907,22550,10865,3,10862,2,1308,0,0.001288897,mm10,mBC-0716-1
"A9,C7",12910,13238,9740,3498,6968,0,3246,3254,2222,1032,2.153100775,1573,365,212,109,0,109,0,44,0,0.128440367,empty,mBC-0716-1
"A9,C8",1059188,1152199,744933,407266,607729,1,342864,343392,259273,84119,3.082216859,188230,205024,139639,66334,21,66313,7,4167,0,0.00190008,mm10,mBC-0716-1
"A9,C9",10219,10570,7811,2759,5575,0,2551,2564,1739,825,2.107878788,1205,671,391,200,1,199,1,61,0,0.065326633,empty,mBC-0716-1
"A9,C10",663382,712415,475821,236594,377098,1,205511,205827,174117,31710,5.490917692,108354,61634,44373,21287,8,21279,1,2068,0,0.000563936,mm10,mBC-0716-1
"A9,C11",9612,10135,7328,2807,5385,0,2553,2562,1759,803,2.190535492,1276,797,503,284,0,284,0,73,0,0.052816901,empty,mBC-0716-1
"A9,C12",16446,17126,12401,4725,8912,0,4105,4121,2940,1181,2.489415749,1979,2311,918,458,1,457,1,122,0,0.056892779,empty,mBC-0716-1
"A9,D1",8623,8931,6553,2378,4790,0,2244,2248,1542,706,2.184135977,1096,412,265,134,0,134,0,43,0,0.037313433,empty,mBC-0716-1
"A9,D2",17380,17690,13433,4257,9267,0,4031,4037,2760,1277,2.161315583,1877,1500,970,458,0,458,0,137,0,0.034934498,empty,mBC-0716-1
"A9,D3",10680,11215,7962,3253,5930,0,2823,2836,1921,915,2.099453552,1425,919,542,267,0,267,0,92,0,0.056179775,empty,mBC-0716-1
"A9,D4",11926,12334,8961,3373,6521,0,3078,3082,2158,924,2.335497835,1521,717,477,242,0,242,0,98,0,0.024793388,empty,mBC-0716-1
"A9,D5",10923,11227,8295,2932,5979,0,2796,2803,1959,844,2.321090047,1341,949,587,301,0,301,0,86,0,0.079734219,empty,mBC-0716-1
"A9,D6",956933,1039457,684417,355040,548421,0,299688,300175,249355,50820,4.906631248,162461,143798,102291,48818,24,48794,2,3417,0,0.000512358,mm10,mBC-0716-1
"A9,D7",124578,112937,107852,5085,64474,0,6845,6898,4156,2742,1.515681984,2205,2349,1343,664,2,662,2,235,0,0.021148036,empty,mBC-0716-1
"A9,D8",13395,13856,9996,3860,7327,0,3401,3407,2372,1035,2.29178744,1668,1001,576,268,1,267,1,86,0,0.108614232,empty,mBC-0716-1
"A9,D9",162089,168528,115824,52704,92994,1,47829,47906,35675,12231,2.916768866,25223,16709,10487,5130,1,5129,1,821,0,0.005654124,empty,mBC-0716-1
"A9,D10",12283,12591,9408,3183,6754,0,3148,3151,2250,901,2.497225305,1515,1183,573,310,0,310,0,85,0,0.14516129,empty,mBC-0716-1
"A9,D11",676129,732689,488288,244401,387849,2,214193,214531,155117,59414,2.610781971,114108,52640,36219,17195,7,17188,1,1674,0,0.004363509,mm10,mBC-0716-1
"A9,D12",17132,17879,12996,4883,9113,0,4154,4159,2822,1337,2.110695587,2005,1482,971,499,1,498,1,157,0,0.070281124,empty,mBC-0716-1
"A9,E1",1492827,1622710,1068513,554197,843054,1,473601,474310,369215,105095,3.513154765,256207,127299,72564,35137,20,35117,5,2945,0,0.01013754,mm10,mBC-0716-1
"A9,E2",13226,13144,9929,3215,6987,0,3122,3131,2216,915,2.421857923,1457,31287,8988,4636,5,4631,1,639,0,0.062405528,empty,mBC-0716-1
"A9,E3",296089,293624,231780,61844,159388,0,63644,63761,46765,16996,2.751529772,28792,15564,9719,4610,3,4607,2,807,0,0.006294769,mm10,mBC-0716-1
"A9,E4",12794,13198,9772,3426,6831,0,3167,3180,2234,946,2.361522199,1479,753,488,268,0,268,0,96,0,0.02238806,empty,mBC-0716-1
"A9,E5",17966,18190,13770,4420,9410,0,4147,4161,2887,1274,2.266091052,1882,5562,1776,913,4,909,1,204,0,0.03740374,empty,mBC-0716-1
"A9,E6",10784,10768,8152,2616,5642,0,2540,2546,1788,758,2.35883905,1213,1293,712,338,0,338,0,91,0,0.035502959,empty,mBC-0716-1
"A9,E7",588472,639392,402562,236830,341620,0,207130,207429,138141,69288,1.993721857,115782,10745,4424,2164,1,2163,1,434,0,0.024040684,mm10,mBC-0716-1
"A9,E8",14395,14393,10877,3516,7486,0,3273,3281,2242,1039,2.157844081,1483,1499,934,471,0,471,0,151,0,0.061571125,empty,mBC-0716-1
"A9,E9",7114,7211,5278,1933,3830,0,1822,1823,1287,536,2.401119403,876,5369,1830,925,0,925,0,201,0,0.019459459,empty,mBC-0716-1
"A9,E10",10546,11192,8147,3045,5796,0,2685,2694,1858,836,2.222488038,1296,967,581,293,0,293,0,86,0,0.109215017,empty,mBC-0716-1
"A9,E11",7254,7507,5543,1964,4004,0,1793,1797,1229,568,2.163732394,836,748,467,231,0,231,0,95,0,0.073593074,empty,mBC-0716-1
"A9,E12",12361,12448,9292,3156,6818,0,3161,3169,2198,971,2.263645726,1520,3574,1527,795,0,795,0,151,0,0.183647799,empty,mBC-0716-1
"A9,F1",14670,15083,11138,3945,7920,1,3545,3550,2463,1087,2.265869365,1733,974,614,314,0,314,0,87,0,0.133757962,empty,mBC-0716-1
"A9,F2",18705,19297,14335,4962,10222,0,4723,4736,3349,1387,2.414563807,2209,1743,1035,537,1,536,1,163,0,0.057835821,empty,mBC-0716-1
"A9,F3",12937,13074,9866,3208,6987,0,3172,3182,2206,976,2.260245902,1448,4375,1401,722,1,721,1,184,0,0.034674064,empty,mBC-0716-1
"A9,F4",14008,14167,10234,3933,7551,0,3491,3500,2481,1019,2.434739941,1727,10172,3145,1598,1,1597,1,299,0,0.046336882,empty,mBC-0716-1
"A9,F5",1421047,1528701,1025762,502939,789351,1,427156,427855,359276,68579,5.238863209,227736,159658,109611,51796,21,51775,2,3505,0,0.000270401,mm10,mBC-0716-1
"A9,F6",18681,18970,14040,4930,10032,0,4612,4623,3246,1377,2.357298475,2259,4089,1593,750,2,748,1,179,0,0.049465241,empty,mBC-0716-1
"A9,F7",15983,16390,12250,4140,9051,0,4109,4117,2920,1197,2.439431913,1930,1021,523,279,0,279,0,89,0,0.078853047,empty,mBC-0716-1
"A9,F8",1560524,1757132,1053836,703296,915996,3,584717,585511,412551,172960,2.385239362,334739,3675,2204,1093,0,1093,0,254,0,0.004574565,mm10,mBC-0716-1
"A9,F9",12394,12501,9475,3026,6720,0,3048,3054,2163,891,2.427609428,1397,3870,1483,729,0,729,0,186,0,0.106995885,empty,mBC-0716-1
"A9,F10",17235,17137,13416,3721,9057,0,3903,3910,2694,1216,2.215460526,1729,1479,785,345,0,345,0,116,0,0.072463768,empty,mBC-0716-1
"A9,F11",8767,8849,6700,2149,4801,0,2078,2079,1448,631,2.294770206,976,702,468,243,0,243,0,83,0,0.139917695,empty,mBC-0716-1
"A9,F12",407114,434648,287915,146733,234590,0,132281,132459,90875,41584,2.185335706,71086,1494,503,239,0,239,0,67,0,0,empty,mBC-0716-1
"A9,G1",8402,8538,6515,2023,4538,0,2015,2023,1380,643,2.146189736,936,1253,763,419,0,419,0,116,0,0.021479714,empty,mBC-0716-1
"A9,G2",589922,598048,439869,158179,317786,0,152459,152753,121718,31035,3.921959078,74673,2460,1699,842,1,841,1,186,0,0.003567182,empty,mBC-0716-1
"A9,G3",18539,19203,13829,5374,10169,0,4853,4859,3494,1365,2.55970696,2410,6529,2514,1272,1,1271,1,226,0,0.114083399,empty,mBC-0716-1
"A9,G4",22851,23015,17641,5374,12130,0,5284,5303,3792,1511,2.509596294,2426,53,29,16,0,16,0,16,0,0.0625,empty,mBC-0716-1
"A9,G5",10968,10950,8251,2699,5851,0,2644,2657,1812,845,2.144378698,1240,1043,705,348,0,348,0,119,0,0.045977011,empty,mBC-0716-1
"A9,G6",19432,20204,15042,5162,10498,0,4570,4577,3257,1320,2.467424242,2179,108,73,45,0,45,0,32,0,0,empty,mBC-0716-1
"A9,G7",16279,16930,12557,4373,8858,0,3930,3937,2712,1225,2.213877551,1835,1474,856,487,0,487,0,143,0,0.051334702,empty,mBC-0716-1
"A9,G8",11771,12428,9002,3426,6437,0,3039,3044,2117,927,2.283710895,1443,1267,761,367,3,364,1,125,0,0.03021978,empty,mBC-0716-1
"A9,G9",1111754,1191389,804211,387178,625687,0,339630,340128,276183,63945,4.319071077,179993,71938,49395,23394,10,23384,2,2414,0,0.001069107,mm10,mBC-0716-1
"A9,G10",800327,894615,551221,343394,471887,5,283337,283759,193173,90586,2.13248184,162151,65183,42840,20371,10,20361,1,2046,0,0.005500712,mm10,mBC-0716-1
"A9,G11",1243964,1341676,903446,438230,697489,2,373649,374171,310895,63276,4.913316265,196503,89521,62362,29769,9,29760,1,2625,0,0.002150538,mm10,mBC-0716-1
"A9,G12",9301,9692,7159,2533,5180,1,2336,2342,1652,690,2.394202899,1140,933,557,276,0,276,0,83,0,0.014492754,empty,mBC-0716-1
"A9,H1",17228,17519,12971,4548,9410,0,4279,4297,2989,1308,2.285168196,2042,5218,1566,838,1,837,1,185,0,0.107526882,empty,mBC-0716-1
"A9,H2",19576,20286,14851,5435,10498,0,4657,4669,3230,1439,2.244614315,2280,1277,736,363,0,363,0,117,0,0.08815427,empty,mBC-0716-1
"A9,H3",609087,658060,444084,213976,349035,0,185171,185436,146073,39363,3.710921424,98426,47173,32681,15368,3,15365,1,1685,0,0.001431826,mm10,mBC-0716-1
"A9,H4",10580,10840,7881,2959,5654,0,2641,2645,1865,780,2.391025641,1312,95,51,30,0,30,0,13,0,0,empty,mBC-0716-1
"A9,H5",439486,458084,315289,142795,247034,1,129737,129907,103560,26347,3.930618287,68290,26103,9653,4744,4,4740,2,770,0,0.096413502,mm10,mBC-0716-1
"A9,H6",11180,11473,8400,3073,6053,0,2798,2803,1970,833,2.364945978,1334,7932,2545,1272,0,1272,0,239,0,0.129716981,empty,mBC-0716-1
"A9,H7",514462,551015,373567,177448,295687,1,153187,153440,127038,26402,4.811680933,81253,63312,43987,21241,9,21232,2,2041,0,0.001931047,mm10,mBC-0716-1
"A9,H8",10763,11116,8146,2970,5944,0,2823,2825,1956,869,2.250863061,1386,1061,639,357,0,357,0,128,0,0.039215686,empty,mBC-0716-1
"A9,H9",12924,13144,9733,3411,6991,0,3236,3243,2251,992,2.269153226,1554,1954,888,438,0,438,0,121,0,0.057077626,empty,mBC-0716-1
"A9,H10",10974,11298,8233,3065,5903,0,2695,2702,1873,829,2.259348613,1265,1025,710,328,0,328,0,102,0,0.033536585,empty,mBC-0716-1
"A9,H11",13546,14195,10224,3971,7561,0,3545,3551,2473,1078,2.29406308,1786,164,108,59,0,59,0,33,0,0.13559322,empty,mBC-0716-1
"A9,H12",4780,4875,3617,1258,2712,0,1249,1249,882,367,2.403269755,618,596,386,167,0,167,0,58,0,0,empty,mBC-0716-1
"A10,A1",13110,13565,9802,3763,7422,0,3475,3481,2455,1026,2.392787524,1673,830,548,317,0,317,0,109,0,0.078864353,empty,mBC-0716-1
"A10,A2",17393,17302,13290,4012,9204,0,3974,3983,2745,1238,2.217285945,1789,2684,1144,544,0,544,0,147,0,0.055147059,empty,mBC-0716-1
"A10,A3",15569,16236,11684,4552,8690,0,4017,4025,2809,1216,2.310032895,2017,856,498,277,0,277,0,89,0,0.090252708,empty,mBC-0716-1
"A10,A4",706091,730733,515328,215405,388941,1,201631,201969,163394,38575,4.235748542,101978,3892,2003,944,1,943,1,211,0,0.038176034,empty,mBC-0716-1
"A10,A5",539631,566322,402067,164255,306515,1,147016,147248,114533,32715,3.500932294,74676,84085,49650,23710,11,23699,3,2375,0,0.006371577,mm10,mBC-0716-1
"A10,A6",11617,12068,8855,3213,6504,0,3067,3075,2143,932,2.299356223,1473,946,531,299,0,299,0,111,0,0.046822742,empty,mBC-0716-1
"A10,A7",15680,16033,11941,4092,8641,0,3910,3921,2679,1242,2.157004831,1831,982,618,334,0,334,0,107,0,0.053892216,empty,mBC-0716-1
"A10,A8",1014454,1170015,671871,498144,627108,1,404916,405455,296983,108472,2.737877056,237745,157973,106735,50731,21,50710,3,3702,0,0.000788799,mm10,mBC-0716-1
"A10,A9",17788,18194,13716,4478,9401,0,4064,4076,2877,1199,2.399499583,1877,896,563,271,0,271,0,81,0,0.10701107,empty,mBC-0716-1
"A10,A10",14509,15097,10946,4151,8028,0,3759,3765,2618,1147,2.282476024,1848,317,192,111,0,111,0,39,0,0.027027027,empty,mBC-0716-1
"A10,A11",678499,715554,479218,236336,382692,1,213383,213655,172352,41303,4.172868799,112681,16114,11615,5548,1,5547,1,895,0,0.00378583,mm10,mBC-0716-1
"A10,A12",20074,20550,15511,5039,10632,0,4596,4610,3212,1398,2.297567954,2145,2963,1508,727,0,727,0,194,0,0.10866575,empty,mBC-0716-1
"A10,B1",18672,19239,14472,4767,10039,0,4416,4420,3118,1302,2.394777266,2039,835,588,330,0,330,0,114,0,0.136363636,empty,mBC-0716-1
"A10,B2",1112972,1213366,762005,451361,634922,2,372248,372779,307371,65408,4.699287549,207678,31410,18803,8904,5,8899,1,1124,0,0.00258456,mm10,mBC-0716-1
"A10,B3",546066,557254,424671,132583,299993,0,130994,131228,103611,27617,3.751710903,62483,9299,6061,2947,2,2945,1,541,0,0.004074703,mm10,mBC-0716-1
"A10,B4",1736502,1961681,1184058,777623,1027981,1,644973,645816,428143,217673,1.966909079,375615,52651,34992,16539,14,16525,1,1876,0,0.001815431,mm10,mBC-0716-1
"A10,B5",460114,283116,184315,98801,195612,2,103340,103849,87529,16320,5.363296569,58780,61276,41168,19646,7,19639,1,1972,0,0.000356434,mm10,mBC-0716-1
"A10,B6",11230,11707,8517,3190,6282,0,2906,2908,1945,963,2.01973001,1422,903,514,273,0,273,0,84,0,0.021978022,empty,mBC-0716-1
"A10,B7",523455,553720,386936,166784,301883,0,156703,156978,112321,44657,2.515193587,80587,14966,8605,4159,3,4156,1,630,0,0.009143407,mm10,mBC-0716-1
"A10,B8",15109,15688,11809,3879,8426,0,3689,3689,2593,1096,2.365875912,1744,1296,746,370,0,370,0,121,0,0.043243243,empty,mBC-0716-1
"A10,B9",14809,15283,11274,4009,8131,0,3708,3733,2553,1180,2.163559322,1828,437,232,132,0,132,0,56,0,0,empty,mBC-0716-1
"A10,B10",506084,487690,326293,161397,273598,4,145825,146817,116548,30269,3.850408008,78944,23152,15396,7298,5,7293,1,999,0,0.001645413,mm10,mBC-0716-1
"A10,B11",18804,19713,14121,5592,10506,0,5052,5060,3750,1310,2.86259542,2534,248,103,54,0,54,0,36,0,0,empty,mBC-0716-1
"A10,B12",17534,18192,13246,4946,9696,0,4453,4469,3106,1363,2.278796772,2241,1442,913,442,0,442,0,112,0,0.074660633,empty,mBC-0716-1
"A10,C1",21777,21977,16909,5068,11595,0,4867,4878,3458,1420,2.435211268,2246,583,340,175,0,175,0,75,0,0.005714286,empty,mBC-0716-1
"A10,C2",17801,18335,13351,4984,9847,0,4560,4580,3190,1390,2.294964029,2278,1380,852,429,0,429,0,156,0,0.062937063,empty,mBC-0716-1
"A10,C3",19842,20596,15194,5402,10829,0,4975,4997,3437,1560,2.203205128,2462,339,198,96,0,96,0,39,0,0.0625,empty,mBC-0716-1
"A10,C4",16116,16564,12178,4386,8876,0,3867,3877,2685,1192,2.252516779,1889,1031,559,288,0,288,0,115,0,0.072916667,empty,mBC-0716-1
"A10,C5",16341,16717,12425,4292,8906,1,4076,4095,2872,1223,2.348323794,1976,1672,928,472,1,471,1,120,0,0.154989384,empty,mBC-0716-1
"A10,C6",16058,16510,12140,4370,9243,0,4252,4257,3031,1226,2.472267537,2047,2337,1114,576,1,575,1,143,0,0.029565217,empty,mBC-0716-1
"A10,C7",15594,16294,11948,4346,8628,0,4042,4048,2832,1216,2.328947368,1964,352,225,120,0,120,0,47,0,0,empty,mBC-0716-1
"A10,C8",244691,264658,176827,87831,141700,0,80533,80656,59413,21243,2.79682719,42780,6093,3871,1923,1,1922,1,400,0,0.024973985,mm10,mBC-0716-1
"A10,C9",12334,12734,9333,3401,6773,0,3117,3120,2222,898,2.474387528,1493,3293,1086,582,0,582,0,122,0,0.125429553,empty,mBC-0716-1
"A10,C10",12922,13244,9979,3265,7066,0,3160,3164,2227,937,2.376734258,1458,688,438,238,0,238,0,75,0,0.06302521,empty,mBC-0716-1
"A10,C11",11017,11391,8307,3084,6125,0,2776,2779,1964,815,2.409815951,1366,756,496,247,0,247,0,83,0,0.004048583,empty,mBC-0716-1
"A10,C12",19172,19985,14508,5477,10511,1,4890,4909,3436,1473,2.332654447,2452,982,570,272,0,272,0,87,0,0.058823529,empty,mBC-0716-1
"A10,D1",575662,668890,369983,298907,363213,1,246968,247264,179474,67790,2.647499631,147454,9539,6484,3073,1,3072,1,561,0,0.000325521,mm10,mBC-0716-1
"A10,D2",19993,20428,15516,4912,10782,0,4723,4738,3308,1430,2.313286713,2201,2335,1393,697,0,697,0,179,0,0.076040172,empty,mBC-0716-1
"A10,D3",962824,1016635,709534,307101,548982,0,281078,281500,200666,80834,2.482445506,147006,34519,21432,10070,4,10066,1,1401,0,0.001490165,mm10,mBC-0716-1
"A10,D4",13634,13996,10232,3764,7416,0,3456,3466,2404,1062,2.263653484,1696,26385,8806,4429,6,4423,3,652,0,0.03820936,empty,mBC-0716-1
"A10,D5",292656,324761,203631,121130,175537,0,105793,105942,83902,22040,3.806805808,59271,4283,2874,1360,0,1360,0,307,0,0.015441176,mm10,mBC-0716-1
"A10,D6",11767,12255,8898,3357,6532,0,3146,3157,2225,932,2.387339056,1526,1122,556,280,1,279,1,101,0,0.032258065,empty,mBC-0716-1
"A10,D7",2052598,2222414,1440016,782398,1158007,1,679712,680621,549537,131084,4.19225077,369961,186965,123654,59099,19,59080,3,3921,0,0.014895058,mm10,mBC-0716-1
"A10,D8",16314,17089,12182,4907,9222,0,4448,4457,3052,1405,2.172241993,2268,758,492,254,0,254,0,105,0,0.015748031,empty,mBC-0716-1
"A10,D9",4494,4470,3277,1193,2577,0,1270,1278,903,375,2.408,630,1312,859,444,1,443,1,127,0,0.072234763,empty,mBC-0716-1
"A10,D10",575931,629696,410974,218722,339082,3,188292,188548,155784,32764,4.754730802,102401,43803,29492,14140,7,14133,1,1623,0,0.003184037,mm10,mBC-0716-1
"A10,D11",926996,1026995,636140,390855,539984,0,324240,324700,260412,64288,4.050709308,181560,64121,45503,21733,7,21726,3,2062,0,0.001104667,mm10,mBC-0716-1
"A10,D12",19602,20068,15150,4918,10660,0,4778,4786,3291,1495,2.201337793,2240,2511,1472,740,1,739,1,187,0,0.081190798,empty,mBC-0716-1
"A10,E1",20831,20971,15966,5005,11109,0,4803,4812,3416,1396,2.446991404,2232,1506,803,423,0,423,0,141,0,0.042553191,empty,mBC-0716-1
"A10,E2",15609,15613,11884,3729,8423,0,3757,3764,2649,1115,2.375784753,1707,1316,854,458,0,458,0,136,0,0.019650655,empty,mBC-0716-1
"A10,E3",12058,12639,9217,3422,6754,0,3112,3120,2189,931,2.351235231,1542,1091,713,395,1,394,1,136,0,0.093908629,empty,mBC-0716-1
"A10,E4",14832,15062,11296,3766,7984,0,3569,3581,2484,1097,2.264357338,1654,843,561,299,0,299,0,111,0,0.043478261,empty,mBC-0716-1
"A10,E5",20584,21033,15966,5067,11143,0,4918,4936,3481,1455,2.392439863,2268,1123,773,388,0,388,0,122,0,0.072164948,empty,mBC-0716-1
"A10,E6",12328,12494,9405,3089,6755,0,2996,3006,2074,932,2.225321888,1419,1112,705,353,1,352,1,95,0,0.051136364,empty,mBC-0716-1
"A10,E7",12944,13235,9946,3289,7149,0,3205,3216,2180,1036,2.104247104,1528,1258,660,322,0,322,0,99,0,0.040372671,empty,mBC-0716-1
"A10,E8",16611,16999,12757,4242,9112,0,4011,4019,2794,1225,2.280816327,1894,1576,864,446,0,446,0,144,0,0.058295964,empty,mBC-0716-1
"A10,E9",8694,9015,6508,2507,4889,0,2319,2322,1638,684,2.394736842,1111,966,601,306,0,306,0,88,0,0.091503268,empty,mBC-0716-1
"A10,E10",1137129,1238294,813271,425023,661444,0,377968,378498,284307,94191,3.018409402,205513,30926,20190,9552,3,9549,1,1315,0,0.009843963,mm10,mBC-0716-1
"A10,E11",8746,8909,6496,2413,4839,0,2255,2260,1590,670,2.373134328,1096,18416,5327,2705,4,2701,2,387,0,0.169566827,empty,mBC-0716-1
"A10,E12",14138,14631,10760,3871,7841,0,3577,3585,2467,1118,2.206618962,1752,971,590,289,0,289,0,91,0,0.121107266,empty,mBC-0716-1
"A10,F1",2244156,2507341,1561209,946132,1294121,3,788012,789122,592308,196814,3.009481033,445872,106809,76970,36369,15,36354,1,2919,0,0.000522638,mm10,mBC-0716-1
"A10,F2",21412,21826,16119,5707,11660,0,5393,5408,3808,1600,2.38,2567,13778,4794,2413,0,2413,0,453,0,0.049730626,empty,mBC-0716-1
"A10,F3",15644,16221,11763,4458,8711,0,4074,4079,2829,1250,2.2632,2003,5133,2069,1120,2,1118,1,251,0,0.113595707,empty,mBC-0716-1
"A10,F4",16086,16085,11929,4156,8895,0,4071,4077,2839,1238,2.293214863,1955,526,367,232,0,232,0,80,0,0.086206897,empty,mBC-0716-1
"A10,F5",659806,713644,477649,235995,384001,1,211911,212212,157713,54499,2.893869612,112715,21797,14549,7044,5,7039,1,1028,0,0.001704788,mm10,mBC-0716-1
"A10,F6",22522,23023,17090,5933,12356,0,5608,5623,3891,1732,2.246535797,2694,1722,1081,532,0,532,0,155,0,0.003759398,empty,mBC-0716-1
"A10,F7",19058,19694,14618,5076,10600,0,4846,4859,3399,1460,2.328082192,2300,1617,780,414,0,414,0,114,0,0.028985507,empty,mBC-0716-1
"A10,F8",1001654,1115223,680415,434808,589749,3,361106,361579,296487,65092,4.554891538,204116,9710,6594,2990,1,2989,1,530,0,0.00100368,mm10,mBC-0716-1
"A10,F9",14167,14466,10823,3643,7835,0,3446,3449,2442,1007,2.425024826,1630,1522,1018,526,0,526,0,162,0,0.015209125,empty,mBC-0716-1
"A10,F10",504775,501411,394777,106634,270464,1,108088,108355,87352,21003,4.159024901,48925,21984,14923,7283,0,7283,0,1010,0,0.007002609,mm10,mBC-0716-1
"A10,F11",531456,562859,396441,166418,303793,0,151601,151821,108119,43702,2.474005766,77302,58624,42279,20306,4,20302,1,2011,0,0.00118215,mm10,mBC-0716-1
"A10,F12",13340,13765,10016,3749,7122,0,3282,3284,2302,982,2.344195519,1588,95,59,42,1,41,1,17,0,0.243902439,empty,mBC-0716-1
"A10,G1",9818,10116,7482,2634,5361,0,2394,2395,1699,696,2.441091954,1136,1386,946,497,0,497,0,116,0,0.046277666,empty,mBC-0716-1
"A10,G2",20197,20569,15595,4974,10699,0,4733,4743,3350,1393,2.404881551,2192,247,146,80,0,80,0,38,0,0,empty,mBC-0716-1
"A10,G3",806128,857931,595534,262397,449893,2,227281,227734,191312,36422,5.252649498,117547,134540,95567,45478,15,45463,1,3186,0,0.000879836,mm10,mBC-0716-1
"A10,G4",26872,27273,20686,6587,14181,0,6131,6155,4314,1841,2.343291689,2824,92,33,21,0,21,0,18,0,0,empty,mBC-0716-1
"A10,G5",12455,12770,9453,3317,6731,0,3088,3095,2182,913,2.38992333,1492,957,591,296,0,296,0,86,0,0.040540541,empty,mBC-0716-1
"A10,G6",23061,23618,17670,5948,12641,0,5572,5593,3929,1664,2.361177885,2657,153,110,61,0,61,0,33,0,0,empty,mBC-0716-1
"A10,G7",19850,19838,15296,4542,10417,0,4552,4555,3226,1329,2.427389014,2029,6122,2716,1444,2,1442,1,251,0,0.279472954,empty,mBC-0716-1
"A10,G8",14065,14581,10680,3901,7798,1,3640,3651,2449,1202,2.037437604,1808,2072,1047,511,0,511,0,145,0,0.033268102,empty,mBC-0716-1
"A10,G9",10633,11048,8113,2935,5754,0,2678,2681,1886,795,2.372327044,1278,1023,680,333,0,333,0,110,0,0.09009009,empty,mBC-0716-1
"A10,G10",13234,13576,10103,3473,7135,0,3195,3205,2232,973,2.29393628,1476,1038,655,327,0,327,0,102,0,0.094801223,empty,mBC-0716-1
"A10,G11",504360,517802,388378,129424,279059,0,126297,126531,90304,36227,2.49272642,60609,15761,10935,5312,2,5310,2,833,0,0.00094162,mm10,mBC-0716-1
"A10,G12",1329497,1457128,949975,507153,777804,2,439201,439872,336514,103358,3.255809903,241538,144036,97781,47347,17,47330,2,3386,0,0.001014156,mm10,mBC-0716-1
"A10,H1",20160,20824,15411,5413,11169,0,5110,5117,3616,1501,2.409060626,2481,818,463,253,0,253,0,91,0,0.098814229,empty,mBC-0716-1
"A10,H2",23796,24269,18136,6133,12793,0,5683,5705,4038,1667,2.422315537,2772,4005,1753,880,1,879,1,207,0,0.080773606,empty,mBC-0716-1
"A10,H3",601766,649827,438543,211284,348843,1,181825,182104,131177,50927,2.575784947,98198,47366,31528,14806,8,14798,2,1598,0,0.008717394,mm10,mBC-0716-1
"A10,H4",12305,12860,9269,3591,6871,0,3191,3195,2190,1005,2.179104478,1576,90,63,35,0,35,0,19,0,0,empty,mBC-0716-1
"A10,H5",1683341,1846215,1175722,670493,956307,3,557086,557852,456936,100916,4.527884577,308138,162015,105807,50655,16,50639,3,3511,0,0.001599558,mm10,mBC-0716-1
"A10,H6",12714,12895,9575,3320,6999,0,3218,3223,2232,991,2.252270434,1533,1115,733,414,0,414,0,151,0,0.048309179,empty,mBC-0716-1
"A10,H7",586487,634483,404761,229722,344467,1,202533,202816,155675,47141,3.302327061,112249,5415,3772,1746,2,1744,1,419,0,0.009174312,mm10,mBC-0716-1
"A10,H8",832151,843340,629185,214155,450880,0,208738,209113,163227,45886,3.557228784,101267,16463,11589,5644,1,5643,1,945,0,0.006202375,mm10,mBC-0716-1
"A10,H9",15415,15696,11617,4079,8482,1,3853,3863,2759,1104,2.499094203,1886,1158,708,338,0,338,0,111,0,0.00887574,empty,mBC-0716-1
"A10,H10",13533,13824,10130,3694,7334,0,3315,3317,2310,1007,2.293942403,1571,12899,3884,2034,3,2031,2,348,0,0.068439193,empty,mBC-0716-1
"A10,H11",16317,17001,12341,4660,8987,0,4140,4157,2909,1248,2.330929487,1978,234,160,99,0,99,0,42,0,0.01010101,empty,mBC-0716-1
"A10,H12",5607,5787,4239,1548,3212,0,1517,1520,1049,471,2.227176221,731,544,334,189,1,188,1,56,0,0.106382979,empty,mBC-0716-1
"A11,A1",9255,9724,6990,2734,5283,0,2568,2570,1854,716,2.589385475,1260,692,374,199,0,199,0,87,0,0.045226131,empty,mBC-0716-1
"A11,A2",131023,117872,112929,4943,65661,0,6852,6894,4686,2208,2.122282609,2182,1640,1049,449,0,449,0,167,0,0.053452116,empty,mBC-0716-1
"A11,A3",10444,10519,7829,2690,5710,0,2673,2681,1880,801,2.347066167,1257,580,358,200,0,200,0,71,0,0.02,empty,mBC-0716-1
"A11,A4",13037,13157,10070,3087,7065,0,2989,2996,2100,896,2.34375,1381,244,185,105,0,105,0,44,0,0.057142857,empty,mBC-0716-1
"A11,A5",10575,10908,8136,2772,5806,0,2518,2523,1763,760,2.319736842,1219,745,517,265,0,265,0,82,0,0.056603774,empty,mBC-0716-1
"A11,A6",411115,470197,274173,196024,250956,0,157361,157539,124376,33163,3.750444773,91812,63440,37964,18442,12,18430,2,1950,0,0.001790559,mm10,mBC-0716-1
"A11,A7",775774,847573,564911,282662,454768,0,247796,248158,177751,70407,2.524621131,132919,46494,31352,14760,10,14750,2,1663,0,0.002847458,mm10,mBC-0716-1
"A11,A8",336456,371982,236072,135910,200682,0,115322,115460,97298,18162,5.35722938,63630,47636,32064,15433,8,15425,2,1734,0,0.000388979,mm10,mBC-0716-1
"A11,A9",11516,11705,8808,2897,6211,0,2736,2736,1880,856,2.196261682,1304,580,334,176,0,176,0,66,0,0.0625,empty,mBC-0716-1
"A11,A10",9882,10181,7368,2813,5383,0,2471,2474,1732,742,2.334231806,1241,681,296,179,0,179,0,43,0,0.17877095,empty,mBC-0716-1
"A11,A11",11098,11186,8527,2659,6067,0,2665,2675,1863,812,2.294334975,1239,797,506,254,1,253,1,75,0,0.011857708,empty,mBC-0716-1
"A11,A12",12656,12654,9732,2922,6764,0,2947,2953,2080,873,2.382588774,1403,1403,811,393,0,393,0,112,0,0.10178117,empty,mBC-0716-1
"A11,B1",792164,909382,516401,392981,473228,1,307689,308083,217191,90892,2.389550235,183158,42444,29798,13958,1,13957,1,1581,0,0,mm10,mBC-0716-1
"A11,B2",12430,12520,9529,2991,6699,0,3003,3010,2094,916,2.286026201,1394,1952,616,336,0,336,0,85,0,0.032738095,empty,mBC-0716-1
"A11,B3",13842,14118,10571,3547,7686,0,3539,3546,2586,960,2.69375,1701,620,445,239,0,239,0,83,0,0.025104603,empty,mBC-0716-1
"A11,B4",10526,10856,8062,2794,5672,0,2487,2493,1750,743,2.355316285,1214,623,386,215,1,214,1,77,0,0.074766355,empty,mBC-0716-1
"A11,B5",6103,3915,2727,1188,2679,0,1252,1260,877,383,2.289817232,698,359,221,112,0,112,0,46,0,0.151785714,empty,mBC-0716-1
"A11,B6",7444,7841,5567,2274,4148,0,1910,1917,1339,578,2.316608997,962,455,301,162,0,162,0,63,0,0.037037037,empty,mBC-0716-1
"A11,B7",10186,10318,7724,2594,5510,0,2435,2443,1694,749,2.261682243,1122,910,417,229,0,229,0,68,0,0.07860262,empty,mBC-0716-1
"A11,B8",8661,8942,6710,2232,4771,0,2160,2162,1545,617,2.504051864,998,2905,1079,567,1,566,1,155,0,0.042402827,empty,mBC-0716-1
"A11,B9",9340,9446,7226,2220,4894,0,2138,2148,1499,649,2.309707242,942,2083,712,383,1,382,1,92,0,0.015706806,empty,mBC-0716-1
"A11,B10",10338,10301,7586,2715,5561,0,2507,2520,1731,789,2.19391635,1207,2697,871,412,1,411,1,89,0,0.00973236,empty,mBC-0716-1
"A11,B11",10532,10957,7950,3007,5836,0,2694,2700,1976,724,2.729281768,1368,162,80,51,0,51,0,26,0,0,empty,mBC-0716-1
"A11,B12",11481,12153,8714,3439,6406,0,2948,2956,2075,881,2.355278093,1461,744,461,258,0,258,0,86,0,0.031007752,empty,mBC-0716-1
"A11,C1",14378,14334,11221,3113,7524,0,3081,3094,2090,1004,2.081673307,1379,470,321,178,0,178,0,65,0,0,empty,mBC-0716-1
"A11,C2",373042,392840,274759,118081,211273,0,104420,104568,89312,15256,5.85422129,53968,56726,39841,18830,8,18822,2,1895,0,0.002018914,mm10,mBC-0716-1
"A11,C3",14904,15329,11293,4036,8095,0,3729,3736,2683,1053,2.547958215,1782,317,206,105,0,105,0,48,0,0,empty,mBC-0716-1
"A11,C4",451749,466848,337139,129709,249547,1,118427,118603,96796,21807,4.438758197,58713,78102,53840,25376,11,25365,1,2269,0,0.001379854,mm10,mBC-0716-1
"A11,C5",10938,11312,8145,3167,6103,1,2899,2906,2075,831,2.496991576,1462,662,436,229,0,229,0,65,0,0.096069869,empty,mBC-0716-1
"A11,C6",12668,12995,9481,3514,7280,0,3468,3476,2520,956,2.635983264,1679,4833,1548,793,1,792,1,177,0,0.037878788,empty,mBC-0716-1
"A11,C7",10282,10884,7652,3232,5886,0,2829,2839,2008,831,2.416365824,1427,250,149,81,0,81,0,38,0,0,empty,mBC-0716-1
"A11,C8",447325,497439,310766,186673,267632,0,155391,155571,106735,48836,2.18558031,88806,34010,23363,11132,7,11125,3,1373,0,0.001438202,mm10,mBC-0716-1
"A11,C9",7666,7927,5759,2168,4169,0,1938,1941,1330,611,2.176759411,964,2167,651,350,0,350,0,85,0,0.082857143,empty,mBC-0716-1
"A11,C10",8705,8949,6742,2207,4766,0,2165,2167,1504,663,2.268476621,1001,1839,716,382,1,381,1,100,0,0.028871391,empty,mBC-0716-1
"A11,C11",7434,7636,5642,1994,4132,0,1960,1963,1358,605,2.244628099,940,587,410,194,0,194,0,67,0,0.036082474,empty,mBC-0716-1
"A11,C12",423402,445372,319549,125823,235525,1,111163,111353,94177,17176,5.483057755,55856,54666,36108,17072,6,17066,2,1755,0,0.014883394,mm10,mBC-0716-1
"A11,D1",6996,7407,5244,2163,4075,0,1959,1964,1428,536,2.664179104,1009,373,260,122,0,122,0,33,0,0.131147541,empty,mBC-0716-1
"A11,D2",13047,13117,10066,3051,6919,0,3048,3054,2188,866,2.526558891,1350,3019,1362,729,0,729,0,190,0,0.087791495,empty,mBC-0716-1
"A11,D3",8559,8919,6381,2538,4743,0,2239,2244,1567,677,2.314623338,1069,489,263,159,0,159,0,73,0,0,empty,mBC-0716-1
"A11,D4",9869,9986,7505,2481,5441,0,2554,2562,1869,693,2.696969697,1186,614,388,208,0,208,0,74,0,0.014423077,empty,mBC-0716-1
"A11,D5",8722,9096,6569,2527,4924,0,2274,2276,1596,680,2.347058824,1139,988,490,281,1,280,1,97,0,0.046428571,empty,mBC-0716-1
"A11,D6",374062,408824,266509,142315,219557,0,121736,121900,101131,20769,4.869324474,66294,38974,25508,12153,8,12145,1,1462,0,0.002223137,mm10,mBC-0716-1
"A11,D7",8372,8550,6277,2273,4558,0,2077,2082,1467,615,2.385365854,1005,913,667,362,0,362,0,116,0,0.002762431,empty,mBC-0716-1
"A11,D8",980073,1054937,710189,344748,555762,1,295805,296218,249347,46871,5.319856628,157388,77778,53949,25255,7,25248,1,2390,0,0.002495247,mm10,mBC-0716-1
"A11,D9",3155,3457,2336,1121,1939,0,997,997,701,296,2.368243243,511,852,519,247,0,247,0,97,0,0.024291498,empty,mBC-0716-1
"A11,D10",840245,956114,574366,381748,508064,0,311468,311924,256055,55869,4.583131969,178791,86495,56036,26858,9,26849,1,2547,0,0.000931133,mm10,mBC-0716-1
"A11,D11",8370,8523,6290,2233,4594,0,2103,2115,1488,627,2.373205742,1018,1001,664,350,0,350,0,105,0,0.045714286,empty,mBC-0716-1
"A11,D12",2369122,2557313,1702189,855124,1297933,1,738355,739472,582119,157353,3.699446467,394300,177555,123020,58506,24,58482,4,3844,0,0.001248247,mm10,mBC-0716-1
"A11,E1",13828,13857,10536,3321,7438,0,3312,3320,2325,995,2.336683417,1526,759,408,246,0,246,0,118,0,0.069105691,empty,mBC-0716-1
"A11,E2",10209,10360,7820,2540,5603,0,2550,2554,1780,774,2.299741602,1240,3519,1377,666,1,665,1,158,0,0.052631579,empty,mBC-0716-1
"A11,E3",7772,7997,5996,2001,4280,0,1918,1924,1289,635,2.02992126,914,1076,645,290,0,290,0,92,0,0.010344828,empty,mBC-0716-1
"A11,E4",9649,9898,7373,2525,5126,0,2366,2367,1724,643,2.68118196,1115,729,434,240,0,240,0,93,0,0.075,empty,mBC-0716-1
"A11,E5",809139,899545,544983,354562,470658,0,293536,293924,220160,73764,2.984653761,166309,22114,15555,7267,6,7261,2,1011,0,0.000137722,mm10,mBC-0716-1
"A11,E6",8495,8851,6406,2445,4670,0,2121,2122,1490,632,2.357594937,1046,1165,551,291,0,291,0,91,0,0.065292096,empty,mBC-0716-1
"A11,E7",9153,9278,6974,2304,4989,0,2220,2224,1590,634,2.507886435,1037,555,352,191,0,191,0,73,0,0.020942408,empty,mBC-0716-1
"A11,E8",11269,11614,8675,2939,6267,0,2823,2824,1980,844,2.345971564,1377,1052,660,333,1,332,1,115,0,0.114457831,empty,mBC-0716-1
"A11,E9",5778,5906,4414,1492,3176,0,1482,1482,1013,469,2.159914712,703,614,383,207,0,207,0,72,0,0.120772947,empty,mBC-0716-1
"A11,E10",8131,8338,6112,2226,4451,0,2084,2091,1418,673,2.106983655,1005,876,559,297,0,297,0,86,0,0.084175084,empty,mBC-0716-1
"A11,E11",5797,6043,4319,1724,3276,0,1524,1524,1088,436,2.495412844,776,621,393,212,0,212,0,76,0,0.056603774,empty,mBC-0716-1
"A11,E12",9499,9741,7088,2653,5298,0,2543,2548,1745,803,2.173100872,1254,531,318,169,0,169,0,75,0,0.100591716,empty,mBC-0716-1
"A11,F1",11111,11632,8438,3194,6159,0,2816,2830,1971,859,2.294528522,1415,1016,505,244,0,244,0,77,0,0.114754098,empty,mBC-0716-1
"A11,F2",881470,934340,646519,287821,494916,1,255616,255999,206377,49622,4.158981903,132887,197046,117920,56561,33,56528,8,3857,0,0.006810784,mm10,mBC-0716-1
"A11,F3",1296061,1421080,916014,505066,747910,1,428243,428842,354816,74026,4.793126739,235934,115893,81667,39246,19,39227,3,3096,0,0.000968721,mm10,mBC-0716-1
"A11,F4",10674,10761,7947,2814,6022,0,2771,2779,1932,847,2.280991736,1319,425,262,169,0,169,0,73,0,0.041420118,empty,mBC-0716-1
"A11,F5",15131,15467,11579,3888,8207,0,3749,3754,2668,1086,2.456721915,1790,721,470,253,0,253,0,88,0,0.027667984,empty,mBC-0716-1
"A11,F6",14817,15119,11118,4001,8087,1,3667,3682,2640,1042,2.533589251,1751,1408,754,403,0,403,0,138,0,0.076923077,empty,mBC-0716-1
"A11,F7",1525145,1602944,1124117,478827,847832,1,441710,442546,357883,84663,4.227147632,226173,55207,34641,16634,5,16629,2,1970,0,0.004089242,mm10,mBC-0716-1
"A11,F8",14325,14407,10962,3445,7725,0,3371,3381,2400,981,2.44648318,1535,173,123,52,0,52,0,28,0,0,empty,mBC-0716-1
"A11,F9",9761,10166,7480,2686,5385,0,2453,2458,1728,730,2.367123288,1172,794,508,256,0,256,0,103,0,0.12109375,empty,mBC-0716-1
"A11,F10",12885,12902,9847,3055,6917,0,2985,2996,2162,834,2.592326139,1401,774,523,258,0,258,0,99,0,0.062015504,empty,mBC-0716-1
"A11,F11",7834,8137,5978,2159,4336,0,1952,1954,1348,606,2.224422442,970,800,503,260,0,260,0,82,0,0.046153846,empty,mBC-0716-1
"A11,F12",8606,8972,6559,2413,4685,0,2176,2179,1542,637,2.420722135,1034,93,57,29,0,29,0,14,0,0,empty,mBC-0716-1
"A11,G1",6272,6382,4902,1480,3471,0,1513,1515,1058,457,2.315098468,690,1103,714,384,0,384,0,112,0,0.020833333,empty,mBC-0716-1
"A11,G2",12547,12669,9600,3069,6698,0,2821,2825,2014,811,2.483353884,1326,260,182,109,0,109,0,51,0,0.036697248,empty,mBC-0716-1
"A11,G3",532539,596888,365148,231740,315590,1,189118,189335,149114,40221,3.707366798,107515,43082,29405,14363,4,14359,1,1588,0,0.003482137,mm10,mBC-0716-1
"A11,G4",598048,636692,441884,194808,334980,1,168746,169069,143707,25362,5.666232947,86984,465,333,183,0,183,0,55,0,0,empty,mBC-0716-1
"A11,G5",8270,8449,6315,2134,4573,0,2071,2083,1427,656,2.175304878,971,1941,802,421,0,421,0,120,0,0.045130641,empty,mBC-0716-1
"A11,G6",16261,16413,12125,4288,8474,0,3877,3888,2720,1168,2.328767123,1844,922,307,167,0,167,0,43,0,0.101796407,empty,mBC-0716-1
"A11,G7",569382,598289,425495,172794,315625,1,154336,154626,134686,19940,6.754563691,77653,101095,66596,31448,18,31430,4,2594,0,0.00944957,mm10,mBC-0716-1
"A11,G8",9217,9523,6950,2573,5056,0,2380,2390,1700,690,2.463768116,1159,923,612,300,0,300,0,101,0,0.066666667,empty,mBC-0716-1
"A11,G9",6891,6835,5234,1601,3636,0,1653,1655,1159,496,2.336693548,772,825,562,277,0,277,0,97,0,0.061371841,empty,mBC-0716-1
"A11,G10",480844,534369,337467,196902,285240,0,162980,163208,133057,30151,4.413021127,90270,68503,48992,23200,6,23194,1,2230,0,0.00056049,mm10,mBC-0716-1
"A11,G11",7687,7724,5984,1740,4138,0,1855,1855,1346,509,2.644400786,781,396,260,140,0,140,0,58,0,0,empty,mBC-0716-1
"A11,G12",441620,479808,313578,166230,259562,0,141537,141760,123517,18243,6.770651757,77175,80243,57534,27694,19,27675,2,2358,0,0.002854562,mm10,mBC-0716-1
"A11,H1",507518,571208,345326,225882,302670,1,181863,182110,156909,25201,6.226300544,102842,60468,42982,20566,8,20558,1,2035,0,0.000826929,mm10,mBC-0716-1
"A11,H2",380311,389572,289417,100155,209537,0,96113,96301,72272,24029,3.00769903,47292,9146,5658,2655,0,2655,0,545,0,0.009039548,mm10,mBC-0716-1
"A11,H3",12570,12607,9557,3050,6784,0,3043,3058,2126,932,2.28111588,1419,1977,848,470,0,470,0,115,0,0.180851064,empty,mBC-0716-1
"A11,H4",8494,8940,6352,2588,4762,0,2258,2269,1543,726,2.125344353,1132,159,56,38,1,37,1,17,0,0,empty,mBC-0716-1
"A11,H5",11654,12200,8903,3297,6464,0,3012,3027,2109,918,2.297385621,1446,749,376,242,0,242,0,108,0,0.061983471,empty,mBC-0716-1
"A11,H6",9787,10211,7460,2751,5556,1,2595,2598,1878,720,2.608333333,1278,745,494,262,0,262,0,104,0,0.057251908,empty,mBC-0716-1
"A11,H7",11031,11493,8329,3164,6234,0,2912,2916,2086,830,2.513253012,1434,932,536,278,0,278,0,113,0,0.010791367,empty,mBC-0716-1
"A11,H8",8042,8135,6064,2071,4542,0,2158,2166,1547,619,2.499192246,1066,828,483,247,0,247,0,90,0,0.060728745,empty,mBC-0716-1
"A11,H9",10174,10445,7717,2728,5673,0,2670,2674,1881,793,2.372005044,1321,567,379,180,0,180,0,76,0,0,empty,mBC-0716-1
"A11,H10",391380,453586,259890,193696,242376,2,153609,153798,114109,39689,2.875078737,91324,33145,22846,11290,2,11288,2,1299,0,0.001417434,mm10,mBC-0716-1
"A11,H11",470253,495683,348754,146929,263499,3,130045,130293,105628,24665,4.282505575,66561,444,259,132,0,132,0,56,0,0,empty,mBC-0716-1
"A11,H12",3843,3938,2939,999,2149,0,980,981,655,326,2.009202454,472,217,103,78,0,78,0,45,0,0.038461538,empty,mBC-0716-1
"A12,A1",11281,11505,8559,2946,6376,0,2978,2987,2091,896,2.333705357,1465,769,509,253,0,253,0,76,0,0.090909091,empty,mBC-0716-1
"A12,A2",14758,14922,11222,3700,7909,0,3499,3511,2564,947,2.70749736,1622,1101,574,308,0,308,0,94,0,0.012987013,empty,mBC-0716-1
"A12,A3",12520,12915,9470,3445,7007,0,3241,3243,2213,1030,2.148543689,1572,768,475,246,0,246,0,78,0,0.024390244,empty,mBC-0716-1
"A12,A4",16409,16455,12688,3767,8669,0,3714,3718,2618,1100,2.38,1692,495,332,167,0,167,0,48,0,0.083832335,empty,mBC-0716-1
"A12,A5",12867,13327,9954,3373,7139,0,3231,3240,2237,1003,2.230309073,1557,1188,784,414,0,414,0,97,0,0.053140097,empty,mBC-0716-1
"A12,A6",558711,592949,417463,175486,315278,0,152547,152795,128111,24684,5.190042133,77669,98791,70833,33944,15,33929,1,2788,0,0.000795779,mm10,mBC-0716-1
"A12,A7",12451,13184,9524,3660,7102,0,3265,3277,2205,1072,2.056902985,1615,9743,3066,1527,1,1526,1,274,0,0.047182176,empty,mBC-0716-1
"A12,A8",8491,8951,6486,2465,4852,0,2298,2299,1629,670,2.431343284,1153,1161,750,367,0,367,0,110,0,0.032697548,empty,mBC-0716-1
"A12,A9",14265,14396,10949,3447,7594,0,3335,3340,2328,1012,2.300395257,1559,724,397,224,0,224,0,75,0,0.053571429,empty,mBC-0716-1
"A12,A10",674086,769220,436444,332776,409195,0,264381,264721,198917,65804,3.02287095,154934,33311,21289,10178,10,10168,3,1309,0,0.003245476,mm10,mBC-0716-1
"A12,A11",13973,14268,10696,3572,7645,0,3350,3354,2295,1059,2.16713881,1656,1221,748,391,0,391,0,97,0,0.104859335,empty,mBC-0716-1
"A12,A12",15589,15915,12219,3696,8404,0,3609,3623,2526,1097,2.302643573,1647,2026,1233,618,0,618,0,140,0,0.064724919,empty,mBC-0716-1
"A12,B1",592381,642835,430626,212209,344443,0,183095,183379,152065,31314,4.856134636,97874,77354,51448,24655,8,24647,3,2321,0,0.00210979,mm10,mBC-0716-1
"A12,B2",700312,775793,498388,277405,412272,5,231346,231703,186597,45106,4.136855407,126486,32995,22473,10571,3,10568,1,1350,0,0.001892506,mm10,mBC-0716-1
"A12,B3",14218,14649,10645,4004,7888,0,3660,3663,2532,1131,2.23872679,1837,1114,682,317,0,317,0,99,0,0.1829653,empty,mBC-0716-1
"A12,B4",12318,12586,9574,3012,6858,0,3068,3070,2084,986,2.113590264,1390,797,470,245,0,245,0,100,0,0.073469388,empty,mBC-0716-1
"A12,B5",8495,6072,4193,1879,3926,0,1904,1912,1309,603,2.170812604,1042,463,318,152,0,152,0,68,0,0.065789474,empty,mBC-0716-1
"A12,B6",9304,9835,7091,2744,5241,0,2472,2475,1673,802,2.086034913,1202,1155,758,393,0,393,0,90,0,0.094147583,empty,mBC-0716-1
"A12,B7",12431,12862,9522,3340,6902,0,3044,3057,2104,953,2.207764953,1463,883,568,286,0,286,0,77,0,0.066433566,empty,mBC-0716-1
"A12,B8",10530,10832,8014,2818,5852,0,2595,2607,1847,760,2.430263158,1256,11040,3281,1650,2,1648,1,294,0,0.030946602,empty,mBC-0716-1
"A12,B9",11555,12331,8686,3645,6451,0,3002,3006,2044,962,2.124740125,1582,516,367,176,0,176,0,67,0,0.0625,empty,mBC-0716-1
"A12,B10",447066,433983,308491,125492,241295,3,113920,114553,74044,40509,1.827840727,59964,14610,10061,4851,3,4848,2,710,0,0.011138614,mm10,mBC-0716-1
"A12,B11",12524,13156,9462,3694,7108,0,3359,3366,2358,1008,2.339285714,1694,202,134,72,0,72,0,28,0,0,empty,mBC-0716-1
"A12,B12",13926,14138,10646,3492,7615,0,3437,3441,2443,998,2.447895792,1625,894,535,307,0,307,0,91,0,0.042345277,empty,mBC-0716-1
"A12,C1",17109,17589,13265,4324,9315,0,3996,4010,2861,1149,2.489991297,1903,1585,682,351,0,351,0,76,0,0.056980057,empty,mBC-0716-1
"A12,C2",581581,622019,422338,199681,332957,0,171902,172205,141741,30464,4.652737658,90936,121668,84524,40399,9,40390,3,2997,0,0.000940827,mm10,mBC-0716-1
"A12,C3",16683,17209,12645,4564,9287,0,4412,4424,3095,1329,2.328818661,2179,762,291,142,0,142,0,49,0,0.091549296,empty,mBC-0716-1
"A12,C4",13831,13881,10436,3445,7527,0,3476,3478,2418,1060,2.281132075,1613,1057,593,339,0,339,0,107,0,0.041297935,empty,mBC-0716-1
"A12,C5",13318,13807,10031,3776,7323,0,3427,3437,2445,992,2.464717742,1678,908,612,319,0,319,0,90,0,0.087774295,empty,mBC-0716-1
"A12,C6",12890,13247,9567,3680,7384,0,3503,3514,2460,1054,2.333965844,1771,3251,1246,625,0,625,0,155,0,0.0704,empty,mBC-0716-1
"A12,C7",503655,566371,352946,213425,307241,1,178769,179007,144188,34819,4.141072403,100985,23052,15525,7517,3,7514,2,985,0,0.007985094,mm10,mBC-0716-1
"A12,C8",11349,11789,8467,3322,6363,0,2925,2929,2013,916,2.197598253,1471,1269,862,452,0,452,0,130,0,0.088495575,empty,mBC-0716-1
"A12,C9",9674,10200,7315,2885,5442,0,2614,2622,1834,788,2.327411168,1283,527,345,163,0,163,0,50,0,0.036809816,empty,mBC-0716-1
"A12,C10",832241,944136,553251,390885,497559,0,314634,315050,252713,62337,4.053980782,181957,80756,58133,27700,6,27694,1,2324,0,0.000758287,mm10,mBC-0716-1
"A12,C11",8833,8986,6706,2280,4932,1,2291,2295,1563,732,2.135245902,1083,737,459,231,0,231,0,71,0,0.025974026,empty,mBC-0716-1
"A12,C12",15229,15515,11554,3961,8352,0,3772,3779,2640,1139,2.317822651,1804,2600,990,516,1,515,1,111,0,0.093203883,empty,mBC-0716-1
"A12,D1",322007,344263,236797,107466,189355,0,93739,93891,78095,15796,4.943973158,49429,62237,42555,20283,3,20280,1,1962,0,0.001134122,mm10,mBC-0716-1
"A12,D2",15620,16205,12072,4133,8592,0,3745,3747,2658,1089,2.44077135,1797,1702,1092,557,2,555,1,138,0,0.027027027,empty,mBC-0716-1
"A12,D3",10788,11304,8169,3135,6048,0,2827,2827,1969,858,2.294871795,1419,938,560,303,0,303,0,109,0,0.072607261,empty,mBC-0716-1
"A12,D4",11096,11581,8280,3301,6205,0,2929,2933,2024,909,2.226622662,1494,1584,716,387,1,386,1,99,0,0.046632124,empty,mBC-0716-1
"A12,D5",10443,10815,7825,2990,5908,0,2791,2796,1936,860,2.251162791,1373,923,558,299,0,299,0,99,0,0.053511706,empty,mBC-0716-1
"A12,D6",348063,374538,254056,120482,205806,0,109592,109738,80567,29171,2.761886805,58268,20566,14588,6912,3,6909,2,956,0,0.003184252,mm10,mBC-0716-1
"A12,D7",10149,10366,7770,2596,5643,0,2586,2588,1830,758,2.414248021,1232,1425,983,504,0,504,0,142,0,0.035714286,empty,mBC-0716-1
"A12,D8",12093,12553,9197,3356,6695,0,3048,3055,2116,939,2.253461129,1496,704,467,256,0,256,0,84,0,0.0703125,empty,mBC-0716-1
"A12,D9",3859,4099,2932,1167,2293,0,1101,1101,787,314,2.506369427,532,1120,649,328,0,328,0,105,0,0.131097561,empty,mBC-0716-1
"A12,D10",11021,11594,8319,3275,6293,0,3003,3004,2063,941,2.192348565,1498,642,346,180,0,180,0,70,0,0.005555556,empty,mBC-0716-1
"A12,D11",10013,10214,7560,2654,5580,0,2567,2573,1777,796,2.23241206,1228,1346,813,396,0,396,0,121,0,0.050505051,empty,mBC-0716-1
"A12,D12",15454,15605,11718,3887,8423,0,3663,3671,2645,1026,2.57797271,1715,2110,1356,679,0,679,0,163,0,0.107511046,empty,mBC-0716-1
"A12,E1",16966,17332,12908,4424,9190,0,4021,4027,2836,1191,2.381192275,1933,1234,743,378,1,377,1,124,0,0.082228117,empty,mBC-0716-1
"A12,E2",12738,13268,9718,3550,7239,0,3397,3404,2406,998,2.410821643,1695,3615,1335,656,0,656,0,160,0,0.033536585,empty,mBC-0716-1
"A12,E3",9268,9665,7081,2584,5331,0,2496,2499,1727,772,2.237046632,1206,1034,645,343,0,343,0,115,0,0.020408163,empty,mBC-0716-1
"A12,E4",2207102,2397235,1576283,820952,1227345,6,697627,698627,572627,126000,4.54465873,376008,339138,234259,112402,43,112359,5,5253,0,0.000952305,mm10,mBC-0716-1
"A12,E5",15677,16038,12123,3915,8659,0,3802,3807,2635,1172,2.248293515,1802,991,647,328,0,328,0,116,0,0.024390244,empty,mBC-0716-1
"A12,E6",428777,446998,318818,128180,241777,1,122127,122351,91820,30531,3.007435066,61712,10076,6635,2963,0,2963,0,523,0,0.001012487,mm10,mBC-0716-1
"A12,E7",1064138,1168459,749701,418758,616951,0,349161,349702,277130,72572,3.818690404,192929,204722,142804,67500,29,67471,6,4197,0,0.001215337,mm10,mBC-0716-1
"A12,E8",13543,13872,10550,3322,7396,0,3266,3268,2270,998,2.274549098,1507,1513,955,470,0,470,0,150,0,0.059574468,empty,mBC-0716-1
"A12,E9",7290,7660,5524,2136,4075,0,1890,1892,1355,537,2.523277467,941,986,639,287,0,287,0,91,0,0.069686411,empty,mBC-0716-1
"A12,E10",9700,9679,7485,2194,5231,0,2303,2305,1606,699,2.297567954,1048,1019,647,338,0,338,0,99,0,0.032544379,empty,mBC-0716-1
"A12,E11",7392,7449,5628,1821,4143,0,1866,1866,1317,549,2.398907104,874,14977,4804,2379,4,2375,2,382,0,0.033684211,empty,mBC-0716-1
"A12,E12",11771,12434,8945,3489,6670,0,3116,3125,2202,923,2.385698808,1578,918,582,291,0,291,0,83,0,0.04467354,empty,mBC-0716-1
"A12,F1",13452,13763,10354,3409,7340,0,3251,3256,2306,950,2.427368421,1536,1122,811,369,0,369,0,89,0,0.002710027,empty,mBC-0716-1
"A12,F2",681066,762000,467585,294415,410003,3,251739,252047,184590,67457,2.736409861,143003,31340,15137,7273,8,7265,3,1128,0,0.024776325,mm10,mBC-0716-1
"A12,F3",12934,13467,9719,3748,7322,0,3482,3489,2443,1046,2.335564054,1708,2246,1225,643,0,643,0,164,0,0.083981337,empty,mBC-0716-1
"A12,F4",399060,398088,294628,103460,221470,1,104436,104605,81363,23242,3.500688409,51052,3034,1953,881,1,880,1,215,0,0.002272727,empty,mBC-0716-1
"A12,F5",46613,52046,32927,19119,27619,0,15874,15901,7785,8116,0.959216363,8825,11477,6134,2929,1,2928,1,474,0,0.054986339,empty,mBC-0716-1
"A12,F6",412921,445089,300817,144272,243621,0,129843,130028,88945,41083,2.165007424,69676,9307,6409,3131,0,3131,0,589,0,0.022357074,mm10,mBC-0716-1
"A12,F7",15024,15674,11582,4092,8656,0,3987,4003,2764,1239,2.230831316,1930,594,386,207,0,207,0,87,0,0.004830918,empty,mBC-0716-1
"A12,F8",570763,611230,420235,190995,328261,0,169753,170007,126743,43264,2.929525703,88686,10558,6143,2993,1,2992,1,531,0,0.000334225,mm10,mBC-0716-1
"A12,F9",11834,12440,8985,3455,6770,0,3159,3168,2173,995,2.183919598,1593,1343,842,450,0,450,0,148,0,0.042222222,empty,mBC-0716-1
"A12,F10",15700,16070,12245,3825,8481,0,3616,3625,2522,1103,2.286491387,1623,932,624,319,0,319,0,109,0,0.02507837,empty,mBC-0716-1
"A12,F11",8540,8602,6630,1972,4782,0,2118,2120,1466,654,2.241590214,964,723,527,278,0,278,0,87,0,0.039568345,empty,mBC-0716-1
"A12,F12",10563,10844,7954,2890,5810,0,2681,2684,1848,836,2.210526316,1311,68,46,22,0,22,0,8,0,0,empty,mBC-0716-1
"A12,G1",7692,7969,6000,1969,4239,0,1869,1879,1259,620,2.030645161,885,1351,882,434,0,434,0,123,0,0.029953917,empty,mBC-0716-1
"A12,G2",15811,16071,12060,4011,8587,1,3833,3846,2649,1197,2.213032581,1858,476,306,160,1,159,1,54,0,0,empty,mBC-0716-1
"A12,G3",15365,15815,11719,4096,8434,0,3842,3846,2703,1143,2.364829396,1827,1515,977,471,0,471,0,146,0,0.053078556,empty,mBC-0716-1
"A12,G4",506878,517813,386434,131379,280937,0,128652,128878,92836,36042,2.57577271,62971,136,87,44,0,44,0,25,0,0,empty,mBC-0716-1
"A12,G5",10360,10641,7838,2803,5828,0,2681,2689,1857,832,2.231971154,1323,715,435,226,1,225,1,92,0,0.071111111,empty,mBC-0716-1
"A12,G6",1226402,1291890,922088,369802,678457,2,334393,334963,287936,47027,6.12278053,168310,9640,6650,3201,1,3200,1,535,0,0,mm10,mBC-0716-1
"A12,G7",15345,15681,11978,3703,8475,0,3701,3712,2673,1039,2.572666025,1722,4432,1691,869,0,869,0,192,0,0.086306099,empty,mBC-0716-1
"A12,G8",11018,11586,8286,3300,6226,0,2949,2966,2033,933,2.178992497,1455,979,644,340,0,340,0,119,0,0.044117647,empty,mBC-0716-1
"A12,G9",8214,8463,6260,2203,4511,1,2049,2053,1468,585,2.509401709,947,869,536,282,0,282,0,96,0,0.021276596,empty,mBC-0716-1
"A12,G10",10807,10806,8052,2754,5825,0,2658,2671,1938,733,2.643929059,1289,9351,3388,1634,0,1634,0,281,0,0.154222766,empty,mBC-0716-1
"A12,G11",9714,10235,7493,2742,5399,0,2423,2429,1707,722,2.364265928,1169,680,472,214,0,214,0,78,0,0,empty,mBC-0716-1
"A12,G12",8901,9484,6791,2693,5047,0,2386,2388,1667,721,2.312066574,1174,967,593,282,0,282,0,92,0,0.102836879,empty,mBC-0716-1
"A12,H1",16227,16683,12400,4283,8998,0,4063,4079,2880,1199,2.402001668,1924,792,541,282,0,282,0,82,0,0.021276596,empty,mBC-0716-1
"A12,H2",17775,18005,13649,4356,9623,0,4221,4226,2977,1249,2.383506805,1975,6696,2407,1192,1,1191,1,207,0,0.052057095,empty,mBC-0716-1
"A12,H3",15644,16431,11730,4701,8731,0,4113,4113,2895,1218,2.376847291,2107,1348,892,458,1,457,1,135,0,0.052516411,empty,mBC-0716-1
"A12,H4",10470,10753,7926,2827,5766,0,2712,2718,1851,867,2.134948097,1292,169,84,44,0,44,0,22,0,0,empty,mBC-0716-1
"A12,H5",14227,14710,10910,3800,7846,0,3619,3624,2548,1076,2.36802974,1738,2796,1114,612,0,612,0,174,0,0.12254902,empty,mBC-0716-1
"A12,H6",11120,11390,8481,2909,6299,0,2922,2928,2095,833,2.515006002,1440,1260,826,409,0,409,0,117,0,0.08801956,empty,mBC-0716-1
"A12,H7",13113,13496,9808,3688,7466,0,3532,3542,2479,1063,2.332079022,1768,1150,791,417,0,417,0,130,0,0.064748201,empty,mBC-0716-1
"A12,H8",713402,762714,502975,259739,412065,0,231908,232207,188071,44136,4.26117002,124400,11690,6554,3118,0,3118,0,675,0,0.03014753,mm10,mBC-0716-1
"A12,H9",11997,12399,9099,3300,6702,0,3090,3096,2182,914,2.387308534,1516,1000,645,340,0,340,0,102,0,0.047058824,empty,mBC-0716-1
"A12,H10",483956,489285,357024,132261,263398,0,127214,127424,99189,28235,3.512980344,63312,19424,8322,4033,0,4033,0,733,0,0.010166129,mm10,mBC-0716-1
"A12,H11",13115,13584,9903,3681,7435,0,3481,3489,2403,1086,2.212707182,1702,125,76,48,0,48,0,27,0,0,empty,mBC-0716-1
"A12,H12",4837,5171,3684,1487,2797,0,1358,1363,950,413,2.300242131,676,450,295,152,0,152,0,56,0,0.026315789,empty,mBC-0716-1
"B1,A1",1861628,2106631,1248390,858241,1113173,1,712511,713451,532382,181069,2.940216161,412315,178784,121854,56959,22,56937,4,3758,0,0.000562025,mm10,mBC-0716-1
"B1,A2",677144,752834,444720,308114,401741,2,258946,259283,189134,70149,2.696175284,149934,9851,5402,2638,0,2638,0,540,0,0.021607278,mm10,mBC-0716-1
"B1,A3",13968,14371,10590,3781,7566,0,3368,3373,2344,1029,2.277939747,1608,5757,1951,989,1,988,1,204,0,0.024291498,empty,mBC-0716-1
"B1,A4",18583,19070,14256,4814,9840,0,4388,4406,3099,1307,2.371078806,2081,3600,1123,544,4,540,1,124,0,0.042592593,empty,mBC-0716-1
"B1,A5",14316,14786,10861,3925,7790,0,3504,3506,2418,1088,2.222426471,1695,11586,3515,1701,4,1697,2,347,0,0.026517384,empty,mBC-0716-1
"B1,A6",11159,11689,8353,3336,6154,0,2955,2955,2053,902,2.276053215,1519,10720,3855,1963,2,1961,1,341,0,0.096379398,empty,mBC-0716-1
"B1,A7",567063,643188,389540,253648,346574,0,214382,214654,172196,42458,4.055678553,121446,68764,46347,21890,11,21879,1,2149,0,0.001965355,mm10,mBC-0716-1
"B1,A8",9291,9640,7138,2502,5170,0,2381,2383,1636,747,2.190093708,1139,1369,907,435,0,435,0,129,0,0.03908046,empty,mBC-0716-1
"B1,A9",16449,16919,12434,4485,8895,0,4117,4129,2890,1239,2.332526231,1968,1241,779,421,0,421,0,104,0,0.121140143,empty,mBC-0716-1
"B1,A10",13410,13686,10142,3544,7185,0,3223,3234,2220,1014,2.189349112,1535,997,350,175,1,174,1,48,0,0.005747126,empty,mBC-0716-1
"B1,A11",15059,15538,11476,4062,8355,0,3789,3805,2660,1145,2.323144105,1814,1178,800,388,0,388,0,112,0,0.092783505,empty,mBC-0716-1
"B1,A12",17848,18152,13653,4499,9541,0,4221,4232,2930,1302,2.250384025,2048,2621,1684,799,0,799,0,182,0,0.095118899,empty,mBC-0716-1
"B1,B1",16319,16345,12555,3790,8839,0,3943,3953,2787,1166,2.390222985,1826,1303,819,363,0,363,0,99,0,0.08815427,empty,mBC-0716-1
"B1,B2",715438,739819,560676,179143,389802,0,172776,173118,118545,54573,2.172228025,81835,17279,11115,5350,2,5348,1,700,0,0.000186986,mm10,mBC-0716-1
"B1,B3",688096,734016,506409,227607,388624,0,199808,200185,165392,34793,4.753599862,104399,65591,47202,22761,8,22753,2,2172,0,0.00171406,mm10,mBC-0716-1
"B1,B4",14093,14571,10694,3877,7708,0,3432,3432,2342,1090,2.148623853,1665,2267,1050,551,0,551,0,127,0,0.087114338,empty,mBC-0716-1
"B1,B5",7509,4678,3323,1355,3255,0,1614,1631,1057,574,1.841463415,888,3642,1162,580,0,580,0,132,0,0.082758621,empty,mBC-0716-1
"B1,B6",9861,10201,7511,2690,5436,0,2465,2475,1750,725,2.413793103,1172,1023,674,361,0,361,0,115,0,0.060941828,empty,mBC-0716-1
"B1,B7",14058,14342,10836,3506,7650,0,3483,3497,2445,1052,2.324144487,1624,823,563,286,1,285,1,94,0,0.098245614,empty,mBC-0716-1
"B1,B8",11399,11633,8880,2753,6273,0,2708,2713,1853,860,2.154651163,1243,950,632,339,0,339,0,118,0,0.061946903,empty,mBC-0716-1
"B1,B9",14024,14008,10434,3574,7106,0,3231,3242,2300,942,2.441613588,1518,11279,3237,1554,0,1554,0,255,0,0.171171171,empty,mBC-0716-1
"B1,B10",14245,13906,10149,3757,7801,0,3555,3575,2465,1110,2.220720721,1745,517,321,170,0,170,0,45,0,0.023529412,empty,mBC-0716-1
"B1,B11",15210,15803,11564,4239,8361,0,3865,3877,2776,1101,2.521344233,1976,129,103,62,0,62,0,33,0,0.112903226,empty,mBC-0716-1
"B1,B12",15700,15879,11840,4039,8564,0,3891,3896,2720,1176,2.31292517,1839,7248,2396,1182,1,1181,1,224,0,0.038103302,empty,mBC-0716-1
"B1,C1",19299,19689,15084,4605,10112,0,4294,4311,3057,1254,2.437799043,1915,762,480,236,0,236,0,90,0,0.016949153,empty,mBC-0716-1
"B1,C2",15946,16565,12038,4527,8751,0,4003,4012,2841,1171,2.426131512,2024,1968,1140,573,0,573,0,171,0,0.040139616,empty,mBC-0716-1
"B1,C3",17282,18100,13129,4971,9371,0,4286,4297,2918,1379,2.116026106,2127,667,281,156,0,156,0,50,0,0.012820513,empty,mBC-0716-1
"B1,C4",14809,15090,11329,3761,7975,0,3468,3479,2439,1040,2.345192308,1656,1338,760,418,1,417,1,128,0,0.110311751,empty,mBC-0716-1
"B1,C5",13969,14148,10693,3455,7481,1,3313,3331,2356,975,2.416410256,1528,1000,633,302,0,302,0,86,0,0.066225166,empty,mBC-0716-1
"B1,C6",14392,14593,10921,3672,7845,1,3493,3503,2468,1035,2.384541063,1608,1233,763,378,0,378,0,99,0,0.071428571,empty,mBC-0716-1
"B1,C7",14059,14429,10854,3575,7651,4,3427,3445,2407,1038,2.318882466,1613,286,176,99,0,99,0,39,0,0.03030303,empty,mBC-0716-1
"B1,C8",12891,13298,9875,3423,7077,0,3226,3228,2205,1023,2.15542522,1525,1537,908,476,0,476,0,144,0,0.130252101,empty,mBC-0716-1
"B1,C9",10691,10775,7972,2803,5763,0,2698,2713,1867,846,2.206855792,1333,1037,653,305,0,305,0,82,0,0.068852459,empty,mBC-0716-1
"B1,C10",11837,11935,8974,2961,6437,0,2879,2882,2011,871,2.308840413,1397,4100,1545,818,1,817,1,187,0,0.039167687,empty,mBC-0716-1
"B1,C11",10131,10483,7644,2839,5553,0,2574,2582,1755,827,2.122128174,1274,906,520,270,0,270,0,77,0,0.081481481,empty,mBC-0716-1
"B1,C12",17741,18233,13558,4675,9520,0,4341,4355,3062,1293,2.368136118,2096,1060,745,354,0,354,0,110,0,0.016949153,empty,mBC-0716-1
"B1,D1",9353,9819,6975,2844,5357,0,2565,2571,1749,822,2.127737226,1300,628,372,163,0,163,0,56,0,0,empty,mBC-0716-1
"B1,D2",18085,18103,13914,4189,9488,0,3944,3959,2797,1162,2.407056799,1783,22420,7785,3717,3,3714,1,602,0,0.01642434,empty,mBC-0716-1
"B1,D3",11191,11496,8378,3118,6214,0,2830,2836,1999,837,2.388291517,1360,1012,606,314,0,314,0,91,0,0.057324841,empty,mBC-0716-1
"B1,D4",553025,593880,401279,192601,319133,0,174050,174270,131512,42758,3.075728519,92398,11104,7740,3756,0,3756,0,624,0,0.010117146,mm10,mBC-0716-1
"B1,D5",11750,11901,8919,2982,6417,0,2931,2937,2010,927,2.16828479,1375,1068,646,339,0,339,0,121,0,0.097345133,empty,mBC-0716-1
"B1,D6",10507,11099,8002,3097,5898,0,2806,2812,1949,863,2.258400927,1376,1233,787,372,0,372,0,107,0,0.112903226,empty,mBC-0716-1
"B1,D7",10757,11053,8201,2852,5975,0,2735,2741,1953,788,2.478426396,1308,1851,1191,578,0,578,0,143,0,0.070934256,empty,mBC-0716-1
"B1,D8",18915,20204,14454,5750,10874,0,5242,5248,3954,1294,3.055641422,2655,1633,1045,517,1,516,1,135,0,0.034883721,empty,mBC-0716-1
"B1,D9",4044,4131,2984,1147,2233,0,1069,1069,743,326,2.279141104,536,1164,668,348,0,348,0,101,0,0.057471264,empty,mBC-0716-1
"B1,D10",11881,12037,8887,3150,6291,0,2884,2888,1920,968,1.983471074,1371,15805,4959,2535,1,2534,1,389,0,0.095501184,empty,mBC-0716-1
"B1,D11",11185,11547,8464,3083,6234,0,2894,2897,2048,849,2.412249706,1457,1413,943,442,1,441,1,126,0,0.024943311,empty,mBC-0716-1
"B1,D12",17406,17834,13227,4607,9416,0,4187,4203,2977,1226,2.42822186,2011,3692,1412,702,0,702,0,183,0,0.02991453,empty,mBC-0716-1
"B1,E1",18486,18867,14141,4726,9987,0,4368,4370,3032,1338,2.266068759,2109,3891,1536,785,1,784,1,193,0,0.086734694,empty,mBC-0716-1
"B1,E2",13700,14083,10378,3705,7475,0,3454,3464,2424,1040,2.330769231,1666,1378,861,455,0,455,0,131,0,0.079120879,empty,mBC-0716-1
"B1,E3",10718,11191,8241,2950,5874,0,2658,2662,1812,850,2.131764706,1295,1444,934,452,0,452,0,123,0,0.150442478,empty,mBC-0716-1
"B1,E4",716541,790395,513072,277323,415169,2,230639,231025,193821,37204,5.209681755,125853,144676,95578,46539,12,46527,1,3168,0,0.000924195,mm10,mBC-0716-1
"B1,E5",17853,18321,13866,4455,9615,0,4206,4222,3011,1211,2.486374897,1953,1119,714,334,0,334,0,113,0,0.086826347,empty,mBC-0716-1
"B1,E6",11390,11590,8720,2870,6289,0,2799,2805,1907,898,2.123608018,1338,1593,936,458,0,458,0,103,0,0.032751092,empty,mBC-0716-1
"B1,E7",11718,12072,8810,3262,6379,0,2897,2904,2019,885,2.281355932,1418,1057,686,367,0,367,0,116,0,0.032697548,empty,mBC-0716-1
"B1,E8",14995,15224,11523,3701,8068,0,3487,3493,2412,1081,2.231267345,1581,1701,1045,549,0,549,0,150,0,0.051001821,empty,mBC-0716-1
"B1,E9",436249,461148,313609,147539,246763,2,130167,130387,112252,18135,6.189798732,68180,131979,86790,41427,8,41419,1,3019,0,0.005722012,mm10,mBC-0716-1
"B1,E10",11437,11859,8809,3050,6314,0,2905,2916,1995,921,2.166123779,1424,940,569,277,0,277,0,90,0,0.028880866,empty,mBC-0716-1
"B1,E11",7798,8122,5944,2178,4407,0,2049,2050,1411,639,2.208137715,1039,1021,672,306,0,306,0,94,0,0.045751634,empty,mBC-0716-1
"B1,E12",12404,13057,9270,3787,6986,0,3331,3338,2382,956,2.491631799,1672,1155,765,400,0,400,0,103,0,0.0775,empty,mBC-0716-1
"B1,F1",15427,16157,11810,4347,8457,1,3818,3829,2703,1126,2.40053286,1892,1684,792,420,0,420,0,112,0,0.047619048,empty,mBC-0716-1
"B1,F2",18295,18823,14000,4823,10088,0,4665,4671,3328,1343,2.478034252,2230,2569,1539,763,0,763,0,210,0,0.041939712,empty,mBC-0716-1
"B1,F3",13526,13916,10327,3589,7513,0,3466,3475,2406,1069,2.25070159,1675,4475,1643,861,1,860,1,224,0,0.011627907,empty,mBC-0716-1
"B1,F4",14038,14453,10594,3859,7862,0,3663,3663,2630,1033,2.545982575,1758,517,360,197,0,197,0,70,0,0.060913706,empty,mBC-0716-1
"B1,F5",20713,21429,15823,5606,11236,0,5021,5030,3558,1472,2.417119565,2496,2432,1354,703,1,702,1,187,0,0.032763533,empty,mBC-0716-1
"B1,F6",689318,736755,502704,234051,389206,0,201607,201900,165854,36046,4.601176275,105544,187665,135355,63512,25,63487,2,3780,0,0.000330776,mm10,mBC-0716-1
"B1,F7",16950,17305,12995,4310,9361,0,4120,4127,2921,1206,2.422056385,1938,1085,609,306,0,306,0,88,0,0.016339869,empty,mBC-0716-1
"B1,F8",29312,31023,21612,9411,16380,0,8442,8456,5923,2533,2.338333991,4318,5250,1758,915,0,915,0,194,0,0.057923497,empty,mBC-0716-1
"B1,F9",665349,741287,455170,286117,398481,1,245848,246214,179790,66424,2.706702397,139542,27375,13511,6546,4,6542,3,925,0,0.058086212,mm10,mBC-0716-1
"B1,F10",811418,880871,556852,324019,467298,0,285549,285930,231910,54020,4.293039615,157164,7137,4503,2146,0,2146,0,460,0,0.013979497,mm10,mBC-0716-1
"B1,F11",787112,911679,512592,399087,483527,0,322614,323020,257250,65770,3.911357762,189553,50744,34677,16587,4,16583,1,1819,0,0.001567871,mm10,mBC-0716-1
"B1,F12",11674,12171,8906,3265,6435,0,2959,2961,2089,872,2.395642202,1453,232,165,54,0,54,0,15,0,0,empty,mBC-0716-1
"B1,G1",9189,9453,7037,2416,4996,0,2234,2243,1496,747,2.002677376,1054,1692,1160,583,0,583,0,142,0,0.058319039,empty,mBC-0716-1
"B1,G2",20058,20479,14789,5690,10636,0,5008,5017,3543,1474,2.403663501,2493,5670,1858,905,2,903,2,181,0,0.080841639,empty,mBC-0716-1
"B1,G3",762217,834320,535105,299215,439358,0,252463,252836,214226,38610,5.548458948,137952,92871,66550,31220,13,31207,2,2603,0,0.002563527,mm10,mBC-0716-1
"B1,G4",1234867,1269237,931599,337638,663763,1,313108,313719,257589,56130,4.589150187,153829,1299,822,392,0,392,0,102,0,0,empty,mBC-0716-1
"B1,G5",11118,11538,8360,3178,6160,0,2857,2864,1888,976,1.93442623,1399,924,600,310,0,310,0,96,0,0.051612903,empty,mBC-0716-1
"B1,G6",20877,21333,15950,5383,11224,1,4933,4946,3460,1486,2.328398385,2347,530,222,124,0,124,0,43,0,0.016129032,empty,mBC-0716-1
"B1,G7",1518491,1613062,1110542,502520,838170,2,453693,454429,354714,99715,3.557278243,235102,87311,61428,29530,7,29523,2,2757,0,0.004809809,mm10,mBC-0716-1
"B1,G8",615855,718291,404900,313391,380608,1,247401,247683,198147,49536,4.000060562,146530,91618,56550,26758,13,26745,2,2510,0,0.003589456,mm10,mBC-0716-1
"B1,G9",9136,9224,6944,2280,4883,0,2230,2233,1604,629,2.550079491,1049,1049,657,374,0,374,0,123,0,0.056149733,empty,mBC-0716-1
"B1,G10",11601,11884,8915,2969,6360,0,2793,2805,1961,844,2.323459716,1286,1209,815,383,0,383,0,124,0,0.046997389,empty,mBC-0716-1
"B1,G11",10391,10624,8053,2571,5665,0,2494,2506,1800,706,2.549575071,1150,808,502,236,0,236,0,81,0,0.038135593,empty,mBC-0716-1
"B1,G12",9955,10242,7715,2527,5523,0,2444,2452,1753,699,2.507868383,1166,1350,907,452,0,452,0,105,0,0.033185841,empty,mBC-0716-1
"B1,H1",18040,18374,13745,4629,9665,0,4347,4356,3042,1314,2.315068493,1978,1924,861,433,0,433,0,139,0,0.025404157,empty,mBC-0716-1
"B1,H2",20306,20563,15559,5004,10760,0,4754,4765,3409,1356,2.514011799,2216,1713,1120,561,0,561,0,139,0,0.073083779,empty,mBC-0716-1
"B1,H3",628449,690558,440680,249878,370077,2,215847,216136,172077,44059,3.905603849,119177,63246,44637,20502,7,20495,2,1960,0,0.002439619,mm10,mBC-0716-1
"B1,H4",11155,11383,8501,2882,6090,1,2772,2777,1919,858,2.236596737,1279,142,95,52,0,52,0,26,0,0,empty,mBC-0716-1
"B1,H5",474476,490732,345008,145724,263883,0,135126,135336,104954,30382,3.454479626,69705,11719,8075,3893,1,3892,1,723,0,0.005395683,mm10,mBC-0716-1
"B1,H6",12009,12338,9136,3202,6739,0,3081,3087,2176,911,2.388583974,1521,1744,972,526,0,526,0,143,0,0.053231939,empty,mBC-0716-1
"B1,H7",15069,15161,11269,3892,8129,0,3717,3725,2619,1106,2.367992767,1770,4689,1795,923,0,923,0,209,0,0.08992416,empty,mBC-0716-1
"B1,H8",17391,18056,13026,5030,9711,0,4753,4759,3635,1124,3.233985765,2314,4635,1675,819,2,817,1,204,0,0.029375765,empty,mBC-0716-1
"B1,H9",13278,13708,10125,3583,7202,0,3203,3210,2306,904,2.550884956,1605,861,539,278,0,278,0,99,0,0,empty,mBC-0716-1
"B1,H10",919167,1024601,635419,389182,546782,2,331170,331621,235953,95668,2.466373291,187106,47148,27248,13084,6,13078,2,1792,0,0.00588775,mm10,mBC-0716-1
"B1,H11",14916,15317,11385,3932,8122,0,3703,3715,2581,1134,2.276014109,1766,99,64,49,0,49,0,28,0,0,empty,mBC-0716-1
"B1,H12",5279,5535,4031,1504,2910,0,1323,1324,949,375,2.530666667,627,1615,767,390,0,390,0,95,0,0.048717949,empty,mBC-0716-1
"B2,A1",13623,14382,10163,4219,7669,1,3701,3710,2603,1107,2.351400181,1859,1502,813,394,0,394,0,89,0,0.073604061,empty,mBC-0716-1
"B2,A2",17264,17276,13148,4128,9185,0,4090,4100,2800,1300,2.153846154,1881,11974,3958,2006,4,2002,1,361,0,0.014485514,empty,mBC-0716-1
"B2,A3",594602,652820,428814,224006,349837,1,189020,189310,158305,31005,5.105789389,102759,71711,41161,19572,13,19559,3,1963,0,0.001431566,mm10,mBC-0716-1
"B2,A4",19581,19953,15112,4841,10522,0,4588,4599,3260,1339,2.434652726,2154,605,344,180,0,180,0,61,0,0.094444444,empty,mBC-0716-1
"B2,A5",15643,16288,11892,4396,8564,0,3984,3996,2736,1260,2.171428571,1963,3302,1279,628,0,628,0,145,0,0.097133758,empty,mBC-0716-1
"B2,A6",11866,12172,8984,3188,6483,0,2986,2990,2153,837,2.572281959,1403,1605,964,478,0,478,0,151,0,0.029288703,empty,mBC-0716-1
"B2,A7",14919,15238,11579,3659,8173,1,3648,3656,2550,1106,2.305605787,1679,1050,707,318,3,315,1,100,0,0.041269841,empty,mBC-0716-1
"B2,A8",10373,10622,7822,2800,5601,0,2512,2514,1741,773,2.252263907,1129,1377,732,397,0,397,0,137,0,0.080604534,empty,mBC-0716-1
"B2,A9",16812,17066,12909,4157,8949,0,3903,3908,2737,1171,2.337318531,1835,1190,739,374,0,374,0,98,0,0.125668449,empty,mBC-0716-1
"B2,A10",1345625,1530290,898208,632082,807885,0,515193,515814,418225,97589,4.285575219,297860,39812,24650,11881,9,11872,2,1467,0,0.007412399,mm10,mBC-0716-1
"B2,A11",16728,17273,12763,4510,9114,0,4177,4182,2869,1313,2.185072353,1997,1122,708,373,0,373,0,98,0,0.056300268,empty,mBC-0716-1
"B2,A12",18579,18848,14266,4582,9922,0,4356,4369,3046,1323,2.302343159,2033,6203,2745,1256,1,1255,1,245,0,0.045418327,empty,mBC-0716-1
"B2,B1",17594,18287,13606,4681,9599,0,4278,4292,2979,1313,2.268849962,2089,932,586,281,0,281,0,90,0,0.053380783,empty,mBC-0716-1
"B2,B2",18726,18819,14450,4369,10110,0,4447,4453,3127,1326,2.358220211,2013,3983,1285,622,1,621,1,111,0,0.041867955,empty,mBC-0716-1
"B2,B3",18536,19485,14145,5340,10384,0,4884,4894,3356,1538,2.182054616,2440,5205,1832,943,3,940,1,222,0,0.028723404,empty,mBC-0716-1
"B2,B4",15527,15761,11923,3838,8392,0,3803,3812,2684,1128,2.379432624,1762,887,579,263,0,263,0,90,0,0,empty,mBC-0716-1
"B2,B5",8394,5405,3797,1608,3616,0,1729,1757,1211,546,2.217948718,918,7765,2570,1276,1,1275,1,246,0,0.051764706,empty,mBC-0716-1
"B2,B6",11089,11491,8264,3227,6187,0,2934,2944,2031,913,2.224534502,1460,1014,670,320,1,319,1,78,0,0.009404389,empty,mBC-0716-1
"B2,B7",14803,15376,11512,3864,8130,0,3597,3608,2531,1077,2.350046425,1697,776,455,205,0,205,0,82,0,0.156097561,empty,mBC-0716-1
"B2,B8",12233,12444,9469,2975,6656,0,2923,2929,1999,930,2.149462366,1332,1123,640,329,0,329,0,109,0,0.030395137,empty,mBC-0716-1
"B2,B9",13743,14198,10655,3543,7444,0,3365,3369,2386,983,2.427263479,1535,508,342,173,0,173,0,63,0,0.092485549,empty,mBC-0716-1
"B2,B10",15358,15083,11085,3998,8319,0,3818,3834,2620,1214,2.15815486,1842,547,325,145,0,145,0,44,0,0.013793103,empty,mBC-0716-1
"B2,B11",14575,15039,11086,3953,8013,0,3685,3694,2587,1107,2.336946703,1788,147,107,55,0,55,0,31,0,0.018181818,empty,mBC-0716-1
"B2,B12",16622,16848,12726,4122,9053,0,4068,4085,2812,1273,2.208955224,1877,1455,995,520,0,520,0,121,0,0.042307692,empty,mBC-0716-1
"B2,C1",2017619,2087320,1515243,572077,1047702,2,516170,517143,433741,83402,5.2006067,255387,67462,44665,21081,9,21072,2,2148,0,0.004603265,mm10,mBC-0716-1
"B2,C2",696550,770596,484330,286266,409337,0,238576,238924,184036,54888,3.35293689,134460,88569,62505,29483,13,29470,4,2682,0,0.001526977,mm10,mBC-0716-1
"B2,C3",20224,20902,15269,5633,11073,0,5186,5207,3579,1628,2.198402948,2494,872,426,179,0,179,0,62,0,0.027932961,empty,mBC-0716-1
"B2,C4",16250,16174,12339,3835,8698,0,3835,3844,2671,1173,2.277067349,1760,1235,809,426,0,426,0,123,0,0.063380282,empty,mBC-0716-1
"B2,C5",560439,595798,406635,189163,322251,0,171793,172030,126811,45219,2.804374267,91692,11408,6686,3297,1,3296,1,555,0,0.01092233,mm10,mBC-0716-1
"B2,C6",15364,15491,11445,4046,8482,0,3834,3854,2765,1089,2.53902663,1817,1222,741,395,0,395,0,118,0,0.055696203,empty,mBC-0716-1
"B2,C7",944221,1058715,622677,436038,556350,1,362770,363214,289246,73968,3.910420722,209093,1457,1010,473,0,473,0,140,0,0.025369979,empty,mBC-0716-1
"B2,C8",13498,14039,10388,3651,7507,0,3383,3393,2327,1066,2.182926829,1609,1105,643,360,1,359,1,126,0,0.022284123,empty,mBC-0716-1
"B2,C9",11801,11980,8855,3125,6360,0,2936,2941,2050,891,2.300785634,1358,677,380,187,0,187,0,63,0,0.037433155,empty,mBC-0716-1
"B2,C10",12618,12928,9579,3349,6894,0,3148,3153,2237,916,2.442139738,1547,1183,708,340,0,340,0,93,0,0.079411765,empty,mBC-0716-1
"B2,C11",11051,11432,8270,3162,6037,0,2771,2779,1917,862,2.223897912,1366,758,515,255,0,255,0,76,0,0.070588235,empty,mBC-0716-1
"B2,C12",17910,18428,13470,4958,9910,0,4518,4527,3230,1297,2.490362375,2210,2227,1010,480,1,479,1,117,0,0.108559499,empty,mBC-0716-1
"B2,D1",10333,10567,7845,2722,5771,0,2688,2697,1855,842,2.203087886,1283,514,282,129,0,129,0,47,0,0.007751938,empty,mBC-0716-1
"B2,D2",19128,19418,14879,4539,10301,0,4438,4445,3146,1299,2.421862972,2019,2089,1443,739,0,739,0,176,0,0.058186739,empty,mBC-0716-1
"B2,D3",13144,13774,9786,3988,7132,1,3433,3447,2387,1060,2.251886792,1709,10248,3785,1907,2,1905,1,306,0,0.253543307,empty,mBC-0716-1
"B2,D4",12747,12952,9773,3179,7014,0,3127,3134,2217,917,2.417666303,1423,1367,755,404,0,404,0,98,0,0.133663366,empty,mBC-0716-1
"B2,D5",12724,12995,9629,3366,6961,0,3154,3164,2226,938,2.373134328,1513,1027,613,302,0,302,0,105,0,0.006622517,empty,mBC-0716-1
"B2,D6",807388,899252,554563,344689,472330,3,280339,280801,207073,73728,2.808607313,159690,95688,60960,28529,20,28509,4,2510,0,0.002069522,mm10,mBC-0716-1
"B2,D7",11849,12408,8915,3493,6619,0,3145,3151,2169,982,2.208757637,1546,1222,747,381,1,380,1,120,0,0.031578947,empty,mBC-0716-1
"B2,D8",493633,514331,358235,156096,278417,2,145687,145897,117637,28260,4.162668082,75005,5344,3826,1725,0,1725,0,386,0,0.009855072,mm10,mBC-0716-1
"B2,D9",4622,4929,3484,1445,2651,0,1312,1315,973,342,2.84502924,660,1273,796,335,0,335,0,103,0,0.053731343,empty,mBC-0716-1
"B2,D10",13442,14201,10214,3987,7603,0,3516,3524,2393,1131,2.115826702,1806,699,411,216,0,216,0,75,0,0.023148148,empty,mBC-0716-1
"B2,D11",11933,12145,9031,3114,6597,0,3049,3053,2136,917,2.329334787,1495,1274,879,427,0,427,0,109,0,0.049180328,empty,mBC-0716-1
"B2,D12",1023602,1152418,698540,453878,600475,0,365295,365810,278643,87167,3.196656992,209580,133564,88540,41919,16,41903,2,3000,0,0.012576665,mm10,mBC-0716-1
"B2,E1",3005956,3233849,2151503,1082346,1641357,7,945852,947244,767434,179810,4.268027362,507179,233749,159540,75894,41,75853,7,4478,0,0.001463357,mm10,mBC-0716-1
"B2,E2",1311445,1419513,938915,480598,750496,2,423215,423834,339618,84216,4.032701624,227116,148616,93605,44497,27,44470,3,3479,0,0.00537441,mm10,mBC-0716-1
"B2,E3",11713,11834,8938,2896,6322,0,2852,2859,1974,885,2.230508475,1361,1795,1058,526,0,526,0,120,0,0.02851711,empty,mBC-0716-1
"B2,E4",14555,14880,11229,3651,7637,0,3376,3381,2402,979,2.453524004,1530,905,594,312,0,312,0,116,0,0.083333333,empty,mBC-0716-1
"B2,E5",622916,636732,481734,154998,339881,0,151749,152071,117381,34690,3.383712886,71764,27322,8787,4448,2,4446,2,652,0,0.132478632,mm10,mBC-0716-1
"B2,E6",12858,12776,9669,3107,6754,0,2984,2990,2048,942,2.174097665,1407,8518,3131,1606,0,1606,0,350,0,0.046699875,empty,mBC-0716-1
"B2,E7",12748,12910,9786,3124,6783,0,2929,2944,2047,897,2.282051282,1374,868,532,254,0,254,0,76,0,0.051181102,empty,mBC-0716-1
"B2,E8",16461,16462,12665,3797,8708,0,3805,3815,2713,1102,2.461887477,1726,6923,2498,1143,1,1142,1,262,0,0.061295972,empty,mBC-0716-1
"B2,E9",8337,8514,6308,2206,4644,0,2095,2099,1446,653,2.2143951,1045,1393,763,347,1,346,1,89,0,0.086705202,empty,mBC-0716-1
"B2,E10",484355,526729,360915,165814,283653,0,144275,144507,112234,32273,3.477643851,76551,79016,56188,26755,10,26745,4,2283,0,0.000635633,mm10,mBC-0716-1
"B2,E11",8568,8835,6428,2407,4759,0,2174,2181,1474,707,2.084865629,1072,735,454,271,0,271,0,80,0,0.018450185,empty,mBC-0716-1
"B2,E12",13663,14250,10297,3953,7765,0,3610,3616,2543,1073,2.36999068,1792,941,601,327,0,327,0,97,0,0.116207951,empty,mBC-0716-1
"B2,F1",16478,16758,12367,4391,8841,0,3941,3955,2768,1187,2.331929233,1878,1215,786,391,0,391,0,103,0,0.056265985,empty,mBC-0716-1
"B2,F2",827394,912850,582959,329891,483259,0,283875,284235,216399,67836,3.190031842,156442,46940,31867,15205,8,15197,1,1721,0,0.00881753,mm10,mBC-0716-1
"B2,F3",631736,725053,429382,295671,388842,1,240855,241171,182821,58350,3.133179092,140040,59547,38023,18122,14,18108,3,1899,0,0.004804506,mm10,mBC-0716-1
"B2,F4",1479870,1632597,1011363,621234,867813,4,529402,530111,409820,120291,3.406904922,296820,52716,31220,14707,8,14699,3,1702,0,0.001224573,mm10,mBC-0716-1
"B2,F5",21841,22238,16512,5726,11816,0,5311,5331,3638,1693,2.148848198,2589,9215,3243,1633,1,1632,1,310,0,0.020220588,empty,mBC-0716-1
"B2,F6",21188,21775,16159,5616,11719,0,5326,5337,3735,1602,2.331460674,2538,1844,1138,597,1,596,1,159,0,0.097315436,empty,mBC-0716-1
"B2,F7",18634,19248,14292,4956,10339,0,4664,4670,3324,1346,2.469539376,2238,793,537,291,0,291,0,84,0,0.089347079,empty,mBC-0716-1
"B2,F8",20643,21069,15815,5254,11301,0,5067,5081,3493,1588,2.199622166,2351,302,215,114,0,114,0,37,0,0.00877193,empty,mBC-0716-1
"B2,F9",13910,13865,10531,3334,7444,0,3320,3332,2306,1026,2.247563353,1542,1680,1101,523,0,523,0,149,0,0.066921606,empty,mBC-0716-1
"B2,F10",18945,19358,14493,4865,10140,0,4456,4469,3100,1369,2.264426589,2056,1181,835,398,0,398,0,104,0,0.045226131,empty,mBC-0716-1
"B2,F11",10544,10794,8120,2674,5799,0,2637,2640,1887,753,2.505976096,1210,22369,6644,3388,8,3380,4,532,0,0.026331361,empty,mBC-0716-1
"B2,F12",12823,13034,9652,3382,6920,0,3207,3212,2219,993,2.234642497,1522,77,42,33,0,33,0,12,0,0,empty,mBC-0716-1
"B2,G1",9234,9425,7055,2370,5080,1,2238,2247,1525,722,2.112188366,1072,4116,1752,862,0,862,0,189,0,0.046403712,empty,mBC-0716-1
"B2,G2",18958,19077,14578,4499,10037,0,4457,4465,3167,1298,2.43990755,1993,468,304,161,0,161,0,53,0,0.068322981,empty,mBC-0716-1
"B2,G3",17973,18484,13829,4655,9798,0,4507,4517,3158,1359,2.323767476,2122,1551,1020,521,0,521,0,162,0,0.013435701,empty,mBC-0716-1
"B2,G4",26262,26561,20070,6491,13846,0,6053,6070,4324,1746,2.476517755,2837,167,71,49,0,49,0,25,0,0,empty,mBC-0716-1
"B2,G5",12255,12755,9404,3351,6763,0,3085,3093,2150,943,2.279957582,1511,916,576,306,0,306,0,89,0,0.016339869,empty,mBC-0716-1
"B2,G6",694651,754272,503996,250276,401515,0,219940,220281,150984,69297,2.178795619,118034,3377,2078,1008,0,1008,0,227,0,0,mm10,mBC-0716-1
"B2,G7",18885,19372,14625,4747,10074,0,4363,4374,3071,1303,2.356868764,2018,1768,999,468,0,468,0,142,0,0.004273504,empty,mBC-0716-1
"B2,G8",13070,13499,9900,3599,7273,0,3374,3388,2350,1038,2.263969171,1605,1917,1005,475,0,475,0,133,0,0.103157895,empty,mBC-0716-1
"B2,G9",12326,12864,9250,3614,6771,0,3288,3300,2436,864,2.819444444,1572,2069,1138,590,1,589,1,155,0,0.100169779,empty,mBC-0716-1
"B2,G10",12446,12740,9509,3231,6674,0,2871,2880,2030,850,2.388235294,1346,2564,1194,555,1,554,1,152,0,0.057761733,empty,mBC-0716-1
"B2,G11",11409,11871,8793,3078,6368,0,2886,2892,2035,857,2.374562427,1400,2629,948,501,1,500,1,122,0,0.032,empty,mBC-0716-1
"B2,G12",554116,605706,392203,213503,331793,0,190483,190737,144240,46497,3.102135622,104679,20522,11853,5638,2,5636,1,805,0,0.009936125,mm10,mBC-0716-1
"B2,H1",19057,19526,14535,4991,10461,0,4695,4700,3429,1271,2.697875688,2245,2309,968,472,0,472,0,123,0,0.025423729,empty,mBC-0716-1
"B2,H2",21106,21268,16234,5034,11288,0,4925,4947,3440,1507,2.282680823,2250,2284,1322,675,0,675,0,157,0,0.051851852,empty,mBC-0716-1
"B2,H3",18525,18700,14088,4612,10085,0,4549,4565,3201,1364,2.346774194,2151,1478,878,408,0,408,0,123,0,0.017156863,empty,mBC-0716-1
"B2,H4",12213,12606,9219,3387,6691,0,3110,3114,2136,978,2.18404908,1499,150,71,38,0,38,0,20,0,0,empty,mBC-0716-1
"B2,H5",753703,837802,532077,305725,440843,1,250956,251292,186711,64581,2.891113485,139037,97304,70409,33378,10,33368,2,2799,0,0.000419564,mm10,mBC-0716-1
"B2,H6",13121,13648,9815,3833,7434,0,3553,3562,2542,1020,2.492156863,1757,1225,697,377,1,376,1,139,0,0.090425532,empty,mBC-0716-1
"B2,H7",15883,16402,11899,4503,8947,0,4230,4238,3009,1229,2.448331977,2082,1363,865,473,1,472,1,161,0,0.014830508,empty,mBC-0716-1
"B2,H8",12513,12815,9450,3365,6900,0,3166,3169,2230,939,2.37486688,1516,1522,1013,475,0,475,0,147,0,0.018947368,empty,mBC-0716-1
"B2,H9",14158,14392,10627,3765,7788,0,3567,3572,2473,1099,2.25022748,1752,3333,1313,656,0,656,0,159,0,0.106707317,empty,mBC-0716-1
"B2,H10",627780,659223,454609,204614,347741,3,177843,178112,152683,25429,6.004286445,92250,104896,74154,35138,17,35121,2,2574,0,0.001281285,mm10,mBC-0716-1
"B2,H11",550682,606163,394804,211359,327070,4,183276,183510,125602,57908,2.168992195,100332,1568,1131,519,0,519,0,123,0,0,empty,mBC-0716-1
"B2,H12",5612,6108,4215,1893,3252,0,1569,1573,1067,506,2.108695652,821,571,348,176,0,176,0,53,0,0.068181818,empty,mBC-0716-1
"B3,A1",605231,662374,432416,229958,359064,1,198672,198963,157204,41759,3.764553749,108367,79466,52684,25835,8,25827,3,2335,0,0.00557556,mm10,mBC-0716-1
"B3,A2",789426,821844,589419,232425,431608,1,205738,206137,180514,25623,7.044998634,102764,140903,97513,46367,34,46333,4,3277,0,0.001532385,mm10,mBC-0716-1
"B3,A3",17594,18166,13342,4824,9689,0,4447,4455,3143,1312,2.395579268,2152,1440,813,417,0,417,0,129,0,0.03117506,empty,mBC-0716-1
"B3,A4",21730,21984,16817,5167,11553,0,5025,5037,3541,1496,2.36697861,2334,632,369,221,0,221,0,91,0,0.049773756,empty,mBC-0716-1
"B3,A5",17267,17905,13076,4829,9499,0,4329,4341,3039,1302,2.334101382,2107,1779,1095,526,0,526,0,161,0,0.020912548,empty,mBC-0716-1
"B3,A6",15974,16541,12053,4488,9009,0,4351,4353,3186,1167,2.730077121,2138,9959,3279,1673,2,1671,2,380,0,0.040694195,empty,mBC-0716-1
"B3,A7",16995,17757,12843,4914,9441,0,4349,4354,3037,1317,2.305998481,2146,6745,2661,1352,2,1350,1,294,0,0.045925926,empty,mBC-0716-1
"B3,A8",11292,11712,8502,3210,6328,0,3011,3025,2113,912,2.316885965,1472,1768,1107,591,0,591,0,193,0,0.035532995,empty,mBC-0716-1
"B3,A9",19479,19851,15083,4768,10483,0,4693,4700,3336,1364,2.445747801,2212,1326,836,426,0,426,0,138,0,0.084507042,empty,mBC-0716-1
"B3,A10",16154,16560,12041,4519,8852,0,4100,4105,2912,1193,2.440905281,2013,488,307,164,0,164,0,71,0,0.006097561,empty,mBC-0716-1
"B3,A11",18881,18870,14385,4485,10070,0,4386,4401,3126,1275,2.451764706,2021,1352,929,507,1,506,1,161,0,0.0256917,empty,mBC-0716-1
"B3,A12",20950,21437,16066,5371,11271,0,4870,4891,3422,1469,2.329475834,2347,3369,2054,1031,0,1031,0,238,0,0.046556741,empty,mBC-0716-1
"B3,B1",20007,20581,15205,5376,10833,0,4879,4888,3424,1464,2.338797814,2312,1550,1022,493,1,492,1,136,0,0.152439024,empty,mBC-0716-1
"B3,B2",20873,21073,15768,5305,11132,0,4922,4933,3446,1487,2.317417619,2310,7004,2153,1088,1,1087,1,240,0,0.021159154,empty,mBC-0716-1
"B3,B3",20330,20589,15428,5161,10966,0,4885,4896,3480,1416,2.457627119,2302,1667,855,460,0,460,0,166,0,0.07826087,empty,mBC-0716-1
"B3,B4",17160,17401,13048,4353,9178,0,4108,4113,2885,1228,2.349348534,1904,1193,656,376,0,376,0,140,0,0.098404255,empty,mBC-0716-1
"B3,B5",12372,9163,6369,2794,5986,0,2978,2999,2135,864,2.471064815,1584,843,493,287,0,287,0,111,0,0.041811847,empty,mBC-0716-1
"B3,B6",12227,12634,9150,3484,6886,0,3161,3172,2275,897,2.536231884,1607,1547,942,487,0,487,0,138,0,0.047227926,empty,mBC-0716-1
"B3,B7",16643,17212,12743,4469,9185,0,4154,4158,2879,1279,2.250977326,1951,1330,696,390,0,390,0,121,0,0.043589744,empty,mBC-0716-1
"B3,B8",723704,749646,533074,216572,398956,0,202667,202994,163807,39187,4.18013627,101924,16896,11964,5637,1,5636,1,907,0,0.003726047,mm10,mBC-0716-1
"B3,B9",15215,15387,11765,3622,8130,0,3609,3618,2509,1109,2.262398557,1682,1289,608,319,0,319,0,121,0,0.05015674,empty,mBC-0716-1
"B3,B10",800022,777365,512344,265021,429563,4,231659,233605,179464,54141,3.314752221,127981,38652,26933,12841,4,12837,1,1507,0,0.001012698,mm10,mBC-0716-1
"B3,B11",654492,711448,476515,234933,376559,2,200290,200599,146193,54406,2.687074955,106858,12300,8831,4261,0,4261,0,686,0,0.00281624,mm10,mBC-0716-1
"B3,B12",841893,961421,566003,395418,512010,1,323160,323584,261153,62431,4.183066105,187029,93268,64607,30514,8,30506,1,2543,0,0.001245657,mm10,mBC-0716-1
"B3,C1",895840,945172,671934,273238,494515,0,240757,241182,202513,38669,5.237089141,121143,59493,42957,20472,9,20463,2,2013,0,0.002296828,mm10,mBC-0716-1
"B3,C2",20665,20973,15409,5564,11394,0,5279,5298,3732,1566,2.383141762,2629,2222,1445,699,1,698,1,220,0,0.040114613,empty,mBC-0716-1
"B3,C3",20774,21376,15807,5569,11322,0,5223,5228,3706,1522,2.434954008,2492,751,471,242,0,242,0,82,0,0.037190083,empty,mBC-0716-1
"B3,C4",18087,18442,13797,4645,9855,0,4375,4385,3155,1230,2.56504065,2090,5988,2501,1220,1,1219,1,277,0,0.016406891,empty,mBC-0716-1
"B3,C5",17667,17844,13297,4547,9613,0,4474,4477,3173,1304,2.433282209,2164,4683,1873,936,0,936,0,215,0,0.133547009,empty,mBC-0716-1
"B3,C6",17087,17775,12932,4843,9761,0,4541,4563,3237,1326,2.441176471,2264,1706,1084,614,0,614,0,188,0,0.081433225,empty,mBC-0716-1
"B3,C7",16800,17538,12745,4793,9360,0,4362,4378,3070,1308,2.347094801,2182,1111,536,258,0,258,0,76,0,0.027131783,empty,mBC-0716-1
"B3,C8",15448,15708,11736,3972,8510,0,3907,3912,2704,1208,2.238410596,1874,5025,2171,1145,3,1142,1,278,0,0.033274956,empty,mBC-0716-1
"B3,C9",13356,13681,10130,3551,7183,0,3333,3342,2337,1005,2.325373134,1481,10612,3414,1646,4,1642,1,332,0,0.014007308,empty,mBC-0716-1
"B3,C10",14575,14608,11088,3520,7701,0,3440,3454,2419,1035,2.337198068,1607,28333,8648,4458,3,4455,1,646,0,0.085072952,empty,mBC-0716-1
"B3,C11",12142,12460,8975,3485,6558,0,3108,3114,2202,912,2.414473684,1497,1314,836,440,0,440,0,131,0,0.029545455,empty,mBC-0716-1
"B3,C12",20742,21154,15572,5582,11151,0,5053,5071,3527,1544,2.284326425,2422,1570,980,479,0,479,0,152,0,0.012526096,empty,mBC-0716-1
"B3,D1",12152,12537,9172,3365,6795,0,3264,3278,2318,960,2.414583333,1612,887,585,299,0,299,0,94,0,0.003344482,empty,mBC-0716-1
"B3,D2",785289,846487,572840,273647,449352,1,238758,239121,194760,44361,4.390342869,126020,141708,101909,48167,13,48154,3,3268,0,0.00151597,mm10,mBC-0716-1
"B3,D3",668652,730463,477430,253033,392701,0,218398,218751,168788,49963,3.378259912,119709,123019,77889,37051,18,37033,2,2812,0,0.004077444,mm10,mBC-0716-1
"B3,D4",14697,14805,11221,3584,7953,0,3630,3634,2541,1093,2.324794145,1706,1426,904,451,1,450,1,165,0,0.028888889,empty,mBC-0716-1
"B3,D5",14667,15049,11019,4030,8099,0,3698,3712,2612,1100,2.374545455,1783,2018,1309,628,1,627,1,196,0,0.055821372,empty,mBC-0716-1
"B3,D6",12698,13068,9696,3372,7065,0,3280,3298,2287,1011,2.262116716,1618,1558,1027,601,0,601,0,177,0,0.063227953,empty,mBC-0716-1
"B3,D7",13811,14500,10487,4013,7662,0,3604,3611,2554,1057,2.416272469,1787,4056,2095,1031,4,1027,1,276,0,0.011684518,empty,mBC-0716-1
"B3,D8",16555,17236,12513,4723,9177,0,4307,4318,3042,1276,2.384012539,2106,1312,727,367,0,367,0,149,0,0.032697548,empty,mBC-0716-1
"B3,D9",178060,189829,121920,67909,104930,0,59926,60013,45641,14372,3.175688839,33106,99831,63621,30669,17,30652,3,2665,0,0.006785854,mm10,mBC-0716-1
"B3,D10",14163,14564,10562,4002,7985,0,3730,3742,2680,1062,2.52354049,1860,1061,691,343,1,342,1,113,0,0.011695906,empty,mBC-0716-1
"B3,D11",14277,14684,10831,3853,7902,0,3648,3658,2591,1067,2.428303655,1763,1898,1227,611,1,610,1,181,0,0.070491803,empty,mBC-0716-1
"B3,D12",2214352,2469583,1556122,913461,1281026,2,769073,770189,595284,174905,3.403470455,429871,224136,154197,73577,34,73543,4,4722,0,0.003372177,mm10,mBC-0716-1
"B3,E1",1163661,1262333,826825,435508,656105,2,366852,367420,304981,62439,4.884463236,197926,143996,102496,47558,16,47542,1,3239,0,0.001535484,mm10,mBC-0716-1
"B3,E2",16999,17346,12792,4554,9291,0,4260,4266,3068,1198,2.560934891,2077,7936,2830,1429,1,1428,1,306,0,0.06442577,empty,mBC-0716-1
"B3,E3",12255,12822,9377,3445,6742,0,2978,2985,2121,864,2.454861111,1383,2188,1449,688,1,687,1,203,0,0.011644833,empty,mBC-0716-1
"B3,E4",864266,941242,629293,311949,493452,1,262418,262846,189050,73796,2.561791967,142280,93093,66904,31518,13,31505,1,2615,0,0.000761784,mm10,mBC-0716-1
"B3,E5",21241,21613,16259,5354,11354,0,5021,5026,3498,1528,2.289267016,2329,1602,1014,573,0,573,0,200,0,0.017452007,empty,mBC-0716-1
"B3,E6",22355,23647,17006,6641,12433,0,5991,6004,4353,1651,2.636583889,2976,3997,1798,922,0,922,0,220,0,0.085683297,empty,mBC-0716-1
"B3,E7",14185,14586,10824,3762,7752,0,3511,3518,2460,1058,2.325141777,1683,1784,1107,594,0,594,0,176,0,0.050505051,empty,mBC-0716-1
"B3,E8",17913,18387,13829,4558,9680,0,4189,4200,2967,1233,2.406326034,1962,2514,1459,745,0,745,0,226,0,0.057718121,empty,mBC-0716-1
"B3,E9",9490,9826,7078,2748,5198,0,2391,2402,1635,767,2.131681877,1224,1435,894,480,0,480,0,147,0,0.095833333,empty,mBC-0716-1
"B3,E10",741744,794704,548627,246077,422340,0,216011,216387,169362,47025,3.6015311,113240,124621,83265,39254,21,39233,2,2882,0,0.003899778,mm10,mBC-0716-1
"B3,E11",9589,9779,7250,2529,5269,0,2482,2492,1718,774,2.219638243,1127,8429,2691,1397,0,1397,0,300,0,0.05511811,empty,mBC-0716-1
"B3,E12",16365,17080,12340,4740,9249,0,4298,4303,3049,1254,2.431419458,2115,1544,989,542,0,542,0,171,0,0.081180812,empty,mBC-0716-1
"B3,F1",19283,19403,14440,4963,10095,0,4506,4515,3187,1328,2.399849398,2108,48852,15608,7726,6,7720,2,1050,0,0.045595855,empty,mBC-0716-1
"B3,F2",23142,23827,17625,6202,12699,0,5782,5793,4068,1725,2.35826087,2734,27625,8924,4491,5,4486,3,734,0,0.01671868,empty,mBC-0716-1
"B3,F3",523670,542455,389773,152682,295270,0,144726,144935,114940,29995,3.831971995,72967,17963,12510,6161,2,6159,1,994,0,0.004383829,mm10,mBC-0716-1
"B3,F4",18163,18258,13423,4835,10057,0,4673,4687,3341,1346,2.482169391,2381,917,522,264,0,264,0,114,0,0.011363636,empty,mBC-0716-1
"B3,F5",25402,26057,19405,6652,13674,1,6144,6161,4301,1860,2.312365591,2950,5165,2331,1132,0,1132,0,306,0,0.067137809,empty,mBC-0716-1
"B3,F6",24484,25006,18598,6408,13403,0,6169,6172,4336,1836,2.361655773,2964,2990,1998,970,1,969,1,245,0,0.033023736,empty,mBC-0716-1
"B3,F7",23846,24853,18056,6797,13626,0,6364,6374,4458,1916,2.326722338,3076,1034,624,344,0,344,0,133,0,0.01744186,empty,mBC-0716-1
"B3,F8",440480,438741,335010,103731,239185,1,105201,105397,83636,21761,3.84338955,49450,1259,896,453,0,453,0,141,0,0,empty,mBC-0716-1
"B3,F9",813397,848665,613891,234774,447548,1,211788,212148,180784,31364,5.764060707,105187,190187,131020,63117,30,63087,5,3784,0,0.000634045,mm10,mBC-0716-1
"B3,F10",794645,856265,577805,278460,455147,0,246342,246727,185151,61576,3.00686956,129808,56658,32018,15286,7,15279,1,1781,0,0.016165979,mm10,mBC-0716-1
"B3,F11",11962,12274,9236,3038,6625,0,2885,2897,1999,898,2.226057906,1365,1224,750,367,0,367,0,139,0,0.038147139,empty,mBC-0716-1
"B3,F12",14540,14815,11044,3771,7799,0,3523,3529,2483,1046,2.373804971,1677,176,113,66,0,66,0,26,0,0,empty,mBC-0716-1
"B3,G1",10381,10663,7862,2801,5760,0,2590,2595,1791,804,2.22761194,1272,2537,1576,815,0,815,0,219,0,0.023312883,empty,mBC-0716-1
"B3,G2",21207,21679,16284,5395,11390,0,5005,5018,3532,1486,2.376850606,2346,1333,568,286,0,286,0,88,0,0.055944056,empty,mBC-0716-1
"B3,G3",1448297,1584222,1043579,540643,827875,0,457192,457840,378847,78993,4.795956604,247414,287552,204840,96866,38,96828,2,4756,0,0.000547362,mm10,mBC-0716-1
"B3,G4",29186,29208,22304,6904,15538,1,6704,6731,4790,1941,2.467800103,3110,116,72,52,0,52,0,42,0,0,empty,mBC-0716-1
"B3,G5",13423,13921,10258,3663,7546,0,3406,3413,2378,1035,2.297584541,1664,1260,746,397,0,397,0,155,0,0.055415617,empty,mBC-0716-1
"B3,G6",865846,913187,643529,269658,480431,2,238536,238981,197580,41401,4.772348494,121379,9197,6415,3076,0,3076,0,516,0,0,mm10,mBC-0716-1
"B3,G7",20465,20885,15896,4989,11080,0,4826,4839,3421,1418,2.412552891,2220,2592,1525,811,0,811,0,243,0,0.071516646,empty,mBC-0716-1
"B3,G8",14524,15084,11123,3961,8001,0,3686,3698,2643,1055,2.50521327,1776,2096,1204,612,0,612,0,191,0,0.034313725,empty,mBC-0716-1
"B3,G9",1121153,1228649,805938,422711,651807,4,359876,360369,302826,57543,5.262603618,195565,333508,204594,97706,47,97659,7,4957,0,0.004167563,mm10,mBC-0716-1
"B3,G10",606693,644261,456169,188092,346289,1,170422,170688,123307,47381,2.602456681,86990,81331,57259,27437,6,27431,2,2486,0,0.005030805,mm10,mBC-0716-1
"B3,G11",12705,13002,9759,3243,6869,0,3081,3091,2218,873,2.540664376,1444,730,505,280,0,280,0,116,0,0.035714286,empty,mBC-0716-1
"B3,G12",11475,11761,8649,3112,6533,0,2925,2941,2072,869,2.384349827,1429,1554,886,456,0,456,0,152,0,0.01754386,empty,mBC-0716-1
"B3,H1",21396,21926,16155,5771,11734,0,5437,5451,3912,1539,2.541910331,2640,1604,1182,546,1,545,1,169,0,0.073394495,empty,mBC-0716-1
"B3,H2",801390,843768,615373,228395,443949,0,206198,206555,154170,52385,2.94301804,101851,149569,105158,51255,17,51238,2,3082,0,0.001288106,mm10,mBC-0716-1
"B3,H3",20573,21037,15611,5426,11243,0,5179,5189,3641,1548,2.352067183,2518,1714,1105,620,0,620,0,186,0,0.056451613,empty,mBC-0716-1
"B3,H4",13717,14154,10239,3915,7721,0,3595,3609,2547,1062,2.398305085,1818,91,64,43,0,43,0,31,0,0,empty,mBC-0716-1
"B3,H5",20436,20536,15093,5443,10731,0,4969,4985,3544,1441,2.459403192,2363,60530,18440,9341,17,9324,5,1255,0,0.074324324,empty,mBC-0716-1
"B3,H6",640381,743857,414320,329537,399143,1,262888,263179,211405,51774,4.083227102,156806,173415,117158,55835,22,55813,3,3468,0,0.002580044,mm10,mBC-0716-1
"B3,H7",716574,750731,530939,219792,401134,2,196116,196523,166916,29607,5.637720809,99445,169192,118295,55627,22,55605,2,3647,0,0.001061056,mm10,mBC-0716-1
"B3,H8",14238,14817,10778,4039,8020,1,3734,3740,2664,1076,2.475836431,1843,1548,940,514,0,514,0,184,0,0.044747082,empty,mBC-0716-1
"B3,H9",16866,17373,12889,4484,9298,0,4236,4253,3014,1239,2.432606941,2003,1436,974,522,0,522,0,183,0,0.084291188,empty,mBC-0716-1
"B3,H10",15228,15418,11509,3909,8240,0,3712,3719,2575,1144,2.250874126,1738,1596,1039,547,0,547,0,165,0,0.058500914,empty,mBC-0716-1
"B3,H11",18700,19064,14052,5012,10314,1,4738,4761,3313,1448,2.287983425,2346,245,153,87,0,87,0,50,0,0.022988506,empty,mBC-0716-1
"B3,H12",6479,6926,4828,2098,3730,0,1751,1756,1238,518,2.38996139,914,676,381,211,0,211,0,100,0,0,empty,mBC-0716-1
"B4,A1",18024,19196,13635,5561,10206,0,5010,5020,3634,1386,2.621933622,2541,964,649,327,0,327,0,95,0,0.04587156,empty,mBC-0716-1
"B4,A2",21733,22033,16433,5600,11754,0,5271,5274,3746,1528,2.451570681,2509,1976,1016,537,1,536,1,145,0,0.115671642,empty,mBC-0716-1
"B4,A3",18992,20042,14323,5719,10482,0,5000,5011,3576,1435,2.491986063,2513,2429,1032,488,1,487,1,122,0,0.036960986,empty,mBC-0716-1
"B4,A4",21649,22230,16830,5400,11553,0,5004,5014,3592,1422,2.526019691,2353,515,294,151,0,151,0,54,0,0.033112583,empty,mBC-0716-1
"B4,A5",780635,880087,534103,345984,467166,0,285113,285527,231054,54473,4.241624291,162526,80556,53930,25349,10,25339,1,2280,0,0.000828762,mm10,mBC-0716-1
"B4,A6",16080,16884,12236,4648,8962,0,4269,4273,2993,1280,2.33828125,2096,2222,1354,622,0,622,0,164,0,0.032154341,empty,mBC-0716-1
"B4,A7",17204,17830,13263,4567,9561,0,4328,4337,3026,1311,2.308161709,2035,1231,692,361,0,361,0,109,0,0.171745152,empty,mBC-0716-1
"B4,A8",799501,875539,581614,293925,470166,2,253297,253686,204941,48745,4.204349164,136072,191839,126747,60559,24,60535,1,3838,0,0.002015363,mm10,mBC-0716-1
"B4,A9",19743,20442,15169,5273,10555,0,4737,4752,3309,1443,2.293139293,2267,1371,870,443,0,443,0,130,0,0.009029345,empty,mBC-0716-1
"B4,A10",18285,18740,13750,4990,10052,0,4652,4658,3303,1355,2.437638376,2264,1138,478,237,0,237,0,73,0,0.025316456,empty,mBC-0716-1
"B4,A11",712917,780868,503585,277283,413133,3,234014,234357,191351,43006,4.449402409,127629,54483,38954,18895,5,18890,1,1859,0,0.000476443,mm10,mBC-0716-1
"B4,A12",22104,22679,17029,5650,11684,0,5096,5106,3565,1541,2.313432836,2378,2741,1779,857,0,857,0,190,0,0.066511085,empty,mBC-0716-1
"B4,B1",19952,20520,15412,5108,10724,0,4884,4892,3403,1489,2.285426461,2267,1375,929,483,0,483,0,117,0,0.082815735,empty,mBC-0716-1
"B4,B2",20265,20712,15491,5221,10996,0,4877,4891,3454,1437,2.40361865,2287,391,213,107,0,107,0,42,0,0.056074766,empty,mBC-0716-1
"B4,B3",20282,20933,15285,5648,10970,0,4976,4987,3504,1483,2.362778152,2406,6238,2346,1130,3,1127,2,218,0,0.078970719,empty,mBC-0716-1
"B4,B4",17566,18089,13406,4683,9535,0,4209,4216,2946,1270,2.319685039,2031,932,585,319,0,319,0,101,0,0.015673981,empty,mBC-0716-1
"B4,B5",10355,6523,4644,1879,4462,0,2157,2170,1564,606,2.580858086,1124,668,424,206,0,206,0,72,0,0,empty,mBC-0716-1
"B4,B6",14130,14408,10561,3847,7465,0,3597,3605,2571,1034,2.486460348,1692,19037,6101,3056,5,3051,3,508,0,0.077023927,empty,mBC-0716-1
"B4,B7",17084,17230,13085,4145,9057,0,3995,3999,2825,1174,2.406303237,1826,6599,2134,1086,2,1084,1,203,0,0.07103321,empty,mBC-0716-1
"B4,B8",14361,14669,10993,3676,7752,0,3484,3490,2406,1084,2.219557196,1681,5374,2124,1162,1,1161,1,270,0,0.108527132,empty,mBC-0716-1
"B4,B9",15736,16015,11923,4092,8387,0,3796,3808,2635,1173,2.246376812,1821,570,391,219,0,219,0,79,0,0.03196347,empty,mBC-0716-1
"B4,B10",19153,18568,13603,4965,10362,3,4924,4950,3465,1485,2.333333333,2460,5004,1722,862,0,862,0,189,0,0.047563805,empty,mBC-0716-1
"B4,B11",18089,18852,13814,5038,9870,0,4519,4527,3206,1321,2.426949281,2165,444,288,124,0,124,0,41,0,0,empty,mBC-0716-1
"B4,B12",19630,20193,15102,5091,10628,0,4774,4794,3387,1407,2.407249467,2236,1467,927,467,1,466,1,122,0,0.070815451,empty,mBC-0716-1
"B4,C1",23523,23491,18249,5242,12172,0,5088,5094,3606,1488,2.423387097,2295,646,443,231,0,231,0,79,0,0.056277056,empty,mBC-0716-1
"B4,C2",22680,23763,17043,6720,12724,0,6122,6142,4363,1779,2.452501405,3062,4291,1741,899,0,899,0,220,0,0.053392659,empty,mBC-0716-1
"B4,C3",929760,1024854,647725,377129,534824,0,312070,312521,248444,64077,3.877272656,172827,29021,20230,9135,3,9132,1,1250,0,0.000109505,mm10,mBC-0716-1
"B4,C4",20447,20733,15373,5360,10998,0,5033,5044,3627,1417,2.559633028,2411,6395,2177,1154,2,1152,1,209,0,0.125868056,empty,mBC-0716-1
"B4,C5",18163,18391,13887,4504,9655,0,4376,4387,3046,1341,2.271439224,2046,1529,789,397,0,397,0,92,0,0.068010076,empty,mBC-0716-1
"B4,C6",20108,20623,15064,5559,11227,0,5310,5323,3808,1515,2.513531353,2618,1916,1043,483,0,483,0,145,0,0.022774327,empty,mBC-0716-1
"B4,C7",18065,18504,13794,4710,9795,0,4458,4463,3164,1299,2.435719784,2171,329,204,111,0,111,0,53,0,0,empty,mBC-0716-1
"B4,C8",16707,17122,12575,4547,9098,0,4153,4166,2942,1224,2.403594771,1964,1755,1116,565,0,565,0,159,0,0.014159292,empty,mBC-0716-1
"B4,C9",13558,13869,10312,3557,7229,0,3335,3344,2314,1030,2.246601942,1577,885,564,327,0,327,0,84,0,0.079510703,empty,mBC-0716-1
"B4,C10",14964,15357,11443,3914,8166,0,3752,3762,2640,1122,2.352941176,1801,1166,766,369,0,369,0,109,0,0.097560976,empty,mBC-0716-1
"B4,C11",12829,13568,9744,3824,7081,0,3373,3381,2347,1034,2.269825919,1684,836,564,293,1,292,1,86,0,0.068493151,empty,mBC-0716-1
"B4,C12",21663,22562,16231,6331,11982,0,5610,5622,3979,1643,2.42178941,2805,1075,718,357,0,357,0,114,0,0.005602241,empty,mBC-0716-1
"B4,D1",739032,790482,527991,262491,418109,1,224920,225311,187408,37903,4.944410733,120633,59390,38452,18065,7,18058,1,1869,0,0.001882822,mm10,mBC-0716-1
"B4,D2",21667,21930,16692,5238,11459,0,5027,5041,3558,1483,2.399190829,2312,2814,1777,880,0,880,0,183,0,0.031818182,empty,mBC-0716-1
"B4,D3",15990,16570,12006,4564,8862,0,4296,4302,3032,1270,2.387401575,2132,1002,630,312,0,312,0,111,0,0.044871795,empty,mBC-0716-1
"B4,D4",15973,16299,12220,4079,8819,0,4036,4052,2800,1252,2.236421725,1960,1161,696,377,1,376,1,122,0,0.029255319,empty,mBC-0716-1
"B4,D5",659744,720909,472347,248562,385435,3,215000,215298,164685,50613,3.25380831,117247,42706,28283,13639,10,13629,2,1589,0,0.002201189,mm10,mBC-0716-1
"B4,D6",13846,14503,10510,3993,7806,0,3653,3664,2611,1053,2.479582146,1854,1276,810,396,0,396,0,117,0,0.025252525,empty,mBC-0716-1
"B4,D7",15410,16309,11559,4750,8606,0,4106,4109,2926,1183,2.473372781,2050,5157,2204,1126,1,1125,1,230,0,0.201777778,empty,mBC-0716-1
"B4,D8",17575,18161,13198,4963,9789,0,4661,4675,3237,1438,2.251043115,2354,874,603,302,0,302,0,94,0,0.069536424,empty,mBC-0716-1
"B4,D9",274655,302935,180080,122855,166311,0,102307,102464,82641,19823,4.168945165,59253,186554,131727,61188,38,61150,5,3868,0,0.001177433,mm10,mBC-0716-1
"B4,D10",556544,595574,408269,187305,320851,1,171192,171472,123246,48226,2.555592419,90289,15058,7785,3694,0,3694,0,622,0,0.012181917,mm10,mBC-0716-1
"B4,D11",14857,15460,11248,4212,8244,0,3855,3867,2696,1171,2.302305722,1927,5778,2294,1115,1,1114,1,251,0,0.082585278,empty,mBC-0716-1
"B4,D12",21683,22211,16478,5733,11620,0,5262,5279,3652,1627,2.244622004,2505,2287,1491,715,0,715,0,203,0,0.039160839,empty,mBC-0716-1
"B4,E1",24856,25305,18926,6379,13298,0,5844,5867,4157,1710,2.430994152,2823,2365,1153,579,0,579,0,168,0,0.079447323,empty,mBC-0716-1
"B4,E2",19042,19388,14583,4805,10193,0,4669,4679,3331,1348,2.471068249,2124,1404,855,434,0,434,0,144,0,0.078341014,empty,mBC-0716-1
"B4,E3",13027,13553,9982,3571,7113,0,3200,3205,2269,936,2.424145299,1534,1546,927,493,0,493,0,147,0,0.056795132,empty,mBC-0716-1
"B4,E4",16672,17473,12664,4809,8993,0,4173,4181,3003,1178,2.549235993,2086,1175,666,300,0,300,0,108,0,0.02,empty,mBC-0716-1
"B4,E5",21895,22235,16990,5245,11771,0,5164,5172,3623,1549,2.338928341,2399,1339,882,462,0,462,0,138,0,0.075757576,empty,mBC-0716-1
"B4,E6",15786,16049,12173,3876,8440,0,3704,3711,2640,1071,2.464985994,1700,9119,2805,1395,0,1395,0,273,0,0.07311828,empty,mBC-0716-1
"B4,E7",15342,15564,11713,3851,8247,0,3716,3724,2661,1063,2.503292568,1744,1222,782,410,0,410,0,113,0,0.051219512,empty,mBC-0716-1
"B4,E8",19286,19810,14764,5046,10433,0,4667,4674,3316,1358,2.441826215,2242,1777,1148,621,0,621,0,175,0,0.043478261,empty,mBC-0716-1
"B4,E9",11003,11447,8322,3125,6101,0,2891,2893,2142,751,2.852197071,1382,1511,894,473,0,473,0,123,0,0.128964059,empty,mBC-0716-1
"B4,E10",684090,751205,499168,252037,397559,2,211806,212147,173915,38232,4.548938062,113478,174453,114601,55123,24,55099,3,3474,0,0.003593532,mm10,mBC-0716-1
"B4,E11",10624,11222,8054,3168,6135,1,2976,2986,2106,880,2.393181818,1526,968,578,300,0,300,0,107,0,0.093333333,empty,mBC-0716-1
"B4,E12",18120,18940,13684,5256,10206,0,4787,4798,3435,1363,2.520176082,2395,1086,643,335,0,335,0,117,0,0.032835821,empty,mBC-0716-1
"B4,F1",18971,19707,14449,5258,10225,0,4658,4676,3290,1386,2.373737374,2248,1207,733,361,0,361,0,107,0,0.083102493,empty,mBC-0716-1
"B4,F2",25203,26033,18967,7066,13750,1,6443,6461,4535,1926,2.354620976,3122,2352,1510,759,1,758,1,223,0,0.052770449,empty,mBC-0716-1
"B4,F3",19281,20566,14536,6030,10835,0,5287,5297,3762,1535,2.450814332,2646,4278,1827,912,2,910,2,242,0,0.040659341,empty,mBC-0716-1
"B4,F4",21475,22039,16374,5665,11927,0,5485,5496,3956,1540,2.568831169,2575,1531,711,358,1,357,1,103,0,0.084033613,empty,mBC-0716-1
"B4,F5",696014,766144,477485,288659,409757,1,250027,250333,173341,76992,2.251415732,141332,6084,4111,1983,1,1982,1,436,0,0.018163471,mm10,mBC-0716-1
"B4,F6",27442,28698,20912,7786,15056,0,7125,7128,5060,2068,2.446808511,3474,2460,1524,763,0,763,0,196,0,0.064220183,empty,mBC-0716-1
"B4,F7",21418,22306,16353,5953,12032,0,5569,5580,3900,1680,2.321428571,2701,840,550,249,0,249,0,83,0,0.004016064,empty,mBC-0716-1
"B4,F8",24862,25800,18900,6900,13597,0,6291,6297,4494,1803,2.492512479,3061,385,234,113,0,113,0,48,0,0.026548673,empty,mBC-0716-1
"B4,F9",17064,17500,13051,4449,9373,0,4283,4290,3040,1250,2.432,2046,1685,1091,544,0,544,0,155,0,0.049632353,empty,mBC-0716-1
"B4,F10",1019406,1080367,756345,324022,559646,1,283151,283656,223459,60197,3.712128511,145090,75270,53961,25291,10,25281,1,2345,0,0.00146355,mm10,mBC-0716-1
"B4,F11",12635,12951,9724,3227,6961,1,3167,3180,2235,945,2.365079365,1575,2010,937,458,0,458,0,127,0,0.032751092,empty,mBC-0716-1
"B4,F12",14598,15010,11237,3773,7847,0,3582,3587,2499,1088,2.296875,1677,87,40,25,0,25,0,11,0,0,empty,mBC-0716-1
"B4,G1",10651,10932,8143,2789,5700,0,2540,2547,1790,757,2.364597094,1190,10770,3788,1829,3,1826,2,324,0,0.065717415,empty,mBC-0716-1
"B4,G2",22183,22790,17286,5504,11833,0,5244,5247,3687,1560,2.363461538,2394,421,295,141,0,141,0,45,0,0.120567376,empty,mBC-0716-1
"B4,G3",22609,23316,17183,6133,12301,0,5747,5750,4034,1716,2.350815851,2790,1793,1123,504,1,503,1,148,0,0.031809145,empty,mBC-0716-1
"B4,G4",30438,30711,23603,7108,16121,0,7038,7050,4986,2064,2.415697674,3242,69,53,39,0,39,0,22,0,0.179487179,empty,mBC-0716-1
"B4,G5",14622,15321,11231,4090,8020,0,3684,3700,2589,1111,2.330333033,1768,1157,627,329,0,329,0,116,0,0.082066869,empty,mBC-0716-1
"B4,G6",26155,26578,20081,6497,13995,0,6171,6180,4355,1825,2.38630137,2861,312,165,94,0,94,0,38,0,0.255319149,empty,mBC-0716-1
"B4,G7",20973,21712,16311,5401,11334,0,5014,5028,3539,1489,2.376762928,2375,2039,1195,642,1,641,1,169,0,0.031201248,empty,mBC-0716-1
"B4,G8",829493,894506,600806,293700,464422,0,246880,247296,212869,34427,6.183199233,130569,159265,112570,52711,21,52690,1,3552,0,0.003150503,mm10,mBC-0716-1
"B4,G9",479190,511101,358020,153081,275110,0,135183,135392,115410,19982,5.775698128,69553,100871,68271,32292,18,32274,2,2727,0,0.000712648,mm10,mBC-0716-1
"B4,G10",14553,14912,11179,3733,7857,0,3550,3554,2515,1039,2.420596728,1673,1518,954,474,0,474,0,131,0,0.004219409,empty,mBC-0716-1
"B4,G11",13695,13998,10547,3451,7434,0,3354,3359,2366,993,2.382678751,1544,1095,543,289,1,288,1,101,0,0.065972222,empty,mBC-0716-1
"B4,G12",13360,14014,10097,3917,7495,0,3645,3655,2635,1020,2.583333333,1784,3387,1423,719,0,719,0,157,0,0.086230876,empty,mBC-0716-1
"B4,H1",23465,24261,17918,6343,12864,0,5910,5924,4219,1705,2.474486804,2894,1140,671,347,0,347,0,109,0,0.07204611,empty,mBC-0716-1
"B4,H2",25068,25370,19015,6355,13187,0,5926,5942,4185,1757,2.381900968,2774,2775,1515,749,1,748,1,169,0,0.057486631,empty,mBC-0716-1
"B4,H3",23410,24296,17808,6488,12846,0,6019,6030,4332,1698,2.551236749,2930,1812,1225,609,0,609,0,144,0,0.103448276,empty,mBC-0716-1
"B4,H4",16002,16388,11972,4416,8668,0,4056,4064,2850,1214,2.347611203,1975,249,130,64,0,64,0,22,0,0,empty,mBC-0716-1
"B4,H5",20690,21503,15723,5780,11299,0,5262,5269,3790,1479,2.562542258,2546,1287,826,433,2,431,1,123,0,0.078886311,empty,mBC-0716-1
"B4,H6",18033,18984,13599,5385,10057,0,4851,4868,3437,1431,2.401816911,2341,1522,993,529,0,529,0,161,0,0.035916824,empty,mBC-0716-1
"B4,H7",20414,21288,15543,5745,11357,0,5253,5257,3721,1536,2.422526042,2595,38149,11193,5572,4,5568,2,853,0,0.022090517,empty,mBC-0716-1
"B4,H8",739268,837980,494104,343876,441179,0,274479,274818,215856,58962,3.660934161,159523,173251,94161,45457,19,45438,4,3361,0,0.018948897,mm10,mBC-0716-1
"B4,H9",18910,19951,14404,5547,10448,0,4842,4849,3537,1312,2.695884146,2410,951,537,291,0,291,0,108,0,0.037800687,empty,mBC-0716-1
"B4,H10",17819,18380,13493,4887,9749,0,4568,4582,3281,1301,2.521906226,2234,5041,1711,887,1,886,1,208,0,0.05530474,empty,mBC-0716-1
"B4,H11",19703,20589,14848,5741,10868,0,5103,5114,3558,1556,2.286632391,2498,133,70,52,0,52,0,35,0,0.019230769,empty,mBC-0716-1
"B4,H12",7387,7482,5626,1856,4095,0,1886,1888,1325,563,2.353463588,904,663,387,214,0,214,0,76,0,0.070093458,empty,mBC-0716-1
"B5,A1",13955,14634,10518,4116,7879,0,3697,3705,2548,1157,2.202247191,1810,890,598,315,0,315,0,82,0,0.098412698,empty,mBC-0716-1
"B5,A2",19739,19973,14931,5042,10534,0,4660,4669,3219,1450,2.22,2195,6485,2382,1233,2,1231,2,263,0,0.03493095,empty,mBC-0716-1
"B5,A3",16516,17268,12462,4806,9017,0,4193,4200,2954,1246,2.370786517,2060,3829,1223,651,0,651,0,143,0,0.015360983,empty,mBC-0716-1
"B5,A4",21487,21690,16622,5068,11262,0,4823,4855,3379,1476,2.289295393,2213,575,332,195,0,195,0,55,0,0.035897436,empty,mBC-0716-1
"B5,A5",16936,17417,12757,4660,9197,0,4264,4274,3025,1249,2.42193755,2047,1045,568,258,0,258,0,102,0,0.11627907,empty,mBC-0716-1
"B5,A6",16389,17109,12094,5015,9240,0,4624,4628,3367,1261,2.670103093,2290,7215,2624,1373,0,1373,0,295,0,0.056081573,empty,mBC-0716-1
"B5,A7",16433,17011,12642,4369,9077,0,4140,4146,2798,1348,2.075667656,2010,1266,792,407,0,407,0,110,0,0.056511057,empty,mBC-0716-1
"B5,A8",11274,11501,8538,2963,6196,0,2941,2942,2075,867,2.393310265,1394,1258,819,393,0,393,0,118,0,0.048346056,empty,mBC-0716-1
"B5,A9",18388,18599,14219,4380,9710,0,4179,4183,2932,1251,2.34372502,1935,1054,614,328,0,328,0,102,0,0.036585366,empty,mBC-0716-1
"B5,A10",15466,15877,11813,4064,8444,0,3816,3820,2671,1149,2.324630113,1867,218,132,77,0,77,0,24,0,0.116883117,empty,mBC-0716-1
"B5,A11",17774,18070,13456,4614,9582,0,4269,4277,3005,1272,2.362421384,1984,977,650,326,1,325,1,94,0,0.055384615,empty,mBC-0716-1
"B5,A12",20249,20600,15688,4912,10723,0,4711,4727,3311,1416,2.338276836,2197,2509,1670,845,0,845,0,165,0,0.10295858,empty,mBC-0716-1
"B5,B1",18946,19502,14392,5110,10107,0,4479,4483,3204,1279,2.505082095,2133,1055,663,335,0,335,0,95,0,0.008955224,empty,mBC-0716-1
"B5,B2",19291,19489,14805,4684,10331,1,4442,4465,3116,1349,2.309859155,2065,419,278,138,0,138,0,49,0,0.057971014,empty,mBC-0716-1
"B5,B3",19678,20301,14894,5407,10544,0,4743,4760,3262,1498,2.177570093,2301,14114,4663,2475,3,2472,1,421,0,0.097087379,empty,mBC-0716-1
"B5,B4",16342,16838,12729,4109,8841,0,3919,3922,2763,1159,2.383951682,1879,929,596,280,0,280,0,99,0,0.010714286,empty,mBC-0716-1
"B5,B5",497708,291030,200362,90668,202442,8,100061,100749,84829,15920,5.328454774,54511,68712,47919,22449,7,22442,2,2071,0,0.001737813,mm10,mBC-0716-1
"B5,B6",11955,12212,8964,3248,6469,0,2958,2968,1996,972,2.053497942,1466,7921,2633,1341,4,1337,3,262,0,0.033657442,empty,mBC-0716-1
"B5,B7",15991,16335,12488,3847,8590,1,3730,3747,2618,1129,2.318866253,1741,1143,528,281,0,281,0,74,0,0.074733096,empty,mBC-0716-1
"B5,B8",713973,811281,481566,329715,429212,0,262641,262957,217531,45426,4.788689297,150559,137079,97142,45742,21,45721,1,3382,0,0.002340281,mm10,mBC-0716-1
"B5,B9",14697,14940,11427,3513,7866,0,3495,3499,2514,985,2.552284264,1590,557,366,178,0,178,0,56,0,0.095505618,empty,mBC-0716-1
"B5,B10",15835,15753,11425,4328,8786,0,4136,4148,2798,1350,2.072592593,2069,430,280,148,0,148,0,47,0,0.033783784,empty,mBC-0716-1
"B5,B11",16339,17073,12375,4698,9001,0,4180,4183,2982,1201,2.482930891,2089,400,169,110,0,110,0,37,0,0.136363636,empty,mBC-0716-1
"B5,B12",18078,18802,13910,4892,9914,0,4440,4453,3132,1321,2.370931113,2151,1072,658,337,0,337,0,101,0,0.014836795,empty,mBC-0716-1
"B5,C1",22300,22592,17452,5140,11759,0,4981,4993,3522,1471,2.394289599,2319,655,337,207,0,207,0,70,0,0.024154589,empty,mBC-0716-1
"B5,C2",19079,19719,14540,5179,10473,0,4792,4801,3359,1442,2.329403606,2349,1572,1048,528,0,528,0,157,0,0.03030303,empty,mBC-0716-1
"B5,C3",19760,20194,14974,5220,10671,0,4896,4907,3413,1494,2.284471218,2347,4652,1597,826,1,825,1,157,0,0.020606061,empty,mBC-0716-1
"B5,C4",17456,17674,13336,4338,9441,0,4185,4195,2977,1218,2.444170772,2003,1173,797,366,0,366,0,108,0,0.054644809,empty,mBC-0716-1
"B5,C5",16333,16721,12404,4317,8849,0,4049,4055,2844,1211,2.348472337,1939,904,560,289,0,289,0,91,0,0.01384083,empty,mBC-0716-1
"B5,C6",17275,17816,13052,4764,9588,0,4439,4445,3105,1340,2.317164179,2103,6432,2491,1255,1,1254,1,254,0,0.063795853,empty,mBC-0716-1
"B5,C7",15862,16610,12043,4567,8638,1,3989,4001,2787,1214,2.295716639,1943,298,199,101,0,101,0,45,0,0.04950495,empty,mBC-0716-1
"B5,C8",15106,15380,11333,4047,8088,0,3699,3708,2557,1151,2.221546481,1781,14939,4990,2518,3,2515,1,426,0,0.021868787,empty,mBC-0716-1
"B5,C9",12861,13317,9761,3556,7027,0,3246,3261,2288,973,2.351490236,1591,718,420,222,0,222,0,64,0,0.04954955,empty,mBC-0716-1
"B5,C10",14009,14078,10501,3577,7646,0,3451,3459,2412,1047,2.303724928,1670,5212,1884,989,0,989,0,209,0,0.080889788,empty,mBC-0716-1
"B5,C11",534363,588150,376931,211219,318216,1,182757,182999,143506,39493,3.633707239,101176,31679,18630,9114,1,9113,1,1239,0,0.023153736,mm10,mBC-0716-1
"B5,C12",19927,20353,14961,5392,10809,1,4965,4983,3521,1462,2.408344733,2434,4010,1592,747,0,747,0,158,0,0.024096386,empty,mBC-0716-1
"B5,D1",11369,11478,8596,2882,6242,0,2951,2953,2083,870,2.394252874,1368,583,430,206,0,206,0,55,0,0.106796117,empty,mBC-0716-1
"B5,D2",20605,20927,16012,4915,10980,0,4668,4673,3261,1412,2.309490085,2099,3282,1653,869,0,869,0,181,0,0.03452244,empty,mBC-0716-1
"B5,D3",13683,14334,10318,4016,7547,0,3596,3601,2504,1097,2.282588879,1795,813,553,298,0,298,0,90,0,0.080536913,empty,mBC-0716-1
"B5,D4",13562,14000,10324,3676,7455,0,3472,3477,2470,1007,2.452830189,1723,1128,695,361,2,359,1,109,0,0.064066852,empty,mBC-0716-1
"B5,D5",14443,14677,10991,3686,7828,0,3543,3549,2459,1090,2.255963303,1669,1079,682,351,0,351,0,104,0,0.045584046,empty,mBC-0716-1
"B5,D6",12524,13286,9483,3803,6923,0,3321,3329,2290,1039,2.204042348,1667,1043,607,320,0,320,0,95,0,0.00625,empty,mBC-0716-1
"B5,D7",13234,13370,9933,3437,7017,0,3232,3243,2304,939,2.453674121,1540,1470,997,502,0,502,0,141,0,0.013944223,empty,mBC-0716-1
"B5,D8",16025,16784,12139,4645,8844,0,4158,4168,2860,1308,2.186544343,2017,791,472,272,0,272,0,88,0,0.029411765,empty,mBC-0716-1
"B5,D9",5175,5346,3745,1601,3018,0,1534,1541,1132,409,2.767726161,806,6611,2272,1165,1,1164,1,231,0,0.107388316,empty,mBC-0716-1
"B5,D10",483193,507524,360444,147080,274813,1,137316,137536,107434,30102,3.568998738,70181,7738,4366,2131,2,2129,1,400,0,0.019257868,mm10,mBC-0716-1
"B5,D11",13321,13544,10106,3438,7242,0,3299,3306,2277,1029,2.212827988,1550,1115,692,376,0,376,0,132,0,0.042553191,empty,mBC-0716-1
"B5,D12",20603,21033,15776,5257,11071,0,5112,5120,3624,1496,2.422459893,2366,2566,1481,720,0,720,0,170,0,0.048611111,empty,mBC-0716-1
"B5,E1",1021712,1159676,688096,471580,612174,1,386820,387326,283391,103935,2.726617598,223410,59134,35589,17090,4,17086,1,1842,0,0.01170549,mm10,mBC-0716-1
"B5,E2",16177,16596,12370,4226,8778,0,3908,3916,2752,1164,2.364261168,1813,1417,872,443,0,443,0,121,0,0.081264108,empty,mBC-0716-1
"B5,E3",627033,694498,428269,266229,372291,1,230583,230889,181678,49211,3.69181687,128610,80773,34680,17562,12,17550,2,2117,0,0.063988604,mm10,mBC-0716-1
"B5,E4",15334,15370,11779,3591,7968,0,3499,3505,2513,992,2.533266129,1574,1009,581,321,0,321,0,117,0,0.052959502,empty,mBC-0716-1
"B5,E5",20246,20462,15671,4791,10889,0,4683,4694,3329,1365,2.438827839,2155,1106,650,317,0,317,0,108,0,0.085173502,empty,mBC-0716-1
"B5,E6",13355,13810,10131,3679,7198,0,3171,3176,2224,952,2.336134454,1479,1160,799,389,0,389,0,107,0,0.064267352,empty,mBC-0716-1
"B5,E7",13657,14082,10467,3615,7326,0,3293,3301,2271,1030,2.204854369,1538,912,574,316,0,316,0,94,0,0.069620253,empty,mBC-0716-1
"B5,E8",17292,17571,13304,4267,9342,0,4139,4154,2882,1272,2.26572327,1942,1354,888,463,0,463,0,137,0,0.060475162,empty,mBC-0716-1
"B5,E9",8907,9083,6763,2320,4880,0,2231,2244,1598,646,2.473684211,1089,876,552,288,0,288,0,78,0,0.097222222,empty,mBC-0716-1
"B5,E10",13100,13528,9932,3596,7193,0,3263,3274,2201,1073,2.051258155,1576,1477,854,418,0,418,0,102,0,0.06937799,empty,mBC-0716-1
"B5,E11",9199,9473,6915,2558,5024,0,2313,2320,1578,742,2.126684636,1135,1137,728,355,0,355,0,95,0,0.056338028,empty,mBC-0716-1
"B5,E12",15148,15665,11482,4183,8383,0,3900,3909,2697,1212,2.225247525,1915,1108,714,373,0,373,0,102,0,0.029490617,empty,mBC-0716-1
"B5,F1",17640,18167,13672,4495,9566,0,4252,4256,2912,1344,2.166666667,1957,3351,1547,829,0,829,0,161,0,0.048250905,empty,mBC-0716-1
"B5,F2",21997,22547,16650,5897,11878,0,5434,5445,3845,1600,2.403125,2639,2370,1588,773,0,773,0,188,0,0.086675291,empty,mBC-0716-1
"B5,F3",16684,17292,12575,4717,9061,0,4226,4242,2938,1304,2.253067485,2054,1262,740,407,0,407,0,142,0,0.098280098,empty,mBC-0716-1
"B5,F4",636318,639226,468856,170370,346924,2,165365,165623,127663,37960,3.363092729,81567,10191,6048,2943,0,2943,0,507,0,0.016309888,mm10,mBC-0716-1
"B5,F5",822137,907611,580198,327413,475945,2,272295,272666,195679,76987,2.541714835,151275,79853,51072,24647,6,24641,2,2295,0,0.006046833,mm10,mBC-0716-1
"B5,F6",1631838,1815915,1123867,692048,945146,4,570592,571363,457912,113451,4.036209465,322480,192206,137945,66761,21,66740,4,3991,0,0.001048846,mm10,mBC-0716-1
"B5,F7",19106,19267,14792,4475,10491,0,4617,4623,3160,1463,2.159945318,2114,620,355,192,0,192,0,74,0,0.03125,empty,mBC-0716-1
"B5,F8",22938,23483,17511,5972,12437,0,5758,5764,4088,1676,2.439140811,2709,912,355,202,0,202,0,69,0,0,empty,mBC-0716-1
"B5,F9",15601,15835,11759,4076,8437,0,3861,3863,2715,1148,2.364982578,1876,1395,887,497,0,497,0,160,0,0.034205231,empty,mBC-0716-1
"B5,F10",20301,20683,15642,5041,10933,0,4753,4758,3418,1340,2.550746269,2232,1258,717,384,0,384,0,118,0,0.03125,empty,mBC-0716-1
"B5,F11",670108,729535,480299,249236,387918,2,209620,209917,176965,32952,5.37038723,113388,111054,74947,36155,10,36145,2,2876,0,0.00060866,mm10,mBC-0716-1
"B5,F12",472817,502262,341367,160895,270906,1,146392,146599,114411,32188,3.55446129,77242,848,626,315,0,315,0,67,0,0,empty,mBC-0716-1
"B5,G1",10081,10311,7850,2461,5425,0,2389,2394,1629,765,2.129411765,1041,1504,967,474,0,474,0,136,0,0.042194093,empty,mBC-0716-1
"B5,G2",20440,20577,15568,5009,10909,0,4774,4788,3400,1388,2.449567723,2240,452,272,142,0,142,0,44,0,0,empty,mBC-0716-1
"B5,G3",642852,673146,473895,199251,357460,0,179509,179803,143300,36503,3.925704737,90486,93864,67907,33053,14,33039,3,2678,0,0.000817216,mm10,mBC-0716-1
"B5,G4",27657,27882,21182,6700,14635,0,6376,6389,4563,1826,2.49890471,3003,72,48,35,0,35,0,21,0,0,empty,mBC-0716-1
"B5,G5",13856,14093,10386,3707,7372,0,3342,3350,2381,969,2.457172343,1566,16284,5180,2638,3,2635,2,432,0,0.05199241,empty,mBC-0716-1
"B5,G6",24090,24371,18571,5800,12856,0,5691,5707,4040,1667,2.423515297,2588,179,115,57,0,57,0,20,0,0,empty,mBC-0716-1
"B5,G7",20017,20531,15372,5159,10844,0,4830,4841,3397,1444,2.352493075,2244,1918,1158,633,3,630,1,153,0,0.087301587,empty,mBC-0716-1
"B5,G8",14298,14779,10822,3957,7969,0,3771,3777,2590,1187,2.181971356,1858,11930,4031,2038,0,2038,0,368,0,0.02404318,empty,mBC-0716-1
"B5,G9",10512,10979,8055,2924,5862,0,2710,2713,1912,801,2.38701623,1353,1178,823,423,0,423,0,133,0,0.054373522,empty,mBC-0716-1
"B5,G10",653619,701606,471778,229828,377647,0,205889,206170,139213,66957,2.079140344,111836,10527,6793,3330,2,3328,1,589,0,0.009915865,mm10,mBC-0716-1
"B5,G11",12400,12528,9624,2904,6665,0,2976,2980,2128,852,2.497652582,1337,660,397,214,0,214,0,78,0,0.088785047,empty,mBC-0716-1
"B5,G12",1317569,1406052,954545,451507,747381,3,400110,400716,329282,71434,4.609597671,211643,147138,106234,50451,16,50435,2,3572,0,0.00047586,mm10,mBC-0716-1
"B5,H1",20201,20666,15606,5060,11043,0,4807,4818,3396,1422,2.388185654,2224,1703,801,424,1,423,1,110,0,0.047281324,empty,mBC-0716-1
"B5,H2",850828,883991,639434,244557,463549,0,219356,219699,176669,43030,4.105716942,109099,93285,63382,30663,9,30654,3,2599,0,0.00570888,mm10,mBC-0716-1
"B5,H3",20131,20947,15263,5684,10941,0,5112,5130,3634,1496,2.429144385,2458,1158,802,402,0,402,0,108,0,0.044776119,empty,mBC-0716-1
"B5,H4",13207,13513,9970,3543,7257,0,3356,3359,2298,1061,2.165881244,1604,92,54,33,0,33,0,16,0,0,empty,mBC-0716-1
"B5,H5",17764,18516,13405,5111,9766,0,4471,4477,3187,1290,2.470542636,2228,2965,1320,642,1,641,1,160,0,0.057722309,empty,mBC-0716-1
"B5,H6",14231,15015,10597,4418,7909,0,3732,3740,2608,1132,2.303886926,1863,1350,898,475,0,475,0,138,0,0.050526316,empty,mBC-0716-1
"B5,H7",17684,18282,13403,4879,9684,0,4525,4528,3202,1326,2.414781297,2183,1234,779,401,0,401,0,138,0,0.02244389,empty,mBC-0716-1
"B5,H8",13718,14171,10385,3786,7401,0,3350,3360,2396,964,2.485477178,1601,5679,1993,1047,1,1046,1,241,0,0.065965583,empty,mBC-0716-1
"B5,H9",16076,16497,12101,4396,8844,0,4131,4139,2999,1140,2.630701754,1980,8773,3056,1509,0,1509,0,303,0,0.030483764,empty,mBC-0716-1
"B5,H10",14161,14489,10788,3701,7712,0,3553,3559,2530,1029,2.458697765,1680,889,595,321,0,321,0,116,0,0.031152648,empty,mBC-0716-1
"B5,H11",17268,17544,12889,4655,9490,0,4408,4412,3071,1341,2.290082028,2137,85,57,40,0,40,0,26,0,0,empty,mBC-0716-1
"B5,H12",6449,6690,4918,1772,3508,0,1621,1624,1157,467,2.47751606,789,687,459,217,0,217,0,58,0,0.165898618,empty,mBC-0716-1
"B6,A1",600271,658393,416725,241668,359602,0,211751,212029,170023,42006,4.04758844,118191,9740,6352,3098,1,3097,1,514,0,0.003228931,mm10,mBC-0716-1
"B6,A2",17908,17839,13655,4184,9357,0,4124,4135,2915,1220,2.389344262,1885,3003,1349,662,3,659,2,138,0,0.22306525,empty,mBC-0716-1
"B6,A3",16199,17136,12226,4910,8874,1,4110,4116,2923,1193,2.450125733,2051,1546,755,395,0,395,0,78,0,0.17721519,empty,mBC-0716-1
"B6,A4",20787,20883,16107,4776,11129,0,4859,4875,3458,1417,2.440366972,2193,422,270,124,0,124,0,43,0,0.024193548,empty,mBC-0716-1
"B6,A5",16414,16776,12434,4342,9006,0,4103,4115,2798,1317,2.124525437,1935,4958,1812,915,0,915,0,179,0,0.143169399,empty,mBC-0716-1
"B6,A6",11944,12384,9031,3353,6725,0,3130,3137,2150,987,2.178318136,1557,948,596,311,0,311,0,91,0,0.064308682,empty,mBC-0716-1
"B6,A7",16991,17243,12879,4364,9001,0,4164,4174,2876,1298,2.215716487,1961,5056,1787,925,1,924,1,188,0,0.124458874,empty,mBC-0716-1
"B6,A8",10923,11196,8130,3066,6015,0,2679,2688,1882,806,2.334987593,1305,2208,876,450,0,450,0,114,0,0.171111111,empty,mBC-0716-1
"B6,A9",18590,18694,14257,4437,9742,0,4257,4273,3023,1250,2.4184,1953,4058,1445,745,0,745,0,153,0,0.10738255,empty,mBC-0716-1
"B6,A10",14893,15435,11285,4150,8188,0,3754,3767,2665,1102,2.418330309,1812,871,387,202,0,202,0,62,0,0.00990099,empty,mBC-0716-1
"B6,A11",17050,17437,13095,4342,9264,0,4003,4016,2748,1268,2.167192429,1901,2343,897,478,1,477,1,139,0,0.052410901,empty,mBC-0716-1
"B6,A12",20309,20402,15640,4762,10706,0,4639,4650,3261,1389,2.347732181,2107,2910,1360,632,1,631,1,151,0,0.137876387,empty,mBC-0716-1
"B6,B1",20165,21254,15476,5778,10924,0,5003,5010,3606,1404,2.568376068,2371,967,579,272,0,272,0,77,0,0.025735294,empty,mBC-0716-1
"B6,B2",20159,20290,15537,4753,10565,0,4696,4707,3243,1464,2.215163934,2120,318,177,105,0,105,0,37,0,0,empty,mBC-0716-1
"B6,B3",18574,18968,14267,4701,10070,0,4502,4514,3163,1351,2.341228719,2109,788,474,237,1,236,1,86,0,0.097457627,empty,mBC-0716-1
"B6,B4",599355,626075,442181,183894,338002,1,168739,169042,117680,51362,2.291188038,88489,11750,8275,4039,2,4037,1,679,0,0.000495417,mm10,mBC-0716-1
"B6,B5",10568,7833,5321,2512,5090,0,2534,2548,1926,622,3.096463023,1384,431,292,143,0,143,0,41,0,0.041958042,empty,mBC-0716-1
"B6,B6",11372,11847,8640,3207,6191,0,2761,2769,1886,883,2.13590034,1320,686,380,207,0,207,0,76,0,0.154589372,empty,mBC-0716-1
"B6,B7",16655,17160,12605,4555,8937,0,4046,4058,2879,1179,2.441899915,1974,7568,2419,1244,1,1243,1,237,0,0.063555913,empty,mBC-0716-1
"B6,B8",12930,13099,9778,3321,7055,0,3190,3199,2227,972,2.291152263,1496,858,521,259,0,259,0,81,0,0.065637066,empty,mBC-0716-1
"B6,B9",14876,15200,11588,3612,7952,0,3411,3425,2385,1040,2.293269231,1558,524,316,156,0,156,0,50,0,0.134615385,empty,mBC-0716-1
"B6,B10",693229,671975,449350,222625,371577,1,194782,196208,167136,29072,5.749036874,105514,33607,17217,8493,3,8490,2,1152,0,0.013074205,mm10,mBC-0716-1
"B6,B11",18782,19448,14265,5183,10375,0,4766,4777,3378,1399,2.414581844,2371,96,38,22,0,22,0,16,0,0.045454545,empty,mBC-0716-1
"B6,B12",17526,18377,13467,4910,9791,0,4464,4468,3086,1382,2.232995658,2106,945,651,301,0,301,0,77,0,0.026578073,empty,mBC-0716-1
"B6,C1",846793,876492,639830,236662,461181,0,223568,223947,183527,40420,4.540499753,110525,3844,2704,1335,2,1333,1,300,0,0.013503376,mm10,mBC-0716-1
"B6,C2",17888,18312,13604,4708,9708,0,4312,4318,3031,1287,2.355089355,2065,2390,1114,568,1,567,1,161,0,0.047619048,empty,mBC-0716-1
"B6,C3",19405,19886,14726,5160,10540,0,4767,4777,3342,1435,2.328919861,2326,455,283,149,0,149,0,39,0,0,empty,mBC-0716-1
"B6,C4",16793,17075,12850,4225,9016,0,3978,3981,2769,1212,2.284653465,1869,839,518,247,0,247,0,78,0,0.028340081,empty,mBC-0716-1
"B6,C5",16165,16643,12273,4370,8875,0,4093,4109,2906,1203,2.415627598,1992,854,525,247,0,247,0,83,0,0.105263158,empty,mBC-0716-1
"B6,C6",16706,17169,12513,4656,9398,0,4310,4319,3110,1209,2.572373863,2108,4675,1799,940,1,939,1,170,0,0.169329073,empty,mBC-0716-1
"B6,C7",15454,16078,11632,4446,8548,0,3977,3988,2807,1181,2.376799323,1970,128,83,41,0,41,0,14,0,0.024390244,empty,mBC-0716-1
"B6,C8",564440,649360,369306,280054,349190,0,233478,233757,96823,136934,0.707077862,139537,12816,5702,2636,5,2631,1,528,0,0.030786773,empty,mBC-0716-1
"B6,C9",12204,12559,9288,3271,6616,0,3047,3056,2109,947,2.227032735,1448,688,359,155,0,155,0,52,0,0.006451613,empty,mBC-0716-1
"B6,C10",13793,14109,10578,3531,7389,0,3284,3294,2213,1081,2.047178538,1517,5065,1806,910,0,910,0,163,0,0.049450549,empty,mBC-0716-1
"B6,C11",11853,12290,8924,3366,6487,0,3087,3099,2072,1027,2.017526777,1499,2937,1162,569,0,569,0,123,0,0.057996485,empty,mBC-0716-1
"B6,C12",19732,20558,14933,5625,10705,0,4841,4850,3285,1565,2.099041534,2358,2309,1130,525,0,525,0,122,0,0.045714286,empty,mBC-0716-1
"B6,D1",433971,458840,315461,143379,250741,0,126660,126850,108704,18146,5.990521327,66773,39505,26766,12616,1,12615,1,1444,0,0.000237812,mm10,mBC-0716-1
"B6,D2",20892,21106,16130,4976,11099,0,4802,4815,3310,1505,2.199335548,2158,1526,980,468,2,466,2,130,0,0.017167382,empty,mBC-0716-1
"B6,D3",719220,787311,508185,279126,421621,0,239652,239967,195953,44014,4.452060708,130795,47793,32580,15318,4,15314,1,1643,0,0.001371294,mm10,mBC-0716-1
"B6,D4",13774,14131,10591,3540,7538,0,3510,3516,2438,1078,2.261595547,1682,749,533,275,0,275,0,86,0,0.127272727,empty,mBC-0716-1
"B6,D5",402854,404126,300086,104040,222093,0,102336,102513,80192,22321,3.592670579,49714,6551,4005,1910,1,1909,1,435,0,0.017286537,mm10,mBC-0716-1
"B6,D6",11951,12571,8900,3671,6636,0,3115,3122,2152,970,2.218556701,1621,844,520,255,0,255,0,73,0,0,empty,mBC-0716-1
"B6,D7",12718,12919,9666,3253,6852,0,3148,3160,2194,966,2.271221532,1496,863,597,289,0,289,0,96,0,0.044982699,empty,mBC-0716-1
"B6,D8",1378096,1542960,963524,579436,818052,0,487879,488550,368430,120120,3.067182817,274154,65408,43921,21032,6,21026,1,2150,0,0.000998763,mm10,mBC-0716-1
"B6,D9",4210,4237,3104,1133,2372,0,1118,1121,784,337,2.326409496,528,959,547,283,0,283,0,78,0,0,empty,mBC-0716-1
"B6,D10",14287,14440,10721,3719,7790,1,3741,3746,2690,1056,2.547348485,1737,1568,678,331,1,330,1,86,0,0.1,empty,mBC-0716-1
"B6,D11",1347487,1468572,961515,507057,773905,1,439631,440319,325775,114544,2.844103576,240117,78094,54588,26381,10,26371,2,2441,0,0.000948011,mm10,mBC-0716-1
"B6,D12",21387,21680,15900,5780,11222,0,5096,5103,3519,1584,2.221590909,2459,18519,6572,3444,0,3444,0,564,0,0.116724739,empty,mBC-0716-1
"B6,E1",21227,21497,16273,5224,11239,0,4949,4960,3552,1408,2.522727273,2301,935,544,293,0,293,0,96,0,0.078498294,empty,mBC-0716-1
"B6,E2",15587,15649,11836,3813,8331,0,3740,3751,2641,1110,2.379279279,1765,1098,678,330,1,329,1,94,0,0.130699088,empty,mBC-0716-1
"B6,E3",1208864,1307537,885105,422432,689415,0,367682,368240,299392,68848,4.348594004,193716,164942,115589,55858,30,55828,3,3629,0,0.000340331,mm10,mBC-0716-1
"B6,E4",15586,16000,11834,4166,8266,0,3637,3647,2596,1051,2.470028544,1726,1019,622,314,0,314,0,90,0,0.02866242,empty,mBC-0716-1
"B6,E5",21057,21718,16449,5269,11430,0,4976,4986,3468,1518,2.28458498,2330,2042,924,488,1,487,1,129,0,0.036960986,empty,mBC-0716-1
"B6,E6",12849,12899,9850,3049,6811,0,2975,2978,2063,915,2.254644809,1400,946,566,313,0,313,0,86,0,0.063897764,empty,mBC-0716-1
"B6,E7",13216,13341,10157,3184,7100,0,3191,3202,2197,1005,2.186069652,1436,1019,702,312,0,312,0,97,0,0.099358974,empty,mBC-0716-1
"B6,E8",17255,17729,13411,4318,9454,0,4015,4027,2891,1136,2.544894366,1853,1524,919,476,0,476,0,123,0,0.033613445,empty,mBC-0716-1
"B6,E9",8774,9051,6600,2451,4889,0,2306,2313,1630,683,2.386530015,1149,1315,568,290,0,290,0,69,0,0.124137931,empty,mBC-0716-1
"B6,E10",13078,13389,10126,3263,7151,0,3192,3205,2233,972,2.297325103,1532,741,510,278,0,278,0,67,0,0.021582734,empty,mBC-0716-1
"B6,E11",8812,8837,6716,2121,4781,0,2128,2130,1453,677,2.146233383,982,1062,447,227,0,227,0,68,0,0.088105727,empty,mBC-0716-1
"B6,E12",14649,15037,10989,4048,8100,0,3728,3732,2626,1106,2.374321881,1790,15005,4234,2180,4,2176,3,358,0,0.052849265,empty,mBC-0716-1
"B6,F1",17662,17852,13536,4316,9454,0,4184,4188,2960,1228,2.410423453,1927,865,562,288,0,288,0,87,0,0.006944444,empty,mBC-0716-1
"B6,F2",22269,23350,16682,6668,12210,0,5628,5645,3979,1666,2.388355342,2830,2174,1405,700,0,700,0,173,0,0.038571429,empty,mBC-0716-1
"B6,F3",15359,16103,11513,4590,8560,0,4076,4084,2833,1251,2.264588329,2000,1100,607,300,0,300,0,114,0,0,empty,mBC-0716-1
"B6,F4",15593,15487,11734,3753,8511,1,3838,3847,2684,1163,2.307824592,1761,356,217,133,0,133,0,47,0,0.022556391,empty,mBC-0716-1
"B6,F5",23497,23962,17935,6027,12645,0,5673,5683,4021,1662,2.419374248,2625,7531,2750,1375,1,1374,1,255,0,0.128820961,empty,mBC-0716-1
"B6,F6",22852,23675,17172,6503,12446,0,5734,5744,4036,1708,2.362997658,2802,1193,740,409,0,409,0,124,0,0.019559902,empty,mBC-0716-1
"B6,F7",19206,19488,14685,4803,10540,0,4607,4617,3194,1423,2.24455376,2111,7217,2120,1021,1,1020,1,211,0,0.005882353,empty,mBC-0716-1
"B6,F8",22333,22719,16959,5760,11977,1,5413,5418,3723,1695,2.196460177,2599,223,154,79,0,79,0,30,0,0,empty,mBC-0716-1
"B6,F9",1251383,1263321,955987,307334,665051,3,301455,302077,238677,63400,3.764621451,142892,81538,43537,21309,17,21292,6,2367,0,0.014230697,mm10,mBC-0716-1
"B6,F10",20815,21140,16139,5001,11156,0,4741,4756,3381,1375,2.458909091,2252,1207,708,344,0,344,0,101,0,0.058139535,empty,mBC-0716-1
"B6,F11",11099,11307,8469,2838,6039,0,2718,2728,1922,806,2.384615385,1285,614,349,175,0,175,0,65,0,0.108571429,empty,mBC-0716-1
"B6,F12",13400,13815,10053,3762,7380,0,3383,3391,2350,1041,2.257444765,1655,71,46,26,0,26,0,17,0,0,empty,mBC-0716-1
"B6,G1",10348,10475,8047,2428,5607,0,2478,2487,1683,804,2.093283582,1093,2948,1453,685,0,685,0,131,0,0.150364964,empty,mBC-0716-1
"B6,G2",621092,617151,470811,146340,329822,0,146106,146378,114729,31649,3.625043445,68202,2847,1922,982,2,980,1,234,0,0.004081633,empty,mBC-0716-1
"B6,G3",820304,913162,557573,355589,482816,0,292578,292962,243811,49151,4.960448414,165838,92575,66414,31825,20,31805,4,2574,0,0.000628832,mm10,mBC-0716-1
"B6,G4",27585,27579,21361,6218,14698,0,6357,6368,4587,1781,2.575519371,2931,104,50,27,0,27,0,13,0,0,empty,mBC-0716-1
"B6,G5",13042,13277,9891,3386,6987,0,3173,3185,2178,1007,2.16285998,1544,706,450,209,0,209,0,77,0,0.043062201,empty,mBC-0716-1
"B6,G6",23772,24203,18288,5915,12914,0,5674,5691,4006,1685,2.377448071,2686,161,92,50,0,50,0,21,0,0,empty,mBC-0716-1
"B6,G7",20353,20893,15363,5530,10854,0,4904,4921,3498,1423,2.458186929,2395,5194,2020,1080,0,1080,0,184,0,0.203703704,empty,mBC-0716-1
"B6,G8",399226,401990,309222,92768,219193,2,92669,92862,63326,29536,2.144027627,43220,12620,7111,3302,1,3301,1,592,0,0.155407452,mm10,mBC-0716-1
"B6,G9",10659,10959,8010,2949,5775,0,2663,2673,1903,770,2.471428571,1269,14053,4108,2072,1,2071,1,390,0,0.051183003,empty,mBC-0716-1
"B6,G10",13472,13740,10252,3488,7214,0,3291,3294,2301,993,2.317220544,1549,3813,1552,813,0,813,0,160,0,0.033210332,empty,mBC-0716-1
"B6,G11",12094,12498,9323,3175,6631,0,2904,2916,1970,946,2.082452431,1378,345,223,115,0,115,0,47,0,0.026086957,empty,mBC-0716-1
"B6,G12",11050,11498,8479,3019,6080,3,2647,2658,1869,789,2.368821293,1276,961,543,263,1,262,1,63,0,0.007633588,empty,mBC-0716-1
"B6,H1",765250,874019,510539,363480,464365,1,292081,292449,238683,53766,4.43929249,170328,31714,22247,10679,6,10673,1,1346,0,0.001967582,mm10,mBC-0716-1
"B6,H2",24289,24895,18578,6317,13092,0,5855,5873,4002,1871,2.138963121,2817,1133,744,402,0,402,0,115,0,0.059701493,empty,mBC-0716-1
"B6,H3",19760,20222,14939,5283,10670,0,4962,4973,3473,1500,2.315333333,2374,785,507,258,0,258,0,83,0,0.07751938,empty,mBC-0716-1
"B6,H4",1046791,1103089,769288,333801,587876,0,307605,308039,237209,70830,3.348990541,160693,817,559,309,1,308,1,69,0,0.006493506,empty,mBC-0716-1
"B6,H5",17741,18512,13380,5132,9584,1,4484,4492,3219,1273,2.528672427,2212,1035,683,353,0,353,0,95,0,0.019830028,empty,mBC-0716-1
"B6,H6",13260,13499,9903,3596,7256,0,3339,3348,2344,1004,2.334661355,1676,1054,634,318,0,318,0,120,0,0.097484277,empty,mBC-0716-1
"B6,H7",16382,16899,12462,4437,9194,0,4270,4284,3019,1265,2.386561265,2055,1854,964,514,0,514,0,133,0,0.050583658,empty,mBC-0716-1
"B6,H8",515655,539510,382462,157048,288876,0,139662,139924,120903,19021,6.356290416,70646,109877,76322,36990,15,36975,4,2895,0,0.002028398,mm10,mBC-0716-1
"B6,H9",16425,16853,12415,4438,9018,0,4155,4161,2981,1180,2.526271186,2007,736,505,262,0,262,0,85,0,0.095419847,empty,mBC-0716-1
"B6,H10",382445,368410,292869,75541,200875,0,79727,79882,62934,16948,3.713358508,35792,6263,4463,2098,1,2097,1,476,0,0.004768717,mm10,mBC-0716-1
"B6,H11",16360,17267,12256,5011,9124,0,4331,4347,3011,1336,2.253742515,2201,234,138,71,0,71,0,24,0,0,empty,mBC-0716-1
"B6,H12",5683,5817,4288,1529,3135,0,1443,1451,997,454,2.196035242,711,636,302,145,0,145,0,42,0,0.013793103,empty,mBC-0716-1
"B7,A1",13933,14408,10532,3876,7603,1,3584,3600,2585,1015,2.54679803,1675,1019,584,299,1,298,1,98,0,0.020134228,empty,mBC-0716-1
"B7,A2",17990,18174,13654,4520,9233,0,4076,4082,2875,1207,2.381938691,1866,7935,2693,1367,0,1367,0,237,0,0.11265545,empty,mBC-0716-1
"B7,A3",15719,16194,12065,4129,8397,0,3903,3912,2773,1139,2.434591747,1814,1326,651,363,0,363,0,99,0,0.115702479,empty,mBC-0716-1
"B7,A4",19721,20103,15346,4757,10394,0,4468,4479,3176,1303,2.437452034,2062,515,294,167,0,167,0,66,0,0.041916168,empty,mBC-0716-1
"B7,A5",16080,16440,12312,4128,8609,0,3806,3819,2677,1142,2.3441331,1800,1215,753,360,0,360,0,123,0,0.036111111,empty,mBC-0716-1
"B7,A6",25768,27177,19372,7805,14481,0,6896,6904,5051,1853,2.725849973,3450,1127,692,369,0,369,0,141,0,0.081300813,empty,mBC-0716-1
"B7,A7",15277,15625,11655,3970,8083,0,3659,3666,2466,1200,2.055,1704,1511,701,340,0,340,0,109,0,0.029411765,empty,mBC-0716-1
"B7,A8",10709,11175,7919,3256,5836,0,2724,2728,1924,804,2.393034826,1345,1058,600,359,0,359,0,129,0,0.027855153,empty,mBC-0716-1
"B7,A9",18126,18063,14041,4022,9273,1,3947,3958,2826,1132,2.496466431,1775,3227,1178,592,1,591,1,142,0,0.052453469,empty,mBC-0716-1
"B7,A10",14390,14303,10906,3397,7471,0,3284,3284,2312,972,2.378600823,1486,300,169,100,0,100,0,46,0,0,empty,mBC-0716-1
"B7,A11",17097,17386,13057,4329,9104,0,4103,4116,2832,1284,2.205607477,1913,906,578,291,0,291,0,88,0,0.072164948,empty,mBC-0716-1
"B7,A12",19524,19584,15150,4434,10049,0,4328,4332,3005,1327,2.264506405,2011,7470,3275,1667,0,1667,0,277,0,0.179964007,empty,mBC-0716-1
"B7,B1",18407,18720,14201,4519,9517,0,4238,4254,2958,1296,2.282407407,1979,2852,1105,575,0,575,0,145,0,0.088695652,empty,mBC-0716-1
"B7,B2",18691,18833,14226,4607,9855,1,4352,4378,3003,1375,2.184,2084,378,264,151,0,151,0,55,0,0.006622517,empty,mBC-0716-1
"B7,B3",17716,18348,13635,4713,9608,0,4302,4317,3039,1278,2.377934272,2063,942,638,299,0,299,0,113,0,0.040133779,empty,mBC-0716-1
"B7,B4",15812,16173,12162,4011,8544,0,3876,3892,2776,1116,2.487455197,1842,1009,638,304,0,304,0,116,0,0.036184211,empty,mBC-0716-1
"B7,B5",16223,13776,8970,4806,8172,1,4457,4474,3121,1353,2.306725795,2495,906,498,227,0,227,0,76,0,0.04845815,empty,mBC-0716-1
"B7,B6",391171,402106,287369,114737,215431,0,106328,106463,86439,20024,4.316769876,53531,7983,5561,2518,0,2518,0,518,0,0.011119936,mm10,mBC-0716-1
"B7,B7",893660,973307,650337,322970,501175,1,268767,269148,214269,54879,3.904389657,143427,72108,49045,23426,12,23414,1,2238,0,0.001580251,mm10,mBC-0716-1
"B7,B8",12560,12817,9589,3228,6772,0,3084,3090,2145,945,2.26984127,1459,907,559,264,0,264,0,99,0,0.003787879,empty,mBC-0716-1
"B7,B9",14294,14672,10828,3844,7530,0,3357,3365,2378,987,2.409321175,1636,906,417,203,1,202,1,72,0,0.074257426,empty,mBC-0716-1
"B7,B10",616270,615202,385246,229956,330579,2,192606,193775,145837,47938,3.042200342,108579,18019,11062,5228,4,5224,1,810,0,0.004402757,mm10,mBC-0716-1
"B7,B11",15224,15426,11639,3787,7992,0,3573,3578,2583,995,2.595979899,1669,157,77,47,0,47,0,27,0,0,empty,mBC-0716-1
"B7,B12",17214,17943,13102,4841,9332,0,4227,4237,2985,1252,2.384185304,2095,1170,707,385,0,385,0,108,0,0.090909091,empty,mBC-0716-1
"B7,C1",21465,21439,16734,4705,11068,0,4667,4687,3182,1505,2.114285714,2103,728,507,251,0,251,0,82,0,0.067729084,empty,mBC-0716-1
"B7,C2",866077,924479,631011,293468,475176,2,249288,249680,205265,44415,4.62152426,130911,95245,66069,31133,16,31117,3,2744,0,0.001574702,mm10,mBC-0716-1
"B7,C3",1015688,1098682,726365,372317,558612,1,309112,309570,242065,67505,3.585882527,166960,16935,11214,5505,1,5504,1,849,0,0.004178779,mm10,mBC-0716-1
"B7,C4",16725,16740,12705,4035,8716,0,3793,3802,2661,1141,2.332164768,1773,1195,678,364,0,364,0,107,0,0.032967033,empty,mBC-0716-1
"B7,C5",15296,15617,11614,4003,8129,0,3693,3700,2546,1154,2.206239168,1752,1186,659,362,0,362,0,107,0,0.063535912,empty,mBC-0716-1
"B7,C6",1361052,1446567,969240,477327,765565,3,426594,427276,354308,72968,4.855662756,226541,112281,72883,35126,15,35111,1,2842,0,0.01264561,mm10,mBC-0716-1
"B7,C7",15314,15748,11632,4116,8126,0,3711,3720,2616,1104,2.369565217,1719,367,242,99,0,99,0,39,0,0.01010101,empty,mBC-0716-1
"B7,C8",14415,14766,10928,3838,7573,0,3465,3475,2367,1108,2.136281588,1604,1240,806,420,0,420,0,123,0,0.064285714,empty,mBC-0716-1
"B7,C9",706816,804827,487584,317243,419369,0,256173,256544,176948,79596,2.223076537,147925,17862,12784,6159,1,6158,1,873,0,0.005683664,mm10,mBC-0716-1
"B7,C10",12720,12969,9715,3254,6832,0,3085,3087,2151,936,2.298076923,1468,822,507,286,0,286,0,77,0,0.090909091,empty,mBC-0716-1
"B7,C11",10858,11317,8191,3126,5967,0,2772,2781,1898,883,2.149490374,1371,645,412,214,1,213,1,69,0,0.042253521,empty,mBC-0716-1
"B7,C12",19417,20048,14526,5522,10279,0,4715,4730,3342,1388,2.40778098,2340,1839,1000,476,0,476,0,117,0,0.132352941,empty,mBC-0716-1
"B7,D1",10937,11301,8157,3144,6085,0,2917,2929,2111,818,2.580684597,1439,3536,1250,690,0,690,0,128,0,0.065217391,empty,mBC-0716-1
"B7,D2",19698,20209,15033,5176,10535,0,4580,4591,3178,1413,2.249115357,2163,11830,4249,2133,4,2129,2,422,0,0.021606388,empty,mBC-0716-1
"B7,D3",13434,13862,9826,4036,7156,0,3375,3380,2302,1078,2.135435993,1678,7598,2751,1449,1,1448,1,245,0,0.210635359,empty,mBC-0716-1
"B7,D4",13504,13981,10275,3706,7274,0,3314,3319,2356,963,2.446521288,1613,991,629,275,0,275,0,90,0,0.032727273,empty,mBC-0716-1
"B7,D5",627889,679101,449319,229782,356094,0,194133,194421,163035,31386,5.194513477,104182,82004,57879,27813,11,27802,3,2373,0,0.002409899,mm10,mBC-0716-1
"B7,D6",11742,12211,8830,3381,6446,0,3008,3013,2122,891,2.381593715,1518,1167,807,416,0,416,0,102,0,0.086538462,empty,mBC-0716-1
"B7,D7",13067,13381,9925,3456,6894,0,3139,3147,2217,930,2.383870968,1484,11831,3997,1973,3,1970,2,324,0,0.162436548,empty,mBC-0716-1
"B7,D8",541476,588312,396185,192127,310402,1,161493,161746,136288,25458,5.35344489,85917,65448,45893,21960,7,21953,2,1988,0,0.002140937,mm10,mBC-0716-1
"B7,D9",638203,681025,435045,245980,363205,0,206516,206840,170688,36152,4.721398539,114964,276737,188421,89386,32,89354,4,4836,0,0.001936119,mm10,mBC-0716-1
"B7,D10",13098,13735,9753,3982,7041,0,3328,3336,2317,1019,2.273797841,1648,1308,613,304,0,304,0,94,0,0.0625,empty,mBC-0716-1
"B7,D11",12671,12904,9614,3290,6762,0,3090,3095,2210,885,2.497175141,1514,1267,841,400,0,400,0,115,0,0.0325,empty,mBC-0716-1
"B7,D12",1074105,1158420,787666,370754,601565,2,321410,321989,242016,79973,3.02622135,170406,88961,64014,30478,12,30466,3,2799,0,0.000426705,mm10,mBC-0716-1
"B7,E1",20872,21421,16119,5302,11085,0,4859,4862,3488,1374,2.538573508,2298,1363,777,434,0,434,0,144,0,0.087557604,empty,mBC-0716-1
"B7,E2",15804,16064,11984,4080,8495,0,3832,3849,2617,1232,2.124188312,1845,5942,2089,1052,2,1050,2,212,0,0.016190476,empty,mBC-0716-1
"B7,E3",11771,12058,9034,3024,6273,0,2788,2797,1975,822,2.402676399,1286,2384,1223,644,0,644,0,175,0,0.035714286,empty,mBC-0716-1
"B7,E4",14553,14786,11168,3618,7574,0,3357,3365,2410,955,2.523560209,1497,920,574,312,1,311,1,110,0,0.022508039,empty,mBC-0716-1
"B7,E5",19794,19927,15185,4742,10298,0,4481,4491,3186,1305,2.44137931,2088,1191,828,374,0,374,0,121,0,0.005347594,empty,mBC-0716-1
"B7,E6",12842,13046,9859,3187,6823,0,3064,3074,2095,979,2.139938713,1444,1352,842,430,0,430,0,121,0,0.055813953,empty,mBC-0716-1
"B7,E7",1689527,1747645,1262165,485480,887377,3,432993,433858,328843,105015,3.131390754,219395,123032,73863,35917,17,35900,2,3180,0,0.016211699,mm10,mBC-0716-1
"B7,E8",16522,16678,12751,3927,8760,0,3744,3752,2582,1170,2.206837607,1760,3798,1488,724,0,724,0,191,0,0.027624309,empty,mBC-0716-1
"B7,E9",8680,9029,6516,2513,4743,0,2271,2276,1592,684,2.32748538,1127,1001,694,350,0,350,0,98,0,0.085714286,empty,mBC-0716-1
"B7,E10",717846,808998,490984,318014,422747,0,260974,261310,185547,75763,2.449045048,147753,43195,29670,13920,5,13915,2,1691,0,0.002946461,mm10,mBC-0716-1
"B7,E11",538466,583238,384558,198680,309164,0,168612,168855,134488,34367,3.913288911,90918,75366,52483,25010,11,24999,3,2194,0,0.00100004,mm10,mBC-0716-1
"B7,E12",15545,15902,11599,4303,8457,0,3975,3984,2733,1251,2.184652278,1969,2183,971,449,0,449,0,128,0,0.031180401,empty,mBC-0716-1
"B7,F1",17837,17877,13104,4773,9020,0,4085,4098,2922,1176,2.484693878,1998,5965,2439,1290,0,1290,0,212,0,0.356589147,empty,mBC-0716-1
"B7,F2",22050,22452,16618,5834,11639,0,5350,5368,3735,1633,2.28720147,2549,2707,1619,814,0,814,0,230,0,0.047911548,empty,mBC-0716-1
"B7,F3",15719,16150,11720,4430,8464,0,4002,4012,2787,1225,2.275102041,1998,1282,794,427,0,427,0,143,0,0.028103044,empty,mBC-0716-1
"B7,F4",15972,16043,12175,3868,8668,1,3907,3915,2826,1089,2.595041322,1829,556,405,218,0,218,0,72,0,0.082568807,empty,mBC-0716-1
"B7,F5",22941,23493,17548,5945,12002,0,5463,5477,3819,1658,2.303377563,2561,5872,2205,1117,2,1115,2,243,0,0.059192825,empty,mBC-0716-1
"B7,F6",22212,22529,16782,5747,11732,0,5364,5368,3769,1599,2.357098186,2625,1830,1169,592,1,591,1,177,0,0.052453469,empty,mBC-0716-1
"B7,F7",18894,19203,14572,4631,10273,0,4617,4626,3188,1438,2.216968011,2193,714,452,248,0,248,0,85,0,0,empty,mBC-0716-1
"B7,F8",483460,500313,349497,150816,266321,0,138301,138520,108541,29979,3.620567731,71722,1015,708,360,0,360,0,102,0,0.002777778,empty,mBC-0716-1
"B7,F9",14582,15007,11138,3869,7808,0,3514,3521,2419,1102,2.195099819,1667,10834,3836,1926,1,1925,1,360,0,0.011428571,empty,mBC-0716-1
"B7,F10",547633,540973,429702,111271,283159,0,110918,111174,84136,27038,3.111768622,49619,19707,13055,6201,2,6199,1,926,0,0.00306501,mm10,mBC-0716-1
"B7,F11",10466,10704,7999,2705,5638,0,2535,2549,1795,754,2.380636605,1224,1040,651,324,0,324,0,98,0,0.089506173,empty,mBC-0716-1
"B7,F12",12915,13003,9831,3172,6710,0,2918,2926,1955,971,2.01338826,1360,68,47,28,0,28,0,10,0,0,empty,mBC-0716-1
"B7,G1",665680,731360,474621,256739,378190,1,214901,215234,177853,37381,4.757844894,115551,109470,77878,37192,18,37174,3,2816,0,0.001210523,mm10,mBC-0716-1
"B7,G2",19600,20011,14901,5110,10186,0,4533,4541,3181,1360,2.338970588,2066,355,187,116,0,116,0,45,0,0.043103448,empty,mBC-0716-1
"B7,G3",18493,18816,14137,4679,9855,0,4425,4448,3077,1371,2.244347192,2079,1609,1015,516,0,516,0,164,0,0.063953488,empty,mBC-0716-1
"B7,G4",26955,27462,20974,6488,14266,0,6271,6287,4435,1852,2.394708423,2977,82,59,31,0,31,0,22,0,0,empty,mBC-0716-1
"B7,G5",12445,12896,9407,3489,6713,0,3131,3132,2113,1019,2.07360157,1507,1042,699,355,0,355,0,108,0,0.064788732,empty,mBC-0716-1
"B7,G6",23511,23916,18197,5719,12410,0,5418,5440,3845,1595,2.410658307,2495,103,83,42,0,42,0,33,0,0,empty,mBC-0716-1
"B7,G7",19909,20097,15481,4616,10240,1,4544,4553,3246,1307,2.483550115,1984,4612,1969,982,1,981,1,233,0,0.088685015,empty,mBC-0716-1
"B7,G8",13497,14163,10142,4021,7398,0,3464,3478,2410,1068,2.256554307,1727,1162,797,428,0,428,0,125,0,0.08411215,empty,mBC-0716-1
"B7,G9",9963,10218,7599,2619,5337,0,2401,2404,1784,620,2.877419355,1129,1159,739,351,0,351,0,129,0,0.085470085,empty,mBC-0716-1
"B7,G10",620982,661006,459411,201595,346493,0,173201,173462,139093,34369,4.047048212,90131,104416,75460,36736,15,36721,1,2945,0,0.000517415,mm10,mBC-0716-1
"B7,G11",518906,554187,383610,170577,293284,1,152801,153035,120930,32105,3.766703006,79291,13406,9341,4494,3,4491,1,684,0,0.002894678,mm10,mBC-0716-1
"B7,G12",1422551,1633569,936266,697303,851093,4,557731,558446,417905,140541,2.973545086,328278,98189,70745,33647,16,33631,2,2858,0,0.001189379,mm10,mBC-0716-1
"B7,H1",19751,20517,15095,5422,10610,0,4820,4839,3376,1463,2.30758715,2390,662,377,220,0,220,0,93,0,0.077272727,empty,mBC-0716-1
"B7,H2",24979,25747,19000,6747,13159,0,5926,5932,4213,1719,2.450843514,2851,10252,3993,2005,0,2005,0,325,0,0.191521197,empty,mBC-0716-1
"B7,H3",19058,19496,14237,5259,10237,0,4724,4735,3416,1319,2.589840788,2372,1053,664,336,0,336,0,117,0,0.026785714,empty,mBC-0716-1
"B7,H4",12814,13182,9746,3436,6952,0,3172,3183,2233,950,2.350526316,1529,90,50,29,0,29,0,16,0,0.068965517,empty,mBC-0716-1
"B7,H5",17313,17974,13184,4790,9236,0,4298,4305,3034,1271,2.387096774,2098,1503,961,534,0,534,0,154,0,0.029962547,empty,mBC-0716-1
"B7,H6",14096,14265,10605,3660,7508,0,3449,3452,2497,955,2.614659686,1663,8703,3588,1759,1,1758,1,346,0,0.138794084,empty,mBC-0716-1
"B7,H7",17090,17496,12863,4633,9200,0,4155,4163,2976,1187,2.50716091,1977,1474,982,458,0,458,0,153,0,0.021834061,empty,mBC-0716-1
"B7,H8",13136,13663,9935,3728,7128,0,3394,3401,2371,1030,2.301941748,1702,1253,831,421,0,421,0,130,0,0.011876485,empty,mBC-0716-1
"B7,H9",680456,713507,505334,208173,370896,2,180241,180544,152143,28401,5.356959262,91668,88534,61372,29558,10,29548,2,2450,0,0.000270746,mm10,mBC-0716-1
"B7,H10",13550,13641,10231,3410,7106,0,3240,3245,2289,956,2.394351464,1495,947,592,322,1,321,1,107,0,0.059190031,empty,mBC-0716-1
"B7,H11",16723,17420,12589,4831,9070,0,4232,4241,2958,1283,2.305533905,2207,130,86,63,0,63,0,37,0,0.174603175,empty,mBC-0716-1
"B7,H12",5922,6306,4444,1862,3238,0,1508,1518,1051,467,2.250535332,762,1187,603,310,1,309,1,86,0,0.025889968,empty,mBC-0716-1
"B8,A1",14383,14786,10763,4023,8060,0,3800,3805,2801,1004,2.789840637,1886,1097,708,365,0,365,0,114,0,0.021917808,empty,mBC-0716-1
"B8,A2",18572,18974,14259,4715,10046,0,4384,4396,3113,1283,2.426344505,2076,1002,659,341,0,341,0,127,0,0.061583578,empty,mBC-0716-1
"B8,A3",608041,648264,452705,195559,350003,1,181247,181529,139217,42312,3.290248629,92775,16311,11263,5496,1,5495,1,894,0,0.004367607,mm10,mBC-0716-1
"B8,A4",747778,805223,546020,259203,428089,0,225029,225343,183609,41734,4.399506398,118778,26536,18232,8239,0,8239,0,1143,0,0.003155723,mm10,mBC-0716-1
"B8,A5",16490,17290,12661,4629,9231,0,4242,4253,3000,1253,2.394253791,2058,11322,3841,1945,3,1942,1,352,0,0.061791967,empty,mBC-0716-1
"B8,A6",616841,688967,430477,258490,368289,1,215729,215984,164748,51236,3.215473495,121011,82295,58665,27957,7,27950,2,2390,0,0.000608229,mm10,mBC-0716-1
"B8,A7",16234,17060,12410,4650,8956,0,4113,4127,2810,1317,2.133637054,2010,1159,694,364,0,364,0,132,0,0.016483516,empty,mBC-0716-1
"B8,A8",10685,11146,8054,3092,6062,0,2838,2842,2026,816,2.482843137,1366,1402,807,453,0,453,0,147,0,0.006622517,empty,mBC-0716-1
"B8,A9",18118,18370,13871,4499,9634,0,4210,4214,2910,1304,2.231595092,1968,996,652,304,0,304,0,111,0,0.009868421,empty,mBC-0716-1
"B8,A10",15070,15408,11444,3964,8402,0,3791,3795,2731,1064,2.566729323,1821,333,212,99,0,99,0,45,0,0,empty,mBC-0716-1
"B8,A11",17521,18084,13308,4776,9682,0,4410,4422,3068,1354,2.265878877,2118,1140,790,371,1,370,1,112,0,0.062162162,empty,mBC-0716-1
"B8,A12",27933,29359,20264,9095,15611,2,7856,7875,3488,4387,0.795076362,4149,3675,2168,982,1,981,1,238,0,0.070336391,empty,mBC-0716-1
"B8,B1",764244,811456,577353,234103,428381,0,204570,204881,163800,41081,3.987244712,102980,100194,72013,34132,6,34126,1,2691,0,0.001054914,mm10,mBC-0716-1
"B8,B2",20273,21067,15497,5570,11068,0,4988,4998,3487,1511,2.307743216,2399,821,408,218,0,218,0,70,0,0.096330275,empty,mBC-0716-1
"B8,B3",22038,23571,16687,6884,12811,0,6292,6300,4520,1780,2.539325843,3176,1144,691,348,0,348,0,126,0,0.037356322,empty,mBC-0716-1
"B8,B4",760028,798839,559559,239280,426019,3,220938,221294,162652,58642,2.773643464,113002,26580,16934,8255,5,8250,1,1138,0,0.004242424,mm10,mBC-0716-1
"B8,B5",8815,5571,3858,1713,3835,0,1848,1863,1300,563,2.309058615,1033,2411,906,464,1,463,1,116,0,0.064794816,empty,mBC-0716-1
"B8,B6",1244579,1457054,829728,627326,777096,2,507576,508174,338479,169695,1.994631545,302963,66574,45380,21830,12,21818,3,2214,0,0.001375011,mm10,mBC-0716-1
"B8,B7",15757,16237,12217,4020,8794,0,3923,3929,2775,1154,2.404679376,1911,1194,763,376,0,376,0,101,0,0.093085106,empty,mBC-0716-1
"B8,B8",13359,13889,10134,3755,7490,0,3389,3396,2395,1001,2.392607393,1691,2137,1123,561,0,561,0,158,0,0.021390374,empty,mBC-0716-1
"B8,B9",14750,15328,11518,3810,8055,0,3549,3564,2547,1017,2.504424779,1656,6425,2117,1095,0,1095,0,200,0,0.033789954,empty,mBC-0716-1
"B8,B10",15975,15712,11668,4044,8607,0,4020,4037,2758,1279,2.156372166,1864,647,428,219,0,219,0,68,0,0.03196347,empty,mBC-0716-1
"B8,B11",2496884,2715628,1750560,965068,1381290,0,819970,821088,647920,173168,3.741568881,446105,16331,10265,4964,4,4960,1,794,0,0.004233871,mm10,mBC-0716-1
"B8,B12",550640,597361,395853,201508,326112,1,179803,180078,111492,68586,1.625579564,100500,14669,5838,2799,4,2795,1,538,0,0.013953488,mm10,mBC-0716-1
"B8,C1",22008,21963,17063,4900,11430,0,4868,4886,3424,1462,2.341997264,2172,5571,1898,1014,1,1013,1,184,0,0.163869694,empty,mBC-0716-1
"B8,C2",19220,19949,14520,5429,10600,0,5006,5016,3448,1568,2.198979592,2485,1605,969,529,0,529,0,161,0,0.052930057,empty,mBC-0716-1
"B8,C3",21000,22159,15942,6217,11609,0,5302,5317,3786,1531,2.472893534,2689,447,264,150,0,150,0,65,0,0,empty,mBC-0716-1
"B8,C4",17252,17484,13247,4237,9491,0,4178,4185,2951,1234,2.391410049,1964,1128,672,342,0,342,0,125,0,0.064327485,empty,mBC-0716-1
"B8,C5",16257,16822,12204,4618,9065,0,4185,4202,2956,1246,2.372391653,2053,1098,669,349,0,349,0,115,0,0.054441261,empty,mBC-0716-1
"B8,C6",17001,17191,12903,4288,9602,0,4460,4473,3152,1321,2.386071158,2131,3981,1488,773,0,773,0,175,0,0.047865459,empty,mBC-0716-1
"B8,C7",15769,16450,12049,4401,8687,0,3998,4004,2826,1178,2.398981324,1889,465,330,159,0,159,0,54,0,0.094339623,empty,mBC-0716-1
"B8,C8",14794,15050,11144,3906,8164,0,3780,3791,2548,1243,2.049879324,1836,1488,903,445,0,445,0,155,0,0.017977528,empty,mBC-0716-1
"B8,C9",12384,12411,9314,3097,6705,0,3055,3063,2120,943,2.248144221,1417,722,448,239,0,239,0,86,0,0.012552301,empty,mBC-0716-1
"B8,C10",13351,13960,10222,3738,7457,0,3417,3427,2345,1082,2.16728281,1681,1809,732,403,1,402,1,116,0,0.052238806,empty,mBC-0716-1
"B8,C11",11383,11659,8720,2939,6193,1,2850,2871,1944,927,2.097087379,1314,932,619,312,0,312,0,99,0,0.073717949,empty,mBC-0716-1
"B8,C12",19821,20592,14839,5753,10795,0,4947,4959,3482,1477,2.357481381,2369,1225,810,392,0,392,0,136,0,0.030612245,empty,mBC-0716-1
"B8,D1",11342,11859,8580,3279,6431,0,3068,3076,2193,883,2.483578709,1521,3037,1081,501,1,500,1,97,0,0.072,empty,mBC-0716-1
"B8,D2",20300,20583,15730,4853,11043,0,4785,4797,3336,1461,2.283367556,2191,2060,1345,713,0,713,0,179,0,0.044880785,empty,mBC-0716-1
"B8,D3",785364,809679,601908,207771,441020,1,204341,204677,152963,51714,2.957864408,99939,46639,21803,10421,5,10416,3,1446,0,0.012000768,mm10,mBC-0716-1
"B8,D4",674274,755686,475746,279940,404769,1,224860,225165,194748,30417,6.402603807,127408,22172,7005,3356,1,3355,1,599,0,0.080774963,mm10,mBC-0716-1
"B8,D5",13871,14450,10516,3934,7688,0,3481,3487,2463,1024,2.405273438,1743,1223,759,398,0,398,0,130,0,0.050251256,empty,mBC-0716-1
"B8,D6",11830,12243,9105,3138,6656,0,3080,3088,2182,906,2.408388521,1455,1109,604,338,0,338,0,132,0,0.050295858,empty,mBC-0716-1
"B8,D7",13062,13650,9877,3773,7281,0,3394,3396,2367,1029,2.300291545,1668,1205,790,406,0,406,0,137,0,0.054187192,empty,mBC-0716-1
"B8,D8",824701,883814,593807,290007,469020,1,249611,250007,212798,37209,5.718992717,132691,82354,56136,27088,14,27074,2,2337,0,0.000147743,mm10,mBC-0716-1
"B8,D9",5222,5451,3814,1637,3010,0,1461,1471,1001,470,2.129787234,778,1202,692,350,0,350,0,133,0,0.037142857,empty,mBC-0716-1
"B8,D10",13895,14683,10729,3954,7777,0,3622,3625,2557,1068,2.394194757,1735,696,451,250,0,250,0,86,0,0.076,empty,mBC-0716-1
"B8,D11",12802,13241,9668,3573,7153,0,3278,3283,2325,958,2.426931106,1632,1429,886,510,0,510,0,189,0,0.02745098,empty,mBC-0716-1
"B8,D12",20037,20460,15244,5216,10921,0,4906,4917,3512,1405,2.499644128,2334,5264,2333,1158,3,1155,1,262,0,0.049350649,empty,mBC-0716-1
"B8,E1",21462,22149,16459,5690,11693,0,5186,5196,3673,1523,2.411687459,2497,1452,886,446,0,446,0,176,0,0.094170404,empty,mBC-0716-1
"B8,E2",16048,16233,12124,4109,8815,0,3989,3997,2876,1121,2.565566459,1874,1615,999,489,0,489,0,161,0,0.047034765,empty,mBC-0716-1
"B8,E3",1818271,1993135,1259452,733683,1028918,2,612161,613007,493262,119745,4.119270116,337800,240475,164426,79509,30,79479,1,4297,0,0.001308522,mm10,mBC-0716-1
"B8,E4",15288,15691,11634,4057,8297,0,3710,3711,2607,1104,2.361413043,1750,1109,728,374,0,374,0,137,0,0.064171123,empty,mBC-0716-1
"B8,E5",20678,21061,15984,5077,11325,0,5055,5065,3505,1560,2.246794872,2348,2202,1081,579,0,579,0,164,0,0.04835924,empty,mBC-0716-1
"B8,E6",13568,13586,10290,3296,7231,0,3160,3165,2198,967,2.273009307,1463,21355,7181,3477,9,3468,5,517,0,0.071510957,empty,mBC-0716-1
"B8,E7",541951,574532,407540,166992,308318,2,149233,149511,105656,43855,2.409212176,76558,89005,58330,28363,12,28351,2,2285,0,0.002398504,mm10,mBC-0716-1
"B8,E8",17163,17294,13130,4164,9218,0,4047,4053,2844,1209,2.35235732,1857,2000,1254,647,0,647,0,184,0,0.047913447,empty,mBC-0716-1
"B8,E9",9059,9407,6891,2516,5095,0,2444,2448,1756,692,2.537572254,1164,1162,697,356,0,356,0,111,0,0.033707865,empty,mBC-0716-1
"B8,E10",12554,13163,9555,3608,6990,0,3229,3242,2231,1011,2.206726014,1591,1105,695,329,0,329,0,118,0,0.030395137,empty,mBC-0716-1
"B8,E11",547903,595745,392639,203106,324072,1,177656,177927,145266,32661,4.447689905,95788,92624,65451,31593,8,31585,1,2575,0,0.000886497,mm10,mBC-0716-1
"B8,E12",14920,15533,11335,4198,8364,0,3909,3917,2744,1173,2.339300938,1910,1086,627,325,0,325,0,111,0,0.021538462,empty,mBC-0716-1
"B8,F1",17194,17540,13131,4409,9304,0,4093,4101,2851,1250,2.2808,1889,1213,726,344,1,343,1,111,0,0.072886297,empty,mBC-0716-1
"B8,F2",724893,794795,520588,274207,425628,0,235816,236197,193869,42328,4.580159705,128525,165889,112759,53459,18,53441,2,3523,0,0.001459554,mm10,mBC-0716-1
"B8,F3",2514779,2865026,1699452,1165574,1484198,5,945346,946561,764072,182489,4.186948254,547069,300441,201602,95718,44,95674,4,5030,0,0.00101386,mm10,mBC-0716-1
"B8,F4",17381,17734,13151,4583,9695,0,4487,4496,3196,1300,2.458461538,2168,790,471,276,0,276,0,99,0,0.076086957,empty,mBC-0716-1
"B8,F5",23076,23425,17573,5852,12546,0,5580,5589,3910,1679,2.328767123,2676,1392,808,417,0,417,0,159,0,0.045563549,empty,mBC-0716-1
"B8,F6",23053,23705,17571,6134,12663,0,5819,5831,4129,1702,2.425969448,2788,2529,1432,707,0,707,0,182,0,0.02970297,empty,mBC-0716-1
"B8,F7",19591,20091,15055,5036,11046,0,4960,4977,3533,1444,2.4466759,2395,903,574,274,0,274,0,104,0,0.062043796,empty,mBC-0716-1
"B8,F8",504012,522378,372835,149543,284424,3,140578,140818,99893,40925,2.440879658,72521,1663,1089,554,0,554,0,156,0,0.010830325,empty,mBC-0716-1
"B8,F9",15468,15901,11746,4155,8348,0,3708,3717,2605,1112,2.342625899,1759,1340,848,487,0,487,0,191,0,0.022587269,empty,mBC-0716-1
"B8,F10",20644,20956,15955,5001,11108,0,4844,4853,3406,1447,2.353835522,2219,2049,1083,543,0,543,0,149,0,0.036832413,empty,mBC-0716-1
"B8,F11",11307,11178,8513,2665,6037,0,2710,2712,1884,828,2.275362319,1248,21844,6758,3431,2,3429,2,546,0,0.059200933,empty,mBC-0716-1
"B8,F12",14026,14376,10576,3800,7532,0,3380,3389,2387,1002,2.382235529,1647,1091,296,144,0,144,0,37,0,0,empty,mBC-0716-1
"B8,G1",883327,943067,643140,299927,506898,1,275656,276095,206573,69522,2.971332816,143362,45239,26116,12613,9,12604,2,1635,0,0.012456363,mm10,mBC-0716-1
"B8,G2",20514,20684,15835,4849,10998,0,4835,4844,3343,1501,2.227181879,2263,363,238,111,0,111,0,40,0,0,empty,mBC-0716-1
"B8,G3",19346,19701,14646,5055,10555,0,4841,4842,3413,1429,2.388383485,2230,4309,1887,1015,0,1015,0,250,0,0.030541872,empty,mBC-0716-1
"B8,G4",27118,27533,20771,6762,14657,0,6512,6528,4579,1949,2.349409954,3053,118,85,47,0,47,0,33,0,0,empty,mBC-0716-1
"B8,G5",13209,13727,10161,3566,7317,0,3370,3379,2350,1029,2.283770651,1627,952,562,326,0,326,0,113,0,0.009202454,empty,mBC-0716-1
"B8,G6",24487,24995,18788,6207,13201,0,5806,5814,4055,1759,2.305287095,2764,135,95,61,0,61,0,32,0,0,empty,mBC-0716-1
"B8,G7",19418,19884,15105,4779,10512,0,4570,4583,3313,1270,2.608661417,2076,1851,1205,623,2,621,1,185,0,0.051529791,empty,mBC-0716-1
"B8,G8",14337,14678,10915,3763,7873,0,3553,3567,2403,1164,2.06443299,1697,1511,978,516,0,516,0,149,0,0.042635659,empty,mBC-0716-1
"B8,G9",10569,10723,7892,2831,5848,0,2736,2738,1991,747,2.665327979,1326,1079,712,364,0,364,0,126,0,0.115384615,empty,mBC-0716-1
"B8,G10",13302,13708,10319,3389,7291,0,3236,3242,2283,959,2.380604797,1526,1025,587,290,0,290,0,125,0,0.082758621,empty,mBC-0716-1
"B8,G11",12242,12638,9515,3123,6743,0,3029,3046,2166,880,2.461363636,1433,707,458,242,0,242,0,97,0,0.037190083,empty,mBC-0716-1
"B8,G12",11217,11551,8682,2869,6272,0,2811,2813,1962,851,2.305522914,1353,1043,623,342,1,341,1,115,0,0.023460411,empty,mBC-0716-1
"B8,H1",519832,514773,398298,116475,279195,0,117874,118103,92236,25867,3.565778792,54613,13202,9055,4431,2,4429,1,703,0,0.003386769,mm10,mBC-0716-1
"B8,H2",25692,26138,19490,6648,13976,1,6373,6400,4595,1805,2.545706371,3073,4745,2043,1035,2,1033,1,250,0,0.064859632,empty,mBC-0716-1
"B8,H3",19675,20444,14906,5538,10833,0,4999,5008,3521,1487,2.367854741,2445,1661,983,483,0,483,0,162,0,0.033126294,empty,mBC-0716-1
"B8,H4",13278,13467,10107,3360,7380,0,3344,3353,2321,1032,2.249031008,1613,136,88,44,0,44,0,26,0,0,empty,mBC-0716-1
"B8,H5",624762,682982,452945,230037,365926,2,195053,195324,151700,43624,3.477443609,105836,113452,77143,36737,13,36724,1,2862,0,0.002777475,mm10,mBC-0716-1
"B8,H6",667904,732338,489935,242403,393416,1,211661,211973,148925,63048,2.362089202,113263,92715,66106,31801,11,31790,3,2746,0,0.000975149,mm10,mBC-0716-1
"B8,H7",908807,1021195,605380,415815,544368,4,342692,343153,260448,82705,3.149120368,197484,78557,53835,25334,18,25316,2,2318,0,0.003120556,mm10,mBC-0716-1
"B8,H8",1141679,1214440,818827,395613,641964,0,344811,345319,285952,59367,4.816682669,182963,211015,147007,69668,25,69643,4,4159,0,0.000559999,mm10,mBC-0716-1
"B8,H9",690530,732168,494235,237933,393451,0,207912,208206,171548,36658,4.679687926,110376,97888,63535,30645,8,30637,1,2619,0,0.002154258,mm10,mBC-0716-1
"B8,H10",698313,730156,515325,214831,386549,0,190742,191097,160487,30610,5.242959817,96911,72316,51774,24927,9,24918,1,2256,0,0.002247371,mm10,mBC-0716-1
"B8,H11",17137,17918,13016,4902,9638,0,4530,4539,3217,1322,2.433434191,2219,150,95,65,0,65,0,39,0,0,empty,mBC-0716-1
"B8,H12",6049,6272,4535,1737,3394,0,1534,1540,1058,482,2.195020747,751,604,362,197,0,197,0,68,0,0.040609137,empty,mBC-0716-1
"B9,A1",14579,14906,11003,3903,8130,0,3835,3836,2709,1127,2.403726708,1892,657,353,179,0,179,0,68,0,0.094972067,empty,mBC-0716-1
"B9,A2",19538,20037,15152,4885,10694,0,4684,4699,3319,1380,2.405072464,2222,711,454,249,0,249,0,90,0,0.080321285,empty,mBC-0716-1
"B9,A3",16909,17277,12853,4424,9133,0,4272,4293,3079,1214,2.536243822,2009,740,472,265,0,265,0,79,0,0.033962264,empty,mBC-0716-1
"B9,A4",21916,22186,16948,5238,11620,0,5076,5080,3527,1553,2.271088216,2293,454,271,130,0,130,0,47,0,0.1,empty,mBC-0716-1
"B9,A5",17150,17858,13049,4809,9497,0,4345,4356,2985,1371,2.177242888,2117,2061,978,492,0,492,0,122,0,0.038617886,empty,mBC-0716-1
"B9,A6",535198,588156,379389,208767,316891,1,181108,181385,123413,57972,2.12883806,99352,33938,21708,10567,1,10566,1,1253,0,0.030191179,mm10,mBC-0716-1
"B9,A7",16531,17149,12740,4409,9125,0,4039,4051,2750,1301,2.113758647,1934,999,576,303,0,303,0,84,0,0.138613861,empty,mBC-0716-1
"B9,A8",11588,11798,8874,2924,6276,0,2839,2848,2032,816,2.490196078,1329,943,553,324,0,324,0,104,0,0.055555556,empty,mBC-0716-1
"B9,A9",18832,19157,14560,4597,9968,0,4322,4331,2960,1371,2.159008023,1990,1045,632,329,0,329,0,99,0,0.094224924,empty,mBC-0716-1
"B9,A10",16170,16586,12472,4114,8746,0,3870,3881,2676,1205,2.220746888,1798,321,200,119,0,119,0,45,0,0.134453782,empty,mBC-0716-1
"B9,A11",600238,655279,428523,226756,352089,1,192860,193190,148419,44771,3.315070023,104750,40316,25056,11973,3,11970,1,1474,0,0.002005013,mm10,mBC-0716-1
"B9,A12",20195,20597,15701,4896,10802,0,4762,4777,3344,1433,2.333565946,2147,2446,1444,751,1,750,1,170,0,0.121333333,empty,mBC-0716-1
"B9,B1",19188,19932,14606,5326,10512,0,4751,4764,3341,1423,2.347856641,2311,2074,1024,507,1,506,1,124,0,0.136363636,empty,mBC-0716-1
"B9,B2",20132,20472,15363,5109,10832,0,4823,4841,3325,1516,2.193271768,2285,515,320,155,0,155,0,46,0,0.019354839,empty,mBC-0716-1
"B9,B3",19104,19409,14631,4778,10440,0,4670,4683,3226,1457,2.214138641,2226,1105,656,323,0,323,0,97,0,0.046439628,empty,mBC-0716-1
"B9,B4",18036,18642,13434,5208,9661,0,4388,4402,3134,1268,2.471608833,2128,17419,5363,2768,5,2763,2,448,0,0.12631198,empty,mBC-0716-1
"B9,B5",9136,5468,3782,1686,3848,0,1892,1904,1301,603,2.157545605,1051,535,323,179,0,179,0,52,0,0.022346369,empty,mBC-0716-1
"B9,B6",12133,12646,9257,3389,6777,1,3144,3150,2184,966,2.260869565,1456,1045,687,387,0,387,0,104,0,0.028423773,empty,mBC-0716-1
"B9,B7",16455,16891,12696,4195,8955,0,3985,4000,2830,1170,2.418803419,1822,625,384,206,0,206,0,65,0,0.082524272,empty,mBC-0716-1
"B9,B8",13836,14256,10520,3736,7584,0,3457,3464,2475,989,2.502527806,1642,2830,933,483,2,481,1,139,0,0.014553015,empty,mBC-0716-1
"B9,B9",15583,15760,12134,3626,8227,0,3638,3644,2536,1108,2.288808664,1652,912,399,215,0,215,0,66,0,0.046511628,empty,mBC-0716-1
"B9,B10",16948,17195,12456,4739,9323,0,4382,4399,2980,1419,2.100070472,2175,340,134,68,0,68,0,33,0,0.161764706,empty,mBC-0716-1
"B9,B11",17526,18212,13226,4986,9578,0,4391,4402,3129,1273,2.457973291,2153,245,181,80,0,80,0,34,0,0.05,empty,mBC-0716-1
"B9,B12",469557,497009,348490,148519,271590,2,137870,138117,109739,28378,3.867044894,70857,15407,10565,5058,4,5054,1,737,0,0.005342303,mm10,mBC-0716-1
"B9,C1",22846,22900,17575,5325,12042,0,5149,5166,3623,1543,2.348023331,2357,418,247,140,0,140,0,68,0,0.007142857,empty,mBC-0716-1
"B9,C2",180540,200769,108660,92109,105612,0,71349,71446,38334,33112,1.157707176,43402,35392,15732,7523,13,7510,4,1036,0,0.031824234,mm10,mBC-0716-1
"B9,C3",22031,22586,16582,6004,12080,0,5685,5710,3990,1720,2.319767442,2775,385,226,133,0,133,0,53,0,0.210526316,empty,mBC-0716-1
"B9,C4",18416,18435,14035,4400,9896,1,4407,4418,3167,1251,2.53157474,2041,5751,1955,1009,0,1009,0,235,0,0.171456888,empty,mBC-0716-1
"B9,C5",17375,18107,13277,4830,9689,0,4430,4434,3092,1342,2.304023845,2146,1651,671,368,0,368,0,94,0,0.067934783,empty,mBC-0716-1
"B9,C6",17227,17720,12929,4791,9709,0,4558,4565,3203,1362,2.351688693,2219,1029,684,342,0,342,0,103,0,0.01754386,empty,mBC-0716-1
"B9,C7",16772,17127,12698,4429,9147,0,4250,4265,2963,1302,2.275729647,2020,268,183,98,0,98,0,37,0,0,empty,mBC-0716-1
"B9,C8",742150,811587,528658,282929,434884,0,242995,243353,199486,43867,4.547518636,131575,72251,51109,24231,7,24224,1,2175,0,0.001444848,mm10,mBC-0716-1
"B9,C9",12963,13442,9805,3637,7173,0,3300,3312,2284,1028,2.221789883,1598,3786,1311,640,1,639,1,135,0,0.082942097,empty,mBC-0716-1
"B9,C10",797473,911906,540520,371386,488156,1,312267,312628,210512,102116,2.061498688,180250,33048,22216,10574,2,10572,2,1332,0,0.006526674,mm10,mBC-0716-1
"B9,C11",11945,12130,9112,3018,6455,0,2936,2951,2045,906,2.257174393,1395,629,338,173,0,173,0,63,0,0.069364162,empty,mBC-0716-1
"B9,C12",20862,21219,15911,5308,11283,0,5105,5123,3640,1483,2.454484154,2385,870,576,265,0,265,0,76,0,0.086792453,empty,mBC-0716-1
"B9,D1",11720,12178,8738,3440,6600,0,3142,3145,2187,958,2.282881002,1575,378,206,81,0,81,0,28,0,0,empty,mBC-0716-1
"B9,D2",21039,21741,16188,5553,11551,1,5112,5139,3577,1562,2.290012804,2496,1413,952,483,0,483,0,137,0,0.039337474,empty,mBC-0716-1
"B9,D3",13941,14308,10579,3729,7675,0,3554,3564,2505,1059,2.365439093,1685,845,535,278,0,278,0,99,0,0.050359712,empty,mBC-0716-1
"B9,D4",17234,17957,13048,4909,9755,0,4700,4708,3369,1339,2.516056759,2339,827,476,252,0,252,0,89,0,0.015873016,empty,mBC-0716-1
"B9,D5",14338,15070,10846,4224,8152,0,3847,3855,2784,1071,2.599439776,2005,719,429,236,1,235,1,86,0,0.042553191,empty,mBC-0716-1
"B9,D6",389181,394548,300904,93644,216034,0,92532,92707,69700,23007,3.029512757,44122,20914,10912,5377,2,5375,1,861,0,0.00855814,mm10,mBC-0716-1
"B9,D7",474840,482812,354436,128376,262362,1,122717,122892,97039,25853,3.753490891,60551,6806,4738,2269,1,2268,1,503,0,0.011022928,mm10,mBC-0716-1
"B9,D8",939682,1014767,677573,337194,531738,2,284777,285274,239045,46229,5.170888403,151658,73136,50054,23827,9,23818,2,2084,0,8.39701E-05,mm10,mBC-0716-1
"B9,D9",5012,5169,3675,1494,2941,0,1441,1449,984,465,2.116129032,763,843,479,226,0,226,0,86,0,0.039823009,empty,mBC-0716-1
"B9,D10",14470,15042,11034,4008,8103,0,3746,3759,2593,1166,2.223842196,1826,952,449,236,0,236,0,79,0,0.033898305,empty,mBC-0716-1
"B9,D11",13396,13822,10183,3639,7484,0,3395,3404,2346,1058,2.217391304,1630,1069,627,329,0,329,0,104,0,0.100303951,empty,mBC-0716-1
"B9,D12",1610875,1791027,1138489,652538,930778,3,537315,538045,437469,100576,4.349636096,297396,323574,230509,108212,42,108170,1,5077,0,0.000526948,mm10,mBC-0716-1
"B9,E1",22508,23128,17198,5930,12376,0,5498,5510,3880,1630,2.380368098,2592,990,651,342,1,341,1,122,0,0.002932551,empty,mBC-0716-1
"B9,E2",16714,16961,12817,4144,9204,0,4111,4115,2931,1184,2.475506757,1944,996,598,293,0,293,0,92,0,0,empty,mBC-0716-1
"B9,E3",539955,583199,389047,194152,316336,0,174451,174734,122164,52570,2.323834887,93135,17662,12197,5949,1,5948,1,874,0,0.003698722,mm10,mBC-0716-1
"B9,E4",15859,16017,12264,3753,8409,0,3779,3784,2698,1086,2.484346225,1730,8475,2928,1468,2,1466,1,272,0,0.015006821,empty,mBC-0716-1
"B9,E5",1050774,1101753,786720,315033,573680,0,284406,284860,225134,59726,3.769447142,142265,80819,48953,23531,11,23520,2,2204,0,0.000807823,mm10,mBC-0716-1
"B9,E6",13883,14385,10444,3941,7542,0,3449,3465,2385,1080,2.208333333,1688,809,534,289,0,289,0,89,0,0.093425606,empty,mBC-0716-1
"B9,E7",14619,15058,11160,3898,8033,0,3663,3670,2571,1099,2.339399454,1734,719,485,265,0,265,0,99,0,0.041509434,empty,mBC-0716-1
"B9,E8",18104,18355,13957,4398,9822,0,4230,4238,2985,1253,2.382282522,1963,1341,872,455,0,455,0,132,0,0.050549451,empty,mBC-0716-1
"B9,E9",9197,9684,6944,2740,5153,0,2394,2398,1721,677,2.542097489,1180,718,432,238,0,238,0,93,0,0.046218487,empty,mBC-0716-1
"B9,E10",14727,14809,10679,4130,7592,0,3509,3519,2422,1097,2.207839562,1680,19292,6646,3410,1,3409,1,514,0,0.142857143,empty,mBC-0716-1
"B9,E11",9536,9573,7270,2303,5197,0,2364,2369,1621,748,2.167112299,1067,815,492,239,0,239,0,79,0,0.041841004,empty,mBC-0716-1
"B9,E12",16338,16617,11955,4662,8649,0,4032,4048,2804,1244,2.254019293,1929,38518,11697,5908,2,5906,1,846,0,0.07907213,empty,mBC-0716-1
"B9,F1",18028,18271,13808,4463,9747,0,4330,4346,3010,1336,2.252994012,2033,1152,669,322,0,322,0,93,0,0.083850932,empty,mBC-0716-1
"B9,F2",811110,901519,572146,329373,480176,1,277307,277683,208979,68704,3.041729739,154858,38466,26574,12723,4,12719,1,1579,0,0.005110465,mm10,mBC-0716-1
"B9,F3",16958,17737,12818,4919,9541,0,4519,4529,3131,1398,2.23962804,2261,3132,1239,650,0,650,0,189,0,0.027692308,empty,mBC-0716-1
"B9,F4",17107,17271,12954,4317,9563,0,4197,4210,2963,1247,2.376102646,2016,507,266,157,0,157,0,67,0,0,empty,mBC-0716-1
"B9,F5",25114,25324,19019,6305,13168,0,5837,5842,4106,1736,2.365207373,2733,19104,6018,3054,5,3049,3,483,0,0.118399475,empty,mBC-0716-1
"B9,F6",24337,24873,18417,6456,13145,0,6002,6020,4308,1712,2.51635514,2892,2188,1274,676,0,676,0,164,0,0.107988166,empty,mBC-0716-1
"B9,F7",19967,20198,15362,4836,11064,0,4947,4962,3578,1384,2.585260116,2241,1490,749,366,0,366,0,99,0,0.008196721,empty,mBC-0716-1
"B9,F8",876372,884317,666853,217464,473749,1,216415,216769,144638,72131,2.005212738,103497,1931,838,485,0,485,0,114,0,0.008247423,empty,mBC-0716-1
"B9,F9",15396,15749,11661,4088,8422,0,3836,3857,2757,1100,2.506363636,1832,1354,871,507,0,507,0,132,0,0.053254438,empty,mBC-0716-1
"B9,F10",2380099,2648579,1631627,1016952,1348128,3,832001,833160,670697,162463,4.128306137,464236,196501,131948,62658,20,62638,3,3781,0,0.001708228,mm10,mBC-0716-1
"B9,F11",11924,12428,9039,3389,6514,0,2976,2978,2037,941,2.164718385,1452,738,463,210,1,209,1,76,0,0.028708134,empty,mBC-0716-1
"B9,F12",1896974,2108697,1330953,777744,1077093,2,647793,648647,472841,175806,2.689561221,360953,6365,4109,2062,0,2062,0,360,0,0.000484966,mm10,mBC-0716-1
"B9,G1",10550,10801,8150,2651,5631,0,2461,2467,1768,699,2.529327611,1092,2449,1088,531,0,531,0,122,0,0.131826742,empty,mBC-0716-1
"B9,G2",21007,21182,16066,5116,11306,0,5058,5068,3536,1532,2.308093995,2326,375,243,142,0,142,0,49,0,0,empty,mBC-0716-1
"B9,G3",1381332,1520637,981305,539332,801820,1,458911,459494,354255,105239,3.366195042,251795,99683,68543,33139,8,33131,1,2780,0,0.001539344,mm10,mBC-0716-1
"B9,G4",28545,28725,22151,6574,15208,0,6589,6598,4670,1928,2.42219917,2974,89,64,45,0,45,0,24,0,0,empty,mBC-0716-1
"B9,G5",13489,14223,10437,3786,7493,0,3366,3376,2288,1088,2.102941176,1609,792,501,238,0,238,0,76,0,0.138655462,empty,mBC-0716-1
"B9,G6",25028,25472,19412,6060,13438,0,5861,5879,4146,1733,2.392383151,2666,81,46,24,0,24,0,17,0,0,empty,mBC-0716-1
"B9,G7",1676638,1787101,1213855,573246,930749,5,506715,507530,412569,94961,4.344615158,266301,113712,80668,38551,13,38538,1,3171,0,0.001245524,mm10,mBC-0716-1
"B9,G8",14898,15402,11331,4071,8248,0,3848,3855,2682,1173,2.286445013,1887,950,650,373,1,372,1,118,0,0.102150538,empty,mBC-0716-1
"B9,G9",10874,11298,8334,2964,6015,0,2751,2760,1944,816,2.382352941,1339,730,446,253,0,253,0,94,0,0,empty,mBC-0716-1
"B9,G10",13771,14189,10691,3498,7540,0,3391,3401,2416,985,2.452791878,1572,1006,623,335,0,335,0,103,0,0.017910448,empty,mBC-0716-1
"B9,G11",680111,741194,495171,246023,395815,1,211797,212059,181387,30672,5.913764997,112608,37003,24508,11988,6,11982,2,1355,0,0.004172926,mm10,mBC-0716-1
"B9,G12",11896,12215,8986,3229,6487,0,3032,3034,2192,842,2.603325416,1410,792,536,292,0,292,0,90,0,0.051369863,empty,mBC-0716-1
"B9,H1",21473,21868,16352,5516,11659,0,5251,5264,3769,1495,2.521070234,2485,792,511,248,0,248,0,88,0,0.012096774,empty,mBC-0716-1
"B9,H2",24137,24231,18582,5649,12580,0,5548,5550,3838,1712,2.24182243,2463,1296,814,405,1,404,1,123,0,0.037128713,empty,mBC-0716-1
"B9,H3",20487,21285,15501,5784,11280,0,5251,5261,3719,1542,2.411802853,2568,944,554,302,1,301,1,95,0,0.159468439,empty,mBC-0716-1
"B9,H4",13717,13892,10351,3541,7494,0,3414,3432,2398,1034,2.319148936,1670,147,102,63,0,63,0,25,0,0,empty,mBC-0716-1
"B9,H5",1026525,1096939,745488,351451,569744,1,303884,304342,259601,44741,5.802306609,158741,86878,56207,26863,12,26851,2,2342,0,0.000968307,mm10,mBC-0716-1
"B9,H6",15011,15388,11342,4046,8276,0,3858,3864,2721,1143,2.380577428,1847,1060,764,409,0,409,0,127,0,0.004889976,empty,mBC-0716-1
"B9,H7",17919,18337,13495,4842,9967,0,4660,4671,3291,1380,2.384782609,2327,939,572,273,0,273,0,106,0,0,empty,mBC-0716-1
"B9,H8",14067,14554,10571,3983,7808,0,3643,3655,2566,1089,2.356290174,1836,1132,712,360,0,360,0,101,0,0.088888889,empty,mBC-0716-1
"B9,H9",16416,16774,12243,4531,8893,0,4029,4036,2886,1150,2.509565217,1973,13870,4307,2171,3,2168,2,402,0,0.029520295,empty,mBC-0716-1
"B9,H10",14239,14541,10674,3867,7750,0,3578,3585,2501,1084,2.307195572,1723,958,610,333,1,332,1,104,0,0,empty,mBC-0716-1
"B9,H11",17380,17783,12953,4830,9672,0,4458,4465,3218,1247,2.580593424,2204,76,50,33,0,33,0,22,0,0.242424242,empty,mBC-0716-1
"B9,H12",6196,6481,4656,1825,3532,0,1685,1686,1217,469,2.594882729,798,503,287,150,0,150,0,50,0,0.08,empty,mBC-0716-1
"B10,A1",12369,12424,9369,3055,6777,0,3005,3013,2145,868,2.471198157,1383,828,517,279,0,279,0,98,0,0.039426523,empty,mBC-0716-1
"B10,A2",567666,581732,415415,166317,312991,0,156326,156561,123934,32627,3.798510436,78251,14685,8202,4099,4,4095,1,725,0,0.014896215,mm10,mBC-0716-1
"B10,A3",14302,14821,10921,3900,7861,0,3602,3606,2466,1140,2.163157895,1737,705,387,206,0,206,0,69,0,0.009708738,empty,mBC-0716-1
"B10,A4",19229,19247,14949,4298,10020,0,4272,4290,3023,1267,2.385951066,1940,836,436,257,0,257,0,73,0,0.101167315,empty,mBC-0716-1
"B10,A5",15120,15745,11575,4170,8329,1,3837,3846,2718,1128,2.409574468,1865,1586,1055,501,0,501,0,115,0,0.051896208,empty,mBC-0716-1
"B10,A6",11459,11781,8711,3070,6205,0,2876,2887,2009,878,2.288154897,1344,1372,873,462,0,462,0,125,0,0.064935065,empty,mBC-0716-1
"B10,A7",14756,15154,11297,3857,8019,1,3638,3653,2503,1150,2.176521739,1741,7706,2618,1326,1,1325,1,269,0,0.012830189,empty,mBC-0716-1
"B10,A8",402215,444200,282306,161894,242252,0,143259,143433,104705,38728,2.703599463,79059,34116,16662,8081,3,8078,1,1183,0,0.022901708,mm10,mBC-0716-1
"B10,A9",16373,16594,12874,3720,8657,0,3721,3727,2617,1110,2.357657658,1652,1287,816,379,0,379,0,94,0,0.094986807,empty,mBC-0716-1
"B10,A10",13711,13795,10399,3396,7352,0,3296,3298,2343,955,2.453403141,1496,434,279,145,0,145,0,46,0,0.068965517,empty,mBC-0716-1
"B10,A11",16019,16326,12323,4003,8690,0,3815,3834,2638,1196,2.205685619,1780,908,553,265,0,265,0,79,0,0.090566038,empty,mBC-0716-1
"B10,A12",18660,18901,14329,4572,9960,0,4324,4330,3060,1270,2.409448819,1998,2257,1282,685,1,684,1,175,0,0.064327485,empty,mBC-0716-1
"B10,B1",17256,17574,13012,4562,9334,0,4095,4102,2900,1202,2.412645591,2014,1016,546,277,0,277,0,95,0,0.014440433,empty,mBC-0716-1
"B10,B2",17979,18026,13714,4312,9559,0,4110,4110,2851,1259,2.264495631,1854,3270,928,482,0,482,0,116,0,0.026970954,empty,mBC-0716-1
"B10,B3",1556439,1818824,1036170,782654,954065,1,620233,621041,515664,105377,4.893515663,365015,195707,131101,62292,19,62273,1,4020,0,0.001075908,mm10,mBC-0716-1
"B10,B4",14690,14734,11350,3384,7916,0,3442,3455,2436,1019,2.390578999,1642,996,602,305,0,305,0,105,0,0.072131148,empty,mBC-0716-1
"B10,B5",11802,8807,6520,2287,5540,0,2391,2405,1692,713,2.373071529,1243,734,479,245,0,245,0,69,0,0.040816327,empty,mBC-0716-1
"B10,B6",10477,10818,7970,2848,5739,0,2652,2661,1841,820,2.245121951,1276,1224,609,321,0,321,0,100,0,0.099688474,empty,mBC-0716-1
"B10,B7",14607,15461,11235,4226,8198,0,3744,3757,2583,1174,2.200170358,1846,744,452,226,0,226,0,76,0,0.10619469,empty,mBC-0716-1
"B10,B8",11711,11697,9033,2664,6323,0,2759,2764,1945,819,2.374847375,1295,2097,952,431,0,431,0,124,0,0.078886311,empty,mBC-0716-1
"B10,B9",13740,14158,10603,3555,7383,0,3252,3256,2274,982,2.315682281,1548,435,281,143,0,143,0,60,0,0.013986014,empty,mBC-0716-1
"B10,B10",14669,14420,10562,3858,7816,0,3497,3508,2405,1103,2.180417044,1706,458,235,125,0,125,0,46,0,0.04,empty,mBC-0716-1
"B10,B11",15633,16153,11870,4283,8486,0,3879,3886,2761,1125,2.454222222,1869,161,116,59,0,59,0,34,0,0,empty,mBC-0716-1
"B10,B12",16152,16426,12405,4021,8766,0,3955,3962,2795,1167,2.395029991,1826,4534,1572,763,0,763,0,167,0,0.051114024,empty,mBC-0716-1
"B10,C1",1278080,1388224,891085,497139,706946,3,409939,410486,340490,69996,4.864420824,223404,36957,26788,12941,3,12938,1,1421,0,0.001313959,mm10,mBC-0716-1
"B10,C2",16852,17280,12772,4508,9058,0,4134,4145,2901,1244,2.331993569,1953,2050,1071,536,0,536,0,169,0,0.005597015,empty,mBC-0716-1
"B10,C3",18099,18433,13910,4523,9732,0,4333,4342,3055,1287,2.373737374,1992,752,429,213,0,213,0,57,0,0.061032864,empty,mBC-0716-1
"B10,C4",15697,15830,12018,3812,8473,0,3691,3694,2598,1096,2.370437956,1717,1037,642,330,0,330,0,111,0,0.03030303,empty,mBC-0716-1
"B10,C5",14313,14609,10899,3710,7718,0,3540,3548,2564,984,2.605691057,1691,3734,1284,667,1,666,1,149,0,0.18018018,empty,mBC-0716-1
"B10,C6",15901,16284,11954,4330,8889,0,4086,4096,2952,1144,2.58041958,1946,7187,2501,1321,5,1316,1,281,0,0.029635258,empty,mBC-0716-1
"B10,C7",14463,15019,11001,4018,7843,0,3615,3626,2501,1125,2.223111111,1794,270,173,94,0,94,0,36,0,0.127659574,empty,mBC-0716-1
"B10,C8",12785,12697,9798,2899,6790,0,3019,3020,2145,875,2.451428571,1336,1443,877,442,0,442,0,124,0,0.085972851,empty,mBC-0716-1
"B10,C9",455759,447277,353875,93402,240794,2,97951,98155,72586,25569,2.838828269,45021,18569,11969,5844,3,5841,2,842,0,0.0047937,mm10,mBC-0716-1
"B10,C10",61269,71440,44667,26773,38256,1,22345,22393,14518,7875,1.843555556,12553,6814,4115,2005,2,2003,2,376,0,0.011482776,empty,mBC-0716-1
"B10,C11",10136,10456,7695,2761,5555,0,2575,2580,1804,776,2.324742268,1223,910,607,315,0,315,0,91,0,0.057142857,empty,mBC-0716-1
"B10,C12",17641,18205,13441,4764,9702,0,4433,4434,3127,1307,2.392501913,2117,8234,2946,1414,1,1413,1,285,0,0.024769993,empty,mBC-0716-1
"B10,D1",10098,10534,7594,2940,5660,0,2722,2728,1932,796,2.427135678,1328,1311,435,234,1,233,1,69,0,0.008583691,empty,mBC-0716-1
"B10,D2",18382,18861,14349,4512,10033,1,4293,4309,2983,1326,2.249622926,1944,2189,1387,704,0,704,0,184,0,0.078125,empty,mBC-0716-1
"B10,D3",11842,12506,9061,3445,6699,0,3096,3100,2125,975,2.179487179,1504,4772,1604,822,0,822,0,182,0,0.025547445,empty,mBC-0716-1
"B10,D4",12857,13432,9720,3712,7012,0,3244,3248,2254,994,2.267605634,1593,883,577,301,0,301,0,101,0,0.119601329,empty,mBC-0716-1
"B10,D5",12087,12317,9210,3107,6657,0,3091,3103,2175,928,2.34375,1425,1066,702,384,0,384,0,105,0,0,empty,mBC-0716-1
"B10,D6",11110,11249,8449,2800,5879,0,2665,2676,1860,816,2.279411765,1250,1154,737,372,0,372,0,114,0,0.032258065,empty,mBC-0716-1
"B10,D7",596581,686996,398952,288044,368414,0,233329,233592,190468,43124,4.416751693,136334,106290,74642,35788,6,35782,1,2820,0,0.002263708,mm10,mBC-0716-1
"B10,D8",14068,14177,10594,3583,7543,0,3435,3441,2363,1078,2.192022263,1627,795,544,280,0,280,0,90,0,0,empty,mBC-0716-1
"B10,D9",3921,3961,2926,1035,2230,0,1058,1061,765,296,2.584459459,519,1182,628,321,0,321,0,111,0,0.040498442,empty,mBC-0716-1
"B10,D10",13831,14195,10368,3827,7621,0,3573,3578,2571,1007,2.553128103,1713,747,458,207,0,207,0,78,0,0.082125604,empty,mBC-0716-1
"B10,D11",864552,971182,594291,376891,513321,1,301881,302297,230301,71996,3.198802711,175568,179121,119890,56651,28,56623,2,3799,0,0.005421825,mm10,mBC-0716-1
"B10,D12",774105,812286,576050,236236,427437,1,211740,212137,174693,37444,4.665447068,106694,95141,66449,31667,8,31659,2,2498,0,0.001326637,mm10,mBC-0716-1
"B10,E1",19179,19184,14651,4533,10185,0,4442,4454,3116,1338,2.328849028,2093,3102,1503,722,1,721,1,188,0,0.045769764,empty,mBC-0716-1
"B10,E2",14278,14429,10705,3724,7680,0,3438,3449,2448,1001,2.445554446,1668,8044,2924,1394,1,1393,1,261,0,0.100502513,empty,mBC-0716-1
"B10,E3",10916,11058,8470,2588,5938,0,2575,2579,1796,783,2.293742018,1184,6154,2276,1063,1,1062,1,208,0,0.055555556,empty,mBC-0716-1
"B10,E4",546139,562600,424485,138115,299769,2,134658,134899,108826,26073,4.173896368,64455,13524,8753,4216,0,4216,0,705,0,0.039136622,mm10,mBC-0716-1
"B10,E5",18781,19443,14450,4993,10215,0,4539,4554,3173,1381,2.297610427,2181,3057,1408,656,0,656,0,156,0,0.032012195,empty,mBC-0716-1
"B10,E6",12026,11909,9237,2672,6370,0,2738,2749,1882,867,2.170703576,1231,1349,928,433,0,433,0,110,0,0.016166282,empty,mBC-0716-1
"B10,E7",12472,12693,9471,3222,6754,0,3025,3029,2117,912,2.32127193,1415,2342,946,504,1,503,1,139,0,0.035785288,empty,mBC-0716-1
"B10,E8",637363,672117,475535,196582,358490,1,175931,176220,148135,28085,5.274523767,89353,140044,95365,45953,21,45932,1,3288,0,0.001545763,mm10,mBC-0716-1
"B10,E9",7732,8149,5865,2284,4330,0,1989,1997,1385,612,2.263071895,979,1792,855,435,0,435,0,122,0,0.032183908,empty,mBC-0716-1
"B10,E10",11995,12482,9174,3308,6592,0,3019,3027,2055,972,2.114197531,1477,1103,762,387,0,387,0,111,0,0.124031008,empty,mBC-0716-1
"B10,E11",8108,8419,6053,2366,4499,0,2098,2099,1455,644,2.25931677,1076,890,559,321,0,321,0,93,0,0.093457944,empty,mBC-0716-1
"B10,E12",13383,13479,10033,3446,7267,0,3303,3314,2325,989,2.350859454,1644,1193,636,321,0,321,0,100,0,0.009345794,empty,mBC-0716-1
"B10,F1",15933,16282,12166,4116,8601,0,3901,3923,2815,1108,2.540613718,1848,2162,1106,587,0,587,0,131,0,0.195911414,empty,mBC-0716-1
"B10,F2",20259,20899,15212,5687,11079,0,5085,5090,3598,1492,2.41152815,2475,31669,10807,5474,4,5470,2,785,0,0.08226691,empty,mBC-0716-1
"B10,F3",652292,679609,482839,196770,361791,0,176230,176504,148064,28440,5.206188467,88837,108392,68460,32269,14,32255,2,2656,0,0.003782359,mm10,mBC-0716-1
"B10,F4",14586,15031,11039,3992,8234,0,3817,3828,2732,1096,2.49270073,1904,499,297,169,0,169,0,62,0,0,empty,mBC-0716-1
"B10,F5",21449,21905,16328,5577,11524,0,5287,5297,3728,1569,2.376035692,2426,1452,925,463,1,462,1,154,0,0.034632035,empty,mBC-0716-1
"B10,F6",20556,21434,15524,5910,11308,0,5254,5258,3700,1558,2.374839538,2582,10992,3984,2059,0,2059,0,384,0,0.063137445,empty,mBC-0716-1
"B10,F7",17700,18094,13548,4546,9791,0,4319,4330,3030,1300,2.330769231,2099,896,540,273,2,271,2,81,0,0.140221402,empty,mBC-0716-1
"B10,F8",595888,608532,443424,165108,327368,1,158482,158766,126905,31861,3.983082766,78331,2579,1761,837,1,836,1,205,0,0,empty,mBC-0716-1
"B10,F9",13669,13854,10334,3520,7299,0,3265,3271,2255,1016,2.219488189,1576,1825,1175,604,0,604,0,194,0,0.033112583,empty,mBC-0716-1
"B10,F10",18159,18264,13833,4431,9788,0,4250,4263,2955,1308,2.259174312,2039,5286,1872,943,1,942,1,218,0,0.116772824,empty,mBC-0716-1
"B10,F11",10058,10169,7597,2572,5531,0,2519,2527,1753,774,2.264857881,1194,837,493,288,0,288,0,99,0,0.111111111,empty,mBC-0716-1
"B10,F12",12393,12516,9453,3063,6626,0,2887,2894,1981,913,2.169769989,1324,70,48,25,0,25,0,16,0,0,empty,mBC-0716-1
"B10,G1",8742,8728,6804,1924,4793,0,2051,2057,1413,644,2.194099379,909,1553,1051,557,0,557,0,139,0,0.016157989,empty,mBC-0716-1
"B10,G2",18750,19027,14281,4746,9906,0,4381,4386,3091,1295,2.386872587,1996,1507,596,320,0,320,0,81,0,0.025,empty,mBC-0716-1
"B10,G3",17208,17609,13096,4513,9284,0,4208,4216,2955,1261,2.343378271,2021,1782,1122,575,0,575,0,161,0,0.04,empty,mBC-0716-1
"B10,G4",25063,25408,19557,5851,13316,0,5819,5828,4174,1654,2.523579202,2635,79,54,30,0,30,0,21,0,0,empty,mBC-0716-1
"B10,G5",12515,12577,9219,3358,6521,0,3030,3040,2168,872,2.486238532,1423,28836,8948,4491,3,4488,2,668,0,0.085561497,empty,mBC-0716-1
"B10,G6",708136,750908,523561,227347,398539,2,200187,200520,172549,27971,6.168853455,102475,8890,6166,2936,0,2936,0,471,0,0.000681199,mm10,mBC-0716-1
"B10,G7",18258,18901,14045,4856,9962,0,4492,4494,3148,1346,2.338781575,2176,1576,964,548,0,548,0,143,0,0.074817518,empty,mBC-0716-1
"B10,G8",619190,707133,436643,270490,376675,1,218369,218641,154226,64415,2.394255996,125079,102237,68052,32596,11,32585,4,2798,0,0.002700629,mm10,mBC-0716-1
"B10,G9",9298,9831,7102,2729,5236,0,2417,2419,1721,698,2.465616046,1175,1197,752,382,0,382,0,127,0,0.047120419,empty,mBC-0716-1
"B10,G10",12144,12393,9220,3173,6436,0,2888,2891,2003,888,2.255630631,1335,927,595,325,0,325,0,114,0,0.012307692,empty,mBC-0716-1
"B10,G11",11204,11597,8636,2961,6143,0,2785,2793,1980,813,2.435424354,1303,686,482,231,0,231,0,79,0,0.060606061,empty,mBC-0716-1
"B10,G12",10294,10551,7815,2736,5657,0,2611,2616,1891,725,2.608275862,1264,1021,685,382,0,382,0,104,0,0.164921466,empty,mBC-0716-1
"B10,H1",1297460,1414210,933451,480759,742728,1,407700,408326,348483,59843,5.823287603,220252,90495,63924,30515,13,30502,3,2639,0,0.000754049,mm10,mBC-0716-1
"B10,H2",21994,22547,16957,5590,11928,0,5441,5456,3880,1576,2.461928934,2566,4179,1831,931,1,930,1,213,0,0.038709677,empty,mBC-0716-1
"B10,H3",17633,18361,13392,4969,9585,0,4326,4331,2987,1344,2.222470238,2105,1198,766,389,0,389,0,116,0,0.064267352,empty,mBC-0716-1
"B10,H4",11639,11969,8890,3079,6381,0,2916,2921,2032,889,2.285714286,1430,164,113,69,0,69,0,31,0,0.086956522,empty,mBC-0716-1
"B10,H5",15948,16456,12042,4414,8628,1,3904,3911,2755,1156,2.383217993,1865,1325,854,452,0,452,0,151,0,0.011061947,empty,mBC-0716-1
"B10,H6",12485,13036,9381,3655,6932,0,3151,3156,2219,937,2.368196371,1537,1355,939,479,0,479,0,145,0,0.06263048,empty,mBC-0716-1
"B10,H7",15402,15727,11490,4237,8496,0,3942,3946,2800,1146,2.443280977,1976,1310,862,472,0,472,0,151,0,0.040254237,empty,mBC-0716-1
"B10,H8",12243,12458,9269,3189,6660,2,3000,3004,2135,869,2.456846951,1431,1297,821,426,0,426,0,145,0,0.0657277,empty,mBC-0716-1
"B10,H9",14462,14751,10875,3876,7909,0,3586,3597,2604,993,2.622356495,1757,908,523,297,0,297,0,113,0,0.070707071,empty,mBC-0716-1
"B10,H10",12423,12515,9379,3136,6731,0,3060,3067,2164,903,2.396456257,1475,1164,690,340,0,340,0,105,0,0,empty,mBC-0716-1
"B10,H11",515432,564587,371462,193125,303994,0,164646,164876,133705,31171,4.289403612,89348,1963,1171,598,0,598,0,147,0,0.001672241,empty,mBC-0716-1
"B10,H12",5359,5531,4113,1418,2972,0,1360,1363,985,378,2.605820106,645,608,339,165,0,165,0,50,0,0.109090909,empty,mBC-0716-1
"B11,A1",14343,14924,10805,4119,8273,0,3997,4000,2932,1068,2.745318352,1941,902,632,266,0,266,0,74,0,0.109022556,empty,mBC-0716-1
"B11,A2",18845,19207,14521,4686,10354,0,4589,4600,3338,1262,2.645007924,2158,729,502,272,1,271,1,70,0,0.070110701,empty,mBC-0716-1
"B11,A3",785620,827430,589389,238041,433652,1,209862,210219,175777,34442,5.103565414,105315,48319,34581,16153,6,16147,1,1758,0,0.000743172,mm10,mBC-0716-1
"B11,A4",20033,20483,15563,4920,10702,0,4676,4682,3353,1329,2.522949586,2166,348,192,107,0,107,0,38,0,0.112149533,empty,mBC-0716-1
"B11,A5",16859,17445,12815,4630,9190,0,4202,4210,2996,1214,2.467874794,2026,5044,1958,975,0,975,0,195,0,0.063589744,empty,mBC-0716-1
"B11,A6",535604,600270,370226,230044,321672,0,192685,192936,146560,46376,3.160255304,109332,36889,23268,11171,6,11165,1,1442,0,0.003224362,mm10,mBC-0716-1
"B11,A7",15370,16007,11854,4153,8587,0,3932,3940,2731,1209,2.258891646,1908,995,500,237,0,237,0,101,0,0.092827004,empty,mBC-0716-1
"B11,A8",10619,10963,8216,2747,5973,0,2708,2711,1934,777,2.489060489,1226,1127,718,350,0,350,0,107,0,0.054285714,empty,mBC-0716-1
"B11,A9",19581,19886,14985,4901,10560,0,4783,4805,3414,1391,2.454349389,2179,18507,5693,2910,1,2909,1,469,0,0.044345136,empty,mBC-0716-1
"B11,A10",15456,15771,11775,3996,8440,0,3873,3880,2688,1192,2.255033557,1815,275,152,88,0,88,0,30,0,0,empty,mBC-0716-1
"B11,A11",18059,18770,13748,5022,9954,0,4565,4573,3284,1289,2.547711404,2269,32849,9457,4725,5,4720,3,691,0,0.031991525,empty,mBC-0716-1
"B11,A12",451203,449212,341883,107329,240755,0,106881,107083,83628,23455,3.565465786,50488,7913,5511,2713,2,2711,1,575,0,0.008115087,mm10,mBC-0716-1
"B11,B1",17648,18342,13460,4882,9680,0,4406,4417,3055,1362,2.243024963,2105,825,592,302,1,301,1,90,0,0.073089701,empty,mBC-0716-1
"B11,B2",19154,19514,14557,4957,10442,1,4585,4605,3202,1403,2.282252316,2161,373,228,148,0,148,0,42,0,0,empty,mBC-0716-1
"B11,B3",18023,18255,13768,4487,9831,0,4492,4507,3186,1321,2.411809235,2109,863,531,251,0,251,0,79,0,0.007968127,empty,mBC-0716-1
"B11,B4",15719,16440,12098,4342,8789,0,4049,4057,2795,1262,2.21473851,1957,633,382,206,0,206,0,82,0,0.029126214,empty,mBC-0716-1
"B11,B5",10268,6881,4766,2115,4588,1,2174,2193,1556,637,2.442700157,1199,549,392,211,0,211,0,57,0,0,empty,mBC-0716-1
"B11,B6",11653,12457,8721,3736,6686,0,3245,3250,2216,1034,2.143133462,1664,705,419,225,0,225,0,69,0,0.066666667,empty,mBC-0716-1
"B11,B7",15139,15716,11667,4049,8310,0,3770,3776,2656,1120,2.371428571,1804,606,424,218,0,218,0,65,0,0.087155963,empty,mBC-0716-1
"B11,B8",12765,13490,9748,3742,7209,0,3375,3379,2399,980,2.447959184,1676,502,329,195,0,195,0,74,0,0.061538462,empty,mBC-0716-1
"B11,B9",14623,14734,11132,3602,7691,0,3464,3472,2505,967,2.590486039,1596,469,299,154,0,154,0,50,0,0,empty,mBC-0716-1
"B11,B10",373021,356989,253085,103904,200490,1,98918,99417,75036,24381,3.077642426,51346,3594,2327,1140,0,1140,0,239,0,0,mm10,mBC-0716-1
"B11,B11",16361,16708,12600,4108,8933,0,4029,4039,2797,1242,2.252012882,1863,190,111,66,0,66,0,30,0,0.090909091,empty,mBC-0716-1
"B11,B12",17196,17675,13050,4625,9598,0,4324,4333,3083,1250,2.4664,2099,1035,671,327,0,327,0,97,0,0.058103976,empty,mBC-0716-1
"B11,C1",1795897,1883542,1315723,567819,957790,4,506174,507006,383892,123114,3.118183147,257459,32560,22433,10769,5,10764,1,1360,0,0.001950948,mm10,mBC-0716-1
"B11,C2",1551283,1736426,1051983,684443,910911,2,574474,575269,427313,147956,2.888108627,328554,58744,40998,19726,5,19721,2,2273,0,0.001216977,mm10,mBC-0716-1
"B11,C3",18954,19433,14385,5048,10271,1,4694,4701,3325,1376,2.416424419,2236,663,419,209,0,209,0,57,0,0.023923445,empty,mBC-0716-1
"B11,C4",17258,17591,13307,4284,9506,0,4243,4248,3009,1239,2.428571429,1938,842,576,305,0,305,0,94,0,0.052459016,empty,mBC-0716-1
"B11,C5",15773,16362,12065,4297,8576,1,3943,3956,2810,1146,2.452006981,1866,737,409,223,0,223,0,61,0,0.053811659,empty,mBC-0716-1
"B11,C6",1526131,1658810,1054849,603961,894579,1,523614,524350,396136,128214,3.089646996,292449,124780,86929,41337,16,41321,3,3146,0,0.000435614,mm10,mBC-0716-1
"B11,C7",16677,17506,12590,4916,9421,0,4457,4464,3209,1255,2.556972112,2263,268,173,105,0,105,0,36,0,0,empty,mBC-0716-1
"B11,C8",14635,15328,11255,4073,8155,0,3808,3814,2638,1176,2.243197279,1820,1091,686,367,0,367,0,99,0,0.057220708,empty,mBC-0716-1
"B11,C9",12032,12326,9204,3122,6594,0,3039,3051,2123,928,2.287715517,1458,717,407,214,0,214,0,63,0,0.028037383,empty,mBC-0716-1
"B11,C10",716471,804530,499202,305328,428004,0,252523,252848,214059,38789,5.518549073,140981,57238,38945,18974,5,18969,2,1990,0,0.002583162,mm10,mBC-0716-1
"B11,C11",11381,11659,8648,3011,6174,0,2828,2838,1964,874,2.247139588,1320,490,312,178,0,178,0,65,0,0.011235955,empty,mBC-0716-1
"B11,C12",422706,431841,318221,113620,234351,0,108753,108961,66095,42866,1.541898008,54626,8506,3215,1628,0,1628,0,319,0,0.03009828,mm10,mBC-0716-1
"B11,D1",11904,12574,8907,3667,6855,0,3434,3439,2485,954,2.604821803,1686,458,234,101,1,100,1,35,0,0,empty,mBC-0716-1
"B11,D2",1173210,1198555,914145,284410,627358,1,271623,272214,206792,65422,3.160893889,127715,119118,80209,38713,15,38698,1,3101,0,0.002429066,mm10,mBC-0716-1
"B11,D3",13605,14105,10235,3870,7589,0,3579,3585,2524,1061,2.378887842,1736,1212,562,297,0,297,0,81,0,0.01010101,empty,mBC-0716-1
"B11,D4",16265,16826,12454,4372,9066,0,4155,4159,2904,1255,2.313944223,2013,1428,642,330,0,330,0,103,0,0,empty,mBC-0716-1
"B11,D5",13943,14303,10419,3884,7722,0,3670,3676,2627,1049,2.5042898,1782,1292,701,344,0,344,0,104,0,0.026162791,empty,mBC-0716-1
"B11,D6",12029,12452,9111,3341,6740,0,3191,3204,2216,988,2.24291498,1546,651,373,200,0,200,0,68,0,0.045,empty,mBC-0716-1
"B11,D7",13371,13911,10071,3840,7428,0,3510,3512,2505,1007,2.487586892,1746,9499,2858,1487,1,1486,1,303,0,0.041722746,empty,mBC-0716-1
"B11,D8",16038,16709,12038,4671,8887,0,4062,4069,2893,1176,2.460034014,2006,503,296,157,0,157,0,54,0,0.127388535,empty,mBC-0716-1
"B11,D9",6198,6367,4436,1931,3575,0,1763,1767,1245,522,2.385057471,914,4133,1509,736,0,736,0,174,0,0.059782609,empty,mBC-0716-1
"B11,D10",13099,13494,9986,3508,7262,0,3367,3372,2422,950,2.549473684,1595,514,315,169,0,169,0,51,0,0.00591716,empty,mBC-0716-1
"B11,D11",12976,13630,9795,3835,7266,0,3424,3437,2353,1084,2.170664207,1700,970,635,343,1,342,1,99,0,0.084795322,empty,mBC-0716-1
"B11,D12",1173052,1260540,853170,407370,664323,0,356608,357140,289278,67862,4.262739088,187713,130174,87533,42012,22,41990,2,3368,0,0.000857347,mm10,mBC-0716-1
"B11,E1",21132,21749,16211,5538,11619,0,5221,5224,3773,1451,2.600275672,2462,1312,829,335,0,335,0,116,0,0.119402985,empty,mBC-0716-1
"B11,E2",16565,17145,12542,4603,9191,0,4203,4210,3025,1185,2.552742616,2036,1232,714,369,1,368,1,104,0,0.08423913,empty,mBC-0716-1
"B11,E3",12147,12495,9419,3076,6594,0,2935,2938,2065,873,2.365406644,1374,1111,775,395,0,395,0,116,0,0.091139241,empty,mBC-0716-1
"B11,E4",14677,15299,11265,4034,8049,0,3681,3686,2606,1080,2.412962963,1783,932,581,315,0,315,0,113,0,0.028571429,empty,mBC-0716-1
"B11,E5",48798,50913,37947,12966,26743,0,11974,11999,9325,2674,3.487284966,5670,2834,1857,915,0,915,0,179,0,0.009836066,empty,mBC-0716-1
"B11,E6",13665,14150,10342,3808,7504,0,3385,3398,2403,995,2.415075377,1714,1046,655,320,0,320,0,89,0,0.015625,empty,mBC-0716-1
"B11,E7",13944,14426,10671,3755,7752,0,3591,3602,2550,1052,2.423954373,1704,957,606,320,0,320,0,90,0,0.078125,empty,mBC-0716-1
"B11,E8",16345,17061,12689,4372,9081,0,4029,4039,2834,1205,2.35186722,1873,1121,747,370,0,370,0,125,0,0.051351351,empty,mBC-0716-1
"B11,E9",9352,9851,7015,2836,5220,0,2520,2524,1772,752,2.356382979,1234,1869,832,435,1,434,1,115,0,0.00921659,empty,mBC-0716-1
"B11,E10",12582,12925,9547,3378,6808,0,3144,3144,2156,988,2.182186235,1479,865,502,252,0,252,0,80,0,0.031746032,empty,mBC-0716-1
"B11,E11",9311,9569,7087,2482,5254,0,2503,2509,1764,745,2.367785235,1209,714,431,198,0,198,0,65,0,0.060606061,empty,mBC-0716-1
"B11,E12",14866,15185,11211,3974,8275,0,3887,3901,2656,1245,2.133333333,1919,2543,893,469,0,469,0,116,0,0.034115139,empty,mBC-0716-1
"B11,F1",16556,17089,12648,4441,9055,0,4103,4106,2927,1179,2.482612383,2021,782,533,282,0,282,0,84,0,0.028368794,empty,mBC-0716-1
"B11,F2",22037,22628,16653,5975,12115,0,5699,5712,4031,1681,2.397977394,2800,2334,1382,702,0,702,0,195,0,0.047008547,empty,mBC-0716-1
"B11,F3",16298,17322,12263,5059,9325,0,4474,4480,3166,1314,2.409436834,2265,1291,912,426,0,426,0,135,0,0.046948357,empty,mBC-0716-1
"B11,F4",595620,606785,456565,150220,327793,0,139644,139920,118753,21167,5.610289602,67110,23235,14663,7150,1,7149,1,989,0,0.00013988,mm10,mBC-0716-1
"B11,F5",23216,23921,17856,6065,12580,0,5629,5645,3960,1685,2.350148368,2688,1126,771,366,0,366,0,110,0,0.008196721,empty,mBC-0716-1
"B11,F6",23320,24255,17722,6533,12893,0,5955,5973,4263,1710,2.492982456,2874,1736,1193,576,0,576,0,161,0,0.046875,empty,mBC-0716-1
"B11,F7",746506,814211,535740,278471,439145,1,239699,240034,192215,47819,4.019636546,129401,20405,12388,5831,3,5828,1,942,0,0.002402196,mm10,mBC-0716-1
"B11,F8",21967,22991,16798,6193,12215,0,5685,5692,4007,1685,2.378041543,2758,113,86,55,0,55,0,33,0,0,empty,mBC-0716-1
"B11,F9",687678,700435,508164,192271,373009,1,181183,181482,144367,37115,3.889721137,89514,26154,18471,9013,4,9009,1,1199,0,0.006882007,mm10,mBC-0716-1
"B11,F10",19797,20101,15262,4839,10846,0,4715,4724,3352,1372,2.443148688,2256,1594,797,390,1,389,1,118,0,0.007712082,empty,mBC-0716-1
"B11,F11",10892,11155,8440,2715,6050,0,2781,2789,1976,813,2.430504305,1319,462,269,139,0,139,0,61,0,0.050359712,empty,mBC-0716-1
"B11,F12",13375,13564,10117,3447,7237,0,3180,3193,2259,934,2.41862955,1509,133,89,27,0,27,0,15,0,0,empty,mBC-0716-1
"B11,G1",726653,779668,536094,243574,409697,0,210347,210666,178786,31880,5.608092848,109546,93364,64150,30747,12,30735,4,2692,0,0.001203839,mm10,mBC-0716-1
"B11,G2",19577,20042,14806,5236,10418,0,4614,4620,3262,1358,2.402061856,2218,285,172,103,1,102,1,46,0,0,empty,mBC-0716-1
"B11,G3",18923,19447,14484,4963,10324,0,4638,4652,3274,1378,2.375907112,2136,1361,893,450,0,450,0,144,0,0.086666667,empty,mBC-0716-1
"B11,G4",26562,26968,20334,6634,14224,0,6152,6157,4410,1747,2.524327418,2883,69,37,26,0,26,0,17,0,0,empty,mBC-0716-1
"B11,G5",1117277,1197563,804009,393554,633099,2,343720,344220,277300,66920,4.143753736,182453,85436,54034,26454,9,26445,2,2568,0,0.011344299,mm10,mBC-0716-1
"B11,G6",940266,1029842,647375,382467,539116,1,320137,320624,262798,57826,4.544633902,176670,3775,2620,1292,0,1292,0,275,0,0.003869969,mm10,mBC-0716-1
"B11,G7",18821,19240,14634,4606,10272,0,4554,4564,3260,1304,2.5,2066,915,535,308,0,308,0,112,0,0.081168831,empty,mBC-0716-1
"B11,G8",14292,15090,10820,4270,7967,0,3726,3734,2607,1127,2.313220941,1893,1063,625,357,0,357,0,107,0,0.047619048,empty,mBC-0716-1
"B11,G9",10447,11095,7870,3225,5805,0,2744,2746,1965,781,2.516005122,1354,666,444,257,0,257,0,86,0,0.011673152,empty,mBC-0716-1
"B11,G10",13325,13426,10164,3262,7213,0,3307,3321,2291,1030,2.224271845,1547,3404,1210,574,1,573,1,133,0,0.071553229,empty,mBC-0716-1
"B11,G11",1866957,2044956,1313338,731618,1069466,1,628871,629738,520030,109708,4.740128341,344741,76915,52927,25455,5,25450,1,2451,0,0.000785855,mm10,mBC-0716-1
"B11,G12",11684,11988,8763,3225,6411,0,2995,2997,2078,919,2.261153428,1457,15057,4863,2497,5,2492,2,408,0,0.097110754,empty,mBC-0716-1
"B11,H1",20009,20781,15288,5493,11145,0,5159,5179,3699,1480,2.499324324,2526,703,472,247,0,247,0,80,0,0.020242915,empty,mBC-0716-1
"B11,H2",22431,23122,17217,5905,12143,0,5438,5450,3840,1610,2.385093168,2595,1251,844,410,0,410,0,118,0,0.019512195,empty,mBC-0716-1
"B11,H3",19677,20570,14990,5580,10899,1,5077,5095,3585,1510,2.374172185,2531,846,497,261,0,261,0,105,0,0.137931034,empty,mBC-0716-1
"B11,H4",13286,13662,10049,3613,7314,0,3410,3422,2398,1024,2.341796875,1690,71,52,30,0,30,0,16,0,0,empty,mBC-0716-1
"B11,H5",18196,19170,13809,5361,10031,0,4710,4717,3377,1340,2.520149254,2366,1133,652,357,0,357,0,116,0,0.072829132,empty,mBC-0716-1
"B11,H6",15006,15765,11364,4401,8518,0,4028,4032,2925,1107,2.642276423,2027,2551,1110,534,0,534,0,171,0,0.035580524,empty,mBC-0716-1
"B11,H7",17510,18273,13177,5096,9958,0,4692,4697,3451,1246,2.769662921,2394,869,585,328,0,328,0,130,0,0.021341463,empty,mBC-0716-1
"B11,H8",13562,14204,10174,4030,7569,0,3560,3578,2583,995,2.595979899,1794,1068,656,331,0,331,0,108,0,0.054380665,empty,mBC-0716-1
"B11,H9",15683,16326,11961,4365,8673,1,3919,3932,2816,1116,2.523297491,1852,932,623,317,0,317,0,99,0,0.050473186,empty,mBC-0716-1
"B11,H10",14727,15495,11143,4352,8303,0,3956,3960,2828,1132,2.498233216,1955,827,524,277,0,277,0,90,0,0.003610108,empty,mBC-0716-1
"B11,H11",17088,17581,13042,4539,9669,0,4567,4583,3306,1277,2.588880188,2247,82,43,26,0,26,0,19,0,0.153846154,empty,mBC-0716-1
"B11,H12",689540,727895,519702,208193,394840,1,188922,189266,160273,28993,5.527989515,95240,106328,74212,35240,14,35226,1,2935,0,0.003406575,mm10,mBC-0716-1
"B12,A1",371725,398459,267015,131444,219373,1,116888,117053,99517,17536,5.675011405,62378,46456,32568,15561,5,15556,1,1697,0,0.002057084,mm10,mBC-0716-1
"B12,A2",14339,14406,10859,3547,7633,0,3368,3369,2371,998,2.375751503,1552,797,511,246,0,246,0,69,0,0.203252033,empty,mBC-0716-1
"B12,A3",12842,13447,9704,3743,7155,0,3356,3358,2346,1012,2.318181818,1650,725,461,229,0,229,0,83,0,0,empty,mBC-0716-1
"B12,A4",16790,17061,13008,4053,8958,0,3929,3936,2787,1149,2.425587467,1778,358,210,102,0,102,0,41,0,0.039215686,empty,mBC-0716-1
"B12,A5",485604,522909,360248,162661,281704,2,142172,142416,110494,31922,3.461374601,73864,82092,59218,28383,12,28371,2,2485,0,0.000881181,mm10,mBC-0716-1
"B12,A6",336312,354692,243677,111015,193440,0,103017,103150,76026,27124,2.802905176,53536,11609,7794,3783,4,3779,2,656,0,0.003969304,mm10,mBC-0716-1
"B12,A7",379809,383164,293492,89672,207990,0,87897,88075,63411,24664,2.570994162,41958,10996,7175,3412,0,3412,0,617,0,0.001172333,mm10,mBC-0716-1
"B12,A8",427009,445073,324388,120685,240072,0,110417,110634,94968,15666,6.062045193,54250,78542,54287,25736,8,25728,1,2251,0,0.0008551,mm10,mBC-0716-1
"B12,A9",1637486,1654999,1251690,403309,857903,1,400306,401101,294576,106525,2.765322694,188667,41799,21935,10144,9,10135,2,1540,0,0.026147015,mm10,mBC-0716-1
"B12,A10",11837,11962,9023,2939,6408,0,2821,2826,2022,804,2.514925373,1323,236,166,89,0,89,0,41,0,0,empty,mBC-0716-1
"B12,A11",13690,14003,10600,3403,7586,0,3376,3383,2367,1016,2.329724409,1603,2852,1178,576,1,575,1,136,0,0.060869565,empty,mBC-0716-1
"B12,A12",646948,723782,459776,264006,383059,0,218048,218371,144554,73817,1.958275194,123065,95872,67327,31786,19,31767,2,2624,0,0.00358863,mm10,mBC-0716-1
"B12,B1",14481,14732,11167,3565,7818,0,3448,3461,2400,1061,2.262016965,1648,822,545,273,0,273,0,79,0,0.04029304,empty,mBC-0716-1
"B12,B2",15561,15677,11975,3702,8377,0,3699,3708,2651,1057,2.508041627,1662,331,223,115,0,115,0,42,0,0.043478261,empty,mBC-0716-1
"B12,B3",19134,20380,13816,6564,10892,0,5528,5542,3148,2394,1.314954052,2995,5309,1841,896,0,896,0,199,0,0.109375,empty,mBC-0716-1
"B12,B4",12656,13231,9648,3583,7092,0,3150,3159,2226,933,2.38585209,1571,802,412,243,0,243,0,82,0,0.028806584,empty,mBC-0716-1
"B12,B5",336373,206847,139576,67271,141097,2,73072,73514,52990,20524,2.581855389,40463,18664,9836,4589,4,4585,2,764,0,0.009160305,mm10,mBC-0716-1
"B12,B6",9284,9494,6991,2503,5231,0,2377,2379,1674,705,2.374468085,1184,610,363,215,0,215,0,66,0,0.041860465,empty,mBC-0716-1
"B12,B7",12657,13056,9823,3233,7053,0,3128,3132,2216,916,2.419213974,1473,502,315,161,0,161,0,51,0,0.111801242,empty,mBC-0716-1
"B12,B8",10228,10721,7846,2875,5844,0,2689,2693,1859,834,2.229016787,1320,573,421,205,0,205,0,81,0,0.07804878,empty,mBC-0716-1
"B12,B9",11564,11757,8990,2767,6360,0,2755,2759,1904,855,2.226900585,1326,566,242,116,0,116,0,43,0,0.086206897,empty,mBC-0716-1
"B12,B10",13025,12504,9177,3327,7021,1,3230,3274,2178,1096,1.987226277,1611,943,386,200,0,200,0,60,0,0.19,empty,mBC-0716-1
"B12,B11",549213,546889,416325,130564,290976,1,127771,128029,103151,24878,4.146273816,60135,2104,1225,597,1,596,1,131,0,0.006711409,empty,mBC-0716-1
"B12,B12",14038,14601,10922,3679,7854,0,3565,3570,2474,1096,2.25729927,1717,753,448,244,0,244,0,81,0,0.094262295,empty,mBC-0716-1
"B12,C1",17657,17672,13690,3982,9321,0,3938,3948,2758,1190,2.317647059,1772,334,226,132,1,131,1,57,0,0.045801527,empty,mBC-0716-1
"B12,C2",14940,15353,11461,3892,8066,0,3632,3636,2508,1128,2.223404255,1690,1231,854,396,0,396,0,117,0,0.027777778,empty,mBC-0716-1
"B12,C3",15183,15383,11451,3932,8260,0,3730,3747,2586,1161,2.227390181,1796,1913,705,397,1,396,1,90,0,0.01010101,empty,mBC-0716-1
"B12,C4",13324,13820,10140,3680,7465,0,3361,3371,2375,996,2.384538153,1693,819,542,301,0,301,0,93,0,0.179401993,empty,mBC-0716-1
"B12,C5",13328,13592,10051,3541,7243,0,3335,3341,2338,1003,2.331006979,1617,1595,661,351,1,350,1,93,0,0.105714286,empty,mBC-0716-1
"B12,C6",13435,13653,10103,3550,7615,0,3511,3520,2468,1052,2.346007605,1712,806,559,301,0,301,0,84,0,0.03986711,empty,mBC-0716-1
"B12,C7",494163,548981,347449,201532,296976,0,172683,172908,128382,44526,2.883304137,96295,9465,5974,2938,1,2937,1,493,0,0.012597889,mm10,mBC-0716-1
"B12,C8",11514,11783,8774,3009,6271,0,2815,2816,1933,883,2.189127973,1307,2848,1105,562,2,560,1,146,0,0.001785714,empty,mBC-0716-1
"B12,C9",9865,10300,7534,2766,5446,0,2532,2544,1787,757,2.360634082,1219,421,308,187,0,187,0,49,0,0.026737968,empty,mBC-0716-1
"B12,C10",562954,613107,401945,211162,328958,1,180385,180680,153877,26803,5.741036451,97012,49605,33895,16006,5,16001,1,1722,0,0.001312418,mm10,mBC-0716-1
"B12,C11",2153851,2310185,1557869,752316,1179432,3,648568,649550,562144,87406,6.431412031,341917,121612,87514,40956,16,40940,1,3061,0,0.000757206,mm10,mBC-0716-1
"B12,C12",558878,609373,401194,208179,329113,0,180304,180587,153355,27232,5.631426263,97426,57829,39116,18317,6,18311,2,1912,0,0.002566763,mm10,mBC-0716-1
"B12,D1",8779,9310,6640,2670,4966,0,2393,2395,1651,744,2.219086022,1167,401,241,117,0,117,0,38,0,0.094017094,empty,mBC-0716-1
"B12,D2",15946,16298,12193,4105,8653,0,3749,3753,2578,1175,2.194042553,1768,1729,1103,546,0,546,0,147,0,0.038461538,empty,mBC-0716-1
"B12,D3",523306,606009,353461,252548,327317,1,205524,205801,143489,62312,2.302750674,121380,34932,21048,10326,4,10322,2,1353,0,0.00649099,mm10,mBC-0716-1
"B12,D4",11133,11300,8508,2792,5997,0,2723,2733,1854,879,2.109215017,1271,933,520,289,0,289,0,106,0,0.024221453,empty,mBC-0716-1
"B12,D5",10641,11060,8077,2983,5917,0,2795,2800,1961,839,2.337306317,1360,838,561,282,0,282,0,91,0,0.060283688,empty,mBC-0716-1
"B12,D6",9854,10376,7432,2944,5483,0,2619,2626,1841,785,2.34522293,1327,926,585,311,0,311,0,89,0,0.025723473,empty,mBC-0716-1
"B12,D7",9669,9797,7254,2543,5316,0,2519,2523,1725,798,2.161654135,1175,870,576,291,0,291,0,108,0,0.020618557,empty,mBC-0716-1
"B12,D8",12146,12537,9170,3367,6769,0,3196,3199,2267,932,2.432403433,1556,634,388,207,0,207,0,63,0,0.115942029,empty,mBC-0716-1
"B12,D9",3653,3714,2700,1014,2095,0,1004,1004,723,281,2.572953737,488,789,482,221,1,220,1,82,0,0.022727273,empty,mBC-0716-1
"B12,D10",427374,465296,317460,147836,252299,3,131509,131779,86893,44886,1.935859734,69917,20424,14369,6841,3,6838,1,941,0,0.002632349,mm10,mBC-0716-1
"B12,D11",9973,10262,7608,2654,5509,0,2601,2604,1849,755,2.449006623,1187,1016,692,298,0,298,0,86,0,0.053691275,empty,mBC-0716-1
"B12,D12",15276,15831,11603,4228,8382,0,3897,3900,2754,1146,2.403141361,1836,3954,1587,808,0,808,0,216,0,0.070544554,empty,mBC-0716-1
"B12,E1",16789,16781,12961,3820,8872,0,3866,3868,2768,1100,2.516363636,1699,1572,798,398,0,398,0,130,0,0.085427136,empty,mBC-0716-1
"B12,E2",12298,12476,9148,3328,6822,0,3106,3115,2151,964,2.231327801,1478,2517,956,518,0,518,0,141,0,0.092664093,empty,mBC-0716-1
"B12,E3",989163,1094292,702470,391822,581856,0,330468,330970,257858,73112,3.526890251,183322,138724,95625,45845,15,45830,1,3303,0,0.000763692,mm10,mBC-0716-1
"B12,E4",502635,534406,374796,159610,287231,0,146794,147032,115631,31401,3.68239865,75679,7357,5156,2456,0,2456,0,471,0,0.001628664,mm10,mBC-0716-1
"B12,E5",15638,16015,12122,3893,8723,0,3854,3867,2701,1166,2.316466552,1800,665,455,212,0,212,0,73,0,0.061320755,empty,mBC-0716-1
"B12,E6",10289,10540,7848,2692,5587,0,2532,2534,1740,794,2.191435768,1240,700,423,233,0,233,0,68,0,0.034334764,empty,mBC-0716-1
"B12,E7",337528,346688,255611,91077,189269,0,88256,88428,65851,22577,2.916729415,43607,6958,4621,2203,0,2203,0,421,0,0.024058103,mm10,mBC-0716-1
"B12,E8",13706,13733,10455,3278,7305,0,3161,3169,2275,894,2.544742729,1462,2423,1184,605,1,604,1,141,0,0.069536424,empty,mBC-0716-1
"B12,E9",6984,7205,5365,1840,3830,0,1727,1736,1202,534,2.25093633,814,644,381,189,0,189,0,74,0,0.005291005,empty,mBC-0716-1
"B12,E10",552652,641191,375480,265711,346937,0,219663,219936,153263,66673,2.298726621,130031,6365,4545,2149,2,2147,1,425,0,0.005589194,mm10,mBC-0716-1
"B12,E11",7413,7613,5474,2139,4127,0,1886,1891,1312,579,2.26597582,948,4746,1536,786,0,786,0,158,0,0.108142494,empty,mBC-0716-1
"B12,E12",11416,11777,8580,3197,6371,0,2932,2938,2042,896,2.279017857,1424,500,291,154,1,153,1,61,0,0.052287582,empty,mBC-0716-1
"B12,F1",13897,14086,10571,3515,7468,0,3371,3381,2368,1013,2.337611056,1594,875,582,277,0,277,0,82,0,0.119133574,empty,mBC-0716-1
"B12,F2",17087,17628,12842,4786,9429,0,4340,4350,3027,1323,2.287981859,2115,1405,928,500,1,499,1,164,0,0.036072144,empty,mBC-0716-1
"B12,F3",11924,12625,8994,3631,6778,0,3152,3155,2184,971,2.2492276,1589,718,487,277,0,277,0,100,0,0.097472924,empty,mBC-0716-1
"B12,F4",12877,12989,9667,3322,7197,0,3284,3290,2277,1013,2.247778875,1615,493,292,148,0,148,0,43,0,0.101351351,empty,mBC-0716-1
"B12,F5",18646,18770,14121,4649,9849,0,4424,4451,3091,1360,2.272794118,2089,997,600,348,0,348,0,98,0,0.074712644,empty,mBC-0716-1
"B12,F6",17578,17971,13292,4679,9510,0,4312,4325,3007,1318,2.281487102,2058,2523,1074,595,0,595,0,162,0,0.047058824,empty,mBC-0716-1
"B12,F7",15501,15752,11936,3816,8569,0,3695,3706,2589,1117,2.317815577,1699,369,254,137,0,137,0,52,0,0,empty,mBC-0716-1
"B12,F8",17118,17585,13068,4517,9421,0,4257,4268,2938,1330,2.209022556,2043,250,121,71,0,71,0,37,0,0,empty,mBC-0716-1
"B12,F9",11744,12291,8922,3369,6567,0,3052,3060,2139,921,2.32247557,1494,939,602,322,0,322,0,114,0,0,empty,mBC-0716-1
"B12,F10",15878,15928,12285,3643,8543,1,3692,3696,2578,1118,2.305903399,1644,744,472,244,0,244,0,78,0,0.036885246,empty,mBC-0716-1
"B12,F11",8849,9110,6802,2308,4735,0,2050,2054,1396,658,2.121580547,928,591,367,209,0,209,0,77,0,0.09569378,empty,mBC-0716-1
"B12,F12",11293,11378,8267,3111,6291,0,2959,2966,2078,888,2.34009009,1470,404,127,75,0,75,0,29,0,0,empty,mBC-0716-1
"B12,G1",7855,7885,6058,1827,4324,0,1904,1911,1276,635,2.009448819,880,2244,989,517,0,517,0,131,0,0.034816248,empty,mBC-0716-1
"B12,G2",524784,551925,389794,162131,296783,0,144515,144725,122546,22179,5.525316741,74056,22737,14784,7094,4,7090,1,958,0,0.004231312,mm10,mBC-0716-1
"B12,G3",14890,15121,11330,3791,8117,0,3667,3672,2528,1144,2.20979021,1748,3063,1406,695,2,693,2,175,0,0.062049062,empty,mBC-0716-1
"B12,G4",801934,837747,603076,234671,438105,3,207728,208141,168772,39369,4.286926262,102979,961,585,312,0,312,0,71,0,0,empty,mBC-0716-1
"B12,G5",10542,10516,7890,2626,5682,0,2592,2595,1790,805,2.223602484,1243,575,358,198,0,198,0,70,0,0.090909091,empty,mBC-0716-1
"B12,G6",19037,19124,14598,4526,10191,0,4506,4520,3149,1371,2.296863603,2097,552,162,79,0,79,0,33,0,0,empty,mBC-0716-1
"B12,G7",15638,16254,11947,4307,8625,0,3817,3825,2675,1150,2.326086957,1869,971,609,326,0,326,0,107,0,0.09202454,empty,mBC-0716-1
"B12,G8",11202,11607,8355,3252,6284,0,2879,2887,2048,839,2.441001192,1435,2918,1150,584,0,584,0,145,0,0.087328767,empty,mBC-0716-1
"B12,G9",8011,8165,5980,2185,4454,0,2059,2062,1441,621,2.320450886,1035,801,480,253,0,253,0,99,0,0.027667984,empty,mBC-0716-1
"B12,G10",11308,11359,8434,2925,6001,0,2736,2744,1951,793,2.460277427,1286,6342,2170,1100,0,1100,0,192,0,0.217272727,empty,mBC-0716-1
"B12,G11",9676,10043,7396,2647,5233,0,2344,2355,1681,674,2.494065282,1115,582,276,131,0,131,0,59,0,0.007633588,empty,mBC-0716-1
"B12,G12",9391,9639,7077,2562,5099,0,2336,2340,1634,706,2.314447592,1134,21413,6489,3247,0,3247,0,515,0,0.082845704,empty,mBC-0716-1
"B12,H1",16505,16463,12508,3955,8962,0,4033,4039,2881,1158,2.48791019,1828,1108,489,234,1,233,1,82,0,0,empty,mBC-0716-1
"B12,H2",18231,18522,14101,4421,9704,0,4297,4308,2980,1328,2.243975904,1952,938,610,336,1,335,1,112,0,0.020895522,empty,mBC-0716-1
"B12,H3",584803,646962,416903,230059,345703,1,193765,194088,141444,52644,2.686801915,106382,33138,22430,10917,8,10909,2,1332,0,0.002566688,mm10,mBC-0716-1
"B12,H4",10225,10352,7877,2475,5507,0,2459,2463,1694,769,2.202860858,1170,110,71,40,0,40,0,18,0,0.175,empty,mBC-0716-1
"B12,H5",2859076,3057595,2042309,1015286,1537868,3,871686,873092,716406,156686,4.572240021,464032,226965,158069,75616,24,75592,2,4520,0,0.000992168,mm10,mBC-0716-1
"B12,H6",10801,11151,8094,3057,5971,1,2741,2750,1897,853,2.223915592,1339,1074,588,320,1,319,1,109,0,0,empty,mBC-0716-1
"B12,H7",1045380,1126538,750117,376421,604893,1,334497,335069,266775,68294,3.906272879,180100,35660,25585,12325,3,12322,2,1601,0,0.002678137,mm10,mBC-0716-1
"B12,H8",10285,10500,7637,2863,5746,0,2668,2680,1886,794,2.375314861,1372,1032,619,311,0,311,0,106,0,0.003215434,empty,mBC-0716-1
"B12,H9",11618,11945,8823,3122,6468,0,2944,2949,2078,871,2.38576349,1392,1394,735,394,0,394,0,111,0,0.098984772,empty,mBC-0716-1
"B12,H10",11211,11365,8481,2884,6127,0,2740,2742,1922,820,2.343902439,1281,909,576,267,0,267,0,76,0,0.08988764,empty,mBC-0716-1
"B12,H11",13298,13805,10087,3718,7296,0,3467,3474,2476,998,2.480961924,1670,75,54,38,0,38,0,28,0,0,empty,mBC-0716-1
"B12,H12",5088,5310,3740,1570,2804,0,1372,1378,1004,374,2.684491979,721,4827,1688,846,0,846,0,161,0,0.145390071,empty,mBC-0716-1
"C1,A1",645410,711787,446456,265331,381209,0,222278,222630,189185,33445,5.656600389,123649,66656,45957,22220,7,22213,2,2034,0,0.001125467,mm10,mBC-0716-1
"C1,A2",16407,16672,12493,4179,8948,0,4068,4079,2870,1209,2.373862696,1950,766,503,256,0,256,0,79,0,0.0234375,empty,mBC-0716-1
"C1,A3",516061,552318,376214,176104,295390,0,157562,157794,105888,51906,2.039995376,82567,29336,20249,9743,6,9737,1,1186,0,0.001540516,mm10,mBC-0716-1
"C1,A4",18167,18415,14118,4297,9869,0,4217,4227,2985,1242,2.403381643,1955,1292,493,249,0,249,0,60,0,0.012048193,empty,mBC-0716-1
"C1,A5",14823,15493,11167,4326,8184,0,3818,3833,2608,1225,2.128979592,1977,1022,650,331,0,331,0,94,0,0.066465257,empty,mBC-0716-1
"C1,A6",16121,16846,12135,4711,9276,0,4364,4385,3202,1183,2.706677937,2136,1132,658,361,1,360,1,112,0,0.036111111,empty,mBC-0716-1
"C1,A7",14024,14599,10530,4069,7852,0,3711,3722,2585,1137,2.273526825,1801,727,358,185,0,185,0,75,0,0.027027027,empty,mBC-0716-1
"C1,A8",9505,9675,7317,2358,5303,0,2356,2361,1649,712,2.316011236,1115,871,490,261,1,260,1,84,0,0.057692308,empty,mBC-0716-1
"C1,A9",16253,16551,12334,4217,8666,0,3810,3816,2752,1064,2.586466165,1825,4157,1532,749,1,748,1,159,0,0.06684492,empty,mBC-0716-1
"C1,A10",13630,14077,10405,3672,7507,0,3356,3370,2369,1001,2.366633367,1650,290,161,83,0,83,0,34,0,0.012048193,empty,mBC-0716-1
"C1,A11",15843,16120,12184,3936,8663,0,3806,3814,2623,1191,2.202350966,1786,593,389,223,2,221,1,81,0,0.040723982,empty,mBC-0716-1
"C1,A12",17997,18290,13726,4564,9634,0,4243,4252,2972,1280,2.321875,2017,10408,3478,1744,1,1743,1,293,0,0.11589214,empty,mBC-0716-1
"C1,B1",16210,16501,12428,4073,8802,0,3929,3938,2779,1159,2.397756687,1806,583,356,192,1,191,1,78,0,0,empty,mBC-0716-1
"C1,B2",17066,17281,13027,4254,9358,0,4170,4178,2908,1270,2.28976378,1972,389,246,100,0,100,0,28,0,0.18,empty,mBC-0716-1
"C1,B3",16704,17012,12746,4266,9207,0,4212,4222,3057,1165,2.624034335,1905,771,475,235,0,235,0,91,0,0.029787234,empty,mBC-0716-1
"C1,B4",14466,15009,10957,4052,7968,0,3635,3638,2514,1124,2.236654804,1765,823,561,274,0,274,0,92,0,0,empty,mBC-0716-1
"C1,B5",7945,4709,3380,1329,3262,0,1587,1597,1119,478,2.341004184,854,535,307,151,0,151,0,45,0,0.072847682,empty,mBC-0716-1
"C1,B6",10640,11035,8060,2975,5907,0,2743,2743,1918,825,2.324848485,1324,650,443,251,0,251,0,81,0,0.007968127,empty,mBC-0716-1
"C1,B7",13951,14388,10832,3556,7732,0,3433,3442,2400,1042,2.303262956,1609,602,384,187,0,187,0,68,0,0,empty,mBC-0716-1
"C1,B8",11745,11896,8881,3015,6552,0,2985,2987,2103,884,2.378959276,1457,708,492,249,0,249,0,83,0,0.088353414,empty,mBC-0716-1
"C1,B9",12833,13204,9858,3346,6978,0,3180,3188,2170,1018,2.131630648,1559,329,227,135,0,135,0,51,0,0.007407407,empty,mBC-0716-1
"C1,B10",14747,14358,10371,3987,7926,0,3709,3739,2496,1243,2.008045052,1821,1862,711,357,0,357,0,70,0,0.06162465,empty,mBC-0716-1
"C1,B11",511330,553132,365805,187327,296856,1,165097,165318,118591,46727,2.537954502,89641,634,320,154,1,153,1,52,0,0.013071895,empty,mBC-0716-1
"C1,B12",16126,16566,12413,4153,9089,0,4186,4191,3024,1167,2.59125964,1966,1895,824,404,0,404,0,97,0,0.054455446,empty,mBC-0716-1
"C1,C1",19526,19073,15037,4036,10223,0,4268,4275,3017,1258,2.398251192,1882,2819,882,450,1,449,1,112,0,0.100222717,empty,mBC-0716-1
"C1,C2",718225,789380,507162,282218,416662,4,236085,236397,176513,59884,2.947581992,130152,72564,41983,20212,17,20195,5,2201,0,0.020401089,mm10,mBC-0716-1
"C1,C3",711386,736267,531647,204620,388656,0,188332,188634,147414,41220,3.576273654,94118,20000,11717,5734,4,5730,2,809,0,0.006457243,mm10,mBC-0716-1
"C1,C4",15117,15559,11721,3838,8249,0,3658,3670,2581,1089,2.370064279,1695,1156,683,382,0,382,0,123,0,0.068062827,empty,mBC-0716-1
"C1,C5",15849,16066,11962,4104,8516,0,3931,3951,2838,1113,2.549865229,1883,2211,959,452,0,452,0,117,0,0.112831858,empty,mBC-0716-1
"C1,C6",14824,15348,11140,4208,8418,0,3878,3891,2743,1148,2.389372822,1929,1254,801,424,0,424,0,110,0,0.073113208,empty,mBC-0716-1
"C1,C7",14624,14990,10902,4088,8185,1,3903,3909,2744,1165,2.355364807,1889,339,234,139,0,139,0,46,0,0.050359712,empty,mBC-0716-1
"C1,C8",13180,13697,9951,3746,7304,0,3360,3365,2311,1054,2.19259962,1618,1020,582,331,0,331,0,102,0,0.117824773,empty,mBC-0716-1
"C1,C9",10959,11287,8363,2924,6020,0,2747,2753,1920,833,2.304921969,1284,495,296,140,0,140,0,55,0,0.057142857,empty,mBC-0716-1
"C1,C10",11988,12194,9112,3082,6589,0,2984,2987,2060,927,2.222222222,1408,641,359,199,1,198,1,65,0,0.005050505,empty,mBC-0716-1
"C1,C11",10475,10873,7907,2966,5911,0,2792,2804,1941,863,2.249130939,1380,721,444,233,0,233,0,68,0,0.072961373,empty,mBC-0716-1
"C1,C12",17591,17763,13331,4432,9403,0,4136,4139,2918,1221,2.38984439,2005,743,423,222,0,222,0,76,0,0.058558559,empty,mBC-0716-1
"C1,D1",10259,10545,7670,2875,5912,0,2884,2885,2078,807,2.574969021,1440,502,316,161,0,161,0,67,0,0.043478261,empty,mBC-0716-1
"C1,D2",18692,18809,14509,4300,10140,0,4391,4406,3046,1360,2.239705882,1960,1781,1058,543,0,543,0,144,0,0.086556169,empty,mBC-0716-1
"C1,D3",11843,12369,8926,3443,6698,0,3081,3094,2182,912,2.39254386,1567,775,473,274,0,274,0,82,0,0.083941606,empty,mBC-0716-1
"C1,D4",14199,14662,10638,4024,7823,0,3768,3778,2745,1033,2.657308809,1847,777,533,274,0,274,0,93,0,0.116788321,empty,mBC-0716-1
"C1,D5",12353,12919,9288,3631,7035,0,3269,3281,2325,956,2.432008368,1663,1024,627,305,0,305,0,109,0,0.131147541,empty,mBC-0716-1
"C1,D6",510678,565115,361804,203311,304490,0,175264,175500,139341,36159,3.853563428,96620,25662,16955,8341,3,8338,1,1144,0,0.003717918,mm10,mBC-0716-1
"C1,D7",11624,12222,8714,3508,6493,0,3032,3043,2112,931,2.268528464,1510,7507,2459,1236,4,1232,2,261,0,0.030844156,empty,mBC-0716-1
"C1,D8",13978,14533,10581,3952,7853,0,3621,3624,2549,1075,2.371162791,1801,699,460,210,0,210,0,70,0,0.057142857,empty,mBC-0716-1
"C1,D9",4783,4976,3503,1473,2785,0,1382,1385,996,389,2.560411311,698,700,454,223,0,223,0,86,0,0.040358744,empty,mBC-0716-1
"C1,D10",12748,13208,9681,3527,7149,0,3431,3444,2348,1096,2.142335766,1679,682,447,225,0,225,0,70,0,0.102222222,empty,mBC-0716-1
"C1,D11",12092,12519,9147,3372,6817,0,3219,3226,2273,953,2.385099685,1565,1024,573,316,0,316,0,94,0,0.03164557,empty,mBC-0716-1
"C1,D12",336649,336432,255284,81148,183187,0,79695,79830,58658,21172,2.770546004,38175,8288,5229,2426,1,2425,1,517,0,0.009484536,mm10,mBC-0716-1
"C1,E1",19789,20160,14983,5177,11015,0,5038,5046,3546,1500,2.364,2392,2361,969,523,0,523,0,145,0,0.059273423,empty,mBC-0716-1
"C1,E2",14987,14948,11213,3735,8280,0,3844,3852,2802,1050,2.668571429,1854,1300,877,463,0,463,0,122,0,0.105831533,empty,mBC-0716-1
"C1,E3",11030,11246,8322,2924,6215,0,2790,2797,1979,818,2.419315403,1343,1984,921,504,0,504,0,140,0,0.101190476,empty,mBC-0716-1
"C1,E4",13535,13785,10268,3517,7339,0,3342,3349,2416,933,2.589496249,1605,2389,979,474,0,474,0,118,0,0.004219409,empty,mBC-0716-1
"C1,E5",18048,18509,13828,4681,9779,0,4332,4340,3158,1182,2.671742809,2021,808,434,234,0,234,0,97,0,0.017094017,empty,mBC-0716-1
"C1,E6",12426,12589,9301,3288,6808,0,3098,3107,2193,914,2.399343545,1464,819,529,277,0,277,0,85,0,0.028880866,empty,mBC-0716-1
"C1,E7",532921,559437,395938,163499,298767,0,144210,144425,120404,24021,5.012447442,73746,94352,61854,29811,17,29794,3,2566,0,0.000234947,mm10,mBC-0716-1
"C1,E8",895056,950720,652492,298228,495989,1,256592,257017,216674,40343,5.370795429,133047,162580,112435,54028,18,54010,2,3400,0,0.000722089,mm10,mBC-0716-1
"C1,E9",8161,8661,6018,2643,4594,0,2098,2109,1481,628,2.358280255,1090,3404,1305,679,0,679,0,150,0,0.095729013,empty,mBC-0716-1
"C1,E10",10878,11162,8271,2891,6029,0,2767,2774,1930,844,2.286729858,1311,3141,1199,585,1,584,1,133,0,0.054794521,empty,mBC-0716-1
"C1,E11",8354,8757,6415,2342,4676,0,2206,2212,1570,642,2.445482866,1067,693,488,238,0,238,0,75,0,0,empty,mBC-0716-1
"C1,E12",12960,13647,9904,3743,7350,0,3412,3414,2402,1012,2.373517787,1683,871,546,298,0,298,0,94,0,0.003355705,empty,mBC-0716-1
"C1,F1",15230,15770,11552,4218,8340,0,3778,3790,2622,1168,2.244863014,1817,885,520,245,0,245,0,79,0,0.085714286,empty,mBC-0716-1
"C1,F2",677512,759884,469345,290539,404852,2,244782,245101,182627,62474,2.923248071,137781,91634,58328,27978,6,27972,2,2412,0,0.00975976,mm10,mBC-0716-1
"C1,F3",647949,697169,464167,233002,370603,1,199273,199568,168648,30920,5.454333765,106322,93130,61917,29750,9,29741,2,2504,0,0.000437107,mm10,mBC-0716-1
"C1,F4",428640,442147,327601,114546,242207,2,106639,106833,79294,27539,2.879334762,52314,12211,8251,3927,0,3927,0,646,0,0.002291826,mm10,mBC-0716-1
"C1,F5",21003,21364,16050,5314,11330,0,4993,5008,3582,1426,2.511921459,2340,1915,887,503,1,502,1,135,0,0.035856574,empty,mBC-0716-1
"C1,F6",706214,738320,522501,215819,386199,2,190590,190905,157216,33689,4.666686456,96998,86073,60472,29159,9,29150,1,2520,0,0.002915952,mm10,mBC-0716-1
"C1,F7",16749,17111,12880,4231,9250,0,4168,4175,2919,1256,2.324044586,1911,608,378,189,0,189,0,67,0,0.015873016,empty,mBC-0716-1
"C1,F8",1277377,1397004,913080,483924,732429,2,409089,409719,322787,86932,3.713097594,222073,14739,10498,5064,3,5061,1,772,0,0.002371073,mm10,mBC-0716-1
"C1,F9",629033,655500,467146,188354,348255,0,168083,168342,141404,26938,5.249238993,84895,57509,37154,17795,7,17788,1,1949,0,0.005734203,mm10,mBC-0716-1
"C1,F10",827314,894138,597275,296863,468061,0,252401,252739,203844,48895,4.169015237,134270,99830,70226,33781,13,33768,2,2702,0,0.000533049,mm10,mBC-0716-1
"C1,F11",10403,10657,7983,2674,6047,0,2723,2732,1959,773,2.534282018,1290,1492,656,350,0,350,0,96,0,0.022857143,empty,mBC-0716-1
"C1,F12",12226,12532,9209,3323,6666,0,3066,3072,2180,892,2.443946188,1455,122,96,37,0,37,0,12,0,0,empty,mBC-0716-1
"C1,G1",8773,8942,6694,2248,4779,0,2158,2158,1433,725,1.976551724,1012,1341,873,458,0,458,0,108,0,0.034934498,empty,mBC-0716-1
"C1,G2",19096,19290,14340,4950,10237,2,4675,4693,3347,1346,2.486627043,2197,3103,1101,570,0,570,0,117,0,0.068421053,empty,mBC-0716-1
"C1,G3",17498,17765,13251,4514,9403,0,4305,4315,2980,1335,2.232209738,2076,1275,788,436,0,436,0,125,0,0.061926606,empty,mBC-0716-1
"C1,G4",24631,24976,19013,5963,13151,0,5655,5665,4047,1618,2.501236094,2618,83,65,38,0,38,0,20,0,0,empty,mBC-0716-1
"C1,G5",11494,11905,8747,3158,6325,0,2887,2890,2016,874,2.306636156,1384,771,457,258,0,258,0,74,0,0.112403101,empty,mBC-0716-1
"C1,G6",21221,21923,16486,5437,11610,0,5155,5161,3629,1532,2.368798956,2394,144,107,64,0,64,0,28,0,0.046875,empty,mBC-0716-1
"C1,G7",931397,1047010,639867,407143,548787,3,332355,332832,272886,59946,4.552196977,187150,83933,60054,28405,11,28394,3,2468,0,0.004331901,mm10,mBC-0716-1
"C1,G8",12892,13547,9750,3797,7200,0,3318,3323,2308,1015,2.273891626,1667,842,537,273,0,273,0,95,0,0.025641026,empty,mBC-0716-1
"C1,G9",9319,9600,7049,2551,5231,0,2432,2437,1746,691,2.526772793,1162,955,521,270,1,269,1,98,0,0.011152416,empty,mBC-0716-1
"C1,G10",12161,12596,9179,3417,6800,0,3130,3138,2204,934,2.359743041,1526,4634,1847,859,1,858,1,199,0,0.132867133,empty,mBC-0716-1
"C1,G11",11207,11707,8429,3278,6419,0,2961,2961,2059,902,2.2827051,1463,403,271,136,0,136,0,60,0,0.022058824,empty,mBC-0716-1
"C1,G12",10153,10341,7750,2591,5881,0,2745,2748,2027,721,2.811373093,1334,693,460,244,0,244,0,70,0,0.094262295,empty,mBC-0716-1
"C1,H1",19008,19732,14517,5215,10485,0,4772,4775,3433,1342,2.558122206,2314,875,602,287,0,287,0,82,0,0.020905923,empty,mBC-0716-1
"C1,H2",20960,20966,16012,4954,11346,0,5005,5013,3482,1531,2.274330503,2279,1389,935,503,0,503,0,118,0,0.033797217,empty,mBC-0716-1
"C1,H3",530698,573232,380814,192418,307473,0,165609,165829,139135,26694,5.212219975,88933,62463,44763,21672,10,21662,1,2022,0,0.000646293,mm10,mBC-0716-1
"C1,H4",569640,646416,381321,265095,346083,1,218922,219168,159555,59613,2.676513512,127559,2065,870,470,1,469,1,111,0,0.063965885,empty,mBC-0716-1
"C1,H5",1098549,1162556,822494,340062,612331,0,315230,315740,231147,84593,2.732460133,160975,56092,38152,18822,4,18818,1,2039,0,0.006004889,mm10,mBC-0716-1
"C1,H6",13261,13709,9999,3710,7498,0,3528,3537,2561,976,2.62397541,1718,1003,589,297,0,297,0,105,0,0.087542088,empty,mBC-0716-1
"C1,H7",15402,15945,11605,4340,8632,0,4019,4029,2904,1125,2.581333333,1960,3816,1477,767,0,767,0,191,0,0.039113429,empty,mBC-0716-1
"C1,H8",12136,12435,9306,3129,6733,0,3103,3103,2193,910,2.40989011,1515,1157,683,327,0,327,0,115,0,0.149847095,empty,mBC-0716-1
"C1,H9",13821,14435,10480,3955,7726,0,3549,3551,2597,954,2.722222222,1814,783,489,261,0,261,0,81,0,0.053639847,empty,mBC-0716-1
"C1,H10",984949,1080051,695669,384382,573679,2,326903,327327,241208,86119,2.800868566,183588,18163,12573,6105,3,6102,1,1004,0,0.005080302,mm10,mBC-0716-1
"C1,H11",1617828,1782520,1166817,615703,933210,4,523754,524485,415788,108697,3.825202167,285149,6729,4661,2253,4,2249,1,414,0,0.000444642,mm10,mBC-0716-1
"C1,H12",5856,6121,4429,1692,3311,0,1545,1547,1097,450,2.437777778,745,504,324,173,0,173,0,52,0,0.104046243,empty,mBC-0716-1
"C2,A1",13163,13489,9955,3534,7388,0,3423,3428,2504,924,2.70995671,1626,1720,792,388,0,388,0,112,0,0.06443299,empty,mBC-0716-1
"C2,A2",17635,17816,13480,4336,9444,5,4128,4137,2922,1215,2.404938272,1946,1132,700,353,0,353,0,100,0,0.104815864,empty,mBC-0716-1
"C2,A3",14760,15450,11175,4275,8241,0,3862,3868,2704,1164,2.323024055,1906,1087,692,375,0,375,0,106,0,0.074666667,empty,mBC-0716-1
"C2,A4",18936,19558,14531,5027,10181,0,4579,4592,3165,1427,2.217939734,2173,454,268,161,0,161,0,53,0,0.180124224,empty,mBC-0716-1
"C2,A5",14973,15693,11499,4194,8395,0,3830,3836,2665,1171,2.275832622,1905,1347,884,442,0,442,0,123,0,0.009049774,empty,mBC-0716-1
"C2,A6",12524,12940,9662,3278,7001,0,3023,3025,2135,890,2.398876404,1466,1485,958,512,0,512,0,137,0,0.02734375,empty,mBC-0716-1
"C2,A7",342240,364970,230527,134443,195253,0,112687,112831,88356,24475,3.610051073,62955,37416,25780,12155,7,12148,2,1438,0,0.001646362,mm10,mBC-0716-1
"C2,A8",9788,10273,7407,2866,5551,0,2635,2637,1815,822,2.208029197,1296,4750,1766,919,1,918,1,219,0,0.054466231,empty,mBC-0716-1
"C2,A9",16559,16970,12756,4214,8782,0,3836,3843,2702,1141,2.36809816,1829,1552,832,397,1,396,1,119,0,0.080808081,empty,mBC-0716-1
"C2,A10",14314,14429,10949,3480,7697,0,3456,3464,2436,1028,2.369649805,1556,352,232,130,0,130,0,51,0,0.1,empty,mBC-0716-1
"C2,A11",16096,16238,12263,3975,8755,0,3928,3942,2767,1175,2.354893617,1860,1259,796,411,0,411,0,119,0,0.087591241,empty,mBC-0716-1
"C2,A12",17948,18172,13968,4204,9553,0,4182,4185,2960,1225,2.416326531,1850,2426,1526,721,0,721,0,167,0,0.085991678,empty,mBC-0716-1
"C2,B1",16528,16809,12580,4229,8829,0,3887,3897,2638,1259,2.095313741,1800,965,648,327,0,327,0,96,0,0.042813456,empty,mBC-0716-1
"C2,B2",17155,17569,12962,4607,9267,0,4205,4219,2983,1236,2.413430421,2012,465,293,166,0,166,0,59,0,0.078313253,empty,mBC-0716-1
"C2,B3",531775,568661,392347,176314,307233,1,158545,158786,125741,33045,3.8051445,82330,49241,29772,14108,5,14103,1,1583,0,0.004041693,mm10,mBC-0716-1
"C2,B4",14649,14977,11365,3612,7995,0,3630,3635,2532,1103,2.29555757,1647,2096,889,463,0,463,0,134,0,0.006479482,empty,mBC-0716-1
"C2,B5",8274,5186,3533,1653,3559,0,1761,1778,1259,519,2.425818882,989,738,440,235,0,235,0,71,0,0.055319149,empty,mBC-0716-1
"C2,B6",547189,624040,378091,245949,334383,0,198589,198844,167594,31250,5.363008,113042,134239,97359,46487,20,46467,2,3260,0,0.000925388,mm10,mBC-0716-1
"C2,B7",14084,14522,10979,3543,7705,0,3356,3367,2360,1007,2.343594836,1569,911,606,286,1,285,1,84,0,0.01754386,empty,mBC-0716-1
"C2,B8",11849,12092,9207,2885,6367,0,2786,2788,1970,818,2.408312958,1305,927,622,293,0,293,0,99,0,0.054607509,empty,mBC-0716-1
"C2,B9",13390,13641,10319,3322,7075,0,3113,3115,2218,897,2.472686734,1437,547,335,186,0,186,0,61,0,0.053763441,empty,mBC-0716-1
"C2,B10",14649,14285,10533,3752,7829,0,3555,3566,2419,1147,2.108979948,1728,2256,948,480,0,480,0,114,0,0.05,empty,mBC-0716-1
"C2,B11",14594,14899,10932,3967,8094,0,3761,3772,2668,1104,2.416666667,1847,208,163,98,0,98,0,32,0,0,empty,mBC-0716-1
"C2,B12",634459,687387,464893,222494,369188,0,196274,196604,157151,39453,3.983245888,103500,61041,40319,18728,9,18719,4,1863,0,0.002617661,mm10,mBC-0716-1
"C2,C1",20448,20570,15834,4736,10682,0,4540,4551,3135,1416,2.213983051,2083,644,417,213,0,213,0,73,0,0.126760563,empty,mBC-0716-1
"C2,C2",16851,17644,12606,5038,9395,0,4314,4319,3014,1305,2.309578544,2186,1736,1136,528,0,528,0,152,0,0.068181818,empty,mBC-0716-1
"C2,C3",657636,726757,471836,254921,387282,0,212996,213302,170362,42940,3.967442944,116953,38462,26149,12476,5,12471,2,1441,0,0,mm10,mBC-0716-1
"C2,C4",16021,16055,12189,3866,8602,0,3729,3738,2616,1122,2.331550802,1727,2745,1406,645,1,644,1,133,0,0.062111801,empty,mBC-0716-1
"C2,C5",857436,933493,605149,328344,491290,2,281457,281856,214374,67482,3.176758247,153677,90539,56472,27373,7,27366,1,2480,0,0.002631002,mm10,mBC-0716-1
"C2,C6",15294,15511,11171,4340,8379,0,3911,3918,2777,1141,2.433829974,1905,23137,7928,4084,3,4081,3,571,0,0.161480029,empty,mBC-0716-1
"C2,C7",14472,14733,10891,3842,7773,0,3553,3564,2479,1085,2.284792627,1693,365,196,110,0,110,0,48,0,0.109090909,empty,mBC-0716-1
"C2,C8",13263,13452,10146,3306,7199,0,3253,3260,2272,988,2.299595142,1526,1291,832,407,0,407,0,135,0,0.041769042,empty,mBC-0716-1
"C2,C9",11013,11309,8362,2947,5968,0,2695,2695,1852,843,2.196915777,1264,845,451,236,0,236,0,73,0,0.046610169,empty,mBC-0716-1
"C2,C10",12137,12490,9183,3307,6709,0,2987,2990,2081,909,2.289328933,1423,880,568,289,0,289,0,88,0,0.048442907,empty,mBC-0716-1
"C2,C11",10497,11003,7785,3218,5862,0,2764,2770,1896,874,2.169336384,1432,650,402,199,0,199,0,68,0,0.005025126,empty,mBC-0716-1
"C2,C12",17879,18247,13526,4721,9699,0,4386,4394,3138,1256,2.498407643,2064,1155,740,395,0,395,0,122,0,0.081012658,empty,mBC-0716-1
"C2,D1",10883,11419,8077,3342,6160,0,3005,3015,2113,902,2.342572062,1505,538,325,165,0,165,0,54,0,0.048484848,empty,mBC-0716-1
"C2,D2",18558,18843,14239,4604,9957,0,4314,4326,2977,1349,2.206819867,1947,2918,1737,825,0,825,0,193,0,0.048484848,empty,mBC-0716-1
"C2,D3",12047,12496,8975,3521,6760,0,3184,3192,2244,948,2.367088608,1578,1392,874,416,0,416,0,123,0,0.019230769,empty,mBC-0716-1
"C2,D4",12272,12630,9384,3246,6783,0,3061,3069,2192,877,2.499429875,1450,1337,716,392,0,392,0,123,0,0.038265306,empty,mBC-0716-1
"C2,D5",12324,12662,9373,3289,6883,0,3168,3172,2202,970,2.270103093,1529,1321,860,408,0,408,0,117,0,0.06127451,empty,mBC-0716-1
"C2,D6",490245,524806,357802,167004,283466,1,149653,149908,108273,41635,2.600528402,78396,71291,47016,22654,7,22647,1,1991,0,0.006976641,mm10,mBC-0716-1
"C2,D7",11602,11947,8813,3134,6329,1,2902,2914,2105,809,2.60197775,1388,1263,852,447,0,447,0,136,0,0.033557047,empty,mBC-0716-1
"C2,D8",14481,15103,10992,4111,7918,0,3583,3601,2484,1117,2.223813787,1729,880,555,304,0,304,0,102,0,0.006578947,empty,mBC-0716-1
"C2,D9",5042,5263,3734,1529,2902,0,1395,1400,1002,398,2.51758794,711,1277,750,349,0,349,0,109,0,0.151862464,empty,mBC-0716-1
"C2,D10",12797,13498,9663,3835,7178,1,3386,3398,2332,1066,2.187617261,1734,860,508,270,0,270,0,85,0,0.148148148,empty,mBC-0716-1
"C2,D11",11874,12250,9020,3230,6545,0,3022,3028,2098,930,2.255913978,1471,1387,924,441,0,441,0,134,0,0.058956916,empty,mBC-0716-1
"C2,D12",643694,697578,470775,226803,369963,0,194399,194700,171281,23419,7.31376233,102590,226504,153952,73522,35,73487,2,3903,0,0.001292746,mm10,mBC-0716-1
"C2,E1",20165,20629,15432,5197,10850,0,4852,4862,3419,1443,2.369369369,2321,1782,1141,545,0,545,0,164,0,0.040366972,empty,mBC-0716-1
"C2,E2",577484,621269,424302,196967,332387,3,171367,171630,142150,29480,4.821913161,90212,130567,83395,39707,22,39685,2,3027,0,0.006828777,mm10,mBC-0716-1
"C2,E3",364718,385760,273295,112465,210530,0,106366,106571,83795,22776,3.679092027,53937,9790,6965,3401,3,3398,1,628,0,0.002942908,mm10,mBC-0716-1
"C2,E4",15190,14991,10902,4089,7593,0,3514,3523,2508,1015,2.470935961,1648,71731,22350,11421,13,11408,3,1314,0,0.171721599,empty,mBC-0716-1
"C2,E5",1186667,1331181,823274,507907,694964,1,420268,420875,290256,130619,2.222157573,237837,74455,53324,25592,8,25584,2,2232,0,0.00050813,mm10,mBC-0716-1
"C2,E6",12342,12588,9410,3178,6659,0,2935,2942,2031,911,2.229418222,1363,3874,1518,753,1,752,1,173,0,0.019946809,empty,mBC-0716-1
"C2,E7",233890,210267,203614,6653,115302,0,11742,11845,9230,2615,3.529636711,2719,20041,12618,5594,6,5588,3,1035,0,0.005726557,empty,mBC-0716-1
"C2,E8",15379,15674,11719,3955,8244,0,3594,3604,2553,1051,2.429115128,1677,1777,1163,575,0,575,0,172,0,0,empty,mBC-0716-1
"C2,E9",417749,425727,311994,113733,230857,1,110378,110569,83713,26856,3.117106047,54275,18204,11388,5403,3,5400,1,925,0,0.018703704,mm10,mBC-0716-1
"C2,E10",11604,11859,8747,3112,6404,0,2885,2892,2006,886,2.264108352,1401,6001,2040,1021,0,1021,0,204,0,0.068560235,empty,mBC-0716-1
"C2,E11",8374,8602,6307,2295,4698,0,2231,2240,1523,717,2.124128312,1115,1309,844,393,0,393,0,95,0,0.025445293,empty,mBC-0716-1
"C2,E12",13538,14199,10064,4135,7748,0,3737,3746,2583,1163,2.220980224,1920,1047,665,336,1,335,1,112,0,0.032835821,empty,mBC-0716-1
"C2,F1",15134,15351,11602,3749,8343,0,3774,3780,2611,1169,2.233532934,1738,1182,748,344,1,343,1,98,0,0.049562682,empty,mBC-0716-1
"C2,F2",20398,20834,15554,5280,11137,0,5077,5087,3666,1421,2.579873329,2362,2306,1430,700,0,700,0,214,0,0.027142857,empty,mBC-0716-1
"C2,F3",579162,639798,409335,230463,343356,3,194056,194351,154164,40187,3.836165924,107684,75386,52748,25291,6,25285,2,2291,0,0.001542416,mm10,mBC-0716-1
"C2,F4",16088,16860,12056,4804,9039,0,4208,4228,3018,1210,2.494214876,2113,536,332,163,0,163,0,63,0,0.006134969,empty,mBC-0716-1
"C2,F5",21707,22456,16524,5932,11843,0,5307,5321,3742,1579,2.369854338,2582,1615,1045,497,0,497,0,133,0,0.042253521,empty,mBC-0716-1
"C2,F6",663683,767978,437288,330690,412858,0,267622,267959,174714,93245,1.873709046,163651,15290,8215,3915,6,3909,2,714,0,0.037861346,mm10,mBC-0716-1
"C2,F7",686675,726268,518827,207441,394768,3,192270,192622,142904,49718,2.874291001,97310,38891,23782,11668,4,11664,1,1394,0,0.006087106,mm10,mBC-0716-1
"C2,F8",19855,20638,15044,5594,11069,0,5255,5271,3624,1647,2.200364299,2511,266,149,67,0,67,0,35,0,0,empty,mBC-0716-1
"C2,F9",784540,855449,549611,305838,453770,2,261641,262010,212471,49539,4.28896425,143219,111809,72870,34471,15,34456,3,2725,0,0.004121198,mm10,mBC-0716-1
"C2,F10",18278,18933,14187,4746,9956,0,4359,4367,3080,1287,2.393162393,2034,1341,802,404,0,404,0,113,0,0.079207921,empty,mBC-0716-1
"C2,F11",9980,10215,7840,2375,5516,0,2409,2420,1703,717,2.375174338,1082,918,582,304,0,304,0,98,0,0.036184211,empty,mBC-0716-1
"C2,F12",12850,12960,9752,3208,6785,0,3059,3069,2157,912,2.365131579,1421,132,91,55,0,55,0,17,0,0,empty,mBC-0716-1
"C2,G1",8726,8832,6680,2152,4817,0,2123,2134,1463,671,2.180327869,1003,1883,1306,634,0,634,0,158,0,0.056782334,empty,mBC-0716-1
"C2,G2",18260,18815,14046,4769,9942,1,4428,4433,3073,1360,2.259558824,2162,535,303,163,0,163,0,48,0,0.079754601,empty,mBC-0716-1
"C2,G3",17399,18102,13154,4948,9462,0,4383,4397,3050,1347,2.264291017,2152,1714,1047,495,0,495,0,155,0,0.044444444,empty,mBC-0716-1
"C2,G4",24598,24725,19068,5657,13096,0,5586,5604,4023,1581,2.54459203,2578,65,24,15,0,15,0,12,0,0,empty,mBC-0716-1
"C2,G5",11751,11965,8868,3097,6339,0,2893,2901,2056,845,2.433136095,1391,876,469,233,0,233,0,100,0,0.017167382,empty,mBC-0716-1
"C2,G6",22131,22448,17020,5428,11665,0,5052,5061,3504,1557,2.250481696,2348,952,400,208,1,207,1,64,0,0,empty,mBC-0716-1
"C2,G7",17349,17899,13431,4468,9443,0,4107,4114,2911,1203,2.419783874,1978,1601,983,506,1,505,1,157,0,0.035643564,empty,mBC-0716-1
"C2,G8",638069,690109,464982,225127,365818,2,194874,195215,160971,34244,4.700706693,102470,136308,97581,46297,14,46283,1,3168,0,0.000756217,mm10,mBC-0716-1
"C2,G9",9476,10041,7158,2883,5321,0,2543,2543,1758,785,2.239490446,1297,1096,668,354,1,353,1,113,0,0.07082153,empty,mBC-0716-1
"C2,G10",12173,12492,9339,3153,6588,0,3016,3021,2124,897,2.367892977,1377,1320,832,427,0,427,0,128,0,0.107728337,empty,mBC-0716-1
"C2,G11",11449,11586,8808,2778,6200,0,2692,2702,1913,789,2.424588086,1273,1553,801,415,0,415,0,110,0,0.028915663,empty,mBC-0716-1
"C2,G12",10600,10798,8086,2712,5856,0,2681,2688,1846,842,2.19239905,1266,1133,593,289,1,288,1,95,0,0.003472222,empty,mBC-0716-1
"C2,H1",18475,18911,14122,4789,10076,0,4521,4530,3142,1388,2.263688761,2130,1087,739,373,0,373,0,101,0,0.072386059,empty,mBC-0716-1
"C2,H2",21145,21402,16261,5141,11265,0,4968,4980,3552,1428,2.487394958,2278,3321,1675,792,1,791,1,192,0,0.03539823,empty,mBC-0716-1
"C2,H3",18296,18828,13712,5116,9870,0,4434,4440,3073,1367,2.247988296,2159,1156,756,389,0,389,0,122,0,0.033419023,empty,mBC-0716-1
"C2,H4",12420,12596,9368,3228,6622,0,2996,3006,2127,879,2.419795222,1430,543,254,112,0,112,0,35,0,0,empty,mBC-0716-1
"C2,H5",16575,16921,12638,4283,9096,0,4173,4185,2928,1257,2.329355609,2012,1594,937,472,0,472,0,141,0,0.048728814,empty,mBC-0716-1
"C2,H6",13630,14271,10174,4097,7551,0,3597,3604,2557,1047,2.442215855,1774,1313,791,369,0,369,0,120,0,0.048780488,empty,mBC-0716-1
"C2,H7",15774,16009,11795,4214,8745,0,3978,3983,2793,1190,2.347058824,1901,1214,824,456,0,456,0,153,0,0.052631579,empty,mBC-0716-1
"C2,H8",16534,17001,12507,4494,9307,0,4359,4365,3140,1225,2.563265306,2176,1627,1006,506,0,506,0,154,0,0.065217391,empty,mBC-0716-1
"C2,H9",14239,14361,10844,3517,7730,0,3545,3560,2524,1036,2.436293436,1696,1313,819,377,0,377,0,102,0,0.039787798,empty,mBC-0716-1
"C2,H10",12858,13020,9712,3308,6948,0,3141,3146,2155,991,2.17457114,1515,1279,837,416,0,416,0,105,0,0.043269231,empty,mBC-0716-1
"C2,H11",15999,16355,11855,4500,8719,0,4042,4053,2830,1223,2.313982011,2007,577,244,125,0,125,0,50,0,0.024,empty,mBC-0716-1
"C2,H12",5579,5765,4224,1541,3122,0,1452,1456,973,483,2.014492754,736,756,459,212,0,212,0,58,0,0.066037736,empty,mBC-0716-1
"C3,A1",13308,13846,10095,3751,7556,0,3629,3635,2544,1091,2.331805683,1757,1425,983,485,0,485,0,116,0,0.032989691,empty,mBC-0716-1
"C3,A2",18181,18167,13856,4311,9578,0,4185,4198,2944,1254,2.3476874,1942,12688,4326,2260,2,2258,2,358,0,0.178033658,empty,mBC-0716-1
"C3,A3",699431,773603,500751,272852,410642,1,228152,228531,176353,52178,3.379834413,125095,89744,56131,27097,16,27081,2,2410,0,0.001809387,mm10,mBC-0716-1
"C3,A4",21520,21615,16643,4972,11241,0,4846,4858,3405,1453,2.343427392,2217,549,314,151,0,151,0,58,0,0,empty,mBC-0716-1
"C3,A5",400730,414823,299251,115572,227495,0,108817,109021,80207,28814,2.783612133,55072,2440,1392,655,1,654,1,196,0,0.088685015,empty,mBC-0716-1
"C3,A6",17452,18068,13017,5051,9715,0,4665,4676,3236,1440,2.247222222,2311,51967,17470,8965,11,8954,4,1339,0,0.075050257,empty,mBC-0716-1
"C3,A7",15985,16613,12359,4254,8743,0,3936,3947,2736,1211,2.259289843,1867,1048,625,344,0,344,0,122,0,0.058139535,empty,mBC-0716-1
"C3,A8",10949,10928,8333,2595,5862,0,2669,2682,1873,809,2.315203956,1194,1255,803,434,0,434,0,146,0,0.004608295,empty,mBC-0716-1
"C3,A9",17918,18000,13895,4105,9626,1,4069,4089,2874,1215,2.365432099,1887,961,573,299,0,299,0,92,0,0.040133779,empty,mBC-0716-1
"C3,A10",15234,15633,11526,4107,8316,0,3832,3843,2691,1152,2.3359375,1813,522,332,164,0,164,0,58,0,0.048780488,empty,mBC-0716-1
"C3,A11",17645,17563,13521,4042,9434,0,4101,4110,2878,1232,2.336038961,1837,1599,863,442,0,442,0,110,0,0.128959276,empty,mBC-0716-1
"C3,A12",20498,20560,15671,4889,10739,0,4699,4704,3372,1332,2.531531532,2128,2244,1215,662,1,661,1,178,0,0.149773071,empty,mBC-0716-1
"C3,B1",18867,19267,14519,4748,10144,0,4517,4525,3129,1396,2.241404011,2081,1853,857,449,0,449,0,123,0,0.069042316,empty,mBC-0716-1
"C3,B2",20793,21187,15783,5404,11006,0,4881,4892,3445,1447,2.380787837,2296,4358,1334,712,0,712,0,150,0,0.130617978,empty,mBC-0716-1
"C3,B3",847723,930940,611179,319761,490655,4,271840,272279,220940,51339,4.303550907,146466,80279,56199,26607,15,26592,1,2283,0,0.001541817,mm10,mBC-0716-1
"C3,B4",16978,17506,12923,4583,9178,0,4153,4161,2911,1250,2.3288,1956,1123,680,355,0,355,0,130,0,0.112676056,empty,mBC-0716-1
"C3,B5",15619,13142,8674,4468,7842,0,4177,4195,3286,909,3.614961496,2285,838,511,249,0,249,0,78,0,0.052208835,empty,mBC-0716-1
"C3,B6",11493,12122,8769,3353,6444,0,3089,3098,2158,940,2.295744681,1494,1439,838,403,0,403,0,107,0,0.014888337,empty,mBC-0716-1
"C3,B7",16092,16604,12297,4307,8715,0,3958,3971,2801,1170,2.394017094,1911,1181,641,361,0,361,0,104,0,0.060941828,empty,mBC-0716-1
"C3,B8",13156,13742,10124,3618,7183,0,3226,3229,2263,966,2.342650104,1541,1128,694,352,0,352,0,106,0,0.0625,empty,mBC-0716-1
"C3,B9",15107,15418,11704,3714,7957,0,3417,3434,2374,1060,2.239622642,1543,693,432,218,1,217,1,74,0,0.092165899,empty,mBC-0716-1
"C3,B10",16260,15792,11554,4238,8735,0,4020,4037,2782,1255,2.216733068,1981,575,371,151,0,151,0,51,0,0.066225166,empty,mBC-0716-1
"C3,B11",15532,15835,11792,4043,8440,0,3772,3782,2609,1173,2.224211424,1799,299,158,80,0,80,0,41,0,0,empty,mBC-0716-1
"C3,B12",1052357,1130350,772603,357747,600085,0,315678,316173,252576,63597,3.97150809,166731,76576,53054,25203,9,25194,1,2395,0,0.002659363,mm10,mBC-0716-1
"C3,C1",1070444,1141242,793335,347907,587453,2,299402,299922,261487,38435,6.803356316,153173,93581,67147,31659,10,31649,1,2548,0,0.001801005,mm10,mBC-0716-1
"C3,C2",18260,19018,13846,5172,10138,0,4681,4694,3248,1446,2.246196404,2309,1802,1091,538,0,538,0,180,0,0.039033457,empty,mBC-0716-1
"C3,C3",20483,20557,15180,5377,10816,0,4927,4934,3439,1495,2.300334448,2425,16156,5106,2574,4,2570,1,408,0,0.009727626,empty,mBC-0716-1
"C3,C4",17109,17564,13188,4376,9301,0,4136,4149,2910,1239,2.348668281,1982,1254,788,429,0,429,0,136,0,0.013986014,empty,mBC-0716-1
"C3,C5",17495,18101,13391,4710,9534,0,4259,4281,2997,1284,2.33411215,2057,1044,573,306,0,306,0,87,0,0,empty,mBC-0716-1
"C3,C6",16372,16476,12174,4302,9084,0,4146,4154,3029,1125,2.692444444,2004,1901,1125,560,0,560,0,133,0,0.067857143,empty,mBC-0716-1
"C3,C7",701292,783411,482893,300518,413518,2,241870,242239,207526,34713,5.978336646,138030,9393,5030,2416,0,2416,0,646,0,0.004966887,mm10,mBC-0716-1
"C3,C8",14355,14739,10870,3869,7906,0,3616,3621,2527,1094,2.309872029,1740,1394,842,436,1,435,1,133,0,0.027586207,empty,mBC-0716-1
"C3,C9",864662,949398,612225,337173,498484,0,281357,281821,235705,46116,5.111132796,155121,74630,47079,22127,12,22115,1,2178,0,0.002441782,mm10,mBC-0716-1
"C3,C10",13229,13616,10288,3328,7254,0,3244,3248,2290,958,2.39039666,1513,1055,698,297,0,297,0,91,0,0.003367003,empty,mBC-0716-1
"C3,C11",11598,12115,8833,3282,6373,0,2945,2950,2017,933,2.161843516,1396,852,514,291,0,291,0,100,0,0.048109966,empty,mBC-0716-1
"C3,C12",19675,20329,14884,5445,10575,0,4737,4754,3323,1431,2.322152341,2314,1543,927,533,1,532,1,141,0,0.041353383,empty,mBC-0716-1
"C3,D1",10827,11043,8214,2829,5908,0,2670,2671,1856,815,2.277300613,1289,822,542,250,0,250,0,74,0,0.044,empty,mBC-0716-1
"C3,D2",20581,20868,15953,4915,10940,0,4694,4720,3235,1485,2.178451178,2175,2084,1351,704,0,704,0,174,0,0.042613636,empty,mBC-0716-1
"C3,D3",13065,13672,9870,3802,7251,0,3394,3397,2347,1050,2.235238095,1657,1057,640,318,0,318,0,107,0,0.066037736,empty,mBC-0716-1
"C3,D4",13931,14440,10638,3802,7571,0,3448,3452,2400,1052,2.281368821,1668,1338,845,451,0,451,0,136,0,0.057649667,empty,mBC-0716-1
"C3,D5",699480,716786,510188,206598,374438,1,185803,186114,143100,43014,3.326823825,95143,89744,42203,20028,10,20018,4,2299,0,0.013288041,mm10,mBC-0716-1
"C3,D6",537126,580472,394023,186449,311007,0,160238,160500,129511,30989,4.179257156,84772,87513,58040,27701,9,27692,2,2429,0,0.004080601,mm10,mBC-0716-1
"C3,D7",13010,13478,9890,3588,7139,1,3277,3285,2257,1028,2.195525292,1562,1530,957,490,0,490,0,150,0,0.055102041,empty,mBC-0716-1
"C3,D8",775718,843414,557640,285774,446788,0,242937,243281,202789,40492,5.008125062,130774,91902,59125,28148,16,28132,4,2571,0,0.006682781,mm10,mBC-0716-1
"C3,D9",4700,4987,3530,1457,2694,0,1282,1285,925,360,2.569444444,658,1314,688,335,0,335,0,124,0,0.032835821,empty,mBC-0716-1
"C3,D10",15453,16208,11729,4479,8634,0,4089,4095,2934,1161,2.527131783,2025,1034,401,222,0,222,0,89,0,0.031531532,empty,mBC-0716-1
"C3,D11",12993,13236,9942,3294,7031,1,3147,3159,2193,966,2.270186335,1504,1581,958,494,0,494,0,154,0,0.068825911,empty,mBC-0716-1
"C3,D12",20104,20750,15479,5271,10909,0,4971,4977,3440,1537,2.23812622,2317,2485,1639,789,0,789,0,211,0,0.031685678,empty,mBC-0716-1
"C3,E1",21146,21510,16285,5225,11269,0,4839,4851,3428,1423,2.408995081,2198,1662,1069,574,0,574,0,177,0,0.071428571,empty,mBC-0716-1
"C3,E2",15986,16102,12264,3838,8537,0,3758,3763,2634,1129,2.333038087,1682,1564,1007,566,0,566,0,149,0,0.038869258,empty,mBC-0716-1
"C3,E3",12078,12260,9408,2852,6535,0,2789,2794,1952,842,2.318289786,1273,1465,983,507,0,507,0,156,0,0.055226824,empty,mBC-0716-1
"C3,E4",15319,15795,11695,4100,8172,0,3729,3741,2632,1109,2.373309288,1757,1566,960,486,0,486,0,124,0,0.002057613,empty,mBC-0716-1
"C3,E5",20373,20785,16003,4782,10911,0,4768,4791,3400,1391,2.444284687,2140,2821,1278,657,0,657,0,188,0,0.00761035,empty,mBC-0716-1
"C3,E6",631616,641596,467351,174245,339704,0,163160,163433,128952,34481,3.73979873,80457,48159,27715,13646,9,13637,3,1634,0,0.010486177,mm10,mBC-0716-1
"C3,E7",709359,733114,528647,204467,387674,0,191888,192227,139241,52986,2.627882837,94983,21800,14796,6977,2,6975,2,1049,0,0.009318996,mm10,mBC-0716-1
"C3,E8",16858,17051,13015,4036,9016,0,3896,3901,2774,1127,2.461401952,1750,2121,1358,641,2,639,1,172,0,0.028169014,empty,mBC-0716-1
"C3,E9",8697,8854,6616,2238,4754,0,2093,2093,1468,625,2.3488,1012,853,526,284,2,282,2,89,0,0.120567376,empty,mBC-0716-1
"C3,E10",13195,13599,9994,3605,7136,0,3208,3210,2252,958,2.350730689,1542,16113,4889,2498,3,2495,2,407,0,0.105811623,empty,mBC-0716-1
"C3,E11",8827,9442,6649,2793,5088,0,2374,2375,1635,740,2.209459459,1210,1048,628,298,0,298,0,107,0,0.05033557,empty,mBC-0716-1
"C3,E12",494684,546933,351350,195583,297354,2,170027,170246,119927,50319,2.383334327,94412,34768,20555,9911,3,9908,2,1283,0,0.019580137,mm10,mBC-0716-1
"C3,F1",17830,18027,13584,4443,9633,0,4289,4299,2997,1302,2.301843318,1958,3719,1579,778,1,777,1,170,0,0.110682111,empty,mBC-0716-1
"C3,F2",22228,23189,16745,6444,12202,0,5682,5691,4030,1661,2.426249247,2830,2449,1626,781,0,781,0,230,0,0.085787452,empty,mBC-0716-1
"C3,F3",15814,16430,11889,4541,8751,0,4182,4182,2894,1288,2.24689441,2056,1602,1045,540,1,539,1,181,0,0.009276438,empty,mBC-0716-1
"C3,F4",16009,16364,11996,4368,8733,0,3971,3979,2726,1253,2.175578611,1970,454,302,145,0,145,0,71,0,0,empty,mBC-0716-1
"C3,F5",24048,25015,18178,6837,13002,0,5903,5919,4095,1824,2.245065789,2890,11331,3773,1941,1,1940,1,352,0,0.11185567,empty,mBC-0716-1
"C3,F6",22278,22880,16949,5931,12211,0,5426,5436,3779,1657,2.28062764,2590,2224,1322,677,0,677,0,187,0,0.050221566,empty,mBC-0716-1
"C3,F7",29644,31128,22212,8916,16847,0,8276,8291,5761,2530,2.277075099,4081,5756,2180,1167,1,1166,1,201,0,0.047169811,empty,mBC-0716-1
"C3,F8",662741,696230,500442,195788,370014,1,177158,177457,147486,29971,4.920956925,88190,15131,10215,4895,1,4894,1,722,0,0,mm10,mBC-0716-1
"C3,F9",14455,14915,11037,3878,7880,0,3554,3563,2510,1053,2.383665717,1727,1638,1056,554,0,554,0,175,0,0.023465704,empty,mBC-0716-1
"C3,F10",20830,20913,16233,4680,10954,0,4675,4689,3241,1448,2.238259669,2093,1380,827,455,1,454,1,137,0,0.030837004,empty,mBC-0716-1
"C3,F11",11239,11537,8619,2918,6099,0,2663,2671,1850,821,2.253349574,1281,1145,717,361,0,361,0,123,0,0.030470914,empty,mBC-0716-1
"C3,F12",727133,800600,513769,286831,419666,0,236576,236961,192920,44041,4.380463659,129805,15546,9175,4383,0,4383,0,659,0,0.002509697,mm10,mBC-0716-1
"C3,G1",10370,10495,8107,2388,5610,0,2455,2460,1692,768,2.203125,1084,4170,1821,906,2,904,2,216,0,0.036504425,empty,mBC-0716-1
"C3,G2",20894,21329,16081,5248,11014,0,4889,4904,3433,1471,2.33378654,2318,434,287,152,0,152,0,53,0,0,empty,mBC-0716-1
"C3,G3",802371,902406,549524,352882,476466,1,287505,287862,222142,65720,3.380127815,165098,80261,57980,27738,10,27728,2,2281,0,0.001514714,mm10,mBC-0716-1
"C3,G4",28217,28558,21758,6800,14950,0,6383,6395,4503,1892,2.380021142,2872,66,44,27,0,27,0,20,0,0,empty,mBC-0716-1
"C3,G5",13837,14058,10460,3598,7485,0,3410,3418,2348,1070,2.194392523,1636,3493,1239,587,1,586,1,160,0,0.039249147,empty,mBC-0716-1
"C3,G6",24176,24791,18595,6196,12951,0,5661,5677,3948,1729,2.28340081,2712,208,144,87,0,87,0,35,0,0,empty,mBC-0716-1
"C3,G7",20441,20738,15826,4912,10818,0,4765,4778,3336,1442,2.313453537,2207,2284,1127,560,0,560,0,189,0,0.05,empty,mBC-0716-1
"C3,G8",13813,14405,10385,4020,7617,0,3490,3497,2445,1052,2.324144487,1718,1493,869,445,0,445,0,144,0,0.049438202,empty,mBC-0716-1
"C3,G9",10658,11133,8018,3115,5860,0,2667,2674,1851,823,2.2490887,1333,1048,661,366,0,366,0,138,0,0.032786885,empty,mBC-0716-1
"C3,G10",13630,13911,10505,3406,7281,0,3172,3184,2197,987,2.225937183,1492,1190,797,397,1,396,1,124,0,0.037878788,empty,mBC-0716-1
"C3,G11",693947,728351,514481,213870,386069,2,192841,193159,160968,32191,5.00040384,97642,76433,52909,25100,8,25092,1,2121,0,0.000876773,mm10,mBC-0716-1
"C3,G12",701906,776979,481806,295173,420940,1,255114,255445,201711,53734,3.753880225,144080,26644,16735,7965,4,7961,3,1295,0,0.001507348,mm10,mBC-0716-1
"C3,H1",945082,1050478,655505,394973,551007,1,326875,327302,267122,60180,4.438717182,182573,74589,51470,24164,13,24151,2,2284,0,0.001780465,mm10,mBC-0716-1
"C3,H2",1337190,1508500,905017,603483,772649,2,480637,481328,385804,95524,4.03881747,271966,225514,162857,76739,25,76714,2,4172,0,0.00091248,mm10,mBC-0716-1
"C3,H3",876696,959861,600594,359267,506547,1,305756,306194,239120,67074,3.565017742,170653,43930,26213,12609,9,12600,2,1613,0,0.005396825,mm10,mBC-0716-1
"C3,H4",12957,13192,9741,3451,6888,0,3111,3117,2091,1026,2.038011696,1480,183,128,62,0,62,0,21,0,0.193548387,empty,mBC-0716-1
"C3,H5",18214,18870,13710,5160,9868,0,4589,4598,3238,1360,2.380882353,2276,2211,1084,563,0,563,0,177,0,0.104795737,empty,mBC-0716-1
"C3,H6",13241,13798,10122,3676,7475,0,3448,3448,2388,1060,2.252830189,1706,1429,875,467,0,467,0,150,0,0.085653105,empty,mBC-0716-1
"C3,H7",16423,16803,12463,4340,9083,0,4143,4150,2920,1230,2.37398374,2007,1397,828,434,0,434,0,152,0,0.050691244,empty,mBC-0716-1
"C3,H8",12983,13365,9779,3586,7150,0,3324,3325,2292,1033,2.218780252,1647,1630,1032,539,0,539,0,168,0,0.018552876,empty,mBC-0716-1
"C3,H9",16048,16713,12034,4679,8984,0,4153,4168,2955,1213,2.436108821,2123,5728,2167,1082,2,1080,2,213,0,0.057407407,empty,mBC-0716-1
"C3,H10",917273,994568,645523,349045,528094,0,293360,293766,232153,61613,3.767922354,160882,201503,145503,69147,32,69115,1,4116,0,0.000723432,mm10,mBC-0716-1
"C3,H11",676912,766391,460850,305541,409486,0,255932,256239,197017,59222,3.326753571,146694,783,517,268,0,268,0,86,0,0.007462687,empty,mBC-0716-1
"C3,H12",5837,6101,4432,1669,3241,1,1505,1513,1041,472,2.205508475,731,953,501,272,0,272,0,89,0,0.069852941,empty,mBC-0716-1
"C4,A1",17343,18395,13045,5350,9993,0,4864,4867,3464,1403,2.468995011,2460,907,529,278,0,278,0,74,0,0.089928058,empty,mBC-0716-1
"C4,A2",21546,22082,16433,5649,11802,0,5292,5301,3720,1581,2.352941176,2536,1053,660,333,0,333,0,91,0,0.021021021,empty,mBC-0716-1
"C4,A3",18546,19169,14145,5024,10282,0,4836,4848,3437,1411,2.435861091,2341,737,476,255,0,255,0,79,0,0.02745098,empty,mBC-0716-1
"C4,A4",21714,22214,16744,5470,11640,0,5123,5143,3628,1515,2.394719472,2374,524,320,181,0,181,0,53,0,0.182320442,empty,mBC-0716-1
"C4,A5",18204,18886,13961,4925,10108,0,4528,4533,3291,1242,2.649758454,2195,1109,713,389,1,388,1,106,0,0.00257732,empty,mBC-0716-1
"C4,A6",14599,15051,11124,3927,8135,0,3791,3794,2758,1036,2.662162162,1803,1100,719,389,0,389,0,124,0,0.12596401,empty,mBC-0716-1
"C4,A7",655765,673303,498343,174960,359942,0,160419,160707,141989,18718,7.585692916,77798,75986,51345,24336,12,24324,3,2237,0,0.002384476,mm10,mBC-0716-1
"C4,A8",12299,12865,9334,3531,6937,0,3201,3211,2272,939,2.419595314,1575,5429,2022,980,1,979,1,234,0,0.051072523,empty,mBC-0716-1
"C4,A9",19969,20358,15129,5229,10530,0,4751,4765,3339,1426,2.341514727,2249,20602,6288,3033,0,3033,0,469,0,0.020441807,empty,mBC-0716-1
"C4,A10",18987,19676,14353,5323,10634,0,5029,5041,3571,1470,2.429251701,2461,271,188,101,0,101,0,39,0,0.03960396,empty,mBC-0716-1
"C4,A11",20319,20612,15607,5005,11017,0,5021,5038,3516,1522,2.310118265,2379,1644,825,423,0,423,0,111,0,0.078014184,empty,mBC-0716-1
"C4,A12",2160361,2325594,1528228,797366,1179585,3,684542,685633,543443,142190,3.821949504,366897,302361,210275,101425,50,101375,5,4924,0,0.001824908,mm10,mBC-0716-1
"C4,B1",19936,20675,15409,5266,10881,0,4842,4850,3387,1463,2.315105947,2284,860,578,288,0,288,0,82,0,0.038194444,empty,mBC-0716-1
"C4,B2",20957,21277,15759,5518,11094,0,4939,4956,3438,1518,2.264822134,2371,5986,1646,793,2,791,1,160,0,0.008849558,empty,mBC-0716-1
"C4,B3",20067,20583,15381,5202,10928,0,4948,4953,3505,1448,2.42058011,2274,1165,754,391,0,391,0,101,0,0.046035806,empty,mBC-0716-1
"C4,B4",18353,18768,13690,5078,9823,0,4475,4490,3208,1282,2.502340094,2183,16404,5144,2606,1,2605,1,425,0,0.100575816,empty,mBC-0716-1
"C4,B5",13900,10338,6936,3402,6606,0,3508,3532,2560,972,2.633744856,1938,853,364,199,0,199,0,74,0,0.010050251,empty,mBC-0716-1
"C4,B6",13121,13796,9870,3926,7389,0,3536,3541,2427,1114,2.178635548,1769,893,556,292,0,292,0,84,0,0.044520548,empty,mBC-0716-1
"C4,B7",16804,16989,13096,3893,9066,0,3971,3978,2799,1179,2.374045802,1771,2683,864,463,1,462,1,123,0,0.03030303,empty,mBC-0716-1
"C4,B8",13686,14043,10633,3410,7571,0,3356,3367,2439,928,2.628232759,1547,822,528,243,0,243,0,97,0,0.020576132,empty,mBC-0716-1
"C4,B9",16025,16910,12330,4580,8771,0,3937,3950,2714,1236,2.19579288,1912,473,308,156,0,156,0,48,0,0.044871795,empty,mBC-0716-1
"C4,B10",18368,18608,13367,5241,10297,0,4814,4839,3372,1467,2.298568507,2447,387,217,104,0,104,0,42,0,0.038461538,empty,mBC-0716-1
"C4,B11",872398,966713,603944,362769,506134,0,299797,300180,251378,48802,5.150977419,167348,11804,8489,4085,0,4085,0,651,0,0.003182375,mm10,mBC-0716-1
"C4,B12",19723,20231,14827,5404,10646,0,4900,4912,3474,1438,2.415855355,2384,12483,3912,2003,2,2001,1,364,0,0.058470765,empty,mBC-0716-1
"C4,C1",23353,23529,18151,5378,12267,0,5151,5163,3617,1546,2.339586028,2349,549,366,210,1,209,1,59,0,0.066985646,empty,mBC-0716-1
"C4,C2",22273,23385,16735,6650,12454,0,5898,5912,4228,1684,2.510688836,2924,1394,955,513,1,512,1,139,0,0.033203125,empty,mBC-0716-1
"C4,C3",21349,22299,16305,5994,11744,0,5360,5378,3714,1664,2.231971154,2605,665,362,182,0,182,0,55,0,0.027472527,empty,mBC-0716-1
"C4,C4",19277,19746,14753,4993,10642,0,4775,4783,3444,1339,2.572068708,2222,1050,714,325,0,325,0,103,0,0.089230769,empty,mBC-0716-1
"C4,C5",19004,20122,14214,5908,10849,0,5230,5239,3645,1594,2.286700125,2755,2185,967,492,1,491,1,119,0,0.020366599,empty,mBC-0716-1
"C4,C6",19745,20120,14933,5187,11117,0,5131,5145,3633,1512,2.402777778,2508,1443,875,424,0,424,0,122,0,0.063679245,empty,mBC-0716-1
"C4,C7",17462,17920,13190,4730,9633,0,4472,4483,3230,1253,2.577813248,2141,1016,460,223,0,223,0,61,0,0.094170404,empty,mBC-0716-1
"C4,C8",16512,16898,12758,4140,9158,0,4137,4146,2866,1280,2.2390625,1949,1283,815,418,0,418,0,130,0,0.04784689,empty,mBC-0716-1
"C4,C9",444090,497756,303809,193947,260670,0,159650,159905,114805,45100,2.54556541,90174,6074,3747,1796,1,1795,1,387,0,0.007799443,mm10,mBC-0716-1
"C4,C10",14925,15543,11390,4153,8175,1,3736,3745,2598,1147,2.265039233,1823,798,504,268,1,267,1,84,0,0.04494382,empty,mBC-0716-1
"C4,C11",12759,13388,9767,3621,7072,0,3380,3392,2389,1003,2.381854437,1654,1591,767,335,0,335,0,86,0,0.059701493,empty,mBC-0716-1
"C4,C12",21566,22004,16114,5890,11726,0,5346,5353,3695,1658,2.228588661,2680,1025,640,335,0,335,0,101,0,0.032835821,empty,mBC-0716-1
"C4,D1",13660,14295,10204,4091,7690,0,3673,3678,2655,1023,2.595307918,1815,560,363,195,0,195,0,54,0,0.097435897,empty,mBC-0716-1
"C4,D2",21263,21374,16689,4685,11411,0,4780,4802,3325,1477,2.251184834,2170,2502,1453,745,0,745,0,163,0,0.048322148,empty,mBC-0716-1
"C4,D3",15016,15527,11348,4179,8329,0,3867,3874,2744,1130,2.428318584,1870,1070,679,355,0,355,0,88,0,0.078873239,empty,mBC-0716-1
"C4,D4",630691,721833,424912,296921,389820,0,247990,248246,185201,63045,2.937600127,143815,12923,8912,4297,2,4295,1,680,0,0.006053551,mm10,mBC-0716-1
"C4,D5",15706,16123,12065,4058,8804,0,4097,4102,2951,1151,2.563857515,1934,933,565,325,0,325,0,104,0,0.009230769,empty,mBC-0716-1
"C4,D6",668608,783864,446870,336994,419219,1,268998,269359,208524,60835,3.427697871,158529,105683,75445,35454,9,35445,1,2759,0,0.001213147,mm10,mBC-0716-1
"C4,D7",15069,15677,11448,4229,8440,0,4001,4002,2867,1135,2.525991189,1949,1263,765,363,2,361,1,118,0,0.074792244,empty,mBC-0716-1
"C4,D8",18243,18698,13670,5028,9939,0,4631,4642,3360,1282,2.620904836,2281,7578,2313,1243,0,1243,0,227,0,0.071600965,empty,mBC-0716-1
"C4,D9",7712,7981,5778,2203,4393,0,2208,2211,1640,571,2.872154116,1031,1300,849,419,0,419,0,123,0,0.059665871,empty,mBC-0716-1
"C4,D10",375250,382564,286098,96466,208839,0,93742,93908,74941,18967,3.951125639,45047,17090,10304,5032,4,5028,2,808,0,0.004176611,mm10,mBC-0716-1
"C4,D11",14578,15000,11135,3865,7999,0,3656,3658,2580,1078,2.393320965,1736,1118,678,332,0,332,0,110,0,0.060240964,empty,mBC-0716-1
"C4,D12",21383,22353,16379,5974,11691,0,5398,5414,3902,1512,2.580687831,2516,3911,1849,844,0,844,0,217,0,0.017772512,empty,mBC-0716-1
"C4,E1",24055,24856,18537,6319,13262,0,5946,5953,4269,1684,2.535035629,2867,1197,732,375,0,375,0,122,0,0.064,empty,mBC-0716-1
"C4,E2",18631,19248,14223,5025,10259,0,4606,4619,3344,1275,2.622745098,2150,1315,727,385,0,385,0,123,0,0.083116883,empty,mBC-0716-1
"C4,E3",696553,719942,529357,190585,381869,0,176956,177325,148736,28589,5.202560425,86061,72289,46648,22802,8,22794,1,2191,0,0.004123892,mm10,mBC-0716-1
"C4,E4",16018,16491,12375,4116,8753,0,3912,3917,2816,1101,2.557674841,1839,819,465,259,1,258,1,100,0,0.034883721,empty,mBC-0716-1
"C4,E5",2470604,2717200,1708425,1008775,1381649,1,849917,851036,701354,149682,4.685626862,467547,147018,102302,48779,15,48764,2,3365,0,0.00360922,mm10,mBC-0716-1
"C4,E6",15469,15936,11856,4080,8486,0,3864,3868,2673,1195,2.236820084,1910,1159,683,354,1,353,1,96,0,0.042492918,empty,mBC-0716-1
"C4,E7",15072,15548,11512,4036,8367,0,3768,3782,2645,1137,2.326297274,1851,919,549,285,0,285,0,99,0,0.049122807,empty,mBC-0716-1
"C4,E8",18919,19497,14390,5107,10418,0,4705,4713,3359,1354,2.480797637,2252,1624,1096,592,0,592,0,162,0,0.02027027,empty,mBC-0716-1
"C4,E9",11077,11531,8234,3297,6034,0,2892,2900,2076,824,2.519417476,1422,2875,1073,511,1,510,1,123,0,0.037254902,empty,mBC-0716-1
"C4,E10",13717,14352,10402,3950,7612,0,3500,3509,2459,1050,2.341904762,1703,2075,1078,520,0,520,0,116,0,0.132692308,empty,mBC-0716-1
"C4,E11",663890,743994,452109,291885,403511,1,250414,250724,158352,92372,1.714285714,145500,5453,3687,1730,1,1729,1,381,0,0.004048583,mm10,mBC-0716-1
"C4,E12",17045,18051,12869,5182,9616,0,4534,4537,3201,1336,2.395958084,2295,1216,739,375,0,375,0,106,0,0.018666667,empty,mBC-0716-1
"C4,F1",18767,19485,14418,5067,10257,1,4689,4704,3258,1446,2.253112033,2216,1267,814,452,1,451,1,108,0,0.048780488,empty,mBC-0716-1
"C4,F2",24451,25316,18391,6925,13445,0,6235,6243,4452,1791,2.485762144,3059,4145,1922,971,1,970,1,234,0,0.087628866,empty,mBC-0716-1
"C4,F3",18628,19489,13978,5511,10489,0,5113,5126,3612,1514,2.385733157,2541,1590,1049,516,0,516,0,139,0,0.03875969,empty,mBC-0716-1
"C4,F4",21261,22090,15921,6169,12136,0,5762,5769,4202,1567,2.681557116,2881,511,297,161,0,161,0,61,0,0.037267081,empty,mBC-0716-1
"C4,F5",25503,26421,19494,6927,13961,0,6411,6430,4542,1888,2.405720339,3038,1306,858,418,0,418,0,122,0,0.040669856,empty,mBC-0716-1
"C4,F6",26412,27554,19991,7563,14781,0,6848,6859,4899,1960,2.499489796,3384,2414,1503,728,1,727,1,194,0,0.035763411,empty,mBC-0716-1
"C4,F7",20456,20946,15669,5277,11485,2,5198,5224,3662,1562,2.344430218,2468,839,544,282,0,282,0,76,0,0,empty,mBC-0716-1
"C4,F8",25105,26302,19065,7237,14116,1,6624,6628,4644,1984,2.340725806,3297,175,101,66,0,66,0,32,0,0,empty,mBC-0716-1
"C4,F9",17245,17728,13206,4522,9583,0,4344,4350,3051,1299,2.348729792,2066,6313,2400,1188,0,1188,0,245,0,0.047138047,empty,mBC-0716-1
"C4,F10",20878,21088,16127,4961,11310,0,4987,4996,3467,1529,2.267495095,2349,1235,795,396,0,396,0,110,0,0.03030303,empty,mBC-0716-1
"C4,F11",12507,13103,9618,3485,6957,0,3094,3101,2173,928,2.341594828,1517,713,420,221,0,221,0,81,0,0.040723982,empty,mBC-0716-1
"C4,F12",15903,16489,11673,4816,8461,0,3977,3979,2785,1194,2.332495812,1990,3030,812,416,0,416,0,93,0,0.024038462,empty,mBC-0716-1
"C4,G1",413577,438487,313622,124865,238220,1,117571,117758,88254,29504,2.991255423,59425,25777,17870,8724,2,8722,2,1204,0,0.006649851,mm10,mBC-0716-1
"C4,G2",21412,21742,16258,5484,11637,0,5153,5156,3645,1511,2.412309729,2431,436,221,123,0,123,0,40,0,0.138211382,empty,mBC-0716-1
"C4,G3",21302,22024,16234,5790,11637,0,5360,5365,3689,1676,2.201073986,2602,1809,1176,611,0,611,0,145,0,0.062193126,empty,mBC-0716-1
"C4,G4",30072,30335,23182,7153,16018,1,6918,6929,5030,1899,2.648762507,3221,39,29,20,0,20,0,11,0,0,empty,mBC-0716-1
"C4,G5",14065,14679,10635,4044,7782,0,3593,3600,2508,1092,2.296703297,1737,964,648,345,0,345,0,96,0,0.063768116,empty,mBC-0716-1
"C4,G6",866958,925752,643429,282323,487128,1,245947,246355,186585,59770,3.12171658,126713,8014,5591,2703,0,2703,0,442,0,0.002589715,mm10,mBC-0716-1
"C4,G7",614297,662530,457911,204619,357168,0,183711,183951,117723,66228,1.777541221,96837,40030,27383,13203,4,13199,1,1542,0,0.004470036,mm10,mBC-0716-1
"C4,G8",15970,16672,12086,4586,8970,0,4265,4278,3007,1271,2.365853659,2140,1150,690,349,0,349,0,113,0,0.031518625,empty,mBC-0716-1
"C4,G9",12275,12852,9416,3436,6805,0,3163,3169,2245,924,2.42965368,1557,1326,889,432,0,432,0,118,0,0.071759259,empty,mBC-0716-1
"C4,G10",14646,15217,11267,3950,8010,0,3528,3545,2483,1062,2.338041431,1703,1067,694,371,0,371,0,107,0,0.094339623,empty,mBC-0716-1
"C4,G11",13382,13631,10156,3475,7306,0,3418,3423,2447,976,2.507172131,1631,608,397,193,0,193,0,63,0,0.113989637,empty,mBC-0716-1
"C4,G12",12638,13003,9492,3511,7014,0,3278,3285,2343,942,2.487261146,1603,970,586,305,0,305,0,95,0,0.072131148,empty,mBC-0716-1
"C4,H1",22861,23421,17250,6171,12616,0,5819,5838,4279,1559,2.744708146,2814,883,538,284,1,283,1,89,0,0.067137809,empty,mBC-0716-1
"C4,H2",779319,847688,565513,282175,451940,0,249438,249836,194427,55409,3.508942591,133791,40734,29071,13816,10,13806,1,1463,0,0.003838911,mm10,mBC-0716-1
"C4,H3",22766,23579,17396,6183,12627,0,5895,5901,4073,1828,2.228118162,2867,1226,730,393,0,393,0,113,0,0.03562341,empty,mBC-0716-1
"C4,H4",15493,16174,11680,4494,8603,0,4003,4003,2889,1114,2.593357271,1972,85,47,30,0,30,0,13,0,0,empty,mBC-0716-1
"C4,H5",20400,20993,15435,5558,11242,0,5220,5239,3776,1463,2.580997949,2531,996,644,366,0,366,0,120,0,0.071038251,empty,mBC-0716-1
"C4,H6",17274,18267,12986,5281,9937,0,4776,4787,3515,1272,2.76336478,2450,1215,778,388,0,388,0,126,0,0.082474227,empty,mBC-0716-1
"C4,H7",1413172,1550070,994525,555545,821785,4,472041,472697,362777,109920,3.300372999,261403,136776,92185,44195,18,44177,4,3260,0,0.000995993,mm10,mBC-0716-1
"C4,H8",16164,16896,12306,4590,9021,0,4230,4246,3028,1218,2.486042693,2053,1446,908,460,0,460,0,126,0,0.056521739,empty,mBC-0716-1
"C4,H9",19019,19700,14485,5215,10505,1,4895,4906,3570,1336,2.672155689,2340,8289,2791,1374,1,1373,1,266,0,0.016023307,empty,mBC-0716-1
"C4,H10",16713,17118,12592,4526,9220,0,4264,4275,3039,1236,2.458737864,2052,1008,585,316,0,316,0,108,0,0.018987342,empty,mBC-0716-1
"C4,H11",19343,20516,14745,5771,11056,0,5343,5354,3756,1598,2.350438048,2706,266,86,52,0,52,0,23,0,0,empty,mBC-0716-1
"C4,H12",7063,7341,5355,1986,4035,0,1890,1894,1348,546,2.468864469,936,661,404,175,0,175,0,56,0,0,empty,mBC-0716-1
"C5,A1",1427038,1625952,954466,671486,861595,4,543553,544204,439006,105198,4.173140174,316299,158517,112951,53656,23,53633,1,3542,0,0.001398393,mm10,mBC-0716-1
"C5,A2",19180,19379,14733,4646,10241,0,4414,4427,3133,1294,2.421174652,2131,1454,852,429,0,429,0,131,0,0.013986014,empty,mBC-0716-1
"C5,A3",17381,17336,13079,4257,9144,0,4175,4181,2967,1214,2.44398682,1986,13648,4742,2387,2,2385,1,374,0,0.112368973,empty,mBC-0716-1
"C5,A4",21247,21809,16469,5340,11290,0,4969,4981,3563,1418,2.512693935,2343,643,364,190,0,190,0,67,0,0,empty,mBC-0716-1
"C5,A5",16667,17650,12596,5054,9364,0,4401,4405,3034,1371,2.212983224,2179,2772,1606,797,0,797,0,175,0,0.026348808,empty,mBC-0716-1
"C5,A6",12912,13406,9889,3517,7073,0,3234,3240,2295,945,2.428571429,1550,1895,1031,486,0,486,0,147,0,0.047325103,empty,mBC-0716-1
"C5,A7",17295,17297,13055,4242,9219,0,4116,4125,2895,1230,2.353658537,1949,19049,6813,3505,3,3502,2,603,0,0.074528841,empty,mBC-0716-1
"C5,A8",540230,571205,403145,168060,305636,1,151172,151427,119310,32117,3.714855061,76996,108972,71929,34239,16,34223,3,2753,0,0.001402566,mm10,mBC-0716-1
"C5,A9",19206,19366,14758,4608,10052,0,4325,4340,3082,1258,2.449920509,1958,1049,698,354,0,354,0,113,0,0.09039548,empty,mBC-0716-1
"C5,A10",15668,15901,12015,3886,8354,0,3723,3737,2657,1080,2.460185185,1708,250,156,90,0,90,0,34,0,0.011111111,empty,mBC-0716-1
"C5,A11",18408,18917,14029,4888,10006,0,4461,4467,3121,1346,2.31872214,2132,1232,647,326,0,326,0,95,0,0.039877301,empty,mBC-0716-1
"C5,A12",20703,21083,16013,5070,10817,0,4733,4749,3363,1386,2.426406926,2190,6207,2627,1284,1,1283,1,269,0,0.019485581,empty,mBC-0716-1
"C5,B1",19552,20680,15111,5569,10793,0,4895,4896,3438,1458,2.358024691,2409,1111,655,371,0,371,0,105,0,0.09703504,empty,mBC-0716-1
"C5,B2",20113,20855,15273,5582,10881,0,4872,4893,3363,1530,2.198039216,2398,479,279,158,0,158,0,52,0,0.075949367,empty,mBC-0716-1
"C5,B3",859453,954530,605472,349058,501402,2,289423,289797,216153,73644,2.93510673,161901,72002,51315,24390,11,24379,1,2212,0,0.001435662,mm10,mBC-0716-1
"C5,B4",16650,17212,12847,4365,9167,0,4136,4148,2895,1253,2.310454908,1984,4900,1672,881,1,880,1,196,0,0.027272727,empty,mBC-0716-1
"C5,B5",15942,13745,8671,5074,8385,0,4703,4718,3654,1064,3.434210526,2655,1997,1160,578,0,578,0,136,0,0.060553633,empty,mBC-0716-1
"C5,B6",12430,12875,9316,3559,6831,0,3213,3222,2186,1036,2.11003861,1620,16156,4692,2374,4,2370,2,401,0,0.034177215,empty,mBC-0716-1
"C5,B7",16567,17291,12775,4516,9108,0,4145,4155,2895,1260,2.297619048,1999,1571,945,524,0,524,0,113,0,0.045801527,empty,mBC-0716-1
"C5,B8",12892,13599,9976,3623,7188,0,3225,3234,2248,986,2.279918864,1579,1804,1088,516,0,516,0,126,0,0,empty,mBC-0716-1
"C5,B9",15254,15600,11746,3854,8005,0,3523,3531,2448,1083,2.260387812,1610,1062,540,306,0,306,0,76,0,0.111111111,empty,mBC-0716-1
"C5,B10",16838,16345,12221,4124,8970,0,4109,4135,2816,1319,2.13495072,1928,643,396,204,0,204,0,58,0,0.009803922,empty,mBC-0716-1
"C5,B11",18839,19703,14425,5278,10442,0,4839,4845,3414,1431,2.385744235,2408,200,153,83,0,83,0,37,0,0,empty,mBC-0716-1
"C5,B12",17826,18132,13758,4374,9735,0,4378,4387,3086,1301,2.372021522,2048,1260,870,389,0,389,0,116,0,0.06940874,empty,mBC-0716-1
"C5,C1",22668,23008,17615,5393,11738,0,4916,4930,3392,1538,2.205461638,2242,4267,1336,677,1,676,1,170,0,0.023668639,empty,mBC-0716-1
"C5,C2",19793,20255,15131,5124,10726,0,4873,4891,3402,1489,2.284754869,2384,1523,982,502,1,501,1,146,0,0.061876248,empty,mBC-0716-1
"C5,C3",511553,534060,369099,164961,288957,2,152137,152409,124096,28313,4.383004274,79396,21555,8631,4312,2,4310,2,713,0,0.082134571,mm10,mBC-0716-1
"C5,C4",17719,18093,13528,4565,9452,0,4215,4223,3018,1205,2.504564315,1971,2183,1022,543,1,542,1,150,0,0.04797048,empty,mBC-0716-1
"C5,C5",824394,902009,581767,320242,475668,1,266442,266847,208550,58297,3.577371048,146054,114362,82235,39710,12,39698,2,2958,0,0.000730515,mm10,mBC-0716-1
"C5,C6",882470,1047579,557473,490106,572555,1,387881,388331,236475,151856,1.557231851,242721,58225,41358,19775,9,19766,2,2010,0,0.001264798,mm10,mBC-0716-1
"C5,C7",16307,17027,12431,4596,9158,0,4311,4325,3059,1266,2.416271722,2139,460,271,131,0,131,0,45,0,0.061068702,empty,mBC-0716-1
"C5,C8",15384,15952,11557,4395,8352,0,3897,3906,2729,1177,2.318606627,1888,8099,2980,1477,0,1477,0,281,0,0.032498307,empty,mBC-0716-1
"C5,C9",847273,976352,560385,415967,512480,2,328177,328644,274834,53810,5.107489314,192286,68948,47980,22726,7,22719,1,2193,0,0.001452529,mm10,mBC-0716-1
"C5,C10",13658,14215,10463,3752,7463,0,3430,3442,2395,1047,2.287488061,1669,1096,697,371,1,370,1,106,0,0.07027027,empty,mBC-0716-1
"C5,C11",11754,12202,8903,3299,6465,0,3005,3024,2105,919,2.290533188,1465,818,559,275,0,275,0,83,0,0.007272727,empty,mBC-0716-1
"C5,C12",743456,810614,531856,278758,425375,0,232059,232396,188472,43924,4.290866041,126431,62948,41448,19437,5,19432,1,1941,0,0.005249074,mm10,mBC-0716-1
"C5,D1",11734,12293,8815,3478,6705,0,3249,3253,2278,975,2.336410256,1614,611,374,201,0,201,0,64,0,0,empty,mBC-0716-1
"C5,D2",20958,21310,16235,5075,11161,0,4926,4935,3483,1452,2.398760331,2220,2263,1460,698,0,698,0,181,0,0.075931232,empty,mBC-0716-1
"C5,D3",13949,14948,10686,4262,7946,0,3761,3768,2613,1155,2.262337662,1957,1170,717,398,0,398,0,112,0,0.165829146,empty,mBC-0716-1
"C5,D4",14545,15039,11069,3970,7800,0,3501,3507,2454,1053,2.33048433,1668,1319,911,451,1,450,1,121,0,0.048888889,empty,mBC-0716-1
"C5,D5",700046,763327,494558,268769,405521,2,226312,226624,194787,31837,6.11825863,123097,115755,82866,39894,12,39882,2,2815,0,0.000777293,mm10,mBC-0716-1
"C5,D6",12282,12748,9210,3538,6789,0,3250,3254,2303,951,2.421661409,1578,2087,1257,575,0,575,0,153,0,0.017391304,empty,mBC-0716-1
"C5,D7",866573,948752,601091,347661,496643,0,287803,288221,234767,53454,4.391944476,158893,165742,115115,54761,23,54738,5,3477,0,0.001808616,mm10,mBC-0716-1
"C5,D8",392423,411864,284075,127789,221989,2,113184,113364,95471,17893,5.335661991,58498,43263,29672,14061,7,14054,1,1588,0,0.001921161,mm10,mBC-0716-1
"C5,D9",5735,6010,4171,1839,3255,0,1586,1591,1129,462,2.443722944,844,1740,905,453,0,453,0,123,0,0.066225166,empty,mBC-0716-1
"C5,D10",13533,14019,10192,3827,7588,0,3474,3478,2427,1051,2.309229305,1703,1085,660,309,0,309,0,99,0,0.01618123,empty,mBC-0716-1
"C5,D11",13215,13620,10106,3514,7285,0,3300,3308,2327,981,2.372069317,1590,3164,1546,774,0,774,0,176,0,0.052971576,empty,mBC-0716-1
"C5,D12",20303,21163,15503,5660,11103,0,5006,5015,3492,1523,2.292843073,2484,2319,1408,701,1,700,1,189,0,0.071428571,empty,mBC-0716-1
"C5,E1",22230,22702,17023,5679,11974,0,5344,5355,3757,1598,2.35106383,2505,1749,1056,539,0,539,0,153,0,0.087198516,empty,mBC-0716-1
"C5,E2",16683,16778,12707,4071,8933,0,3970,3979,2856,1123,2.54318789,1867,7982,2904,1406,1,1405,1,302,0,0.06975089,empty,mBC-0716-1
"C5,E3",12662,12922,9710,3212,6805,0,2950,2959,2062,897,2.29877369,1447,2288,1259,668,1,667,1,158,0,0.181409295,empty,mBC-0716-1
"C5,E4",15857,16363,12094,4269,8593,0,3897,3904,2738,1166,2.348198971,1858,1262,800,424,0,424,0,128,0,0.035377358,empty,mBC-0716-1
"C5,E5",20269,20842,15750,5092,10999,0,4841,4845,3381,1464,2.30942623,2232,2019,1189,581,0,581,0,158,0,0.053356282,empty,mBC-0716-1
"C5,E6",14025,14259,10807,3452,7531,0,3386,3386,2405,981,2.45158002,1602,15381,5351,2726,4,2722,2,434,0,0.110213079,empty,mBC-0716-1
"C5,E7",13879,14264,10663,3601,7576,0,3369,3381,2377,1004,2.36752988,1641,2010,1132,614,0,614,0,164,0,0.027687296,empty,mBC-0716-1
"C5,E8",17719,18160,13669,4491,9476,0,4142,4152,2849,1303,2.186492709,1935,3254,1867,923,0,923,0,226,0,0.041170098,empty,mBC-0716-1
"C5,E9",9444,9675,7307,2368,5074,0,2270,2273,1622,651,2.491551459,993,1222,837,406,0,406,0,100,0,0.051724138,empty,mBC-0716-1
"C5,E10",13537,14211,10177,4034,7423,0,3543,3553,2444,1109,2.203787196,1701,9256,3255,1620,0,1620,0,293,0,0.008641975,empty,mBC-0716-1
"C5,E11",9283,9644,7183,2461,5182,0,2401,2406,1725,681,2.533039648,1120,1055,652,310,0,310,0,86,0,0.04516129,empty,mBC-0716-1
"C5,E12",15066,15595,11423,4172,8387,0,3878,3897,2712,1185,2.288607595,1929,1104,639,340,0,340,0,116,0,0.038235294,empty,mBC-0716-1
"C5,F1",18242,18573,13990,4583,9616,0,4223,4229,2944,1285,2.291050584,2005,1529,1048,545,0,545,0,130,0,0.179816514,empty,mBC-0716-1
"C5,F2",22896,23319,17279,6040,12437,0,5802,5819,4054,1765,2.296883853,2773,2386,1581,853,0,853,0,219,0,0.021101993,empty,mBC-0716-1
"C5,F3",16997,17636,12786,4850,9432,0,4483,4499,3123,1376,2.269622093,2249,1464,996,519,0,519,0,158,0,0.026974952,empty,mBC-0716-1
"C5,F4",17739,18226,13398,4828,9829,0,4523,4539,3191,1348,2.367210682,2241,740,454,247,0,247,0,80,0,0.044534413,empty,mBC-0716-1
"C5,F5",23893,24120,17910,6210,12576,1,5760,5774,3969,1805,2.198891967,2779,2930,1653,704,0,704,0,200,0,0.036931818,empty,mBC-0716-1
"C5,F6",24367,25206,18311,6895,13270,0,6139,6154,4411,1743,2.530694205,3017,14628,4902,2584,1,2583,1,383,0,0.160665892,empty,mBC-0716-1
"C5,F7",20248,20483,15373,5110,10944,0,4856,4864,3356,1508,2.225464191,2228,2133,863,480,0,480,0,161,0,0.122916667,empty,mBC-0716-1
"C5,F8",23118,23624,17540,6084,12337,0,5583,5591,3960,1631,2.427958308,2615,403,272,147,0,147,0,45,0,0.006802721,empty,mBC-0716-1
"C5,F9",15576,15533,11881,3652,8378,1,3710,3715,2607,1108,2.352888087,1705,4917,2023,1073,3,1070,1,233,0,0.04953271,empty,mBC-0716-1
"C5,F10",487169,486051,388451,97600,260845,0,98932,99151,69412,29739,2.334039477,44873,21890,12939,6270,3,6267,1,950,0,0.007020903,mm10,mBC-0716-1
"C5,F11",11412,11603,8760,2843,6136,0,2680,2685,1871,814,2.298525799,1228,969,581,321,0,321,0,103,0,0.052959502,empty,mBC-0716-1
"C5,F12",14025,14411,10690,3721,7490,0,3392,3396,2308,1088,2.121323529,1628,208,121,74,0,74,0,17,0,0,empty,mBC-0716-1
"C5,G1",10144,10610,7988,2622,5591,0,2488,2495,1716,779,2.202824134,1144,1741,1205,595,1,594,1,135,0,0.021885522,empty,mBC-0716-1
"C5,G2",20616,20835,15898,4937,10875,0,4784,4789,3393,1396,2.430515759,2252,455,267,142,0,142,0,40,0,0.028169014,empty,mBC-0716-1
"C5,G3",19951,20528,15048,5480,10708,0,4806,4814,3346,1468,2.279291553,2344,2099,1333,647,0,647,0,169,0,0.023183926,empty,mBC-0716-1
"C5,G4",27913,28473,21452,7021,14872,0,6338,6349,4497,1852,2.428185745,2999,57,41,28,0,28,0,22,0,0,empty,mBC-0716-1
"C5,G5",13336,13603,10114,3489,7108,1,3211,3218,2251,967,2.327817994,1549,1729,1117,546,1,545,1,139,0,0.058715596,empty,mBC-0716-1
"C5,G6",24178,24726,18633,6093,12945,0,5692,5697,3957,1740,2.274137931,2618,169,100,51,0,51,0,31,0,0,empty,mBC-0716-1
"C5,G7",20382,20701,15710,4991,10853,0,4764,4779,3308,1471,2.248810333,2164,2797,1599,799,0,799,0,197,0,0.060075094,empty,mBC-0716-1
"C5,G8",1686929,1839263,1208937,630326,942167,5,528972,529799,444912,84887,5.241226572,284095,234832,159251,76828,29,76799,5,4449,0,0.001197932,mm10,mBC-0716-1
"C5,G9",10799,11144,8167,2977,5786,0,2645,2658,1853,805,2.301863354,1293,1037,687,358,0,358,0,112,0,0.078212291,empty,mBC-0716-1
"C5,G10",14158,14308,10810,3498,7449,0,3365,3378,2374,1004,2.364541833,1570,2313,1226,631,0,631,0,170,0,0.06022187,empty,mBC-0716-1
"C5,G11",12796,13218,9890,3328,6913,0,3111,3116,2127,989,2.15065723,1469,711,475,251,0,251,0,80,0,0.06374502,empty,mBC-0716-1
"C5,G12",11828,12155,8971,3184,6417,0,2980,2988,2096,892,2.349775785,1400,1300,853,399,0,399,0,100,0,0.005012531,empty,mBC-0716-1
"C5,H1",20905,21607,15898,5709,11327,0,5146,5150,3668,1482,2.475033738,2452,899,588,316,0,316,0,98,0,0.041139241,empty,mBC-0716-1
"C5,H2",23755,24359,18082,6277,12629,0,5684,5697,4011,1686,2.379003559,2623,2004,1254,612,1,611,1,174,0,0.026186579,empty,mBC-0716-1
"C5,H3",20255,20848,15519,5329,10925,0,4957,4961,3509,1452,2.416666667,2332,1574,982,441,0,441,0,119,0,0.0430839,empty,mBC-0716-1
"C5,H4",325639,318238,253358,64880,173053,0,66933,67066,52234,14832,3.521709817,30087,455,303,152,0,152,0,50,0,0,empty,mBC-0716-1
"C5,H5",665054,749248,458295,290953,399914,2,243481,243778,177598,66180,2.683559988,139377,35613,17526,8364,4,8360,1,1189,0,0.026196172,mm10,mBC-0716-1
"C5,H6",14509,14897,10997,3900,7933,0,3651,3660,2604,1056,2.465909091,1765,2013,1280,669,0,669,0,180,0,0.013452915,empty,mBC-0716-1
"C5,H7",17471,17936,13208,4728,9599,0,4394,4396,3070,1326,2.315233786,2101,1763,1115,583,0,583,0,166,0,0.027444254,empty,mBC-0716-1
"C5,H8",14025,14332,10735,3597,7663,0,3504,3511,2458,1053,2.334283001,1674,2139,1303,685,0,685,0,174,0,0.016058394,empty,mBC-0716-1
"C5,H9",15668,15978,11867,4111,8598,0,3970,3982,2801,1181,2.371718882,1943,1455,924,519,0,519,0,133,0,0.105973025,empty,mBC-0716-1
"C5,H10",15163,15556,11507,4049,8209,0,3885,3898,2703,1195,2.261924686,1885,1290,815,431,0,431,0,112,0,0.006960557,empty,mBC-0716-1
"C5,H11",17537,18333,13218,5115,9653,0,4516,4522,3155,1367,2.307973665,2300,130,77,54,0,54,0,33,0,0,empty,mBC-0716-1
"C5,H12",6519,6788,5025,1763,3700,0,1695,1697,1196,501,2.387225549,833,726,470,227,0,227,0,66,0,0.044052863,empty,mBC-0716-1
"C6,A1",17486,18180,13141,5039,9955,0,4753,4771,3437,1334,2.576461769,2387,1477,977,505,0,505,0,130,0,0.100990099,empty,mBC-0716-1
"C6,A2",22419,22421,17058,5363,11929,0,5270,5285,3772,1513,2.493060145,2438,16222,5647,2817,1,2816,1,431,0,0.205965909,empty,mBC-0716-1
"C6,A3",17833,18569,13453,5116,10015,0,4699,4708,3315,1393,2.379755922,2342,1105,690,350,0,350,0,112,0,0.034285714,empty,mBC-0716-1
"C6,A4",22859,23255,17491,5764,12200,0,5330,5354,3742,1612,2.32133995,2514,9526,3109,1557,3,1554,3,290,0,0.016087516,empty,mBC-0716-1
"C6,A5",18269,18882,13828,5054,10144,0,4729,4739,3348,1391,2.40690151,2323,1585,931,480,0,480,0,131,0,0.0375,empty,mBC-0716-1
"C6,A6",18822,20501,13976,6525,10983,1,5529,5549,3977,1572,2.529898219,2907,2765,1364,699,0,699,0,174,0,0.071530758,empty,mBC-0716-1
"C6,A7",17914,18659,13630,5029,9932,0,4634,4649,3299,1350,2.443703704,2203,4619,1815,913,0,913,0,197,0,0.08871851,empty,mBC-0716-1
"C6,A8",13173,13694,9982,3712,7287,0,3439,3451,2400,1051,2.283539486,1687,2427,1068,559,1,558,1,177,0,0.068100358,empty,mBC-0716-1
"C6,A9",19741,20008,15187,4821,10541,0,4518,4533,3204,1329,2.410835214,2102,1493,958,489,0,489,0,139,0,0.08997955,empty,mBC-0716-1
"C6,A10",17577,18314,13389,4925,9697,0,4446,4455,3042,1413,2.152866242,2145,364,242,112,0,112,0,47,0,0.107142857,empty,mBC-0716-1
"C6,A11",20298,20575,15528,5047,10990,0,4885,4894,3455,1439,2.400972898,2276,1242,717,339,0,339,0,104,0,0.017699115,empty,mBC-0716-1
"C6,A12",21923,21961,16896,5065,11517,0,5020,5033,3501,1532,2.285248042,2211,2969,1766,928,0,928,0,210,0,0.077586207,empty,mBC-0716-1
"C6,B1",20088,20700,15465,5235,10953,0,4902,4908,3501,1407,2.488272921,2302,1581,1004,482,1,481,1,144,0,0.041580042,empty,mBC-0716-1
"C6,B2",20970,21551,16016,5535,11478,0,5272,5290,3669,1621,2.263417643,2533,592,360,200,0,200,0,66,0,0.035,empty,mBC-0716-1
"C6,B3",1531249,1663528,1103431,560097,874311,0,488907,489611,384720,104891,3.667807534,263352,46713,25121,11702,8,11694,2,1717,0,0.006328031,mm10,mBC-0716-1
"C6,B4",777414,846938,568531,278407,449721,0,242379,242707,185618,57089,3.251379425,128719,104043,73261,35691,10,35681,3,2617,0,0.001177097,mm10,mBC-0716-1
"C6,B5",10227,6614,4627,1987,4401,0,2053,2064,1451,613,2.367047308,1117,754,423,227,0,227,0,79,0,0.017621145,empty,mBC-0716-1
"C6,B6",632626,701032,447760,253272,376910,0,215662,215937,158352,57585,2.749882782,119846,63331,44237,20933,8,20925,1,2065,0,0.001624851,mm10,mBC-0716-1
"C6,B7",17169,17679,13153,4526,9388,0,4159,4166,2949,1217,2.423171734,1963,899,584,285,0,285,0,93,0,0.007017544,empty,mBC-0716-1
"C6,B8",868869,976850,591030,385820,516024,1,316586,317000,238393,78607,3.032719732,181528,64755,45528,21844,9,21835,2,2100,0,0.001557133,mm10,mBC-0716-1
"C6,B9",1933633,2177192,1317677,859515,1133712,1,718370,719298,519135,200163,2.593561248,409064,108453,70437,33289,14,33275,3,2930,0,0.002223892,mm10,mBC-0716-1
"C6,B10",18427,18784,13501,5283,10246,0,4839,4859,3377,1482,2.278677463,2424,745,455,229,0,229,0,72,0,0.030567686,empty,mBC-0716-1
"C6,B11",837337,926310,580206,346104,487028,0,286381,286796,214928,71868,2.990593867,161383,3998,2666,1270,0,1270,0,287,0,0.000787402,mm10,mBC-0716-1
"C6,B12",19321,19733,14671,5062,10687,0,4941,4955,3552,1403,2.531717748,2382,1391,835,419,0,419,0,151,0,0.064439141,empty,mBC-0716-1
"C6,C1",24011,24179,18566,5613,12579,0,5367,5380,3746,1634,2.29253366,2459,1830,794,421,0,421,0,123,0,0.011876485,empty,mBC-0716-1
"C6,C2",22238,23433,16817,6616,12451,0,5838,5852,4136,1716,2.41025641,2909,1845,1060,569,0,569,0,186,0,0.080843585,empty,mBC-0716-1
"C6,C3",23235,24164,17609,6555,12772,0,6058,6070,4232,1838,2.30250272,2957,696,372,176,0,176,0,67,0,0.119318182,empty,mBC-0716-1
"C6,C4",19882,19931,15103,4828,10791,0,4892,4899,3508,1391,2.521926671,2227,1377,880,432,0,432,0,132,0,0.055555556,empty,mBC-0716-1
"C6,C5",17676,18008,13503,4505,9813,0,4498,4505,3154,1351,2.334566987,2134,1099,560,320,1,319,1,108,0,0.02507837,empty,mBC-0716-1
"C6,C6",18791,19411,14115,5296,10692,0,5050,5054,3573,1481,2.412559082,2457,1692,1034,546,1,545,1,128,0,0.064220183,empty,mBC-0716-1
"C6,C7",17758,18265,13354,4911,9979,0,4707,4709,3331,1378,2.417271408,2313,1899,660,342,0,342,0,94,0,0.038011696,empty,mBC-0716-1
"C6,C8",16709,17316,12822,4494,9204,0,4235,4236,3021,1215,2.486419753,2083,1809,1166,559,0,559,0,170,0,0.039355993,empty,mBC-0716-1
"C6,C9",13230,13844,10117,3727,7419,0,3515,3526,2449,1077,2.273909006,1690,968,647,345,1,344,1,93,0,0.040697674,empty,mBC-0716-1
"C6,C10",15017,15454,11437,4017,8268,0,3864,3871,2686,1185,2.266666667,1906,2680,1045,569,0,569,0,138,0,0.031634446,empty,mBC-0716-1
"C6,C11",12105,12698,9180,3518,6822,0,3239,3240,2286,954,2.396226415,1555,1071,663,353,0,353,0,115,0,0.028328612,empty,mBC-0716-1
"C6,C12",23131,24183,17316,6867,12700,0,5871,5885,4235,1650,2.566666667,2941,13982,4278,2131,2,2129,1,380,0,0.039924847,empty,mBC-0716-1
"C6,D1",12936,13744,9725,4019,7526,0,3685,3702,2633,1069,2.463049579,1869,1099,535,306,0,306,0,86,0,0.104575163,empty,mBC-0716-1
"C6,D2",952574,1022213,706683,315530,537606,2,283223,283642,210416,73226,2.873514872,145637,119553,85886,39790,13,39777,1,2918,0,0.00153355,mm10,mBC-0716-1
"C6,D3",495847,535575,356798,178777,294571,0,162224,162469,122596,39873,3.074662052,87696,14651,8529,4136,3,4133,1,694,0,0.061456569,mm10,mBC-0716-1
"C6,D4",15496,15927,11664,4263,8584,0,3994,4001,2738,1263,2.167854315,1937,1514,878,423,0,423,0,141,0,0.037825059,empty,mBC-0716-1
"C6,D5",547296,587660,398244,189416,319246,0,169068,169320,121680,47640,2.554156171,89355,76897,53909,25663,19,25644,2,2156,0,0.000389955,mm10,mBC-0716-1
"C6,D6",13723,14476,10219,4257,7778,0,3709,3717,2636,1081,2.438482886,1889,1406,850,432,0,432,0,137,0,0.064814815,empty,mBC-0716-1
"C6,D7",756281,885394,485793,399601,472249,0,317693,318034,237825,80209,2.965066264,190050,143816,99527,47643,33,47610,3,3345,0,0.000357068,mm10,mBC-0716-1
"C6,D8",18025,18813,13491,5322,10139,0,4923,4930,3447,1483,2.324342549,2493,1021,592,308,0,308,0,98,0,0.094155844,empty,mBC-0716-1
"C6,D9",7110,7430,5184,2246,4141,0,2065,2068,1488,580,2.565517241,1082,1701,1073,459,1,458,1,131,0,0.028384279,empty,mBC-0716-1
"C6,D10",14605,15440,11016,4424,8196,0,3846,3855,2693,1162,2.317555938,1910,882,528,289,0,289,0,96,0,0.031141869,empty,mBC-0716-1
"C6,D11",14701,14923,11159,3764,8187,0,3724,3735,2583,1152,2.2421875,1823,2035,1177,572,0,572,0,171,0,0.052447552,empty,mBC-0716-1
"C6,D12",21336,22172,16145,6027,11777,0,5384,5395,3768,1627,2.315918869,2639,11687,4145,2063,1,2062,1,415,0,0.032977692,empty,mBC-0716-1
"C6,E1",24107,24650,18502,6148,13276,0,5955,5964,4235,1729,2.449392713,2828,1508,932,498,0,498,0,173,0,0.082329317,empty,mBC-0716-1
"C6,E2",581805,616411,426951,189460,331785,1,169413,169704,142309,27395,5.194707063,87461,134524,95075,44937,16,44921,3,3150,0,0.000267136,mm10,mBC-0716-1
"C6,E3",12739,13237,9837,3400,7122,0,3103,3117,2076,1041,1.994236311,1508,2355,1367,683,1,682,1,198,0,0.073313783,empty,mBC-0716-1
"C6,E4",511117,530628,395033,135595,286119,0,127788,128025,98201,29824,3.292683745,62166,40718,29850,14420,4,14416,1,1642,0,0.000832408,mm10,mBC-0716-1
"C6,E5",21817,22523,16739,5784,11968,0,5414,5422,3840,1582,2.427307206,2562,4905,1886,979,1,978,1,228,0,0.011247444,empty,mBC-0716-1
"C6,E6",15386,15965,11770,4195,8534,0,3920,3929,2770,1159,2.389991372,1892,1512,929,470,0,470,0,140,0,0.025531915,empty,mBC-0716-1
"C6,E7",15684,15854,11955,3899,8369,0,3685,3697,2610,1087,2.401103956,1736,10568,3507,1772,3,1769,2,310,0,0.102882985,empty,mBC-0716-1
"C6,E8",19486,19728,15152,4576,10502,1,4598,4622,3229,1393,2.318018665,2129,2734,1457,817,0,817,0,218,0,0.074663403,empty,mBC-0716-1
"C6,E9",10639,10977,8169,2808,5902,0,2756,2766,1945,821,2.369062119,1283,6879,2386,1174,1,1173,1,239,0,0.033248082,empty,mBC-0716-1
"C6,E10",14020,14561,10731,3830,7911,0,3676,3688,2571,1117,2.301700985,1793,1457,897,481,1,480,1,148,0,0.05,empty,mBC-0716-1
"C6,E11",10633,11042,7973,3069,6053,0,2770,2770,1967,803,2.449564134,1418,1329,766,435,0,435,0,108,0,0.055172414,empty,mBC-0716-1
"C6,E12",17260,18008,13099,4909,9677,1,4560,4575,3239,1336,2.424401198,2242,1361,863,478,0,478,0,143,0,0.025104603,empty,mBC-0716-1
"C6,F1",18451,19150,14092,5058,10237,0,4569,4580,3251,1329,2.44620015,2246,1662,1071,525,2,523,2,136,0,0.057361377,empty,mBC-0716-1
"C6,F2",1019203,1138017,700763,437254,597375,1,360410,360872,276429,84443,3.273557311,203500,101919,71905,33319,20,33299,3,2735,0,0.001741794,mm10,mBC-0716-1
"C6,F3",580152,613373,412797,200576,333880,0,182126,182361,141326,41035,3.444035579,96784,18221,10069,4930,4,4926,1,936,0,0.008323183,mm10,mBC-0716-1
"C6,F4",20978,21187,15788,5399,11570,0,5301,5311,3844,1467,2.620313565,2473,1479,676,303,0,303,0,92,0,0.095709571,empty,mBC-0716-1
"C6,F5",25976,26753,19781,6972,14116,0,6466,6492,4574,1918,2.384775808,3172,1730,1088,594,1,593,1,170,0,0.038785835,empty,mBC-0716-1
"C6,F6",661520,713017,483346,229671,381628,1,200888,201143,148471,52672,2.818784174,106093,84213,58360,27602,12,27590,2,2517,0,0.002102211,mm10,mBC-0716-1
"C6,F7",21137,21503,16318,5185,11717,0,5257,5269,3653,1616,2.260519802,2425,1070,633,312,0,312,0,106,0,0.009615385,empty,mBC-0716-1
"C6,F8",24629,25202,18633,6569,13659,0,6286,6299,4561,1738,2.624280783,3011,683,263,150,0,150,0,72,0,0.033333333,empty,mBC-0716-1
"C6,F9",17168,17551,13145,4406,9561,0,4320,4335,3073,1262,2.435023772,2033,2047,1223,645,0,645,0,191,0,0.024806202,empty,mBC-0716-1
"C6,F10",1655001,1753739,1239977,513762,907620,4,462257,463051,375623,87428,4.296369584,233386,224462,147744,69727,23,69704,4,4250,0,0.001865029,mm10,mBC-0716-1
"C6,F11",711003,751884,529492,222392,401571,0,200452,200830,164027,36803,4.456892101,102401,99242,67933,32601,13,32588,1,2688,0,0.000613723,mm10,mBC-0716-1
"C6,F12",15035,15596,11225,4371,8188,0,3862,3871,2685,1186,2.26391231,1975,115,78,49,0,49,0,24,0,0,empty,mBC-0716-1
"C6,G1",339371,359634,251400,108234,197412,0,102243,102396,83003,19393,4.280049502,52502,73923,28131,14150,18,14132,5,1622,0,0.152490801,mm10,mBC-0716-1
"C6,G2",22066,22560,16902,5658,11972,0,5321,5326,3714,1612,2.303970223,2501,379,228,118,0,118,0,42,0,0.093220339,empty,mBC-0716-1
"C6,G3",880195,1000384,592149,408235,530135,0,331598,332020,271195,60825,4.458610769,191675,132432,87111,41373,14,41359,3,3010,0,0.002006818,mm10,mBC-0716-1
"C6,G4",888224,935187,669009,266178,493107,1,235339,235723,206138,29585,6.967652527,118667,1065,711,393,0,393,0,97,0,0.027989822,empty,mBC-0716-1
"C6,G5",14525,14947,10969,3978,7956,0,3656,3664,2527,1137,2.222515391,1786,1368,899,455,0,455,0,120,0,0.112087912,empty,mBC-0716-1
"C6,G6",26692,27150,20597,6553,14433,0,6390,6399,4577,1822,2.512074643,2846,858,342,177,0,177,0,56,0,0.050847458,empty,mBC-0716-1
"C6,G7",21209,21698,16298,5400,11627,0,5278,5290,3819,1471,2.596193066,2528,2381,1370,688,0,688,0,190,0,0.077034884,empty,mBC-0716-1
"C6,G8",16062,17005,12244,4761,9063,0,4250,4255,2990,1265,2.363636364,2136,1723,1128,596,0,596,0,173,0,0.068791946,empty,mBC-0716-1
"C6,G9",11738,12066,9027,3039,6477,0,2977,2989,2104,885,2.37740113,1420,1861,1197,564,0,564,0,173,0,0.04787234,empty,mBC-0716-1
"C6,G10",14873,15330,11478,3852,8214,0,3724,3731,2598,1133,2.293027361,1750,1306,833,482,2,480,1,160,0,0.077083333,empty,mBC-0716-1
"C6,G11",13209,13354,10185,3169,7305,0,3333,3343,2409,934,2.579229122,1538,754,524,261,0,261,0,83,0,0.045977011,empty,mBC-0716-1
"C6,G12",12956,13316,9856,3460,7129,0,3308,3310,2324,986,2.356997972,1587,27303,8639,4439,3,4436,3,709,0,0.028854824,empty,mBC-0716-1
"C6,H1",24158,25254,18279,6975,13586,0,6394,6417,4495,1922,2.338709677,3196,1089,658,334,0,334,0,139,0,0.038922156,empty,mBC-0716-1
"C6,H2",27738,28453,21169,7284,15151,0,7079,7084,5069,2015,2.515632754,3392,2027,1327,658,0,658,0,181,0,0.036474164,empty,mBC-0716-1
"C6,H3",22642,23260,17258,6002,12548,0,5821,5836,4156,1680,2.473809524,2836,1693,870,434,0,434,0,132,0,0.062211982,empty,mBC-0716-1
"C6,H4",15367,15923,11660,4263,8577,0,3972,3983,2800,1183,2.366863905,1954,230,149,67,0,67,0,33,0,0.044776119,empty,mBC-0716-1
"C6,H5",20634,21818,15668,6150,11673,0,5698,5705,4116,1589,2.59030837,2863,1772,1118,553,1,552,1,180,0,0.03442029,empty,mBC-0716-1
"C6,H6",17125,17784,13016,4768,9664,0,4404,4410,3118,1292,2.413312693,2104,1688,1115,615,0,615,0,189,0,0.048780488,empty,mBC-0716-1
"C6,H7",19218,20080,14414,5666,11142,0,5293,5297,3791,1506,2.517264276,2756,1577,997,523,0,523,0,176,0,0.022944551,empty,mBC-0716-1
"C6,H8",16173,16877,12180,4697,8914,0,4270,4274,3041,1233,2.466342255,2126,1832,1142,540,1,539,1,182,0,0.022263451,empty,mBC-0716-1
"C6,H9",765942,861696,518480,343216,460609,0,281992,282319,229205,53114,4.315340588,161727,82132,57858,27808,14,27794,5,2363,0,0.001619054,mm10,mBC-0716-1
"C6,H10",676142,716807,485350,231457,380334,1,198806,199153,167525,31628,5.296730745,105492,143663,97809,47241,23,47218,6,3184,0,0.001249523,mm10,mBC-0716-1
"C6,H11",19362,20285,14781,5504,10845,0,5139,5150,3716,1434,2.591352859,2554,339,168,87,0,87,0,43,0,0.011494253,empty,mBC-0716-1
"C6,H12",7258,7500,5455,2045,4023,0,1865,1865,1317,548,2.403284672,886,675,404,224,1,223,1,81,0,0.062780269,empty,mBC-0716-1
"C7,A1",13886,14457,10381,4076,7844,0,3781,3792,2701,1091,2.475710357,1837,1273,622,330,0,330,0,104,0,0.012121212,empty,mBC-0716-1
"C7,A2",618732,657350,428443,228907,351975,3,201402,201717,136419,65298,2.089175779,111783,35229,15656,7786,7,7779,4,1198,0,0.016454557,mm10,mBC-0716-1
"C7,A3",15616,16299,11939,4360,8702,0,4055,4066,2879,1187,2.425442291,1944,586,363,174,0,174,0,57,0,0.034482759,empty,mBC-0716-1
"C7,A4",21419,21376,15979,5397,10870,0,4984,5002,3487,1515,2.301650165,2340,41802,11934,5960,5,5955,2,800,0,0.052392947,empty,mBC-0716-1
"C7,A5",558195,588013,409579,178434,319152,0,162702,162995,111030,51965,2.136630424,86231,17020,11122,5332,2,5330,1,901,0,0.005065666,mm10,mBC-0716-1
"C7,A6",12351,12674,9359,3315,6814,0,3179,3182,2167,1015,2.134975369,1556,1127,736,360,0,360,0,117,0,0.025,empty,mBC-0716-1
"C7,A7",15237,15753,11567,4186,8300,0,3757,3759,2560,1199,2.135112594,1824,968,592,312,1,311,1,94,0,0.090032154,empty,mBC-0716-1
"C7,A8",10256,10475,7771,2704,5743,0,2551,2557,1820,737,2.469470828,1262,1206,687,394,0,394,0,130,0,0.109137056,empty,mBC-0716-1
"C7,A9",17380,17667,13477,4190,9281,0,3966,3975,2826,1149,2.459530026,1812,954,516,286,0,286,0,96,0,0.038461538,empty,mBC-0716-1
"C7,A10",15609,16114,11825,4289,8654,0,3987,3994,2763,1231,2.244516653,1996,270,170,94,0,94,0,44,0,0.010638298,empty,mBC-0716-1
"C7,A11",17315,17407,13197,4210,9342,0,4140,4149,2899,1250,2.3192,1890,3065,1148,622,2,620,1,164,0,0.04516129,empty,mBC-0716-1
"C7,A12",19794,19966,15145,4821,10299,0,4490,4503,3150,1353,2.328159645,2062,5923,2713,1334,1,1333,1,236,0,0.12528132,empty,mBC-0716-1
"C7,B1",978655,1097006,677354,419652,573507,0,346342,346814,257561,89253,2.885740535,194877,47098,33862,15804,4,15800,1,1854,0,0.000632911,mm10,mBC-0716-1
"C7,B2",18528,18757,14323,4434,9906,0,4292,4308,3055,1253,2.438148444,1917,450,285,153,0,153,0,48,0,0.039215686,empty,mBC-0716-1
"C7,B3",18411,18897,13913,4984,10070,0,4590,4613,3227,1386,2.328282828,2280,3719,1325,683,0,683,0,176,0,0.023426061,empty,mBC-0716-1
"C7,B4",732376,816549,513791,302758,434242,0,251482,251848,203844,48004,4.246396134,140397,68463,42204,19821,10,19811,2,2072,0,0.003836253,mm10,mBC-0716-1
"C7,B5",9672,6472,4570,1902,4235,0,2017,2030,1452,578,2.512110727,1061,737,440,237,0,237,0,66,0,0,empty,mBC-0716-1
"C7,B6",11805,12249,8888,3361,6529,1,3112,3125,2137,988,2.162955466,1522,7096,2612,1299,3,1296,2,246,0,0.034722222,empty,mBC-0716-1
"C7,B7",17148,17246,12613,4633,8677,0,3950,3955,2735,1220,2.241803279,1833,35395,9827,4984,5,4979,2,569,0,0.210283189,empty,mBC-0716-1
"C7,B8",12441,12806,9542,3264,6890,0,3086,3097,2156,941,2.291179596,1475,770,538,274,0,274,0,92,0,0.072992701,empty,mBC-0716-1
"C7,B9",768942,812299,551714,260585,427190,1,233268,233620,180765,52855,3.420017028,121853,9106,5995,2901,1,2900,1,525,0,0.000344828,mm10,mBC-0716-1
"C7,B10",86944,90723,58101,32622,49594,0,27854,27989,21137,6852,3.084792761,15413,3498,1768,844,0,844,0,175,0,0.021327014,empty,mBC-0716-1
"C7,B11",18237,18710,13389,5321,9948,0,4881,4893,3542,1351,2.621761658,2461,156,98,54,0,54,0,32,0,0,empty,mBC-0716-1
"C7,B12",868765,905569,648369,257200,486246,1,237790,238192,171535,66657,2.573398143,122224,53092,19283,9073,11,9062,3,1210,0,0.027367027,mm10,mBC-0716-1
"C7,C1",1143360,1266448,802572,463876,652517,0,387839,388421,273687,114734,2.385404501,213525,24197,14382,6969,2,6967,1,957,0,0.002870676,mm10,mBC-0716-1
"C7,C2",18612,18812,13981,4831,10174,0,4773,4786,3385,1401,2.416131335,2278,4755,1696,857,0,857,0,232,0,0.086347725,empty,mBC-0716-1
"C7,C3",18866,19596,14415,5181,10270,0,4675,4688,3266,1422,2.29676512,2310,503,268,147,0,147,0,50,0,0.102040816,empty,mBC-0716-1
"C7,C4",844910,888340,616609,271731,467937,2,238978,239379,197696,41683,4.742844805,122909,117871,82103,38030,13,38017,2,2931,0,0.003919299,mm10,mBC-0716-1
"C7,C5",17619,18401,13107,5294,9719,0,4683,4690,3328,1362,2.443465492,2300,802,483,241,0,241,0,79,0,0.024896266,empty,mBC-0716-1
"C7,C6",16303,16812,12278,4534,9248,0,4308,4316,3024,1292,2.340557276,2139,941,596,295,0,295,0,99,0,0.06440678,empty,mBC-0716-1
"C7,C7",16209,16731,12084,4647,8666,0,4062,4073,2859,1214,2.355024712,2003,3762,1350,706,2,704,2,122,0,0.190340909,empty,mBC-0716-1
"C7,C8",14413,14465,10892,3573,7867,0,3562,3569,2487,1082,2.298521257,1734,1267,706,352,0,352,0,109,0,0.102272727,empty,mBC-0716-1
"C7,C9",12429,12966,9311,3655,6882,0,3235,3242,2344,898,2.610244989,1571,652,440,228,0,228,0,73,0,0,empty,mBC-0716-1
"C7,C10",13157,13308,9930,3378,7161,0,3242,3251,2282,969,2.35500516,1553,853,520,275,0,275,0,87,0,0.087272727,empty,mBC-0716-1
"C7,C11",10676,11138,8078,3060,6049,0,2784,2792,1907,885,2.15480226,1378,3833,1326,677,0,677,0,150,0,0.032496307,empty,mBC-0716-1
"C7,C12",717161,760132,534415,225717,398791,1,199040,199403,150599,48804,3.085792148,102069,31871,21716,10189,4,10185,2,1327,0,0.001276387,mm10,mBC-0716-1
"C7,D1",11199,12133,8321,3812,6510,0,3166,3178,2216,962,2.303534304,1676,558,392,191,0,191,0,53,0,0.167539267,empty,mBC-0716-1
"C7,D2",19690,20169,15237,4932,10596,0,4622,4647,3187,1460,2.182876712,2188,2059,1264,660,0,660,0,182,0,0.048484848,empty,mBC-0716-1
"C7,D3",764002,858657,519603,339054,457575,0,284550,285006,213409,71597,2.980697515,162328,17769,12698,6165,5,6160,1,896,0,0.001785714,mm10,mBC-0716-1
"C7,D4",16665,17019,12645,4374,9195,0,4267,4274,3074,1200,2.561666667,1979,5954,1895,998,3,995,3,218,0,0.018090452,empty,mBC-0716-1
"C7,D5",13726,13936,10559,3377,7434,0,3329,3339,2365,974,2.428131417,1567,922,552,284,1,283,1,98,0,0.088339223,empty,mBC-0716-1
"C7,D6",618616,711505,406886,304619,381815,1,251220,251531,196981,54550,3.611017415,148592,7139,5072,2420,1,2419,1,505,0,0.002893758,mm10,mBC-0716-1
"C7,D7",12799,13464,9756,3708,7095,0,3326,3334,2382,952,2.50210084,1678,1043,675,347,0,347,0,118,0,0.011527378,empty,mBC-0716-1
"C7,D8",16115,16735,12138,4597,8843,0,4157,4161,2915,1246,2.339486356,2034,1832,782,376,0,376,0,116,0,0.039893617,empty,mBC-0716-1
"C7,D9",241956,261322,162471,98851,144381,0,86931,87039,69397,17642,3.933624306,48783,24034,13904,6614,4,6610,1,1033,0,0.058547655,mm10,mBC-0716-1
"C7,D10",13721,14279,10247,4032,7687,0,3728,3743,2601,1142,2.277583187,1870,904,512,275,0,275,0,95,0,0.029090909,empty,mBC-0716-1
"C7,D11",12775,13167,9541,3626,7009,0,3238,3252,2257,995,2.268341709,1596,1505,944,498,0,498,0,128,0,0.062248996,empty,mBC-0716-1
"C7,D12",19395,20004,14897,5107,10407,0,4630,4632,3243,1389,2.334773218,2194,5728,2290,1166,0,1166,0,274,0,0.073756432,empty,mBC-0716-1
"C7,E1",21717,22223,16731,5492,11808,0,5235,5239,3735,1504,2.48337766,2449,1404,931,487,0,487,0,159,0,0.082135524,empty,mBC-0716-1
"C7,E2",16006,16108,12182,3926,8601,0,3821,3826,2746,1080,2.542592593,1806,1943,1019,541,0,541,0,134,0,0.134935305,empty,mBC-0716-1
"C7,E3",11685,12188,8972,3216,6554,0,2938,2943,2053,890,2.306741573,1425,1336,825,403,0,403,0,123,0,0.079404467,empty,mBC-0716-1
"C7,E4",15151,15415,11648,3767,8129,0,3647,3654,2552,1102,2.315789474,1727,2936,1256,661,0,661,0,140,0,0.071104387,empty,mBC-0716-1
"C7,E5",19779,20027,15282,4745,10524,0,4605,4614,3242,1372,2.362973761,2100,802,476,277,1,276,1,106,0,0.02173913,empty,mBC-0716-1
"C7,E6",13524,13627,10204,3423,7259,0,3236,3240,2190,1050,2.085714286,1614,1200,745,368,0,368,0,101,0,0.043478261,empty,mBC-0716-1
"C7,E7",13548,13980,10457,3523,7395,0,3298,3310,2317,993,2.333333333,1576,1183,781,417,0,417,0,113,0,0.095923261,empty,mBC-0716-1
"C7,E8",16704,16504,12830,3674,8808,0,3819,3825,2655,1170,2.269230769,1728,1374,946,496,0,496,0,140,0,0.114919355,empty,mBC-0716-1
"C7,E9",8870,9213,6736,2477,4898,0,2260,2267,1606,661,2.429652042,1107,881,524,279,0,279,0,78,0,0.028673835,empty,mBC-0716-1
"C7,E10",12843,13246,9824,3422,7062,0,3157,3164,2105,1059,1.987724268,1486,1118,694,358,0,358,0,103,0,0.078212291,empty,mBC-0716-1
"C7,E11",8698,9011,6661,2350,4804,0,2164,2169,1516,653,2.321592649,1044,2616,1116,561,0,561,0,139,0,0.017825312,empty,mBC-0716-1
"C7,E12",14612,14993,11003,3990,8105,0,3713,3725,2639,1086,2.430018416,1817,812,484,252,0,252,0,83,0,0.051587302,empty,mBC-0716-1
"C7,F1",657700,711877,478433,233444,377325,0,199652,200012,158872,41140,3.861740399,107358,76459,49933,23544,7,23537,2,2343,0,0.009049582,mm10,mBC-0716-1
"C7,F2",22193,22903,16762,6141,12029,0,5534,5552,3918,1634,2.397796818,2671,6408,2862,1442,0,1442,0,267,0,0.22815534,empty,mBC-0716-1
"C7,F3",15672,16332,11684,4648,8865,0,4172,4182,2985,1197,2.493734336,2131,3035,1407,692,0,692,0,193,0,0.033236994,empty,mBC-0716-1
"C7,F4",605189,648387,408858,239529,351105,0,206583,206882,173925,32957,5.277331068,113721,33110,21621,10239,3,10236,2,1328,0,0.000488472,mm10,mBC-0716-1
"C7,F5",22600,22929,17164,5765,12128,0,5377,5384,3795,1589,2.388294525,2518,4465,1782,890,0,890,0,196,0,0.050561798,empty,mBC-0716-1
"C7,F6",22860,23350,17105,6245,12314,0,5709,5724,4119,1605,2.56635514,2735,5785,2272,1118,0,1118,0,242,0,0.030411449,empty,mBC-0716-1
"C7,F7",737485,818494,528768,289726,442998,0,247163,247499,172815,74684,2.31394944,138476,32238,22511,10771,5,10766,1,1305,0,0.002693665,mm10,mBC-0716-1
"C7,F8",22534,23294,17051,6243,12322,0,5714,5731,3972,1759,2.258101194,2743,651,231,137,0,137,0,56,0,0.131386861,empty,mBC-0716-1
"C7,F9",15813,16290,12128,4162,8601,0,3825,3831,2815,1016,2.770669291,1778,1498,921,440,0,440,0,147,0,0.034090909,empty,mBC-0716-1
"C7,F10",19307,19664,14991,4673,10232,0,4444,4453,3152,1301,2.422751729,2021,6721,2207,1140,1,1139,1,262,0,0.024582968,empty,mBC-0716-1
"C7,F11",10997,11297,8495,2802,5965,0,2705,2714,1915,799,2.396745932,1268,844,510,269,0,269,0,92,0,0.126394052,empty,mBC-0716-1
"C7,F12",13247,13748,10025,3723,7188,0,3293,3305,2358,947,2.489968321,1610,77,58,31,0,31,0,17,0,0,empty,mBC-0716-1
"C7,G1",9538,9682,7400,2282,5171,0,2240,2247,1515,732,2.069672131,1002,1605,1091,525,0,525,0,138,0,0.00952381,empty,mBC-0716-1
"C7,G2",19831,19739,15176,4563,10258,0,4503,4506,3146,1360,2.313235294,2027,404,277,138,0,138,0,40,0,0.043478261,empty,mBC-0716-1
"C7,G3",19364,19789,14600,5189,10169,0,4665,4679,3275,1404,2.332621083,2183,6249,2535,1318,1,1317,1,263,0,0.207289294,empty,mBC-0716-1
"C7,G4",26742,27076,20617,6459,14275,0,6255,6273,4487,1786,2.512318029,2947,64,46,33,0,33,0,21,0,0.03030303,empty,mBC-0716-1
"C7,G5",12736,12906,9874,3032,6789,0,2996,2999,2070,929,2.228202368,1399,772,463,243,0,243,0,90,0,0.127572016,empty,mBC-0716-1
"C7,G6",1278530,1344215,942531,401684,705962,0,363950,364573,274818,89755,3.06186842,187022,4444,2888,1336,2,1334,1,296,0,0,mm10,mBC-0716-1
"C7,G7",1980918,2114855,1440257,674598,1076723,4,582646,583515,489315,94200,5.194426752,304605,284440,189356,89727,37,89690,6,4792,0,0.001014606,mm10,mBC-0716-1
"C7,G8",14392,14606,10914,3692,7687,0,3620,3634,2499,1135,2.201762115,1709,13619,3974,2080,2,2078,1,390,0,0.035611165,empty,mBC-0716-1
"C7,G9",619753,655419,437944,217475,352990,0,198344,198636,159752,38884,4.108425059,105284,8576,5991,2840,2,2838,1,592,0,0.015151515,mm10,mBC-0716-1
"C7,G10",12770,13147,9890,3257,7053,0,3184,3188,2226,962,2.313929314,1424,2239,1038,548,0,548,0,149,0,0.012773723,empty,mBC-0716-1
"C7,G11",12028,12396,9253,3143,6570,0,2951,2962,2101,861,2.44018583,1449,601,414,198,0,198,0,76,0,0,empty,mBC-0716-1
"C7,G12",11200,11722,8578,3144,6198,0,2901,2905,2053,852,2.409624413,1409,9452,3005,1567,2,1565,1,271,0,0.034504792,empty,mBC-0716-1
"C7,H1",20572,21040,15562,5478,11299,0,5196,5214,3643,1571,2.318905156,2518,994,559,305,0,305,0,96,0,0.131147541,empty,mBC-0716-1
"C7,H2",847649,888842,628183,260659,467478,0,239349,239735,187886,51849,3.623715019,121707,31630,21941,10372,6,10366,1,1333,0,0.004726992,mm10,mBC-0716-1
"C7,H3",19587,20261,14971,5290,10589,0,4857,4865,3486,1379,2.527918782,2258,1692,979,482,0,482,0,118,0,0.053941909,empty,mBC-0716-1
"C7,H4",797005,917309,511861,405448,483448,2,321582,321936,251024,70912,3.539936823,190893,3335,2148,993,0,993,0,207,0,0,empty,mBC-0716-1
"C7,H5",17341,18318,13131,5187,9591,1,4551,4563,3224,1339,2.40776699,2258,2747,1329,655,1,654,1,155,0,0.090214067,empty,mBC-0716-1
"C7,H6",14422,15037,10913,4124,8066,0,3805,3815,2709,1106,2.449367089,1929,1210,795,404,0,404,0,148,0,0.037128713,empty,mBC-0716-1
"C7,H7",1528128,1667476,1092681,574795,869545,3,481234,481949,375384,106565,3.522582461,261970,206413,146790,69680,16,69664,3,4214,0,0.000315802,mm10,mBC-0716-1
"C7,H8",13264,13722,9870,3852,7306,0,3438,3446,2443,1003,2.435692921,1718,1221,734,366,0,366,0,112,0,0.051912568,empty,mBC-0716-1
"C7,H9",15951,16627,12069,4558,8828,0,4101,4106,2941,1165,2.524463519,2026,872,510,256,0,256,0,86,0,0.05078125,empty,mBC-0716-1
"C7,H10",13893,14335,10513,3822,7646,0,3566,3572,2514,1058,2.376181474,1759,2316,1076,551,0,551,0,161,0,0.054446461,empty,mBC-0716-1
"C7,H11",16717,17314,12688,4626,9184,0,4241,4256,2955,1301,2.271329746,2045,151,95,55,0,55,0,30,0,0,empty,mBC-0716-1
"C7,H12",5955,6363,4521,1842,3429,0,1629,1638,1183,455,2.6,836,667,391,187,0,187,0,56,0,0.07486631,empty,mBC-0716-1
"C8,A1",686486,755144,474742,280402,408534,0,242021,242336,185432,56904,3.258681288,134700,42405,28001,13263,3,13260,1,1531,0,0.004751131,mm10,mBC-0716-1
"C8,A2",20065,20306,15460,4846,10836,0,4741,4749,3396,1353,2.509977827,2192,1428,698,389,0,389,0,115,0,0.030848329,empty,mBC-0716-1
"C8,A3",869879,982544,592304,390240,519109,1,319756,320177,259279,60898,4.257594666,181545,44639,30853,14420,7,14413,3,1646,0,0.000208145,mm10,mBC-0716-1
"C8,A4",21402,21855,16434,5421,11268,0,4901,4911,3491,1420,2.458450704,2305,497,303,156,0,156,0,55,0,0.064102564,empty,mBC-0716-1
"C8,A5",17455,18375,13307,5068,9752,0,4533,4540,3171,1369,2.316289262,2256,1104,683,371,0,371,0,115,0,0.070080863,empty,mBC-0716-1
"C8,A6",19403,20272,14666,5606,11114,0,5231,5244,3819,1425,2.68,2592,1109,682,364,0,364,0,137,0,0.032967033,empty,mBC-0716-1
"C8,A7",16438,17104,12525,4579,9049,0,4161,4170,2856,1314,2.173515982,2025,1494,921,450,0,450,0,120,0,0.055555556,empty,mBC-0716-1
"C8,A8",524820,550084,375545,174539,297792,1,160547,160802,122716,38086,3.222076354,84226,72479,30589,15158,8,15150,3,1840,0,0.121122112,mm10,mBC-0716-1
"C8,A9",20121,20800,15485,5315,10938,0,4917,4931,3495,1436,2.433844011,2320,1033,724,382,1,381,1,108,0,0.128608924,empty,mBC-0716-1
"C8,A10",793004,850350,560099,290251,451679,0,252802,253182,206469,46713,4.419947338,135029,24054,16685,7716,6,7710,2,1022,0,0.002464332,mm10,mBC-0716-1
"C8,A11",19419,19942,14809,5133,10510,0,4773,4777,3395,1382,2.45658466,2288,932,628,330,0,330,0,101,0,0.154545455,empty,mBC-0716-1
"C8,A12",20454,20802,15869,4933,10866,0,4767,4778,3381,1397,2.420186113,2205,2219,1469,714,0,714,0,184,0,0.040616246,empty,mBC-0716-1
"C8,B1",18903,19442,14469,4973,10373,0,4758,4765,3339,1426,2.341514727,2298,1500,891,446,1,445,1,128,0,0.049438202,empty,mBC-0716-1
"C8,B2",751503,807479,553663,253816,428705,0,217645,217957,181007,36950,4.898700947,113869,37406,23669,11350,6,11344,2,1328,0,0.000352609,mm10,mBC-0716-1
"C8,B3",2432938,2610986,1775331,835655,1332359,1,731614,732833,594277,138556,4.289074454,384414,236775,168115,79940,36,79904,5,4589,0,0.001126352,mm10,mBC-0716-1
"C8,B4",16352,16953,12561,4392,9214,0,4175,4179,2915,1264,2.306170886,2014,977,624,322,0,322,0,114,0,0.037267081,empty,mBC-0716-1
"C8,B5",9689,6008,4199,1809,4105,0,2015,2028,1433,595,2.408403361,1060,569,358,174,0,174,0,66,0,0.040229885,empty,mBC-0716-1
"C8,B6",12414,13007,9366,3641,6931,0,3254,3266,2279,987,2.309017224,1618,1012,608,292,0,292,0,100,0,0.047945205,empty,mBC-0716-1
"C8,B7",16086,16519,12424,4095,8897,0,3996,4010,2778,1232,2.25487013,1913,1059,693,317,0,317,0,87,0,0.05362776,empty,mBC-0716-1
"C8,B8",555321,598513,407885,190628,320952,0,165051,165272,132041,33231,3.973428425,86433,55971,39316,18588,7,18581,1,1890,0,0.000430547,mm10,mBC-0716-1
"C8,B9",14682,14976,11402,3574,8019,0,3557,3566,2506,1060,2.364150943,1658,565,355,193,0,193,0,68,0,0.056994819,empty,mBC-0716-1
"C8,B10",17122,16468,12207,4261,9320,0,4270,4303,2930,1373,2.13401311,2086,1037,483,266,1,265,1,70,0,0.045283019,empty,mBC-0716-1
"C8,B11",20020,20867,15017,5850,11229,0,5403,5410,3924,1486,2.64064603,2658,173,121,76,0,76,0,41,0,0.078947368,empty,mBC-0716-1
"C8,B12",1151334,1283459,768628,514831,686242,4,438866,439367,291133,148234,1.964009606,251424,44078,31158,14251,4,14247,1,1700,0,0.002316277,mm10,mBC-0716-1
"C8,C1",960133,1003348,732078,271270,521690,3,242318,242795,199168,43627,4.565246292,119397,38627,27556,13068,3,13065,1,1493,0,0.000612323,mm10,mBC-0716-1
"C8,C2",20768,21697,15575,6122,11584,0,5547,5559,4038,1521,2.654832347,2799,1726,1082,497,0,497,0,157,0,0.030181087,empty,mBC-0716-1
"C8,C3",20243,20230,15321,4909,10923,0,5012,5027,3564,1463,2.436090226,2307,681,387,219,0,219,0,65,0,0.082191781,empty,mBC-0716-1
"C8,C4",18602,19132,14128,5004,10446,0,4730,4743,3363,1380,2.436956522,2352,1154,675,350,1,349,1,114,0,0.045845272,empty,mBC-0716-1
"C8,C5",16781,17430,12809,4621,9414,0,4387,4394,3098,1296,2.390432099,2154,816,478,278,0,278,0,88,0,0.021582734,empty,mBC-0716-1
"C8,C6",17525,17840,13154,4686,9808,0,4564,4571,3363,1208,2.783940397,2211,1269,852,423,0,423,0,127,0,0.011820331,empty,mBC-0716-1
"C8,C7",17301,17991,12903,5088,9781,0,4646,4659,3330,1329,2.505643341,2379,430,282,139,0,139,0,54,0,0.100719424,empty,mBC-0716-1
"C8,C8",15411,16064,11638,4426,8576,0,3932,3940,2722,1218,2.234811166,1935,1258,742,359,0,359,0,139,0,0.033426184,empty,mBC-0716-1
"C8,C9",12845,13458,9666,3792,7154,1,3434,3440,2422,1018,2.379174853,1719,703,422,199,0,199,0,56,0,0.005025126,empty,mBC-0716-1
"C8,C10",14085,14562,11070,3492,7685,0,3417,3422,2392,1030,2.322330097,1577,889,600,292,0,292,0,92,0,0.099315068,empty,mBC-0716-1
"C8,C11",11637,12155,8794,3361,6461,0,2965,2968,2037,931,2.187969925,1421,907,592,285,0,285,0,93,0,0.059649123,empty,mBC-0716-1
"C8,C12",20828,21284,15783,5501,11368,1,5190,5204,3645,1559,2.338037203,2473,1132,745,401,0,401,0,105,0,0.037406484,empty,mBC-0716-1
"C8,D1",12981,13692,9619,4073,7355,0,3623,3628,2539,1089,2.331496786,1827,513,294,143,0,143,0,46,0,0.076923077,empty,mBC-0716-1
"C8,D2",20369,20829,15972,4857,11079,0,4846,4853,3381,1472,2.296875,2239,1985,1297,657,0,657,0,181,0,0.071537291,empty,mBC-0716-1
"C8,D3",14391,15000,10888,4112,8119,0,3903,3913,2728,1185,2.302109705,1919,1048,633,319,0,319,0,103,0,0.015673981,empty,mBC-0716-1
"C8,D4",14361,14683,10816,3867,7868,0,3665,3675,2558,1117,2.290062668,1722,5702,1990,992,0,992,0,224,0,0.030241935,empty,mBC-0716-1
"C8,D5",14432,15142,10976,4166,8217,0,3826,3833,2724,1109,2.456266907,1884,1210,809,398,1,397,1,117,0,0.088161209,empty,mBC-0716-1
"C8,D6",13297,13889,10014,3875,7506,0,3606,3615,2523,1092,2.31043956,1811,6699,2161,1133,0,1133,0,255,0,0.042365402,empty,mBC-0716-1
"C8,D7",14078,14730,10700,4030,7841,0,3678,3686,2637,1049,2.513822688,1773,1197,781,410,0,410,0,152,0,0.1,empty,mBC-0716-1
"C8,D8",16107,16812,12026,4786,9099,0,4295,4301,2974,1327,2.241145441,2144,720,469,238,1,237,1,85,0,0.092827004,empty,mBC-0716-1
"C8,D9",6688,7060,4843,2217,3893,0,2029,2032,1534,498,3.080321285,1048,1089,604,353,0,353,0,126,0,0.042492918,empty,mBC-0716-1
"C8,D10",14144,14921,10670,4251,7946,0,3756,3761,2627,1134,2.316578483,1869,638,415,216,0,216,0,90,0,0.00462963,empty,mBC-0716-1
"C8,D11",13535,14082,10388,3694,7585,0,3498,3516,2464,1052,2.342205323,1683,1306,863,394,2,392,1,128,0,0.06377551,empty,mBC-0716-1
"C8,D12",1566482,1715900,1118185,597715,893096,4,503915,504562,427933,76629,5.584478461,274229,134769,94837,43913,12,43901,1,3237,0,0.001343933,mm10,mBC-0716-1
"C8,E1",22978,23073,17532,5541,12540,0,5655,5666,3994,1672,2.388755981,2653,1538,990,450,0,450,0,151,0,0.013333333,empty,mBC-0716-1
"C8,E2",651602,705446,463121,242325,378702,1,210443,210728,170679,40049,4.261754351,113624,66779,37784,17946,8,17938,2,1823,0,0.004348311,mm10,mBC-0716-1
"C8,E3",12359,12604,9404,3200,6764,0,3043,3056,2122,934,2.271948608,1430,1793,1058,496,0,496,0,148,0,0.064516129,empty,mBC-0716-1
"C8,E4",15989,16661,12257,4404,8789,0,3965,3969,2790,1179,2.366412214,1893,3136,1304,684,0,684,0,169,0,0.054093567,empty,mBC-0716-1
"C8,E5",27022,27043,20643,6400,14397,0,6429,6452,4645,1807,2.570558937,2990,7360,2856,1393,0,1393,0,296,0,0.145728643,empty,mBC-0716-1
"C8,E6",14442,14555,10937,3618,7801,0,3559,3575,2551,1024,2.491210938,1672,3427,1453,756,1,755,1,179,0,0.174834437,empty,mBC-0716-1
"C8,E7",393833,399328,301370,97958,217591,1,96254,96431,73677,22754,3.237980135,46154,20679,12279,6013,0,6013,0,943,0,0.009645768,mm10,mBC-0716-1
"C8,E8",17607,17833,13509,4324,9627,0,4229,4245,3040,1205,2.522821577,2025,1652,1000,508,0,508,0,160,0,0.043307087,empty,mBC-0716-1
"C8,E9",10552,10889,7884,3005,5949,0,2834,2840,2061,779,2.645699615,1401,1139,735,372,0,372,0,116,0,0.002688172,empty,mBC-0716-1
"C8,E10",13208,13503,10046,3457,7166,0,3336,3339,2337,1002,2.332335329,1576,1165,711,357,0,357,0,109,0,0.039215686,empty,mBC-0716-1
"C8,E11",750354,795351,545583,249768,424203,1,219185,219522,185775,33747,5.504933772,114226,127308,89237,42145,17,42128,1,2999,0,0.001329282,mm10,mBC-0716-1
"C8,E12",16098,16865,11825,5040,9143,0,4366,4377,3012,1365,2.206593407,2254,19131,5901,2968,4,2964,2,524,0,0.024291498,empty,mBC-0716-1
"C8,F1",17725,18098,13394,4704,9409,0,4137,4147,2898,1249,2.320256205,1933,1122,623,310,0,310,0,110,0,0.074193548,empty,mBC-0716-1
"C8,F2",22970,23592,17493,6099,12793,1,5925,5938,4232,1706,2.480656506,2861,2160,1429,727,0,727,0,230,0,0.053645117,empty,mBC-0716-1
"C8,F3",716183,804699,493911,310788,431000,0,257574,257913,192439,65474,2.939166692,146212,82902,58399,27756,19,27737,2,2398,0,0.001009482,mm10,mBC-0716-1
"C8,F4",19209,19707,14544,5163,10894,0,4988,4997,3570,1427,2.501751927,2448,623,400,196,0,196,0,75,0,0.056122449,empty,mBC-0716-1
"C8,F5",24814,25537,18935,6602,13421,0,6029,6043,4226,1817,2.325811778,2819,1374,876,425,0,425,0,151,0,0.042352941,empty,mBC-0716-1
"C8,F6",25067,26490,18955,7535,14142,0,6613,6621,4643,1978,2.347320526,3352,2045,1259,681,0,681,0,195,0,0.058737151,empty,mBC-0716-1
"C8,F7",19841,20507,15152,5355,11162,1,5085,5106,3586,1520,2.359210526,2418,866,532,285,0,285,0,113,0,0.115789474,empty,mBC-0716-1
"C8,F8",23018,23699,17608,6091,12969,0,6118,6127,4267,1860,2.294086022,2967,341,198,101,0,101,0,49,0,0,empty,mBC-0716-1
"C8,F9",16805,17154,12717,4437,9362,0,4322,4333,3073,1260,2.438888889,2088,7990,2824,1436,1,1435,1,325,0,0.03902439,empty,mBC-0716-1
"C8,F10",20156,20347,15608,4739,10947,0,4705,4720,3357,1363,2.462949376,2166,1498,933,423,0,423,0,138,0,0.035460993,empty,mBC-0716-1
"C8,F11",11626,11710,8917,2793,6481,0,2831,2834,2030,804,2.524875622,1326,1129,709,348,0,348,0,110,0,0.048850575,empty,mBC-0716-1
"C8,F12",13810,14016,10465,3551,7463,0,3323,3338,2331,1007,2.314796425,1593,92,32,14,0,14,0,8,0,0,empty,mBC-0716-1
"C8,G1",679935,752161,478700,273461,400799,1,231566,231885,175764,56121,3.131875768,127830,94197,66857,31618,12,31606,1,2581,0,0.000474593,mm10,mBC-0716-1
"C8,G2",20264,20550,15406,5144,10879,0,4847,4852,3433,1419,2.419309373,2272,2151,896,426,1,425,1,96,0,0.063529412,empty,mBC-0716-1
"C8,G3",669907,747067,469408,277659,399725,0,230391,230686,163157,67529,2.416102711,129564,73150,52947,24893,9,24884,2,2265,0,0.001969137,mm10,mBC-0716-1
"C8,G4",28165,28282,21663,6619,15118,0,6529,6543,4658,1885,2.471087533,2996,98,73,39,0,39,0,30,0,0,empty,mBC-0716-1
"C8,G5",672755,763731,469087,294644,407717,0,241880,242221,187374,54847,3.416303535,137550,49825,30096,14294,3,14291,1,1633,0,0.005248058,mm10,mBC-0716-1
"C8,G6",892984,984730,632312,352418,519226,1,296641,297087,240713,56374,4.2699294,161594,4851,3532,1601,0,1601,0,321,0,0,mm10,mBC-0716-1
"C8,G7",20899,21539,15965,5574,11208,1,5027,5046,3548,1498,2.368491322,2412,10036,3501,1784,5,1779,2,362,0,0.084879146,empty,mBC-0716-1
"C8,G8",821984,897513,590738,306775,471886,1,256742,257087,214117,42970,4.982941587,138284,104947,75047,35299,12,35287,3,2741,0,0.000821832,mm10,mBC-0716-1
"C8,G9",11066,11505,8301,3204,6177,0,2933,2938,2062,876,2.353881279,1495,1194,795,415,0,415,0,133,0,0.089156627,empty,mBC-0716-1
"C8,G10",13792,14267,10523,3744,7596,0,3497,3507,2425,1082,2.241219963,1665,819,480,270,1,269,1,98,0,0.148698885,empty,mBC-0716-1
"C8,G11",748294,829903,525533,304370,443356,1,259487,259863,215524,44339,4.860822301,142953,51964,36817,17236,4,17232,2,1814,0,0.001044568,mm10,mBC-0716-1
"C8,G12",12238,12771,9392,3379,6991,0,3261,3271,2274,997,2.280842528,1600,1128,756,379,0,379,0,117,0,0.044854881,empty,mBC-0716-1
"C8,H1",22488,23222,16961,6261,12350,0,5762,5773,4135,1638,2.524420024,2852,1005,602,303,0,303,0,115,0,0.04620462,empty,mBC-0716-1
"C8,H2",23739,24462,17972,6490,13046,0,5885,5908,4207,1701,2.473251029,2895,1540,1054,480,0,480,0,155,0,0.039583333,empty,mBC-0716-1
"C8,H3",20817,21611,15818,5793,11661,0,5464,5473,3862,1611,2.397268777,2659,1249,771,404,0,404,0,143,0,0.027227723,empty,mBC-0716-1
"C8,H4",682690,753026,483611,269415,399303,1,218523,218861,186911,31950,5.850109546,120570,10477,7028,3347,1,3346,1,549,0,0.000298864,mm10,mBC-0716-1
"C8,H5",688071,755268,500265,255003,401351,2,217063,217399,182604,34795,5.247995402,116534,89851,60026,28375,11,28364,2,2341,0,0.005711465,mm10,mBC-0716-1
"C8,H6",504568,526412,380490,145922,284502,0,134009,134216,101714,32502,3.129468956,66834,60030,38651,18470,8,18462,3,1949,0,0.005254035,mm10,mBC-0716-1
"C8,H7",742623,814146,519039,295107,434888,0,245138,245482,199248,46234,4.309555738,135837,62046,44934,21296,6,21290,2,2202,0,0.000187882,mm10,mBC-0716-1
"C8,H8",2165919,2397598,1524339,873259,1248408,3,739831,740874,566159,174715,3.240471625,412242,272789,188809,89916,35,89881,4,4802,0,0.000756556,mm10,mBC-0716-1
"C8,H9",17090,17253,12913,4340,9292,0,4190,4197,3037,1160,2.618103448,2020,1026,615,321,0,321,0,135,0,0.003115265,empty,mBC-0716-1
"C8,H10",715946,775389,495908,279481,413992,1,246089,246435,192963,53472,3.608673698,135567,9484,6126,3095,1,3094,1,573,0,0.010019392,mm10,mBC-0716-1
"C8,H11",1645970,1793310,1177207,616103,950338,3,542619,543386,434869,108517,4.007381332,295135,2840,1792,889,1,888,1,213,0,0.011261261,empty,mBC-0716-1
"C8,H12",6861,7285,5040,2245,3864,0,1855,1860,1349,511,2.639921722,968,2305,894,504,0,504,0,135,0,0.047619048,empty,mBC-0716-1
"C9,A1",13495,13671,10312,3359,7389,0,3354,3365,2331,1034,2.254352031,1579,1110,685,341,0,341,0,107,0,0.099706745,empty,mBC-0716-1
"C9,A2",1669680,1777894,1175831,602063,917803,2,515501,516378,440599,75779,5.814262527,275823,163331,107999,51779,18,51761,3,3577,0,0.003902552,mm10,mBC-0716-1
"C9,A3",837266,914652,589407,325245,480870,1,268729,269111,220500,48611,4.536010368,146546,98968,69999,32463,18,32445,3,2696,0,0.000862999,mm10,mBC-0716-1
"C9,A4",20623,20815,16006,4809,10783,0,4639,4651,3225,1426,2.261570827,2080,567,322,173,0,173,0,59,0,0.052023121,empty,mBC-0716-1
"C9,A5",16692,17223,12847,4376,9172,0,4087,4089,2817,1272,2.214622642,1964,1342,905,412,0,412,0,143,0,0.033980583,empty,mBC-0716-1
"C9,A6",12669,12891,9638,3253,6939,0,3159,3167,2195,972,2.258230453,1470,2246,1086,597,1,596,1,155,0,0.023489933,empty,mBC-0716-1
"C9,A7",15859,16699,12056,4643,8854,1,4067,4081,2795,1286,2.17340591,2083,1452,773,422,0,422,0,121,0,0.082938389,empty,mBC-0716-1
"C9,A8",566148,615945,402096,213849,332674,1,189302,189535,131719,57816,2.278244777,102641,37617,25240,11858,8,11850,1,1431,0,0.001350211,mm10,mBC-0716-1
"C9,A9",19691,20222,14975,5247,10435,0,4552,4563,3250,1313,2.475247525,2174,1208,783,393,1,392,1,110,0,0.12755102,empty,mBC-0716-1
"C9,A10",15401,15648,11743,3905,8365,1,3857,3867,2746,1121,2.449598573,1834,183,107,45,0,45,0,38,0,0,empty,mBC-0716-1
"C9,A11",17284,17557,13316,4241,9283,0,4137,4145,2904,1241,2.340048348,1902,1130,694,339,0,339,0,99,0,0.026548673,empty,mBC-0716-1
"C9,A12",20559,20798,15891,4907,10782,0,4745,4753,3433,1320,2.600757576,2152,2702,1683,782,0,782,0,159,0,0.10741688,empty,mBC-0716-1
"C9,B1",18726,19165,14299,4866,10041,0,4521,4532,3188,1344,2.37202381,2174,1075,677,326,0,326,0,111,0,0.021472393,empty,mBC-0716-1
"C9,B2",1123311,1184710,818150,366560,614807,1,321859,322456,257585,64871,3.970726519,166532,26601,18384,8611,2,8609,1,1119,0,0.00092926,mm10,mBC-0716-1
"C9,B3",18239,18270,13977,4293,9747,0,4284,4291,3070,1221,2.514332514,1964,2517,1190,608,0,608,0,159,0,0.092105263,empty,mBC-0716-1
"C9,B4",15929,16404,12159,4245,8690,0,3891,3902,2735,1167,2.34361611,1833,2218,1069,558,0,558,0,121,0,0.173835125,empty,mBC-0716-1
"C9,B5",14513,10978,6894,4084,6850,0,3780,3805,2519,1286,1.958786936,2184,6926,2185,1098,0,1098,0,186,0,0.112021858,empty,mBC-0716-1
"C9,B6",622501,672811,451315,221496,358959,1,190724,190981,152686,38295,3.987100144,101516,120653,73625,35340,10,35330,4,2848,0,0.012284178,mm10,mBC-0716-1
"C9,B7",15690,16012,11998,4014,8462,0,3838,3843,2673,1170,2.284615385,1746,1303,656,304,0,304,0,92,0,0.029605263,empty,mBC-0716-1
"C9,B8",12900,13140,9856,3284,6963,0,3107,3112,2164,948,2.282700422,1456,1041,600,353,0,353,0,125,0,0.042492918,empty,mBC-0716-1
"C9,B9",14888,15316,11247,4069,7974,0,3579,3589,2404,1185,2.028691983,1731,1002,575,268,0,268,0,71,0,0.257462687,empty,mBC-0716-1
"C9,B10",16438,15948,11892,4056,8827,0,4012,4024,2756,1268,2.173501577,1945,488,258,124,0,124,0,51,0,0,empty,mBC-0716-1
"C9,B11",16093,16169,12172,3997,8441,0,3707,3719,2601,1118,2.32647585,1751,735,336,184,0,184,0,55,0,0,empty,mBC-0716-1
"C9,B12",17719,18064,13605,4459,9666,0,4292,4301,3036,1265,2.4,2044,2067,986,512,0,512,0,132,0,0.044921875,empty,mBC-0716-1
"C9,C1",812611,834221,603032,231189,438364,0,214481,214865,173440,41425,4.186843693,106016,19798,10887,5241,0,5241,0,825,0,0.020225148,mm10,mBC-0716-1
"C9,C2",18072,18384,13576,4808,9717,0,4471,4481,3077,1404,2.191595442,2145,1706,1036,525,0,525,0,164,0,0.041904762,empty,mBC-0716-1
"C9,C3",21055,21880,15849,6031,11591,0,5485,5499,3900,1599,2.43902439,2709,2851,1033,514,0,514,0,96,0,0.048638132,empty,mBC-0716-1
"C9,C4",864930,953335,589731,363604,506333,3,301354,301719,243834,57885,4.212386629,169365,137391,80376,37771,27,37744,4,2988,0,0.009802883,mm10,mBC-0716-1
"C9,C5",16224,16423,12386,4037,8794,0,3945,3947,2690,1257,2.140015911,1862,928,577,304,1,303,1,94,0,0.089108911,empty,mBC-0716-1
"C9,C6",17422,17771,12959,4812,9710,1,4553,4565,3182,1383,2.300795372,2263,1057,624,342,0,342,0,116,0,0.149122807,empty,mBC-0716-1
"C9,C7",719697,768591,521122,247469,409814,0,217210,217602,173979,43623,3.988240149,114937,23289,14458,6826,4,6822,1,1027,0,0.006449721,mm10,mBC-0716-1
"C9,C8",14747,15236,11077,4159,8105,0,3738,3747,2572,1175,2.18893617,1826,5138,2113,1067,1,1066,1,245,0,0.152908068,empty,mBC-0716-1
"C9,C9",826862,928653,567825,360828,493473,1,299686,300042,203743,96299,2.115733289,171634,27220,16893,8159,6,8153,1,1090,0,0.004415553,mm10,mBC-0716-1
"C9,C10",13592,14026,10074,3952,7261,0,3433,3438,2361,1077,2.192200557,1703,26069,7835,3911,5,3906,2,585,0,0.06016385,empty,mBC-0716-1
"C9,C11",11593,12068,8759,3309,6484,0,3022,3026,2109,917,2.299890949,1501,676,410,220,0,220,0,86,0,0.004545455,empty,mBC-0716-1
"C9,C12",520738,542436,374737,167699,291473,1,153538,153801,117758,36043,3.267153123,80324,13960,7160,3376,2,3374,1,637,0,0.02519265,mm10,mBC-0716-1
"C9,D1",11203,11518,8422,3096,6082,0,2770,2778,2003,775,2.584516129,1298,621,388,174,0,174,0,48,0,0.149425287,empty,mBC-0716-1
"C9,D2",20272,20336,15627,4709,10837,0,4690,4695,3276,1419,2.308668076,2166,1802,1204,575,0,575,0,172,0,0.020869565,empty,mBC-0716-1
"C9,D3",558852,605568,401104,204464,326804,1,176190,176432,110061,66371,1.658269425,98606,11102,6089,2964,0,2964,0,555,0,0.033738192,mm10,mBC-0716-1
"C9,D4",15964,16810,12045,4765,8915,0,4260,4264,2978,1286,2.315707621,2123,1262,738,384,0,384,0,115,0,0.114583333,empty,mBC-0716-1
"C9,D5",13813,14225,10378,3847,7448,1,3373,3382,2366,1016,2.328740157,1670,6161,2264,1191,0,1191,0,253,0,0.19395466,empty,mBC-0716-1
"C9,D6",11718,12142,8760,3382,6450,0,3066,3081,2176,905,2.40441989,1546,1347,896,457,0,457,0,120,0,0.070021882,empty,mBC-0716-1
"C9,D7",12398,12823,9388,3435,6790,0,3222,3229,2292,937,2.446104589,1563,1108,697,366,1,365,1,126,0,0.043835616,empty,mBC-0716-1
"C9,D8",722893,765072,527856,237216,407083,0,211697,212004,175983,36021,4.885566753,110333,40621,27322,12551,3,12548,1,1413,0,0.003028371,mm10,mBC-0716-1
"C9,D9",4545,4799,3337,1462,2513,0,1155,1158,799,359,2.225626741,594,1080,613,324,0,324,0,102,0,0.067901235,empty,mBC-0716-1
"C9,D10",655398,731640,459655,271985,392067,1,227748,228056,176913,51143,3.459183075,127266,30800,21129,9863,3,9860,1,1235,0,0.003245436,mm10,mBC-0716-1
"C9,D11",586550,633894,425593,208301,340388,1,181241,181521,150018,31503,4.762022665,96405,152259,106049,49773,20,49753,5,3415,0,0.000763773,mm10,mBC-0716-1
"C9,D12",19771,20370,15031,5339,10821,0,5001,5013,3533,1480,2.387162162,2465,9441,3707,1900,4,1896,2,366,0,0.051160338,empty,mBC-0716-1
"C9,E1",20764,21136,15949,5187,11258,0,4999,5015,3430,1585,2.164037855,2335,1694,959,491,0,491,0,171,0,0.048879837,empty,mBC-0716-1
"C9,E2",15478,16010,11813,4197,8537,0,3850,3856,2706,1150,2.353043478,1889,1402,889,442,0,442,0,130,0,0.07918552,empty,mBC-0716-1
"C9,E3",12139,12224,9275,2949,6501,0,2863,2880,1941,939,2.067092652,1301,5507,2083,1126,1,1125,1,255,0,0.038222222,empty,mBC-0716-1
"C9,E4",15188,15553,11671,3882,8201,0,3669,3678,2542,1136,2.237676056,1728,1081,680,344,0,344,0,119,0,0.049418605,empty,mBC-0716-1
"C9,E5",19743,20101,15254,4847,10643,0,4603,4612,3249,1363,2.383712399,2158,1145,742,377,3,374,1,120,0,0.058823529,empty,mBC-0716-1
"C9,E6",12810,12819,9895,2924,6834,0,2904,2918,2047,871,2.350172216,1338,1237,734,339,1,338,1,107,0,0.097633136,empty,mBC-0716-1
"C9,E7",13470,13585,10323,3262,7202,0,3213,3223,2227,996,2.235943775,1534,1247,760,417,1,416,1,123,0,0.036057692,empty,mBC-0716-1
"C9,E8",16786,16951,12893,4058,9092,0,4015,4022,2800,1222,2.291325696,1833,1802,1238,618,0,618,0,166,0,0.056634304,empty,mBC-0716-1
"C9,E9",8667,8924,6581,2343,4747,0,2154,2160,1538,622,2.47266881,1042,949,545,297,1,296,1,101,0,0.027027027,empty,mBC-0716-1
"C9,E10",12328,12639,9567,3072,6788,0,2960,2972,2065,907,2.276736494,1435,1146,704,350,0,350,0,115,0,0.065714286,empty,mBC-0716-1
"C9,E11",8846,9032,6652,2380,4964,0,2314,2322,1566,756,2.071428571,1124,6072,2208,1092,2,1090,2,211,0,0.088990826,empty,mBC-0716-1
"C9,E12",14665,14912,11124,3788,8002,0,3629,3635,2494,1141,2.185801928,1767,3397,1541,845,0,845,0,195,0,0.140828402,empty,mBC-0716-1
"C9,F1",17405,17578,13151,4427,9263,0,4064,4072,2866,1206,2.376451078,1937,1296,814,422,0,422,0,110,0,0.09478673,empty,mBC-0716-1
"C9,F2",847220,981270,559021,422249,521089,2,340497,340960,272325,68635,3.967727836,200598,101862,69022,32707,11,32696,5,2550,0,0.002293859,mm10,mBC-0716-1
"C9,F3",15798,16104,11873,4231,8639,0,4049,4049,2807,1242,2.260064412,1977,2685,1146,595,1,594,1,176,0,0.035353535,empty,mBC-0716-1
"C9,F4",16463,16604,12333,4271,9077,0,4114,4124,2872,1252,2.293929712,1995,389,263,129,0,129,0,66,0,0.031007752,empty,mBC-0716-1
"C9,F5",22715,22959,17336,5623,12165,0,5392,5406,3694,1712,2.15771028,2509,1865,1136,560,0,560,0,158,0,0.032142857,empty,mBC-0716-1
"C9,F6",22780,23142,17255,5887,12250,0,5473,5487,3880,1607,2.414436839,2620,2010,1163,609,0,609,0,193,0,0.031198686,empty,mBC-0716-1
"C9,F7",888548,936959,652932,284027,503540,1,254880,255289,205876,49413,4.166433934,131203,77920,44206,21444,13,21431,3,2020,0,0.008539032,mm10,mBC-0716-1
"C9,F8",23728,24361,18023,6338,12930,0,5890,5895,4198,1697,2.473777254,2815,274,187,91,1,90,1,38,0,0,empty,mBC-0716-1
"C9,F9",14695,14874,11306,3568,7855,0,3492,3506,2446,1060,2.30754717,1676,1556,976,519,1,518,1,169,0,0.127413127,empty,mBC-0716-1
"C9,F10",20130,20410,15908,4502,10743,0,4544,4553,3143,1410,2.229078014,2049,1375,910,503,0,503,0,147,0,0.079522863,empty,mBC-0716-1
"C9,F11",10920,10940,8389,2551,5810,0,2469,2472,1656,816,2.029411765,1127,877,538,291,0,291,0,79,0,0.079037801,empty,mBC-0716-1
"C9,F12",712113,816904,474543,342361,434454,0,282018,282360,202140,80220,2.519820494,165860,759,507,248,0,248,0,46,0,0,empty,mBC-0716-1
"C9,G1",9550,9867,7444,2423,5303,0,2344,2349,1638,711,2.303797468,1082,1788,1199,597,0,597,0,142,0,0.041876047,empty,mBC-0716-1
"C9,G2",606907,625431,436178,189253,338548,1,178030,178291,147553,30738,4.80034485,91364,3368,2379,1152,0,1152,0,283,0,0.006944444,mm10,mBC-0716-1
"C9,G3",19001,19527,14462,5065,10316,0,4660,4670,3224,1446,2.229598893,2229,2284,1360,674,0,674,0,172,0,0.010385757,empty,mBC-0716-1
"C9,G4",26805,26933,20709,6224,14137,0,6086,6097,4333,1764,2.456349206,2788,37,29,18,0,18,0,13,0,0,empty,mBC-0716-1
"C9,G5",692649,770561,486355,284206,408130,3,232624,232962,194417,38545,5.043896744,129123,146561,97399,46375,12,46363,3,3221,0,0.005672627,mm10,mBC-0716-1
"C9,G6",1675792,1752483,1218615,533868,906874,1,476199,477047,384130,92917,4.134119698,245856,8224,5995,2965,1,2964,1,492,0,0.004723347,mm10,mBC-0716-1
"C9,G7",1286297,1460148,859162,600986,759805,2,487616,488266,337349,150917,2.235328028,283166,63997,44065,20978,6,20972,1,2089,0,0.00200267,mm10,mBC-0716-1
"C9,G8",14507,14599,10638,3961,7831,0,3699,3717,2581,1136,2.272007042,1828,6880,2626,1280,0,1280,0,248,0,0.1546875,empty,mBC-0716-1
"C9,G9",617808,694121,434214,259907,370519,1,214173,214490,170226,44264,3.845698536,119352,164718,116645,54825,16,54809,1,3286,0,0.001496105,mm10,mBC-0716-1
"C9,G10",13395,13689,10338,3351,7157,0,3165,3171,2206,965,2.286010363,1452,1146,741,414,0,414,0,115,0,0.132850242,empty,mBC-0716-1
"C9,G11",13409,13328,9764,3564,6727,0,3180,3189,2228,961,2.318418314,1476,19997,6282,3190,5,3185,2,512,0,0.073783359,empty,mBC-0716-1
"C9,G12",11616,11841,8785,3056,6337,0,2896,2903,2000,903,2.214839424,1361,1081,726,401,0,401,0,102,0,0.137157107,empty,mBC-0716-1
"C9,H1",20062,20365,15221,5144,11008,0,4987,4998,3557,1441,2.468424705,2393,1035,721,375,0,375,0,105,0,0.08,empty,mBC-0716-1
"C9,H2",23883,24316,18062,6254,12626,1,5662,5680,4034,1646,2.450789793,2717,9741,3715,1803,1,1802,1,300,0,0.156492786,empty,mBC-0716-1
"C9,H3",19669,20167,14973,5194,10672,0,4939,4950,3439,1511,2.275976175,2293,3596,1554,782,1,781,1,175,0,0.04993598,empty,mBC-0716-1
"C9,H4",13130,13192,9980,3212,7089,0,3171,3178,2170,1008,2.152777778,1458,123,88,48,0,48,0,23,0,0,empty,mBC-0716-1
"C9,H5",879495,1023724,574020,449704,538598,3,352686,353128,277748,75380,3.684637835,209770,106218,73251,34752,9,34743,3,2767,0,0.001266442,mm10,mBC-0716-1
"C9,H6",14111,14268,10753,3515,7843,0,3536,3542,2497,1045,2.389473684,1695,1398,885,483,1,482,1,159,0,0.039419087,empty,mBC-0716-1
"C9,H7",619993,661988,438700,223288,360418,1,201935,202226,157339,44887,3.50522423,108474,11493,7329,3503,3,3500,1,659,0,0.008285714,mm10,mBC-0716-1
"C9,H8",12937,13182,9966,3216,7023,0,3244,3247,2325,922,2.521691974,1516,1459,876,428,0,428,0,130,0,0.067757009,empty,mBC-0716-1
"C9,H9",15607,15904,11895,4009,8482,0,3793,3797,2715,1082,2.509242144,1821,1085,705,372,0,372,0,127,0,0.008064516,empty,mBC-0716-1
"C9,H10",13711,14307,10337,3970,7632,1,3608,3617,2495,1122,2.223707665,1760,1378,784,415,0,415,0,134,0,0.045783133,empty,mBC-0716-1
"C9,H11",778955,881431,535878,345553,466571,0,276860,277272,228552,48720,4.691133005,157928,5252,3476,1608,0,1608,0,306,0,0.003109453,mm10,mBC-0716-1
"C9,H12",5927,6220,4494,1726,3299,1,1533,1537,1095,442,2.477375566,744,944,622,322,1,321,1,89,0,0.040498442,empty,mBC-0716-1
"C10,A1",493032,493728,369173,124555,268613,0,123704,123938,100029,23909,4.183738341,59675,10702,6080,2869,1,2868,1,598,0,0.029986053,mm10,mBC-0716-1
"C10,A2",20782,21298,15913,5385,11281,0,4996,5014,3522,1492,2.360589812,2330,905,550,276,0,276,0,92,0,0.039855072,empty,mBC-0716-1
"C10,A3",17356,17858,13125,4733,9609,0,4443,4452,3145,1307,2.40627391,2183,748,530,277,0,277,0,106,0,0.018050542,empty,mBC-0716-1
"C10,A4",22043,22369,16936,5433,11616,0,5144,5160,3653,1507,2.424021234,2361,1636,715,366,0,366,0,91,0,0.114754098,empty,mBC-0716-1
"C10,A5",17726,18597,13382,5215,9881,0,4562,4581,3260,1321,2.467827403,2308,1409,835,409,0,409,0,123,0,0.04400978,empty,mBC-0716-1
"C10,A6",20799,22340,15841,6499,12173,0,5963,5968,4329,1639,2.641244661,2971,1694,1135,577,0,577,0,161,0,0.029462738,empty,mBC-0716-1
"C10,A7",16474,17280,12779,4501,9347,0,4231,4244,2998,1246,2.406099518,2051,1105,742,370,1,369,1,109,0,0.08401084,empty,mBC-0716-1
"C10,A8",2048157,2236040,1438652,797388,1174536,1,701325,702323,559626,142697,3.921778313,380646,276163,179225,85321,40,85281,4,4833,0,0.011163096,mm10,mBC-0716-1
"C10,A9",18885,18986,14611,4375,10120,0,4379,4390,3134,1256,2.49522293,1970,1041,617,324,0,324,0,108,0,0.049382716,empty,mBC-0716-1
"C10,A10",17003,18034,12864,5170,9494,0,4495,4501,3263,1238,2.635702746,2260,318,193,107,0,107,0,51,0,0,empty,mBC-0716-1
"C10,A11",20121,20317,15062,5255,10743,0,4834,4843,3463,1380,2.50942029,2304,16344,5184,2683,1,2682,1,456,0,0.156972409,empty,mBC-0716-1
"C10,A12",20674,20836,15984,4852,11063,1,4814,4829,3364,1465,2.296245734,2248,2545,1617,776,0,776,0,196,0,0.034793814,empty,mBC-0716-1
"C10,B1",18997,19569,14464,5105,10263,0,4693,4699,3250,1449,2.242926156,2222,1190,801,371,0,371,0,114,0,0.016172507,empty,mBC-0716-1
"C10,B2",19951,20464,15268,5196,10801,0,4889,4894,3468,1426,2.43197756,2320,437,259,126,0,126,0,53,0,0.111111111,empty,mBC-0716-1
"C10,B3",19607,20345,14856,5489,10836,1,5043,5053,3523,1530,2.302614379,2420,1086,690,371,0,371,0,108,0,0.053908356,empty,mBC-0716-1
"C10,B4",18802,19011,13774,5237,9899,0,4658,4665,3188,1477,2.158429248,2329,58728,17644,8967,8,8959,2,1047,0,0.144324143,empty,mBC-0716-1
"C10,B5",16143,12630,8727,3903,7865,0,3923,3938,2920,1018,2.868369352,2097,1005,641,316,0,316,0,73,0,0.113924051,empty,mBC-0716-1
"C10,B6",459813,502376,326520,175856,273588,1,154859,155100,117569,37531,3.132583731,85073,37223,19336,9603,6,9597,1,1362,0,0.042200688,mm10,mBC-0716-1
"C10,B7",16087,16405,12503,3902,8829,0,3803,3815,2697,1118,2.41234347,1723,1014,610,341,0,341,0,106,0,0.058651026,empty,mBC-0716-1
"C10,B8",13488,14272,10219,4053,7597,0,3534,3547,2491,1056,2.358901515,1769,738,501,286,0,286,0,114,0,0.104895105,empty,mBC-0716-1
"C10,B9",15201,15476,11649,3827,8351,0,3707,3715,2613,1102,2.371143376,1790,575,338,161,0,161,0,48,0,0,empty,mBC-0716-1
"C10,B10",566843,565131,370077,195054,314046,3,171227,171971,138013,33958,4.064226397,93831,13585,9283,4298,4,4294,1,686,0,0.011644155,mm10,mBC-0716-1
"C10,B11",17489,17886,13309,4577,9509,0,4396,4404,3093,1311,2.359267735,2126,255,195,99,0,99,0,42,0,0.171717172,empty,mBC-0716-1
"C10,B12",19235,19559,14323,5236,10404,0,4738,4746,3367,1379,2.441624365,2306,27059,8700,4396,6,4390,2,650,0,0.146241458,empty,mBC-0716-1
"C10,C1",22439,22671,17352,5319,11783,0,5062,5072,3558,1514,2.35006605,2281,662,370,213,0,213,0,82,0,0.070422535,empty,mBC-0716-1
"C10,C2",21409,22653,15993,6660,12169,0,5776,5788,4208,1580,2.663291139,3015,2118,1199,615,0,615,0,168,0,0.030894309,empty,mBC-0716-1
"C10,C3",20239,20794,15491,5303,11029,0,5002,5008,3486,1522,2.290407359,2397,675,383,181,0,181,0,53,0,0.005524862,empty,mBC-0716-1
"C10,C4",19366,19616,14724,4892,10382,0,4580,4590,3188,1402,2.273894437,2199,1151,768,386,0,386,0,124,0,0.002590674,empty,mBC-0716-1
"C10,C5",18788,19581,13993,5588,10421,0,5001,5008,3525,1483,2.376938638,2464,1176,662,296,0,296,0,92,0,0.060810811,empty,mBC-0716-1
"C10,C6",17934,18496,13588,4908,10305,0,4881,4886,3483,1403,2.48253742,2337,1140,601,334,0,334,0,116,0,0.02994012,empty,mBC-0716-1
"C10,C7",17238,18020,13006,5014,9574,0,4483,4489,3066,1423,2.154602952,2231,452,253,145,0,145,0,52,0,0.131034483,empty,mBC-0716-1
"C10,C8",15830,16477,12031,4446,8932,0,4134,4142,2871,1271,2.258851298,2064,1570,949,458,0,458,0,150,0,0.054585153,empty,mBC-0716-1
"C10,C9",425578,439285,323359,115926,238885,2,109340,109536,85221,24315,3.504873535,53564,57624,26357,12948,7,12941,3,1615,0,0.026195812,mm10,mBC-0716-1
"C10,C10",14018,14268,10818,3450,7726,0,3480,3495,2404,1091,2.203483043,1594,986,614,342,0,342,0,104,0,0.032163743,empty,mBC-0716-1
"C10,C11",11996,12383,8927,3456,6538,0,3078,3084,2189,895,2.445810056,1495,1113,675,335,0,335,0,106,0,0.056716418,empty,mBC-0716-1
"C10,C12",542343,573611,389103,184508,309805,1,166949,167213,129515,37698,3.4355934,88892,6479,4359,2083,0,2083,0,444,0,0.002400384,mm10,mBC-0716-1
"C10,D1",13925,14412,10377,4035,7814,0,3778,3784,2678,1106,2.421338156,1847,823,524,223,0,223,0,67,0,0.049327354,empty,mBC-0716-1
"C10,D2",20552,20853,15831,5022,11197,0,4824,4834,3371,1463,2.304169515,2225,2134,1453,684,0,684,0,184,0,0.042397661,empty,mBC-0716-1
"C10,D3",15013,15635,11331,4304,8463,0,4022,4028,2841,1187,2.393428812,1990,1080,674,382,0,382,0,111,0,0.018324607,empty,mBC-0716-1
"C10,D4",15103,15740,11404,4336,8435,0,3978,3988,2731,1257,2.172633254,1941,971,614,307,0,307,0,113,0,0.035830619,empty,mBC-0716-1
"C10,D5",15338,15811,11697,4114,8473,0,3920,3926,2833,1093,2.591948765,1849,1031,694,361,0,361,0,123,0,0.008310249,empty,mBC-0716-1
"C10,D6",808427,913867,547440,366427,487033,0,304630,305056,221268,83788,2.640807753,176845,23012,13597,6485,6,6479,3,960,0,0.032258065,mm10,mBC-0716-1
"C10,D7",14337,14908,10722,4186,7894,0,3723,3732,2686,1046,2.567877629,1800,1401,914,513,0,513,0,145,0,0.035087719,empty,mBC-0716-1
"C10,D8",17389,17819,12833,4986,9330,0,4462,4471,3186,1285,2.479377432,2187,13793,4693,2315,1,2314,1,368,0,0.169835782,empty,mBC-0716-1
"C10,D9",194466,204621,142966,61655,113088,0,54955,55049,40850,14199,2.876963166,28702,99940,71570,34052,19,34033,3,2661,0,0.001028414,mm10,mBC-0716-1
"C10,D10",15661,16732,11934,4798,8794,0,4268,4278,3019,1259,2.397934869,2114,659,376,225,0,225,0,74,0,0.044444444,empty,mBC-0716-1
"C10,D11",692960,749617,501375,248242,399855,0,216166,216481,164435,52046,3.15941667,114828,82262,55746,26761,8,26753,1,2383,0,0.001682054,mm10,mBC-0716-1
"C10,D12",20758,21511,16067,5444,11466,0,5222,5239,3642,1597,2.280525986,2513,2038,1251,615,0,615,0,183,0,0.055284553,empty,mBC-0716-1
"C10,E1",1756897,1918804,1239657,679147,996092,0,577114,577877,451333,126544,3.566609243,317305,104209,69208,32872,16,32856,4,2756,0,0.003317507,mm10,mBC-0716-1
"C10,E2",18043,18644,13819,4825,10053,0,4665,4670,3394,1276,2.659874608,2280,1519,945,439,0,439,0,132,0,0.091116173,empty,mBC-0716-1
"C10,E3",12567,12988,9575,3413,6834,0,3087,3096,2189,907,2.413450937,1408,1147,743,393,0,393,0,143,0,0.015267176,empty,mBC-0716-1
"C10,E4",16152,16859,12455,4404,8866,0,3986,3987,2787,1200,2.3225,1944,916,555,256,0,256,0,102,0,0.0234375,empty,mBC-0716-1
"C10,E5",1255631,1388019,857981,530038,719328,2,438485,439132,367237,71895,5.107963002,243343,70276,49440,23569,7,23562,2,2176,0,0.000127324,mm10,mBC-0716-1
"C10,E6",579907,632284,409033,223251,335169,1,187932,188186,146619,41567,3.527293286,102556,90553,64148,30581,10,30571,1,2624,0,0.002420595,mm10,mBC-0716-1
"C10,E7",916162,976455,674795,301660,508305,0,263187,263649,196186,67463,2.908053303,137138,156374,79842,38507,24,38483,4,3114,0,0.040641322,mm10,mBC-0716-1
"C10,E8",875384,913659,654817,258842,479095,1,233383,233729,196596,37133,5.294374276,116399,116283,82054,39651,10,39641,3,2950,0,0.004944376,mm10,mBC-0716-1
"C10,E9",10103,10415,7638,2777,5626,0,2671,2675,1947,728,2.674450549,1293,935,557,306,0,306,0,97,0,0.091503268,empty,mBC-0716-1
"C10,E10",13610,14028,10345,3683,7427,0,3470,3478,2426,1052,2.30608365,1676,1296,780,426,0,426,0,115,0,0.023474178,empty,mBC-0716-1
"C10,E11",10041,10714,7687,3027,5803,0,2701,2705,1951,754,2.587533156,1314,853,489,272,0,272,0,90,0,0.051470588,empty,mBC-0716-1
"C10,E12",16723,17562,12706,4856,9510,0,4455,4465,3183,1282,2.482839314,2220,1093,686,347,0,347,0,118,0,0.031700288,empty,mBC-0716-1
"C10,F1",17616,17696,13368,4328,9363,0,4135,4143,2889,1254,2.303827751,1939,1332,870,447,0,447,0,126,0,0.07606264,empty,mBC-0716-1
"C10,F2",23231,24252,17567,6685,12843,0,6079,6089,4336,1753,2.473474044,2928,4842,2311,1186,1,1185,1,279,0,0.156118143,empty,mBC-0716-1
"C10,F3",18183,18926,13660,5266,10170,0,4988,4996,3485,1511,2.30641959,2452,1714,1125,588,0,588,0,199,0,0.018707483,empty,mBC-0716-1
"C10,F4",588818,588813,444270,144543,319995,3,143049,143344,111857,31487,3.552481977,68289,6714,4497,2168,1,2167,1,432,0,0.00184587,mm10,mBC-0716-1
"C10,F5",25125,25793,19313,6480,13621,0,6211,6225,4451,1774,2.509019166,2936,2440,1174,604,0,604,0,159,0,0.064569536,empty,mBC-0716-1
"C10,F6",25837,26375,19545,6830,14012,0,6428,6447,4599,1848,2.488636364,3027,2310,1189,651,0,651,0,178,0,0.086021505,empty,mBC-0716-1
"C10,F7",20640,21408,15720,5688,11659,0,5346,5357,3716,1641,2.264472882,2583,1493,569,316,1,315,1,96,0,0.063492063,empty,mBC-0716-1
"C10,F8",23463,24225,17943,6282,13078,0,5945,5961,4239,1722,2.461672474,2848,177,125,74,0,74,0,43,0,0,empty,mBC-0716-1
"C10,F9",16536,17010,12556,4454,9017,0,3977,3984,2811,1173,2.396419437,1900,15188,4819,2500,5,2495,2,462,0,0.026052104,empty,mBC-0716-1
"C10,F10",20674,21222,16058,5164,11317,0,4979,4992,3646,1346,2.708766716,2334,3242,1417,727,0,727,0,196,0,0.034387895,empty,mBC-0716-1
"C10,F11",12011,12505,9249,3256,6600,0,2987,3011,2096,915,2.290710383,1442,4083,1493,757,0,757,0,175,0,0.022457067,empty,mBC-0716-1
"C10,F12",581068,633120,418392,214728,337471,0,183225,183524,150443,33081,4.547716212,98830,4384,2857,1371,1,1370,1,313,0,0.001459854,mm10,mBC-0716-1
"C10,G1",675564,709672,518409,191263,374643,0,172373,172668,147396,25272,5.832383666,84670,87179,61451,29380,7,29373,2,2603,0,0.001429885,mm10,mBC-0716-1
"C10,G2",20514,20829,15651,5178,11174,0,4958,4970,3460,1510,2.291390728,2368,406,245,122,0,122,0,48,0,0.040983607,empty,mBC-0716-1
"C10,G3",20788,21528,15797,5731,11257,0,5137,5153,3709,1444,2.568559557,2497,1508,1011,517,0,517,0,160,0,0.025145068,empty,mBC-0716-1
"C10,G4",1246048,1406350,823156,583194,730646,1,470314,470983,357310,113673,3.143314595,272975,660,375,172,0,172,0,44,0,0,empty,mBC-0716-1
"C10,G5",14127,14639,10706,3933,7772,0,3683,3691,2599,1092,2.38003663,1793,814,527,274,0,274,0,98,0,0.098540146,empty,mBC-0716-1
"C10,G6",26322,26357,19686,6671,13610,0,6099,6101,4383,1718,2.551222352,2789,2842,948,484,0,484,0,109,0,0.123966942,empty,mBC-0716-1
"C10,G7",20181,20663,15608,5055,10862,0,4758,4777,3355,1422,2.359353024,2195,1419,849,452,0,452,0,138,0,0.101769912,empty,mBC-0716-1
"C10,G8",15448,16068,11720,4348,8589,0,4099,4102,2870,1232,2.329545455,2003,1184,752,415,0,415,0,146,0,0.048192771,empty,mBC-0716-1
"C10,G9",818069,910102,568335,341767,480165,1,283170,283518,240301,43217,5.560335053,157431,104452,68717,32339,15,32324,3,2788,0,0.002474941,mm10,mBC-0716-1
"C10,G10",14263,14587,10912,3675,7778,0,3500,3513,2472,1041,2.374639769,1677,1097,735,399,0,399,0,113,0,0.140350877,empty,mBC-0716-1
"C10,G11",12642,12781,9744,3037,6944,0,3072,3083,2226,857,2.597432905,1451,589,371,209,0,209,0,90,0,0.023923445,empty,mBC-0716-1
"C10,G12",12787,13536,9567,3969,7304,0,3460,3469,2507,962,2.606029106,1756,1280,904,432,0,432,0,133,0,0.069444444,empty,mBC-0716-1
"C10,H1",21813,22541,16661,5880,12120,0,5611,5621,3995,1626,2.456949569,2699,778,516,265,0,265,0,103,0,0.022641509,empty,mBC-0716-1
"C10,H2",1157204,1235953,835779,400174,638724,1,346517,347063,282057,65006,4.338937944,181819,137050,94874,44782,13,44769,2,3196,0,0.004378029,mm10,mBC-0716-1
"C10,H3",688888,738202,502321,235881,394557,0,212500,212822,152385,60437,2.521385906,111988,21188,12601,5995,0,5995,0,886,0,0.015846539,mm10,mBC-0716-1
"C10,H4",14487,15536,10987,4549,8362,0,3990,3993,2836,1157,2.451166811,2075,81,61,38,0,38,0,22,0,0.052631579,empty,mBC-0716-1
"C10,H5",19332,19807,14730,5077,10747,1,4961,4971,3549,1422,2.495780591,2368,1819,1064,536,0,536,0,169,0,0.046641791,empty,mBC-0716-1
"C10,H6",1318784,1471357,910852,560505,780059,2,470089,470640,346946,123694,2.804873316,266750,136585,95077,45692,17,45675,4,3486,0,0.002014231,mm10,mBC-0716-1
"C10,H7",18720,19679,14247,5432,10715,0,4972,4981,3539,1442,2.454230236,2469,1247,841,469,1,468,1,161,0,0.042735043,empty,mBC-0716-1
"C10,H8",15584,15912,11521,4391,8503,0,4030,4038,2888,1150,2.511304348,1961,5873,2780,1451,2,1449,1,250,0,0.299516908,empty,mBC-0716-1
"C10,H9",18973,19640,14278,5362,10595,0,4923,4928,3541,1387,2.552992069,2411,1925,920,489,0,489,0,138,0,0.042944785,empty,mBC-0716-1
"C10,H10",17060,17707,12775,4932,9543,0,4642,4656,3324,1332,2.495495495,2233,1110,710,384,0,384,0,122,0,0.018229167,empty,mBC-0716-1
"C10,H11",18837,19598,14312,5286,10741,0,5064,5073,3551,1522,2.333114323,2534,118,64,43,0,43,0,25,0,0,empty,mBC-0716-1
"C10,H12",7265,7537,5476,2061,4023,0,1919,1919,1387,532,2.607142857,963,1120,506,258,0,258,0,85,0,0.034883721,empty,mBC-0716-1
"C11,A1",13976,14241,10421,3820,7879,0,3763,3774,2682,1092,2.456043956,1822,671,430,233,0,233,0,89,0,0.051502146,empty,mBC-0716-1
"C11,A2",18361,18573,14266,4307,9831,0,4229,4238,3038,1200,2.531666667,1922,755,469,247,0,247,0,70,0,0.052631579,empty,mBC-0716-1
"C11,A3",611541,693978,425484,268494,373359,0,222136,222415,150736,71679,2.102931123,126877,30009,21135,10079,3,10076,1,1301,0,0.002183406,mm10,mBC-0716-1
"C11,A4",19548,19823,14905,4918,10382,1,4560,4565,3212,1353,2.37398374,2118,5877,1700,848,1,847,1,179,0,0.024793388,empty,mBC-0716-1
"C11,A5",15955,16150,12312,3838,8580,0,3845,3852,2644,1208,2.188741722,1768,1183,757,353,0,353,0,97,0,0.110481586,empty,mBC-0716-1
"C11,A6",20354,22347,14814,7533,12261,0,6602,6615,4998,1617,3.090909091,3504,964,672,326,0,326,0,93,0,0.104294479,empty,mBC-0716-1
"C11,A7",15457,15944,11729,4215,8419,0,3769,3774,2697,1077,2.504178273,1835,761,464,253,0,253,0,96,0,0.007905138,empty,mBC-0716-1
"C11,A8",10215,10715,7777,2938,5780,0,2629,2634,1844,790,2.334177215,1282,1340,836,432,4,428,2,126,0,0.035046729,empty,mBC-0716-1
"C11,A9",17133,17636,13268,4368,9258,0,4078,4086,2843,1243,2.287208367,1894,1018,703,365,0,365,0,100,0,0.112328767,empty,mBC-0716-1
"C11,A10",14900,15518,11199,4319,8109,3,3719,3731,2606,1125,2.316444444,1814,601,246,109,0,109,0,50,0,0.018348624,empty,mBC-0716-1
"C11,A11",16801,17189,12691,4498,9289,0,4300,4311,3007,1304,2.305981595,2050,884,548,288,0,288,0,81,0,0.048611111,empty,mBC-0716-1
"C11,A12",19192,19476,14792,4684,10264,0,4547,4558,3166,1392,2.274425287,2098,2399,1355,669,0,669,0,150,0,0.119581465,empty,mBC-0716-1
"C11,B1",505037,523078,380191,142887,283490,2,136190,136414,104858,31556,3.322917987,67781,11161,7299,3508,0,3508,0,620,0,0.004561003,mm10,mBC-0716-1
"C11,B2",18858,19382,14466,4916,10335,3,4635,4654,3209,1445,2.220761246,2245,438,306,169,1,168,1,60,0,0.119047619,empty,mBC-0716-1
"C11,B3",17368,17731,13214,4517,9459,0,4196,4212,2962,1250,2.3696,2049,1061,606,308,0,308,0,92,0,0.126623377,empty,mBC-0716-1
"C11,B4",15337,15616,11796,3820,8390,0,3642,3654,2567,1087,2.361545538,1724,835,559,281,0,281,0,85,0,0.163701068,empty,mBC-0716-1
"C11,B5",8604,5533,3737,1796,3787,0,1873,1884,1307,577,2.265164645,1085,560,333,174,0,174,0,58,0,0.011494253,empty,mBC-0716-1
"C11,B6",12301,12631,9137,3494,6639,0,3248,3259,2224,1035,2.148792271,1600,28875,8526,4375,6,4369,2,671,0,0.031586175,empty,mBC-0716-1
"C11,B7",686299,736100,506476,229624,394891,2,202895,203222,169238,33984,4.979931733,105733,65963,48119,22727,3,22724,1,1957,0,0.000704101,mm10,mBC-0716-1
"C11,B8",12110,12535,9250,3285,6706,0,3058,3064,2178,886,2.458239278,1450,1053,703,367,0,367,0,95,0,0.04359673,empty,mBC-0716-1
"C11,B9",14195,14674,10911,3763,7795,0,3573,3586,2504,1082,2.314232902,1715,564,375,182,0,182,0,60,0,0.038461538,empty,mBC-0716-1
"C11,B10",15947,15774,11779,3995,8709,0,4005,4017,2792,1225,2.279183673,1931,336,167,94,0,94,0,39,0,0.085106383,empty,mBC-0716-1
"C11,B11",15589,15901,12066,3835,8422,1,3816,3829,2737,1092,2.506410256,1734,124,63,42,0,42,0,23,0,0.023809524,empty,mBC-0716-1
"C11,B12",16488,16669,12477,4192,9082,0,4085,4093,2905,1188,2.445286195,1926,1105,652,343,0,343,0,99,0,0.023323615,empty,mBC-0716-1
"C11,C1",21480,21635,16612,5023,11128,0,4729,4737,3335,1402,2.37874465,2187,3118,1007,504,0,504,0,111,0,0.128968254,empty,mBC-0716-1
"C11,C2",712732,801689,487283,314406,427243,1,256300,256638,199035,57603,3.455288787,147532,96647,67364,32224,16,32208,1,2490,0,0.000558867,mm10,mBC-0716-1
"C11,C3",18681,18969,14203,4766,10100,0,4623,4630,3261,1369,2.382030679,2197,481,301,123,0,123,0,41,0,0.089430894,empty,mBC-0716-1
"C11,C4",1093730,1141116,812896,328220,611301,5,305372,305889,238695,67194,3.552326101,155225,34283,22018,10370,9,10361,1,1533,0,0.001061674,mm10,mBC-0716-1
"C11,C5",16214,16674,12356,4318,8828,0,4032,4037,2839,1198,2.369782972,1938,1968,937,499,1,498,1,127,0,0.098393574,empty,mBC-0716-1
"C11,C6",17925,18351,13416,4935,10036,0,4685,4685,3378,1307,2.584544759,2271,4588,1705,876,1,875,1,179,0,0.005714286,empty,mBC-0716-1
"C11,C7",15325,15764,11665,4099,8333,0,3826,3832,2715,1117,2.430617726,1884,257,163,83,0,83,0,41,0,0,empty,mBC-0716-1
"C11,C8",14401,14888,10930,3958,7881,0,3561,3569,2477,1092,2.268315018,1734,2932,1215,603,1,602,1,131,0,0.026578073,empty,mBC-0716-1
"C11,C9",11513,11949,8693,3256,6336,0,2916,2926,1963,963,2.038421599,1449,628,360,169,0,169,0,48,0,0.059171598,empty,mBC-0716-1
"C11,C10",12586,12857,9542,3315,6898,0,3083,3090,2117,973,2.175745118,1458,1006,613,309,1,308,1,82,0,0.016233766,empty,mBC-0716-1
"C11,C11",651657,733767,458135,275632,393501,1,228942,229247,191228,38019,5.029800889,128497,78295,52242,24906,13,24893,3,2326,0,0.002972723,mm10,mBC-0716-1
"C11,C12",18633,19286,14020,5266,10231,0,4715,4727,3279,1448,2.264502762,2304,792,485,239,0,239,0,82,0,0.062761506,empty,mBC-0716-1
"C11,D1",11235,11609,8406,3203,6339,0,2999,3007,2083,924,2.254329004,1505,3377,1161,551,3,548,2,131,0,0.045620438,empty,mBC-0716-1
"C11,D2",18888,18989,14605,4384,10030,0,4324,4334,2993,1341,2.23191648,1919,8137,2455,1252,2,1250,2,243,0,0.1256,empty,mBC-0716-1
"C11,D3",13095,13707,9795,3912,7376,0,3473,3482,2409,1073,2.245107176,1751,8980,3001,1523,2,1521,2,253,0,0.046679816,empty,mBC-0716-1
"C11,D4",626402,662634,477345,185289,353077,2,163815,164117,142981,21136,6.764808857,82037,117528,81687,39136,8,39128,2,2881,0,0.0021468,mm10,mBC-0716-1
"C11,D5",13215,13449,10055,3394,7392,0,3403,3418,2408,1010,2.384158416,1614,1011,645,314,0,314,0,99,0,0.01910828,empty,mBC-0716-1
"C11,D6",11625,12258,8667,3591,6551,0,3141,3146,2158,988,2.184210526,1588,979,659,328,0,328,0,92,0,0.158536585,empty,mBC-0716-1
"C11,D7",12697,12957,9690,3267,7052,0,3349,3359,2378,981,2.424057085,1620,1254,805,440,1,439,1,124,0,0.0523918,empty,mBC-0716-1
"C11,D8",573183,634072,414671,219401,342328,0,184582,184854,147677,37177,3.9722678,101773,40906,27654,12944,5,12939,1,1478,0,0.000850143,mm10,mBC-0716-1
"C11,D9",5751,6303,4164,2139,3457,0,1771,1775,1301,474,2.744725738,989,11926,3510,1759,1,1758,1,346,0,0.018202503,empty,mBC-0716-1
"C11,D10",1018573,1108164,738244,369920,594131,2,327003,327499,261692,65807,3.976659018,174991,53143,37586,18117,8,18109,1,1961,0,0.001325308,mm10,mBC-0716-1
"C11,D11",12542,12805,9521,3284,6925,0,3144,3157,2281,876,2.603881279,1513,1160,798,361,0,361,0,104,0,0.047091413,empty,mBC-0716-1
"C11,D12",18887,19323,14509,4814,10285,0,4657,4666,3285,1381,2.378711079,2183,2173,1325,594,2,592,1,151,0,0.052364865,empty,mBC-0716-1
"C11,E1",20641,20984,15826,5158,11158,0,4938,4952,3539,1413,2.504600142,2344,2422,1049,586,1,585,1,148,0,0.100854701,empty,mBC-0716-1
"C11,E2",15655,16060,11846,4214,8607,0,3896,3899,2811,1088,2.583639706,1845,1592,752,387,0,387,0,102,0,0.074935401,empty,mBC-0716-1
"C11,E3",11488,11802,8820,2982,6276,0,2827,2832,1927,905,2.129281768,1317,1276,827,462,0,462,0,113,0,0.062770563,empty,mBC-0716-1
"C11,E4",650812,672510,495445,177065,356357,0,164417,164684,144371,20313,7.107320435,79555,69318,49371,23968,11,23957,1,2234,0,0.003798472,mm10,mBC-0716-1
"C11,E5",20136,20553,15318,5235,10693,0,4752,4764,3342,1422,2.35021097,2199,5946,2205,1194,1,1193,1,255,0,0.134953898,empty,mBC-0716-1
"C11,E6",13210,13234,10160,3074,7117,0,3194,3206,2241,965,2.322279793,1402,1197,746,407,0,407,0,90,0,0.073710074,empty,mBC-0716-1
"C11,E7",772554,883609,516239,367370,466906,5,294587,294985,239924,55061,4.357421769,170390,119520,80531,38360,16,38344,5,2755,0,0.00088671,mm10,mBC-0716-1
"C11,E8",16625,17045,12741,4304,9085,0,4006,4015,2814,1201,2.34304746,1876,10748,3789,1906,0,1906,0,328,0,0.100734523,empty,mBC-0716-1
"C11,E9",8976,9351,6819,2532,5183,0,2478,2493,1708,785,2.175796178,1237,1575,798,436,0,436,0,126,0,0.105504587,empty,mBC-0716-1
"C11,E10",12052,12692,9094,3598,6782,0,3214,3218,2238,980,2.283673469,1607,5666,1777,917,1,916,1,190,0,0.050218341,empty,mBC-0716-1
"C11,E11",8743,9382,6613,2769,5110,0,2402,2409,1719,690,2.491304348,1242,750,458,257,0,257,0,89,0,0.035019455,empty,mBC-0716-1
"C11,E12",469791,504723,328525,176198,275952,0,158217,158472,128948,29524,4.367565371,86472,4921,3386,1640,1,1639,1,379,0,0.023184869,mm10,mBC-0716-1
"C11,F1",16300,16870,12402,4468,8913,0,4025,4033,2803,1230,2.278861789,1952,1110,744,372,0,372,0,94,0,0.051075269,empty,mBC-0716-1
"C11,F2",21044,21611,16075,5536,11591,0,5318,5332,3804,1528,2.489528796,2605,2415,1408,704,1,703,1,187,0,0.029871977,empty,mBC-0716-1
"C11,F3",15785,16719,11833,4886,8851,0,4276,4289,2992,1297,2.306861989,2165,1227,794,410,0,410,0,145,0,0.014634146,empty,mBC-0716-1
"C11,F4",17041,17287,12828,4459,9537,1,4416,4428,3114,1314,2.369863014,2144,2497,1017,493,0,493,0,124,0,0.176470588,empty,mBC-0716-1
"C11,F5",22346,23047,16935,6112,12336,1,5710,5737,4036,1701,2.372721928,2798,1164,797,355,0,355,0,122,0,0.042253521,empty,mBC-0716-1
"C11,F6",22278,23166,16888,6278,12251,0,5662,5683,4071,1612,2.525434243,2750,1826,983,485,0,485,0,143,0,0.105154639,empty,mBC-0716-1
"C11,F7",1965938,2194644,1390485,804159,1160115,3,693235,694167,516117,178050,2.898719461,385334,62639,44546,21743,6,21737,1,2163,0,0.000966095,mm10,mBC-0716-1
"C11,F8",464696,476857,348674,128183,260063,0,123641,123892,94438,29454,3.206287771,61154,4297,2165,1113,0,1113,0,248,0,0.000898473,mm10,mBC-0716-1
"C11,F9",14751,15043,11400,3643,8131,0,3704,3712,2649,1063,2.492003763,1766,1139,665,363,0,363,0,125,0,0.066115702,empty,mBC-0716-1
"C11,F10",18429,18676,14371,4305,9874,0,4185,4197,2992,1205,2.482987552,1904,1142,713,352,0,352,0,104,0,0.028409091,empty,mBC-0716-1
"C11,F11",10762,11003,8242,2761,5917,0,2599,2605,1806,799,2.260325407,1216,713,449,245,0,245,0,89,0,0,empty,mBC-0716-1
"C11,F12",12840,12905,9807,3098,6923,0,3170,3175,2162,1013,2.134254689,1488,79,64,18,0,18,0,5,0,0,empty,mBC-0716-1
"C11,G1",569396,631321,409882,221439,337988,1,189606,189884,145525,44359,3.280619491,102581,89580,62435,30368,8,30360,2,2704,0,0.000658762,mm10,mBC-0716-1
"C11,G2",19531,19759,15071,4688,10279,0,4507,4514,3204,1310,2.445801527,2021,362,219,116,0,116,0,39,0,0.094827586,empty,mBC-0716-1
"C11,G3",18214,18754,13805,4949,9952,0,4547,4560,3210,1350,2.377777778,2182,1464,1024,468,0,468,0,128,0,0.061965812,empty,mBC-0716-1
"C11,G4",863706,931711,629067,302644,492789,1,258528,258910,163301,95609,1.70800866,141574,339,236,98,0,98,0,31,0,0,empty,mBC-0716-1
"C11,G5",12325,12888,9448,3440,6847,0,3125,3125,2196,929,2.363832078,1477,615,368,215,0,215,0,76,0,0.074418605,empty,mBC-0716-1
"C11,G6",23009,23616,17723,5893,12350,0,5412,5423,3829,1594,2.402132999,2463,126,88,49,0,49,0,25,0,0,empty,mBC-0716-1
"C11,G7",18497,18877,14166,4711,10097,0,4544,4557,3160,1397,2.261989979,2216,1491,830,392,0,392,0,120,0,0.025510204,empty,mBC-0716-1
"C11,G8",13510,13805,10220,3585,7413,0,3497,3502,2489,1013,2.457058243,1647,913,635,296,0,296,0,115,0,0.047297297,empty,mBC-0716-1
"C11,G9",10035,10475,7629,2846,5584,0,2610,2615,1849,766,2.41383812,1305,914,589,310,0,310,0,107,0,0.029032258,empty,mBC-0716-1
"C11,G10",12709,12826,9822,3004,6863,0,3022,3031,2025,1006,2.012922465,1369,1653,909,490,0,490,0,130,0,0.069387755,empty,mBC-0716-1
"C11,G11",11369,11618,8735,2883,6307,0,2808,2813,2054,759,2.706192358,1358,482,324,149,0,149,0,61,0,0.040268456,empty,mBC-0716-1
"C11,G12",11227,11668,8584,3084,6293,0,2923,2931,2036,895,2.274860335,1418,978,653,356,0,356,0,91,0,0.08988764,empty,mBC-0716-1
"C11,H1",20771,21356,15859,5497,11393,0,5245,5253,3791,1462,2.593023256,2486,676,393,238,0,238,0,77,0,0.029411765,empty,mBC-0716-1
"C11,H2",24261,24996,18489,6507,13285,0,6236,6244,4439,1805,2.459279778,3004,4629,1608,802,1,801,1,186,0,0.069912609,empty,mBC-0716-1
"C11,H3",19400,20126,14653,5473,10816,0,5066,5075,3612,1463,2.468899522,2464,1149,651,377,0,377,0,132,0,0.034482759,empty,mBC-0716-1
"C11,H4",12809,13004,9803,3201,7082,0,3225,3232,2231,1001,2.228771229,1510,87,47,34,0,34,0,19,0,0.088235294,empty,mBC-0716-1
"C11,H5",853131,982019,562809,419210,516435,2,332822,333225,268628,64597,4.158521294,195072,96629,65608,31317,10,31307,1,2503,0,0.000798543,mm10,mBC-0716-1
"C11,H6",1096158,1200986,758611,442375,641621,0,375789,376284,300814,75470,3.985875182,209051,151680,106977,51932,20,51912,2,3529,0,0.000712745,mm10,mBC-0716-1
"C11,H7",16892,17218,12768,4450,9278,1,4211,4221,2970,1251,2.374100719,2009,997,704,388,0,388,0,136,0,0.074742268,empty,mBC-0716-1
"C11,H8",13096,13595,9882,3713,7253,0,3384,3393,2387,1006,2.372763419,1632,1198,746,420,0,420,0,124,0,0.05,empty,mBC-0716-1
"C11,H9",800519,871551,555769,315782,463841,0,272247,272601,200866,71735,2.800111522,150616,13126,7473,3576,0,3576,0,665,0,0.014261745,mm10,mBC-0716-1
"C11,H10",14204,14877,10667,4210,8046,0,3825,3834,2611,1223,2.134914146,1930,852,480,243,0,243,0,92,0,0.082304527,empty,mBC-0716-1
"C11,H11",16459,17008,12351,4657,9220,0,4322,4328,2991,1337,2.237097981,2145,78,45,29,0,29,0,23,0,0,empty,mBC-0716-1
"C11,H12",5994,6351,4424,1927,3511,0,1732,1736,1203,533,2.257035647,909,484,315,169,0,169,0,52,0,0.136094675,empty,mBC-0716-1
"C12,A1",18716,19691,14105,5586,10586,0,5080,5085,3550,1535,2.312703583,2487,540,308,156,0,156,0,65,0,0,empty,mBC-0716-1
"C12,A2",909435,943349,692415,250934,488920,1,222989,223395,182765,40630,4.498277135,109733,63982,44208,21426,4,21422,2,2082,0,0.000793577,mm10,mBC-0716-1
"C12,A3",18943,19719,14464,5255,10400,0,4828,4843,3394,1449,2.342305038,2367,823,406,210,0,210,0,80,0,0.033333333,empty,mBC-0716-1
"C12,A4",21278,21767,16435,5332,11448,0,4974,4983,3541,1442,2.455617198,2327,439,181,98,0,98,0,51,0,0.020408163,empty,mBC-0716-1
"C12,A5",19364,19955,14868,5087,10495,0,4705,4707,3300,1407,2.345415778,2257,836,549,282,0,282,0,103,0,0.003546099,empty,mBC-0716-1
"C12,A6",670957,727261,503537,223724,382553,0,193924,194236,157243,36993,4.250614981,100483,38461,25702,12567,4,12563,1,1425,0,0.000477593,mm10,mBC-0716-1
"C12,A7",559364,594112,417499,176613,319114,1,162559,162823,118733,44090,2.692968927,84348,7950,5707,2782,2,2780,1,515,0,0.002158273,mm10,mBC-0716-1
"C12,A8",12025,12433,9007,3426,6711,0,3145,3155,2251,904,2.490044248,1550,1057,693,369,0,369,0,118,0,0.059620596,empty,mBC-0716-1
"C12,A9",20341,20804,15790,5014,10838,0,4726,4727,3359,1368,2.455409357,2141,929,622,263,0,263,0,85,0,0.08365019,empty,mBC-0716-1
"C12,A10",19090,19734,14800,4934,10268,0,4612,4620,3263,1357,2.404568902,2162,241,137,79,0,79,0,36,0,0,empty,mBC-0716-1
"C12,A11",713393,781135,522523,258612,413571,1,220920,221325,174853,46472,3.762545189,118225,40506,26381,12376,4,12372,1,1457,0,0.00210152,mm10,mBC-0716-1
"C12,A12",22534,22881,17304,5577,11969,0,5179,5189,3660,1529,2.393721387,2437,1677,1098,555,0,555,0,143,0,0.091891892,empty,mBC-0716-1
"C12,B1",915441,936238,688984,247254,487621,2,231968,232481,184458,48023,3.841034504,113784,23311,12022,5899,0,5899,0,908,0,0.015087303,mm10,mBC-0716-1
"C12,B2",1664155,1843453,1157158,686295,967402,2,583454,584226,440548,143678,3.066217514,326421,25641,16565,7950,9,7941,2,1092,0,0.000125929,mm10,mBC-0716-1
"C12,B3",21134,21842,16077,5765,11765,0,5430,5446,3909,1537,2.543266103,2659,798,464,251,0,251,0,102,0,0,empty,mBC-0716-1
"C12,B4",2842978,3080842,2046559,1034283,1547319,3,882096,883511,711212,172299,4.127777875,474902,134802,88169,41864,20,41844,3,3396,0,0.002318134,mm10,mBC-0716-1
"C12,B5",468157,292788,197448,95340,197917,2,103400,103995,78577,25418,3.091391927,57406,6984,4712,2243,2,2241,2,420,0,0.000892459,mm10,mBC-0716-1
"C12,B6",14470,14923,11004,3919,7827,0,3640,3649,2515,1134,2.217813051,1755,3927,1481,776,1,775,1,159,0,0.018064516,empty,mBC-0716-1
"C12,B7",16918,17431,13140,4291,9147,0,4021,4031,2831,1200,2.359166667,1864,1201,608,344,0,344,0,113,0,0.101744186,empty,mBC-0716-1
"C12,B8",14042,14335,10654,3681,7649,0,3512,3525,2511,1014,2.476331361,1671,536,297,162,0,162,0,76,0,0.111111111,empty,mBC-0716-1
"C12,B9",16037,16181,12419,3762,8667,0,3779,3793,2608,1185,2.200843882,1791,491,282,164,0,164,0,64,0,0.073170732,empty,mBC-0716-1
"C12,B10",19153,18762,13912,4850,10244,0,4653,4668,3195,1473,2.16904277,2210,421,229,113,0,113,0,39,0,0.008849558,empty,mBC-0716-1
"C12,B11",22525,23601,16754,6847,12621,0,6081,6092,4396,1696,2.591981132,3096,203,154,100,0,100,0,38,0,0.04,empty,mBC-0716-1
"C12,B12",727877,810341,517713,292628,430799,1,243643,244027,197179,46848,4.208909665,134648,84220,49179,23829,11,23818,2,2340,0,0.018095558,mm10,mBC-0716-1
"C12,C1",22068,22278,17011,5267,11704,0,4944,4952,3565,1387,2.570295602,2310,454,319,178,0,178,0,68,0,0.078651685,empty,mBC-0716-1
"C12,C2",23527,24515,17945,6570,12724,0,5850,5861,4165,1696,2.455778302,2835,1254,867,453,0,453,0,142,0,0.035320088,empty,mBC-0716-1
"C12,C3",21436,22637,16273,6364,11624,0,5332,5346,3646,1700,2.144705882,2649,1722,661,345,0,345,0,82,0,0.057971014,empty,mBC-0716-1
"C12,C4",21329,21601,16224,5377,11507,0,5127,5135,3620,1515,2.389438944,2453,838,477,217,0,217,0,80,0,0.156682028,empty,mBC-0716-1
"C12,C5",663105,685788,499632,186156,365290,1,173429,173724,123088,50636,2.430839719,87210,6308,4293,1996,1,1995,1,395,0,0,mm10,mBC-0716-1
"C12,C6",21562,21974,16280,5694,12202,0,5724,5737,4172,1565,2.665814696,2777,670,454,230,0,230,0,88,0,0.02173913,empty,mBC-0716-1
"C12,C7",1753853,1974490,1233250,741240,1020532,1,601865,602710,473069,129641,3.649069353,339052,45216,27885,13401,4,13397,2,1555,0,7.46436E-05,mm10,mBC-0716-1
"C12,C8",17716,18552,13478,5074,9842,0,4550,4553,3146,1407,2.235963042,2276,1016,567,305,0,305,0,125,0,0.026229508,empty,mBC-0716-1
"C12,C9",14601,14963,11140,3823,7894,0,3598,3614,2548,1066,2.390243902,1767,379,235,134,0,134,0,57,0,0.014925373,empty,mBC-0716-1
"C12,C10",14858,15229,11399,3830,7999,0,3636,3646,2526,1120,2.255357143,1696,2411,870,422,0,422,0,99,0,0.016587678,empty,mBC-0716-1
"C12,C11",12527,12989,9236,3753,6830,1,3162,3168,2236,932,2.399141631,1579,637,421,202,0,202,0,68,0,0.069306931,empty,mBC-0716-1
"C12,C12",21354,21920,16231,5689,11536,0,5175,5181,3738,1443,2.59043659,2506,923,532,294,1,293,1,86,0,0.061433447,empty,mBC-0716-1
"C12,D1",15732,16000,11872,4128,8587,0,4058,4065,2871,1194,2.404522613,1939,391,240,123,0,123,0,42,0,0.089430894,empty,mBC-0716-1
"C12,D2",20583,21428,15737,5691,11323,0,5090,5101,3537,1564,2.261508951,2494,1439,945,511,0,511,0,146,0,0.082191781,empty,mBC-0716-1
"C12,D3",16030,16651,12056,4595,8969,0,4233,4238,2937,1301,2.257494235,2106,872,495,265,0,265,0,91,0,0.052830189,empty,mBC-0716-1
"C12,D4",16242,16921,12362,4559,9027,0,4200,4207,2986,1221,2.445536446,2038,692,427,217,1,216,1,88,0,0.046296296,empty,mBC-0716-1
"C12,D5",16886,17569,12938,4631,9188,0,4328,4343,3074,1269,2.422379827,2033,763,435,235,0,235,0,85,0,0.029787234,empty,mBC-0716-1
"C12,D6",14546,15113,11056,4057,8124,0,3808,3812,2616,1196,2.18729097,1845,728,370,195,0,195,0,71,0,0,empty,mBC-0716-1
"C12,D7",16702,17513,12545,4968,8947,1,4124,4145,2888,1257,2.297533811,2008,13427,4084,2073,1,2072,1,387,0,0.074324324,empty,mBC-0716-1
"C12,D8",20036,21126,15107,6019,11262,0,5412,5429,3845,1584,2.42739899,2762,707,477,224,0,224,0,77,0,0.022321429,empty,mBC-0716-1
"C12,D9",9718,9971,7052,2919,5498,0,2739,2743,1926,817,2.357405141,1419,885,534,266,0,266,0,84,0,0.139097744,empty,mBC-0716-1
"C12,D10",1023212,1091061,745347,345714,564100,1,300491,301016,235759,65257,3.612777173,156674,73392,49301,23620,9,23611,1,2245,0,0.00067765,mm10,mBC-0716-1
"C12,D11",14727,15320,11209,4111,8155,0,3758,3765,2615,1150,2.273913043,1796,975,612,347,0,347,0,121,0,0.048991354,empty,mBC-0716-1
"C12,D12",21145,21724,16223,5501,11433,0,5204,5214,3721,1493,2.492297388,2472,1633,1047,558,0,558,0,152,0,0.02688172,empty,mBC-0716-1
"C12,E1",832571,876838,611623,265215,465545,2,242833,243205,184265,58940,3.126314897,125971,54009,18529,9087,7,9080,3,1263,0,0.04030837,mm10,mBC-0716-1
"C12,E2",19869,20234,15228,5006,10844,1,4810,4828,3360,1468,2.288828338,2291,956,603,301,0,301,0,106,0,0.033222591,empty,mBC-0716-1
"C12,E3",59098,64204,45423,18781,33670,0,15981,16023,13146,2877,4.569343066,8133,5538,3786,1841,2,1839,1,339,0,0.002718869,empty,mBC-0716-1
"C12,E4",1000417,1092408,713333,379075,565358,0,316912,317401,253672,63729,3.980479844,172017,38597,26701,13024,1,13023,1,1498,0,0.000307149,mm10,mBC-0716-1
"C12,E5",21436,21627,16349,5278,11625,1,5210,5232,3721,1511,2.462607545,2402,5728,2129,1068,0,1068,0,249,0,0.013108614,empty,mBC-0716-1
"C12,E6",16970,17422,13016,4406,9154,0,4142,4155,2781,1374,2.024017467,2030,1094,747,355,0,355,0,99,0,0.14084507,empty,mBC-0716-1
"C12,E7",16581,17104,12631,4473,8977,0,4019,4035,2862,1173,2.439897698,1959,734,424,206,0,206,0,80,0,0.111650485,empty,mBC-0716-1
"C12,E8",781147,828366,581225,247141,437126,1,216746,217086,180209,36877,4.886758684,110607,101016,65581,31293,8,31285,3,2646,0,0.004347131,mm10,mBC-0716-1
"C12,E9",567054,639163,403563,235600,341265,0,195953,196264,157137,39127,4.016075856,109560,47921,32557,15525,4,15521,1,1749,0,0.008826751,mm10,mBC-0716-1
"C12,E10",1252794,1374310,905574,468736,725593,3,405409,406037,323771,82266,3.935659932,219072,80180,55772,26723,10,26713,2,2487,0,0.002433272,mm10,mBC-0716-1
"C12,E11",808081,935645,542521,393124,502059,1,326312,326673,230992,95681,2.414188815,191315,32166,21773,10296,6,10290,2,1337,0,0.002429543,mm10,mBC-0716-1
"C12,E12",18544,19526,14101,5425,10353,0,4819,4831,3346,1485,2.253198653,2405,747,485,253,0,253,0,91,0,0.04743083,empty,mBC-0716-1
"C12,F1",1045412,1127688,759967,367721,581730,1,312553,313037,251142,61895,4.057549075,165224,72401,50456,24085,10,24075,2,2178,0,0.001827622,mm10,mBC-0716-1
"C12,F2",24748,25664,18672,6992,13530,0,6338,6349,4409,1940,2.272680412,3147,1779,1126,561,0,561,0,153,0,0.08912656,empty,mBC-0716-1
"C12,F3",18866,19534,14295,5239,10423,0,4907,4922,3350,1572,2.131043257,2412,1313,866,466,0,466,0,146,0,0.122317597,empty,mBC-0716-1
"C12,F4",1851348,2010508,1342936,667572,1043072,6,572541,573427,459804,113623,4.046751098,306480,41830,27301,12969,8,12961,2,1631,0,0.005015045,mm10,mBC-0716-1
"C12,F5",25979,26631,20037,6594,13927,0,6216,6232,4442,1790,2.481564246,2877,1181,770,399,0,399,0,134,0,0.035087719,empty,mBC-0716-1
"C12,F6",29032,30151,22154,7997,15496,0,7259,7266,5169,2097,2.464949928,3445,7676,2623,1331,0,1331,0,291,0,0.030803907,empty,mBC-0716-1
"C12,F7",21114,21491,15962,5529,11766,0,5427,5444,3769,1675,2.250149254,2597,5620,1677,853,0,853,0,188,0,0.014067995,empty,mBC-0716-1
"C12,F8",25975,26565,19904,6661,14131,0,6417,6428,4601,1827,2.51833607,3095,196,145,75,0,75,0,37,0,0,empty,mBC-0716-1
"C12,F9",17392,17717,13403,4314,9361,0,4194,4208,2957,1251,2.363709033,1959,1269,847,433,0,433,0,149,0,0.020785219,empty,mBC-0716-1
"C12,F10",20100,20205,15655,4550,10726,0,4575,4584,3263,1321,2.47009841,2038,914,587,299,0,299,0,104,0,0.040133779,empty,mBC-0716-1
"C12,F11",12637,12988,9736,3252,6726,0,2937,2948,2042,906,2.253863135,1372,786,565,286,0,286,0,85,0,0.06993007,empty,mBC-0716-1
"C12,F12",451500,458675,346892,111783,245971,0,106448,106653,82461,24192,3.408606151,51340,1107,752,323,0,323,0,87,0,0,empty,mBC-0716-1
"C12,G1",10002,10148,7793,2355,5520,0,2400,2406,1661,745,2.229530201,1101,1057,715,352,1,351,1,98,0,0.01994302,empty,mBC-0716-1
"C12,G2",22821,22805,17226,5579,11639,2,5146,5156,3578,1578,2.267427123,2318,5821,1940,986,1,985,1,192,0,0.102538071,empty,mBC-0716-1
"C12,G3",22151,22732,16690,6042,11885,0,5550,5560,3920,1640,2.390243902,2684,1879,945,530,1,529,1,141,0,0.109640832,empty,mBC-0716-1
"C12,G4",28842,29304,22416,6888,15398,0,6645,6656,4786,1870,2.559358289,3066,50,28,19,0,19,0,9,0,0,empty,mBC-0716-1
"C12,G5",15296,15964,11585,4379,8354,0,3834,3843,2766,1077,2.568245125,1891,758,483,276,0,276,0,86,0,0.047101449,empty,mBC-0716-1
"C12,G6",25649,25867,19855,6012,13771,0,5989,5998,4234,1764,2.400226757,2751,111,79,41,0,41,0,25,0,0,empty,mBC-0716-1
"C12,G7",20463,20667,15754,4913,11009,0,4884,4902,3482,1420,2.452112676,2214,1089,672,335,0,335,0,126,0,0.059701493,empty,mBC-0716-1
"C12,G8",932871,1013036,678458,334578,525209,0,278239,278708,245144,33564,7.303777857,147592,97586,70561,33220,15,33205,2,2710,0,0.000210812,mm10,mBC-0716-1
"C12,G9",11573,12062,8982,3080,6392,0,2902,2907,2050,857,2.392065344,1413,901,593,308,0,308,0,108,0,0.071428571,empty,mBC-0716-1
"C12,G10",14427,14900,11079,3821,7938,0,3566,3576,2474,1102,2.245009074,1722,874,566,296,0,296,0,101,0,0.013513514,empty,mBC-0716-1
"C12,G11",857702,963249,599240,364009,507725,3,300353,300751,243388,57363,4.242944058,168473,56411,39597,18364,5,18359,1,1917,0,0.000326815,mm10,mBC-0716-1
"C12,G12",523654,536693,396627,140066,293098,0,135969,136208,102152,34056,2.999530186,67022,13329,7090,3459,1,3458,1,607,0,0.015326778,mm10,mBC-0716-1
"C12,H1",1664985,1799232,1223655,575577,925429,3,491079,491846,398138,93708,4.248708755,260083,85103,59165,27986,12,27974,2,2479,0,0.002752556,mm10,mBC-0716-1
"C12,H2",25497,25911,19442,6469,13582,0,6094,6106,4283,1823,2.349424026,2837,1265,853,366,0,366,0,122,0,0.024590164,empty,mBC-0716-1
"C12,H3",1952645,2216032,1301099,914933,1144856,4,744488,745343,634004,111339,5.694356874,433512,38058,14342,6973,4,6969,1,1124,0,0.085952073,mm10,mBC-0716-1
"C12,H4",963893,1063179,685188,377991,553242,1,315777,316182,246175,70007,3.516434071,172949,4896,2711,1355,0,1355,0,281,0,0.015498155,mm10,mBC-0716-1
"C12,H5",19996,20692,15022,5670,11000,0,5236,5247,3784,1463,2.586466165,2555,1136,651,325,0,325,0,107,0,0,empty,mBC-0716-1
"C12,H6",19360,19933,14601,5332,10729,0,4964,4979,3498,1481,2.361917623,2466,1265,797,393,0,393,0,124,0,0.048346056,empty,mBC-0716-1
"C12,H7",20401,21397,15296,6101,11509,0,5499,5514,3953,1561,2.532351057,2722,1073,732,353,0,353,0,117,0,0.076487252,empty,mBC-0716-1
"C12,H8",581951,613475,444142,169333,327028,2,156203,156451,119579,36872,3.243084183,77947,26889,18278,8835,1,8834,1,1234,0,0.005999547,mm10,mBC-0716-1
"C12,H9",20904,21321,15711,5610,11206,0,5060,5072,3556,1516,2.345646438,2409,5829,1837,958,0,958,0,191,0,0.169102296,empty,mBC-0716-1
"C12,H10",18794,19689,14355,5334,10176,0,4700,4707,3321,1386,2.396103896,2274,813,508,270,1,269,1,99,0,0.011152416,empty,mBC-0716-1
"C12,H11",801653,867771,595001,272770,453918,1,230521,230873,198792,32081,6.196564945,120649,3045,1780,837,1,836,1,183,0,0.015550239,empty,mBC-0716-1
"C12,H12",7630,8022,5740,2282,4304,1,2032,2038,1403,635,2.209448819,1062,346,186,99,0,99,0,42,0,0.01010101,empty,mBC-0716-1
"D1,A1",14515,15066,10863,4203,8270,0,3950,3956,2769,1187,2.332771693,1969,1058,745,375,0,375,0,87,0,0.016,empty,mBC-0716-1
"D1,A2",18529,18871,14181,4690,10001,0,4424,4431,3167,1264,2.505537975,2051,1432,864,442,1,441,1,106,0,0.136054422,empty,mBC-0716-1
"D1,A3",15895,16133,11988,4145,8734,0,4135,4144,2914,1230,2.369105691,1992,7039,2371,1236,3,1233,2,215,0,0.144363341,empty,mBC-0716-1
"D1,A4",18576,19189,14512,4677,9989,0,4364,4372,3105,1267,2.450670876,2044,468,299,135,0,135,0,43,0,0.111111111,empty,mBC-0716-1
"D1,A5",15777,16274,12043,4231,8782,0,4006,4011,2770,1241,2.232070911,1929,1414,717,350,0,350,0,103,0,0.042857143,empty,mBC-0716-1
"D1,A6",12766,13212,9686,3526,7002,0,3256,3267,2352,915,2.570491803,1575,4446,1780,823,0,823,0,186,0,0.07654921,empty,mBC-0716-1
"D1,A7",15298,15845,11756,4089,8514,0,3863,3865,2722,1143,2.381452318,1857,1175,792,396,0,396,0,102,0,0.098484848,empty,mBC-0716-1
"D1,A8",10403,10731,7887,2844,5726,0,2607,2610,1841,769,2.394018205,1242,1446,840,424,1,423,1,123,0,0.030732861,empty,mBC-0716-1
"D1,A9",16768,17075,12815,4260,8980,0,3912,3919,2786,1133,2.458958517,1824,1102,712,369,0,369,0,102,0,0.037940379,empty,mBC-0716-1
"D1,A10",1551513,1654298,1110807,543491,859195,2,476266,476970,376453,100517,3.745167484,252494,56051,36894,17271,3,17268,2,1801,0,0.002721798,mm10,mBC-0716-1
"D1,A11",17093,17568,13179,4389,9348,0,4242,4266,2998,1268,2.364353312,1984,1176,745,369,0,369,0,94,0,0.062330623,empty,mBC-0716-1
"D1,A12",18941,19639,14573,5066,10136,0,4506,4514,3207,1307,2.453710788,2177,2380,1487,747,0,747,0,164,0,0.073627845,empty,mBC-0716-1
"D1,B1",17617,17928,13669,4259,9457,0,4265,4276,2956,1320,2.239393939,1950,1062,631,300,0,300,0,99,0,0.02,empty,mBC-0716-1
"D1,B2",1329082,1418116,975979,442137,743528,4,387515,388123,311093,77030,4.038595352,202895,44926,28012,13181,4,13177,1,1527,0,0.000303559,mm10,mBC-0716-1
"D1,B3",598897,647312,429613,217699,348170,0,194823,195103,142297,52806,2.694712722,106071,23280,11536,5609,2,5607,2,830,0,0.116461566,mm10,mBC-0716-1
"D1,B4",15195,15858,11650,4208,8421,0,3816,3826,2746,1080,2.542592593,1828,917,556,276,0,276,0,101,0,0.06884058,empty,mBC-0716-1
"D1,B5",8973,5639,3935,1704,3769,0,1754,1766,1250,516,2.42248062,954,889,534,257,0,257,0,76,0,0.178988327,empty,mBC-0716-1
"D1,B6",12518,12985,9486,3499,6925,0,3293,3299,2344,955,2.454450262,1588,1253,802,388,0,388,0,108,0,0,empty,mBC-0716-1
"D1,B7",14934,15046,11389,3657,8020,0,3558,3565,2509,1056,2.37594697,1703,40500,11373,5524,9,5515,4,771,0,0.050589302,empty,mBC-0716-1
"D1,B8",12142,12513,9411,3102,6649,0,2995,3001,2150,851,2.526439483,1387,1125,737,362,0,362,0,107,0,0.011049724,empty,mBC-0716-1
"D1,B9",13966,14435,10755,3680,7509,0,3384,3392,2343,1049,2.233555767,1607,3589,1144,633,0,633,0,136,0,0.037914692,empty,mBC-0716-1
"D1,B10",15618,15052,11423,3629,8418,0,3852,3865,2686,1179,2.278201866,1725,498,318,184,0,184,0,57,0,0.070652174,empty,mBC-0716-1
"D1,B11",768616,843157,543776,299381,439797,0,247380,247748,208779,38969,5.357566271,135573,4619,2816,1338,0,1338,0,257,0,0.001494768,mm10,mBC-0716-1
"D1,B12",16539,16855,12720,4135,9130,0,4125,4134,2859,1275,2.242352941,1908,1187,717,351,1,350,1,108,0,0.008571429,empty,mBC-0716-1
"D1,C1",20473,20669,16003,4666,10724,0,4476,4484,3220,1264,2.547468354,2015,639,405,198,0,198,0,61,0,0.005050505,empty,mBC-0716-1
"D1,C2",19191,19861,14447,5414,10744,0,4987,4993,3551,1442,2.462552011,2475,1606,1094,504,1,503,1,127,0,0.06361829,empty,mBC-0716-1
"D1,C3",18456,18939,14085,4854,10017,0,4558,4564,3145,1419,2.216349542,2175,1774,689,368,0,368,0,74,0,0.10326087,empty,mBC-0716-1
"D1,C4",16743,17017,12761,4256,9124,0,4099,4105,3035,1070,2.836448598,1945,4746,1894,887,0,887,0,209,0,0.038331454,empty,mBC-0716-1
"D1,C5",803685,884166,561170,322996,468513,0,277834,278194,214874,63320,3.393461781,154143,9422,6578,2996,2,2994,1,530,0,0.010354041,mm10,mBC-0716-1
"D1,C6",16774,17069,12630,4439,9385,1,4362,4370,3132,1238,2.529886914,2093,1177,697,339,0,339,0,88,0,0.020648968,empty,mBC-0716-1
"D1,C7",15488,16169,11794,4375,8696,0,4032,4050,2861,1189,2.406223717,1983,385,267,125,0,125,0,45,0,0.072,empty,mBC-0716-1
"D1,C8",14164,14396,10715,3681,7798,0,3625,3634,2509,1125,2.230222222,1740,1238,737,365,0,365,0,98,0,0.065753425,empty,mBC-0716-1
"D1,C9",11981,12460,8977,3483,6679,0,3163,3176,2263,913,2.47864184,1584,710,452,234,0,234,0,70,0,0.08974359,empty,mBC-0716-1
"D1,C10",13157,13531,9967,3564,7189,0,3266,3276,2276,1000,2.276,1569,7874,2388,1146,0,1146,0,221,0,0.086387435,empty,mBC-0716-1
"D1,C11",10834,11171,8119,3052,5957,0,2781,2784,1956,828,2.362318841,1335,774,481,227,0,227,0,62,0,0.061674009,empty,mBC-0716-1
"D1,C12",18927,19758,14462,5296,10469,1,4778,4798,3415,1383,2.469269704,2330,1096,692,348,0,348,0,101,0,0.028735632,empty,mBC-0716-1
"D1,D1",11559,12079,8674,3405,6594,0,3176,3177,2259,918,2.460784314,1586,455,246,120,0,120,0,41,0,0.108333333,empty,mBC-0716-1
"D1,D2",18331,18369,14173,4196,9751,0,4197,4209,2880,1329,2.167042889,1898,2052,1271,634,0,634,0,176,0,0.036277603,empty,mBC-0716-1
"D1,D3",13205,13746,9823,3923,7526,0,3606,3620,2563,1057,2.424787133,1845,862,503,226,0,226,0,72,0,0.022123894,empty,mBC-0716-1
"D1,D4",13399,13765,10156,3609,7293,0,3298,3307,2277,1030,2.210679612,1591,1351,631,286,0,286,0,98,0,0.048951049,empty,mBC-0716-1
"D1,D5",13488,14017,9947,4070,7531,0,3571,3577,2491,1086,2.29373849,1785,2070,917,465,0,465,0,137,0,0.077419355,empty,mBC-0716-1
"D1,D6",19744,21147,14772,6375,11358,0,5820,5828,4321,1507,2.867285999,3011,6412,2359,1141,1,1140,1,213,0,0.034210526,empty,mBC-0716-1
"D1,D7",12746,13114,9559,3555,6927,0,3254,3262,2361,901,2.620421754,1554,1298,855,440,0,440,0,135,0,0.056818182,empty,mBC-0716-1
"D1,D8",778080,853389,551156,302233,452111,0,259276,259634,199500,60134,3.317590714,142437,38851,27944,13299,6,13293,1,1488,0,0.00030091,mm10,mBC-0716-1
"D1,D9",6094,6565,4405,2160,3619,0,1845,1849,1367,482,2.836099585,989,1430,811,395,0,395,0,125,0,0.070886076,empty,mBC-0716-1
"D1,D10",13907,14433,10348,4085,7568,0,3506,3518,2456,1062,2.312617702,1781,1366,566,285,0,285,0,84,0,0.084210526,empty,mBC-0716-1
"D1,D11",12485,12978,9458,3520,6944,0,3166,3172,2251,921,2.444082519,1582,1575,989,477,0,477,0,131,0,0.039832285,empty,mBC-0716-1
"D1,D12",1494566,1684919,1032406,652513,877412,1,534437,535204,418541,116663,3.587607039,304497,211676,144180,67647,27,67620,2,4038,0,0.001049985,mm10,mBC-0716-1
"D1,E1",20629,20792,15901,4891,11049,0,4857,4863,3444,1419,2.427061311,2220,1743,1001,531,0,531,0,168,0,0.048964218,empty,mBC-0716-1
"D1,E2",15702,15811,11968,3843,8574,1,3867,3875,2812,1063,2.645343368,1822,1326,823,421,0,421,0,103,0,0.038004751,empty,mBC-0716-1
"D1,E3",11914,12066,9068,2998,6467,1,2991,3008,2135,873,2.44558992,1401,10555,3870,1884,1,1883,1,304,0,0.050982475,empty,mBC-0716-1
"D1,E4",14180,14582,10778,3804,7743,0,3514,3524,2510,1014,2.475345168,1709,1141,735,381,0,381,0,113,0,0.023622047,empty,mBC-0716-1
"D1,E5",19276,19555,14866,4689,10572,0,4733,4746,3339,1407,2.373134328,2221,1362,848,414,0,414,0,122,0,0.031400966,empty,mBC-0716-1
"D1,E6",333778,337873,245438,92435,184042,0,89568,89714,71489,18225,3.922578875,44360,14087,8050,3814,1,3813,1,713,0,0.034880671,mm10,mBC-0716-1
"D1,E7",13468,13540,10398,3142,7272,0,3297,3306,2283,1023,2.231671554,1515,1213,835,395,1,394,1,114,0,0.010152284,empty,mBC-0716-1
"D1,E8",16847,17413,12954,4459,9131,0,4065,4077,2889,1188,2.431818182,1979,6081,2378,1166,0,1166,0,251,0,0.024013722,empty,mBC-0716-1
"D1,E9",59903,55698,52496,3202,31694,0,3648,3665,2651,1014,2.614398422,1379,2375,1395,634,0,634,0,201,0,0.009463722,empty,mBC-0716-1
"D1,E10",12022,12744,9250,3494,6727,0,3151,3154,2216,938,2.362473348,1524,1484,983,493,0,493,0,111,0,0.085192698,empty,mBC-0716-1
"D1,E11",9005,9277,6889,2388,5092,0,2369,2369,1668,701,2.379457917,1108,975,624,317,0,317,0,95,0,0.047318612,empty,mBC-0716-1
"D1,E12",14488,15005,10983,4022,8011,0,3806,3815,2751,1064,2.585526316,1854,1347,819,410,0,410,0,115,0,0.017073171,empty,mBC-0716-1
"D1,F1",16414,16613,12631,3982,8763,0,3924,3936,2811,1125,2.498666667,1770,1301,958,426,0,426,0,108,0,0.075117371,empty,mBC-0716-1
"D1,F2",21230,22029,16252,5777,11642,0,5287,5309,3699,1610,2.297515528,2565,2633,1687,808,1,807,1,222,0,0.038413879,empty,mBC-0716-1
"D1,F3",1312175,1492905,887572,605333,787920,0,490208,490792,398184,92608,4.299671735,284274,232439,156173,73119,23,73096,4,4221,0,0.001477509,mm10,mBC-0716-1
"D1,F4",17926,18435,13541,4894,10131,0,4718,4724,3399,1325,2.565283019,2333,2906,857,455,0,455,0,111,0,0.048351648,empty,mBC-0716-1
"D1,F5",22241,22778,16840,5938,11956,1,5407,5420,3782,1638,2.308913309,2580,1359,868,436,0,436,0,133,0,0.066513761,empty,mBC-0716-1
"D1,F6",23107,23700,17494,6206,12681,0,5910,5929,4225,1704,2.479460094,2859,1993,1205,593,0,593,0,152,0,0.050590219,empty,mBC-0716-1
"D1,F7",18368,19119,13954,5165,10469,0,4812,4831,3409,1422,2.397327707,2414,671,424,251,0,251,0,81,0,0.06374502,empty,mBC-0716-1
"D1,F8",21762,22430,16532,5898,11931,0,5451,5457,3855,1602,2.406367041,2606,1442,495,265,0,265,0,77,0,0.071698113,empty,mBC-0716-1
"D1,F9",14868,15303,11525,3778,8141,0,3732,3736,2688,1048,2.564885496,1711,3267,1535,773,0,773,0,200,0,0.029754204,empty,mBC-0716-1
"D1,F10",18595,18832,14401,4431,9954,0,4318,4321,3089,1232,2.507305195,1945,1283,808,412,0,412,0,109,0,0.019417476,empty,mBC-0716-1
"D1,F11",10938,11269,8520,2749,5943,0,2635,2636,1858,778,2.388174807,1208,936,590,304,0,304,0,98,0,0.039473684,empty,mBC-0716-1
"D1,F12",12670,13126,9555,3571,6925,0,3187,3189,2196,993,2.211480363,1582,35,23,13,0,13,0,8,0,0,empty,mBC-0716-1
"D1,G1",9069,9368,6977,2391,4947,0,2183,2186,1509,677,2.228951256,993,1805,1101,506,2,504,1,143,0,0.011904762,empty,mBC-0716-1
"D1,G2",18873,19084,14325,4759,10117,0,4478,4481,3104,1377,2.254175744,2150,362,216,124,0,124,0,43,0,0.088709677,empty,mBC-0716-1
"D1,G3",18894,19389,14402,4987,10210,0,4683,4692,3242,1450,2.235862069,2234,3280,1500,745,0,745,0,195,0,0.045637584,empty,mBC-0716-1
"D1,G4",26001,26518,20167,6351,13894,0,5985,5997,4237,1760,2.407386364,2736,69,44,30,0,30,0,21,0,0,empty,mBC-0716-1
"D1,G5",12304,12346,9385,2961,6647,0,2990,2995,2083,912,2.283991228,1404,939,547,272,0,272,0,89,0,0.106617647,empty,mBC-0716-1
"D1,G6",768711,842235,546818,295417,445086,0,249596,249932,194088,55844,3.475539002,135676,3558,2499,1195,0,1195,0,246,0,0.0041841,mm10,mBC-0716-1
"D1,G7",18867,19179,14713,4466,9991,0,4280,4293,3030,1263,2.399049881,1913,1557,831,441,0,441,0,149,0,0.045351474,empty,mBC-0716-1
"D1,G8",13827,14537,10490,4047,7655,0,3642,3651,2614,1037,2.520732883,1810,1469,940,474,0,474,0,138,0,0.021097046,empty,mBC-0716-1
"D1,G9",9923,10354,7568,2786,5572,0,2561,2564,1859,705,2.636879433,1292,3153,1290,690,0,690,0,168,0,0.049275362,empty,mBC-0716-1
"D1,G10",1379632,1465489,988769,476720,767131,0,420974,421590,347232,74358,4.669732914,221930,95666,65278,30556,14,30542,2,2846,0,0.001440639,mm10,mBC-0716-1
"D1,G11",920348,1045838,610583,435255,544795,0,344642,345106,280315,64791,4.326449661,198229,92435,64221,30085,12,30073,2,2485,0,0.001496359,mm10,mBC-0716-1
"D1,G12",10703,11074,8105,2969,6069,0,2842,2844,2031,813,2.498154982,1359,1095,713,363,0,363,0,84,0,0.068870523,empty,mBC-0716-1
"D1,H1",723679,801637,516200,285437,423302,2,234451,234841,194493,40348,4.820387628,128468,123655,79286,36798,16,36782,4,2876,0,0.002501223,mm10,mBC-0716-1
"D1,H2",23150,23378,17525,5853,12517,0,5729,5740,4116,1624,2.534482759,2729,8751,3277,1589,1,1588,1,284,0,0.023299748,empty,mBC-0716-1
"D1,H3",19299,19675,14340,5335,10818,0,5078,5085,3606,1479,2.438133874,2508,1316,841,439,0,439,0,120,0,0.0523918,empty,mBC-0716-1
"D1,H4",12993,13641,9746,3895,7365,0,3437,3448,2429,1019,2.383709519,1745,98,74,43,0,43,0,18,0,0,empty,mBC-0716-1
"D1,H5",18340,18862,13741,5121,9928,0,4698,4707,3329,1378,2.415820029,2218,18618,6209,2981,2,2979,2,507,0,0.042296073,empty,mBC-0716-1
"D1,H6",14968,15944,11273,4671,8517,0,4063,4067,2878,1189,2.420521447,2080,2265,1145,622,0,622,0,147,0,0.085209003,empty,mBC-0716-1
"D1,H7",512283,548609,374205,174404,297178,1,153756,154047,130510,23537,5.544886774,80909,75677,53501,24948,14,24934,2,2368,0,0.001443812,mm10,mBC-0716-1
"D1,H8",13956,14234,10728,3506,7775,0,3512,3521,2559,962,2.66008316,1649,13730,4024,2071,0,2071,0,365,0,0.02945437,empty,mBC-0716-1
"D1,H9",527444,564621,377452,187169,304071,1,164350,164572,137757,26815,5.137311206,87400,62078,42766,20583,8,20575,1,1996,0,0.025078979,mm10,mBC-0716-1
"D1,H10",13922,14390,10419,3971,7853,0,3750,3755,2735,1020,2.681372549,1873,837,505,279,0,279,0,98,0,0.014336918,empty,mBC-0716-1
"D1,H11",17345,18186,13257,4929,9700,0,4633,4641,3279,1362,2.407488987,2201,216,80,44,0,44,0,24,0,0.113636364,empty,mBC-0716-1
"D1,H12",6671,6953,4851,2102,3753,0,1826,1833,1316,517,2.545454545,915,671,419,199,0,199,0,63,0,0.085427136,empty,mBC-0716-1
"D2,A1",13180,13356,10051,3305,7252,0,3357,3374,2386,988,2.414979757,1621,11890,3977,1986,2,1984,1,324,0,0.052419355,empty,mBC-0716-1
"D2,A2",17207,17387,13272,4115,9167,0,4034,4041,2870,1171,2.45089667,1881,2511,1181,570,1,569,1,148,0,0.091388401,empty,mBC-0716-1
"D2,A3",15282,15769,11787,3982,8351,0,3771,3779,2653,1126,2.356127886,1802,4039,1514,732,0,732,0,167,0,0.013661202,empty,mBC-0716-1
"D2,A4",244989,223337,214150,9187,121949,0,13235,13330,9158,4172,2.195110259,3743,1816,1112,561,0,561,0,153,0,0.049910873,empty,mBC-0716-1
"D2,A5",15660,16334,12059,4275,8620,0,3911,3923,2657,1266,2.098736177,1900,4293,1689,833,0,833,0,190,0,0.066026411,empty,mBC-0716-1
"D2,A6",13968,14456,10637,3819,7640,0,3485,3491,2487,1004,2.477091633,1671,4853,1922,958,1,957,1,226,0,0.007314525,empty,mBC-0716-1
"D2,A7",15839,16349,11957,4392,8487,0,3904,3920,2696,1224,2.202614379,1870,5052,1626,821,1,820,1,189,0,0.02195122,empty,mBC-0716-1
"D2,A8",10130,10248,7636,2612,5503,0,2490,2492,1729,763,2.266055046,1176,1470,815,433,0,433,0,128,0,0.147806005,empty,mBC-0716-1
"D2,A9",17583,18025,13595,4430,9197,0,3916,3918,2749,1169,2.351582549,1843,1630,823,360,0,360,0,113,0,0.1,empty,mBC-0716-1
"D2,A10",14844,15175,11268,3907,7946,0,3599,3611,2550,1061,2.403393025,1713,309,198,131,0,131,0,51,0,0,empty,mBC-0716-1
"D2,A11",16538,16728,12723,4005,8976,0,4024,4040,2833,1207,2.347141674,1869,1084,658,307,0,307,0,96,0,0.078175896,empty,mBC-0716-1
"D2,A12",19835,20271,15239,5032,10496,0,4629,4640,3310,1330,2.488721805,2203,8433,3583,1761,2,1759,1,312,0,0.077316657,empty,mBC-0716-1
"D2,B1",17796,18327,13691,4636,9681,0,4300,4317,3049,1268,2.404574132,2043,970,673,353,0,353,0,90,0,0.141643059,empty,mBC-0716-1
"D2,B2",19431,19695,14833,4862,10333,0,4602,4612,3245,1367,2.373811266,2179,488,220,115,1,114,1,54,0,0.00877193,empty,mBC-0716-1
"D2,B3",17770,18289,13604,4685,9504,0,4170,4179,2948,1231,2.394800975,1961,1034,636,313,0,313,0,107,0,0.076677316,empty,mBC-0716-1
"D2,B4",15714,16045,12060,3985,8446,0,3691,3694,2631,1063,2.475070555,1722,1286,849,406,0,406,0,126,0,0.019704433,empty,mBC-0716-1
"D2,B5",9010,5763,4104,1659,3857,0,1830,1845,1252,593,2.111298482,983,672,418,209,0,209,0,86,0,0.043062201,empty,mBC-0716-1
"D2,B6",11388,11618,8678,2940,6265,0,2894,2897,1979,918,2.15577342,1369,1235,709,376,0,376,0,113,0,0.005319149,empty,mBC-0716-1
"D2,B7",15395,15976,11995,3981,8383,0,3643,3656,2544,1112,2.287769784,1695,890,567,280,0,280,0,74,0,0.082142857,empty,mBC-0716-1
"D2,B8",608952,634592,451205,183387,338189,1,170836,171155,135462,35693,3.795197938,86631,10798,7416,3435,1,3434,1,630,0,0.002912056,mm10,mBC-0716-1
"D2,B9",14099,14415,10884,3531,7590,0,3299,3308,2262,1046,2.162523901,1504,654,416,187,0,187,0,62,0,0.069518717,empty,mBC-0716-1
"D2,B10",15374,15351,11329,4022,8559,0,3940,3950,2729,1221,2.235053235,1926,401,222,124,0,124,0,44,0,0.064516129,empty,mBC-0716-1
"D2,B11",15482,15883,11857,4026,8308,0,3713,3719,2615,1104,2.36865942,1757,1390,437,250,0,250,0,68,0,0.012,empty,mBC-0716-1
"D2,B12",695461,765452,500109,265343,407971,1,227250,227615,185206,42409,4.367139051,123040,65948,45593,21095,10,21085,1,2005,0,0.001707375,mm10,mBC-0716-1
"D2,C1",22121,22146,16908,5238,11191,2,4787,4805,3402,1403,2.424803991,2214,8506,2804,1405,2,1403,2,242,0,0.156094084,empty,mBC-0716-1
"D2,C2",17336,17749,13067,4682,9304,0,4338,4342,3034,1308,2.319571865,2087,1540,978,491,0,491,0,155,0,0.018329939,empty,mBC-0716-1
"D2,C3",22378,23549,17063,6486,12379,0,5760,5780,4191,1589,2.637507867,2849,687,462,246,0,246,0,66,0,0.101626016,empty,mBC-0716-1
"D2,C4",16471,16420,12521,3899,8673,0,3836,3841,2764,1077,2.566388115,1769,3671,1429,752,0,752,0,185,0,0.136968085,empty,mBC-0716-1
"D2,C5",15008,15564,11359,4205,8185,0,3704,3720,2665,1055,2.526066351,1792,898,536,264,0,264,0,85,0,0.075757576,empty,mBC-0716-1
"D2,C6",15186,15428,11530,3898,8358,0,3782,3791,2632,1159,2.27092321,1820,1208,710,387,0,387,0,132,0,0.015503876,empty,mBC-0716-1
"D2,C7",659604,724575,471096,253479,385977,0,215835,216180,158675,57505,2.759325276,118309,21457,15346,7166,1,7165,1,984,0,0.001395673,mm10,mBC-0716-1
"D2,C8",14031,14674,10798,3876,7692,0,3557,3571,2489,1082,2.300369686,1700,1526,1007,512,0,512,0,136,0,0.052734375,empty,mBC-0716-1
"D2,C9",12047,12149,9244,2905,6325,0,2829,2838,2025,813,2.490774908,1300,592,359,173,0,173,0,57,0,0.063583815,empty,mBC-0716-1
"D2,C10",12706,13322,9538,3784,6981,0,3216,3225,2206,1019,2.164867517,1624,843,510,259,0,259,0,92,0,0.061776062,empty,mBC-0716-1
"D2,C11",11162,11629,8315,3314,6210,0,2983,2988,2009,979,2.052093973,1515,841,584,273,0,273,0,79,0,0.102564103,empty,mBC-0716-1
"D2,C12",18315,18938,13764,5174,9895,0,4534,4555,3150,1405,2.241992883,2237,1573,957,494,0,494,0,135,0,0.052631579,empty,mBC-0716-1
"D2,D1",527897,630782,330124,300658,337692,0,225901,226163,185042,41121,4.499939204,139732,75047,51042,23993,11,23982,1,2223,0,0.000917355,mm10,mBC-0716-1
"D2,D2",697922,757896,491418,266478,402202,1,233740,234046,172945,61101,2.830477406,127094,36503,23567,11043,2,11041,1,1477,0,0.011864867,mm10,mBC-0716-1
"D2,D3",12558,13142,9527,3615,7064,0,3343,3359,2385,974,2.448665298,1650,2754,1087,544,0,544,0,134,0,0.03125,empty,mBC-0716-1
"D2,D4",13220,13728,10171,3557,7134,0,3231,3236,2290,946,2.420718816,1503,948,591,289,0,289,0,99,0,0.006920415,empty,mBC-0716-1
"D2,D5",12683,12764,9552,3212,6889,0,3065,3068,2158,910,2.371428571,1513,1071,654,364,1,363,1,115,0,0.074380165,empty,mBC-0716-1
"D2,D6",11673,11927,8671,3256,6402,0,2999,3017,2101,916,2.293668122,1470,2645,1150,588,2,586,1,162,0,0.133105802,empty,mBC-0716-1
"D2,D7",12218,12483,9267,3216,6556,0,3007,3016,2059,957,2.151515152,1410,1317,853,438,1,437,1,158,0,0.091533181,empty,mBC-0716-1
"D2,D8",14354,14934,10797,4137,7969,0,3792,3800,2618,1182,2.214890017,1881,976,659,339,0,339,0,115,0,0.029498525,empty,mBC-0716-1
"D2,D9",4134,4345,3050,1295,2404,0,1177,1177,851,326,2.610429448,605,1695,927,467,0,467,0,124,0,0.03640257,empty,mBC-0716-1
"D2,D10",12629,13000,9626,3374,6891,0,3098,3104,2134,970,2.2,1502,848,451,233,0,233,0,81,0,0.017167382,empty,mBC-0716-1
"D2,D11",731386,786879,523343,263536,414427,0,226005,226362,191968,34394,5.581438623,119607,133482,94544,44858,19,44839,2,3011,0,0.001471933,mm10,mBC-0716-1
"D2,D12",19318,19629,14968,4661,10350,0,4656,4659,3176,1483,2.141604855,2183,2298,1266,625,0,625,0,183,0,0.0096,empty,mBC-0716-1
"D2,E1",1050843,1171453,706354,465099,609835,3,379738,380261,266754,113507,2.350110566,216389,63214,41004,19505,8,19497,1,1977,0,0.002410627,mm10,mBC-0716-1
"D2,E2",852863,963447,561808,401639,508661,2,330072,330515,253722,76793,3.303973018,192737,12415,7642,3676,2,3674,1,644,0,0.007893304,mm10,mBC-0716-1
"D2,E3",530796,585559,383041,202518,313619,1,171425,171721,140567,31154,4.512004879,92958,201109,141220,66979,33,66946,3,3898,0,0.000582559,mm10,mBC-0716-1
"D2,E4",14427,14830,11114,3716,7777,0,3479,3481,2420,1061,2.280867107,1611,1209,693,373,0,373,0,126,0,0.040214477,empty,mBC-0716-1
"D2,E5",19564,19791,15222,4569,10428,1,4495,4504,3138,1366,2.297218155,2040,1347,872,460,0,460,0,144,0,0.039130435,empty,mBC-0716-1
"D2,E6",462946,477579,333615,143964,255149,3,132578,132816,105479,27337,3.858470205,68591,12968,9204,4275,2,4273,1,764,0,0.003276387,mm10,mBC-0716-1
"D2,E7",12958,13033,9934,3099,6958,0,3086,3099,2114,985,2.146192893,1439,1802,831,424,0,424,0,120,0,0.047169811,empty,mBC-0716-1
"D2,E8",16695,16924,12938,3986,8930,0,3860,3864,2748,1116,2.462365591,1720,2734,1397,718,4,714,1,165,0,0.085434174,empty,mBC-0716-1
"D2,E9",8588,8835,6550,2285,4662,0,2153,2154,1546,608,2.542763158,1015,1231,687,339,1,338,1,99,0,0.047337278,empty,mBC-0716-1
"D2,E10",12049,12365,9285,3080,6616,0,3037,3044,2077,967,2.147880041,1395,1149,652,323,0,323,0,89,0,0.043343653,empty,mBC-0716-1
"D2,E11",8662,8909,6688,2221,4685,0,2120,2122,1496,626,2.389776358,980,1073,593,306,0,306,0,92,0,0.065359477,empty,mBC-0716-1
"D2,E12",13818,14427,10592,3835,7750,0,3580,3583,2478,1105,2.242533937,1789,1289,859,403,0,403,0,123,0,0.049627792,empty,mBC-0716-1
"D2,F1",16739,17138,12771,4367,9078,0,4044,4050,2809,1241,2.26349718,1924,1309,766,410,0,410,0,109,0,0.075609756,empty,mBC-0716-1
"D2,F2",1433451,1547971,1041546,506425,803369,2,431398,431987,352628,79359,4.443453169,230683,390620,278590,130700,46,130654,4,5471,0,0.000413305,mm10,mBC-0716-1
"D2,F3",15209,15967,11472,4495,8431,0,3963,3973,2702,1271,2.12588513,2027,1465,919,485,0,485,0,163,0,0.111340206,empty,mBC-0716-1
"D2,F4",16773,17276,12443,4833,9112,0,4198,4208,2986,1222,2.443535188,2086,6842,2388,1216,0,1216,0,224,0,0.121710526,empty,mBC-0716-1
"D2,F5",22221,22633,16951,5682,11897,0,5335,5347,3675,1672,2.197966507,2509,1335,789,407,1,406,1,134,0,0.0591133,empty,mBC-0716-1
"D2,F6",21637,21987,16549,5438,11625,1,5171,5184,3664,1520,2.410526316,2428,5748,2382,1149,1,1148,1,247,0,0.040940767,empty,mBC-0716-1
"D2,F7",18688,19053,14221,4832,10180,0,4600,4608,3163,1445,2.188927336,2166,2210,931,491,1,490,1,132,0,0.014285714,empty,mBC-0716-1
"D2,F8",21495,22231,16310,5921,11540,0,5165,5185,3637,1548,2.349483204,2502,297,185,101,0,101,0,46,0,0.00990099,empty,mBC-0716-1
"D2,F9",13785,13965,10584,3381,7496,0,3330,3334,2342,992,2.360887097,1543,1559,912,500,1,499,1,162,0,0.058116232,empty,mBC-0716-1
"D2,F10",19691,19835,15186,4649,10378,0,4415,4426,3115,1311,2.376048818,2025,1285,828,393,0,393,0,133,0,0.030534351,empty,mBC-0716-1
"D2,F11",844738,901341,617177,284164,469506,2,243372,243737,207059,36678,5.64531872,126730,130687,94773,44165,21,44144,2,3109,0,0.001495107,mm10,mBC-0716-1
"D2,F12",13239,13948,9978,3970,7194,0,3298,3309,2336,973,2.400822199,1625,149,85,41,0,41,0,16,0,0,empty,mBC-0716-1
"D2,G1",9880,10021,7743,2278,5323,0,2326,2332,1583,749,2.113484646,985,2057,1384,682,0,682,0,154,0,0.054252199,empty,mBC-0716-1
"D2,G2",1147394,1213236,826695,386541,621817,2,326865,327408,277108,50300,5.509105368,169805,43452,29197,13637,3,13634,1,1511,0,0.007114567,mm10,mBC-0716-1
"D2,G3",18388,18789,14072,4717,9698,0,4364,4369,3041,1328,2.289909639,2002,4613,1921,1027,3,1024,2,222,0,0.151367188,empty,mBC-0716-1
"D2,G4",26318,26709,20165,6544,14138,0,6162,6173,4312,1861,2.317033853,2935,60,42,29,0,29,0,19,0,0.137931034,empty,mBC-0716-1
"D2,G5",12493,12804,9497,3307,6759,0,3059,3071,2103,968,2.172520661,1488,1375,790,391,0,391,0,132,0,0.028132992,empty,mBC-0716-1
"D2,G6",23120,23860,18029,5831,12505,0,5551,5574,3920,1654,2.370012092,2650,137,67,40,0,40,0,25,0,0,empty,mBC-0716-1
"D2,G7",19350,19334,15070,4264,10270,0,4411,4420,3171,1249,2.538831065,1978,1716,1047,487,0,487,0,153,0,0.061601643,empty,mBC-0716-1
"D2,G8",13665,13960,10595,3365,7339,0,3226,3233,2267,966,2.34679089,1482,1671,1053,551,0,551,0,161,0,0.094373866,empty,mBC-0716-1
"D2,G9",9881,10072,7430,2642,5416,0,2470,2475,1699,776,2.18943299,1214,929,594,299,0,299,0,115,0,0.080267559,empty,mBC-0716-1
"D2,G10",12721,12909,9780,3129,6794,0,3077,3081,2139,942,2.270700637,1394,1466,976,450,0,450,0,145,0,0.057777778,empty,mBC-0716-1
"D2,G11",486811,506028,375182,130846,271106,1,120917,121122,83566,37556,2.225103845,59978,53917,38678,18141,14,18127,3,1893,0,0.002151487,mm10,mBC-0716-1
"D2,G12",745387,801251,547880,253371,424785,0,217397,217744,180539,37205,4.852546701,113858,149332,96640,45854,30,45824,3,3121,0,0.002815119,mm10,mBC-0716-1
"D2,H1",19669,20292,15036,5256,10649,0,4837,4855,3500,1355,2.58302583,2313,938,548,279,0,279,0,100,0,0.032258065,empty,mBC-0716-1
"D2,H2",864704,922011,650109,271902,480979,4,238130,238542,169169,69373,2.438542372,122110,107751,73904,34927,21,34906,3,2489,0,0.00105999,mm10,mBC-0716-1
"D2,H3",19111,19133,14648,4485,10130,0,4476,4487,3249,1238,2.624394184,2053,1381,924,453,0,453,0,137,0,0.052980132,empty,mBC-0716-1
"D2,H4",12746,12943,9645,3298,6846,0,3144,3148,2165,983,2.202441506,1526,205,123,43,0,43,0,17,0,0,empty,mBC-0716-1
"D2,H5",17125,17562,13024,4538,9297,0,4244,4253,3003,1250,2.4024,2053,1401,883,488,3,485,1,143,0,0.063917526,empty,mBC-0716-1
"D2,H6",13232,13758,9887,3871,7351,0,3386,3388,2474,914,2.70678337,1691,1597,1027,525,0,525,0,159,0,0.007619048,empty,mBC-0716-1
"D2,H7",15681,16003,11846,4157,8519,0,3837,3842,2749,1093,2.515096066,1841,1285,739,402,0,402,0,153,0,0.039800995,empty,mBC-0716-1
"D2,H8",12570,12950,9593,3357,6856,0,3144,3148,2215,933,2.374062165,1547,1624,994,511,0,511,0,137,0,0.039138943,empty,mBC-0716-1
"D2,H9",15683,15775,12007,3768,8495,0,3832,3837,2767,1070,2.585981308,1762,1144,754,379,0,379,0,103,0,0.044854881,empty,mBC-0716-1
"D2,H10",13556,13738,10104,3634,7167,0,3282,3290,2376,914,2.599562363,1586,15815,5039,2604,1,2603,1,467,0,0.062620054,empty,mBC-0716-1
"D2,H11",519620,559960,385044,174916,300448,1,149495,149748,125901,23847,5.279532017,78977,3982,2702,1369,0,1369,0,262,0,0,mm10,mBC-0716-1
"D2,H12",407395,437143,303589,133554,236336,0,118028,118231,94622,23609,4.007878351,61099,80389,55765,26422,6,26416,1,2288,0,0.001438522,mm10,mBC-0716-1
"D3,A1",617637,686530,429431,257099,368075,0,211492,211798,172145,39653,4.341285653,117682,213820,134541,64119,18,64101,3,3907,0,0.00533533,mm10,mBC-0716-1
"D3,A2",20023,20550,15361,5189,10968,0,4834,4845,3389,1456,2.32760989,2319,1669,1092,565,0,565,0,169,0,0.111504425,empty,mBC-0716-1
"D3,A3",17735,18290,13354,4936,9810,0,4530,4547,3180,1367,2.326261887,2314,1213,817,399,0,399,0,144,0,0.007518797,empty,mBC-0716-1
"D3,A4",22510,22847,17303,5544,11909,0,5213,5220,3717,1503,2.473053892,2459,5806,1716,854,0,854,0,189,0,0.049180328,empty,mBC-0716-1
"D3,A5",18225,18660,13845,4815,9866,0,4544,4552,3230,1322,2.443267776,2156,1877,1230,657,1,656,1,193,0,0.028963415,empty,mBC-0716-1
"D3,A6",14101,14884,10800,4084,7894,0,3729,3737,2615,1122,2.330659537,1845,2034,1275,622,0,622,0,213,0,0.053054662,empty,mBC-0716-1
"D3,A7",17150,17874,13038,4836,9401,0,4323,4334,3021,1313,2.300837776,2106,1579,963,497,0,497,0,158,0,0.052313883,empty,mBC-0716-1
"D3,A8",11654,12068,8927,3141,6440,0,2955,2961,2051,910,2.253846154,1386,1708,1103,589,1,588,1,196,0,0.013605442,empty,mBC-0716-1
"D3,A9",19236,19748,14761,4987,10352,0,4550,4567,3244,1323,2.452003023,2159,1872,1223,615,0,615,0,169,0,0.006504065,empty,mBC-0716-1
"D3,A10",16860,17042,12887,4155,9137,0,4137,4140,2918,1222,2.387888707,2003,598,414,164,0,164,0,67,0,0.018292683,empty,mBC-0716-1
"D3,A11",736386,786237,536275,249962,415009,3,214868,215234,183645,31589,5.813574346,112152,113379,81738,38636,14,38622,3,2947,0,0.001812439,mm10,mBC-0716-1
"D3,A12",20935,21150,15989,5161,11069,0,4946,4956,3490,1466,2.380627558,2318,3565,2150,1061,0,1061,0,250,0,0.087653157,empty,mBC-0716-1
"D3,B1",19485,19974,14863,5111,10586,0,4754,4765,3357,1408,2.384232955,2315,2008,1320,645,0,645,0,188,0,0.043410853,empty,mBC-0716-1
"D3,B2",788783,845588,579481,266107,447588,0,232245,232585,187948,44637,4.210587629,121597,54853,35463,17074,8,17066,2,1776,0,0.000878941,mm10,mBC-0716-1
"D3,B3",19857,20708,15217,5491,10823,0,4824,4835,3411,1424,2.395365169,2347,3551,1397,719,0,719,0,198,0,0.04867872,empty,mBC-0716-1
"D3,B4",16993,17562,13020,4542,9347,0,4314,4321,3069,1252,2.451277955,2037,1635,1018,553,0,553,0,179,0,0.056057866,empty,mBC-0716-1
"D3,B5",561858,332386,200612,131774,233241,6,137082,137869,111995,25874,4.328476463,81437,61901,43273,20547,6,20541,2,1959,0,0.001314444,mm10,mBC-0716-1
"D3,B6",12560,13009,9486,3523,7023,0,3348,3358,2361,997,2.368104313,1654,1687,1075,534,0,534,0,153,0,0.048689139,empty,mBC-0716-1
"D3,B7",17005,17266,12933,4333,9201,1,4115,4122,2959,1163,2.544282029,1933,5049,1906,1031,1,1030,1,230,0,0.030097087,empty,mBC-0716-1
"D3,B8",14108,14525,10797,3728,7809,0,3555,3558,2492,1066,2.337711069,1716,1301,732,410,0,410,0,153,0,0.082926829,empty,mBC-0716-1
"D3,B9",15901,16361,12028,4333,8550,0,3818,3829,2629,1200,2.190833333,1845,1211,770,422,0,422,0,104,0,0.030805687,empty,mBC-0716-1
"D3,B10",17313,17245,12717,4528,9398,0,4337,4352,3084,1268,2.432176656,2071,878,542,275,0,275,0,87,0,0.08,empty,mBC-0716-1
"D3,B11",17779,18322,13451,4871,9579,0,4378,4392,3068,1324,2.317220544,2158,1021,497,232,0,232,0,72,0,0.017241379,empty,mBC-0716-1
"D3,B12",19509,20210,14807,5403,10673,0,4982,4992,3522,1470,2.395918367,2336,1936,1186,579,0,579,0,179,0,0.074265976,empty,mBC-0716-1
"D3,C1",1107695,1146009,836264,309745,586720,3,276140,276621,230076,46545,4.943087335,135991,86136,59814,28623,13,28610,2,2501,0,0.003250612,mm10,mBC-0716-1
"D3,C2",20504,21603,15385,6218,11497,0,5408,5420,3821,1599,2.389618512,2791,2118,1365,723,0,723,0,222,0,0.017980636,empty,mBC-0716-1
"D3,C3",966905,1133328,632537,500791,591915,2,388691,389172,288155,101017,2.852539672,231164,63263,43837,20308,4,20304,1,1995,0,0.001379039,mm10,mBC-0716-1
"D3,C4",19151,19447,14547,4900,10402,0,4645,4654,3298,1356,2.432153392,2253,1914,1310,657,0,657,0,190,0,0.057838661,empty,mBC-0716-1
"D3,C5",16764,17231,12761,4470,9357,0,4310,4317,3092,1225,2.524081633,2120,1615,994,509,0,509,0,182,0,0.033398821,empty,mBC-0716-1
"D3,C6",18075,18719,13594,5125,10274,0,4828,4837,3429,1408,2.435369318,2423,1836,1223,647,0,647,0,206,0,0.040185471,empty,mBC-0716-1
"D3,C7",17590,18258,13477,4781,9590,0,4436,4448,3137,1311,2.392829901,2198,1100,449,263,0,263,0,94,0,0.011406844,empty,mBC-0716-1
"D3,C8",15717,16054,12010,4044,8541,0,3921,3932,2770,1162,2.383820998,1842,2315,1427,731,1,730,1,214,0,0.020547945,empty,mBC-0716-1
"D3,C9",13425,13635,10336,3299,7242,0,3300,3307,2303,1004,2.293824701,1513,1024,629,322,0,322,0,109,0,0.074534161,empty,mBC-0716-1
"D3,C10",15924,15896,11637,4259,8138,1,3868,3878,2774,1104,2.512681159,1766,26931,9164,4859,5,4854,3,647,0,0.208075814,empty,mBC-0716-1
"D3,C11",12076,12461,9120,3341,6824,0,3220,3229,2197,1032,2.128875969,1565,1238,864,409,0,409,0,127,0,0.034229829,empty,mBC-0716-1
"D3,C12",22387,22812,16963,5849,12002,0,5420,5440,3879,1561,2.484945548,2605,18669,6265,3083,4,3079,2,487,0,0.063981812,empty,mBC-0716-1
"D3,D1",12916,13517,9611,3906,7285,0,3529,3531,2547,984,2.588414634,1737,869,501,242,1,241,1,95,0,0.01659751,empty,mBC-0716-1
"D3,D2",21772,21827,16637,5190,11482,0,5046,5053,3586,1467,2.444444444,2296,23028,7874,3900,1,3899,1,661,0,0.049756348,empty,mBC-0716-1
"D3,D3",14640,15419,11087,4332,8262,0,3866,3877,2736,1141,2.397896582,1921,1473,979,473,0,473,0,160,0,0.069767442,empty,mBC-0716-1
"D3,D4",15075,15562,11360,4202,8266,0,3895,3899,2785,1114,2.5,1876,1812,1177,611,0,611,0,189,0,0.037643208,empty,mBC-0716-1
"D3,D5",761018,828966,543122,285844,439868,0,240626,240956,193670,47286,4.095715434,131357,103600,70325,33300,14,33286,3,2772,0,0.001712432,mm10,mBC-0716-1
"D3,D6",13244,13937,9990,3947,7403,0,3529,3533,2478,1055,2.348815166,1782,1527,959,496,0,496,0,149,0,0.040322581,empty,mBC-0716-1
"D3,D7",13731,14247,10230,4017,7604,0,3667,3671,2603,1068,2.437265918,1791,1725,1150,639,1,638,1,206,0,0.070532915,empty,mBC-0716-1
"D3,D8",740447,851321,512563,338758,453331,0,269431,269762,202310,67452,2.999318034,157511,105439,72228,34291,21,34270,4,2750,0,0.000700321,mm10,mBC-0716-1
"D3,D9",268428,274638,204423,70215,149927,0,65794,65887,49846,16041,3.107412256,32115,120635,76016,36622,15,36607,3,2896,0,0.006692709,mm10,mBC-0716-1
"D3,D10",14407,14899,10989,3910,7915,0,3644,3653,2576,1077,2.391829155,1754,1085,650,348,0,348,0,127,0,0.045977011,empty,mBC-0716-1
"D3,D11",14085,14517,10780,3737,7634,0,3446,3454,2458,996,2.467871486,1653,2120,1330,693,0,693,0,206,0,0.060606061,empty,mBC-0716-1
"D3,D12",21428,22088,16301,5787,11782,0,5400,5408,3761,1647,2.283545841,2627,5284,2681,1456,1,1455,1,339,0,0.068728522,empty,mBC-0716-1
"D3,E1",23030,23737,17509,6228,12564,0,5718,5735,4053,1682,2.409631391,2810,2209,1346,704,1,703,1,226,0,0.022759602,empty,mBC-0716-1
"D3,E2",643609,705905,453355,252550,377650,0,213288,213591,179819,33772,5.324499585,117979,177982,108075,52448,26,52422,5,3591,0,0.020182366,mm10,mBC-0716-1
"D3,E3",620700,670901,455470,215431,356505,2,185456,185750,157181,28569,5.501802653,97347,218375,141928,67467,32,67435,5,4109,0,0.002743383,mm10,mBC-0716-1
"D3,E4",16141,16448,12323,4125,8680,0,3973,3983,2774,1209,2.29445823,1855,1652,1051,548,0,548,0,176,0,0.167883212,empty,mBC-0716-1
"D3,E5",1421474,1610930,938436,672494,827562,3,529421,530179,432616,97563,4.43422199,304301,164858,116017,54707,29,54678,3,3531,0,0.000768133,mm10,mBC-0716-1
"D3,E6",38111,40468,29360,11108,21267,0,10170,10188,7382,2806,2.630791162,5022,2158,1331,686,0,686,0,194,0,0.075801749,empty,mBC-0716-1
"D3,E7",15290,15855,11806,4049,8265,0,3748,3756,2637,1119,2.356568365,1704,4302,1874,907,1,906,1,238,0,0.056291391,empty,mBC-0716-1
"D3,E8",1568008,1670107,1141372,528735,867538,4,464562,465304,382219,83085,4.600337004,242365,236324,158901,75434,28,75406,4,4429,0,0.001140493,mm10,mBC-0716-1
"D3,E9",1177409,1354246,776572,577674,714767,3,458847,459409,350946,108463,3.23562874,272085,296238,190934,90447,31,90416,7,4732,0,0.003273757,mm10,mBC-0716-1
"D3,E10",842208,977693,574599,403094,516447,3,321167,321554,256518,65036,3.944246264,186022,220039,148319,68386,20,68366,2,4046,0,0.001916157,mm10,mBC-0716-1
"D3,E11",1203353,1337541,829887,507654,713502,1,429349,429908,350901,79007,4.441391269,241156,209224,140341,65796,25,65771,2,4002,0,0.001657265,mm10,mBC-0716-1
"D3,E12",16109,16648,12215,4433,8874,0,4113,4123,2904,1219,2.382280558,1959,1504,865,466,0,466,0,160,0,0.06223176,empty,mBC-0716-1
"D3,F1",18163,18899,14041,4858,9981,0,4501,4511,3149,1362,2.312041116,2085,1847,1170,575,0,575,0,153,0,0.069565217,empty,mBC-0716-1
"D3,F2",24309,25278,18307,6971,13438,0,6293,6304,4429,1875,2.362133333,3134,26494,8846,4322,2,4320,2,727,0,0.086342593,empty,mBC-0716-1
"D3,F3",17815,18560,13356,5204,10053,0,4846,4862,3472,1390,2.497841727,2371,3417,1752,937,0,937,0,267,0,0.077908218,empty,mBC-0716-1
"D3,F4",1454218,1547573,1023457,524116,819166,1,452944,453550,367636,85914,4.279116326,244499,88422,58979,27980,9,27971,3,2464,0,0.001287047,mm10,mBC-0716-1
"D3,F5",732086,812543,503686,308857,431813,1,258577,258875,200534,58341,3.437273958,147819,18125,9466,4369,2,4367,2,894,0,0.02976872,mm10,mBC-0716-1
"D3,F6",25768,26293,19457,6836,14149,0,6587,6606,4692,1914,2.451410658,3182,2714,1701,853,1,852,1,255,0,0.063380282,empty,mBC-0716-1
"D3,F7",1636166,1726416,1234120,492296,903723,1,442068,442745,342294,100451,3.407571851,223749,146914,104790,50578,15,50563,1,3525,0,0.000257105,mm10,mBC-0716-1
"D3,F8",24195,24833,18420,6413,13169,0,6062,6073,4231,1842,2.296959826,2899,336,214,144,0,144,0,73,0,0.006944444,empty,mBC-0716-1
"D3,F9",16396,16674,12669,4005,9022,1,4051,4065,2885,1180,2.444915254,1860,2662,1755,883,0,883,0,245,0,0.069082673,empty,mBC-0716-1
"D3,F10",21426,21712,16496,5216,11482,0,4888,4903,3443,1460,2.358219178,2286,1903,1217,640,0,640,0,179,0,0.0515625,empty,mBC-0716-1
"D3,F11",12482,12782,9675,3107,6665,0,2941,2942,2103,839,2.506555423,1344,2242,1168,558,1,557,1,156,0,0.0502693,empty,mBC-0716-1
"D3,F12",14619,14896,11130,3766,7817,0,3489,3493,2406,1087,2.213431463,1710,162,96,40,0,40,0,22,0,0,empty,mBC-0716-1
"D3,G1",11009,11265,8485,2780,5934,0,2563,2576,1799,777,2.315315315,1173,6783,2737,1398,0,1398,0,303,0,0.035050072,empty,mBC-0716-1
"D3,G2",21229,21636,16051,5585,11289,0,5094,5106,3607,1499,2.406270847,2430,753,498,262,0,262,0,78,0,0.007633588,empty,mBC-0716-1
"D3,G3",21936,22756,16647,6109,11945,0,5546,5551,3919,1632,2.401348039,2692,2175,1355,691,0,691,0,236,0,0.05065123,empty,mBC-0716-1
"D3,G4",2335652,2561828,1654528,907300,1299541,2,757167,758239,603757,154482,3.90826763,413942,2290,1504,739,0,739,0,172,0,0.00270636,empty,mBC-0716-1
"D3,G5",14445,14833,11127,3706,7763,0,3519,3523,2456,1067,2.301780694,1676,1746,1039,526,0,526,0,164,0,0.074144487,empty,mBC-0716-1
"D3,G6",25890,26609,20105,6504,14139,0,6288,6300,4448,1852,2.401727862,3008,370,275,161,0,161,0,69,0,0.00621118,empty,mBC-0716-1
"D3,G7",20893,21426,16062,5364,11070,0,4825,4839,3427,1412,2.427053824,2207,5596,2074,1063,0,1063,0,285,0,0.031044214,empty,mBC-0716-1
"D3,G8",500581,549939,365212,184727,295741,3,160184,160410,119272,41138,2.899314502,86471,59203,39177,18483,7,18476,2,1853,0,0.006440788,mm10,mBC-0716-1
"D3,G9",11055,11323,8419,2904,6145,0,2885,2888,2005,883,2.270668177,1406,1689,1100,567,0,567,0,188,0,0.0335097,empty,mBC-0716-1
"D3,G10",14502,15043,11146,3897,7841,0,3521,3525,2407,1118,2.152951699,1654,1639,1067,558,1,557,1,186,0,0.059245961,empty,mBC-0716-1
"D3,G11",13186,13525,10148,3377,7198,3,3188,3196,2325,871,2.66934558,1520,1264,771,431,0,431,0,151,0,0.023201856,empty,mBC-0716-1
"D3,G12",11970,12535,9145,3390,6718,0,3100,3104,2189,915,2.392349727,1505,1553,955,500,0,500,0,137,0,0.016,empty,mBC-0716-1
"D3,H1",22766,23678,17122,6556,12521,0,5782,5790,4123,1667,2.473305339,2921,1411,807,430,2,428,1,146,0,0.044392523,empty,mBC-0716-1
"D3,H2",25095,25610,19197,6413,13278,0,5954,5969,4204,1765,2.381869688,2750,2372,1525,770,0,770,0,221,0,0.087012987,empty,mBC-0716-1
"D3,H3",21850,22411,16630,5781,11929,0,5463,5467,3887,1580,2.460126582,2618,2227,1275,613,1,612,1,197,0,0.026143791,empty,mBC-0716-1
"D3,H4",14774,15540,11374,4166,8245,0,3820,3828,2692,1136,2.36971831,1849,162,86,51,0,51,0,40,0,0,empty,mBC-0716-1
"D3,H5",911264,1016398,637049,379349,530731,0,301493,301918,258751,43167,5.994185373,170424,11853,4721,2296,1,2295,1,519,0,0.022657952,mm10,mBC-0716-1
"D3,H6",16237,16716,12225,4491,9059,0,4171,4178,2949,1229,2.399511798,2064,2647,1755,870,0,870,0,287,0,0.010344828,empty,mBC-0716-1
"D3,H7",18935,19558,14302,5256,10595,1,4982,4995,3530,1465,2.409556314,2423,2293,1436,717,0,717,0,232,0,0.071129707,empty,mBC-0716-1
"D3,H8",737179,816570,517029,299541,430308,3,246685,247008,188281,58727,3.206038109,137512,152994,97767,47914,16,47898,3,3407,0,0.003862374,mm10,mBC-0716-1
"D3,H9",17027,17605,12915,4690,9454,0,4354,4357,3184,1173,2.714407502,2117,1594,1051,559,0,559,0,181,0,0.017889088,empty,mBC-0716-1
"D3,H10",17304,17971,13077,4894,9483,0,4436,4448,3169,1279,2.477716966,2195,1402,832,481,0,481,0,148,0,0.035343035,empty,mBC-0716-1
"D3,H11",18085,18911,13642,5269,10215,0,4804,4813,3349,1464,2.287568306,2380,231,141,101,1,100,1,53,0,0.04,empty,mBC-0716-1
"D3,H12",6715,6789,5111,1678,3697,0,1676,1683,1201,482,2.491701245,821,654,362,204,0,204,0,90,0,0.073529412,empty,mBC-0716-1
"D4,A1",809796,903480,553874,349606,487355,1,296073,296465,222918,73547,3.030959794,168028,57411,35904,16922,7,16915,1,1804,0,0.002364765,mm10,mBC-0716-1
"D4,A2",19932,20054,14908,5146,10486,0,4667,4681,3374,1307,2.581484315,2149,9042,3432,1770,0,1770,0,353,0,0.248587571,empty,mBC-0716-1
"D4,A3",704859,752664,511254,241410,402428,0,214968,215270,172073,43197,3.983447925,112992,61856,42744,20062,6,20056,2,1935,0,0.000249302,mm10,mBC-0716-1
"D4,A4",20760,21086,15914,5172,11058,0,4857,4866,3478,1388,2.505763689,2257,670,412,212,0,212,0,64,0,0.051886792,empty,mBC-0716-1
"D4,A5",762397,846114,530763,315351,453882,2,268905,269261,216383,52878,4.092117705,149486,185478,109284,51408,23,51385,3,3478,0,0.00437871,mm10,mBC-0716-1
"D4,A6",15460,15936,11957,3979,8556,0,3915,3917,2893,1024,2.825195313,1847,1538,1018,541,0,541,0,149,0,0.038817006,empty,mBC-0716-1
"D4,A7",16252,16963,12260,4703,9232,0,4375,4382,2994,1388,2.157060519,2203,4503,1868,916,1,915,1,200,0,0.044808743,empty,mBC-0716-1
"D4,A8",11085,11297,8341,2956,6234,0,2941,2950,2103,847,2.482880756,1444,14652,4597,2171,2,2169,2,422,0,0.083448594,empty,mBC-0716-1
"D4,A9",18787,19188,14408,4780,10088,0,4445,4450,3169,1281,2.473848556,2077,1568,827,446,0,446,0,119,0,0.105381166,empty,mBC-0716-1
"D4,A10",17540,18058,13270,4788,9830,0,4699,4704,3279,1425,2.301052632,2250,680,297,160,0,160,0,59,0,0.0375,empty,mBC-0716-1
"D4,A11",636024,720595,413936,306659,389967,3,260957,261337,206323,55014,3.750372632,152112,5310,3544,1592,0,1592,0,392,0,0.008165829,mm10,mBC-0716-1
"D4,A12",20045,20384,15458,4926,10772,0,4696,4709,3311,1398,2.368383405,2160,2806,1677,853,0,853,0,206,0,0.05978898,empty,mBC-0716-1
"D4,B1",18460,19082,14370,4712,10022,0,4468,4476,3098,1378,2.248185776,2087,1435,885,443,0,443,0,107,0,0.074492099,empty,mBC-0716-1
"D4,B2",20162,20876,15469,5407,10932,0,4872,4882,3465,1417,2.445306987,2308,690,334,151,0,151,0,57,0,0.158940397,empty,mBC-0716-1
"D4,B3",935633,1013796,678477,335319,533936,2,287581,287971,235631,52340,4.50192969,153562,108478,70436,32975,16,32959,3,2705,0,0.001092266,mm10,mBC-0716-1
"D4,B4",16237,16826,12438,4388,8872,1,4077,4090,2939,1151,2.553431798,1976,1196,736,408,1,407,1,115,0,0.039312039,empty,mBC-0716-1
"D4,B5",9239,5586,3901,1685,3866,0,1858,1871,1286,585,2.198290598,1002,2518,975,475,0,475,0,111,0,0.029473684,empty,mBC-0716-1
"D4,B6",11869,12379,8994,3385,6643,0,3168,3172,2216,956,2.317991632,1490,1260,789,426,0,426,0,111,0,0.070422535,empty,mBC-0716-1
"D4,B7",15707,16171,12266,3905,8784,0,3740,3753,2643,1110,2.381081081,1795,1242,726,356,0,356,0,107,0,0.039325843,empty,mBC-0716-1
"D4,B8",638655,661980,476371,185609,352589,0,168308,168592,145351,23241,6.254076847,83520,131895,88584,42311,16,42295,3,3010,0,0.00198605,mm10,mBC-0716-1
"D4,B9",14589,14901,11147,3754,7884,0,3580,3591,2467,1124,2.194839858,1747,592,349,190,0,190,0,62,0,0.015789474,empty,mBC-0716-1
"D4,B10",16651,16238,12204,4034,9039,0,4112,4132,2787,1345,2.072118959,1979,1087,563,289,0,289,0,87,0,0.152249135,empty,mBC-0716-1
"D4,B11",15945,16005,12229,3776,8547,0,3801,3808,2672,1136,2.352112676,1743,219,156,85,0,85,0,42,0,0,empty,mBC-0716-1
"D4,B12",17833,18427,13674,4753,9782,0,4448,4452,3123,1329,2.349887133,2085,1322,816,436,0,436,0,116,0,0.149082569,empty,mBC-0716-1
"D4,C1",1218033,1304201,867819,436382,671280,1,370128,370674,297233,73441,4.047235196,197406,53506,36961,17724,5,17719,2,1744,0,0.001636661,mm10,mBC-0716-1
"D4,C2",514155,543139,383055,160084,293603,0,147116,147362,103563,43799,2.364506039,75749,56806,35275,16985,7,16978,1,1843,0,0.007480269,mm10,mBC-0716-1
"D4,C3",21829,22352,16262,6090,11799,0,5613,5625,3891,1734,2.243944637,2797,677,447,221,0,221,0,72,0,0.076923077,empty,mBC-0716-1
"D4,C4",17590,17932,13539,4393,9633,0,4290,4296,3005,1291,2.327652982,2043,3179,1593,832,1,831,1,189,0,0.072202166,empty,mBC-0716-1
"D4,C5",15965,16567,12145,4422,8887,0,4136,4143,2939,1204,2.4410299,2019,1049,648,365,1,364,1,117,0,0.027472527,empty,mBC-0716-1
"D4,C6",17070,17404,12988,4416,9630,0,4483,4490,3286,1204,2.72923588,2137,1589,1027,516,1,515,1,136,0,0.027184466,empty,mBC-0716-1
"D4,C7",16149,16509,12232,4277,8953,0,4152,4158,2920,1238,2.358642973,1951,575,311,149,0,149,0,67,0,0,empty,mBC-0716-1
"D4,C8",15109,15664,11592,4072,8387,0,3879,3887,2660,1227,2.167889161,1847,1687,999,507,0,507,0,161,0,0.027613412,empty,mBC-0716-1
"D4,C9",12445,13051,9288,3763,7027,0,3304,3313,2276,1037,2.194792671,1657,907,503,258,0,258,0,76,0,0,empty,mBC-0716-1
"D4,C10",541971,579411,397856,181555,313391,0,162196,162445,124478,37967,3.278584034,84899,89191,61448,28917,15,28902,2,2470,0,0.003044772,mm10,mBC-0716-1
"D4,C11",11273,11709,8462,3247,6266,0,2952,2971,2084,887,2.349492672,1504,6770,2229,1157,3,1154,2,217,0,0.070190641,empty,mBC-0716-1
"D4,C12",19901,20487,15036,5451,11047,0,5118,5135,3684,1451,2.538938663,2425,1143,683,372,0,372,0,131,0,0.064516129,empty,mBC-0716-1
"D4,D1",11896,12366,8768,3598,6716,0,3262,3274,2331,943,2.471898197,1647,872,483,242,0,242,0,69,0,0.074380165,empty,mBC-0716-1
"D4,D2",20225,20661,15787,4874,10963,0,4665,4668,3255,1413,2.303609342,2154,2849,1754,877,0,877,0,223,0,0.058152794,empty,mBC-0716-1
"D4,D3",13928,14405,10488,3917,7890,0,3729,3746,2648,1098,2.411657559,1886,1407,769,421,1,420,1,121,0,0.073809524,empty,mBC-0716-1
"D4,D4",14201,14796,10771,4025,7954,0,3703,3705,2635,1070,2.462616822,1824,5080,1991,940,0,940,0,235,0,0.041489362,empty,mBC-0716-1
"D4,D5",14344,14992,10926,4066,8068,0,3779,3784,2734,1050,2.603809524,1878,1380,966,504,0,504,0,130,0,0.021825397,empty,mBC-0716-1
"D4,D6",12114,12655,9169,3486,6871,0,3241,3243,2284,959,2.38164755,1609,1290,835,422,0,422,0,130,0,0.016587678,empty,mBC-0716-1
"D4,D7",13284,13879,9984,3895,7321,0,3341,3351,2316,1035,2.237681159,1658,1778,1066,556,0,556,0,155,0,0.073741007,empty,mBC-0716-1
"D4,D8",15794,16409,12012,4397,8843,0,4111,4117,2952,1165,2.533905579,2013,1041,658,344,0,344,0,110,0,0.055232558,empty,mBC-0716-1
"D4,D9",6124,6428,4492,1936,3563,0,1814,1816,1314,502,2.61752988,940,5984,2437,1194,0,1194,0,225,0,0.054438861,empty,mBC-0716-1
"D4,D10",13582,13955,10537,3418,7512,1,3491,3498,2426,1072,2.263059701,1575,983,613,329,0,329,0,110,0,0.024316109,empty,mBC-0716-1
"D4,D11",13031,13515,9808,3707,7364,0,3428,3431,2473,958,2.581419624,1692,7891,3121,1494,0,1494,0,278,0,0.035475234,empty,mBC-0716-1
"D4,D12",20046,20189,15408,4781,10659,0,4706,4720,3298,1422,2.319268636,2179,2987,1851,891,0,891,0,242,0,0.056116723,empty,mBC-0716-1
"D4,E1",22063,22715,16842,5873,12061,0,5408,5423,3780,1643,2.300669507,2664,1767,1065,553,0,553,0,157,0,0.050632911,empty,mBC-0716-1
"D4,E2",16192,16687,12186,4501,8959,3,4067,4079,2930,1149,2.550043516,1896,2616,1423,651,1,650,1,143,0,0.066153846,empty,mBC-0716-1
"D4,E3",12029,12476,9292,3184,6718,0,3021,3026,2127,899,2.36596218,1450,2032,1109,553,1,552,1,173,0,0.065217391,empty,mBC-0716-1
"D4,E4",15629,16332,11994,4338,8556,0,3881,3886,2774,1112,2.494604317,1892,4311,1776,871,1,870,1,214,0,0.050574713,empty,mBC-0716-1
"D4,E5",1070542,1211217,716581,494636,638944,1,405839,406358,297379,108979,2.728773433,233900,77241,53047,24931,11,24920,1,2245,0,0.002247191,mm10,mBC-0716-1
"D4,E6",13584,13930,10410,3520,7556,0,3400,3407,2428,979,2.480081716,1622,1573,877,479,0,479,0,128,0,0.041753653,empty,mBC-0716-1
"D4,E7",13796,13970,10511,3459,7604,0,3415,3426,2365,1061,2.229029218,1583,1235,788,420,0,420,0,127,0,0.011904762,empty,mBC-0716-1
"D4,E8",17013,17236,13157,4079,9268,0,4058,4071,2867,1204,2.381229236,1837,2148,1485,721,0,721,0,208,0,0.015256588,empty,mBC-0716-1
"D4,E9",9276,9831,7083,2748,5355,0,2504,2507,1786,721,2.477115118,1266,1453,808,416,0,416,0,128,0,0.040865385,empty,mBC-0716-1
"D4,E10",12877,13634,9813,3821,7252,0,3351,3358,2370,988,2.398785425,1652,3230,1391,718,0,718,0,185,0,0.080779944,empty,mBC-0716-1
"D4,E11",9571,10211,7352,2859,5532,0,2616,2621,1790,831,2.154031288,1323,831,503,230,0,230,0,93,0,0.017391304,empty,mBC-0716-1
"D4,E12",547072,598027,395295,202732,322781,1,172183,172454,149581,22873,6.53963188,92353,114406,82156,38280,13,38267,2,2842,0,0.000679437,mm10,mBC-0716-1
"D4,F1",17047,17695,13009,4686,9346,0,4158,4165,2854,1311,2.17696415,2030,1595,910,447,1,446,1,117,0,0.040358744,empty,mBC-0716-1
"D4,F2",685610,755853,467835,288018,403337,1,241992,242335,177557,64778,2.74100775,136064,86746,60860,28664,15,28649,1,2497,0,0.004188628,mm10,mBC-0716-1
"D4,F3",829748,965259,547441,417818,514079,0,331887,332276,273923,58353,4.694240228,196455,129458,91017,42578,11,42567,3,3077,0,0.001198111,mm10,mBC-0716-1
"D4,F4",17782,18225,13409,4816,10052,1,4621,4636,3248,1388,2.340057637,2210,771,483,283,0,283,0,104,0,0.003533569,empty,mBC-0716-1
"D4,F5",23612,24215,17858,6357,12889,0,5876,5893,4172,1721,2.424171993,2829,1885,1261,651,0,651,0,195,0,0.041474654,empty,mBC-0716-1
"D4,F6",23089,23898,17727,6171,12829,0,5841,5854,4119,1735,2.374063401,2801,2631,1644,826,0,826,0,226,0,0.036319613,empty,mBC-0716-1
"D4,F7",19521,20284,15256,5028,10988,0,4889,4904,3468,1436,2.415041783,2273,970,634,307,0,307,0,109,0,0.039087948,empty,mBC-0716-1
"D4,F8",22529,23265,17134,6131,12510,0,5852,5860,4112,1748,2.352402746,2869,383,233,128,0,128,0,53,0,0.0078125,empty,mBC-0716-1
"D4,F9",15211,15540,11746,3794,8466,0,3644,3646,2605,1041,2.502401537,1758,2211,1449,736,0,736,0,193,0,0.07201087,empty,mBC-0716-1
"D4,F10",19791,20126,15351,4775,10596,0,4592,4598,3209,1389,2.310295176,2095,1333,796,425,0,425,0,134,0,0.054117647,empty,mBC-0716-1
"D4,F11",11566,11986,8853,3133,6360,0,2817,2821,1973,848,2.326650943,1372,1154,814,421,1,420,1,118,0,0.019047619,empty,mBC-0716-1
"D4,F12",13646,13986,10341,3645,7453,0,3429,3434,2397,1037,2.31147541,1619,79,56,33,0,33,0,15,0,0,empty,mBC-0716-1
"D4,G1",9768,9768,7587,2181,5264,0,2283,2288,1633,655,2.493129771,1007,2207,1315,603,1,602,1,175,0,0.064784053,empty,mBC-0716-1
"D4,G2",20441,20991,15549,5442,11091,0,5139,5142,3609,1533,2.354207436,2431,2790,1129,557,1,556,1,132,0,0.028776978,empty,mBC-0716-1
"D4,G3",708122,727332,541892,185440,384302,2,170069,170443,139087,31356,4.435737977,81878,174916,125923,59947,21,59926,2,3718,0,0.001067984,mm10,mBC-0716-1
"D4,G4",1852066,1980063,1360353,619710,1022938,1,541385,542200,436130,106070,4.111718676,283777,1996,1283,633,0,633,0,150,0,0.003159558,empty,mBC-0716-1
"D4,G5",13149,13486,9996,3490,7253,0,3334,3348,2328,1020,2.282352941,1582,1382,791,416,1,415,1,124,0,0.144578313,empty,mBC-0716-1
"D4,G6",24490,24965,19150,5815,13241,0,5849,5863,4154,1709,2.430661205,2626,200,95,66,0,66,0,36,0,0.075757576,empty,mBC-0716-1
"D4,G7",19910,20278,15414,4864,10759,0,4714,4726,3336,1390,2.4,2183,1776,1058,549,1,548,1,165,0,0.034671533,empty,mBC-0716-1
"D4,G8",775078,839900,566471,273429,443510,0,234329,234682,200562,34120,5.878135991,124323,203121,128376,61257,23,61234,2,3765,0,0.018698762,mm10,mBC-0716-1
"D4,G9",11230,12044,8511,3533,6320,0,2972,2977,2060,917,2.246455834,1551,2463,1247,659,0,659,0,182,0,0.042488619,empty,mBC-0716-1
"D4,G10",13265,13423,10289,3134,7167,0,3176,3180,2237,943,2.372216331,1426,1574,1027,523,0,523,0,169,0,0.028680688,empty,mBC-0716-1
"D4,G11",12462,12731,9465,3266,6809,0,3073,3077,2180,897,2.4303233,1453,704,468,255,0,255,0,107,0,0.011764706,empty,mBC-0716-1
"D4,G12",11553,11709,8749,2960,6287,0,2872,2878,1979,899,2.201334816,1330,5707,2060,1056,0,1056,0,219,0,0.053030303,empty,mBC-0716-1
"D4,H1",21019,21907,15905,6002,11847,0,5507,5516,3926,1590,2.46918239,2737,1420,918,442,0,442,0,130,0,0.135746606,empty,mBC-0716-1
"D4,H2",25478,26179,19324,6855,14049,0,6404,6416,4673,1743,2.681009753,3087,2455,1559,732,1,731,1,182,0,0.039671683,empty,mBC-0716-1
"D4,H3",1003257,1138022,658365,479657,597156,0,387559,388052,276896,111156,2.491057613,225882,59752,41052,19145,5,19140,1,1984,0,0.002142111,mm10,mBC-0716-1
"D4,H4",13626,14015,10328,3687,7544,0,3530,3535,2549,986,2.585192698,1689,150,94,53,0,53,0,23,0,0,empty,mBC-0716-1
"D4,H5",18458,18923,14096,4827,10115,0,4704,4716,3431,1285,2.670038911,2173,1528,999,461,2,459,1,142,0,0.034858388,empty,mBC-0716-1
"D4,H6",14820,15717,11257,4460,8392,0,4051,4063,2873,1190,2.414285714,2029,1670,1108,537,0,537,0,177,0,0.067039106,empty,mBC-0716-1
"D4,H7",1248813,1328273,905553,422720,709023,2,377234,377822,293060,84762,3.457445553,201123,123215,84952,40142,15,40127,1,3250,0,0.000423655,mm10,mBC-0716-1
"D4,H8",14191,14971,10688,4283,8054,0,3801,3810,2722,1088,2.501838235,1968,8114,2983,1495,1,1494,1,307,0,0.058902276,empty,mBC-0716-1
"D4,H9",655055,689206,478774,210432,370653,0,188499,188754,162678,26076,6.238610216,97105,117646,74842,35912,18,35894,4,2818,0,0.003343177,mm10,mBC-0716-1
"D4,H10",16623,17266,12347,4919,9256,0,4413,4418,3180,1238,2.568659128,2250,8556,3019,1502,0,1502,0,297,0,0.084553928,empty,mBC-0716-1
"D4,H11",17519,18267,13275,4992,9850,0,4658,4668,3236,1432,2.259776536,2347,172,121,74,0,74,0,45,0,0,empty,mBC-0716-1
"D4,H12",6439,6713,4782,1931,3638,0,1755,1756,1228,528,2.325757576,914,918,607,287,0,287,0,85,0,0,empty,mBC-0716-1
"D5,A1",13361,13766,10163,3603,7487,0,3462,3473,2368,1105,2.142986425,1645,1070,704,337,0,337,0,99,0,0.008902077,empty,mBC-0716-1
"D5,A2",17765,18072,13528,4544,9576,0,4133,4143,2877,1266,2.272511848,1996,1189,766,400,0,400,0,117,0,0.0775,empty,mBC-0716-1
"D5,A3",16510,16656,12485,4171,8918,0,4024,4035,2865,1170,2.448717949,1917,3427,1171,544,0,544,0,131,0,0.044117647,empty,mBC-0716-1
"D5,A4",20728,20741,16009,4732,10850,0,4660,4669,3322,1347,2.466221232,2125,633,337,157,0,157,0,50,0,0.089171975,empty,mBC-0716-1
"D5,A5",16081,16309,12369,3940,8769,0,3849,3856,2615,1241,2.107171636,1810,1718,1014,483,0,483,0,108,0,0.064182195,empty,mBC-0716-1
"D5,A6",427406,448710,319269,129441,244131,0,121610,121854,88220,33634,2.622941072,60995,54062,27653,13404,11,13393,2,1654,0,0.025461062,mm10,mBC-0716-1
"D5,A7",768784,804805,576067,228738,426671,1,206771,207140,179573,27567,6.514056662,103454,108727,73979,35486,12,35474,1,2758,0,0.000704742,mm10,mBC-0716-1
"D5,A8",10841,11207,8261,2946,6011,0,2798,2801,1920,881,2.179341657,1363,1508,822,414,1,413,1,137,0,0.043583535,empty,mBC-0716-1
"D5,A9",18217,18627,14014,4613,9703,0,4211,4218,2964,1254,2.363636364,1990,1486,697,402,0,402,0,100,0,0.119402985,empty,mBC-0716-1
"D5,A10",14724,15425,11128,4297,8075,0,3595,3597,2515,1082,2.324399261,1752,377,238,117,0,117,0,52,0,0,empty,mBC-0716-1
"D5,A11",17202,17265,13201,4064,9310,0,4035,4044,2806,1238,2.266558966,1875,884,513,289,0,289,0,106,0,0.041522491,empty,mBC-0716-1
"D5,A12",1018894,1123767,696958,426809,587774,3,355290,355765,252167,103598,2.434091392,201457,141865,93346,44067,16,44051,3,3196,0,0.00143016,mm10,mBC-0716-1
"D5,B1",845251,942479,585705,356774,501844,0,304458,304825,235945,68880,3.425450058,169882,31835,19829,9515,4,9511,1,1280,0,0.007570182,mm10,mBC-0716-1
"D5,B2",860738,917193,627435,289758,483244,1,252859,253288,212204,41084,5.16512511,132633,1359,712,342,1,341,1,144,0,0.014662757,empty,mBC-0716-1
"D5,B3",18274,18661,14270,4391,9866,0,4404,4414,3058,1356,2.255162242,2011,1131,688,349,0,349,0,111,0,0.077363897,empty,mBC-0716-1
"D5,B4",16047,16856,12486,4370,8969,0,4036,4042,2812,1230,2.286178862,1916,1012,525,275,1,274,1,110,0,0.080291971,empty,mBC-0716-1
"D5,B5",464525,263506,187857,75649,181494,5,86770,87357,67341,20016,3.364358513,46393,3919,2604,1241,1,1240,1,292,0,0.011290323,mm10,mBC-0716-1
"D5,B6",617970,651865,462485,189380,348577,1,168910,169202,141883,27319,5.193564918,85134,105897,73785,35407,19,35388,1,2812,0,0.00031084,mm10,mBC-0716-1
"D5,B7",16308,16697,12646,4051,8955,0,3978,3991,2745,1246,2.203049759,1830,1074,512,256,0,256,0,92,0,0.171875,empty,mBC-0716-1
"D5,B8",13181,13556,10173,3383,7139,0,3147,3154,2201,953,2.309548793,1494,2025,998,546,0,546,0,130,0,0.076923077,empty,mBC-0716-1
"D5,B9",671256,748034,479603,268431,399415,0,227180,227515,152962,74553,2.051721594,127672,15454,11172,5278,0,5278,0,822,0,0.000947329,mm10,mBC-0716-1
"D5,B10",547725,532795,366498,166297,297561,3,151586,152358,126937,25421,4.993391291,79818,18193,12757,6155,2,6153,1,856,0,0.003900536,mm10,mBC-0716-1
"D5,B11",16524,17015,12637,4378,9105,0,4132,4138,2944,1194,2.465661642,2008,233,177,96,0,96,0,43,0,0.020833333,empty,mBC-0716-1
"D5,B12",18267,18643,13810,4833,9972,0,4506,4522,3218,1304,2.467791411,2149,1210,721,359,0,359,0,105,0,0.019498607,empty,mBC-0716-1
"D5,C1",22749,22157,17538,4619,11540,0,4786,4796,3490,1306,2.672281776,2096,3917,1299,693,0,693,0,154,0,0.057720058,empty,mBC-0716-1
"D5,C2",18017,18585,13652,4933,9970,2,4667,4684,3221,1463,2.201640465,2260,1890,1259,593,0,593,0,174,0,0.067453626,empty,mBC-0716-1
"D5,C3",19810,20206,15050,5156,10770,1,4913,4921,3360,1561,2.152466368,2447,585,392,186,0,186,0,57,0,0.182795699,empty,mBC-0716-1
"D5,C4",16730,17030,13026,4004,9035,0,3968,3980,2706,1274,2.124018838,1809,1044,688,360,0,360,0,119,0,0.019444444,empty,mBC-0716-1
"D5,C5",15718,16072,12128,3944,8605,0,3872,3877,2731,1146,2.383071553,1810,1094,679,360,0,360,0,104,0,0.016666667,empty,mBC-0716-1
"D5,C6",15965,16374,12073,4301,9136,0,4219,4223,2980,1243,2.397425583,2013,1252,786,391,0,391,0,123,0,0.043478261,empty,mBC-0716-1
"D5,C7",15304,16021,11769,4252,8503,0,3904,3915,2707,1208,2.24089404,1897,323,197,112,0,112,0,47,0,0,empty,mBC-0716-1
"D5,C8",14885,15042,11100,3942,8196,0,3839,3845,2635,1210,2.17768595,1896,8210,2880,1429,1,1428,1,258,0,0.137955182,empty,mBC-0716-1
"D5,C9",12556,13016,9450,3566,6883,0,3117,3120,2196,924,2.376623377,1420,1354,815,455,0,455,0,104,0,0.232967033,empty,mBC-0716-1
"D5,C10",13442,13959,10342,3617,7579,0,3434,3443,2310,1133,2.038834951,1667,848,530,277,0,277,0,96,0,0.010830325,empty,mBC-0716-1
"D5,C11",11291,11854,8597,3257,6386,0,3033,3042,2149,893,2.406494961,1499,885,528,235,0,235,0,69,0,0.008510638,empty,mBC-0716-1
"D5,C12",717525,771774,524860,246914,406180,3,209386,209782,175675,34107,5.150702202,110342,90451,63114,29931,10,29921,2,2463,0,0.000935798,mm10,mBC-0716-1
"D5,D1",10280,10675,7769,2906,5778,0,2701,2709,1888,821,2.299634592,1318,6436,1853,948,0,948,0,203,0,0.008438819,empty,mBC-0716-1
"D5,D2",20262,20671,15634,5037,11071,0,4921,4926,3496,1430,2.444755245,2276,2165,1358,650,0,650,0,183,0,0.087692308,empty,mBC-0716-1
"D5,D3",13080,13664,9903,3761,7247,0,3424,3430,2417,1013,2.385982231,1686,3672,1239,644,0,644,0,155,0,0.069875776,empty,mBC-0716-1
"D5,D4",1624264,1745161,1163132,582029,917150,2,520896,521725,349406,172319,2.027669613,284000,56563,28684,13550,9,13541,3,1935,0,0.006351082,mm10,mBC-0716-1
"D5,D5",13304,13773,10102,3671,7323,0,3384,3389,2386,1003,2.37886341,1656,1698,754,380,0,380,0,118,0,0.039473684,empty,mBC-0716-1
"D5,D6",11968,12550,8993,3557,6612,0,3068,3071,2116,955,2.215706806,1514,1334,912,420,0,420,0,128,0,0.04047619,empty,mBC-0716-1
"D5,D7",559475,577343,423968,153375,309995,2,140067,140298,119430,20868,5.723116734,68598,141755,99049,47057,19,47038,3,3132,0,0.000786598,mm10,mBC-0716-1
"D5,D8",15431,15779,11651,4128,8362,0,3905,3912,2631,1281,2.053864169,1850,758,515,254,0,254,0,88,0,0.051181102,empty,mBC-0716-1
"D5,D9",4166,4230,3058,1172,2403,0,1178,1180,850,330,2.575757576,558,1552,802,413,1,412,1,125,0,0.067961165,empty,mBC-0716-1
"D5,D10",14160,14764,10827,3937,7752,0,3521,3528,2464,1064,2.315789474,1649,690,453,249,0,249,0,73,0,0.112449799,empty,mBC-0716-1
"D5,D11",13491,13740,10178,3562,7341,0,3295,3304,2262,1042,2.170825336,1566,1705,951,505,1,504,1,134,0,0.087301587,empty,mBC-0716-1
"D5,D12",19951,20121,15365,4756,10663,0,4835,4845,3331,1514,2.2001321,2187,2067,1259,610,0,610,0,189,0,0.054098361,empty,mBC-0716-1
"D5,E1",20791,21133,16063,5070,11127,0,4881,4894,3422,1472,2.324728261,2194,1382,816,431,0,431,0,117,0,0.046403712,empty,mBC-0716-1
"D5,E2",15457,15505,11756,3749,8285,0,3607,3612,2514,1098,2.289617486,1694,1472,884,491,0,491,0,138,0,0.030549898,empty,mBC-0716-1
"D5,E3",541123,559419,399598,159821,300643,3,148186,148421,108524,39897,2.720104268,75509,53316,27120,13093,6,13087,1,1615,0,0.038205853,mm10,mBC-0716-1
"D5,E4",14918,15284,11530,3754,8056,1,3535,3546,2439,1107,2.203252033,1660,3276,1309,673,0,673,0,191,0,0.038632987,empty,mBC-0716-1
"D5,E5",20207,20517,15551,4966,10936,0,4739,4747,3348,1399,2.393137956,2156,1243,745,369,0,369,0,117,0,0.111111111,empty,mBC-0716-1
"D5,E6",13029,13419,10010,3409,7002,0,3058,3066,2117,949,2.230769231,1438,1228,793,439,1,438,1,113,0,0.052511416,empty,mBC-0716-1
"D5,E7",14030,14073,10685,3388,7530,0,3245,3262,2240,1022,2.191780822,1565,1095,671,343,1,342,1,110,0,0.002923977,empty,mBC-0716-1
"D5,E8",17100,17648,13182,4466,9361,0,4129,4136,2857,1279,2.233776388,2033,3247,1667,867,2,865,2,196,0,0.068208092,empty,mBC-0716-1
"D5,E9",8695,9040,6497,2543,4791,0,2174,2174,1461,713,2.049088359,1092,1094,682,334,0,334,0,110,0,0,empty,mBC-0716-1
"D5,E10",736851,831117,501064,330053,445912,0,277752,278116,188912,89204,2.117752567,160202,17244,11894,5800,2,5798,1,928,0,0.005174198,mm10,mBC-0716-1
"D5,E11",8635,8951,6624,2327,4955,0,2340,2344,1597,747,2.137884873,1130,5798,1934,1007,4,1003,2,223,0,0.033898305,empty,mBC-0716-1
"D5,E12",14408,14996,10985,4011,7886,0,3551,3561,2439,1122,2.173796791,1690,1047,695,366,0,366,0,107,0,0.068306011,empty,mBC-0716-1
"D5,F1",17469,17630,13440,4190,9374,0,4108,4118,2895,1223,2.367130008,1862,1211,793,424,0,424,0,109,0,0.054245283,empty,mBC-0716-1
"D5,F2",21533,21982,16404,5578,11784,0,5358,5386,3724,1662,2.240673887,2604,7275,2757,1374,0,1374,0,296,0,0.045123726,empty,mBC-0716-1
"D5,F3",15261,16136,11649,4487,8714,0,4115,4131,2835,1296,2.1875,2085,2137,1287,674,0,674,0,187,0,0.054896142,empty,mBC-0716-1
"D5,F4",15641,15707,11756,3951,8579,0,3880,3892,2680,1212,2.211221122,1807,5800,1577,837,1,836,1,189,0,0.029904306,empty,mBC-0716-1
"D5,F5",23656,24225,18175,6050,12591,0,5526,5539,3942,1597,2.468378209,2567,1401,807,460,0,460,0,167,0,0.030434783,empty,mBC-0716-1
"D5,F6",22917,23926,17202,6724,12732,0,5848,5871,4124,1747,2.360618203,2880,2643,1625,778,1,777,1,204,0,0.042471042,empty,mBC-0716-1
"D5,F7",639062,641222,488471,152751,350296,0,154649,154909,116374,38535,3.019955884,73275,31261,15274,7606,2,7604,2,1034,0,0.021173067,mm10,mBC-0716-1
"D5,F8",3105927,3352742,2220474,1132268,1705475,5,979015,980484,802533,177951,4.509853836,523795,46751,32558,15498,6,15492,1,1821,0,0.001226439,mm10,mBC-0716-1
"D5,F9",699669,739361,528801,210560,394646,0,187297,187585,151526,36059,4.202168668,94465,104196,73555,35143,13,35130,1,2717,0,0.001138628,mm10,mBC-0716-1
"D5,F10",22012,22654,16968,5686,12003,1,5269,5289,3721,1568,2.373086735,2506,1311,858,454,1,453,1,121,0,0.059602649,empty,mBC-0716-1
"D5,F11",10676,11152,8166,2986,5967,0,2664,2672,1806,866,2.085450346,1342,1021,655,328,0,328,0,101,0,0.051829268,empty,mBC-0716-1
"D5,F12",13772,13990,10345,3645,7608,0,3476,3479,2426,1053,2.303893637,1693,128,85,49,0,49,0,17,0,0.081632653,empty,mBC-0716-1
"D5,G1",9708,9735,7533,2202,5320,0,2314,2326,1594,732,2.177595628,1017,1464,901,457,0,457,0,130,0,0.050328228,empty,mBC-0716-1
"D5,G2",20181,20208,15468,4740,10640,0,4623,4630,3235,1395,2.318996416,2057,473,325,134,0,134,0,47,0,0.044776119,empty,mBC-0716-1
"D5,G3",19015,19537,14657,4880,10354,0,4620,4628,3246,1382,2.348769899,2157,1740,1108,549,1,548,1,162,0,0.060218978,empty,mBC-0716-1
"D5,G4",27267,27688,20908,6780,14548,0,6305,6314,4402,1912,2.302301255,2966,95,51,34,0,34,0,23,0,0,empty,mBC-0716-1
"D5,G5",13019,13240,9841,3399,7084,0,3207,3219,2245,974,2.304928131,1539,10821,3280,1615,4,1611,2,325,0,0.029795158,empty,mBC-0716-1
"D5,G6",931983,1013695,661273,352422,536125,4,305481,305957,220014,85943,2.559999069,165223,4148,2844,1399,0,1399,0,263,0,0,mm10,mBC-0716-1
"D5,G7",19893,20461,15324,5137,10869,0,4851,4868,3375,1493,2.26054923,2285,2043,1283,646,0,646,0,167,0,0.06501548,empty,mBC-0716-1
"D5,G8",14474,14716,11068,3648,7749,0,3511,3517,2410,1107,2.177055104,1620,1683,928,495,0,495,0,160,0,0.056565657,empty,mBC-0716-1
"D5,G9",10172,10432,7736,2696,5587,0,2526,2529,1753,776,2.259020619,1188,1115,744,385,0,385,0,130,0,0.057142857,empty,mBC-0716-1
"D5,G10",13098,13450,9973,3477,7179,0,3247,3253,2326,927,2.509169364,1525,12316,4122,2174,1,2173,1,393,0,0.043258168,empty,mBC-0716-1
"D5,G11",11971,12189,9064,3125,6529,0,2998,3003,2095,908,2.307268722,1387,773,533,286,0,286,0,94,0,0,empty,mBC-0716-1
"D5,G12",11592,11558,8792,2766,6116,0,2746,2759,1922,837,2.296296296,1228,1448,923,449,0,449,0,123,0,0.080178174,empty,mBC-0716-1
"D5,H1",781955,825687,585563,240124,438040,0,213282,213661,177743,35918,4.948577315,108213,59916,40703,19237,3,19234,2,1887,0,0.001975668,mm10,mBC-0716-1
"D5,H2",25574,26177,19551,6626,13784,2,6286,6308,4524,1784,2.535874439,3011,2660,1423,718,0,718,0,190,0,0.038997214,empty,mBC-0716-1
"D5,H3",18929,19420,14408,5012,10369,0,4777,4788,3355,1433,2.341242149,2324,2104,925,509,0,509,0,156,0,0.055009823,empty,mBC-0716-1
"D5,H4",12823,13183,9762,3421,6909,0,3106,3108,2138,970,2.204123711,1518,126,91,47,0,47,0,19,0,0,empty,mBC-0716-1
"D5,H5",17341,18150,13131,5019,9664,0,4439,4451,3203,1248,2.56650641,2189,1510,947,482,0,482,0,136,0,0.070539419,empty,mBC-0716-1
"D5,H6",13298,13899,9823,4076,7296,0,3405,3418,2365,1053,2.245963913,1685,12023,3814,1920,0,1920,0,368,0,0.054166667,empty,mBC-0716-1
"D5,H7",815340,917779,548535,369244,490915,1,302834,303222,229733,73489,3.126086897,175678,80879,50949,24092,9,24083,2,2311,0,0.00419383,mm10,mBC-0716-1
"D5,H8",555999,580885,414573,166312,311308,0,152673,152955,118388,34567,3.424885006,76769,57376,37078,17802,7,17795,1,1952,0,0.003989885,mm10,mBC-0716-1
"D5,H9",570942,610319,405879,204440,330350,1,180114,180355,150837,29518,5.110000678,96375,57981,40771,19603,7,19596,2,1943,0,0.002653603,mm10,mBC-0716-1
"D5,H10",13216,13682,9934,3748,7244,0,3361,3369,2362,1007,2.345580933,1639,2664,1026,519,1,518,1,127,0,0.036679537,empty,mBC-0716-1
"D5,H11",765798,916328,490803,425525,489217,1,330089,330451,257453,72998,3.526850051,201603,3146,2055,1001,0,1001,0,183,0,0.000999001,mm10,mBC-0716-1
"D5,H12",851515,909719,629897,279822,489383,1,245939,246338,207996,38342,5.424756142,128510,188064,119895,57176,21,57155,4,3846,0,0.000664859,mm10,mBC-0716-1
"D6,A1",13685,13893,10393,3500,7655,0,3524,3533,2436,1097,2.220601641,1649,1084,696,371,0,371,0,124,0,0.086253369,empty,mBC-0716-1
"D6,A2",18600,18746,14287,4459,9769,0,4234,4242,3045,1197,2.543859649,1935,1761,1107,581,0,581,0,144,0,0.144578313,empty,mBC-0716-1
"D6,A3",16414,16899,12367,4532,8941,0,4092,4099,2846,1253,2.271348763,1950,1313,776,362,0,362,0,125,0,0.046961326,empty,mBC-0716-1
"D6,A4",21508,21466,16624,4842,11386,0,4930,4940,3463,1477,2.344617468,2227,698,432,236,0,236,0,72,0,0.038135593,empty,mBC-0716-1
"D6,A5",17109,17655,13148,4507,9458,1,4249,4262,2988,1274,2.345368917,1974,1638,931,487,0,487,0,154,0,0.020533881,empty,mBC-0716-1
"D6,A6",15133,15723,11370,4353,8513,0,4095,4105,2931,1174,2.496592845,2018,1828,1184,584,0,584,0,184,0,0.068493151,empty,mBC-0716-1
"D6,A7",1116418,1195026,802251,392775,638101,0,349661,350218,271244,78974,3.434598729,184842,82333,58577,28274,8,28266,2,2654,0,0.001238237,mm10,mBC-0716-1
"D6,A8",11135,11737,8442,3295,6280,0,2933,2947,2033,914,2.22428884,1454,1600,986,509,0,509,0,166,0,0.035363458,empty,mBC-0716-1
"D6,A9",1072195,1117072,806755,310317,576585,3,272988,273525,233231,40294,5.788231498,134785,219276,152840,73824,27,73797,1,3994,0,0.002452674,mm10,mBC-0716-1
"D6,A10",15825,16218,12051,4167,8562,0,3784,3796,2633,1163,2.263972485,1819,902,375,197,0,197,0,77,0,0,empty,mBC-0716-1
"D6,A11",17715,18114,13450,4664,9654,0,4343,4357,3077,1280,2.40390625,2037,1596,1076,587,2,585,1,162,0,0.022222222,empty,mBC-0716-1
"D6,A12",20929,21387,16220,5167,11025,0,4819,4828,3390,1438,2.35744089,2187,3021,1851,908,0,908,0,208,0,0.042951542,empty,mBC-0716-1
"D6,B1",19499,19966,14774,5192,10533,0,4792,4804,3358,1446,2.322268326,2297,2787,1340,676,0,676,0,189,0,0.050295858,empty,mBC-0716-1
"D6,B2",20510,20313,15707,4606,10953,0,4689,4695,3252,1443,2.253638254,2159,811,494,251,0,251,0,90,0,0.039840637,empty,mBC-0716-1
"D6,B3",20054,21026,15269,5757,11041,0,5087,5099,3603,1496,2.40842246,2516,1722,1037,500,0,500,0,153,0,0.132,empty,mBC-0716-1
"D6,B4",887781,1029050,586407,442643,549581,1,361744,362212,258907,103305,2.506238807,215456,8577,5744,2741,1,2740,1,536,0,0.00620438,mm10,mBC-0716-1
"D6,B5",482325,308824,196931,111893,210225,2,116154,116739,89501,27238,3.285887363,66624,72779,48273,22826,15,22811,4,2218,0,0.001534347,mm10,mBC-0716-1
"D6,B6",11799,12399,8979,3420,6606,0,3065,3074,2088,986,2.117647059,1583,1312,883,421,1,420,1,105,0,0.04047619,empty,mBC-0716-1
"D6,B7",15883,16344,12313,4031,8741,0,3823,3830,2605,1225,2.126530612,1761,1126,771,426,0,426,0,126,0,0.011737089,empty,mBC-0716-1
"D6,B8",863012,933786,606782,327004,492784,2,278790,279175,233726,45449,5.142599397,151208,66289,47204,22559,3,22556,1,2136,0,0.001551694,mm10,mBC-0716-1
"D6,B9",15411,15787,11571,4216,8294,0,3680,3689,2585,1104,2.341485507,1779,1461,689,345,0,345,0,112,0,0.188405797,empty,mBC-0716-1
"D6,B10",810088,796127,528592,267535,437770,5,236285,237538,171785,65753,2.612580415,128714,19721,13220,6328,3,6325,1,898,0,0.000632411,mm10,mBC-0716-1
"D6,B11",16245,16652,12402,4250,8759,0,3905,3913,2743,1170,2.344444444,1841,1183,311,181,0,181,0,68,0,0,empty,mBC-0716-1
"D6,B12",18016,18396,13749,4647,9956,0,4448,4458,3082,1376,2.239825581,2052,3687,1521,810,0,810,0,184,0,0.140740741,empty,mBC-0716-1
"D6,C1",23356,23326,18210,5116,12039,0,4981,4989,3463,1526,2.269331586,2166,2901,1053,557,1,556,1,139,0,0.09352518,empty,mBC-0716-1
"D6,C2",19256,19947,14293,5654,10649,1,5001,5014,3528,1486,2.374158816,2521,2320,1512,786,0,786,0,206,0,0.053435115,empty,mBC-0716-1
"D6,C3",20497,20661,15425,5236,10891,0,4932,4952,3495,1457,2.398764585,2323,4170,1443,777,1,776,1,164,0,0.135309278,empty,mBC-0716-1
"D6,C4",17270,17535,13223,4312,9288,0,4028,4036,2797,1239,2.257465698,1859,1616,1019,512,0,512,0,150,0,0.025390625,empty,mBC-0716-1
"D6,C5",15926,16248,12007,4241,8733,0,4025,4037,2804,1233,2.274128143,1969,1366,900,480,0,480,0,153,0,0.089583333,empty,mBC-0716-1
"D6,C6",16286,16566,12346,4220,9027,0,4149,4158,2926,1232,2.375,1944,5827,2474,1287,1,1286,1,271,0,0.076982893,empty,mBC-0716-1
"D6,C7",15891,16267,12162,4105,8771,0,4041,4054,2793,1261,2.214908803,2000,488,323,173,1,172,1,69,0,0.040697674,empty,mBC-0716-1
"D6,C8",14990,15070,11083,3987,8044,0,3692,3698,2602,1096,2.374087591,1767,14295,5095,2589,2,2587,2,501,0,0.025898724,empty,mBC-0716-1
"D6,C9",600393,645691,437863,207828,347332,0,178572,178898,150791,28107,5.364891308,94559,98229,66005,31718,21,31697,3,2694,0,0.00719311,mm10,mBC-0716-1
"D6,C10",492468,507013,375147,131866,275740,0,127066,127259,100507,26752,3.756990132,61585,26479,15846,7653,2,7651,1,1128,0,0.006927199,mm10,mBC-0716-1
"D6,C11",1579295,1705589,1147698,557891,889051,4,484912,485758,407627,78131,5.217224917,256986,171918,111572,53430,25,53405,5,3733,0,0.00468121,mm10,mBC-0716-1
"D6,C12",841289,958152,563218,394934,503050,3,316859,317315,250867,66448,3.775388274,183912,58705,41769,19752,6,19746,1,1910,0,0.001873797,mm10,mBC-0716-1
"D6,D1",11027,11184,8235,2949,6047,0,2833,2836,1952,884,2.208144796,1391,714,373,210,0,210,0,78,0,0.004761905,empty,mBC-0716-1
"D6,D2",21943,22466,16909,5557,11817,0,5076,5081,3570,1511,2.362673726,2374,9148,3709,1828,3,1825,1,367,0,0.055342466,empty,mBC-0716-1
"D6,D3",13500,13929,10167,3762,7418,0,3383,3398,2311,1087,2.126034959,1647,1452,893,475,0,475,0,163,0,0.037894737,empty,mBC-0716-1
"D6,D4",710695,789968,511289,278679,422093,1,230862,231179,193389,37790,5.117464938,126833,148776,102452,48312,21,48291,2,3383,0,0.000973266,mm10,mBC-0716-1
"D6,D5",13713,14221,10427,3794,7588,0,3561,3565,2510,1055,2.379146919,1774,10924,3437,1661,1,1660,1,352,0,0.021084337,empty,mBC-0716-1
"D6,D6",12360,12735,9400,3335,6789,0,3170,3173,2214,959,2.308654849,1499,1538,1025,534,0,534,0,151,0,0.065543071,empty,mBC-0716-1
"D6,D7",13046,13700,9788,3912,7207,0,3405,3411,2357,1054,2.236242884,1709,1814,1178,635,0,635,0,199,0,0.05984252,empty,mBC-0716-1
"D6,D8",16166,16947,12244,4703,8937,0,4268,4273,2974,1299,2.289453426,2087,1017,647,332,0,332,0,136,0,0.057228916,empty,mBC-0716-1
"D6,D9",197411,205567,140452,65115,113751,0,57800,57882,50484,7398,6.824006488,30578,198203,141871,67943,26,67917,4,3799,0,0.000456439,mm10,mBC-0716-1
"D6,D10",13924,14359,10630,3729,7705,0,3566,3575,2405,1170,2.055555556,1720,1018,623,349,0,349,0,118,0,0.085959885,empty,mBC-0716-1
"D6,D11",13074,13526,9929,3597,7229,0,3249,3266,2228,1038,2.146435453,1600,1495,922,519,0,519,0,174,0,0.06743738,empty,mBC-0716-1
"D6,D12",20668,21108,15897,5211,11132,0,5070,5082,3421,1661,2.059602649,2383,2844,1773,905,0,905,0,248,0,0.085082873,empty,mBC-0716-1
"D6,E1",984357,1007187,744587,262600,526202,1,244735,245188,198440,46748,4.244887482,117971,143295,95119,45043,15,45028,1,3202,0,0.001932131,mm10,mBC-0716-1
"D6,E2",16100,16426,12198,4228,8831,0,3959,3973,2777,1196,2.321906355,1855,3416,1684,893,0,893,0,243,0,0.0806271,empty,mBC-0716-1
"D6,E3",12276,12661,9304,3357,6861,0,3086,3090,2170,920,2.358695652,1476,13881,4969,2541,3,2538,1,461,0,0.057525611,empty,mBC-0716-1
"D6,E4",659304,713231,478288,234943,380191,2,200220,200529,173410,27119,6.394409823,106918,140343,97252,46294,16,46278,3,3216,0,0.000259302,mm10,mBC-0716-1
"D6,E5",21110,21718,16323,5395,11426,0,5068,5074,3617,1457,2.482498284,2350,1596,1019,567,0,567,0,177,0,0.029982363,empty,mBC-0716-1
"D6,E6",13274,13426,9984,3442,7180,0,3273,3281,2239,1042,2.148752399,1575,6454,2293,1164,1,1163,1,232,0,0.079965606,empty,mBC-0716-1
"D6,E7",13978,14145,10615,3530,7436,0,3359,3366,2278,1088,2.09375,1586,4415,1751,904,0,904,0,224,0,0.043141593,empty,mBC-0716-1
"D6,E8",17144,17462,13203,4259,9372,0,4044,4065,2805,1260,2.226190476,1871,2464,1492,750,1,749,1,213,0,0.037383178,empty,mBC-0716-1
"D6,E9",9063,9208,6844,2364,4889,0,2265,2269,1612,657,2.453576865,1048,1290,757,414,0,414,0,130,0,0.028985507,empty,mBC-0716-1
"D6,E10",1118568,1215874,774547,441327,632861,2,368603,369137,308311,60826,5.068737053,201433,251258,144327,70340,29,70311,3,4056,0,0.007893502,mm10,mBC-0716-1
"D6,E11",9448,9718,7130,2588,5281,0,2407,2414,1642,772,2.126943005,1197,1217,862,430,0,430,0,152,0,0.020930233,empty,mBC-0716-1
"D6,E12",15142,15676,11564,4112,8438,0,3809,3811,2660,1151,2.311033884,1829,1186,783,396,0,396,0,134,0,0.015151515,empty,mBC-0716-1
"D6,F1",17778,18480,13528,4952,9799,0,4517,4535,3156,1379,2.288614938,2201,1809,1184,587,0,587,0,148,0,0.066439523,empty,mBC-0716-1
"D6,F2",22373,23211,17179,6032,12447,0,5771,5785,4065,1720,2.363372093,2758,3074,2047,1071,0,1071,0,288,0,0.052287582,empty,mBC-0716-1
"D6,F3",552453,596951,402272,194679,325480,1,175157,175420,133099,42321,3.144987122,94030,20880,14011,6750,5,6745,1,1046,0,0.008598962,mm10,mBC-0716-1
"D6,F4",1308449,1379998,948787,431211,739145,1,394335,394976,307507,87469,3.515611245,206931,61602,42095,19551,8,19543,1,2099,0,0.001637415,mm10,mBC-0716-1
"D6,F5",24302,24841,18588,6253,13179,0,5910,5916,4104,1812,2.264900662,2824,2063,1297,657,1,656,1,198,0,0.021341463,empty,mBC-0716-1
"D6,F6",23146,23554,17512,6042,12601,0,5764,5780,4074,1706,2.388042204,2715,2761,1745,909,0,909,0,269,0,0.055005501,empty,mBC-0716-1
"D6,F7",20268,20778,15551,5227,11138,0,4965,4976,3477,1499,2.319546364,2379,989,645,350,0,350,0,121,0,0.06,empty,mBC-0716-1
"D6,F8",22362,23346,16907,6439,12423,0,5833,5839,4171,1668,2.50059952,2805,308,192,123,0,123,0,61,0,0,empty,mBC-0716-1
"D6,F9",15354,15906,11826,4080,8412,0,3881,3898,2736,1162,2.354561102,1876,2443,1579,855,0,855,0,245,0,0.033918129,empty,mBC-0716-1
"D6,F10",21215,21804,16644,5160,11444,0,4924,4940,3437,1503,2.286759814,2240,1953,1260,619,0,619,0,153,0,0.040387722,empty,mBC-0716-1
"D6,F11",706014,771591,499155,272436,411825,0,232595,232951,187732,45219,4.151617683,126435,109459,76941,36719,14,36705,2,2886,0,0.001825364,mm10,mBC-0716-1
"D6,F12",14507,15027,11104,3923,8048,1,3728,3740,2561,1179,2.172179813,1842,155,80,47,0,47,0,24,0,0,empty,mBC-0716-1
"D6,G1",11148,11129,8398,2731,5877,0,2622,2627,1766,861,2.051103368,1220,12052,4151,2089,1,2088,1,401,0,0.096264368,empty,mBC-0716-1
"D6,G2",790785,808246,597755,210491,428875,2,202303,202662,156416,46246,3.382260087,98004,12771,6155,2987,3,2984,1,530,0,0.006367292,mm10,mBC-0716-1
"D6,G3",19823,20717,15182,5535,10768,3,4861,4865,3353,1512,2.217592593,2345,2300,1507,806,0,806,0,232,0,0.009925558,empty,mBC-0716-1
"D6,G4",28298,28858,21698,7160,15136,0,6592,6603,4606,1997,2.30645969,3122,157,103,74,0,74,0,37,0,0,empty,mBC-0716-1
"D6,G5",13161,13536,9900,3636,7174,0,3319,3322,2323,999,2.325325325,1605,1345,879,449,0,449,0,127,0,0.073496659,empty,mBC-0716-1
"D6,G6",24356,24804,18909,5895,13041,0,5549,5565,3825,1740,2.198275862,2543,281,170,102,0,102,0,50,0,0,empty,mBC-0716-1
"D6,G7",20297,20456,15637,4819,10821,0,4784,4794,3361,1433,2.34542917,2165,3345,1893,1002,1,1001,1,246,0,0.07992008,empty,mBC-0716-1
"D6,G8",14339,14603,10896,3707,7912,0,3652,3658,2521,1137,2.217238347,1741,1709,1064,538,0,538,0,188,0,0.079925651,empty,mBC-0716-1
"D6,G9",10623,10915,8212,2703,5859,0,2624,2630,1795,835,2.149700599,1229,1317,862,459,0,459,0,176,0,0.021786492,empty,mBC-0716-1
"D6,G10",13697,13833,10555,3278,7417,0,3307,3314,2290,1024,2.236328125,1513,3312,1601,821,0,821,0,225,0,0.049939099,empty,mBC-0716-1
"D6,G11",1175252,1314141,794437,519704,679230,0,417138,417702,344730,72972,4.724140766,235135,139266,98589,46519,15,46504,1,3221,0,0.000107518,mm10,mBC-0716-1
"D6,G12",11472,11971,8696,3275,6439,0,3003,3007,2063,944,2.185381356,1440,1454,969,514,0,514,0,149,0,0.029182879,empty,mBC-0716-1
"D6,H1",20447,20843,15571,5272,11070,0,4945,4961,3458,1503,2.30073187,2320,1290,847,421,1,420,1,143,0,0.05952381,empty,mBC-0716-1
"D6,H2",23553,24022,18166,5856,12632,0,5606,5619,3955,1664,2.376802885,2635,2242,1542,807,0,807,0,220,0,0.059479554,empty,mBC-0716-1
"D6,H3",19819,20204,14975,5229,10665,0,4869,4875,3394,1481,2.291694801,2288,2706,1416,673,0,673,0,189,0,0.014858841,empty,mBC-0716-1
"D6,H4",13079,13617,10010,3607,7309,0,3380,3385,2309,1076,2.145910781,1667,195,122,59,0,59,0,32,0,0.101694915,empty,mBC-0716-1
"D6,H5",18359,18842,14002,4840,9812,0,4442,4452,3102,1350,2.297777778,2110,1865,1229,648,0,648,0,199,0,0.098765432,empty,mBC-0716-1
"D6,H6",1192617,1301194,855903,445291,690313,0,375445,376016,285765,90251,3.166336107,207172,467231,315098,151482,46,151436,4,5669,0,0.002647983,mm10,mBC-0716-1
"D6,H7",17386,17662,13259,4403,9590,0,4299,4313,3040,1273,2.388059701,2018,1798,1137,606,1,605,1,224,0,0.024793388,empty,mBC-0716-1
"D6,H8",13613,14042,10305,3737,7412,0,3355,3360,2432,928,2.620689655,1638,4474,1867,985,0,985,0,261,0,0.020304569,empty,mBC-0716-1
"D6,H9",15697,15886,11800,4086,8394,0,3818,3825,2681,1144,2.343531469,1832,1219,766,377,0,377,0,140,0,0.061007958,empty,mBC-0716-1
"D6,H10",13921,14121,10734,3387,7487,0,3256,3272,2258,1014,2.226824458,1493,1517,1009,529,0,529,0,171,0,0.034026465,empty,mBC-0716-1
"D6,H11",17280,18108,13124,4984,9489,0,4405,4412,3112,1300,2.393846154,2131,230,127,84,0,84,0,43,0,0,empty,mBC-0716-1
"D6,H12",436380,458697,319559,139138,249756,1,128082,128310,102512,25798,3.973641368,66245,25325,16693,7881,0,7881,0,1081,0,0.001903312,mm10,mBC-0716-1
"D7,A1",13956,14312,10583,3729,7830,0,3711,3727,2632,1095,2.403652968,1733,917,626,290,0,290,0,89,0,0.04137931,empty,mBC-0716-1
"D7,A2",17982,18287,13677,4610,9627,0,4255,4265,3012,1253,2.403830806,2008,1423,713,322,0,322,0,96,0,0.068322981,empty,mBC-0716-1
"D7,A3",15772,16338,12037,4301,8592,0,3962,3977,2814,1163,2.419604471,1915,643,360,184,0,184,0,59,0,0.119565217,empty,mBC-0716-1
"D7,A4",19585,19935,15109,4826,10269,0,4405,4419,3114,1305,2.386206897,2020,457,292,115,0,115,0,47,0,0.034782609,empty,mBC-0716-1
"D7,A5",15838,16237,12109,4128,8683,0,3946,3951,2728,1223,2.23058054,1930,1395,779,397,1,396,1,117,0,0,empty,mBC-0716-1
"D7,A6",20967,22609,15848,6761,12203,0,5992,6009,4365,1644,2.655109489,3056,1031,651,285,0,285,0,89,0,0.049122807,empty,mBC-0716-1
"D7,A7",15030,15535,11693,3842,8276,0,3744,3751,2620,1131,2.316534041,1757,921,590,308,0,308,0,85,0,0.097402597,empty,mBC-0716-1
"D7,A8",10148,10382,7675,2707,5487,0,2433,2437,1669,768,2.173177083,1179,1169,764,430,0,430,0,106,0,0.113953488,empty,mBC-0716-1
"D7,A9",17656,18117,13550,4567,9414,0,4162,4165,2870,1295,2.216216216,1923,3453,1310,646,1,645,1,140,0,0.071317829,empty,mBC-0716-1
"D7,A10",14299,14447,10981,3466,7614,1,3378,3383,2353,1030,2.284466019,1572,317,231,123,0,123,0,37,0,0.048780488,empty,mBC-0716-1
"D7,A11",16515,17106,12719,4387,9030,0,4100,4110,2933,1177,2.491928632,1935,1038,618,277,0,277,0,72,0,0.003610108,empty,mBC-0716-1
"D7,A12",18675,19000,14299,4701,9990,0,4391,4393,3117,1276,2.442789969,2065,1880,1065,541,1,540,1,134,0,0.040740741,empty,mBC-0716-1
"D7,B1",17733,18104,13743,4361,9360,0,4151,4168,2907,1261,2.305313243,1911,765,476,254,0,254,0,83,0,0.023622047,empty,mBC-0716-1
"D7,B2",944214,1107393,594581,512812,584239,2,400153,400621,261119,139502,1.871793953,244505,16433,8904,4268,2,4266,1,639,0,0.007735584,mm10,mBC-0716-1
"D7,B3",17198,17722,13337,4385,9432,0,4209,4214,2982,1232,2.420454545,2000,762,461,248,0,248,0,79,0,0.092741935,empty,mBC-0716-1
"D7,B4",15455,16152,11793,4359,8378,0,3837,3844,2741,1103,2.485040798,1865,1000,593,307,0,307,0,87,0,0.026058632,empty,mBC-0716-1
"D7,B5",8713,5443,3817,1626,3655,1,1706,1726,1204,522,2.30651341,932,1050,415,192,0,192,0,64,0,0.020833333,empty,mBC-0716-1
"D7,B6",11856,12113,8724,3389,6352,0,3000,3010,2103,907,2.318632856,1501,24208,7975,4003,3,4000,1,581,0,0.13675,empty,mBC-0716-1
"D7,B7",1508244,1602233,1111258,490975,833129,1,434204,434842,370127,64715,5.719338639,223744,81494,52682,25208,12,25196,2,2393,0,0.001547865,mm10,mBC-0716-1
"D7,B8",909791,952346,676335,276011,506827,1,255283,255719,192595,63124,3.051058235,129373,40344,27420,13332,7,13325,1,1694,0,0.003302064,mm10,mBC-0716-1
"D7,B9",691040,722141,528402,193739,375602,2,175248,175560,140490,35070,4.005988024,85604,24456,17654,8449,2,8447,2,1032,0,0.00272286,mm10,mBC-0716-1
"D7,B10",21138,21097,15096,6001,11514,0,5597,5616,3989,1627,2.45175169,2822,1124,497,258,0,258,0,69,0,0.07751938,empty,mBC-0716-1
"D7,B11",15671,16056,11780,4276,8408,0,3928,3939,2792,1147,2.434176112,1938,1356,514,267,0,267,0,74,0,0,empty,mBC-0716-1
"D7,B12",17039,17653,12840,4813,9242,0,4187,4190,2876,1314,2.188736682,2056,1128,715,348,0,348,0,84,0,0.146551724,empty,mBC-0716-1
"D7,C1",21488,21126,16280,4846,10687,3,4553,4568,3254,1314,2.476407915,2041,4213,1407,742,0,742,0,154,0,0.150943396,empty,mBC-0716-1
"D7,C2",18250,19339,13664,5675,10240,0,4850,4868,3379,1489,2.269308261,2490,4255,1714,846,0,846,0,188,0,0.070921986,empty,mBC-0716-1
"D7,C3",18446,18708,13878,4830,9914,0,4595,4611,3122,1489,2.096709201,2177,488,275,134,0,134,0,43,0,0.149253731,empty,mBC-0716-1
"D7,C4",46407,49538,35948,13590,25797,0,12179,12192,8758,3434,2.550378567,5925,2078,1271,604,0,604,0,147,0,0.061258278,empty,mBC-0716-1
"D7,C5",15409,15950,11829,4121,8302,0,3758,3766,2624,1142,2.297723292,1743,978,603,317,0,317,0,98,0,0.025236593,empty,mBC-0716-1
"D7,C6",15415,15846,11770,4076,8751,0,3986,3991,2894,1097,2.63810392,1900,873,588,328,0,328,0,91,0,0.045731707,empty,mBC-0716-1
"D7,C7",15528,16184,11777,4407,8526,0,4021,4032,2823,1209,2.334987593,1970,243,145,81,0,81,0,34,0,0.049382716,empty,mBC-0716-1
"D7,C8",14148,14594,10777,3817,7742,0,3516,3523,2465,1058,2.329867675,1721,1236,811,435,1,434,1,118,0,0.041474654,empty,mBC-0716-1
"D7,C9",11457,11840,8652,3188,6290,0,2937,2942,2037,905,2.250828729,1436,525,330,182,0,182,0,58,0,0.104395604,empty,mBC-0716-1
"D7,C10",12380,12608,9508,3100,6765,0,3035,3045,2184,861,2.536585366,1451,1292,762,365,1,364,1,91,0,0.104395604,empty,mBC-0716-1
"D7,C11",601864,688632,414664,273968,368513,0,223477,223760,173484,50276,3.450632509,128426,55092,32428,15605,5,15600,2,1735,0,0.014679487,mm10,mBC-0716-1
"D7,C12",515809,548261,373292,174969,293892,1,158643,158872,122757,36115,3.399058563,83610,18516,10511,5048,1,5047,1,783,0,0.011690113,mm10,mBC-0716-1
"D7,D1",11283,11663,8388,3275,6336,0,3053,3059,2201,858,2.565268065,1548,1880,682,321,0,321,0,74,0,0.021806854,empty,mBC-0716-1
"D7,D2",19193,19130,14864,4266,10021,0,4249,4260,2993,1267,2.362273086,1904,1674,1064,519,0,519,0,140,0,0.030828516,empty,mBC-0716-1
"D7,D3",13292,13573,10018,3555,7345,0,3391,3397,2297,1100,2.088181818,1625,804,458,220,0,220,0,72,0,0.072727273,empty,mBC-0716-1
"D7,D4",14606,15296,11010,4286,7920,0,3639,3652,2636,1016,2.594488189,1806,1041,615,313,0,313,0,86,0,0.057507987,empty,mBC-0716-1
"D7,D5",13208,13552,10118,3434,7222,0,3246,3251,2329,922,2.526030369,1565,1123,733,343,0,343,0,95,0,0.049562682,empty,mBC-0716-1
"D7,D6",11734,12306,8826,3480,6460,0,3123,3126,2118,1008,2.101190476,1513,807,476,263,0,263,0,74,0,0.060836502,empty,mBC-0716-1
"D7,D7",12689,13162,9573,3589,6984,0,3240,3244,2267,977,2.320368475,1616,1757,1092,533,0,533,0,147,0,0.103189493,empty,mBC-0716-1
"D7,D8",14378,15006,10971,4035,7979,0,3737,3746,2598,1148,2.263066202,1826,815,474,245,0,245,0,90,0,0.048979592,empty,mBC-0716-1
"D7,D9",5243,5388,3896,1492,2957,0,1458,1460,1052,408,2.578431373,707,842,489,265,0,265,0,98,0,0.01509434,empty,mBC-0716-1
"D7,D10",12597,13010,9598,3412,6866,0,3248,3250,2266,984,2.302845528,1548,3570,1090,566,0,566,0,129,0,0.024734982,empty,mBC-0716-1
"D7,D11",13359,13564,9676,3888,6925,0,3259,3267,2303,964,2.389004149,1588,21560,6794,3509,0,3509,0,540,0,0.133941294,empty,mBC-0716-1
"D7,D12",19011,19596,14644,4952,10266,0,4556,4566,3229,1337,2.415108452,2176,2267,1361,672,0,672,0,175,0,0.02827381,empty,mBC-0716-1
"D7,E1",2160047,2338844,1520718,818126,1182977,2,683958,684837,537455,147382,3.646680056,371292,193134,137665,65142,17,65125,1,4038,0,0.001397313,mm10,mBC-0716-1
"D7,E2",15147,15685,11540,4145,8425,0,3896,3901,2731,1170,2.334188034,1864,1372,865,472,1,471,1,113,0,0.040339703,empty,mBC-0716-1
"D7,E3",11485,11796,8915,2881,6296,0,2833,2843,1978,865,2.286705202,1330,1215,753,355,0,355,0,119,0,0.056338028,empty,mBC-0716-1
"D7,E4",14578,14832,10977,3855,7786,0,3563,3574,2560,1014,2.524654832,1696,5478,2303,1223,5,1218,2,190,0,0.342364532,empty,mBC-0716-1
"D7,E5",19748,20000,15062,4938,10525,0,4699,4706,3297,1409,2.339957417,2200,9765,3158,1583,0,1583,0,295,0,0.01642451,empty,mBC-0716-1
"D7,E6",494602,509548,370731,138817,271006,1,131349,131562,94743,36819,2.573209484,65404,23673,16568,8093,1,8092,1,1050,0,0.004572417,mm10,mBC-0716-1
"D7,E7",682699,744527,491232,253295,393488,0,215045,215355,163563,51792,3.158074606,116976,56882,40747,19709,15,19694,3,1905,0,0.002691175,mm10,mBC-0716-1
"D7,E8",1963014,2059551,1454437,605114,1060476,4,549883,550820,440605,110215,3.99768634,279615,132610,93437,45149,23,45126,1,3496,0,0.000753446,mm10,mBC-0716-1
"D7,E9",9105,9443,6924,2519,5017,0,2331,2339,1632,707,2.30834512,1164,2650,958,453,0,453,0,121,0,0.028697572,empty,mBC-0716-1
"D7,E10",12241,12783,9438,3345,6718,0,3122,3132,2253,879,2.563139932,1503,859,538,296,0,296,0,79,0,0.054054054,empty,mBC-0716-1
"D7,E11",8919,9203,6878,2325,4875,0,2183,2189,1504,685,2.195620438,1022,727,488,268,0,268,0,79,0,0.111940299,empty,mBC-0716-1
"D7,E12",14743,15062,11144,3918,8041,0,3703,3704,2584,1120,2.307142857,1791,6106,2006,1046,0,1046,0,203,0,0.106118547,empty,mBC-0716-1
"D7,F1",16894,17259,13028,4231,8950,0,3988,3991,2796,1195,2.339748954,1842,1140,640,304,0,304,0,85,0,0.148026316,empty,mBC-0716-1
"D7,F2",20630,21286,15715,5571,11265,0,5178,5184,3581,1603,2.233936369,2443,2219,1516,730,0,730,0,185,0,0.093150685,empty,mBC-0716-1
"D7,F3",16070,16594,12040,4554,8826,1,4140,4157,2837,1320,2.149242424,2096,4540,1804,853,1,852,1,202,0,0.04342723,empty,mBC-0716-1
"D7,F4",16328,16764,12340,4424,9162,0,4182,4197,2966,1231,2.409423233,2033,377,242,133,0,133,0,65,0,0,empty,mBC-0716-1
"D7,F5",21926,22401,16764,5637,11863,0,5442,5450,3820,1630,2.343558282,2547,1920,879,470,0,470,0,134,0,0.019148936,empty,mBC-0716-1
"D7,F6",23116,24476,17436,7040,12636,0,5865,5875,4175,1700,2.455882353,2945,11247,3905,2020,2,2018,1,348,0,0.135282458,empty,mBC-0716-1
"D7,F7",18607,18908,14286,4622,9996,0,4425,4433,3095,1338,2.313153961,2018,674,373,200,0,200,0,65,0,0.045,empty,mBC-0716-1
"D7,F8",21087,21807,16150,5657,11395,0,5167,5183,3629,1554,2.335263835,2489,149,98,63,0,63,0,38,0,0.111111111,empty,mBC-0716-1
"D7,F9",14746,15514,11360,4154,8299,0,3784,3795,2649,1146,2.311518325,1857,1093,695,384,0,384,0,117,0,0.0625,empty,mBC-0716-1
"D7,F10",19035,19295,14744,4551,10095,0,4397,4397,3104,1293,2.400618716,2031,814,548,268,0,268,0,95,0,0.029850746,empty,mBC-0716-1
"D7,F11",10849,11092,8218,2874,5814,0,2589,2596,1794,802,2.236907731,1228,2157,845,445,1,444,1,118,0,0.013513514,empty,mBC-0716-1
"D7,F12",931707,986926,682203,304723,519244,0,274804,275242,202715,72527,2.795028059,144229,1519,993,494,0,494,0,116,0,0.008097166,empty,mBC-0716-1
"D7,G1",9073,9064,6947,2117,4956,0,2134,2134,1470,664,2.213855422,996,1573,1079,533,0,533,0,130,0,0.00750469,empty,mBC-0716-1
"D7,G2",19261,19752,14586,5166,10271,0,4513,4534,3128,1406,2.224751067,2211,658,360,196,0,196,0,50,0,0.056122449,empty,mBC-0716-1
"D7,G3",18127,18685,13940,4745,9764,0,4455,4470,3130,1340,2.335820896,2127,2205,1124,574,0,574,0,146,0,0.019163763,empty,mBC-0716-1
"D7,G4",25917,26471,19713,6758,13770,0,6077,6092,4314,1778,2.42632171,2899,84,41,26,0,26,0,18,0,0,empty,mBC-0716-1
"D7,G5",404011,412762,305951,106811,222142,1,102274,102416,66991,35425,1.891065632,50610,8817,4970,2418,0,2418,0,479,0,0.012820513,mm10,mBC-0716-1
"D7,G6",22310,23269,17176,6093,12214,0,5556,5565,3932,1633,2.407838334,2655,127,87,60,0,60,0,25,0,0,empty,mBC-0716-1
"D7,G7",854188,898945,639252,259693,469530,1,235116,235466,189667,45799,4.141291295,117980,112633,76043,36436,10,36426,1,2879,0,0.00085104,mm10,mBC-0716-1
"D7,G8",584839,654978,411917,243061,348145,1,199194,199471,163697,35774,4.575865153,111251,91051,63418,30208,8,30200,2,2538,0,0.001688742,mm10,mBC-0716-1
"D7,G9",10464,10981,7946,3035,5673,1,2655,2662,1795,867,2.070357555,1274,8613,2739,1391,2,1389,1,258,0,0.005039597,empty,mBC-0716-1
"D7,G10",12968,13334,10033,3301,7112,0,3203,3209,2287,922,2.480477223,1505,1020,632,324,0,324,0,107,0,0.138888889,empty,mBC-0716-1
"D7,G11",11220,11847,8625,3222,6225,0,2827,2832,1976,856,2.308411215,1344,606,444,213,0,213,0,63,0,0.009389671,empty,mBC-0716-1
"D7,G12",10810,10985,8175,2810,5919,0,2770,2777,1913,864,2.21412037,1322,778,496,224,0,224,0,74,0,0.0625,empty,mBC-0716-1
"D7,H1",19392,19986,14854,5132,10565,0,4819,4825,3418,1407,2.429282161,2309,1471,731,392,0,392,0,99,0,0.109693878,empty,mBC-0716-1
"D7,H2",21730,22390,16734,5656,11643,0,5146,5151,3600,1551,2.321083172,2465,1609,1010,490,0,490,0,134,0,0.091836735,empty,mBC-0716-1
"D7,H3",18719,19314,14297,5017,10225,0,4620,4633,3304,1329,2.486079759,2261,1148,772,371,0,371,0,105,0,0.064690027,empty,mBC-0716-1
"D7,H4",12896,13142,9630,3512,6942,0,3141,3148,2211,937,2.359658485,1529,244,74,43,0,43,0,18,0,0,empty,mBC-0716-1
"D7,H5",16958,17493,12892,4601,9039,0,4163,4170,2951,1219,2.420836751,1998,1114,667,337,0,337,0,98,0,0.053412463,empty,mBC-0716-1
"D7,H6",13782,14197,10538,3659,7682,0,3548,3557,2570,987,2.603850051,1727,1148,828,377,1,376,1,118,0,0.021276596,empty,mBC-0716-1
"D7,H7",16598,17135,12578,4557,9239,0,4344,4356,3019,1337,2.258040389,2110,1140,755,400,0,400,0,134,0,0.04,empty,mBC-0716-1
"D7,H8",12872,13209,9663,3546,7116,0,3292,3305,2344,961,2.439125911,1625,1174,703,376,0,376,0,103,0,0.087765957,empty,mBC-0716-1
"D7,H9",15064,15229,11439,3790,8172,0,3644,3649,2575,1074,2.397579143,1763,737,519,297,0,297,0,84,0,0.037037037,empty,mBC-0716-1
"D7,H10",13770,14101,10444,3657,7444,0,3507,3507,2510,997,2.517552658,1687,695,475,256,0,256,0,82,0,0.09375,empty,mBC-0716-1
"D7,H11",15997,16582,12019,4563,8785,0,4129,4139,2894,1245,2.324497992,2025,99,53,31,0,31,0,18,0,0.032258065,empty,mBC-0716-1
"D7,H12",5840,6076,4491,1585,3260,0,1487,1498,1038,460,2.256521739,723,1349,592,313,0,313,0,78,0,0.051118211,empty,mBC-0716-1
"D8,A1",1084224,1171855,780185,391670,632410,2,345850,346341,260601,85740,3.03943317,187901,75566,46681,21950,14,21936,6,2223,0,0.005424872,mm10,mBC-0716-1
"D8,A2",736993,779452,538719,240733,412900,0,210398,210724,173536,37188,4.666451544,109402,133172,92670,44414,19,44395,1,3059,0,0.001441604,mm10,mBC-0716-1
"D8,A3",773945,840481,556475,284006,444955,1,238784,239154,206196,32958,6.256326233,128419,90302,61119,28991,12,28979,1,2554,0,0.001759895,mm10,mBC-0716-1
"D8,A4",939707,1012183,648959,363224,533769,0,317479,317920,250094,67826,3.687288061,174078,5350,3239,1477,0,1477,0,313,0,0.016249154,mm10,mBC-0716-1
"D8,A5",1039300,1160694,709362,451332,610704,0,382155,382610,289773,92837,3.121309392,214978,30362,20482,9675,7,9668,2,1286,0,0.007860985,mm10,mBC-0716-1
"D8,A6",14106,14932,10697,4235,8095,0,3860,3864,2753,1111,2.477947795,1928,1272,762,388,0,388,0,132,0,0.036082474,empty,mBC-0716-1
"D8,A7",17422,17745,12976,4769,9560,0,4428,4434,3054,1380,2.213043478,2159,3469,1528,739,0,739,0,184,0,0.037889039,empty,mBC-0716-1
"D8,A8",11565,12029,8765,3264,6525,0,3018,3022,2166,856,2.530373832,1444,1583,1040,493,0,493,0,162,0,0.058823529,empty,mBC-0716-1
"D8,A9",20998,21433,16426,5007,11303,0,4942,4958,3527,1431,2.464709993,2255,1226,655,374,0,374,0,120,0,0.021390374,empty,mBC-0716-1
"D8,A10",16706,16849,12618,4231,9148,0,4176,4192,2925,1267,2.308602999,2005,517,276,125,0,125,0,46,0,0,empty,mBC-0716-1
"D8,A11",19138,19424,14684,4740,10414,0,4651,4669,3300,1369,2.410518627,2147,1220,760,378,0,378,0,121,0,0.037037037,empty,mBC-0716-1
"D8,A12",21307,21721,16377,5344,11386,0,4982,4992,3525,1467,2.402862986,2325,2616,1660,785,1,784,1,200,0,0.058673469,empty,mBC-0716-1
"D8,B1",19839,20333,15222,5111,10572,0,4725,4744,3266,1478,2.209742896,2177,14069,4770,2322,0,2322,0,396,0,0.015073213,empty,mBC-0716-1
"D8,B2",21709,22020,16590,5430,11889,0,5385,5399,3789,1610,2.353416149,2495,785,491,257,0,257,0,70,0,0.20233463,empty,mBC-0716-1
"D8,B3",19580,20148,14950,5198,10806,1,4885,4902,3381,1521,2.222879684,2342,1143,739,381,0,381,0,122,0,0.062992126,empty,mBC-0716-1
"D8,B4",17689,18320,13441,4879,9882,0,4640,4650,3310,1340,2.470149254,2243,1166,685,369,0,369,0,108,0,0.054200542,empty,mBC-0716-1
"D8,B5",9809,6072,4277,1795,4161,0,2000,2013,1429,584,2.446917808,1078,627,398,222,0,222,0,75,0,0,empty,mBC-0716-1
"D8,B6",13012,13662,9927,3735,7188,0,3298,3301,2330,971,2.399588054,1622,2919,1317,626,1,625,1,157,0,0.0528,empty,mBC-0716-1
"D8,B7",470954,486436,362388,124048,265218,1,119365,119549,88041,31508,2.794242732,58102,20522,14248,7041,2,7039,1,985,0,0.006108822,mm10,mBC-0716-1
"D8,B8",14043,14417,10856,3561,7661,0,3417,3427,2402,1025,2.343414634,1606,1036,701,398,0,398,0,131,0,0.087939698,empty,mBC-0716-1
"D8,B9",15956,16441,12350,4091,8626,0,3883,3887,2712,1175,2.308085106,1803,1666,686,360,0,360,0,106,0,0.072222222,empty,mBC-0716-1
"D8,B10",17952,17452,12787,4665,9581,0,4491,4525,3129,1396,2.241404011,2178,529,268,136,0,136,0,62,0,0.080882353,empty,mBC-0716-1
"D8,B11",17673,18388,13416,4972,9676,0,4446,4456,3166,1290,2.454263566,2171,599,167,94,0,94,0,41,0,0,empty,mBC-0716-1
"D8,B12",18852,19467,14219,5248,10311,0,4695,4706,3247,1459,2.225496916,2293,1495,927,479,1,478,1,128,0,0.10460251,empty,mBC-0716-1
"D8,C1",23379,23569,18163,5406,12382,1,5198,5214,3733,1481,2.520594193,2330,652,381,206,0,206,0,90,0,0.019417476,empty,mBC-0716-1
"D8,C2",20089,20804,15198,5606,11274,0,5294,5303,3769,1534,2.456975228,2631,2072,1384,720,0,720,0,199,0,0.056944444,empty,mBC-0716-1
"D8,C3",21438,21993,16265,5728,11693,0,5366,5377,3760,1617,2.325293754,2663,460,297,181,0,181,0,72,0,0.049723757,empty,mBC-0716-1
"D8,C4",1793547,2042408,1171954,870454,1069060,5,701718,702616,550279,152337,3.612247845,409942,193969,136904,64756,22,64734,4,3927,0,0.001112244,mm10,mBC-0716-1
"D8,C5",817950,909815,578514,331301,483548,2,276384,276759,206696,70063,2.95014487,155485,51662,35842,17436,2,17434,1,1762,0,0.000458873,mm10,mBC-0716-1
"D8,C6",17730,18117,13321,4796,9857,0,4592,4608,3226,1382,2.334298119,2228,1561,990,511,2,509,1,140,0,0.043222004,empty,mBC-0716-1
"D8,C7",762874,799772,575048,224724,422338,2,201443,201759,159212,42547,3.742026465,100990,14239,9101,4330,2,4328,2,690,0,0.002310536,mm10,mBC-0716-1
"D8,C8",871714,984935,588581,396354,523449,1,322080,322498,268551,53947,4.978052533,185347,140188,94252,45295,18,45277,2,3166,0,0.001060141,mm10,mBC-0716-1
"D8,C9",13435,13861,10073,3788,7312,0,3379,3381,2355,1026,2.295321637,1659,833,523,279,0,279,0,73,0,0.025089606,empty,mBC-0716-1
"D8,C10",14897,15254,11440,3814,8022,0,3592,3600,2555,1045,2.444976077,1698,1148,723,391,1,390,1,105,0,0.074358974,empty,mBC-0716-1
"D8,C11",12251,12514,9299,3215,6660,0,2999,2999,2052,947,2.166842661,1457,927,545,289,0,289,0,95,0,0.01384083,empty,mBC-0716-1
"D8,C12",20714,21542,15839,5703,11470,0,5314,5325,3782,1543,2.451069345,2517,1490,835,411,2,409,1,124,0,0.063569682,empty,mBC-0716-1
"D8,D1",1368014,1559151,908876,650275,828767,3,535006,535606,392143,143463,2.733408614,313026,41509,22548,10965,4,10961,2,1504,0,0.013411185,mm10,mBC-0716-1
"D8,D2",1020594,1089859,740817,349042,568127,1,298118,298549,260667,37882,6.881025289,156282,200885,141434,68006,20,67986,1,3675,0,0.002515224,mm10,mBC-0716-1
"D8,D3",14763,15165,11230,3935,8152,0,3821,3831,2679,1152,2.325520833,1842,1307,886,451,0,451,0,135,0,0.093126386,empty,mBC-0716-1
"D8,D4",15273,15795,11539,4256,8419,0,3972,3984,2802,1182,2.370558376,1952,1095,723,367,0,367,0,117,0,0.046321526,empty,mBC-0716-1
"D8,D5",14854,15511,11414,4097,8447,0,3896,3909,2700,1209,2.23325062,1916,4667,1663,836,0,836,0,230,0,0.008373206,empty,mBC-0716-1
"D8,D6",521033,560191,366917,193274,303769,0,171202,171449,131427,40022,3.283868872,93399,8966,5618,2622,2,2620,2,533,0,0.040076336,mm10,mBC-0716-1
"D8,D7",18625,19759,13139,6620,10700,0,5650,5654,3331,2323,1.433921653,3117,19061,5999,2935,2,2933,2,501,0,0.055233549,empty,mBC-0716-1
"D8,D8",635282,684933,467449,217484,366334,2,188594,188895,153140,35755,4.283037337,99951,73191,51829,24295,7,24288,2,2168,0,0.000617589,mm10,mBC-0716-1
"D8,D9",6362,6807,4728,2079,3735,0,1867,1877,1323,554,2.388086643,972,1422,727,366,0,366,0,110,0,0.043715847,empty,mBC-0716-1
"D8,D10",15020,15606,11513,4093,8470,0,3952,3962,2788,1174,2.374787053,1930,818,506,279,0,279,0,98,0,0.082437276,empty,mBC-0716-1
"D8,D11",14066,14674,10637,4037,7862,0,3709,3719,2597,1122,2.314616756,1812,1627,1107,547,0,547,0,154,0,0.040219378,empty,mBC-0716-1
"D8,D12",21046,21477,16185,5292,11515,0,5225,5238,3674,1564,2.349104859,2433,2538,1628,836,0,836,0,220,0,0.05861244,empty,mBC-0716-1
"D8,E1",22929,23391,17636,5755,12418,0,5433,5453,3902,1551,2.51579626,2566,1581,1040,543,0,543,0,168,0,0.038674033,empty,mBC-0716-1
"D8,E2",17519,17594,13242,4352,9607,0,4388,4397,3145,1252,2.511980831,2066,1427,844,386,0,386,0,140,0,0.012953368,empty,mBC-0716-1
"D8,E3",13467,13682,10278,3404,7312,0,3239,3253,2269,984,2.305894309,1526,1681,1142,580,0,580,0,171,0,0.018965517,empty,mBC-0716-1
"D8,E4",15697,16094,12140,3954,8581,0,3820,3827,2778,1049,2.648236416,1742,1388,866,458,0,458,0,150,0,0.026200873,empty,mBC-0716-1
"D8,E5",1792419,1868235,1333262,534973,958914,3,487006,487854,403111,84743,4.756864874,244826,103657,71023,33600,12,33588,1,2993,0,0.001190902,mm10,mBC-0716-1
"D8,E6",916588,1009564,633555,376009,528167,0,315408,315869,226350,89519,2.5285135,177107,66031,42127,19734,14,19720,3,1968,0,0.000912779,mm10,mBC-0716-1
"D8,E7",14453,15072,11019,4053,7901,0,3692,3696,2658,1038,2.560693642,1789,1266,813,421,0,421,0,123,0,0.035629454,empty,mBC-0716-1
"D8,E8",18888,19247,14535,4712,10408,0,4540,4554,3211,1343,2.39091586,2102,1972,1298,658,0,658,0,177,0,0.059270517,empty,mBC-0716-1
"D8,E9",9721,10143,7177,2966,5613,0,2692,2695,1879,816,2.302696078,1382,1399,810,434,0,434,0,121,0,0.046082949,empty,mBC-0716-1
"D8,E10",13778,14299,10506,3793,7627,0,3498,3504,2401,1103,2.176790571,1634,1112,634,349,1,348,1,123,0,0.017241379,empty,mBC-0716-1
"D8,E11",10385,10542,7875,2667,5829,0,2723,2727,1921,806,2.38337469,1305,1120,758,375,0,375,0,109,0,0.016,empty,mBC-0716-1
"D8,E12",15440,16307,11747,4560,8890,0,4199,4207,2982,1225,2.434285714,2084,1151,712,360,0,360,0,131,0,0.011111111,empty,mBC-0716-1
"D8,F1",18698,19133,14300,4833,10020,0,4493,4504,3186,1318,2.417298938,2080,2271,1092,520,1,519,1,148,0,0.05973025,empty,mBC-0716-1
"D8,F2",23651,24637,17941,6696,13016,1,6048,6062,4224,1838,2.298150163,2942,2358,1491,846,1,845,1,248,0,0.085207101,empty,mBC-0716-1
"D8,F3",17363,18234,13106,5128,9812,0,4660,4668,3234,1434,2.255230126,2289,1666,1031,546,0,546,0,187,0,0.005494505,empty,mBC-0716-1
"D8,F4",18953,19344,14180,5164,10752,0,5055,5064,3625,1439,2.519110493,2478,2059,748,404,0,404,0,115,0,0.00990099,empty,mBC-0716-1
"D8,F5",29325,30464,22487,7977,15966,0,7144,7154,5047,2107,2.395348837,3375,2563,1342,640,0,640,0,204,0,0.1296875,empty,mBC-0716-1
"D8,F6",1763056,1944253,1266153,678100,1005418,1,570641,571534,395060,176474,2.238630053,314155,167799,104007,50204,22,50182,3,3646,0,0.007652146,mm10,mBC-0716-1
"D8,F7",21264,21831,16126,5705,11917,0,5436,5444,3744,1700,2.202352941,2579,1566,870,433,1,432,1,146,0,0.009259259,empty,mBC-0716-1
"D8,F8",2838623,3008990,2070354,938636,1502252,5,799862,801215,695832,105383,6.602886614,414317,45090,30696,14694,8,14686,1,1708,0,0.000680921,mm10,mBC-0716-1
"D8,F9",2566170,2823570,1799710,1023860,1450775,3,867584,868768,681318,187450,3.634665244,478174,188369,128985,62571,12,62559,3,4143,0,0.003053118,mm10,mBC-0716-1
"D8,F10",21853,22107,16711,5396,11684,1,5092,5107,3615,1492,2.422922252,2357,1879,814,413,0,413,0,130,0,0.041162228,empty,mBC-0716-1
"D8,F11",12395,12660,9586,3074,6750,0,3061,3067,2131,936,2.276709402,1398,778,478,260,0,260,0,98,0,0.053846154,empty,mBC-0716-1
"D8,F12",15077,15588,11463,4125,8065,0,3636,3642,2545,1097,2.319963537,1768,662,214,111,0,111,0,37,0,0,empty,mBC-0716-1
"D8,G1",11038,11355,8473,2882,6031,0,2669,2677,1868,809,2.309023486,1272,10790,3962,1979,4,1975,2,350,0,0.092658228,empty,mBC-0716-1
"D8,G2",21875,22447,16482,5965,11736,0,5295,5311,3729,1582,2.357142857,2566,587,307,124,0,124,0,45,0,0,empty,mBC-0716-1
"D8,G3",23304,24214,17449,6765,12696,0,5828,5838,4136,1702,2.430082256,2847,26080,10405,5358,5,5353,2,734,0,0.241920418,empty,mBC-0716-1
"D8,G4",29989,30796,22731,8065,16185,0,7198,7216,5065,2151,2.354718735,3409,95,61,35,0,35,0,27,0,0.028571429,empty,mBC-0716-1
"D8,G5",595038,618294,455075,163219,327940,1,147561,147815,126064,21751,5.795779504,72402,102064,71224,33969,17,33952,2,2723,0,0.001354854,mm10,mBC-0716-1
"D8,G6",25614,26041,19585,6456,13857,0,6135,6151,4414,1737,2.541162925,2903,376,172,101,0,101,0,48,0,0.089108911,empty,mBC-0716-1
"D8,G7",20772,21183,16063,5120,11278,0,5016,5029,3525,1504,2.34375,2285,1812,1095,550,0,550,0,172,0,0.036363636,empty,mBC-0716-1
"D8,G8",15647,16051,11837,4214,8574,0,4020,4026,2767,1259,2.197776013,1932,1436,901,518,0,518,0,159,0,0.044401544,empty,mBC-0716-1
"D8,G9",11116,11472,8461,3011,5960,0,2684,2690,1889,801,2.358302122,1256,1354,917,469,0,469,0,146,0,0.089552239,empty,mBC-0716-1
"D8,G10",14611,14992,11029,3963,8016,0,3660,3668,2592,1076,2.408921933,1750,1217,795,364,0,364,0,121,0,0.054945055,empty,mBC-0716-1
"D8,G11",12970,13332,10021,3311,7169,0,3251,3261,2276,985,2.310659898,1533,645,390,231,0,231,0,86,0,0.021645022,empty,mBC-0716-1
"D8,G12",12224,12896,9149,3747,6909,0,3252,3264,2340,924,2.532467532,1698,1355,967,505,0,505,0,127,0,0.100990099,empty,mBC-0716-1
"D8,H1",22325,22714,16977,5737,12201,0,5530,5545,3911,1634,2.393512852,2666,1043,617,318,0,318,0,112,0,0.044025157,empty,mBC-0716-1
"D8,H2",24732,24897,18875,6022,13143,0,5821,5831,4038,1793,2.252091467,2669,2568,1536,800,0,800,0,200,0,0.08,empty,mBC-0716-1
"D8,H3",677829,719993,488523,231470,385425,2,203190,203516,134818,68698,1.962473434,110871,17853,12079,5721,2,5719,1,929,0,0.002273125,mm10,mBC-0716-1
"D8,H4",14887,14936,11103,3833,7881,0,3590,3593,2551,1042,2.448176583,1734,443,152,69,1,68,1,29,0,0.191176471,empty,mBC-0716-1
"D8,H5",20114,20772,15209,5563,11038,1,5205,5213,3696,1517,2.436387607,2506,1338,833,445,0,445,0,155,0,0.033707865,empty,mBC-0716-1
"D8,H6",16852,17425,12609,4816,9442,1,4515,4521,3261,1260,2.588095238,2241,2337,1464,735,0,735,0,194,0,0.062585034,empty,mBC-0716-1
"D8,H7",18609,19151,13954,5197,10366,0,4836,4846,3421,1425,2.400701754,2409,1627,1018,522,0,522,0,192,0,0.051724138,empty,mBC-0716-1
"D8,H8",14746,15110,11110,4000,8144,0,3776,3785,2703,1082,2.498151571,1878,1473,982,473,0,473,0,148,0,0.065539112,empty,mBC-0716-1
"D8,H9",16775,17220,12767,4453,9224,0,4208,4214,3000,1214,2.471169687,2039,1265,892,434,1,433,1,125,0,0.020785219,empty,mBC-0716-1
"D8,H10",1093232,1154753,768819,385934,612029,2,339825,340382,273694,66688,4.104096689,181740,133257,91915,43771,16,43755,2,3207,0,0.000365672,mm10,mBC-0716-1
"D8,H11",18269,19422,13879,5543,10316,0,4789,4813,3360,1453,2.312456986,2444,181,114,75,0,75,0,41,0,0,empty,mBC-0716-1
"D8,H12",554252,623261,378404,244857,336907,2,206665,206912,141978,64934,2.186497059,118304,52644,24808,12142,12,12130,5,1554,0,0.032646331,mm10,mBC-0716-1
"D9,A1",15206,15756,11467,4289,8487,0,4028,4035,2881,1154,2.496533795,1951,1269,802,386,0,386,0,117,0,0.010362694,empty,mBC-0716-1
"D9,A2",573674,584659,433246,151413,313665,2,146458,146743,111123,35620,3.119679955,71516,13998,8594,4166,1,4165,1,728,0,0.01272509,mm10,mBC-0716-1
"D9,A3",17004,17988,12867,5121,9560,0,4446,4456,3116,1340,2.325373134,2240,1024,643,368,0,368,0,108,0,0.032608696,empty,mBC-0716-1
"D9,A4",21960,22242,16853,5389,11478,0,5026,5034,3527,1507,2.340411413,2222,6822,2159,1071,2,1069,1,214,0,0.026192703,empty,mBC-0716-1
"D9,A5",17368,17772,13255,4517,9451,0,4335,4339,3032,1307,2.319816373,2054,1891,1146,544,0,544,0,175,0,0.033088235,empty,mBC-0716-1
"D9,A6",502490,535049,373629,161420,287278,2,142462,142711,117978,24733,4.770064287,73000,131140,90634,43789,15,43774,2,3119,0,0.000822406,mm10,mBC-0716-1
"D9,A7",16932,17657,12942,4715,9385,0,4303,4310,2989,1321,2.262679788,2077,1440,892,486,0,486,0,156,0,0.065843621,empty,mBC-0716-1
"D9,A8",11759,12207,8984,3223,6554,0,3060,3063,2229,834,2.672661871,1473,4992,2007,1054,0,1054,0,264,0,0.043643264,empty,mBC-0716-1
"D9,A9",19105,19288,14857,4431,10040,0,4250,4263,2995,1268,2.361987382,1895,1017,626,321,0,321,0,121,0,0.08411215,empty,mBC-0716-1
"D9,A10",16302,16420,12470,3950,8796,0,3970,3983,2798,1185,2.361181435,1817,643,345,188,0,188,0,76,0,0.021276596,empty,mBC-0716-1
"D9,A11",18535,18847,14206,4641,9925,0,4367,4379,3094,1285,2.407782101,2022,956,615,305,0,305,0,111,0,0.098360656,empty,mBC-0716-1
"D9,A12",21454,21747,16298,5449,11230,0,4972,4990,3534,1456,2.427197802,2294,23717,8984,4674,5,4669,4,723,0,0.150353395,empty,mBC-0716-1
"D9,B1",19578,19865,15120,4745,10502,1,4716,4735,3327,1408,2.362926136,2172,1160,809,429,0,429,0,131,0,0.058275058,empty,mBC-0716-1
"D9,B2",20915,21031,16019,5012,11125,0,4928,4942,3434,1508,2.277188329,2301,491,324,162,0,162,0,56,0,0.061728395,empty,mBC-0716-1
"D9,B3",19651,20095,14963,5132,10571,0,4804,4814,3361,1453,2.313145217,2269,978,585,342,0,342,0,121,0,0.061403509,empty,mBC-0716-1
"D9,B4",17247,17683,13303,4380,9353,0,4185,4192,2933,1259,2.329626688,1950,2961,1152,556,1,555,1,149,0,0.126126126,empty,mBC-0716-1
"D9,B5",12518,8978,6214,2764,5891,0,2910,2929,2085,844,2.470379147,1599,2703,1012,551,1,550,1,127,0,0.045454545,empty,mBC-0716-1
"D9,B6",12530,13138,9439,3699,7071,0,3310,3318,2328,990,2.351515152,1646,2241,1494,733,0,733,0,181,0,0.001364256,empty,mBC-0716-1
"D9,B7",16739,17131,12978,4153,9151,0,4099,4102,2940,1162,2.530120482,1902,1317,800,365,0,365,0,117,0,0.032876712,empty,mBC-0716-1
"D9,B8",14023,14525,10622,3903,7699,0,3419,3429,2367,1062,2.228813559,1683,2107,1263,617,0,617,0,181,0,0.017828201,empty,mBC-0716-1
"D9,B9",15615,16001,11996,4005,8284,1,3721,3731,2590,1141,2.26993865,1759,709,456,245,0,245,0,72,0,0.057142857,empty,mBC-0716-1
"D9,B10",711397,684788,468053,216735,377008,3,193102,194331,163900,30431,5.385955112,102361,28998,18848,8967,2,8965,1,1257,0,0.000334635,mm10,mBC-0716-1
"D9,B11",17109,17466,13060,4406,9284,0,4248,4255,2990,1265,2.363636364,2006,228,143,89,0,89,0,43,0,0.101123596,empty,mBC-0716-1
"D9,B12",18848,19210,14395,4815,10119,0,4601,4608,3259,1349,2.415863603,2103,1585,1107,559,0,559,0,143,0,0.046511628,empty,mBC-0716-1
"D9,C1",23087,23327,17799,5528,11983,0,5154,5163,3608,1555,2.320257235,2288,8266,2663,1409,3,1406,1,245,0,0.125177809,empty,mBC-0716-1
"D9,C2",20005,20513,15243,5270,11070,0,5115,5131,3686,1445,2.550865052,2479,1796,1158,588,0,588,0,178,0,0.073129252,empty,mBC-0716-1
"D9,C3",20682,21544,15754,5790,11403,0,5263,5274,3605,1669,2.159976034,2568,588,429,209,0,209,0,72,0,0.033492823,empty,mBC-0716-1
"D9,C4",18253,18657,14088,4569,9902,0,4481,4486,3175,1311,2.421815408,2059,1177,761,430,1,429,1,149,0,0.023310023,empty,mBC-0716-1
"D9,C5",17095,17725,13046,4679,9188,0,4225,4238,3002,1236,2.428802589,2006,1114,678,379,1,378,1,114,0,0.044973545,empty,mBC-0716-1
"D9,C6",19291,19589,14618,4971,10967,0,5083,5094,3669,1425,2.574736842,2429,9909,4030,1968,2,1966,1,387,0,0.039165819,empty,mBC-0716-1
"D9,C7",16921,17426,12863,4563,9290,0,4383,4389,3110,1279,2.431587177,2150,573,426,190,1,189,1,68,0,0,empty,mBC-0716-1
"D9,C8",713697,769039,513042,255997,410456,1,218422,218777,183643,35134,5.226931178,117063,178175,119194,56735,13,56722,3,3828,0,0.000916752,mm10,mBC-0716-1
"D9,C9",13177,13550,10067,3483,7228,0,3281,3285,2310,975,2.369230769,1568,1088,634,304,1,303,1,92,0,0.089108911,empty,mBC-0716-1
"D9,C10",794651,841952,584199,257753,444457,2,227404,227802,188766,39036,4.835690132,117890,80618,57173,27712,11,27701,2,2409,0,0.001046894,mm10,mBC-0716-1
"D9,C11",12412,13136,9132,4004,6982,0,3356,3374,2384,990,2.408080808,1733,15750,4911,2460,2,2458,1,404,0,0.062652563,empty,mBC-0716-1
"D9,C12",20573,21064,15601,5463,11115,0,5019,5039,3464,1575,2.199365079,2455,1823,937,490,0,490,0,151,0,0.114285714,empty,mBC-0716-1
"D9,D1",12165,12925,9092,3833,6839,0,3224,3225,2292,933,2.45659164,1641,639,428,232,0,232,0,82,0,0,empty,mBC-0716-1
"D9,D2",20807,21300,16119,5181,11386,0,5077,5089,3545,1544,2.295984456,2397,2344,1539,755,0,755,0,213,0,0.022516556,empty,mBC-0716-1
"D9,D3",14487,14635,10902,3733,7788,0,3657,3666,2537,1129,2.247121346,1705,1133,701,376,0,376,0,123,0,0.061170213,empty,mBC-0716-1
"D9,D4",16399,17118,12607,4511,9081,0,4227,4235,2999,1236,2.426375405,2004,2010,1063,537,0,537,0,158,0,0.00744879,empty,mBC-0716-1
"D9,D5",14517,14995,10935,4060,8004,0,3646,3659,2599,1060,2.451886792,1829,6060,2444,1287,4,1283,3,265,0,0.023382697,empty,mBC-0716-1
"D9,D6",13059,13365,9904,3461,7152,0,3331,3337,2337,1000,2.337,1590,2250,1476,752,1,751,1,190,0,0.022636485,empty,mBC-0716-1
"D9,D7",13886,14559,10587,3972,7710,0,3556,3562,2511,1051,2.389153187,1767,1739,1165,570,0,570,0,179,0,0.068421053,empty,mBC-0716-1
"D9,D8",16536,17272,12669,4603,9319,0,4348,4362,3099,1263,2.45368171,2068,1124,711,368,0,368,0,115,0,0.073369565,empty,mBC-0716-1
"D9,D9",6023,6314,4446,1868,3460,0,1730,1734,1223,511,2.39334638,870,1140,714,371,0,371,0,134,0,0.013477089,empty,mBC-0716-1
"D9,D10",621764,678600,455068,223532,361434,2,190006,190295,155670,34625,4.495884477,101189,89971,61231,29896,11,29885,2,2467,0,0.001940773,mm10,mBC-0716-1
"D9,D11",13869,14070,10505,3565,7565,0,3487,3494,2467,1027,2.402142162,1646,1687,1075,560,1,559,1,160,0,0.033989267,empty,mBC-0716-1
"D9,D12",21014,21641,16051,5590,11344,0,5200,5210,3719,1491,2.494299128,2464,2629,1744,844,0,844,0,230,0,0.039099526,empty,mBC-0716-1
"D9,E1",22508,23018,17173,5845,12134,0,5348,5360,3823,1537,2.487312947,2575,1470,952,488,1,487,1,166,0,0.045174538,empty,mBC-0716-1
"D9,E2",17095,17304,13030,4274,9348,0,4206,4211,3009,1202,2.503327787,1944,1735,1065,567,0,567,0,186,0,0.074074074,empty,mBC-0716-1
"D9,E3",1435657,1546383,1037756,508627,804929,2,443153,443853,369397,74456,4.961279145,233998,302971,211512,100842,25,100817,5,4973,0,0.00095222,mm10,mBC-0716-1
"D9,E4",1426688,1505088,1059189,445899,781464,0,400882,401476,326460,75016,4.351871601,205561,102712,70573,33953,13,33940,3,2881,0,0.001266942,mm10,mBC-0716-1
"D9,E5",650952,647237,517649,129588,341928,0,132712,133055,103214,29841,3.458798298,59028,13962,9712,4632,0,4632,0,763,0,0.003022453,mm10,mBC-0716-1
"D9,E6",714582,747156,519029,228127,392016,1,199143,199458,173502,25956,6.684466019,102379,142197,101349,47953,17,47936,3,3339,0,0.001835781,mm10,mBC-0716-1
"D9,E7",15061,15464,11382,4082,8151,0,3630,3636,2555,1081,2.363552266,1781,1608,1098,545,0,545,0,157,0,0.014678899,empty,mBC-0716-1
"D9,E8",18289,18266,13936,4330,9790,0,4402,4408,3111,1297,2.398612182,2048,14271,4996,2497,3,2494,1,471,0,0.036086608,empty,mBC-0716-1
"D9,E9",10030,10233,7563,2670,5390,0,2497,2510,1738,772,2.251295337,1192,1108,663,343,1,342,1,117,0,0.00877193,empty,mBC-0716-1
"D9,E10",13208,13624,10016,3608,7220,0,3321,3347,2307,1040,2.218269231,1576,5134,1948,1018,1,1017,1,216,0,0.060963618,empty,mBC-0716-1
"D9,E11",539808,592911,384001,208910,320377,3,177623,177881,144362,33519,4.30687073,96928,126154,90020,42638,11,42627,4,3070,0,0.000938372,mm10,mBC-0716-1
"D9,E12",1493863,1639545,1071301,568244,868756,1,484485,485252,391859,93393,4.195806966,265427,173403,123792,60044,24,60020,4,3903,0,0.002382539,mm10,mBC-0716-1
"D9,F1",1071631,1195629,745715,449914,621660,0,371994,372536,265851,106685,2.491924825,209096,86089,57568,27561,7,27554,3,2371,0,0.001233941,mm10,mBC-0716-1
"D9,F2",23224,23979,17893,6086,12808,0,5927,5942,4132,1810,2.282872928,2791,2602,1738,927,0,927,0,280,0,0.035598706,empty,mBC-0716-1
"D9,F3",17029,17917,12995,4922,9582,0,4557,4575,3172,1403,2.260869565,2217,2966,1524,837,0,837,0,237,0,0.020310633,empty,mBC-0716-1
"D9,F4",18400,18847,13893,4954,10326,0,4857,4870,3459,1411,2.45145287,2386,812,531,283,0,283,0,104,0,0.03180212,empty,mBC-0716-1
"D9,F5",771779,805001,585782,219219,421824,0,195297,195657,161119,34538,4.664977706,96994,91964,64310,30859,10,30849,1,2656,0,0.00168563,mm10,mBC-0716-1
"D9,F6",24445,25290,18412,6878,13349,0,6240,6256,4408,1848,2.385281385,3086,3307,2136,1125,0,1125,0,275,0,0.021333333,empty,mBC-0716-1
"D9,F7",20260,20450,15577,4873,11164,0,4867,4879,3465,1414,2.45049505,2265,964,637,311,0,311,0,104,0,0.028938907,empty,mBC-0716-1
"D9,F8",24103,24899,18430,6469,13240,0,6073,6090,4304,1786,2.409854423,2893,255,165,104,0,104,0,60,0,0,empty,mBC-0716-1
"D9,F9",16394,16655,12446,4209,9001,0,4023,4038,2851,1187,2.401853412,1985,1480,922,447,0,447,0,175,0,0.026845638,empty,mBC-0716-1
"D9,F10",21564,21680,16480,5200,11309,1,4952,4968,3551,1417,2.505998589,2294,13407,4404,2241,2,2239,1,415,0,0.087092452,empty,mBC-0716-1
"D9,F11",811148,896084,554322,341762,473531,1,287576,287979,238557,49422,4.82693942,160402,78664,53673,26051,10,26041,3,2397,0,0.007104182,mm10,mBC-0716-1
"D9,F12",14076,14009,10699,3310,7406,0,3276,3284,2304,980,2.351020408,1504,201,121,78,0,78,0,30,0,0.012820513,empty,mBC-0716-1
"D9,G1",10491,11048,8098,2950,5841,0,2657,2664,1842,822,2.240875912,1302,2048,1189,601,0,601,0,171,0,0.024958403,empty,mBC-0716-1
"D9,G2",21017,21364,16074,5290,11227,0,5009,5025,3492,1533,2.277886497,2315,463,269,150,0,150,0,52,0,0.033333333,empty,mBC-0716-1
"D9,G3",21934,22049,16571,5478,11721,0,5340,5347,3774,1573,2.399237127,2581,1758,1159,599,0,599,0,186,0,0.041736227,empty,mBC-0716-1
"D9,G4",29268,29603,22685,6918,15543,0,6726,6746,4787,1959,2.44359367,3130,125,92,59,0,59,0,38,0,0.13559322,empty,mBC-0716-1
"D9,G5",13543,14198,10287,3911,7602,0,3524,3531,2469,1062,2.324858757,1702,1221,824,413,0,413,0,124,0,0.00968523,empty,mBC-0716-1
"D9,G6",24984,25184,19323,5861,13318,0,5802,5824,4155,1669,2.489514679,2635,239,177,103,0,103,0,47,0,0.009708738,empty,mBC-0716-1
"D9,G7",604785,636165,431158,205007,343279,1,187518,187826,151886,35940,4.226099054,98682,10991,7393,3596,1,3595,1,753,0,0.011682893,mm10,mBC-0716-1
"D9,G8",16367,17163,11947,5216,8687,0,4144,4153,2947,1206,2.443615257,2046,36947,11576,6025,7,6018,2,819,0,0.139913593,empty,mBC-0716-1
"D9,G9",11114,11667,8287,3380,6246,0,2885,2898,1983,915,2.167213115,1534,1270,745,426,0,426,0,156,0,0.037558685,empty,mBC-0716-1
"D9,G10",14019,14375,10627,3748,7675,0,3485,3487,2442,1045,2.336842105,1721,1984,1087,594,0,594,0,193,0,0.069023569,empty,mBC-0716-1
"D9,G11",12822,12682,9722,2960,6922,0,3111,3122,2188,934,2.34261242,1410,797,514,283,1,282,1,104,0,0.053191489,empty,mBC-0716-1
"D9,G12",630893,672007,470241,201766,363467,0,182115,182392,133053,49339,2.696710513,93789,87936,58136,28079,8,28071,1,2493,0,0.004061131,mm10,mBC-0716-1
"D9,H1",735993,772612,553181,219431,408955,0,197515,197847,160620,37227,4.314610363,99456,49971,36306,17600,4,17596,3,1763,0,0.000568311,mm10,mBC-0716-1
"D9,H2",945217,1024354,684830,339524,536502,0,290156,290588,219002,71586,3.059285335,156061,51590,37032,17776,9,17767,4,1846,0,0.002138797,mm10,mBC-0716-1
"D9,H3",20382,21075,15472,5603,11471,0,5197,5210,3759,1451,2.590627154,2559,1303,857,487,0,487,0,151,0,0.006160164,empty,mBC-0716-1
"D9,H4",14535,14992,10782,4210,7982,0,3833,3838,2697,1141,2.363716039,1962,434,175,97,0,97,0,36,0,0.113402062,empty,mBC-0716-1
"D9,H5",771547,855367,545150,310217,451247,0,260072,260439,186908,73531,2.541893895,143955,69250,48830,23156,13,23143,3,2285,0,0.001771594,mm10,mBC-0716-1
"D9,H6",742611,798745,529369,269376,425225,0,233616,233971,169118,64853,2.607712827,125547,70544,49028,23404,4,23400,1,2253,0,0.001367521,mm10,mBC-0716-1
"D9,H7",19066,19693,14158,5535,10558,0,4983,4995,3524,1471,2.395649218,2425,23019,7761,3865,2,3863,2,625,0,0.119855035,empty,mBC-0716-1
"D9,H8",14491,14839,10801,4038,7868,0,3658,3667,2617,1050,2.492380952,1854,37193,11913,6142,9,6133,3,898,0,0.053970324,empty,mBC-0716-1
"D9,H9",767128,799422,567634,231788,422450,1,207694,208001,159179,48822,3.260394904,104933,54848,39331,18682,5,18677,2,1934,0,0.000428334,mm10,mBC-0716-1
"D9,H10",511578,525590,390277,135313,281407,0,128400,128653,88424,40229,2.198016356,63601,35778,19383,8866,4,8862,2,1324,0,0.018393139,mm10,mBC-0716-1
"D9,H11",650992,710881,468720,242161,378340,0,202839,203187,168555,34632,4.867030492,110162,2792,1879,952,0,952,0,205,0,0.013655462,empty,mBC-0716-1
"D9,H12",6577,6885,4933,1952,3670,0,1726,1732,1198,534,2.243445693,892,623,348,172,0,172,0,67,0,0.052325581,empty,mBC-0716-1
"D10,A1",15285,16061,11452,4609,8678,0,4132,4135,2989,1146,2.608202443,2102,891,614,318,0,318,0,86,0,0.062893082,empty,mBC-0716-1
"D10,A2",19880,20310,15227,5083,10724,0,4802,4805,3436,1369,2.509861213,2282,885,511,256,0,256,0,76,0,0.015625,empty,mBC-0716-1
"D10,A3",17186,18104,13100,5004,9568,0,4502,4510,3140,1370,2.291970803,2231,592,388,198,0,198,0,50,0,0.191919192,empty,mBC-0716-1
"D10,A4",21429,21881,16550,5331,11522,1,5022,5042,3613,1429,2.528341498,2322,1225,480,240,0,240,0,52,0,0.0375,empty,mBC-0716-1
"D10,A5",540184,577451,409900,167551,310230,0,148390,148653,109410,39243,2.788013149,75855,92761,66037,31593,9,31584,1,2535,0,0.000918186,mm10,mBC-0716-1
"D10,A6",13644,14181,10462,3719,7728,0,3619,3631,2526,1105,2.285972851,1739,922,587,325,1,324,1,88,0,0.055555556,empty,mBC-0716-1
"D10,A7",16791,17458,12959,4499,9203,0,4217,4230,2918,1312,2.224085366,1960,2708,1155,544,2,542,1,129,0,0.031365314,empty,mBC-0716-1
"D10,A8",11469,12129,8692,3437,6548,0,3079,3085,2158,927,2.32793959,1554,1544,757,386,0,386,0,105,0,0.101036269,empty,mBC-0716-1
"D10,A9",693581,696176,524411,171765,368129,2,163339,163668,121979,41689,2.925927703,78280,34718,18780,8853,9,8844,2,1172,0,0.016960651,mm10,mBC-0716-1
"D10,A10",15975,16353,12074,4279,8759,0,3982,3988,2817,1171,2.405636208,1965,1709,588,285,0,285,0,67,0,0,empty,mBC-0716-1
"D10,A11",18282,18504,14016,4488,10166,0,4507,4511,3229,1282,2.518720749,2073,833,510,220,1,219,1,63,0,0.0456621,empty,mBC-0716-1
"D10,A12",20192,20616,15634,4982,10783,0,4824,4830,3372,1458,2.312757202,2205,2401,1544,714,0,714,0,150,0,0.109243697,empty,mBC-0716-1
"D10,B1",19463,19795,15126,4669,10448,0,4683,4689,3321,1368,2.427631579,2203,1103,755,353,0,353,0,89,0,0.04815864,empty,mBC-0716-1
"D10,B2",20134,20747,15474,5273,10841,0,4899,4907,3373,1534,2.198826597,2264,491,274,148,0,148,0,54,0,0,empty,mBC-0716-1
"D10,B3",18516,19052,14300,4752,10281,0,4616,4626,3219,1407,2.287846482,2146,556,360,178,0,178,0,71,0,0.106741573,empty,mBC-0716-1
"D10,B4",16945,17290,12895,4395,9155,0,4126,4131,2885,1246,2.31540931,1932,721,418,226,0,226,0,70,0,0.03539823,empty,mBC-0716-1
"D10,B5",326276,177625,140378,37247,121751,6,44935,45333,35091,10242,3.426186292,22079,3952,2819,1301,0,1301,0,293,0,0.020753267,empty,mBC-0716-1
"D10,B6",12285,12974,9343,3631,6954,0,3309,3318,2331,987,2.361702128,1619,930,580,304,0,304,0,75,0,0.023026316,empty,mBC-0716-1
"D10,B7",16335,16841,12590,4251,9028,0,4119,4124,2881,1243,2.317779566,1884,959,522,272,0,272,0,63,0,0.073529412,empty,mBC-0716-1
"D10,B8",13279,13923,10176,3747,7389,0,3338,3345,2353,992,2.371975806,1621,779,512,265,0,265,0,62,0,0.143396226,empty,mBC-0716-1
"D10,B9",14874,15313,11439,3874,8072,0,3574,3581,2497,1084,2.303505535,1692,670,345,160,0,160,0,52,0,0,empty,mBC-0716-1
"D10,B10",16927,16383,12301,4082,9199,0,4260,4287,2989,1298,2.302773498,2048,450,236,138,0,138,0,45,0,0.079710145,empty,mBC-0716-1
"D10,B11",16751,17390,12817,4573,9238,0,4278,4287,3029,1258,2.407790143,2073,135,94,50,0,50,0,21,0,0,empty,mBC-0716-1
"D10,B12",18302,18552,13870,4682,9898,0,4505,4523,3229,1294,2.495363215,2104,2361,1002,490,0,490,0,117,0,0.032653061,empty,mBC-0716-1
"D10,C1",1004936,1062603,750610,311993,551791,0,277712,278162,220643,57519,3.836002017,141435,27312,19569,9304,1,9303,1,1181,0,0.000429969,mm10,mBC-0716-1
"D10,C2",21392,22088,15947,6141,11628,0,5505,5519,3962,1557,2.544637123,2764,7722,3015,1533,1,1532,1,257,0,0.248694517,empty,mBC-0716-1
"D10,C3",20091,21080,15383,5697,11160,0,5083,5096,3590,1506,2.383798141,2472,422,235,130,0,130,0,41,0,0.053846154,empty,mBC-0716-1
"D10,C4",730689,781945,528989,252956,417253,1,218000,218316,188100,30216,6.225178713,115217,113042,73202,34556,16,34540,2,2851,0,0.001563405,mm10,mBC-0716-1
"D10,C5",16552,17033,12629,4404,9131,0,4217,4228,2959,1269,2.331757289,2016,1228,692,353,1,352,1,88,0,0.267045455,empty,mBC-0716-1
"D10,C6",17648,18005,13352,4653,9953,0,4586,4598,3281,1317,2.491268033,2181,2355,1041,545,0,545,0,133,0,0.016513761,empty,mBC-0716-1
"D10,C7",16403,17124,12467,4657,9186,0,4319,4329,3025,1304,2.319785276,2142,1028,368,195,0,195,0,45,0,0.005128205,empty,mBC-0716-1
"D10,C8",14955,15540,11360,4180,8268,0,3903,3904,2716,1188,2.286195286,1892,4026,1483,751,0,751,0,175,0,0.03861518,empty,mBC-0716-1
"D10,C9",12902,13130,9780,3350,7066,0,3239,3254,2295,959,2.393117831,1509,1145,508,228,0,228,0,75,0,0.109649123,empty,mBC-0716-1
"D10,C10",653941,699698,488545,211153,371929,1,185470,185797,143242,42555,3.366043943,96514,66990,46356,22159,6,22153,1,2082,0,0.001263937,mm10,mBC-0716-1
"D10,C11",11797,12386,8947,3439,6596,0,3049,3059,2130,929,2.292787944,1490,736,463,221,0,221,0,72,0,0,empty,mBC-0716-1
"D10,C12",21091,21458,15770,5688,11465,0,5280,5296,3724,1572,2.368956743,2576,3890,1508,733,0,733,0,165,0,0.051841746,empty,mBC-0716-1
"D10,D1",12398,12840,9330,3510,6937,0,3258,3260,2300,960,2.395833333,1621,3204,1166,586,1,585,1,109,0,0.020512821,empty,mBC-0716-1
"D10,D2",20478,20716,15828,4888,10955,3,4698,4715,3296,1419,2.322762509,2150,1708,1066,540,0,540,0,124,0,0.053703704,empty,mBC-0716-1
"D10,D3",14011,14572,10554,4018,7921,0,3774,3781,2622,1159,2.262295082,1871,893,565,285,0,285,0,86,0,0.098245614,empty,mBC-0716-1
"D10,D4",666863,737627,476205,261422,396383,0,224127,224433,166706,57727,2.887834116,123283,29348,20880,10049,6,10043,1,1246,0,0.001692721,mm10,mBC-0716-1
"D10,D5",14290,15042,11001,4041,8077,0,3771,3776,2717,1059,2.565627951,1861,806,518,256,0,256,0,88,0,0.04296875,empty,mBC-0716-1
"D10,D6",12784,13191,9648,3543,7214,0,3321,3331,2358,973,2.423432682,1662,867,512,284,0,284,0,88,0,0.059859155,empty,mBC-0716-1
"D10,D7",13930,14417,10609,3808,7741,0,3664,3667,2603,1064,2.446428571,1783,1200,790,409,0,409,0,116,0,0.070904645,empty,mBC-0716-1
"D10,D8",16196,16701,12196,4505,9016,0,4141,4147,2812,1335,2.106367041,2035,840,542,247,0,247,0,72,0,0.056680162,empty,mBC-0716-1
"D10,D9",6342,6790,4624,2166,3710,0,1897,1901,1402,499,2.809619238,949,958,632,315,0,315,0,85,0,0.038095238,empty,mBC-0716-1
"D10,D10",13523,13889,10330,3559,7499,0,3417,3432,2416,1016,2.377952756,1620,709,411,227,0,227,0,65,0,0.066079295,empty,mBC-0716-1
"D10,D11",720470,772063,530548,241515,409299,1,210176,210513,171398,39115,4.381899527,109351,121283,78876,38185,14,38171,4,2652,0,0.003484321,mm10,mBC-0716-1
"D10,D12",20626,21192,15820,5372,11209,0,5038,5052,3551,1501,2.365756163,2371,2583,1559,744,2,742,1,167,0,0.087601078,empty,mBC-0716-1
"D10,E1",22578,23119,17381,5738,12381,1,5594,5612,4010,1602,2.503121099,2693,1289,840,409,0,409,0,110,0,0.114914425,empty,mBC-0716-1
"D10,E2",1150895,1287087,782446,504641,685335,0,424350,424907,293464,131443,2.232633157,240856,136182,93611,45187,25,45162,2,3248,0,0.003144236,mm10,mBC-0716-1
"D10,E3",12184,12655,9434,3221,6846,0,3100,3103,2142,961,2.2289282,1448,1083,697,356,0,356,0,103,0,0.056179775,empty,mBC-0716-1
"D10,E4",16042,16495,12397,4098,8608,0,3873,3883,2753,1130,2.436283186,1825,999,631,298,4,294,1,83,0,0.193877551,empty,mBC-0716-1
"D10,E5",20792,21217,16046,5171,11117,0,4832,4846,3353,1493,2.245813798,2220,1455,712,338,0,338,0,102,0,0,empty,mBC-0716-1
"D10,E6",14301,14495,10922,3573,7745,0,3480,3482,2461,1021,2.410381978,1623,1198,764,384,1,383,1,97,0,0.062663185,empty,mBC-0716-1
"D10,E7",14607,14881,11074,3807,7984,0,3610,3616,2569,1047,2.453677173,1795,1273,707,359,0,359,0,109,0,0.114206128,empty,mBC-0716-1
"D10,E8",17400,17734,13545,4189,9559,0,4130,4146,2893,1253,2.308858739,1870,1618,1056,525,0,525,0,129,0,0.015238095,empty,mBC-0716-1
"D10,E9",241708,241610,189369,52241,133250,0,52372,52509,39854,12655,3.149269064,24142,20642,14334,6859,1,6858,1,951,0,0.002478857,mm10,mBC-0716-1
"D10,E10",13075,13539,10053,3486,7121,0,3199,3206,2253,953,2.364113326,1488,1233,726,401,0,401,0,91,0,0.099750623,empty,mBC-0716-1
"D10,E11",9504,9872,7106,2766,5356,0,2532,2537,1792,745,2.405369128,1283,670,418,219,0,219,0,74,0,0,empty,mBC-0716-1
"D10,E12",406966,423964,300778,123186,232685,1,115322,115520,92247,23273,3.963691832,59147,16307,10341,4900,3,4897,2,810,0,0.008372473,mm10,mBC-0716-1
"D10,F1",17453,17620,13193,4427,9431,0,4254,4261,2914,1347,2.163325909,2018,5423,1858,930,1,929,1,190,0,0.009687836,empty,mBC-0716-1
"D10,F2",22858,24042,17433,6609,12753,0,5945,5959,4233,1726,2.452491309,2923,1782,1165,575,0,575,0,167,0,0.04,empty,mBC-0716-1
"D10,F3",17145,18151,12954,5197,9537,0,4603,4606,3270,1336,2.44760479,2225,1272,843,379,0,379,0,118,0,0.015831135,empty,mBC-0716-1
"D10,F4",752955,800273,540988,259285,432855,1,229968,230320,195181,35139,5.554540539,121295,25237,17504,8241,3,8238,1,1140,0,0.001456664,mm10,mBC-0716-1
"D10,F5",24807,25533,18984,6549,13479,0,6176,6187,4395,1792,2.452566964,2965,7850,2617,1282,3,1279,2,247,0,0.06567631,empty,mBC-0716-1
"D10,F6",24433,25436,18597,6839,13413,0,6169,6185,4367,1818,2.402090209,3020,3312,1519,745,0,745,0,165,0,0.057718121,empty,mBC-0716-1
"D10,F7",20075,20703,15507,5196,11269,0,5104,5118,3549,1569,2.261950287,2420,900,583,289,2,287,1,78,0,0.06271777,empty,mBC-0716-1
"D10,F8",790988,876740,555236,321504,467114,2,270087,270430,227825,42605,5.347377068,149870,6842,4099,2066,2,2064,1,370,0,0.012596899,mm10,mBC-0716-1
"D10,F9",15621,16250,11939,4311,8855,0,4125,4125,2901,1224,2.370098039,1946,1177,700,372,0,372,0,121,0,0.016129032,empty,mBC-0716-1
"D10,F10",20226,20194,15762,4432,10875,0,4674,4689,3382,1307,2.587605203,2115,1074,720,364,0,364,0,102,0,0.093406593,empty,mBC-0716-1
"D10,F11",11596,12213,8949,3264,6514,0,2917,2920,2066,854,2.419203747,1461,903,618,302,0,302,0,84,0,0.099337748,empty,mBC-0716-1
"D10,F12",14130,14782,10858,3924,7778,1,3538,3546,2508,1038,2.416184971,1737,70,46,20,0,20,0,6,0,0,empty,mBC-0716-1
"D10,G1",9966,10200,7657,2543,5461,0,2446,2449,1660,789,2.103929024,1146,1473,1010,514,0,514,0,116,0,0.035019455,empty,mBC-0716-1
"D10,G2",21082,22134,16115,6019,11536,0,5244,5256,3636,1620,2.244444444,2562,402,293,146,0,146,0,36,0,0.02739726,empty,mBC-0716-1
"D10,G3",683143,759895,477326,282569,405834,3,237206,237540,184295,53245,3.461263968,133304,37640,24673,11624,6,11618,1,1446,0,0.00077466,mm10,mBC-0716-1
"D10,G4",28650,28583,21953,6630,15063,0,6505,6517,4593,1924,2.387214137,2924,59,42,26,0,26,0,15,0,0,empty,mBC-0716-1
"D10,G5",13630,14039,10282,3757,7393,0,3350,3358,2292,1066,2.150093809,1634,1780,808,413,0,413,0,111,0,0.053268765,empty,mBC-0716-1
"D10,G6",24631,25313,19010,6303,13262,0,5874,5884,4116,1768,2.328054299,2726,406,201,94,0,94,0,29,0,0.021276596,empty,mBC-0716-1
"D10,G7",19932,20296,15519,4777,10782,0,4632,4644,3293,1351,2.437453738,2128,2119,1086,548,0,548,0,156,0,0.00729927,empty,mBC-0716-1
"D10,G8",14836,15466,11373,4093,8222,0,3821,3827,2678,1149,2.330722367,1850,1244,777,391,0,391,0,121,0,0.010230179,empty,mBC-0716-1
"D10,G9",11104,11528,8433,3095,6117,0,2787,2788,1966,822,2.391727494,1306,821,542,282,0,282,0,83,0,0.067375887,empty,mBC-0716-1
"D10,G10",13911,14252,10631,3621,7685,0,3380,3392,2320,1072,2.164179104,1617,985,684,321,0,321,0,99,0,0.046728972,empty,mBC-0716-1
"D10,G11",12859,13139,9920,3219,7052,3,3260,3270,2406,864,2.784722222,1520,668,420,204,0,204,0,60,0,0,empty,mBC-0716-1
"D10,G12",11788,12092,8951,3141,6568,0,3013,3019,2172,847,2.564344746,1441,902,604,301,0,301,0,78,0,0.086378738,empty,mBC-0716-1
"D10,H1",21134,21742,15960,5782,11645,0,5363,5378,3751,1627,2.305470191,2597,930,652,319,0,319,0,93,0,0.018808777,empty,mBC-0716-1
"D10,H2",1207725,1323693,841958,481735,684615,0,406197,406822,312280,94542,3.303082228,222174,70775,51303,23912,7,23905,1,2245,0,0.001798787,mm10,mBC-0716-1
"D10,H3",21234,21941,16033,5908,11705,0,5526,5547,3874,1673,2.315600717,2691,864,506,279,0,279,0,96,0,0.025089606,empty,mBC-0716-1
"D10,H4",14081,14474,10620,3854,7749,0,3661,3672,2540,1132,2.243816254,1760,113,63,33,0,33,0,15,0,0.151515152,empty,mBC-0716-1
"D10,H5",857784,908889,619950,288939,476053,1,248523,248913,215481,33432,6.445351759,130604,34837,21864,10136,3,10133,2,1402,0,0.001381624,mm10,mBC-0716-1
"D10,H6",15946,16798,12093,4705,9034,0,4268,4281,3101,1180,2.627966102,2151,1099,705,361,0,361,0,108,0,0.091412742,empty,mBC-0716-1
"D10,H7",18154,18659,13628,5031,10237,1,4829,4842,3481,1361,2.557678178,2349,3968,1656,867,1,866,1,193,0,0.043879908,empty,mBC-0716-1
"D10,H8",17964,18556,13739,4817,10028,0,4612,4620,3342,1278,2.615023474,2199,4833,1771,917,0,917,0,164,0,0.049073064,empty,mBC-0716-1
"D10,H9",18527,19465,14011,5454,10532,0,4953,4967,3653,1314,2.780060883,2533,911,593,282,0,282,0,80,0,0.056737589,empty,mBC-0716-1
"D10,H10",15267,15773,11638,4135,8546,0,3902,3911,2790,1121,2.488849242,1907,8015,2834,1451,0,1451,0,293,0,0.081323225,empty,mBC-0716-1
"D10,H11",17693,18168,13352,4816,9905,1,4628,4640,3276,1364,2.401759531,2292,107,63,41,0,41,0,21,0,0,empty,mBC-0716-1
"D10,H12",6577,6738,4942,1796,3688,0,1736,1742,1239,503,2.463220676,844,466,229,111,0,111,0,48,0,0,empty,mBC-0716-1
"D11,A1",663846,706007,478845,227162,380522,1,198129,198426,169622,28804,5.888834884,104456,93679,52569,25633,12,25621,1,2423,0,0.020256821,mm10,mBC-0716-1
"D11,A2",554669,577333,411746,165587,311523,0,151904,152138,128334,23804,5.391278777,76594,56386,38548,18491,5,18486,2,1816,0,0.001352375,mm10,mBC-0716-1
"D11,A3",794544,898736,546414,352322,479519,0,292851,293266,222811,70455,3.162458307,167505,2500,1181,554,0,554,0,164,0,0.070397112,empty,mBC-0716-1
"D11,A4",19036,19521,14716,4805,10174,0,4488,4494,3193,1301,2.454265949,2042,705,329,165,0,165,0,50,0,0.006060606,empty,mBC-0716-1
"D11,A5",15326,15919,11790,4129,8526,0,3887,3893,2751,1142,2.408931699,1828,1071,569,299,0,299,0,108,0,0.076923077,empty,mBC-0716-1
"D11,A6",15566,16340,11526,4814,8933,1,4362,4371,3253,1118,2.909660107,2210,797,504,293,0,293,0,113,0,0.017064846,empty,mBC-0716-1
"D11,A7",14833,15479,11214,4265,8291,0,3773,3781,2632,1149,2.290687554,1822,763,500,268,0,268,0,104,0,0.052238806,empty,mBC-0716-1
"D11,A8",10025,10196,7601,2595,5692,0,2641,2644,1883,761,2.474375821,1252,3356,1389,718,0,718,0,184,0,0.059888579,empty,mBC-0716-1
"D11,A9",16908,17307,12983,4324,9059,0,4027,4034,2898,1136,2.551056338,1852,1596,782,383,0,383,0,111,0,0.127937337,empty,mBC-0716-1
"D11,A10",14358,14693,10903,3790,7924,0,3513,3530,2504,1026,2.440545809,1680,345,211,122,0,122,0,54,0,0.016393443,empty,mBC-0716-1
"D11,A11",1718855,1816049,1253373,562676,954015,2,510223,511039,413033,98006,4.214364427,264738,63482,40970,19260,11,19249,2,2180,0,0.00275339,mm10,mBC-0716-1
"D11,A12",17950,18277,13757,4520,9698,0,4224,4237,2956,1281,2.307572209,2006,2024,1269,618,0,618,0,149,0,0.051779935,empty,mBC-0716-1
"D11,B1",983791,1039482,728052,311430,538508,0,262980,263420,226459,36961,6.126971673,133717,115002,76064,36599,24,36575,3,2856,0,0.000628845,mm10,mBC-0716-1
"D11,B2",17920,18058,13670,4388,9807,0,4433,4440,3043,1397,2.178239084,2085,411,258,129,0,129,0,42,0,0.007751938,empty,mBC-0716-1
"D11,B3",19445,20346,14617,5729,10972,0,5301,5314,3743,1571,2.38255888,2641,888,517,299,0,299,0,110,0,0.056856187,empty,mBC-0716-1
"D11,B4",698394,758235,516145,242090,403414,1,205206,205509,173256,32253,5.371779369,107660,96456,63244,30537,14,30523,3,2564,0,0.00481604,mm10,mBC-0716-1
"D11,B5",12226,9163,6264,2899,5907,0,2964,2984,2042,942,2.167728238,1647,472,257,149,0,149,0,63,0,0.073825503,empty,mBC-0716-1
"D11,B6",11484,12057,8768,3289,6437,0,2998,3002,2080,922,2.255965293,1448,795,496,261,0,261,0,92,0,0.0651341,empty,mBC-0716-1
"D11,B7",14760,14935,11204,3731,8041,0,3633,3637,2553,1084,2.355166052,1728,1835,828,361,1,360,1,106,0,0.027777778,empty,mBC-0716-1
"D11,B8",565641,616795,410073,206722,331479,0,174826,175089,147232,27857,5.285278386,93128,69026,48564,23141,7,23134,2,2129,0,0.001296793,mm10,mBC-0716-1
"D11,B9",13621,14040,10508,3532,7363,0,3311,3313,2255,1058,2.131379962,1546,459,321,164,0,164,0,59,0,0.256097561,empty,mBC-0716-1
"D11,B10",15244,14830,10765,4065,8349,1,3904,3934,2680,1254,2.137161085,1967,290,185,96,0,96,0,48,0,0.020833333,empty,mBC-0716-1
"D11,B11",590511,616579,428786,187793,329854,0,170142,170421,122220,48201,2.535632041,89810,2842,1856,881,0,881,0,188,0,0.001135074,empty,mBC-0716-1
"D11,B12",16073,16634,12110,4524,8883,0,4051,4061,2865,1196,2.39548495,1924,1022,686,343,0,343,0,98,0,0.034985423,empty,mBC-0716-1
"D11,C1",19687,20085,15221,4864,10607,0,4530,4541,3101,1440,2.153472222,2113,470,284,163,0,163,0,71,0,0.073619632,empty,mBC-0716-1
"D11,C2",3854848,4193325,2744583,1448742,2112610,1,1244175,1245913,1012596,233317,4.340000943,675126,330961,230324,110217,38,110179,5,5599,0,0.001515715,mm10,mBC-0716-1
"D11,C3",734324,797617,531916,265701,423316,0,225851,226164,176520,49644,3.555716703,121403,32910,18002,8651,4,8647,1,1126,0,0.002659882,mm10,mBC-0716-1
"D11,C4",16541,16897,12705,4192,9159,1,4084,4092,2947,1145,2.573799127,1968,862,580,320,0,320,0,117,0,0.034375,empty,mBC-0716-1
"D11,C5",15807,15997,12038,3959,8431,0,3774,3784,2682,1102,2.433756806,1754,570,341,192,0,192,0,78,0,0.088541667,empty,mBC-0716-1
"D11,C6",16874,17393,12594,4799,9723,0,4656,4668,3412,1256,2.71656051,2365,704,443,237,0,237,0,98,0,0.016877637,empty,mBC-0716-1
"D11,C7",14658,15399,11234,4165,8417,0,3860,3869,2694,1175,2.292765957,1922,366,265,131,0,131,0,48,0,0.015267176,empty,mBC-0716-1
"D11,C8",13464,14066,10195,3871,7669,0,3603,3614,2505,1109,2.258791704,1815,886,518,277,0,277,0,115,0,0.068592058,empty,mBC-0716-1
"D11,C9",491208,528298,357451,170847,286568,0,151005,151250,100616,50634,1.987123277,83119,4570,2823,1400,1,1399,1,296,0,0.005003574,mm10,mBC-0716-1
"D11,C10",12006,12402,9145,3257,6761,0,3113,3119,2210,909,2.431243124,1540,748,521,259,1,258,1,82,0,0.096899225,empty,mBC-0716-1
"D11,C11",10618,10810,8150,2660,5786,0,2654,2657,1918,739,2.595399188,1237,578,340,199,0,199,0,74,0,0.120603015,empty,mBC-0716-1
"D11,C12",18145,18700,13589,5111,10125,0,4686,4695,3352,1343,2.495904691,2325,4615,1537,749,0,749,0,167,0,0.073431242,empty,mBC-0716-1
"D11,D1",11144,11671,8283,3388,6387,0,3110,3116,2222,894,2.485458613,1578,993,381,163,0,163,0,50,0,0.012269939,empty,mBC-0716-1
"D11,D2",18205,18310,14128,4182,9805,0,4275,4295,2955,1340,2.205223881,1970,1784,1047,556,0,556,0,163,0,0.118705036,empty,mBC-0716-1
"D11,D3",667089,718806,487469,231337,386203,0,206939,207242,156183,51059,3.058873068,108939,33992,24640,11864,2,11862,1,1346,0,0.005142472,mm10,mBC-0716-1
"D11,D4",688098,785950,466183,319767,422228,2,261268,261607,215912,45695,4.725068388,151357,41995,28698,13466,7,13459,2,1562,0,0.000668698,mm10,mBC-0716-1
"D11,D5",1068174,1125440,805261,320179,598195,2,287272,287753,232472,55281,4.205278486,145751,173504,121352,58268,24,58244,3,3644,0,0.000515075,mm10,mBC-0716-1
"D11,D6",11429,12050,8573,3477,6550,0,3146,3150,2181,969,2.250773994,1586,835,517,210,0,210,0,88,0,0,empty,mBC-0716-1
"D11,D7",12662,13185,9583,3602,7065,0,3274,3280,2342,938,2.496801706,1626,1012,673,356,0,356,0,117,0,0.028089888,empty,mBC-0716-1
"D11,D8",15129,15858,11399,4459,8588,0,4030,4038,2789,1249,2.232986389,2034,539,355,207,0,207,0,93,0,0,empty,mBC-0716-1
"D11,D9",5819,5974,4234,1740,3341,0,1680,1682,1205,477,2.526205451,881,10198,3299,1688,0,1688,0,299,0,0.029028436,empty,mBC-0716-1
"D11,D10",822985,917849,567201,350648,485995,0,289394,289793,229276,60517,3.788621379,162805,38281,21932,10681,8,10673,2,1340,0,0.004591024,mm10,mBC-0716-1
"D11,D11",884797,928842,655337,273505,499311,0,254620,255018,186390,68628,2.715946844,130136,37445,22355,10993,6,10987,4,1522,0,0.009829799,mm10,mBC-0716-1
"D11,D12",18215,18508,13949,4559,9816,0,4504,4505,3206,1299,2.468052348,1998,1749,1158,612,0,612,0,194,0,0.050653595,empty,mBC-0716-1
"D11,E1",20141,20504,15403,5101,11088,0,4951,4968,3516,1452,2.421487603,2345,1140,760,386,0,386,0,147,0,0.010362694,empty,mBC-0716-1
"D11,E2",15746,15881,11998,3883,8750,0,4011,4023,2855,1168,2.444349315,1860,2992,1219,618,1,617,1,173,0,0.030794165,empty,mBC-0716-1
"D11,E3",10835,11191,8381,2810,6022,0,2659,2662,1865,797,2.340025094,1240,842,531,316,0,316,0,121,0,0.028481013,empty,mBC-0716-1
"D11,E4",14464,14810,11043,3767,7843,0,3475,3482,2449,1033,2.370764763,1642,6914,2162,1087,3,1084,2,265,0,0.046125461,empty,mBC-0716-1
"D11,E5",1401849,1474613,1014055,460558,779903,0,422948,423586,309567,114019,2.715047492,223210,14436,9930,4876,4,4872,1,837,0,0.003899836,mm10,mBC-0716-1
"D11,E6",12586,12774,9674,3100,6826,0,3040,3044,2139,905,2.363535912,1400,960,592,310,0,310,0,98,0,0.083870968,empty,mBC-0716-1
"D11,E7",12538,12860,9483,3377,6901,0,3134,3143,2209,934,2.36509636,1518,997,625,314,0,314,0,102,0,0.047770701,empty,mBC-0716-1
"D11,E8",15863,15972,12305,3667,8729,0,3791,3796,2618,1178,2.222410866,1774,1207,761,404,0,404,0,133,0,0.056930693,empty,mBC-0716-1
"D11,E9",8939,9369,6778,2591,5054,0,2382,2385,1699,686,2.476676385,1209,693,405,230,0,230,0,100,0,0.056521739,empty,mBC-0716-1
"D11,E10",11831,12301,9044,3257,6626,0,3019,3023,2126,897,2.370122631,1421,862,539,297,0,297,0,98,0,0.047138047,empty,mBC-0716-1
"D11,E11",8733,9149,6632,2517,4990,0,2301,2309,1664,645,2.579844961,1105,914,491,262,0,262,0,101,0,0.003816794,empty,mBC-0716-1
"D11,E12",379567,386852,280812,106040,212877,0,102854,103025,79565,23460,3.391517477,51213,3511,2383,1102,1,1101,1,291,0,0.008174387,mm10,mBC-0716-1
"D11,F1",16061,16569,12289,4280,8781,0,3897,3916,2747,1169,2.349871685,1872,767,463,230,0,230,0,72,0,0.082608696,empty,mBC-0716-1
"D11,F2",603298,716218,381951,334267,386761,2,264424,264711,207620,57091,3.63665026,161739,60372,38567,18479,10,18469,1,1984,0,0.002815529,mm10,mBC-0716-1
"D11,F3",1359655,1548040,932808,615232,822219,1,505958,506540,364100,142440,2.556163999,291943,114047,79304,37437,13,37424,2,3105,0,0.000587858,mm10,mBC-0716-1
"D11,F4",512955,528650,379419,149231,290600,0,143046,143324,104016,39308,2.646178895,72139,14297,5630,2755,1,2754,1,532,0,0.009440813,mm10,mBC-0716-1
"D11,F5",21225,21999,16122,5877,11734,0,5375,5386,3785,1601,2.364147408,2595,1114,666,311,0,311,0,127,0,0.035369775,empty,mBC-0716-1
"D11,F6",22212,22794,16704,6090,12275,0,5693,5701,4038,1663,2.428141912,2761,1397,873,430,0,430,0,141,0,0.01627907,empty,mBC-0716-1
"D11,F7",18550,19112,14062,5050,10353,0,4669,4679,3360,1319,2.547384382,2250,3303,1135,561,1,560,1,134,0,0.083928571,empty,mBC-0716-1
"D11,F8",21295,22002,16185,5817,11756,0,5389,5397,3844,1553,2.475209272,2615,248,168,95,0,95,0,51,0,0,empty,mBC-0716-1
"D11,F9",1363612,1486417,960794,525623,785468,0,444529,445081,328908,116173,2.831191413,245766,219007,141710,67690,33,67657,2,4085,0,0.002423992,mm10,mBC-0716-1
"D11,F10",565189,591030,419972,171058,320801,0,161797,162068,120053,42015,2.857384268,83060,7949,5416,2626,1,2625,1,512,0,0.006095238,mm10,mBC-0716-1
"D11,F11",10574,10871,8036,2835,5904,0,2678,2681,1900,781,2.432778489,1279,2085,693,377,1,376,1,116,0,0.034574468,empty,mBC-0716-1
"D11,F12",12612,12774,9476,3298,6824,0,3050,3056,2103,953,2.206715635,1500,50,36,21,0,21,0,17,0,0.095238095,empty,mBC-0716-1
"D11,G1",12370,12724,9656,3068,6966,0,2994,3005,2035,970,2.097938144,1418,1405,867,465,0,465,0,132,0,0.025806452,empty,mBC-0716-1
"D11,G2",18307,18573,13941,4632,9997,0,4368,4377,3027,1350,2.242222222,2063,294,188,118,0,118,0,48,0,0,empty,mBC-0716-1
"D11,G3",17996,18088,13612,4476,9796,0,4458,4468,3138,1330,2.359398496,2055,3639,1387,714,0,714,0,204,0,0.018207283,empty,mBC-0716-1
"D11,G4",25263,25570,19561,6009,13563,0,5894,5913,4200,1713,2.451838879,2645,107,71,44,0,44,0,23,0,0,empty,mBC-0716-1
"D11,G5",12061,12501,9150,3351,6722,0,3086,3094,2150,944,2.277542373,1501,1724,691,385,0,385,0,117,0,0.088311688,empty,mBC-0716-1
"D11,G6",21932,22081,16845,5236,11871,0,5210,5228,3809,1419,2.684284708,2464,192,153,86,0,86,0,37,0,0,empty,mBC-0716-1
"D11,G7",704433,766027,496243,269784,412361,0,239364,239721,187133,52588,3.558473416,129591,24484,15711,7692,5,7687,2,1096,0,0.003252244,mm10,mBC-0716-1
"D11,G8",13504,14206,10163,4043,7671,0,3684,3691,2571,1120,2.295535714,1832,1895,890,470,1,469,1,129,0,0.044776119,empty,mBC-0716-1
"D11,G9",9856,10007,7418,2589,5461,0,2579,2585,1820,765,2.379084967,1233,773,508,256,0,256,0,111,0,0.0703125,empty,mBC-0716-1
"D11,G10",12267,12533,9341,3192,6841,0,3034,3037,2204,833,2.645858343,1469,753,478,273,0,273,0,104,0,0.062271062,empty,mBC-0716-1
"D11,G11",11132,11156,8447,2709,6075,0,2662,2666,1842,824,2.235436893,1221,710,395,237,1,236,1,80,0,0.059322034,empty,mBC-0716-1
"D11,G12",10408,10638,7856,2782,5825,0,2683,2693,1856,837,2.21744325,1308,2489,829,449,1,448,1,130,0,0.055803571,empty,mBC-0716-1
"D11,H1",21542,22546,16511,6035,12115,0,5666,5677,4092,1585,2.58170347,2759,927,645,331,0,331,0,102,0,0.03021148,empty,mBC-0716-1
"D11,H2",25376,25963,19319,6644,13951,0,6434,6446,4638,1808,2.565265487,3078,1086,700,419,1,418,1,149,0,0.040669856,empty,mBC-0716-1
"D11,H3",18956,19580,14343,5237,10548,0,4952,4963,3545,1418,2.5,2453,890,545,281,0,281,0,108,0,0.088967972,empty,mBC-0716-1
"D11,H4",630095,678605,443432,235173,362118,0,202183,202469,170152,32317,5.265092676,108972,4210,3114,1437,0,1437,0,275,0,0,mm10,mBC-0716-1
"D11,H5",16578,17412,12418,4994,9392,0,4379,4383,3121,1262,2.473058637,2216,1185,749,385,0,385,0,130,0,0.106493506,empty,mBC-0716-1
"D11,H6",14034,14668,10463,4205,7951,0,3721,3722,2678,1044,2.5651341,1826,1208,781,441,0,441,0,145,0,0.065759637,empty,mBC-0716-1
"D11,H7",16474,17023,12445,4578,9263,0,4260,4269,3057,1212,2.522277228,2122,971,656,348,0,348,0,145,0,0.014367816,empty,mBC-0716-1
"D11,H8",494318,540998,345226,195772,291370,0,164330,164565,139905,24660,5.673357664,90755,93016,62318,29715,12,29703,2,2547,0,0.000841666,mm10,mBC-0716-1
"D11,H9",916891,1009644,611284,398360,532540,1,331897,332377,273525,58852,4.647675525,185517,60353,41531,20061,8,20053,1,1937,0,0.002942203,mm10,mBC-0716-1
"D11,H10",590349,625647,427131,198516,333922,2,172405,172678,147802,24876,5.941550088,90421,56651,40864,19193,4,19189,1,1964,0,0.001615509,mm10,mBC-0716-1
"D11,H11",1337447,1456568,928934,527634,766041,3,447523,448230,333532,114698,2.907914698,248615,1108,685,345,0,345,0,92,0,0,empty,mBC-0716-1
"D11,H12",5663,5888,4334,1554,3232,0,1470,1473,1008,465,2.167741935,714,439,245,150,0,150,0,43,0,0.046666667,empty,mBC-0716-1
"D12,A1",12500,12756,9414,3342,7016,0,3330,3333,2346,987,2.376899696,1580,767,532,294,0,294,0,81,0,0.078231293,empty,mBC-0716-1
"D12,A2",16691,16651,12729,3922,8869,0,3834,3841,2660,1181,2.252328535,1752,872,556,254,0,254,0,82,0,0.015748031,empty,mBC-0716-1
"D12,A3",14320,14953,10933,4020,7972,0,3664,3671,2482,1189,2.087468461,1795,762,507,238,0,238,0,73,0,0.046218487,empty,mBC-0716-1
"D12,A4",18693,19034,14461,4573,10030,0,4266,4280,3017,1263,2.388756928,1999,412,248,150,1,149,1,52,0,0.067114094,empty,mBC-0716-1
"D12,A5",652003,726080,456098,269982,390173,1,227331,227627,178517,49110,3.635043779,126540,46235,32806,15180,3,15177,1,1664,0,0.003096791,mm10,mBC-0716-1
"D12,A6",19756,20903,14652,6251,11294,0,5561,5566,4163,1403,2.967213115,2876,1117,660,309,0,309,0,103,0,0.022653722,empty,mBC-0716-1
"D12,A7",14432,14921,11127,3794,7947,0,3691,3706,2510,1196,2.098662207,1749,829,514,246,0,246,0,86,0,0.036585366,empty,mBC-0716-1
"D12,A8",9896,10061,7521,2540,5453,0,2585,2591,1816,775,2.343225806,1209,1022,612,327,0,327,0,120,0,0.04587156,empty,mBC-0716-1
"D12,A9",18433,18454,13950,4504,9741,0,4304,4319,3199,1120,2.85625,1980,11939,4044,2085,1,2084,1,384,0,0.031190019,empty,mBC-0716-1
"D12,A10",13675,14091,10395,3696,7549,0,3469,3481,2359,1122,2.102495544,1704,320,170,90,0,90,0,30,0,0,empty,mBC-0716-1
"D12,A11",1283956,1415467,894329,521138,747547,2,441237,441903,338429,103474,3.270667027,244306,105641,69685,33345,15,33330,4,2804,0,0.002040204,mm10,mBC-0716-1
"D12,A12",17528,18129,13551,4578,9555,0,4191,4201,2900,1301,2.229054573,1989,3820,2560,1180,0,1180,0,256,0,0.033050847,empty,mBC-0716-1
"D12,B1",17138,17585,13087,4498,9241,1,4174,4184,2930,1254,2.336523126,1968,687,396,225,0,225,0,79,0,0.04,empty,mBC-0716-1
"D12,B2",18020,18358,13904,4454,9584,0,4279,4288,2960,1328,2.228915663,1993,410,222,134,0,134,0,45,0,0.052238806,empty,mBC-0716-1
"D12,B3",16752,17038,12795,4243,8933,0,3986,4004,2790,1214,2.298187809,1865,658,417,215,0,215,0,73,0,0.013953488,empty,mBC-0716-1
"D12,B4",14672,15114,11313,3801,8139,0,3628,3628,2506,1122,2.233511586,1669,863,449,224,0,224,0,79,0,0.142857143,empty,mBC-0716-1
"D12,B5",7914,4879,3385,1494,3306,0,1577,1591,1097,494,2.220647773,884,537,360,165,0,165,0,60,0,0.090909091,empty,mBC-0716-1
"D12,B6",10757,10814,8082,2732,5738,1,2559,2563,1814,749,2.421895861,1229,7044,2090,1019,2,1017,1,199,0,0.022615536,empty,mBC-0716-1
"D12,B7",14113,14425,10699,3726,7729,0,3341,3354,2325,1029,2.259475219,1609,728,465,224,0,224,0,65,0,0.017857143,empty,mBC-0716-1
"D12,B8",614214,672316,436549,235767,358013,1,201728,202009,169831,32178,5.27786065,109401,75553,50830,24212,9,24203,1,2251,0,0.001487419,mm10,mBC-0716-1
"D12,B9",13402,13496,10147,3349,7144,0,3146,3154,2193,961,2.281997919,1485,8152,2851,1364,1,1363,1,265,0,0.046955246,empty,mBC-0716-1
"D12,B10",15410,14796,11113,3683,8268,0,3758,3793,2561,1232,2.078733766,1779,2956,1207,595,1,594,1,127,0,0.063973064,empty,mBC-0716-1
"D12,B11",14291,14591,11088,3503,7730,0,3408,3420,2398,1022,2.346379648,1561,255,149,82,0,82,0,33,0,0,empty,mBC-0716-1
"D12,B12",16780,17162,12672,4490,9023,0,4107,4114,2856,1258,2.27027027,1946,18844,5945,2931,2,2929,2,442,0,0.07715944,empty,mBC-0716-1
"D12,C1",19984,20527,15727,4800,10612,0,4595,4614,3270,1344,2.433035714,2121,494,341,176,0,176,0,65,0,0.039772727,empty,mBC-0716-1
"D12,C2",16653,17294,12647,4647,9096,0,4171,4190,2955,1235,2.392712551,2030,7248,2297,1107,0,1107,0,242,0,0.057813911,empty,mBC-0716-1
"D12,C3",38873,41087,30185,10902,21920,0,10193,10207,7605,2602,2.922751729,5021,2148,1539,719,0,719,0,145,0,0.008344924,empty,mBC-0716-1
"D12,C4",15000,15312,11458,3854,8095,0,3520,3530,2463,1067,2.308341143,1671,1015,650,312,0,312,0,102,0,0.016025641,empty,mBC-0716-1
"D12,C5",14673,15050,11192,3858,7853,0,3542,3550,2553,997,2.560682046,1709,794,485,216,0,216,0,72,0,0.055555556,empty,mBC-0716-1
"D12,C6",14811,15244,11169,4075,8527,0,3931,3940,2860,1080,2.648148148,1938,784,501,294,1,293,1,88,0,0.085324232,empty,mBC-0716-1
"D12,C7",15006,15837,11470,4367,8236,0,3836,3849,2732,1117,2.445837064,1878,270,153,90,0,90,0,35,0,0.066666667,empty,mBC-0716-1
"D12,C8",13344,13794,10114,3680,7308,0,3205,3209,2277,932,2.443133047,1504,2544,1100,596,0,596,0,150,0,0.045302013,empty,mBC-0716-1
"D12,C9",11278,11764,8578,3186,6161,0,2878,2882,2054,828,2.480676329,1384,1174,762,370,0,370,0,93,0,0.032432432,empty,mBC-0716-1
"D12,C10",12059,12534,9239,3295,6742,0,3056,3062,2118,944,2.243644068,1468,1702,1149,577,1,576,1,131,0,0.0625,empty,mBC-0716-1
"D12,C11",9883,10384,7538,2846,5654,0,2686,2694,1841,853,2.158264947,1355,1089,724,349,0,349,0,93,0,0.014326648,empty,mBC-0716-1
"D12,C12",17388,17829,13228,4601,9452,0,4284,4294,2977,1317,2.260440395,2006,1615,1067,501,0,501,0,134,0,0,empty,mBC-0716-1
"D12,D1",969335,1041207,694719,346488,557482,1,300100,300558,247690,52868,4.685064689,160770,93267,62989,30013,15,29998,3,2583,0,0.000833389,mm10,mBC-0716-1
"D12,D2",18637,18654,14292,4362,9876,0,4231,4237,2930,1307,2.241775057,1942,2076,1398,677,0,677,0,157,0,0.050221566,empty,mBC-0716-1
"D12,D3",11994,12335,9024,3311,6620,0,3068,3074,2127,947,2.246040127,1425,868,507,235,0,235,0,77,0,0.021276596,empty,mBC-0716-1
"D12,D4",12943,12957,9790,3167,6943,0,3166,3173,2195,978,2.244376278,1474,3101,1428,716,0,716,0,143,0,0.227653631,empty,mBC-0716-1
"D12,D5",12075,12410,9252,3158,6572,0,2987,2990,2109,881,2.393870602,1418,847,481,249,0,249,0,87,0,0.036144578,empty,mBC-0716-1
"D12,D6",10938,11400,8321,3079,6156,0,2881,2893,2041,852,2.395539906,1407,985,690,332,0,332,0,84,0,0.069277108,empty,mBC-0716-1
"D12,D7",11314,11584,8642,2942,6136,0,2805,2807,1953,854,2.286885246,1318,1885,1021,543,0,543,0,143,0,0.040515654,empty,mBC-0716-1
"D12,D8",13911,14137,10705,3432,7566,0,3448,3455,2451,1004,2.44123506,1595,625,354,209,0,209,0,79,0,0.009569378,empty,mBC-0716-1
"D12,D9",436195,476074,298637,177437,260645,1,154687,154893,112171,42722,2.625602734,86691,40042,28024,13477,4,13473,2,1699,0,0.002300898,mm10,mBC-0716-1
"D12,D10",13044,13343,9764,3579,7230,0,3352,3361,2364,997,2.37111334,1669,1203,795,403,0,403,0,106,0,0.017369727,empty,mBC-0716-1
"D12,D11",11486,11831,8805,3026,6385,0,2886,2901,2012,889,2.263217098,1390,4602,1685,834,1,833,1,199,0,0.044417767,empty,mBC-0716-1
"D12,D12",18047,18401,13736,4665,9685,0,4432,4440,3069,1371,2.238512035,2020,2843,1955,985,1,984,1,208,0,0.06300813,empty,mBC-0716-1
"D12,E1",794912,836402,590862,245540,442088,0,220409,220727,189702,31025,6.114488316,111615,77974,55928,26859,10,26849,1,2339,0,0.003612797,mm10,mBC-0716-1
"D12,E2",14262,14323,10854,3469,7711,0,3428,3441,2432,1009,2.410307235,1575,1274,693,348,1,347,1,115,0,0.109510086,empty,mBC-0716-1
"D12,E3",31555,33018,24113,8905,17474,0,8002,8018,6157,1861,3.308436325,3917,6764,4587,2105,0,2105,0,420,0,0.009026128,empty,mBC-0716-1
"D12,E4",762826,785630,579265,206365,411163,0,186957,187297,155492,31805,4.888916837,90748,140845,100328,47789,17,47772,2,3228,0,0.001046638,mm10,mBC-0716-1
"D12,E5",19010,19452,14826,4626,10304,0,4523,4535,3229,1306,2.472434916,2128,935,613,312,0,312,0,104,0,0.006410256,empty,mBC-0716-1
"D12,E6",11803,12097,9036,3061,6603,0,2962,2967,2077,890,2.333707865,1457,4163,1702,805,1,804,1,181,0,0.0460199,empty,mBC-0716-1
"D12,E7",619013,670501,444351,226150,358002,0,193898,194191,158940,35251,4.508808261,104391,76880,52886,25296,10,25286,1,2303,0,0.001028237,mm10,mBC-0716-1
"D12,E8",666102,743743,452436,291307,398502,3,248549,248849,181457,67392,2.692559948,141071,32491,22769,10663,6,10657,2,1410,0,0.003753402,mm10,mBC-0716-1
"D12,E9",8653,8905,6635,2270,4767,0,2179,2185,1532,653,2.346094946,1035,4449,1950,927,0,927,0,188,0,0.012944984,empty,mBC-0716-1
"D12,E10",11301,11767,8683,3084,6242,0,2849,2854,2006,848,2.365566038,1374,2946,1776,846,0,846,0,199,0,0.009456265,empty,mBC-0716-1
"D12,E11",7846,8034,5962,2072,4421,0,2013,2017,1348,669,2.014947683,916,1988,1334,717,0,717,0,163,0,0.027894003,empty,mBC-0716-1
"D12,E12",14265,14809,10740,4069,7999,0,3783,3792,2648,1144,2.314685315,1880,1158,684,338,1,337,1,90,0,0.083086053,empty,mBC-0716-1
"D12,F1",15508,15945,11954,3991,8389,0,3707,3713,2594,1119,2.318141197,1749,1217,768,390,0,390,0,107,0,0.094871795,empty,mBC-0716-1
"D12,F2",720211,786458,517820,268638,416079,0,226299,226630,173812,52818,3.290772085,122553,121466,87072,41821,15,41806,3,3052,0,0.001148161,mm10,mBC-0716-1
"D12,F3",13915,14412,10456,3956,7711,0,3603,3617,2584,1033,2.501452081,1777,1411,831,455,0,455,0,149,0,0.061538462,empty,mBC-0716-1
"D12,F4",14499,14618,10973,3645,8044,0,3669,3676,2580,1096,2.354014599,1755,424,249,126,0,126,0,51,0,0.095238095,empty,mBC-0716-1
"D12,F5",21285,21819,16342,5477,11548,0,5129,5135,3585,1550,2.312903226,2468,1503,956,506,1,505,1,131,0,0.005940594,empty,mBC-0716-1
"D12,F6",20729,21069,15828,5241,11141,0,5073,5084,3543,1541,2.299156392,2320,1654,996,498,0,498,0,134,0,0.086345382,empty,mBC-0716-1
"D12,F7",17450,17990,13385,4605,9636,3,4320,4331,3016,1315,2.293536122,2017,723,508,236,0,236,0,76,0,0.012711864,empty,mBC-0716-1
"D12,F8",20510,20925,15621,5304,11066,0,5058,5065,3583,1482,2.417678812,2355,1753,568,282,1,281,1,69,0,0.024911032,empty,mBC-0716-1
"D12,F9",13363,13646,10239,3407,7295,0,3295,3297,2363,934,2.529978587,1545,1783,1245,657,0,657,0,192,0,0.01674277,empty,mBC-0716-1
"D12,F10",724141,798590,522007,276583,425656,1,235308,235640,167082,68558,2.437089763,127913,80212,57479,27270,10,27260,2,2436,0,0.002677916,mm10,mBC-0716-1
"D12,F11",10165,9961,7866,2095,5282,0,2236,2242,1561,681,2.292217327,983,1571,1041,496,1,495,1,130,0,0.034343434,empty,mBC-0716-1
"D12,F12",12387,12791,9492,3299,6671,0,3007,3013,2106,907,2.321940463,1452,113,69,35,0,35,0,9,0,0,empty,mBC-0716-1
"D12,G1",9077,9357,7014,2343,4975,0,2248,2257,1552,705,2.20141844,1041,2153,1080,510,0,510,0,128,0,0.019607843,empty,mBC-0716-1
"D12,G2",18829,19201,14336,4865,10011,0,4455,4464,3126,1338,2.33632287,2121,2264,691,326,0,326,0,82,0,0.027607362,empty,mBC-0716-1
"D12,G3",17167,17532,12951,4581,9299,0,4246,4270,2941,1329,2.212942062,2019,1426,954,487,0,487,0,134,0,0.090349076,empty,mBC-0716-1
"D12,G4",805396,838918,586057,252861,445513,1,232967,233381,165189,68192,2.422410253,121505,235,165,82,0,82,0,26,0,0,empty,mBC-0716-1
"D12,G5",610123,690197,425757,264440,367599,0,212393,212691,183368,29323,6.253384715,120093,72690,52496,25206,4,25202,2,2269,0,0.002777557,mm10,mBC-0716-1
"D12,G6",736593,762494,565162,197332,401351,0,180936,181273,147391,33882,4.350126911,87608,3531,2332,1108,0,1108,0,223,0,0.003610108,mm10,mBC-0716-1
"D12,G7",17612,17950,13638,4312,9594,0,4268,4283,3005,1278,2.351330203,1911,1344,833,405,0,405,0,132,0,0.041975309,empty,mBC-0716-1
"D12,G8",12898,13150,9734,3416,6972,0,3194,3205,2186,1019,2.145240432,1529,4604,1541,778,1,777,1,174,0,0.086229086,empty,mBC-0716-1
"D12,G9",9153,9536,7042,2494,5156,0,2377,2387,1635,752,2.174202128,1152,1367,904,470,0,470,0,117,0,0.046808511,empty,mBC-0716-1
"D12,G10",11903,12189,9274,2915,6384,0,2816,2823,1950,873,2.233676976,1329,1592,1020,507,0,507,0,133,0,0.023668639,empty,mBC-0716-1
"D12,G11",10802,11331,8354,2977,5997,0,2777,2784,1950,834,2.338129496,1334,568,342,186,0,186,0,69,0,0,empty,mBC-0716-1
"D12,G12",10073,10141,7651,2490,5543,0,2539,2549,1767,782,2.259590793,1201,1274,834,406,3,403,1,116,0,0.009925558,empty,mBC-0716-1
"D12,H1",695990,751950,488372,263578,403316,0,234812,235124,189149,45975,4.114170745,127241,3938,2486,1172,0,1172,0,271,0,0.041808874,mm10,mBC-0716-1
"D12,H2",21098,21549,16148,5401,11247,0,4918,4937,3519,1418,2.481664316,2343,4573,1968,987,1,986,1,183,0,0.117647059,empty,mBC-0716-1
"D12,H3",17865,18265,13453,4812,9652,0,4455,4472,3161,1311,2.411136537,2169,1310,751,398,0,398,0,119,0,0.045226131,empty,mBC-0716-1
"D12,H4",12013,12317,9103,3214,6525,0,2987,2993,2047,946,2.16384778,1411,42,27,14,0,14,0,5,0,0,empty,mBC-0716-1
"D12,H5",16127,16585,12416,4169,8668,0,3908,3924,2825,1099,2.570518653,1788,1229,841,380,0,380,0,105,0,0.010526316,empty,mBC-0716-1
"D12,H6",12167,12370,9221,3149,6778,0,3083,3086,2153,933,2.307609861,1471,1123,704,378,0,378,0,105,0,0.095238095,empty,mBC-0716-1
"D12,H7",570973,620087,413749,206338,335553,1,178905,179194,147156,32038,4.59317061,95949,46800,32292,15340,8,15332,3,1659,0,0.000391338,mm10,mBC-0716-1
"D12,H8",568186,635856,395370,240486,338291,0,199038,199313,149070,50243,2.966980475,112874,73150,49212,23378,10,23368,1,2102,0,0.004707292,mm10,mBC-0716-1
"D12,H9",13632,13811,10387,3424,7460,0,3301,3304,2302,1002,2.29740519,1575,1420,963,465,0,465,0,135,0,0.053763441,empty,mBC-0716-1
"D12,H10",13522,13910,10232,3678,7370,0,3438,3440,2310,1130,2.044247788,1649,1972,1174,548,0,548,0,155,0,0.02189781,empty,mBC-0716-1
"D12,H11",14768,15194,11138,4056,8173,0,3782,3786,2679,1107,2.420054201,1809,59,32,18,0,18,0,16,0,0,empty,mBC-0716-1
"D12,H12",5376,5536,4072,1464,2981,0,1368,1370,958,412,2.325242718,655,757,514,291,0,291,0,80,0,0.017182131,empty,mBC-0716-1
"E1,A1",13928,14624,10428,4196,7947,0,3852,3856,2769,1087,2.547378105,1911,1806,924,473,0,473,0,116,0,0.084566596,empty,mBC-0716-1
"E1,A2",18519,19116,14167,4949,10218,0,4690,4696,3278,1418,2.311706629,2283,993,590,297,0,297,0,88,0,0.070707071,empty,mBC-0716-1
"E1,A3",15519,16140,11721,4419,8585,1,3988,3993,2845,1148,2.478222997,1940,1956,846,441,0,441,0,121,0,0.027210884,empty,mBC-0716-1
"E1,A4",18677,18971,14347,4624,10072,0,4377,4384,3135,1249,2.510008006,2014,566,282,142,0,142,0,53,0,0.056338028,empty,mBC-0716-1
"E1,A5",15513,16108,11770,4338,8552,0,3991,4005,2845,1160,2.452586207,1920,1308,824,357,0,357,0,96,0,0.022408964,empty,mBC-0716-1
"E1,A6",25182,27238,18594,8644,14832,0,7522,7534,5961,1573,3.789574062,3861,4166,1364,681,0,681,0,167,0,0.067547724,empty,mBC-0716-1
"E1,A7",527415,572056,384658,187398,309975,0,163046,163287,122594,40693,3.012655739,87209,42290,30307,14457,6,14451,2,1575,0,0.000484396,mm10,mBC-0716-1
"E1,A8",554218,608307,398162,210145,325665,0,175610,175875,145150,30725,4.724165989,94673,169668,121394,57184,27,57157,3,3615,0,0.000787305,mm10,mBC-0716-1
"E1,A9",16886,16994,13108,3886,8938,0,3875,3890,2776,1114,2.491921005,1781,3233,1158,599,0,599,0,138,0,0.111853088,empty,mBC-0716-1
"E1,A10",15179,15516,11400,4116,8219,1,3687,3701,2659,1042,2.551823417,1783,387,229,137,0,137,0,47,0,0.138686131,empty,mBC-0716-1
"E1,A11",16303,17036,12635,4401,9232,1,4255,4267,2938,1329,2.210684725,2120,1158,699,352,0,352,0,102,0,0.048295455,empty,mBC-0716-1
"E1,A12",18514,18708,14224,4484,9768,0,4292,4300,3019,1281,2.356752537,1978,2091,1362,633,0,633,0,160,0,0.05371248,empty,mBC-0716-1
"E1,B1",16877,17000,13117,3883,9079,0,4077,4084,2897,1187,2.440606571,1782,961,597,313,0,313,0,111,0,0.073482428,empty,mBC-0716-1
"E1,B2",17991,18220,13509,4711,9579,0,4260,4268,3012,1256,2.398089172,2053,2616,895,439,0,439,0,91,0,0.086560364,empty,mBC-0716-1
"E1,B3",631992,690548,455259,235289,371936,0,207482,207767,164466,43301,3.798203275,111506,42406,29217,13972,6,13966,1,1550,0,0.003508521,mm10,mBC-0716-1
"E1,B4",14765,15112,11357,3755,8170,0,3638,3648,2569,1079,2.380908248,1722,958,556,292,0,292,0,96,0,0.030821918,empty,mBC-0716-1
"E1,B5",8877,5568,3847,1721,3791,0,1848,1861,1303,558,2.335125448,1017,4736,1580,841,2,839,2,179,0,0.087008343,empty,mBC-0716-1
"E1,B6",11128,11818,8499,3319,6236,0,2929,2938,2071,867,2.388696655,1437,886,591,310,0,310,0,87,0,0.096774194,empty,mBC-0716-1
"E1,B7",55294,61728,41962,19766,32631,0,16831,16859,12895,3964,3.253027245,8986,3938,2720,1287,1,1286,1,230,0,0.00466563,empty,mBC-0716-1
"E1,B8",11740,12102,8955,3147,6490,0,2945,2956,2078,878,2.366742597,1378,866,540,269,0,269,0,107,0,0.003717472,empty,mBC-0716-1
"E1,B9",800860,882088,566803,315285,462066,0,259569,259969,204035,55934,3.647781314,143254,55064,36936,17703,8,17695,2,1824,0,0.001299802,mm10,mBC-0716-1
"E1,B10",15379,15522,11082,4440,8620,0,4110,4127,2854,1273,2.241948154,2114,694,376,218,0,218,0,69,0,0.018348624,empty,mBC-0716-1
"E1,B11",17104,17937,13092,4845,9441,0,4437,4445,3139,1306,2.403522205,2134,214,140,80,0,80,0,34,0,0.025,empty,mBC-0716-1
"E1,B12",16655,17179,12838,4341,9146,0,4139,4150,2944,1206,2.441127695,1993,1089,702,336,0,336,0,99,0,0.05952381,empty,mBC-0716-1
"E1,C1",19288,19074,14900,4174,10006,0,4196,4205,2908,1297,2.242097147,1877,2316,987,510,0,510,0,133,0,0.103921569,empty,mBC-0716-1
"E1,C2",18548,19463,13788,5675,10280,0,4922,4930,3460,1470,2.353741497,2478,1590,1042,595,0,595,0,159,0,0.112605042,empty,mBC-0716-1
"E1,C3",17683,18332,13426,4906,9767,0,4400,4415,3156,1259,2.50675139,2157,554,324,202,0,202,0,63,0,0.02970297,empty,mBC-0716-1
"E1,C4",16075,16226,12315,3911,8879,0,3967,3980,2842,1138,2.497363796,1908,3825,1442,707,0,707,0,176,0,0.121640736,empty,mBC-0716-1
"E1,C5",16388,17032,12457,4575,9027,0,4185,4196,2971,1225,2.425306122,2034,1845,688,374,0,374,0,119,0,0.032085561,empty,mBC-0716-1
"E1,C6",16125,16323,12039,4284,9022,0,4173,4191,2961,1230,2.407317073,2041,8869,3003,1518,0,1518,0,275,0,0.0171278,empty,mBC-0716-1
"E1,C7",14964,15655,11254,4401,8241,1,3881,3886,2770,1116,2.482078853,1880,572,200,96,0,96,0,42,0,0,empty,mBC-0716-1
"E1,C8",13585,13907,10136,3771,7500,0,3494,3497,2474,1023,2.418377322,1712,1236,763,409,0,409,0,120,0,0.014669927,empty,mBC-0716-1
"E1,C9",11363,11770,8582,3188,6137,0,2833,2842,1986,856,2.320093458,1335,716,528,276,0,276,0,84,0,0.047101449,empty,mBC-0716-1
"E1,C10",12279,12643,9358,3285,6717,0,3039,3043,2101,942,2.230360934,1472,968,557,265,0,265,0,91,0,0,empty,mBC-0716-1
"E1,C11",10471,11398,7884,3514,6025,0,2860,2864,1989,875,2.273142857,1521,1536,717,322,0,322,0,98,0,0.031055901,empty,mBC-0716-1
"E1,C12",702935,757562,515136,242426,398450,1,208985,209323,150603,58720,2.564764986,111702,36037,25076,11746,3,11743,2,1455,0,0.002895342,mm10,mBC-0716-1
"E1,D1",11266,12039,8439,3600,6534,0,3180,3194,2243,951,2.358569926,1689,515,314,146,0,146,0,49,0,0.082191781,empty,mBC-0716-1
"E1,D2",17816,17938,13820,4118,9597,0,4125,4136,2978,1158,2.571675302,1852,1760,1180,604,0,604,0,182,0,0.072847682,empty,mBC-0716-1
"E1,D3",13633,13827,9940,3887,7435,0,3585,3594,2479,1115,2.223318386,1755,19587,6114,3030,2,3028,1,445,0,0.220277411,empty,mBC-0716-1
"E1,D4",748716,849584,509960,339624,452437,0,278040,278363,213764,64599,3.309091472,159763,77610,46007,21768,9,21759,2,2185,0,0.00114895,mm10,mBC-0716-1
"E1,D5",13499,14123,10366,3757,7562,0,3458,3466,2488,978,2.54396728,1736,1079,640,318,0,318,0,120,0,0.056603774,empty,mBC-0716-1
"E1,D6",506588,556217,366867,189350,300218,2,163603,163857,129166,34691,3.723328817,88161,74214,51002,24495,7,24488,1,2291,0,0.00122509,mm10,mBC-0716-1
"E1,D7",12662,13262,9613,3649,7112,0,3326,3333,2309,1024,2.254882813,1609,1382,827,383,0,383,0,134,0,0.052219321,empty,mBC-0716-1
"E1,D8",14562,14930,10999,3931,8035,0,3704,3715,2577,1138,2.264499121,1782,802,545,290,0,290,0,103,0,0.05862069,empty,mBC-0716-1
"E1,D9",5869,6418,4300,2118,3535,0,1813,1819,1349,470,2.870212766,1011,1189,672,329,0,329,0,101,0,0.015197568,empty,mBC-0716-1
"E1,D10",12814,13172,9765,3407,7079,0,3251,3260,2273,987,2.302938197,1541,1035,524,272,0,272,0,94,0,0.080882353,empty,mBC-0716-1
"E1,D11",11904,12274,9045,3229,6622,0,3129,3136,2156,980,2.2,1503,2056,1047,520,0,520,0,136,0,0.065384615,empty,mBC-0716-1
"E1,D12",18152,18776,13869,4907,9832,0,4523,4528,3145,1383,2.274041938,2146,1581,956,488,0,488,0,159,0,0.053278689,empty,mBC-0716-1
"E1,E1",19925,20667,15118,5549,11009,0,4951,4954,3529,1425,2.476491228,2385,1362,895,458,0,458,0,139,0,0.063318777,empty,mBC-0716-1
"E1,E2",15261,15627,11718,3909,8386,0,3794,3802,2769,1033,2.68054211,1794,1293,820,457,0,457,0,133,0,0.098468271,empty,mBC-0716-1
"E1,E3",10588,11044,8130,2914,5910,0,2649,2655,1900,755,2.516556291,1279,1407,911,465,0,465,0,123,0,0.092473118,empty,mBC-0716-1
"E1,E4",13687,14112,10571,3541,7559,0,3422,3434,2443,991,2.46518668,1613,1287,718,346,0,346,0,123,0,0.086705202,empty,mBC-0716-1
"E1,E5",18624,19188,14230,4958,10217,0,4540,4557,3189,1368,2.331140351,2155,3420,1518,801,1,800,1,182,0,0.0425,empty,mBC-0716-1
"E1,E6",17592,17808,13472,4336,9471,0,4225,4236,2996,1240,2.416129032,1946,16321,5896,2964,1,2963,1,487,0,0.12318596,empty,mBC-0716-1
"E1,E7",1243819,1344459,895861,448598,705064,1,380385,380921,326188,54733,5.959622166,202763,289548,192435,91223,26,91197,3,4715,0,0.002576839,mm10,mBC-0716-1
"E1,E8",16207,16477,12445,4032,8798,0,3847,3857,2650,1207,2.195526098,1822,14484,4787,2431,2,2429,2,415,0,0.050638123,empty,mBC-0716-1
"E1,E9",586961,626351,428159,198192,341946,0,176983,177230,144425,32805,4.402530102,93307,97554,68462,32863,10,32853,1,2829,0,0.001826317,mm10,mBC-0716-1
"E1,E10",11320,11878,8646,3232,6373,0,2918,2920,2018,902,2.237250554,1435,932,552,280,0,280,0,103,0,0.05,empty,mBC-0716-1
"E1,E11",563605,589039,427022,162017,318068,1,149792,150092,119024,31068,3.831080211,74720,73116,49472,23637,15,23622,3,2159,0,0.002709339,mm10,mBC-0716-1
"E1,E12",13895,14676,10383,4293,7901,0,3758,3770,2613,1157,2.258426966,1906,1261,852,459,0,459,0,116,0,0.126361656,empty,mBC-0716-1
"E1,F1",16040,16714,12408,4306,8804,0,3949,3958,2769,1189,2.328847771,1870,1516,841,404,0,404,0,124,0,0.076732673,empty,mBC-0716-1
"E1,F2",20973,21582,15971,5611,11562,0,5325,5330,3745,1585,2.362776025,2573,9612,3754,1918,2,1916,1,382,0,0.081941545,empty,mBC-0716-1
"E1,F3",513387,554114,369088,185026,301466,1,167167,167385,123292,44093,2.7961808,89574,20932,11820,5775,4,5771,1,975,0,0.018714261,mm10,mBC-0716-1
"E1,F4",17095,17576,12949,4627,9686,0,4571,4584,3223,1361,2.368111683,2181,569,348,184,0,184,0,73,0,0,empty,mBC-0716-1
"E1,F5",755335,823769,536564,287205,436271,0,246536,246874,196332,50542,3.884531677,134048,58694,38574,18656,9,18647,1,1859,0,0.002359629,mm10,mBC-0716-1
"E1,F6",727233,799227,510756,288471,424644,0,240759,241084,192864,48220,3.999668187,132779,117415,84270,39909,18,39891,3,2979,0,0.001303552,mm10,mBC-0716-1
"E1,F7",17662,18487,13492,4995,9879,0,4519,4529,3160,1369,2.3082542,2183,858,554,272,0,272,0,89,0,0.007352941,empty,mBC-0716-1
"E1,F8",20746,21930,15796,6134,11625,0,5344,5366,3833,1533,2.500326158,2672,264,166,83,0,83,0,38,0,0,empty,mBC-0716-1
"E1,F9",14856,15427,11398,4029,8183,0,3753,3763,2637,1126,2.341918295,1833,2103,1197,628,0,628,0,175,0,0.066878981,empty,mBC-0716-1
"E1,F10",18054,18362,14040,4322,9738,0,4238,4248,3049,1199,2.54295246,1914,1086,642,347,0,347,0,114,0,0.011527378,empty,mBC-0716-1
"E1,F11",695726,775042,484667,290375,414292,2,244302,244645,186713,57932,3.222968308,136922,94924,65718,31667,6,31661,1,2619,0,0.0004106,mm10,mBC-0716-1
"E1,F12",12561,12966,9535,3431,6896,0,3162,3174,2244,930,2.412903226,1555,135,91,42,0,42,0,12,0,0,empty,mBC-0716-1
"E1,G1",8644,8876,6630,2246,4737,0,2069,2075,1429,646,2.212074303,989,6567,2436,1246,1,1245,1,268,0,0.029718876,empty,mBC-0716-1
"E1,G2",18169,18347,13928,4419,9701,0,4282,4290,3078,1212,2.53960396,2017,394,224,121,0,121,0,44,0,0.05785124,empty,mBC-0716-1
"E1,G3",575822,580992,439826,141166,309977,0,137099,137365,113361,24004,4.722587902,64653,33037,22491,10856,2,10854,1,1356,0,0.004882992,mm10,mBC-0716-1
"E1,G4",24722,25043,19161,5882,13352,0,5689,5706,4086,1620,2.522222222,2616,76,55,39,0,39,0,27,0,0.025641026,empty,mBC-0716-1
"E1,G5",12105,12808,9156,3652,6751,0,3170,3176,2259,917,2.46346783,1625,850,530,293,0,293,0,103,0,0.054607509,empty,mBC-0716-1
"E1,G6",22176,22465,17150,5315,11965,0,5220,5227,3665,1562,2.346350832,2409,208,156,96,0,96,0,44,0,0,empty,mBC-0716-1
"E1,G7",17541,18236,13334,4902,9629,0,4294,4303,3072,1231,2.495532088,2085,1459,959,438,0,438,0,136,0,0.082191781,empty,mBC-0716-1
"E1,G8",13334,14433,10071,4362,7621,0,3668,3671,2530,1141,2.217353199,1930,1110,657,323,0,323,0,104,0,0.021671827,empty,mBC-0716-1
"E1,G9",9428,9869,7179,2690,5307,0,2461,2461,1734,727,2.385144429,1227,924,625,360,0,360,0,136,0,0.041666667,empty,mBC-0716-1
"E1,G10",12371,12592,9448,3144,6680,0,3039,3046,2115,931,2.271750806,1406,880,565,287,0,287,0,102,0,0.013937282,empty,mBC-0716-1
"E1,G11",11026,11559,8495,3064,6103,0,2907,2913,2091,822,2.54379562,1377,676,433,236,1,235,1,87,0,0,empty,mBC-0716-1
"E1,G12",10710,11217,8261,2956,6127,0,2879,2883,1993,890,2.239325843,1390,1085,747,364,0,364,0,110,0,0.098901099,empty,mBC-0716-1
"E1,H1",19486,20030,14857,5173,10699,1,4942,4954,3567,1387,2.571737563,2395,954,578,290,0,290,0,101,0,0.062068966,empty,mBC-0716-1
"E1,H2",21325,22371,16430,5941,11701,0,5338,5355,3797,1558,2.437098845,2597,1387,888,481,0,481,0,157,0,0.01039501,empty,mBC-0716-1
"E1,H3",18795,19584,14398,5186,10529,0,4886,4896,3540,1356,2.610619469,2351,2822,1173,548,1,547,1,154,0,0.060329068,empty,mBC-0716-1
"E1,H4",12251,12351,9412,2939,6794,0,3126,3136,2260,876,2.579908676,1433,116,77,35,0,35,0,16,0,0,empty,mBC-0716-1
"E1,H5",17145,18129,12968,5161,9626,0,4530,4539,3214,1325,2.425660377,2317,1841,985,504,0,504,0,152,0,0.023809524,empty,mBC-0716-1
"E1,H6",571339,611584,404436,207148,329021,1,178984,179238,156291,22947,6.81095568,96300,139605,91637,43561,17,43544,3,3369,0,0.005098291,mm10,mBC-0716-1
"E1,H7",16648,17336,12581,4755,9388,0,4403,4409,3146,1263,2.490894695,2141,2450,1068,573,0,573,0,174,0,0.043630017,empty,mBC-0716-1
"E1,H8",23060,24015,17089,6926,13325,0,6575,6578,5032,1546,3.254851229,3288,18880,5365,2760,3,2757,1,460,0,0.021400073,empty,mBC-0716-1
"E1,H9",15192,15855,11377,4478,8576,0,4015,4018,2860,1158,2.469775475,2075,1148,730,380,0,380,0,122,0,0.026315789,empty,mBC-0716-1
"E1,H10",14184,14655,10577,4078,7825,3,3591,3600,2543,1057,2.405865658,1808,965,664,294,0,294,0,106,0,0.040816327,empty,mBC-0716-1
"E1,H11",16552,17375,12655,4720,9254,0,4350,4361,3115,1246,2.5,2139,119,68,44,0,44,0,31,0,0,empty,mBC-0716-1
"E1,H12",5939,6001,4516,1485,3287,0,1521,1521,1094,427,2.56206089,710,512,353,176,0,176,0,60,0,0.0625,empty,mBC-0716-1
"E2,A1",12172,12423,9213,3210,6665,0,3072,3079,2116,963,2.197300104,1482,836,491,270,0,270,0,96,0,0.025925926,empty,mBC-0716-1
"E2,A2",15846,15945,12090,3855,8451,0,3734,3743,2622,1121,2.338983051,1751,26321,7412,3859,4,3855,2,608,0,0.052658885,empty,mBC-0716-1
"E2,A3",14056,14928,10555,4373,7729,0,3579,3583,2522,1061,2.377002828,1785,1404,601,333,0,333,0,93,0,0.096096096,empty,mBC-0716-1
"E2,A4",18716,19051,14565,4486,10002,0,4390,4402,3140,1262,2.488114105,1963,345,225,135,0,135,0,56,0,0.2,empty,mBC-0716-1
"E2,A5",14662,15376,11207,4169,8092,0,3756,3758,2643,1115,2.370403587,1826,1171,660,337,1,336,1,115,0,0.068452381,empty,mBC-0716-1
"E2,A6",647889,738759,434073,304686,391512,0,245706,246037,201934,44103,4.578690792,142147,67806,45757,21782,6,21776,3,2233,0,0.004041146,mm10,mBC-0716-1
"E2,A7",1401768,1516843,1011991,504852,794885,2,437088,437745,343555,94190,3.647467884,232795,111443,77186,36881,23,36858,3,2962,0,0.001763525,mm10,mBC-0716-1
"E2,A8",9449,9820,7091,2729,5196,0,2423,2426,1739,687,2.531295488,1161,1369,876,436,1,435,1,128,0,0.020689655,empty,mBC-0716-1
"E2,A9",16208,16568,12496,4072,8587,0,3693,3705,2562,1143,2.241469816,1745,1115,735,358,0,358,0,108,0,0.05027933,empty,mBC-0716-1
"E2,A10",13319,13526,10051,3475,7182,0,3220,3231,2273,958,2.372651357,1536,201,133,83,0,83,0,41,0,0.012048193,empty,mBC-0716-1
"E2,A11",14726,14969,11270,3699,8030,0,3534,3549,2406,1143,2.104986877,1669,866,482,258,0,258,0,89,0,0.019379845,empty,mBC-0716-1
"E2,A12",236376,242713,165726,76987,129334,0,70352,70437,52720,17717,2.975673082,37024,10303,5328,2649,2,2647,1,548,0,0.026822818,mm10,mBC-0716-1
"E2,B1",790032,891585,541566,350019,472544,0,294029,294443,223433,71010,3.146500493,167543,27926,18930,9141,4,9137,2,1182,0,0.003064463,mm10,mBC-0716-1
"E2,B2",1069386,1216304,713233,503071,638260,1,414771,415300,287340,127960,2.245545483,240777,6866,4132,2081,1,2080,1,392,0,0.012019231,mm10,mBC-0716-1
"E2,B3",16334,16602,12523,4079,8833,0,3963,3974,2740,1234,2.220421394,1914,8706,2765,1352,1,1351,1,260,0,0.051073279,empty,mBC-0716-1
"E2,B4",14365,14766,10892,3874,7962,0,3561,3574,2466,1108,2.225631769,1741,1900,878,483,0,483,0,124,0,0.062111801,empty,mBC-0716-1
"E2,B5",9997,7466,5202,2264,4800,0,2390,2401,1725,676,2.551775148,1271,11645,3742,1955,4,1951,3,339,0,0.051255766,empty,mBC-0716-1
"E2,B6",505481,553573,368463,185110,298358,1,162285,162482,117357,45125,2.600709141,87313,34723,23154,11243,1,11242,1,1386,0,0.010229497,mm10,mBC-0716-1
"E2,B7",1503733,1673575,1061192,612383,876016,1,511669,512362,403916,108446,3.72458182,284770,94747,66340,31792,4,31788,1,2792,0,0.000629168,mm10,mBC-0716-1
"E2,B8",12003,12339,9222,3117,6672,0,3016,3025,2124,901,2.357380688,1432,872,573,288,1,287,1,93,0,0,empty,mBC-0716-1
"E2,B9",13174,13468,10192,3276,7064,0,3095,3097,2116,981,2.156982671,1472,236,147,69,0,69,0,39,0,0,empty,mBC-0716-1
"E2,B10",719238,677028,473466,203562,380325,1,190159,191824,147203,44621,3.298962372,100679,24513,15256,7342,3,7339,1,967,0,0.004769042,mm10,mBC-0716-1
"E2,B11",708865,738390,528989,209401,386327,2,187532,187905,141322,46583,3.033767683,95202,2709,1910,859,0,859,0,210,0,0,empty,mBC-0716-1
"E2,B12",16011,16593,12273,4320,8825,0,3929,3940,2772,1168,2.373287671,1916,1813,806,426,0,426,0,125,0,0.056338028,empty,mBC-0716-1
"E2,C1",19931,20028,15391,4637,10458,0,4438,4455,3097,1358,2.280559647,2058,707,386,213,0,213,0,72,0,0.145539906,empty,mBC-0716-1
"E2,C2",16016,16361,12047,4314,8752,0,4015,4022,2803,1219,2.299425759,1961,1135,678,356,0,356,0,117,0,0.064606742,empty,mBC-0716-1
"E2,C3",19271,19789,14629,5160,10428,0,4945,4956,3455,1501,2.301798801,2369,445,215,134,0,134,0,45,0,0.007462687,empty,mBC-0716-1
"E2,C4",15296,15381,11814,3567,8213,0,3600,3607,2513,1094,2.297074954,1626,865,482,266,0,266,0,108,0,0.011278195,empty,mBC-0716-1
"E2,C5",13652,13962,10463,3499,7330,0,3327,3332,2360,972,2.427983539,1513,750,433,237,0,237,0,88,0,0.05907173,empty,mBC-0716-1
"E2,C6",14083,14603,10692,3911,7865,0,3588,3599,2506,1093,2.292772187,1783,921,548,286,0,286,0,100,0,0.034965035,empty,mBC-0716-1
"E2,C7",14147,14602,10704,3898,7670,0,3613,3621,2520,1101,2.288828338,1755,288,187,99,0,99,0,41,0,0,empty,mBC-0716-1
"E2,C8",894265,954473,642084,312389,499390,1,267100,267537,220607,46930,4.7007671,141808,72662,48334,23034,5,23029,1,2108,0,0.003300187,mm10,mBC-0716-1
"E2,C9",10555,10914,8074,2840,5753,0,2652,2661,1892,769,2.460338101,1255,973,464,242,0,242,0,73,0,0.012396694,empty,mBC-0716-1
"E2,C10",11743,11776,9007,2769,6266,0,2800,2806,1961,845,2.320710059,1209,792,503,257,0,257,0,95,0,0.003891051,empty,mBC-0716-1
"E2,C11",10773,11004,8123,2881,5898,0,2710,2716,1821,895,2.034636872,1326,1940,598,336,0,336,0,110,0,0,empty,mBC-0716-1
"E2,C12",17254,17714,13064,4650,9391,0,4300,4309,3044,1265,2.406324111,2146,822,583,309,0,309,0,99,0,0.048543689,empty,mBC-0716-1
"E2,D1",9368,9693,6848,2845,5088,0,2397,2399,1732,667,2.596701649,1180,12384,3944,2038,2,2036,2,294,0,0.171414538,empty,mBC-0716-1
"E2,D2",18729,19053,14487,4566,9990,0,4279,4292,3062,1230,2.489430894,1988,5352,2317,1122,1,1121,1,240,0,0.123104371,empty,mBC-0716-1
"E2,D3",11634,12053,8842,3211,6461,1,3003,3015,2057,958,2.147181628,1521,2639,1111,567,0,567,0,144,0,0.014109347,empty,mBC-0716-1
"E2,D4",12049,12522,9266,3256,6632,0,2956,2960,2080,880,2.363636364,1433,742,478,240,0,240,0,85,0,0.066666667,empty,mBC-0716-1
"E2,D5",11917,12446,9087,3359,6620,0,3010,3021,2124,897,2.367892977,1490,1083,627,311,0,311,0,105,0,0.048231511,empty,mBC-0716-1
"E2,D6",10662,11328,7969,3359,6050,0,2869,2873,1968,905,2.174585635,1446,8699,2847,1402,1,1401,1,277,0,0.032119914,empty,mBC-0716-1
"E2,D7",11474,12006,8533,3473,6268,0,2970,2975,2047,928,2.205818966,1509,12706,4390,2263,4,2259,1,372,0,0.05666224,empty,mBC-0716-1
"E2,D8",13875,14387,10584,3803,7771,0,3559,3561,2480,1081,2.294172063,1702,964,586,280,0,280,0,79,0,0.15,empty,mBC-0716-1
"E2,D9",3508,3565,2595,970,1947,0,908,910,659,251,2.625498008,437,2279,914,476,0,476,0,136,0,0.071428571,empty,mBC-0716-1
"E2,D10",11783,12100,8895,3205,6475,0,3003,3018,2094,924,2.266233766,1461,633,373,212,0,212,0,79,0,0.066037736,empty,mBC-0716-1
"E2,D11",11543,11835,8765,3070,6302,1,2867,2887,1960,927,2.114347357,1382,982,698,329,0,329,0,112,0,0.006079027,empty,mBC-0716-1
"E2,D12",17234,17570,13224,4346,9288,0,4166,4171,2835,1336,2.122005988,1902,1042,728,351,0,351,0,117,0,0.085470085,empty,mBC-0716-1
"E2,E1",18855,19269,14397,4872,10061,0,4457,4469,3108,1361,2.283614989,2101,1181,694,341,0,341,0,120,0,0.085043988,empty,mBC-0716-1
"E2,E2",13811,14304,10440,3864,7551,0,3416,3425,2411,1014,2.377712032,1640,1217,759,429,0,429,0,115,0,0.025641026,empty,mBC-0716-1
"E2,E3",10866,11111,8388,2723,5812,0,2559,2563,1745,818,2.133251834,1144,1207,722,375,0,375,0,118,0,0.013333333,empty,mBC-0716-1
"E2,E4",13786,14175,10558,3617,7296,0,3305,3312,2276,1036,2.196911197,1555,2011,891,443,2,441,1,127,0,0.079365079,empty,mBC-0716-1
"E2,E5",19454,19920,15011,4909,10422,0,4620,4627,3276,1351,2.424870466,2186,1411,875,460,0,460,0,112,0,0.043478261,empty,mBC-0716-1
"E2,E6",11140,11209,8411,2798,5978,0,2665,2671,1844,827,2.22974607,1250,5678,1977,997,2,995,1,212,0,0.028140704,empty,mBC-0716-1
"E2,E7",12285,12501,9252,3249,6698,0,3108,3114,2202,912,2.414473684,1457,889,555,314,0,314,0,109,0,0.060509554,empty,mBC-0716-1
"E2,E8",16973,17155,13032,4123,9089,0,3944,3957,2679,1278,2.096244131,1838,1647,1056,568,0,568,0,165,0,0.040492958,empty,mBC-0716-1
"E2,E9",7532,7925,5732,2193,4143,0,1857,1862,1319,543,2.429097606,894,869,512,254,0,254,0,76,0,0.023622047,empty,mBC-0716-1
"E2,E10",11714,12421,8845,3576,6498,0,3090,3090,2164,926,2.336933045,1578,946,597,299,1,298,1,88,0,0.097315436,empty,mBC-0716-1
"E2,E11",7918,8117,6003,2114,4316,0,1967,1970,1377,593,2.322091062,916,677,431,225,0,225,0,74,0,0.004444444,empty,mBC-0716-1
"E2,E12",619797,725368,408631,316737,387654,0,251628,251885,162439,89446,1.816056615,152160,16610,11254,5460,6,5454,2,832,0,0.000183352,mm10,mBC-0716-1
"E2,F1",15631,16111,11884,4227,8328,0,3752,3759,2579,1180,2.18559322,1793,10147,3140,1618,1,1617,1,291,0,0.069264069,empty,mBC-0716-1
"E2,F2",830959,961217,559577,401640,506721,1,317405,317802,258193,59609,4.331443238,186096,199635,135863,65700,23,65677,4,3831,0,0.002207774,mm10,mBC-0716-1
"E2,F3",13772,14469,10432,4037,7603,0,3622,3628,2583,1045,2.471770335,1762,1018,715,382,0,382,0,128,0,0.031413613,empty,mBC-0716-1
"E2,F4",1218176,1315330,869152,446178,702035,3,386505,387069,317645,69424,4.575435008,208497,48843,32483,15395,6,15389,1,1634,0,0.000519852,mm10,mBC-0716-1
"E2,F5",21371,21682,16410,5272,11190,0,4966,4983,3491,1492,2.339812332,2287,960,620,319,0,319,0,105,0,0,empty,mBC-0716-1
"E2,F6",20384,20609,15432,5177,10962,0,5045,5066,3568,1498,2.381842457,2423,4094,1584,784,1,783,1,188,0,0.021711367,empty,mBC-0716-1
"E2,F7",17316,18114,13341,4773,9665,0,4343,4357,3064,1293,2.369682908,2130,659,378,186,0,186,0,87,0,0.016129032,empty,mBC-0716-1
"E2,F8",19382,19828,14614,5214,10493,0,4733,4741,3383,1358,2.491163476,2316,218,134,70,0,70,0,35,0,0,empty,mBC-0716-1
"E2,F9",676055,709946,507122,202824,375376,0,178660,179008,152485,26523,5.749161105,89588,238313,166796,79190,28,79162,2,4171,0,0.001440085,mm10,mBC-0716-1
"E2,F10",859740,954892,610568,344324,501130,1,286200,286648,238224,48424,4.919544028,157319,69906,49936,23177,13,23164,1,2182,0,0.001338284,mm10,mBC-0716-1
"E2,F11",734490,774819,537963,236856,407537,3,207908,208266,176675,31591,5.592573834,106909,93302,66817,31959,8,31951,1,2662,0,0.000813746,mm10,mBC-0716-1
"E2,F12",1386561,1573968,940745,633223,815875,2,512418,513091,397781,115310,3.449666117,295932,4613,3025,1453,0,1453,0,272,0,0.008258775,mm10,mBC-0716-1
"E2,G1",9153,9493,7086,2407,5016,0,2206,2213,1501,712,2.108146067,1066,1835,1028,479,0,479,0,125,0,0.09394572,empty,mBC-0716-1
"E2,G2",1615277,1711712,1163082,548630,885977,1,483514,484224,391540,92684,4.224461611,253817,20035,13712,6633,1,6632,1,976,0,0.001055489,mm10,mBC-0716-1
"E2,G3",17013,17639,12848,4791,9194,0,4075,4087,2820,1267,2.225730071,2040,1483,969,500,0,500,0,136,0,0.08,empty,mBC-0716-1
"E2,G4",23957,24239,18481,5758,12772,0,5515,5529,3897,1632,2.387867647,2479,88,58,46,0,46,0,30,0,0.065217391,empty,mBC-0716-1
"E2,G5",11753,12009,8866,3143,6373,0,2847,2854,1996,858,2.326340326,1386,1926,997,489,0,489,0,143,0,0.073619632,empty,mBC-0716-1
"E2,G6",23163,23439,17698,5741,12226,0,5432,5454,3884,1570,2.47388535,2510,1174,491,243,2,241,2,63,0,0.037344398,empty,mBC-0716-1
"E2,G7",17998,18473,13915,4558,9587,0,4184,4194,2963,1231,2.40698619,1935,1438,765,394,0,394,0,127,0,0.091370558,empty,mBC-0716-1
"E2,G8",20834,21042,15146,5896,11311,0,5443,5451,3809,1642,2.319732034,2660,1652,1147,554,0,554,0,168,0,0.019855596,empty,mBC-0716-1
"E2,G9",868642,955462,597402,358060,496452,1,294857,295356,233794,61562,3.79769988,162320,154567,108590,51830,14,51816,2,3395,0,0.00040528,mm10,mBC-0716-1
"E2,G10",12144,12214,9161,3053,6410,0,2879,2888,2022,866,2.334872979,1368,11297,4148,2179,1,2178,1,346,0,0.220844812,empty,mBC-0716-1
"E2,G11",13808,14100,10531,3569,7506,0,3302,3316,2413,903,2.672203765,1519,676,315,152,0,152,0,72,0,0,empty,mBC-0716-1
"E2,G12",9635,9890,7307,2583,5342,0,2475,2483,1715,768,2.233072917,1151,1060,631,299,0,299,0,85,0,0.107023411,empty,mBC-0716-1
"E2,H1",17783,18204,13638,4566,9609,3,4285,4300,3097,1203,2.57439734,2010,714,450,213,0,213,0,88,0,0.070422535,empty,mBC-0716-1
"E2,H2",22583,23032,17337,5695,12168,1,5445,5461,3874,1587,2.441083806,2530,1521,1031,490,0,490,0,120,0,0.073469388,empty,mBC-0716-1
"E2,H3",17402,17950,13202,4748,9546,0,4378,4393,3104,1289,2.40806827,2165,1110,707,346,0,346,0,103,0,0.083815029,empty,mBC-0716-1
"E2,H4",11449,11698,8632,3066,6155,0,2832,2840,1983,857,2.313885648,1364,567,177,107,0,107,0,29,0,0.08411215,empty,mBC-0716-1
"E2,H5",15768,16384,11969,4415,8532,0,3902,3913,2821,1092,2.583333333,1913,1135,711,379,1,378,1,120,0,0.034391534,empty,mBC-0716-1
"E2,H6",11669,12165,8845,3320,6403,0,2934,2938,2092,846,2.472813239,1410,1316,835,433,0,433,0,148,0,0.057736721,empty,mBC-0716-1
"E2,H7",14728,14964,11120,3844,7999,0,3605,3618,2537,1081,2.346901018,1778,546,353,228,0,228,0,122,0,0.01754386,empty,mBC-0716-1
"E2,H8",11127,11584,8306,3278,6158,0,2821,2830,1944,886,2.194130926,1431,951,591,308,0,308,0,103,0,0.077922078,empty,mBC-0716-1
"E2,H9",596082,633117,435659,197458,337036,1,171462,171694,146449,25245,5.801109131,89324,91812,63784,30337,8,30329,1,2580,0,0.002637739,mm10,mBC-0716-1
"E2,H10",11788,11978,9074,2904,6289,0,2860,2870,1956,914,2.140043764,1289,1025,657,339,0,339,0,102,0,0.038348083,empty,mBC-0716-1
"E2,H11",1101679,1169525,814703,354822,615014,0,308910,309390,258857,50533,5.12253379,159518,4901,3083,1422,0,1422,0,302,0,0.000703235,mm10,mBC-0716-1
"E2,H12",5232,5461,3887,1574,2876,0,1346,1349,953,396,2.406565657,659,462,293,164,0,164,0,54,0,0.054878049,empty,mBC-0716-1
"E3,A1",13912,14016,10593,3423,7854,0,3686,3693,2604,1089,2.391184573,1727,1288,793,399,0,399,0,117,0,0.035087719,empty,mBC-0716-1
"E3,A2",18833,18868,14504,4364,9907,0,4224,4230,2968,1262,2.351822504,1956,1890,1091,619,0,619,0,155,0,0.046849758,empty,mBC-0716-1
"E3,A3",16334,16946,12621,4325,9035,0,4138,4149,2908,1241,2.343271555,1969,1226,670,364,0,364,0,103,0,0.076923077,empty,mBC-0716-1
"E3,A4",1003831,1081266,730761,350505,563899,0,299741,300222,251189,49033,5.122856036,157695,40360,28334,13470,7,13463,1,1491,0,0.002599718,mm10,mBC-0716-1
"E3,A5",16961,17288,13096,4192,9252,0,4148,4154,2905,1249,2.325860689,1912,5590,2102,1079,1,1078,1,225,0,0.091836735,empty,mBC-0716-1
"E3,A6",477514,524879,342278,182601,284040,3,155727,155973,125838,30135,4.17580886,84272,119081,84945,39978,12,39966,2,2881,0,0.001176,mm10,mBC-0716-1
"E3,A7",15718,16315,12002,4313,8780,0,3988,3993,2816,1177,2.392523364,1916,1702,1095,550,1,549,1,138,0,0.007285974,empty,mBC-0716-1
"E3,A8",11457,11652,8578,3074,6267,0,2887,2893,2053,840,2.444047619,1376,2466,1197,569,1,568,1,172,0,0.044014085,empty,mBC-0716-1
"E3,A9",18243,18502,13848,4654,9774,1,4386,4397,3041,1356,2.242625369,2054,9978,3118,1583,0,1583,0,303,0,0.047378395,empty,mBC-0716-1
"E3,A10",15953,16111,12086,4025,8576,0,3825,3842,2734,1108,2.467509025,1801,973,465,242,0,242,0,67,0,0.165289256,empty,mBC-0716-1
"E3,A11",17650,17958,13524,4434,9575,0,4194,4209,2931,1278,2.29342723,1913,1187,733,380,0,380,0,125,0,0.031578947,empty,mBC-0716-1
"E3,A12",19835,20076,15202,4874,10624,0,4664,4670,3288,1382,2.379160637,2176,2900,1700,857,1,856,1,184,0,0.098130841,empty,mBC-0716-1
"E3,B1",18677,19423,14388,5035,10308,0,4639,4646,3313,1333,2.485371343,2199,1198,757,386,1,385,1,123,0,0.046753247,empty,mBC-0716-1
"E3,B2",20187,20188,15511,4677,10698,0,4701,4703,3293,1410,2.335460993,2129,792,398,200,0,200,0,68,0,0.005,empty,mBC-0716-1
"E3,B3",18151,18740,13842,4898,10070,1,4526,4534,3160,1374,2.29985444,2193,1202,775,405,0,405,0,122,0,0.02962963,empty,mBC-0716-1
"E3,B4",16775,17361,12816,4545,9405,1,4186,4197,2933,1264,2.320411392,2052,3249,1441,687,0,687,0,174,0,0.058224163,empty,mBC-0716-1
"E3,B5",11092,7865,5306,2559,5123,0,2589,2598,1849,749,2.468624833,1417,884,507,263,0,263,0,83,0,0.060836502,empty,mBC-0716-1
"E3,B6",12038,12539,9072,3467,6616,0,3052,3060,2108,952,2.214285714,1520,8639,2934,1521,3,1518,1,293,0,0.10342556,empty,mBC-0716-1
"E3,B7",16065,16580,12272,4308,8916,0,4095,4106,2863,1243,2.303298471,1981,1196,768,363,0,363,0,96,0,0.071625344,empty,mBC-0716-1
"E3,B8",13011,13448,9994,3454,7426,0,3363,3369,2357,1012,2.329051383,1663,1475,954,467,0,467,0,143,0,0.064239829,empty,mBC-0716-1
"E3,B9",961544,989946,732628,257318,527542,2,245188,245618,204153,41465,4.923501748,119475,47943,34190,16317,8,16309,2,1760,0,0.002023423,mm10,mBC-0716-1
"E3,B10",529945,535162,346746,188416,299340,2,168793,169348,130331,39017,3.340364457,93360,11347,7703,3618,1,3617,1,579,0,0.00248825,mm10,mBC-0716-1
"E3,B11",15835,16465,11982,4483,8792,0,4030,4035,2791,1244,2.243569132,1945,106,68,51,0,51,0,27,0,0,empty,mBC-0716-1
"E3,B12",636829,688892,462518,226374,373424,0,197466,197754,161347,36407,4.431757629,105254,102004,67368,31538,17,31521,3,2776,0,0.004187684,mm10,mBC-0716-1
"E3,C1",22297,22583,17318,5265,11920,0,4999,5018,3503,1515,2.312211221,2315,1181,769,382,1,381,1,102,0,0.120734908,empty,mBC-0716-1
"E3,C2",18539,19352,14056,5296,10356,0,4826,4830,3327,1503,2.213572854,2312,2115,1374,676,1,675,1,174,0,0.054814815,empty,mBC-0716-1
"E3,C3",20967,21543,15743,5800,11563,0,5341,5348,3749,1599,2.344590369,2635,816,474,240,0,240,0,68,0,0.004166667,empty,mBC-0716-1
"E3,C4",17008,17023,12956,4067,9174,0,3986,3997,2817,1180,2.387288136,1822,1661,1086,538,0,538,0,150,0,0.066914498,empty,mBC-0716-1
"E3,C5",751910,771692,559498,212194,412663,0,200049,200422,155724,44698,3.483914269,99126,81766,33249,16459,18,16441,3,1906,0,0.053281431,mm10,mBC-0716-1
"E3,C6",15908,16086,12091,3995,8980,0,4188,4199,2945,1254,2.348484848,1955,1777,1205,580,0,580,0,146,0,0.05,empty,mBC-0716-1
"E3,C7",16401,16933,12407,4526,8918,0,4125,4143,2820,1323,2.131519274,2029,312,185,94,0,94,0,44,0,0,empty,mBC-0716-1
"E3,C8",14962,15544,11461,4083,8341,0,3829,3834,2615,1219,2.145200984,1874,1553,926,512,0,512,0,152,0,0.064453125,empty,mBC-0716-1
"E3,C9",12475,13023,9442,3581,6841,0,3154,3156,2221,935,2.37540107,1535,1061,641,276,0,276,0,77,0,0.079710145,empty,mBC-0716-1
"E3,C10",13252,13498,10245,3253,7385,0,3322,3333,2265,1068,2.120786517,1558,1564,1068,512,0,512,0,137,0,0.083984375,empty,mBC-0716-1
"E3,C11",11542,11778,8699,3079,6385,0,2958,2960,2065,895,2.30726257,1427,1108,769,352,1,351,1,94,0,0.01994302,empty,mBC-0716-1
"E3,C12",4004792,4298610,2918418,1380192,2119214,6,1197154,1199143,927666,271477,3.417107158,637573,346776,236227,112294,52,112242,6,5289,0,0.001487857,mm10,mBC-0716-1
"E3,D1",11038,11669,8352,3317,6248,0,2908,2912,2037,875,2.328,1414,530,243,107,0,107,0,51,0,0.018691589,empty,mBC-0716-1
"E3,D2",20414,20594,15802,4792,10835,0,4618,4633,3268,1365,2.394139194,2109,3151,2051,990,0,990,0,209,0,0.085858586,empty,mBC-0716-1
"E3,D3",13036,13678,9885,3793,7412,0,3541,3550,2476,1074,2.305400372,1739,1087,595,300,0,300,0,113,0,0.103333333,empty,mBC-0716-1
"E3,D4",13897,14400,10712,3688,7836,0,3568,3575,2492,1083,2.301015697,1685,1590,1049,526,0,526,0,167,0,0.034220532,empty,mBC-0716-1
"E3,D5",649602,669531,495459,174072,359309,1,163645,163940,138250,25690,5.38147139,79304,122177,86205,40435,10,40425,2,3034,0,0.000667904,mm10,mBC-0716-1
"E3,D6",606687,681417,423822,257595,368456,0,214849,215158,181979,33179,5.484764459,120423,174818,107789,50945,24,50921,5,3508,0,0.009112154,mm10,mBC-0716-1
"E3,D7",12821,13462,9755,3707,7290,1,3467,3480,2467,1013,2.435340573,1758,1720,1022,542,1,541,1,171,0,0.029574861,empty,mBC-0716-1
"E3,D8",16217,16765,12022,4743,8980,0,4321,4330,2974,1356,2.193215339,2139,9494,3136,1536,0,1536,0,287,0,0.078125,empty,mBC-0716-1
"E3,D9",4890,4905,3648,1257,2761,0,1327,1329,978,351,2.786324786,625,1479,930,450,0,450,0,135,0,0.04,empty,mBC-0716-1
"E3,D10",13998,14777,10641,4136,7896,0,3744,3752,2647,1105,2.395475113,1861,905,580,306,0,306,0,80,0,0.075163399,empty,mBC-0716-1
"E3,D11",13055,13641,9908,3733,7252,0,3412,3418,2395,1023,2.34115347,1614,7905,3139,1608,3,1605,2,315,0,0.080373832,empty,mBC-0716-1
"E3,D12",20128,20811,15139,5672,10989,1,5018,5037,3430,1607,2.134411948,2477,2253,1506,759,1,758,1,188,0,0.063324538,empty,mBC-0716-1
"E3,E1",667862,695052,478866,216186,378089,0,201899,202166,164115,38051,4.313027253,105712,18330,9870,4442,1,4441,1,831,0,0.016888088,mm10,mBC-0716-1
"E3,E2",15773,16434,11998,4436,8917,0,4121,4137,2913,1224,2.379901961,2046,2498,1363,712,0,712,0,165,0,0.061797753,empty,mBC-0716-1
"E3,E3",12381,12659,9509,3150,6908,0,3085,3090,2203,887,2.483652762,1447,7782,3241,1607,0,1607,0,274,0,0.119477287,empty,mBC-0716-1
"E3,E4",14764,15124,11330,3794,8147,0,3639,3650,2536,1114,2.276481149,1687,1587,1018,472,1,471,1,143,0,0.057324841,empty,mBC-0716-1
"E3,E5",20843,21359,16249,5110,11595,0,5072,5087,3550,1537,2.309694209,2366,1463,963,462,1,461,1,134,0,0.091106291,empty,mBC-0716-1
"E3,E6",26232,27359,20053,7306,14584,0,6909,6928,5046,1882,2.681190223,3314,1996,1152,577,0,577,0,141,0,0.062391681,empty,mBC-0716-1
"E3,E7",14418,15024,11025,3999,7919,0,3608,3616,2510,1106,2.269439421,1730,1276,813,391,0,391,0,113,0,0.084398977,empty,mBC-0716-1
"E3,E8",17552,17650,13655,3995,9454,0,4042,4048,2810,1238,2.269789984,1836,2126,1431,725,1,724,1,187,0,0.04281768,empty,mBC-0716-1
"E3,E9",9208,9517,6793,2724,5063,0,2409,2412,1715,697,2.460545194,1195,12928,4129,2046,1,2045,1,346,0,0.137408313,empty,mBC-0716-1
"E3,E10",932755,1031647,663375,368272,545486,3,316007,316492,248913,67579,3.683289187,172444,100821,64646,30166,8,30158,2,2576,0,0.004410107,mm10,mBC-0716-1
"E3,E11",9056,9227,6854,2373,5083,0,2373,2375,1681,694,2.422190202,1110,1236,766,414,0,414,0,122,0,0.086956522,empty,mBC-0716-1
"E3,E12",14773,15540,11128,4412,8370,0,3917,3921,2720,1201,2.264779351,1927,2696,1256,672,0,672,0,144,0,0.200892857,empty,mBC-0716-1
"E3,F1",17199,17968,13204,4764,9563,0,4368,4378,3046,1332,2.286786787,2132,3238,1522,789,1,788,1,186,0,0.064720812,empty,mBC-0716-1
"E3,F2",505392,517136,380871,136265,282088,2,131946,132187,100328,31859,3.149125836,64287,102307,41879,20528,24,20504,4,2275,0,0.017606321,mm10,mBC-0716-1
"E3,F3",16017,16694,12183,4511,8995,0,4251,4261,2899,1362,2.128487518,2074,2711,1447,689,1,688,1,187,0,0.049418605,empty,mBC-0716-1
"E3,F4",16918,17453,12713,4740,9569,0,4370,4389,3081,1308,2.355504587,2129,642,420,218,0,218,0,81,0,0.02293578,empty,mBC-0716-1
"E3,F5",24057,24714,18201,6513,13102,0,5913,5923,4134,1789,2.31078815,2868,7172,2707,1344,1,1343,1,274,0,0.04095309,empty,mBC-0716-1
"E3,F6",23327,23682,17859,5823,12734,1,5702,5713,4036,1677,2.406678593,2664,2542,1647,802,0,802,0,209,0,0.082294264,empty,mBC-0716-1
"E3,F7",1036878,1148859,738490,410369,620727,0,353064,353572,274190,79382,3.454057595,195328,52074,36960,17649,8,17641,3,1774,0,0.001077036,mm10,mBC-0716-1
"E3,F8",22214,22975,17075,5900,12415,0,5698,5713,4075,1638,2.487789988,2712,224,129,73,0,73,0,40,0,0.068493151,empty,mBC-0716-1
"E3,F9",14837,15272,11407,3865,8345,0,3837,3846,2661,1185,2.24556962,1810,2047,1332,675,0,675,0,196,0,0.051851852,empty,mBC-0716-1
"E3,F10",20649,21093,15986,5107,11259,0,4939,4946,3465,1481,2.339635381,2336,11276,3680,1777,1,1776,1,338,0,0.052364865,empty,mBC-0716-1
"E3,F11",728564,786271,525565,260706,422860,0,230673,231033,194426,36607,5.311169995,122696,87885,56264,26996,8,26988,1,2525,0,0.005261598,mm10,mBC-0716-1
"E3,F12",14067,14795,10768,4027,7844,0,3605,3622,2582,1040,2.482692308,1730,75,44,30,0,30,0,19,0,0,empty,mBC-0716-1
"E3,G1",9804,10016,7532,2484,5427,0,2403,2404,1648,756,2.17989418,1110,1811,1204,607,0,607,0,152,0,0.02306425,empty,mBC-0716-1
"E3,G2",20741,21140,15834,5306,11173,0,5051,5062,3511,1551,2.263700838,2412,422,293,155,0,155,0,55,0,0,empty,mBC-0716-1
"E3,G3",19019,19541,14375,5166,10452,1,4681,4695,3219,1476,2.180894309,2297,6105,2575,1260,0,1260,0,260,0,0.042857143,empty,mBC-0716-1
"E3,G4",27791,27817,21299,6518,14735,0,6288,6302,4449,1853,2.400971398,2878,110,83,48,0,48,0,31,0,0,empty,mBC-0716-1
"E3,G5",13193,13766,10080,3686,7172,0,3317,3325,2319,1006,2.305168986,1576,7707,2551,1213,1,1212,1,262,0,0.023927393,empty,mBC-0716-1
"E3,G6",24548,24904,18822,6082,13135,0,5694,5704,3999,1705,2.345454545,2608,199,144,84,0,84,0,39,0,0,empty,mBC-0716-1
"E3,G7",19651,19888,15282,4606,10748,1,4787,4807,3413,1394,2.448350072,2202,2350,1379,664,0,664,0,163,0,0.081325301,empty,mBC-0716-1
"E3,G8",14389,15120,10886,4234,7964,0,3816,3822,2631,1191,2.20906801,1875,1598,976,479,0,479,0,151,0,0.010438413,empty,mBC-0716-1
"E3,G9",825224,907727,566552,341175,485710,2,299203,299632,219017,80615,2.716826893,167065,30173,15540,7451,3,7448,1,1250,0,0.008592911,mm10,mBC-0716-1
"E3,G10",13666,14067,10341,3726,7490,0,3375,3375,2388,987,2.419452888,1621,1685,955,466,0,466,0,142,0,0.068669528,empty,mBC-0716-1
"E3,G11",12609,12680,9803,2877,6805,0,2962,2967,2020,947,2.133051742,1347,568,408,208,0,208,0,76,0,0.014423077,empty,mBC-0716-1
"E3,G12",11291,11513,8538,2975,6286,0,2917,2924,2010,914,2.199124726,1401,7928,2754,1398,1,1397,1,272,0,0.062276306,empty,mBC-0716-1
"E3,H1",20984,21754,16011,5743,11527,0,5256,5270,3723,1547,2.406593407,2546,1297,773,359,0,359,0,106,0,0.061281337,empty,mBC-0716-1
"E3,H2",24146,24468,18448,6020,12891,0,5710,5723,4025,1698,2.370435807,2652,2172,1432,687,0,687,0,171,0,0.014556041,empty,mBC-0716-1
"E3,H3",563816,587405,418235,169170,319476,0,160373,160652,122191,38461,3.177010478,81808,14721,10101,4737,2,4735,1,728,0,0.002956705,mm10,mBC-0716-1
"E3,H4",13205,13729,9906,3823,7245,0,3315,3324,2248,1076,2.089219331,1614,115,75,47,0,47,0,21,0,0,empty,mBC-0716-1
"E3,H5",19469,20288,14798,5490,10990,0,5216,5226,3754,1472,2.550271739,2605,1796,1108,535,0,535,0,157,0,0.039252336,empty,mBC-0716-1
"E3,H6",14047,14277,10641,3636,7833,0,3596,3605,2553,1052,2.426806084,1736,1941,1230,653,0,653,0,172,0,0.065849923,empty,mBC-0716-1
"E3,H7",530017,547211,398279,148932,299174,1,143473,143711,112709,31002,3.635539643,71409,12257,8382,3896,2,3894,1,712,0,0.003081664,mm10,mBC-0716-1
"E3,H8",13896,14044,10498,3546,7529,0,3441,3449,2410,1039,2.319538017,1646,7047,2546,1344,1,1343,1,299,0,0.049143708,empty,mBC-0716-1
"E3,H9",15064,15612,11409,4203,8438,1,3792,3799,2688,1111,2.419441944,1833,1368,871,419,0,419,0,128,0,0.112171838,empty,mBC-0716-1
"E3,H10",14531,15082,11077,4005,8051,1,3701,3710,2649,1061,2.496701225,1802,1066,664,317,0,317,0,121,0,0.056782334,empty,mBC-0716-1
"E3,H11",17443,18174,13087,5087,9817,0,4644,4658,3288,1370,2.4,2344,298,161,70,0,70,0,40,0,0.171428571,empty,mBC-0716-1
"E3,H12",6067,6450,4547,1903,3457,0,1647,1648,1156,492,2.349593496,833,792,490,256,0,256,0,73,0,0.0546875,empty,mBC-0716-1
"E4,A1",772375,874782,522197,352585,469921,0,292757,293055,199734,93321,2.140289967,168671,32414,22164,10582,5,10577,2,1251,0,0.001229082,mm10,mBC-0716-1
"E4,A2",18388,18441,14174,4267,9795,0,4328,4337,3002,1335,2.248689139,1962,1011,692,323,1,322,1,92,0,0.077639752,empty,mBC-0716-1
"E4,A3",760677,883276,511665,371611,469838,0,295186,295518,235093,60425,3.89065784,173499,41521,26179,12515,8,12507,2,1389,0,0.006716239,mm10,mBC-0716-1
"E4,A4",20159,20631,15523,5108,10701,0,4750,4756,3247,1509,2.15175613,2212,533,315,154,0,154,0,48,0,0,empty,mBC-0716-1
"E4,A5",16425,17363,12384,4979,9161,0,4273,4285,2958,1327,2.229088169,2130,1511,756,374,0,374,0,89,0,0.128342246,empty,mBC-0716-1
"E4,A6",12594,13220,9500,3720,6863,0,3211,3219,2221,998,2.225450902,1552,1150,765,388,0,388,0,92,0,0.06443299,empty,mBC-0716-1
"E4,A7",16254,16680,12341,4339,8827,0,4155,4158,2864,1294,2.213292117,2015,1021,566,272,1,271,1,80,0,0.007380074,empty,mBC-0716-1
"E4,A8",10828,11116,8150,2966,6060,0,2822,2830,1984,846,2.345153664,1401,1090,717,359,0,359,0,105,0,0.075208914,empty,mBC-0716-1
"E4,A9",643618,673855,478930,194925,360739,0,182307,182578,142022,40556,3.501873952,91969,8436,5770,2799,0,2799,0,507,0,0.012147195,mm10,mBC-0716-1
"E4,A10",16421,16630,12602,4028,8911,0,4048,4062,2757,1305,2.112643678,1902,159,76,44,0,44,0,23,0,0,empty,mBC-0716-1
"E4,A11",17380,17664,13427,4237,9536,0,4211,4217,2948,1269,2.323089046,1977,1140,678,388,1,387,1,92,0,0.085271318,empty,mBC-0716-1
"E4,A12",19599,19972,15159,4813,10537,0,4683,4696,3316,1380,2.402898551,2196,1782,1161,585,0,585,0,131,0,0.082051282,empty,mBC-0716-1
"E4,B1",18682,18926,14140,4786,9967,0,4406,4410,3144,1266,2.483412322,2150,4888,1631,864,1,863,1,186,0,0.073001159,empty,mBC-0716-1
"E4,B2",19622,20266,15037,5229,10552,0,4763,4778,3300,1478,2.232746955,2258,369,227,121,0,121,0,44,0,0.049586777,empty,mBC-0716-1
"E4,B3",18524,18881,14179,4702,10192,0,4513,4535,3115,1420,2.193661972,2170,2325,1048,484,0,484,0,133,0,0.045454545,empty,mBC-0716-1
"E4,B4",16273,16947,12486,4461,8946,0,4033,4041,2882,1159,2.486626402,1965,1032,517,274,1,273,1,85,0,0.076923077,empty,mBC-0716-1
"E4,B5",9436,5938,4174,1764,4036,0,1897,1923,1324,599,2.210350584,1041,520,320,158,0,158,0,42,0,0.025316456,empty,mBC-0716-1
"E4,B6",11715,12208,8876,3332,6422,0,3007,3018,2091,927,2.25566343,1455,783,455,233,0,233,0,75,0,0.060085837,empty,mBC-0716-1
"E4,B7",876736,921393,663144,258249,483243,1,229476,229893,185627,44266,4.193444178,114513,73847,45491,21783,5,21778,3,2136,0,0.00261732,mm10,mBC-0716-1
"E4,B8",12959,13466,9887,3579,7164,0,3238,3245,2256,989,2.281092012,1594,671,451,231,0,231,0,81,0,0.025974026,empty,mBC-0716-1
"E4,B9",14549,14809,11360,3449,7813,0,3416,3428,2394,1034,2.315280464,1560,333,193,90,0,90,0,35,0,0.011111111,empty,mBC-0716-1
"E4,B10",16215,16078,11590,4488,8799,0,4073,4100,2779,1321,2.103709311,2045,3301,989,496,1,495,1,113,0,0.056565657,empty,mBC-0716-1
"E4,B11",15794,16088,12079,4009,8575,0,3862,3873,2691,1182,2.276649746,1825,92,54,36,0,36,0,23,0,0,empty,mBC-0716-1
"E4,B12",17470,18072,13319,4753,9546,0,4292,4297,2987,1310,2.280152672,2104,1067,714,352,0,352,0,101,0,0.048295455,empty,mBC-0716-1
"E4,C1",21999,22219,17080,5139,11515,0,4849,4861,3449,1412,2.442634561,2223,464,274,138,0,138,0,59,0,0.050724638,empty,mBC-0716-1
"E4,C2",18621,19333,14081,5252,10233,0,4777,4784,3398,1386,2.451659452,2331,3314,1322,695,0,695,0,165,0,0.031654676,empty,mBC-0716-1
"E4,C3",19581,20026,14972,5054,10378,0,4681,4696,3277,1419,2.309372798,2201,432,278,121,0,121,0,47,0,0.041322314,empty,mBC-0716-1
"E4,C4",16829,17069,12815,4254,9050,0,3964,3974,2773,1201,2.308909242,1923,5227,1942,961,1,960,1,178,0,0.086458333,empty,mBC-0716-1
"E4,C5",17141,17518,13115,4403,9384,0,4314,4322,3123,1199,2.604670559,2046,626,368,195,0,195,0,67,0,0.087179487,empty,mBC-0716-1
"E4,C6",175688,160920,154786,6134,91616,0,8326,8417,5956,2461,2.420154409,2785,19891,11328,5289,3,5286,2,941,0,0.016080212,empty,mBC-0716-1
"E4,C7",16554,16870,12312,4558,8832,0,4191,4209,2881,1328,2.169427711,2075,2540,827,424,2,422,1,100,0,0.137440758,empty,mBC-0716-1
"E4,C8",14577,14786,11083,3703,7774,0,3530,3544,2449,1095,2.23652968,1610,843,460,229,0,229,0,85,0,0.07860262,empty,mBC-0716-1
"E4,C9",12163,12575,9308,3267,6657,0,3099,3099,2211,888,2.489864865,1472,542,354,159,0,159,0,56,0,0.081761006,empty,mBC-0716-1
"E4,C10",13274,13677,10118,3559,7306,0,3303,3313,2264,1049,2.158245949,1615,928,512,268,0,268,0,76,0,0,empty,mBC-0716-1
"E4,C11",634643,642856,468229,174627,345002,0,168650,168979,137966,31013,4.448650566,82769,10635,7313,3426,3,3423,1,557,0,0.011393514,mm10,mBC-0716-1
"E4,C12",19145,19669,14420,5249,10416,0,4759,4770,3384,1386,2.441558442,2322,593,330,170,0,170,0,73,0,0.017647059,empty,mBC-0716-1
"E4,D1",955515,1023840,681247,342593,550438,0,305094,305530,236064,69466,3.398266778,163483,47396,33038,15443,2,15441,1,1755,0,0.002590506,mm10,mBC-0716-1
"E4,D2",20504,20836,16015,4821,10885,0,4636,4652,3287,1365,2.408058608,2120,1759,1149,565,0,565,0,134,0,0.100884956,empty,mBC-0716-1
"E4,D3",1184726,1296787,843608,453179,689533,2,384704,385253,325058,60195,5.400083063,210734,96179,63733,30176,12,30164,3,2667,0,0.000928259,mm10,mBC-0716-1
"E4,D4",13670,14184,10439,3745,7558,0,3474,3474,2440,1034,2.359767892,1675,846,567,301,0,301,0,100,0,0.069767442,empty,mBC-0716-1
"E4,D5",13568,13784,10042,3742,7432,0,3459,3466,2502,964,2.595435685,1691,817,509,270,0,270,0,95,0,0.025925926,empty,mBC-0716-1
"E4,D6",11588,12227,8715,3512,6464,0,3018,3029,2139,890,2.403370787,1559,1009,645,331,0,331,0,91,0,0.19939577,empty,mBC-0716-1
"E4,D7",12669,12973,9633,3340,6709,0,3111,3123,2178,945,2.304761905,1427,1377,678,360,0,360,0,112,0,0.111111111,empty,mBC-0716-1
"E4,D8",618198,668589,432470,236119,360655,0,207509,207765,168192,39573,4.250170571,113755,37694,13278,6686,5,6681,2,955,0,0.105523125,mm10,mBC-0716-1
"E4,D9",5082,5397,3791,1606,2986,0,1461,1464,1032,432,2.388888889,754,9379,3143,1549,2,1547,2,309,0,0.071751778,empty,mBC-0716-1
"E4,D10",12800,13084,9751,3333,6900,0,3175,3180,2284,896,2.549107143,1458,2390,828,433,0,433,0,93,0,0.055427252,empty,mBC-0716-1
"E4,D11",13282,13641,10129,3512,7073,0,3220,3224,2308,916,2.519650655,1482,3184,1534,730,0,730,0,171,0,0.047945205,empty,mBC-0716-1
"E4,D12",20056,20664,15388,5276,10829,0,4897,4914,3348,1566,2.137931034,2301,4165,1654,815,0,815,0,167,0,0.110429448,empty,mBC-0716-1
"E4,E1",21490,21827,16410,5417,11586,0,5193,5203,3727,1476,2.525067751,2478,1177,668,335,0,335,0,109,0,0.050746269,empty,mBC-0716-1
"E4,E2",15869,16042,12007,4035,8543,0,3894,3911,2815,1096,2.568430657,1797,17886,5728,2821,7,2814,2,458,0,0.063255153,empty,mBC-0716-1
"E4,E3",13221,13648,9882,3766,7196,0,3379,3384,2384,1000,2.384,1690,22580,6977,3653,2,3651,2,598,0,0.016433854,empty,mBC-0716-1
"E4,E4",15072,15464,11475,3989,8170,0,3699,3712,2623,1089,2.408631772,1778,1043,676,325,0,325,0,85,0,0.009230769,empty,mBC-0716-1
"E4,E5",20805,20858,16104,4754,11235,0,4783,4800,3340,1460,2.287671233,2222,991,657,316,0,316,0,97,0,0.003164557,empty,mBC-0716-1
"E4,E6",14453,14875,10927,3948,7943,0,3663,3667,2624,1043,2.515819751,1840,843,431,233,0,233,0,70,0,0.051502146,empty,mBC-0716-1
"E4,E7",13523,13764,10251,3513,7176,0,3220,3225,2291,934,2.452890792,1533,1031,634,347,0,347,0,116,0,0.057636888,empty,mBC-0716-1
"E4,E8",977748,1064596,676769,387827,559456,0,326377,326868,273457,53411,5.11986295,179546,108655,76984,36764,13,36751,2,2799,0,0.001550978,mm10,mBC-0716-1
"E4,E9",9047,9234,6664,2570,4882,0,2343,2351,1654,697,2.37302726,1141,6728,2558,1335,1,1334,1,223,0,0.140929535,empty,mBC-0716-1
"E4,E10",12757,13003,9724,3279,6953,1,3178,3186,2196,990,2.218181818,1531,8818,2844,1503,2,1501,1,301,0,0.049300466,empty,mBC-0716-1
"E4,E11",479323,507041,350391,156650,276605,0,146158,146354,113158,33196,3.408784191,75905,10856,7585,3627,0,3627,0,593,0,0.003032809,mm10,mBC-0716-1
"E4,E12",15020,15517,11255,4262,8275,0,3771,3782,2667,1115,2.391928251,1861,4122,1379,701,0,701,0,148,0,0.05278174,empty,mBC-0716-1
"E4,F1",762683,833763,544606,289157,442830,0,249722,250079,206745,43334,4.770965062,135596,61894,39714,18882,12,18870,2,2036,0,0.002225755,mm10,mBC-0716-1
"E4,F2",21866,22752,16484,6268,11976,0,5589,5602,3925,1677,2.340488968,2767,2015,1324,646,0,646,0,170,0,0.029411765,empty,mBC-0716-1
"E4,F3",564302,592684,423018,169666,319885,3,156006,156240,106202,50038,2.122426956,80088,16682,7971,3864,1,3863,1,733,0,0.005953922,mm10,mBC-0716-1
"E4,F4",1307269,1366285,942619,423666,734668,1,394752,395362,297424,97938,3.036860054,207083,36140,24026,11399,4,11395,2,1371,0,0.003861343,mm10,mBC-0716-1
"E4,F5",23494,24259,17721,6538,12580,0,5722,5742,4114,1628,2.527027027,2801,1067,696,340,0,340,0,97,0,0.058823529,empty,mBC-0716-1
"E4,F6",492248,481774,375446,106328,259430,1,106966,107175,83771,23404,3.579345411,49237,9976,6760,3107,2,3105,1,631,0,0.017069243,mm10,mBC-0716-1
"E4,F7",1319141,1354703,998905,355798,722608,0,345574,346139,283132,63007,4.493659435,168467,37479,26277,12742,5,12737,1,1670,0,0.002433854,mm10,mBC-0716-1
"E4,F8",22183,23091,16886,6205,12225,0,5736,5743,3947,1796,2.19766147,2744,101,72,40,0,40,0,23,0,0,empty,mBC-0716-1
"E4,F9",15074,15286,11473,3813,8112,0,3651,3655,2577,1078,2.390538033,1700,3879,1607,800,2,798,1,188,0,0.051378446,empty,mBC-0716-1
"E4,F10",19562,19886,15278,4608,10482,0,4512,4523,3172,1351,2.347890452,2031,1882,809,419,1,418,1,119,0,0.052631579,empty,mBC-0716-1
"E4,F11",10963,11188,8482,2706,6026,0,2696,2700,1924,776,2.479381443,1299,767,539,281,0,281,0,78,0,0.035587189,empty,mBC-0716-1
"E4,F12",13759,14106,10260,3846,7265,0,3348,3366,2304,1062,2.169491525,1615,36,20,17,0,17,0,8,0,0.176470588,empty,mBC-0716-1
"E4,G1",9777,10128,7642,2486,5436,0,2355,2357,1703,654,2.603975535,1090,1484,987,474,0,474,0,111,0,0,empty,mBC-0716-1
"E4,G2",20446,20605,15756,4849,10872,0,4784,4793,3356,1437,2.335421016,2240,383,282,132,0,132,0,37,0,0.189393939,empty,mBC-0716-1
"E4,G3",976642,1017832,722859,294973,543424,0,271460,271860,209485,62375,3.358476954,138058,57886,35002,16800,2,16798,1,2028,0,0.007739017,mm10,mBC-0716-1
"E4,G4",27878,27989,21200,6789,14633,0,6309,6330,4504,1826,2.466593647,2901,184,98,50,0,50,0,19,0,0,empty,mBC-0716-1
"E4,G5",12536,12978,9573,3405,6964,0,3242,3257,2279,978,2.330265849,1631,574,312,166,0,166,0,53,0,0.018072289,empty,mBC-0716-1
"E4,G6",24085,24522,18582,5940,12823,0,5660,5671,4029,1642,2.453714982,2640,130,81,46,0,46,0,22,0,0.108695652,empty,mBC-0716-1
"E4,G7",19971,20347,15510,4837,10582,0,4606,4612,3280,1332,2.462462462,2043,1424,930,470,0,470,0,118,0,0.063829787,empty,mBC-0716-1
"E4,G8",14572,15128,11008,4120,7976,0,3675,3686,2605,1081,2.409805735,1838,936,643,350,0,350,0,106,0,0.011428571,empty,mBC-0716-1
"E4,G9",11729,12142,8904,3238,6322,0,2920,2929,2056,873,2.355097365,1373,1083,566,277,0,277,0,97,0,0.032490975,empty,mBC-0716-1
"E4,G10",12787,13068,9751,3317,7016,0,3199,3209,2224,985,2.25786802,1540,1056,660,290,0,290,0,86,0,0.110344828,empty,mBC-0716-1
"E4,G11",847750,938757,583708,355049,491442,2,291343,291782,248838,42944,5.794476528,161032,45878,31595,14664,4,14660,1,1699,0,0.000136426,mm10,mBC-0716-1
"E4,G12",11220,11412,8531,2881,6214,0,2824,2829,2006,823,2.437424058,1334,943,628,288,0,288,0,80,0,0.010416667,empty,mBC-0716-1
"E4,H1",20330,20745,15397,5348,10978,0,4993,5010,3587,1423,2.52073085,2361,839,526,261,0,261,0,81,0,0.091954023,empty,mBC-0716-1
"E4,H2",1068207,1104544,793930,310614,566321,3,284457,285035,207558,77477,2.678962789,141637,11413,5094,2408,3,2405,1,450,0,0.022869023,mm10,mBC-0716-1
"E4,H3",19723,20536,14745,5791,10899,0,5160,5169,3654,1515,2.411881188,2624,900,559,289,0,289,0,79,0,0.107266436,empty,mBC-0716-1
"E4,H4",12920,12887,9789,3098,6965,0,3132,3135,2181,954,2.286163522,1455,55,49,24,0,24,0,10,0,0,empty,mBC-0716-1
"E4,H5",17458,18161,13147,5014,9660,0,4490,4501,3189,1312,2.430640244,2191,983,607,315,0,315,0,96,0,0.088888889,empty,mBC-0716-1
"E4,H6",13926,14167,10392,3775,7623,0,3484,3494,2446,1048,2.333969466,1667,4113,1623,802,1,801,1,187,0,0.051186017,empty,mBC-0716-1
"E4,H7",17256,17494,12993,4501,9404,0,4292,4308,3036,1272,2.386792453,2048,1337,642,309,0,309,0,98,0,0.13592233,empty,mBC-0716-1
"E4,H8",13354,13676,10013,3663,7261,0,3376,3381,2347,1034,2.269825919,1616,1223,762,415,0,415,0,132,0,0.045783133,empty,mBC-0716-1
"E4,H9",16211,16762,12237,4525,8896,0,4063,4068,2902,1166,2.488850772,2015,725,472,270,0,270,0,80,0,0.022222222,empty,mBC-0716-1
"E4,H10",14297,14573,10658,3915,7729,0,3576,3586,2532,1054,2.40227704,1714,3669,1178,604,0,604,0,144,0,0.039735099,empty,mBC-0716-1
"E4,H11",17155,17257,12829,4428,9192,0,4254,4270,3023,1247,2.424218123,2000,509,154,69,0,69,0,20,0,0.072463768,empty,mBC-0716-1
"E4,H12",6383,6535,4898,1637,3462,0,1547,1549,1092,457,2.389496718,705,497,308,172,0,172,0,45,0,0.011627907,empty,mBC-0716-1
"E5,A1",13113,13697,9796,3901,7598,0,3663,3667,2583,1084,2.382841328,1856,1522,972,485,0,485,0,154,0,0.070103093,empty,mBC-0716-1
"E5,A2",16927,17092,12901,4191,9260,0,4107,4119,2892,1227,2.356968215,1943,1590,990,503,0,503,0,166,0,0.015904573,empty,mBC-0716-1
"E5,A3",14988,15472,11475,3997,8388,0,3850,3859,2695,1164,2.315292096,1835,1051,698,379,0,379,0,147,0,0.039577836,empty,mBC-0716-1
"E5,A4",19030,19467,14809,4658,10385,0,4538,4540,3233,1307,2.473603673,2073,799,488,275,1,274,1,87,0,0.02189781,empty,mBC-0716-1
"E5,A5",15229,15565,11691,3874,8553,0,3921,3932,2830,1102,2.568058076,1824,25769,7533,3779,2,3777,1,560,0,0.051893037,empty,mBC-0716-1
"E5,A6",11966,12363,9101,3262,6826,0,3156,3161,2247,914,2.458424508,1507,2338,1225,650,0,650,0,206,0,0.049230769,empty,mBC-0716-1
"E5,A7",14860,15226,11315,3911,8333,0,3759,3767,2583,1184,2.181587838,1812,1460,911,496,0,496,0,154,0,0.076612903,empty,mBC-0716-1
"E5,A8",1438939,1566737,1003581,563156,834213,2,487156,487882,407631,80251,5.079450723,265075,282800,190518,90997,33,90964,5,4681,0,0.001297216,mm10,mBC-0716-1
"E5,A9",16467,16987,12766,4221,9095,0,3944,3955,2763,1192,2.31795302,1880,1404,865,450,1,449,1,150,0,0.102449889,empty,mBC-0716-1
"E5,A10",13721,14123,10409,3714,7775,0,3530,3535,2528,1007,2.510427011,1663,412,262,146,0,146,0,76,0,0.061643836,empty,mBC-0716-1
"E5,A11",15611,15898,11878,4020,8813,0,4001,4016,2772,1244,2.22829582,1892,1693,1035,549,0,549,0,150,0,0.072859745,empty,mBC-0716-1
"E5,A12",18359,18999,14328,4671,10046,0,4300,4311,2947,1364,2.160557185,2028,2857,1748,902,1,901,1,216,0,0.07991121,empty,mBC-0716-1
"E5,B1",17426,18444,13271,5173,9853,0,4545,4551,3170,1381,2.295438088,2278,1912,1135,567,0,567,0,171,0,0.031746032,empty,mBC-0716-1
"E5,B2",18157,18366,14136,4230,9944,0,4327,4334,2982,1352,2.205621302,1958,747,403,195,0,195,0,80,0,0.030769231,empty,mBC-0716-1
"E5,B3",16852,17339,12944,4395,9551,0,4324,4331,3108,1223,2.541291905,2070,2259,1250,654,0,654,0,197,0,0.016819572,empty,mBC-0716-1
"E5,B4",15272,15427,11627,3800,8453,0,3792,3805,2653,1152,2.302951389,1795,1404,905,494,0,494,0,165,0,0.099190283,empty,mBC-0716-1
"E5,B5",14521,11823,8131,3692,7360,0,3730,3745,2822,923,3.057421452,1988,7132,2503,1244,0,1244,0,259,0,0.02733119,empty,mBC-0716-1
"E5,B6",10642,11036,8078,2958,6010,1,2752,2761,1901,860,2.210465116,1370,1410,879,476,0,476,0,150,0,0.088235294,empty,mBC-0716-1
"E5,B7",617433,659586,451603,207983,361246,0,188755,188994,139968,49026,2.854974911,99294,52673,36797,17521,6,17515,2,1830,0,0.001370254,mm10,mBC-0716-1
"E5,B8",11959,12225,9165,3060,6613,0,2911,2921,2054,867,2.369088812,1397,1459,934,461,0,461,0,153,0,0.017353579,empty,mBC-0716-1
"E5,B9",13396,13902,10212,3690,7365,0,3336,3342,2331,1011,2.305637982,1570,834,442,240,1,239,1,84,0,0.020920502,empty,mBC-0716-1
"E5,B10",486091,481009,314267,166742,272787,3,147630,148530,123713,24817,4.985010275,81459,55727,30038,14490,8,14482,2,1717,0,0.005662201,mm10,mBC-0716-1
"E5,B11",14519,14828,11112,3716,8127,0,3670,3675,2594,1081,2.399629972,1736,329,220,101,0,101,0,50,0,0.02970297,empty,mBC-0716-1
"E5,B12",16350,16918,12446,4472,9204,0,4174,4180,2937,1243,2.362831858,2003,1930,1102,546,2,544,1,176,0,0.051470588,empty,mBC-0716-1
"E5,C1",20243,20242,15575,4667,10822,0,4535,4546,3169,1377,2.301379811,2039,2590,1104,552,0,552,0,150,0,0.15942029,empty,mBC-0716-1
"E5,C2",1303568,1392765,931191,461574,743443,2,408512,409053,316159,92894,3.403438328,217610,246652,172315,82683,35,82648,4,4398,0,0.000919562,mm10,mBC-0716-1
"E5,C3",20721,21610,15688,5922,11747,0,5450,5461,3880,1581,2.454142948,2722,872,589,312,0,312,0,92,0,0.08974359,empty,mBC-0716-1
"E5,C4",15801,16176,12119,4057,8838,0,3942,3947,2819,1128,2.499113475,1843,8009,2797,1447,0,1447,0,331,0,0.08707671,empty,mBC-0716-1
"E5,C5",14778,15319,11233,4086,8326,0,3854,3865,2637,1228,2.147394137,1893,3045,1357,720,1,719,1,196,0,0.037552156,empty,mBC-0716-1
"E5,C6",741185,802864,519279,283585,446823,0,252181,252557,210241,42316,4.968357123,138009,116399,77739,36799,13,36786,2,2815,0,0.005790246,mm10,mBC-0716-1
"E5,C7",14218,14660,10630,4030,8073,0,3829,3833,2671,1162,2.298623064,1858,478,263,160,0,160,0,71,0,0.00625,empty,mBC-0716-1
"E5,C8",13799,14199,10264,3935,7710,0,3592,3601,2443,1158,2.109671848,1844,11339,4445,2188,2,2186,2,388,0,0.14547118,empty,mBC-0716-1
"E5,C9",422370,438815,315525,123290,243885,0,117820,118027,91774,26253,3.495752866,59216,42371,21629,10448,8,10440,3,1416,0,0.016954023,mm10,mBC-0716-1
"E5,C10",12109,12377,9276,3101,6664,0,2970,2981,2043,938,2.17803838,1387,1594,1087,550,0,550,0,138,0,0.041818182,empty,mBC-0716-1
"E5,C11",10535,11061,8040,3021,6007,0,2819,2825,1975,850,2.323529412,1373,1192,779,441,1,440,1,123,0,0.013636364,empty,mBC-0716-1
"E5,C12",17914,18455,13412,5043,9969,0,4521,4530,3278,1252,2.618210863,2275,1425,885,489,0,489,0,162,0,0.071574642,empty,mBC-0716-1
"E5,D1",10058,10412,7581,2831,5898,0,2875,2882,2004,878,2.282460137,1404,7593,2384,1200,0,1200,0,236,0,0.039166667,empty,mBC-0716-1
"E5,D2",983436,1127998,650072,477926,604801,0,394508,394965,273152,121813,2.242387922,232244,108464,75009,35350,15,35335,4,2917,0,0.001867836,mm10,mBC-0716-1
"E5,D3",12034,12817,9054,3763,6935,0,3338,3346,2364,982,2.407331976,1668,1458,952,509,0,509,0,152,0,0.062868369,empty,mBC-0716-1
"E5,D4",644957,670157,470131,200026,364973,2,190246,190584,149551,41033,3.644651866,97497,12585,8917,3985,0,3985,0,800,0,0.003262233,mm10,mBC-0716-1
"E5,D5",12683,13316,9549,3767,7284,0,3370,3378,2365,1013,2.334649556,1691,1383,831,470,0,470,0,178,0,0.05106383,empty,mBC-0716-1
"E5,D6",11441,11830,8544,3286,6380,0,3006,3018,2060,958,2.150313152,1493,1350,900,448,0,448,0,157,0,0.044642857,empty,mBC-0716-1
"E5,D7",11968,12418,8888,3530,6738,0,3194,3198,2290,908,2.522026432,1607,2440,1621,826,0,826,0,239,0,0.01937046,empty,mBC-0716-1
"E5,D8",14392,15425,10846,4579,8307,0,3967,3982,2809,1173,2.394714408,1991,1331,873,452,0,452,0,151,0,0.011061947,empty,mBC-0716-1
"E5,D9",197148,219392,126202,93190,122702,0,78624,78727,59962,18765,3.195417,46550,100352,67186,31696,8,31688,2,2616,0,0.001546327,mm10,mBC-0716-1
"E5,D10",526046,574173,385459,188714,314353,1,164567,164784,135962,28822,4.717299285,87314,102463,73824,35270,8,35262,1,2774,0,0.000141796,mm10,mBC-0716-1
"E5,D11",924737,1032308,636783,395525,550562,0,327624,328034,265190,62844,4.219814143,182663,234783,147243,69019,35,68984,5,4187,0,0.007958367,mm10,mBC-0716-1
"E5,D12",665063,736923,472657,264266,398819,0,231201,231482,176425,55057,3.204406343,126886,68375,40476,19697,10,19687,2,2043,0,0.008990705,mm10,mBC-0716-1
"E5,E1",873905,925949,631746,294203,496166,1,260914,261310,218579,42731,5.115232501,137139,120877,77243,37433,12,37421,2,2978,0,0.008310842,mm10,mBC-0716-1
"E5,E2",14698,15030,11087,3943,8285,0,3773,3783,2636,1147,2.298169137,1798,1880,1099,560,0,560,0,175,0,0.0625,empty,mBC-0716-1
"E5,E3",11171,11427,8549,2878,6139,0,2751,2758,1911,847,2.256198347,1271,2024,1184,567,0,567,0,191,0,0.024691358,empty,mBC-0716-1
"E5,E4",14350,14786,10986,3800,7875,0,3597,3607,2536,1071,2.367880486,1735,1607,1040,534,0,534,0,183,0,0.026217228,empty,mBC-0716-1
"E5,E5",18729,19102,14512,4590,10261,0,4545,4550,3143,1407,2.233830846,2115,1886,1286,700,1,699,1,201,0,0.051502146,empty,mBC-0716-1
"E5,E6",12255,12438,9272,3166,6736,0,3062,3067,2072,995,2.08241206,1450,2048,1374,667,0,667,0,183,0,0.062968516,empty,mBC-0716-1
"E5,E7",12653,12778,9649,3129,6900,0,3029,3036,2106,930,2.264516129,1398,1406,921,446,0,446,0,153,0,0.065022422,empty,mBC-0716-1
"E5,E8",15659,15918,12105,3813,8607,0,3794,3796,2597,1199,2.165971643,1756,2610,1729,844,0,844,0,219,0,0.043838863,empty,mBC-0716-1
"E5,E9",8475,8593,6402,2191,4681,0,2159,2160,1553,607,2.558484349,1015,1499,1004,526,0,526,0,142,0,0.039923954,empty,mBC-0716-1
"E5,E10",11933,12640,9170,3470,6831,0,3223,3230,2241,989,2.265925177,1618,3285,1254,684,2,682,2,177,0,0.061583578,empty,mBC-0716-1
"E5,E11",8576,8950,6427,2523,4909,0,2341,2341,1629,712,2.287921348,1140,1289,905,496,0,496,0,138,0,0.054435484,empty,mBC-0716-1
"E5,E12",13702,14590,10208,4382,7927,0,3824,3833,2670,1163,2.295786758,1962,1400,941,474,0,474,0,154,0,0.05907173,empty,mBC-0716-1
"E5,F1",15966,16091,12194,3897,8657,0,3808,3821,2706,1115,2.42690583,1776,6526,2427,1203,0,1203,0,276,0,0.024937656,empty,mBC-0716-1
"E5,F2",1134883,1213716,825682,388034,654534,1,343888,344457,288178,56279,5.12052453,182730,256254,177897,85991,19,85972,4,4423,0,0.00158191,mm10,mBC-0716-1
"E5,F3",15057,15701,11403,4298,8650,0,4103,4112,2900,1212,2.392739274,2053,1837,1250,668,0,668,0,235,0,0.035928144,empty,mBC-0716-1
"E5,F4",797626,852304,571200,281104,464811,2,249927,250364,192731,57633,3.34410841,134014,41179,27666,13084,2,13082,1,1490,0,0.001070173,mm10,mBC-0716-1
"E5,F5",642800,682583,477483,205100,369614,2,183284,183550,147869,35681,4.144194389,94479,106136,75186,35592,10,35582,1,2835,0,0.000674498,mm10,mBC-0716-1
"E5,F6",630208,651126,451524,199602,356675,0,188430,188695,156907,31788,4.936045048,97563,13348,9133,4291,3,4288,1,855,0,0.01119403,mm10,mBC-0716-1
"E5,F7",18180,18459,13841,4618,10257,0,4624,4633,3196,1437,2.22407794,2128,1479,930,482,0,482,0,168,0,0.060165975,empty,mBC-0716-1
"E5,F8",606183,659540,442836,216704,360394,0,189944,190214,151383,38831,3.898508923,101620,8632,5294,2565,0,2565,0,517,0,0.013255361,mm10,mBC-0716-1
"E5,F9",13958,14154,10692,3462,7742,0,3474,3476,2448,1028,2.381322957,1605,1810,1129,613,0,613,0,225,0,0.042414356,empty,mBC-0716-1
"E5,F10",19426,19802,15021,4781,10781,0,4701,4713,3292,1421,2.316678395,2218,6597,2669,1313,1,1312,1,261,0,0.039634146,empty,mBC-0716-1
"E5,F11",10301,10530,7947,2583,5778,0,2528,2533,1755,778,2.255784062,1229,1309,838,420,0,420,0,152,0,0.057142857,empty,mBC-0716-1
"E5,F12",12384,12430,9502,2928,6698,0,3076,3080,2178,902,2.414634146,1410,211,127,64,0,64,0,36,0,0,empty,mBC-0716-1
"E5,G1",9111,9363,7032,2331,5083,1,2280,2286,1581,705,2.242553191,1063,2230,1509,810,0,810,0,195,0,0.032098765,empty,mBC-0716-1
"E5,G2",979010,1037939,709125,328814,551269,0,289746,290171,235144,55027,4.273247678,150510,43821,31669,15348,5,15343,1,1628,0,0.001173173,mm10,mBC-0716-1
"E5,G3",18564,19103,14281,4822,10443,0,4660,4676,3312,1364,2.428152493,2256,1973,1338,712,1,711,1,213,0,0.029535865,empty,mBC-0716-1
"E5,G4",25439,25709,19727,5982,13718,1,5809,5828,4116,1712,2.404205607,2656,150,98,53,0,53,0,32,0,0.018867925,empty,mBC-0716-1
"E5,G5",11741,11998,8956,3042,6560,0,3051,3060,2131,929,2.29386437,1438,5939,2271,1113,1,1112,1,255,0,0.049460432,empty,mBC-0716-1
"E5,G6",950368,1018346,692292,326054,542456,0,287822,288200,246198,42002,5.86157802,151463,8761,5607,2575,1,2574,1,478,0,0,mm10,mBC-0716-1
"E5,G7",18216,18639,13998,4641,10160,0,4509,4523,3216,1307,2.460596787,2168,8226,2995,1558,4,1554,1,346,0,0.028314028,empty,mBC-0716-1
"E5,G8",1185639,1280790,860713,420077,689218,3,376378,376936,283111,93825,3.017436717,200679,114010,75189,36577,16,36561,4,3093,0,0.001449632,mm10,mBC-0716-1
"E5,G9",9797,10278,7347,2931,5614,0,2659,2671,1913,758,2.523746702,1290,1507,950,451,0,451,0,163,0,0.044345898,empty,mBC-0716-1
"E5,G10",12657,12933,9711,3222,7019,0,3160,3164,2221,943,2.355249205,1496,7298,2938,1504,0,1504,0,291,0,0.168218085,empty,mBC-0716-1
"E5,G11",11419,11883,8663,3220,6453,0,2961,2967,2068,899,2.300333704,1444,20569,6524,3264,3,3261,2,561,0,0.008892978,empty,mBC-0716-1
"E5,G12",10712,11041,8069,2972,6125,0,2783,2790,2013,777,2.590733591,1347,9154,3077,1556,0,1556,0,328,0,0.039203085,empty,mBC-0716-1
"E5,H1",18972,19608,14412,5196,10722,0,4932,4943,3483,1460,2.385616438,2406,1090,641,337,1,336,1,150,0,0.047619048,empty,mBC-0716-1
"E5,H2",1674384,1753875,1205660,548215,921290,1,492310,493097,396350,96747,4.096767858,256803,242605,172200,81374,34,81340,6,4499,0,0.000479469,mm10,mBC-0716-1
"E5,H3",18077,18532,13592,4940,10112,0,4614,4631,3219,1412,2.279745042,2262,1614,1017,564,0,564,0,185,0,0.019503546,empty,mBC-0716-1
"E5,H4",12519,12821,9377,3444,6965,0,3300,3313,2299,1014,2.267258383,1597,187,93,62,0,62,0,37,0,0.016129032,empty,mBC-0716-1
"E5,H5",16214,16660,12238,4422,9159,0,4209,4225,2959,1266,2.33728278,2061,2025,1310,743,0,743,0,213,0,0.064602961,empty,mBC-0716-1
"E5,H6",1055263,1124962,752087,372875,610752,1,331982,332443,262975,69468,3.785555939,177699,301465,215586,102814,38,102776,2,4997,0,0.002286526,mm10,mBC-0716-1
"E5,H7",702713,759849,492328,267521,415944,1,236646,236989,201773,35216,5.729583144,128019,117280,79586,37719,20,37699,4,3046,0,0.001538502,mm10,mBC-0716-1
"E5,H8",597576,648102,424520,223582,352167,1,193528,193813,146151,47662,3.066405103,105991,135810,91164,43899,21,43878,3,3272,0,0.00145859,mm10,mBC-0716-1
"E5,H9",546855,609184,375171,234013,334642,2,195926,196209,151557,44652,3.394181672,111374,70329,48480,23293,3,23290,2,2324,0,0.000729927,mm10,mBC-0716-1
"E5,H10",12711,13018,9698,3320,7069,0,3156,3165,2221,944,2.352754237,1457,1290,803,426,1,425,1,148,0,0.035294118,empty,mBC-0716-1
"E5,H11",1322562,1429126,952747,476379,762002,0,414869,415558,329920,85638,3.852495388,223706,5760,3395,1680,0,1680,0,396,0,0,mm10,mBC-0716-1
"E5,H12",5672,5867,4247,1620,3259,0,1554,1560,1120,440,2.545454545,765,7693,2704,1337,2,1335,1,251,0,0.023220974,empty,mBC-0716-1
"E6,A1",14637,14953,11133,3820,7961,0,3595,3599,2547,1052,2.421102662,1707,1408,915,456,1,455,1,124,0,0.046153846,empty,mBC-0716-1
"E6,A2",19613,19797,14956,4841,10274,0,4489,4500,3238,1262,2.565768621,2067,1139,735,417,1,416,1,134,0,0.064903846,empty,mBC-0716-1
"E6,A3",16754,17280,12739,4541,8963,0,4100,4108,2876,1232,2.334415584,1909,880,550,311,0,311,0,85,0,0,empty,mBC-0716-1
"E6,A4",884716,925232,661754,263478,479656,1,229078,229496,194669,34827,5.589600023,115249,39547,28192,13342,6,13336,3,1456,0,0.003674265,mm10,mBC-0716-1
"E6,A5",17096,17365,12892,4473,9098,0,4101,4116,2861,1255,2.279681275,1963,1300,814,426,0,426,0,130,0,0.063380282,empty,mBC-0716-1
"E6,A6",13066,13435,9863,3572,7057,0,3253,3259,2321,938,2.474413646,1601,1698,1059,496,0,496,0,163,0,0.090725806,empty,mBC-0716-1
"E6,A7",16726,17156,12639,4517,9111,0,4238,4247,2997,1250,2.3976,2012,1201,791,397,0,397,0,109,0,0.027707809,empty,mBC-0716-1
"E6,A8",11031,11449,8390,3059,6042,0,2763,2771,1984,787,2.520965693,1328,2861,1225,668,0,668,0,188,0,0.089820359,empty,mBC-0716-1
"E6,A9",19478,19948,15091,4857,10440,0,4572,4581,3158,1423,2.219255095,2175,4797,1624,800,0,800,0,197,0,0.05875,empty,mBC-0716-1
"E6,A10",16104,16601,12209,4392,8587,0,3869,3872,2701,1171,2.306575576,1829,307,210,113,0,113,0,51,0,0.03539823,empty,mBC-0716-1
"E6,A11",549580,589498,403144,186354,314159,0,161446,161681,136750,24931,5.485138984,84602,82888,56318,26947,6,26941,1,2451,0,0.002115734,mm10,mBC-0716-1
"E6,A12",20515,21201,15826,5375,10888,0,4801,4816,3372,1444,2.335180055,2305,2411,1370,699,0,699,0,172,0,0.08583691,empty,mBC-0716-1
"E6,B1",18745,19039,14329,4710,9984,0,4400,4410,3072,1338,2.295964126,2100,1061,664,344,0,344,0,118,0,0.023255814,empty,mBC-0716-1
"E6,B2",19452,19433,14591,4842,10202,0,4591,4605,3223,1382,2.332127352,2199,549,360,195,0,195,0,59,0,0.087179487,empty,mBC-0716-1
"E6,B3",20124,20650,15377,5273,11013,0,5086,5093,3662,1431,2.559049616,2429,1069,668,336,0,336,0,119,0,0.026785714,empty,mBC-0716-1
"E6,B4",16468,16944,12631,4313,8793,0,3959,3965,2805,1160,2.418103448,1868,1134,689,349,0,349,0,123,0,0.025787966,empty,mBC-0716-1
"E6,B5",850469,524879,358342,166537,351902,3,177581,178643,138255,40388,3.423170249,97425,63511,43006,20277,5,20272,2,2059,0,0.001035912,mm10,mBC-0716-1
"E6,B6",11999,12299,9085,3214,6470,5,2930,2940,2029,911,2.227222832,1411,3781,1292,631,0,631,0,133,0,0.047543582,empty,mBC-0716-1
"E6,B7",16107,16713,12498,4215,8807,0,3879,3894,2739,1155,2.371428571,1850,889,475,238,0,238,0,78,0,0.008403361,empty,mBC-0716-1
"E6,B8",13300,13985,10120,3865,7311,0,3281,3288,2328,960,2.425,1659,857,556,303,0,303,0,105,0,0.02640264,empty,mBC-0716-1
"E6,B9",14625,15145,11265,3880,7873,0,3566,3573,2533,1040,2.435576923,1727,614,355,192,0,192,0,69,0,0.020833333,empty,mBC-0716-1
"E6,B10",549838,551948,343537,208411,307213,3,176026,177177,136743,40434,3.381881585,100972,46654,25475,11941,8,11933,2,1412,0,0.003352049,mm10,mBC-0716-1
"E6,B11",16056,16845,12350,4495,8805,0,3993,3999,2778,1221,2.275184275,1973,229,146,68,0,68,0,41,0,0,empty,mBC-0716-1
"E6,B12",18164,18806,13966,4840,9985,0,4499,4510,3161,1349,2.343217198,2191,2862,1331,670,0,670,0,162,0,0.020895522,empty,mBC-0716-1
"E6,C1",22386,22416,17469,4947,11583,0,4815,4821,3369,1452,2.320247934,2175,880,574,276,0,276,0,91,0,0.010869565,empty,mBC-0716-1
"E6,C2",18884,19324,14288,5036,10096,0,4669,4677,3332,1345,2.47732342,2230,1492,992,520,0,520,0,171,0,0.036538462,empty,mBC-0716-1
"E6,C3",19952,21035,15232,5803,10810,1,4967,4982,3416,1566,2.181353768,2468,1494,514,279,0,279,0,63,0,0,empty,mBC-0716-1
"E6,C4",17867,17944,13529,4415,9418,0,4091,4109,2831,1278,2.215179969,1910,1018,638,316,0,316,0,103,0,0.028481013,empty,mBC-0716-1
"E6,C5",17130,17478,13055,4423,9180,0,4138,4148,2923,1225,2.386122449,2019,1033,712,352,0,352,0,112,0,0.005681818,empty,mBC-0716-1
"E6,C6",18675,19385,14042,5343,10516,0,4935,4945,3538,1407,2.514570007,2440,2265,1266,646,1,645,1,164,0,0.063565891,empty,mBC-0716-1
"E6,C7",16780,17578,12695,4883,9216,0,4199,4209,2935,1274,2.303767661,2081,265,126,85,1,84,1,49,0,0.011904762,empty,mBC-0716-1
"E6,C8",1862434,1994557,1347820,646737,1021749,1,558544,559449,430323,129126,3.332582129,296676,210682,146952,70041,22,70019,4,4157,0,0.001356775,mm10,mBC-0716-1
"E6,C9",498448,524754,358187,166567,282162,1,150555,150750,120505,30245,3.984294925,79873,7793,5111,2436,0,2436,0,491,0,0.005747126,mm10,mBC-0716-1
"E6,C10",13953,14453,10695,3758,7588,0,3408,3418,2425,993,2.442094663,1708,953,608,325,0,325,0,97,0,0.067692308,empty,mBC-0716-1
"E6,C11",12027,12281,9143,3138,6399,0,2874,2887,1965,922,2.131236443,1353,852,533,259,0,259,0,85,0,0.077220077,empty,mBC-0716-1
"E6,C12",1350893,1467457,982294,485163,756390,3,408486,409090,333863,75227,4.438074096,218876,153512,104569,49500,21,49479,2,3534,0,0.001980638,mm10,mBC-0716-1
"E6,D1",11393,11728,8542,3186,6329,0,2995,3003,2071,932,2.222103004,1445,510,279,144,0,144,0,56,0,0.076388889,empty,mBC-0716-1
"E6,D2",1087498,1165312,810610,354702,597177,1,301855,302330,237058,65272,3.631848266,155128,264582,180569,86415,33,86382,4,4411,0,0.000845083,mm10,mBC-0716-1
"E6,D3",721755,810604,497091,313513,430572,0,263858,264196,204008,60188,3.38951286,149465,17222,10626,5003,2,5001,1,799,0,0.004999,mm10,mBC-0716-1
"E6,D4",16925,17640,12768,4872,9506,0,4567,4577,3324,1253,2.6528332,2273,971,655,321,0,321,0,112,0,0.040498442,empty,mBC-0716-1
"E6,D5",14369,14959,10808,4151,7862,0,3590,3603,2473,1130,2.188495575,1809,1214,790,424,1,423,1,127,0,0,empty,mBC-0716-1
"E6,D6",12121,12496,9095,3401,6747,0,3234,3242,2278,964,2.363070539,1658,1019,636,341,0,341,0,110,0,0.023460411,empty,mBC-0716-1
"E6,D7",13777,14245,10543,3702,7564,0,3552,3553,2504,1049,2.387035272,1697,2811,1275,675,0,675,0,194,0,0.042962963,empty,mBC-0716-1
"E6,D8",15932,16326,11868,4458,8611,0,3963,3980,2683,1297,2.068619892,1990,2527,1141,585,0,585,0,134,0,0.305982906,empty,mBC-0716-1
"E6,D9",372524,401868,254763,147105,214240,0,122586,122729,98754,23975,4.119040667,68104,125872,82463,38603,16,38587,2,2944,0,0.01702646,mm10,mBC-0716-1
"E6,D10",898923,1028402,602614,425788,536946,1,338850,339245,279067,60178,4.637359168,196224,66909,45544,21466,10,21456,1,2046,0,0.005033557,mm10,mBC-0716-1
"E6,D11",13720,14047,10257,3790,7395,0,3416,3424,2418,1006,2.403578529,1654,3627,1513,746,0,746,0,200,0,0.061662198,empty,mBC-0716-1
"E6,D12",20594,21299,15918,5381,11086,0,5033,5040,3495,1545,2.262135922,2351,2695,1336,715,0,715,0,187,0,0.071328671,empty,mBC-0716-1
"E6,E1",22253,22806,17169,5637,11834,0,5187,5199,3681,1518,2.424901186,2468,1476,970,490,0,490,0,139,0,0.030612245,empty,mBC-0716-1
"E6,E2",674797,702961,505814,197147,370145,4,175571,175896,151519,24377,6.2156541,87557,128917,86514,41402,18,41384,3,3076,0,0.001014885,mm10,mBC-0716-1
"E6,E3",564690,607082,419471,187611,320676,0,160332,160594,138426,22168,6.244406351,82674,149574,104586,50230,16,50214,2,3363,0,0.001493607,mm10,mBC-0716-1
"E6,E4",15097,15556,11667,3889,8194,0,3717,3724,2630,1094,2.404021938,1807,1467,933,518,0,518,0,164,0,0.015444015,empty,mBC-0716-1
"E6,E5",20871,21275,16043,5232,10974,0,4817,4831,3352,1479,2.266396214,2281,1974,1155,574,0,574,0,167,0,0.050522648,empty,mBC-0716-1
"E6,E6",13745,14232,10487,3745,7435,0,3330,3343,2217,1126,1.968916519,1623,2429,1117,569,0,569,0,132,0,0.077328647,empty,mBC-0716-1
"E6,E7",13866,14204,10561,3643,7369,0,3328,3340,2345,995,2.35678392,1613,1013,618,326,0,326,0,101,0,0.073619632,empty,mBC-0716-1
"E6,E8",17648,17745,13558,4187,9297,0,4015,4029,2820,1209,2.332506203,1801,1857,1236,643,0,643,0,177,0,0.034214619,empty,mBC-0716-1
"E6,E9",9459,9862,7255,2607,5157,0,2339,2340,1677,663,2.529411765,1123,3864,1278,651,1,650,1,132,0,0.08,empty,mBC-0716-1
"E6,E10",13047,13542,9982,3560,7241,0,3313,3332,2317,1015,2.282758621,1621,1177,664,368,1,367,1,109,0,0.163487738,empty,mBC-0716-1
"E6,E11",9396,9744,7209,2535,5195,0,2382,2393,1690,703,2.40398293,1154,818,459,245,0,245,0,102,0,0.036734694,empty,mBC-0716-1
"E6,E12",16482,16918,12461,4457,8908,0,4124,4134,2919,1215,2.402469136,1982,8751,2619,1362,0,1362,0,254,0,0.063876652,empty,mBC-0716-1
"E6,F1",18179,18495,13853,4642,9566,0,4319,4327,3030,1297,2.33616037,2007,1350,738,402,0,402,0,115,0,0,empty,mBC-0716-1
"E6,F2",22687,23529,17317,6212,12297,0,5747,5757,4005,1752,2.285958904,2778,2342,1479,748,1,747,1,234,0,0.038821954,empty,mBC-0716-1
"E6,F3",1188490,1360962,779818,581144,698227,4,450563,451178,362242,88936,4.073063776,264317,124951,87667,42091,14,42077,1,2984,0,0.000641681,mm10,mBC-0716-1
"E6,F4",17921,18568,13474,5094,9943,0,4459,4475,3139,1336,2.349550898,2229,985,423,231,0,231,0,94,0,0.03030303,empty,mBC-0716-1
"E6,F5",788499,871939,556126,315813,457918,1,260501,260893,213394,47499,4.492599844,144690,77198,55530,26094,5,26089,1,2310,0,0.000574955,mm10,mBC-0716-1
"E6,F6",23804,24069,18233,5836,12606,0,5717,5723,4055,1668,2.431055156,2621,2213,1466,779,2,777,1,194,0,0.047619048,empty,mBC-0716-1
"E6,F7",20074,20625,15302,5323,11037,0,4971,4983,3483,1500,2.322,2366,645,412,212,0,212,0,85,0,0.108490566,empty,mBC-0716-1
"E6,F8",22684,23058,17406,5652,12182,0,5436,5443,3768,1675,2.249552239,2570,202,156,82,0,82,0,52,0,0,empty,mBC-0716-1
"E6,F9",15694,16036,11884,4152,8546,0,3866,3878,2739,1139,2.404741001,1849,4923,2191,1200,0,1200,0,233,0,0.211666667,empty,mBC-0716-1
"E6,F10",20268,20586,15727,4859,10662,0,4556,4570,3221,1349,2.387694589,2057,1561,956,491,0,491,0,147,0,0.071283096,empty,mBC-0716-1
"E6,F11",11506,11894,8721,3173,6097,0,2739,2744,1908,836,2.282296651,1354,927,580,300,0,300,0,102,0,0.03,empty,mBC-0716-1
"E6,F12",599116,654571,432877,221694,342500,0,182545,182808,151079,31729,4.761543068,99131,6378,4401,2153,2,2151,2,372,0,0.0018596,mm10,mBC-0716-1
"E6,G1",9897,10362,7638,2724,5459,0,2412,2419,1694,725,2.336551724,1156,1652,1024,508,0,508,0,134,0,0.037401575,empty,mBC-0716-1
"E6,G2",20700,20672,16001,4671,10785,1,4759,4768,3349,1419,2.360112755,2116,580,341,198,0,198,0,59,0,0.055555556,empty,mBC-0716-1
"E6,G3",20700,21385,15454,5931,11187,1,5154,5173,3651,1522,2.398817346,2538,3699,1743,832,0,832,0,206,0,0.088942308,empty,mBC-0716-1
"E6,G4",870173,930225,647004,283221,485621,2,244076,244457,163259,81198,2.010628341,129103,576,441,227,0,227,0,64,0,0.004405286,empty,mBC-0716-1
"E6,G5",643340,693890,468426,225464,365404,1,193546,193844,139734,54110,2.58240621,103051,56952,31506,15132,5,15127,1,1696,0,0.005024129,mm10,mBC-0716-1
"E6,G6",494258,493343,374699,118644,262908,2,116924,117137,93852,23285,4.030577625,55305,919,613,294,0,294,0,92,0,0,empty,mBC-0716-1
"E6,G7",1415166,1558774,987350,571424,793022,0,472887,473553,393385,80168,4.907007784,257672,166344,113454,53104,24,53080,3,3548,0,0.00256217,mm10,mBC-0716-1
"E6,G8",19697,21828,14956,6872,11388,0,5948,5962,4055,1907,2.126376508,3036,2801,1520,730,0,730,0,198,0,0.056164384,empty,mBC-0716-1
"E6,G9",10583,10809,8148,2661,5695,0,2619,2625,1861,764,2.435863874,1208,1546,723,387,0,387,0,123,0,0.028423773,empty,mBC-0716-1
"E6,G10",13808,14051,10537,3514,7317,0,3253,3264,2285,979,2.3340143,1548,2720,1435,724,0,724,0,166,0,0.14640884,empty,mBC-0716-1
"E6,G11",12418,12451,9532,2919,6647,0,2936,2945,2106,839,2.510131108,1367,678,459,237,0,237,0,92,0,0.071729958,empty,mBC-0716-1
"E6,G12",11496,11750,8840,2910,6239,0,2853,2860,1987,873,2.276059565,1351,1196,739,331,1,330,1,99,0,0.003030303,empty,mBC-0716-1
"E6,H1",20926,21310,15787,5523,11287,0,5110,5114,3656,1458,2.507544582,2447,865,534,311,0,311,0,117,0,0.051446945,empty,mBC-0716-1
"E6,H2",1097687,1267470,729782,537688,654511,0,421064,421650,325060,96590,3.365358733,247813,81257,58804,27776,8,27768,1,2441,0,0.002412849,mm10,mBC-0716-1
"E6,H3",20178,20722,15502,5220,10929,0,5011,5021,3480,1541,2.258273848,2379,1226,743,378,0,378,0,134,0,0.058201058,empty,mBC-0716-1
"E6,H4",13881,14397,10570,3827,7588,0,3461,3471,2420,1051,2.302568982,1692,161,116,53,0,53,0,25,0,0.169811321,empty,mBC-0716-1
"E6,H5",18139,19034,14016,5018,9936,0,4604,4609,3221,1388,2.320605187,2270,1397,815,416,0,416,0,151,0,0.055288462,empty,mBC-0716-1
"E6,H6",419843,425286,314975,110311,229988,1,106328,106522,78756,27766,2.836418642,52256,17340,11583,5292,1,5291,1,921,0,0.003591004,mm10,mBC-0716-1
"E6,H7",18130,18446,13247,5199,9865,0,4664,4676,3328,1348,2.46884273,2337,29283,9198,4577,5,4572,4,755,0,0.06167979,empty,mBC-0716-1
"E6,H8",13986,14438,10545,3893,7548,0,3513,3521,2448,1073,2.281453868,1732,1708,982,534,0,534,0,160,0,0.088014981,empty,mBC-0716-1
"E6,H9",17249,17554,13015,4539,9293,0,4289,4300,3109,1191,2.610411419,2025,990,638,348,1,347,1,125,0,0.028818444,empty,mBC-0716-1
"E6,H10",15758,16008,11787,4221,8422,0,3868,3875,2701,1174,2.300681431,1892,11722,3795,2042,1,2041,1,351,0,0.151396374,empty,mBC-0716-1
"E6,H11",850999,987615,572659,414956,520540,3,334515,334917,271493,63424,4.280603557,194663,1758,1218,591,0,591,0,148,0,0.023688663,empty,mBC-0716-1
"E6,H12",6363,6479,4797,1682,3557,0,1668,1668,1177,491,2.397148676,812,7183,2288,1114,0,1114,0,205,0,0.034111311,empty,mBC-0716-1
"E7,A1",13117,13607,9817,3790,7466,0,3642,3650,2656,994,2.672032193,1751,1031,616,304,0,304,0,93,0,0.065789474,empty,mBC-0716-1
"E7,A2",713331,754882,517466,237416,400489,0,210227,210545,176106,34439,5.113563112,109667,56671,40573,19776,4,19772,1,1879,0,0.000960955,mm10,mBC-0716-1
"E7,A3",61262,68282,42477,25805,37437,0,22311,22345,16490,5855,2.816396243,12355,19025,13083,6396,2,6394,1,901,0,0.000781983,empty,mBC-0716-1
"E7,A4",17915,18256,13726,4530,9644,0,4229,4245,2981,1264,2.358386076,1966,598,333,159,0,159,0,47,0,0.050314465,empty,mBC-0716-1
"E7,A5",14702,15519,11206,4313,8186,1,3863,3875,2724,1151,2.366637706,1881,1713,923,449,0,449,0,120,0,0.064587973,empty,mBC-0716-1
"E7,A6",15001,15840,11458,4382,8595,0,4056,4067,2935,1132,2.592756184,1971,1085,628,342,0,342,0,119,0,0.032163743,empty,mBC-0716-1
"E7,A7",13983,14651,10694,3957,7745,0,3546,3554,2462,1092,2.254578755,1737,2774,973,516,0,516,0,124,0,0.110465116,empty,mBC-0716-1
"E7,A8",9316,9387,7042,2345,5138,0,2381,2386,1702,684,2.488304094,1091,1267,788,406,1,405,1,120,0,0.086419753,empty,mBC-0716-1
"E7,A9",15924,16198,12393,3805,8501,0,3744,3753,2686,1067,2.517338332,1740,996,648,333,0,333,0,106,0,0,empty,mBC-0716-1
"E7,A10",13630,14294,10353,3941,7523,1,3503,3517,2485,1032,2.407945736,1742,363,250,145,0,145,0,44,0,0.027586207,empty,mBC-0716-1
"E7,A11",15595,15631,11868,3763,8442,0,3767,3773,2637,1136,2.321302817,1708,1019,654,311,0,311,0,94,0,0.077170418,empty,mBC-0716-1
"E7,A12",17113,17411,13072,4339,9199,0,4038,4043,2814,1229,2.289666395,1893,2661,1618,806,1,805,1,184,0,0.085714286,empty,mBC-0716-1
"E7,B1",16312,16768,12577,4191,8922,0,3940,3948,2771,1177,2.354290569,1888,1273,886,458,0,458,0,121,0,0.048034934,empty,mBC-0716-1
"E7,B2",16784,17390,12904,4486,9075,0,4099,4109,2858,1251,2.284572342,1970,1435,542,261,0,261,0,69,0,0.084291188,empty,mBC-0716-1
"E7,B3",16646,17166,12733,4433,9204,0,4165,4176,2984,1192,2.503355705,2006,1176,806,406,0,406,0,117,0,0.061576355,empty,mBC-0716-1
"E7,B4",14587,15451,11217,4234,8174,0,3724,3728,2628,1100,2.389090909,1845,1351,620,355,0,355,0,106,0,0.030985915,empty,mBC-0716-1
"E7,B5",434994,288267,155793,132474,197135,5,130786,131411,100787,30624,3.291111546,82049,4782,3233,1534,0,1534,0,361,0,0.003911343,mm10,mBC-0716-1
"E7,B6",10374,10894,7821,3073,5729,0,2648,2652,1868,784,2.382653061,1289,1181,756,346,0,346,0,97,0,0.066473988,empty,mBC-0716-1
"E7,B7",13403,13882,10434,3448,7384,0,3358,3364,2393,971,2.464469619,1555,786,498,272,0,272,0,79,0,0.022058824,empty,mBC-0716-1
"E7,B8",10968,11351,8360,2991,6131,0,2825,2833,1998,835,2.392814371,1364,995,681,346,0,346,0,99,0,0.037572254,empty,mBC-0716-1
"E7,B9",12845,13059,9798,3261,6835,0,3180,3184,2143,1041,2.058597502,1500,514,306,172,1,171,1,64,0,0.005847953,empty,mBC-0716-1
"E7,B10",15726,15600,11430,4170,8696,0,4122,4135,2897,1238,2.34006462,1999,458,236,134,0,134,0,45,0,0.059701493,empty,mBC-0716-1
"E7,B11",17105,17843,13038,4805,9559,0,4488,4492,3252,1240,2.622580645,2204,119,83,53,0,53,0,30,0,0,empty,mBC-0716-1
"E7,B12",348054,354897,265162,89735,194951,3,87602,87765,66512,21253,3.129534654,41823,53994,25454,12328,15,12313,4,1508,0,0.024608138,mm10,mBC-0716-1
"E7,C1",18546,18503,14368,4135,9817,0,4181,4188,2959,1229,2.407648495,1856,597,370,204,0,204,0,68,0,0.039215686,empty,mBC-0716-1
"E7,C2",17071,17899,12897,5002,9577,0,4595,4606,3256,1350,2.411851852,2271,1402,976,452,0,452,0,144,0,0.050884956,empty,mBC-0716-1
"E7,C3",17089,17606,12957,4649,9296,0,4276,4288,2985,1303,2.290867229,2034,2819,957,477,0,477,0,101,0,0.031446541,empty,mBC-0716-1
"E7,C4",32617,34760,24680,10080,18542,0,8927,8939,6409,2530,2.533201581,4533,5206,2307,1112,0,1112,0,243,0,0.073741007,empty,mBC-0716-1
"E7,C5",13882,14305,10555,3750,7537,0,3410,3420,2402,1018,2.359528487,1617,861,569,285,1,284,1,81,0,0.133802817,empty,mBC-0716-1
"E7,C6",14257,14444,10714,3730,8009,0,3705,3715,2615,1100,2.377272727,1752,982,618,319,1,318,1,107,0,0.056603774,empty,mBC-0716-1
"E7,C7",1333569,1431711,964040,467671,749636,0,401268,401901,335643,66258,5.065697727,212686,43632,26853,12927,4,12923,2,1585,0,0.00549408,mm10,mBC-0716-1
"E7,C8",13509,13362,9981,3381,7133,0,3283,3284,2334,950,2.456842105,1570,8373,2743,1380,0,1380,0,283,0,0.135507246,empty,mBC-0716-1
"E7,C9",11002,11591,8434,3157,6182,2,2938,2942,2008,934,2.149892934,1404,749,469,211,0,211,0,58,0,0.047393365,empty,mBC-0716-1
"E7,C10",635177,700283,438327,261956,376107,0,225577,225890,179939,45951,3.915888664,125354,14978,10239,4869,2,4867,1,809,0,0.002054654,mm10,mBC-0716-1
"E7,C11",9822,10123,7500,2623,5435,0,2603,2606,1823,783,2.328224777,1273,1025,631,336,0,336,0,79,0,0.053571429,empty,mBC-0716-1
"E7,C12",17029,17577,12808,4769,9477,0,4326,4336,3041,1295,2.348262548,2167,984,676,340,1,339,1,103,0,0.053097345,empty,mBC-0716-1
"E7,D1",10579,10906,7968,2938,5939,1,2835,2844,1940,904,2.146017699,1370,925,440,217,0,217,0,58,0,0.00921659,empty,mBC-0716-1
"E7,D2",17198,17617,13362,4255,9422,0,4116,4131,2857,1274,2.242543171,1926,2022,1163,556,0,556,0,147,0,0.053956835,empty,mBC-0716-1
"E7,D3",12132,12921,9051,3870,7082,0,3393,3398,2369,1029,2.30223518,1712,1111,723,351,0,351,0,117,0,0.085470085,empty,mBC-0716-1
"E7,D4",12145,12594,9345,3249,6679,0,3143,3147,2174,973,2.234326824,1472,1168,815,408,0,408,0,109,0,0.049019608,empty,mBC-0716-1
"E7,D5",12389,12854,9299,3555,6906,0,3203,3208,2296,912,2.51754386,1586,4445,1703,866,1,865,1,219,0,0.025433526,empty,mBC-0716-1
"E7,D6",11053,11325,8367,2958,6084,0,2825,2832,1977,855,2.312280702,1399,893,526,263,0,263,0,92,0,0.125475285,empty,mBC-0716-1
"E7,D7",732843,775064,532431,242633,410154,2,211711,212030,181329,30701,5.906289697,110033,146251,102529,48542,25,48517,5,3283,0,0.001380959,mm10,mBC-0716-1
"E7,D8",13648,14345,10453,3892,7777,0,3644,3654,2573,1081,2.380203515,1809,5509,1873,873,0,873,0,189,0,0.038946163,empty,mBC-0716-1
"E7,D9",5244,5468,3825,1643,3035,0,1546,1548,1128,420,2.685714286,802,1292,665,326,0,326,0,114,0,0.024539877,empty,mBC-0716-1
"E7,D10",12330,12888,9312,3576,6791,0,3221,3228,2320,908,2.555066079,1574,1804,712,390,0,390,0,86,0,0.228205128,empty,mBC-0716-1
"E7,D11",11729,12027,8930,3097,6399,0,2935,2946,2101,845,2.486390533,1395,1788,1058,512,0,512,0,146,0,0.052734375,empty,mBC-0716-1
"E7,D12",17262,17514,13178,4336,9474,0,4228,4232,2956,1276,2.31661442,2055,5471,2248,1124,0,1124,0,246,0,0.058718861,empty,mBC-0716-1
"E7,E1",828797,857343,623277,234066,450554,0,212744,213148,183591,29557,6.211421998,104767,137634,76560,36702,21,36681,4,3064,0,0.027234808,mm10,mBC-0716-1
"E7,E2",14313,15062,10867,4195,8136,0,3718,3729,2661,1068,2.491573034,1849,1401,878,461,0,461,0,139,0,0.086767896,empty,mBC-0716-1
"E7,E3",10665,11007,8129,2878,5840,0,2631,2639,1820,819,2.222222222,1264,1233,742,380,0,380,0,115,0,0.026315789,empty,mBC-0716-1
"E7,E4",337399,334176,261537,72639,181624,2,72301,72465,55865,16600,3.365361446,33161,12703,7970,3821,1,3820,1,721,0,0.006544503,mm10,mBC-0716-1
"E7,E5",17825,18157,13692,4465,9623,0,4232,4236,2995,1241,2.413376309,1977,1152,698,376,0,376,0,120,0,0.085106383,empty,mBC-0716-1
"E7,E6",11942,12315,9153,3162,6617,0,3018,3027,2081,946,2.199788584,1467,1418,938,429,0,429,0,111,0,0.058275058,empty,mBC-0716-1
"E7,E7",457301,481286,340365,140921,261335,0,130814,131064,101576,29488,3.444655453,66818,32450,20927,10240,1,10239,1,1290,0,0.010059576,mm10,mBC-0716-1
"E7,E8",14860,15124,11428,3696,8058,0,3506,3514,2465,1049,2.349857007,1582,1853,1193,590,0,590,0,157,0,0.044067797,empty,mBC-0716-1
"E7,E9",8489,8655,6451,2204,4713,0,2135,2141,1482,659,2.248861912,1064,1156,736,362,0,362,0,109,0,0.132596685,empty,mBC-0716-1
"E7,E10",876595,954404,622152,332252,504316,1,287222,287608,233350,54258,4.300748277,154740,127208,88502,41768,15,41753,2,3008,0,0.002730343,mm10,mBC-0716-1
"E7,E11",8433,8451,6405,2046,4575,0,1989,1993,1410,583,2.418524871,934,910,559,289,0,289,0,94,0,0.044982699,empty,mBC-0716-1
"E7,E12",980079,1077024,696275,380749,577513,3,321907,322337,264287,58050,4.552747631,177188,143927,103413,48910,16,48894,3,3427,0,0.000552215,mm10,mBC-0716-1
"E7,F1",15064,15697,11591,4106,8281,0,3750,3759,2668,1091,2.445462878,1809,2509,1229,597,0,597,0,145,0,0.050251256,empty,mBC-0716-1
"E7,F2",20413,20523,15243,5280,10940,0,5071,5073,3609,1464,2.465163934,2454,76678,23498,12059,5,12054,1,1496,0,0.105691057,empty,mBC-0716-1
"E7,F3",522126,554252,389318,164934,298666,0,146731,146976,111748,35228,3.172135801,75224,88788,60903,28681,19,28662,3,2488,0,0.004396064,mm10,mBC-0716-1
"E7,F4",15853,16472,12194,4278,8889,1,4075,4082,2953,1129,2.615589017,1936,544,304,175,0,175,0,80,0,0.108571429,empty,mBC-0716-1
"E7,F5",20694,21394,15686,5708,11325,1,5149,5160,3658,1502,2.435419441,2506,13167,4455,2225,1,2224,1,403,0,0.068345324,empty,mBC-0716-1
"E7,F6",20528,21175,15741,5434,11410,0,5242,5262,3702,1560,2.373076923,2529,1825,1195,620,1,619,1,162,0,0.066235864,empty,mBC-0716-1
"E7,F7",16679,16913,12780,4133,9286,0,4124,4131,2878,1253,2.29688747,1905,775,472,262,0,262,0,75,0,0.038167939,empty,mBC-0716-1
"E7,F8",20327,21195,15519,5676,11432,0,5275,5292,3801,1491,2.549295775,2585,240,169,90,0,90,0,40,0,0,empty,mBC-0716-1
"E7,F9",14577,14987,11180,3807,8060,0,3665,3669,2658,1011,2.629080119,1742,1562,950,503,0,503,0,160,0,0.047713718,empty,mBC-0716-1
"E7,F10",17204,17425,13280,4145,9344,0,4005,4013,2866,1147,2.498692241,1846,1350,684,350,0,350,0,108,0,0.111428571,empty,mBC-0716-1
"E7,F11",403274,412815,303043,109772,226127,0,108616,108818,81540,27278,2.989222084,53225,6916,4779,2291,1,2290,1,475,0,0.0069869,mm10,mBC-0716-1
"E7,F12",11625,11910,8736,3174,6231,0,2773,2779,1967,812,2.422413793,1296,90,58,28,0,28,0,15,0,0,empty,mBC-0716-1
"E7,G1",285677,286435,217662,68773,157603,1,69448,69569,56152,13417,4.185138257,32869,12236,7857,3717,2,3715,1,733,0,0.006729475,mm10,mBC-0716-1
"E7,G2",17300,17629,13277,4352,9213,0,4086,4099,2762,1337,2.065818998,1914,416,219,127,0,127,0,45,0,0.102362205,empty,mBC-0716-1
"E7,G3",16979,17307,12927,4380,9276,0,4097,4110,2926,1184,2.471283784,1946,3980,1753,854,0,854,0,182,0,0.049180328,empty,mBC-0716-1
"E7,G4",24164,24472,18282,6190,13069,0,5826,5831,4113,1718,2.394062864,2805,400,147,73,0,73,0,34,0,0,empty,mBC-0716-1
"E7,G5",11981,12572,9068,3504,6719,0,3096,3104,2223,881,2.523269012,1532,912,559,288,0,288,0,96,0,0.03125,empty,mBC-0716-1
"E7,G6",20375,20761,15649,5112,11181,0,4909,4923,3427,1496,2.290775401,2320,115,79,31,0,31,0,19,0,0,empty,mBC-0716-1
"E7,G7",16909,17423,12857,4566,9202,0,4212,4223,2954,1269,2.327817179,1991,1489,970,498,0,498,0,145,0,0.120481928,empty,mBC-0716-1
"E7,G8",12592,13214,9549,3665,7128,1,3392,3397,2350,1047,2.244508118,1672,1133,670,334,0,334,0,119,0,0.086826347,empty,mBC-0716-1
"E7,G9",9263,9592,7066,2526,5201,0,2399,2399,1702,697,2.441893831,1147,1542,759,385,0,385,0,134,0,0.015584416,empty,mBC-0716-1
"E7,G10",566464,628850,395547,233303,340426,0,198057,198313,148502,49811,2.981309349,111946,2343,1420,698,1,697,1,274,0,0.007173601,empty,mBC-0716-1
"E7,G11",10358,10987,7967,3020,5832,0,2651,2659,1915,744,2.573924731,1311,529,305,183,0,183,0,74,0,0.010928962,empty,mBC-0716-1
"E7,G12",9742,9926,7549,2377,5387,0,2484,2489,1722,767,2.245110821,1122,3626,1434,751,0,751,0,177,0,0.049267643,empty,mBC-0716-1
"E7,H1",18093,18665,13741,4924,10033,0,4560,4569,3362,1207,2.785418393,2143,3491,1339,639,0,639,0,146,0,0.056338028,empty,mBC-0716-1
"E7,H2",841927,913804,602373,311431,479366,3,255714,256088,218568,37520,5.825373134,137350,221230,157391,74587,33,74554,2,4143,0,0.001005982,mm10,mBC-0716-1
"E7,H3",17243,17937,13033,4904,9595,0,4476,4489,3161,1328,2.380271084,2164,1616,1000,440,1,439,1,117,0,0.107061503,empty,mBC-0716-1
"E7,H4",477429,506493,346080,160413,272642,0,140458,140681,117942,22739,5.186771626,73884,4774,3091,1503,0,1503,0,294,0,0.005988024,mm10,mBC-0716-1
"E7,H5",15724,16015,11910,4105,8687,0,4014,4024,2831,1193,2.37300922,1941,864,494,280,0,280,0,99,0,0.046428571,empty,mBC-0716-1
"E7,H6",12820,13315,9642,3673,7316,0,3457,3466,2468,998,2.472945892,1711,1565,819,400,1,399,1,131,0,0.065162907,empty,mBC-0716-1
"E7,H7",15193,15738,11508,4230,8635,0,3948,3953,2747,1206,2.277777778,1971,1238,773,397,1,396,1,138,0,0.025252525,empty,mBC-0716-1
"E7,H8",427268,470468,302805,167663,254223,0,141586,141803,116068,25735,4.510122401,78276,107581,63811,30957,10,30947,3,2608,0,0.006979675,mm10,mBC-0716-1
"E7,H9",14951,15173,11218,3955,8192,0,3764,3769,2779,990,2.807070707,1827,9834,3420,1778,0,1778,0,309,0,0.071991001,empty,mBC-0716-1
"E7,H10",12994,13486,9820,3666,7067,0,3262,3266,2354,912,2.581140351,1543,1215,742,380,0,380,0,100,0,0.073684211,empty,mBC-0716-1
"E7,H11",15291,15956,11597,4359,8618,0,3995,4002,2803,1199,2.337781485,1996,119,94,58,0,58,0,32,0,0,empty,mBC-0716-1
"E7,H12",5627,5887,4241,1646,3186,1,1552,1555,1089,466,2.336909871,752,501,321,160,0,160,0,51,0,0.00625,empty,mBC-0716-1
"E8,A1",739515,855529,480351,375178,459762,1,299387,299756,228274,71482,3.193447301,178837,73971,47893,22974,13,22961,2,2176,0,0.001698532,mm10,mBC-0716-1
"E8,A2",19445,19759,14884,4875,10423,0,4634,4646,3332,1314,2.535768645,2171,8978,2943,1504,1,1503,1,289,0,0.049234864,empty,mBC-0716-1
"E8,A3",16271,17402,12400,5002,9271,0,4349,4361,3105,1256,2.472133758,2219,1386,678,327,0,327,0,103,0,0.024464832,empty,mBC-0716-1
"E8,A4",20273,20807,15749,5058,10941,0,4880,4888,3527,1361,2.591476855,2259,433,251,121,0,121,0,54,0,0.041322314,empty,mBC-0716-1
"E8,A5",15815,16268,12139,4129,8860,0,4040,4049,2799,1250,2.2392,1928,2188,973,496,0,496,0,159,0,0.024193548,empty,mBC-0716-1
"E8,A6",13732,14528,10263,4265,7814,0,3841,3846,2729,1117,2.443151298,1974,1397,893,463,1,462,1,147,0,0.062770563,empty,mBC-0716-1
"E8,A7",15715,16082,12128,3954,8619,0,3859,3864,2649,1215,2.180246914,1822,1570,1029,495,0,495,0,123,0,0.038383838,empty,mBC-0716-1
"E8,A8",10581,10987,8093,2894,5971,0,2759,2764,1964,800,2.455,1314,1426,878,487,0,487,0,164,0,0.030800821,empty,mBC-0716-1
"E8,A9",19153,19451,14778,4673,10348,1,4510,4533,3291,1242,2.649758454,2135,1264,810,389,0,389,0,124,0,0.025706941,empty,mBC-0716-1
"E8,A10",15621,15951,11814,4137,8704,0,3965,3972,2858,1114,2.565529623,1952,423,250,141,0,141,0,49,0,0,empty,mBC-0716-1
"E8,A11",18832,18821,13941,4880,9967,0,4560,4560,3193,1367,2.335771763,2134,13600,5215,2812,1,2811,1,341,0,0.36072572,empty,mBC-0716-1
"E8,A12",19599,20432,15030,5402,10598,0,4761,4770,3348,1422,2.35443038,2357,2600,1639,814,1,813,1,195,0,0.054120541,empty,mBC-0716-1
"E8,B1",492413,495357,369546,125811,267969,0,123170,123405,96637,26768,3.610168858,59556,5866,4124,1963,1,1962,1,456,0,0.004077472,mm10,mBC-0716-1
"E8,B2",18558,18989,14004,4985,10130,0,4525,4534,3175,1359,2.336276674,2189,649,423,189,0,189,0,54,0,0.052910053,empty,mBC-0716-1
"E8,B3",782927,850594,572650,277944,448599,2,233961,234311,199423,34888,5.716091493,124023,103004,73181,35706,12,35694,1,2782,0,0.000308175,mm10,mBC-0716-1
"E8,B4",16147,17051,12183,4868,8869,0,4138,4155,2890,1265,2.28458498,2034,2155,808,463,0,463,0,137,0,0.060475162,empty,mBC-0716-1
"E8,B5",9342,5754,4136,1618,3912,0,1817,1829,1297,532,2.437969925,954,2839,972,527,0,527,0,126,0,0.079696395,empty,mBC-0716-1
"E8,B6",11968,12557,9051,3506,6637,0,3113,3121,2183,938,2.327292111,1575,1383,854,428,0,428,0,125,0,0.039719626,empty,mBC-0716-1
"E8,B7",1296746,1374281,968697,405584,723906,1,358772,359402,309951,49451,6.267840893,183546,205396,133318,63430,21,63409,4,3934,0,0.001829393,mm10,mBC-0716-1
"E8,B8",12731,12971,9742,3229,6951,0,3114,3118,2145,973,2.204522097,1469,6509,2144,1056,0,1056,0,222,0,0.082386364,empty,mBC-0716-1
"E8,B9",14332,14832,11096,3736,7839,0,3562,3569,2453,1116,2.198028674,1696,708,430,224,0,224,0,70,0,0.053571429,empty,mBC-0716-1
"E8,B10",16479,16241,11913,4328,8875,0,4041,4062,2801,1261,2.221252974,1969,456,270,138,0,138,0,69,0,0.072463768,empty,mBC-0716-1
"E8,B11",16722,17465,12898,4567,9089,0,4181,4192,2895,1297,2.232074017,1963,196,110,66,0,66,0,29,0,0,empty,mBC-0716-1
"E8,B12",17399,17999,13296,4703,9604,0,4373,4377,3107,1270,2.446456693,2091,1178,733,377,0,377,0,107,0,0.055702918,empty,mBC-0716-1
"E8,C1",20812,20963,16063,4900,10925,0,4682,4692,3361,1331,2.525169046,2160,733,524,262,0,262,0,82,0,0.030534351,empty,mBC-0716-1
"E8,C2",19894,21117,15015,6102,11262,0,5355,5367,3786,1581,2.394686907,2729,1921,1316,691,0,691,0,174,0,0.092619392,empty,mBC-0716-1
"E8,C3",514629,522708,386281,136427,282790,0,130614,130880,104023,26857,3.873217411,63718,12493,8229,3911,3,3908,1,678,0,0.006397134,mm10,mBC-0716-1
"E8,C4",634960,677340,461176,216164,365083,0,190284,190601,166172,24429,6.802243235,100442,103836,74181,35858,18,35840,1,2741,0,0.002064732,mm10,mBC-0716-1
"E8,C5",717781,744917,528484,216433,398458,1,203542,203857,153871,49986,3.078281919,103055,28792,14684,7310,1,7309,1,1065,0,0.111095909,mm10,mBC-0716-1
"E8,C6",17740,18377,13120,5257,10190,0,4961,4972,3557,1415,2.513780919,2465,1228,745,400,0,400,0,144,0,0.04,empty,mBC-0716-1
"E8,C7",16293,17126,12330,4796,9259,0,4386,4392,3150,1242,2.536231884,2195,521,340,166,0,166,0,43,0,0.090361446,empty,mBC-0716-1
"E8,C8",14825,15111,11145,3966,8194,0,3776,3790,2657,1133,2.3451015,1858,1393,867,463,0,463,0,129,0,0.058315335,empty,mBC-0716-1
"E8,C9",11905,12344,9230,3114,6695,0,3061,3069,2153,916,2.350436681,1517,928,648,329,0,329,0,85,0,0.042553191,empty,mBC-0716-1
"E8,C10",13371,13773,10387,3386,7224,0,3296,3303,2307,996,2.31626506,1490,989,600,319,0,319,0,100,0,0.065830721,empty,mBC-0716-1
"E8,C11",11146,11710,8420,3290,6222,0,2973,2977,2050,927,2.211434736,1457,1019,619,314,0,314,0,88,0,0.025477707,empty,mBC-0716-1
"E8,C12",631911,662883,483816,179067,350120,1,159947,160258,126999,33259,3.818485222,79629,52022,36740,17438,12,17426,2,1757,0,0.001836337,mm10,mBC-0716-1
"E8,D1",605217,669165,414267,254898,359706,1,212353,212644,159361,53283,2.990841357,119647,27136,18215,8839,4,8835,2,1146,0,0.001018676,mm10,mBC-0716-1
"E8,D2",19760,20073,15323,4750,10718,0,4643,4651,3315,1336,2.481287425,2166,16884,5089,2570,1,2569,1,427,0,0.066952121,empty,mBC-0716-1
"E8,D3",13986,14512,10618,3894,7828,0,3683,3689,2616,1073,2.438024231,1779,959,569,312,0,312,0,92,0,0.067307692,empty,mBC-0716-1
"E8,D4",15430,15956,11732,4224,8642,0,4102,4103,2958,1145,2.583406114,1994,1505,997,500,0,500,0,132,0,0.06,empty,mBC-0716-1
"E8,D5",619365,680994,431440,249554,365908,0,209337,209623,179076,30547,5.862310538,115620,143976,99661,47037,15,47022,1,3256,0,0.001531198,mm10,mBC-0716-1
"E8,D6",12381,12935,9284,3651,6964,0,3314,3315,2317,998,2.321643287,1670,1077,712,396,0,396,0,116,0,0.055555556,empty,mBC-0716-1
"E8,D7",12995,13416,9835,3581,7335,0,3417,3423,2408,1015,2.372413793,1668,1332,852,474,0,474,0,151,0,0.044303797,empty,mBC-0716-1
"E8,D8",15648,16428,11763,4665,8797,0,4117,4128,2932,1196,2.451505017,2062,1010,598,327,0,327,0,104,0,0,empty,mBC-0716-1
"E8,D9",6234,6783,4654,2129,3796,0,1924,1925,1338,587,2.279386712,1029,1265,793,392,1,391,1,125,0,0.130434783,empty,mBC-0716-1
"E8,D10",15406,16130,11554,4576,8726,0,4211,4217,2998,1219,2.459392945,2117,788,516,254,1,253,1,92,0,0,empty,mBC-0716-1
"E8,D11",13503,14176,10220,3956,7511,0,3481,3487,2502,985,2.540101523,1726,9743,3074,1590,2,1588,1,308,0,0.030856423,empty,mBC-0716-1
"E8,D12",19342,20078,14846,5232,10570,0,4842,4859,3441,1418,2.426657264,2270,1651,1096,498,0,498,0,155,0,0.046184739,empty,mBC-0716-1
"E8,E1",21455,21978,16547,5431,11801,0,5204,5221,3761,1460,2.576027397,2523,1609,987,509,0,509,0,172,0,0.043222004,empty,mBC-0716-1
"E8,E2",16815,17287,12866,4421,9358,0,4345,4355,3153,1202,2.62312812,2104,2258,1191,626,0,626,0,157,0,0.012779553,empty,mBC-0716-1
"E8,E3",12086,12252,9381,2871,6453,0,2901,2907,2050,857,2.392065344,1291,6700,2770,1418,1,1417,1,275,0,0.085391673,empty,mBC-0716-1
"E8,E4",14655,15022,11124,3898,8058,0,3636,3648,2568,1080,2.377777778,1793,1699,955,488,0,488,0,148,0,0.047131148,empty,mBC-0716-1
"E8,E5",25230,26049,19640,6409,13765,1,6220,6232,4377,1855,2.359568733,2865,3301,1435,731,1,730,1,194,0,0.026027397,empty,mBC-0716-1
"E8,E6",13932,14374,10734,3640,7636,0,3547,3552,2509,1043,2.405560882,1666,1254,725,387,0,387,0,115,0,0.033591731,empty,mBC-0716-1
"E8,E7",101536,117249,73836,43413,63105,0,37579,37622,30340,7282,4.166437792,20960,6950,4844,2430,1,2429,1,366,0,0.012762454,empty,mBC-0716-1
"E8,E8",17005,17268,13154,4114,9212,0,4046,4051,2887,1164,2.48024055,1868,2245,1343,642,0,642,0,188,0,0.031152648,empty,mBC-0716-1
"E8,E9",9505,10000,7241,2759,5416,0,2556,2563,1792,771,2.324254215,1281,1068,711,350,0,350,0,96,0,0.077142857,empty,mBC-0716-1
"E8,E10",12557,13064,9383,3681,6991,0,3271,3279,2280,999,2.282282282,1638,29591,9356,4766,1,4765,1,708,0,0.06610703,empty,mBC-0716-1
"E8,E11",9726,10371,7347,3024,5532,0,2571,2578,1815,763,2.378768021,1276,1097,719,379,0,379,0,116,0,0.036939314,empty,mBC-0716-1
"E8,E12",15506,16135,11447,4688,8627,0,4124,4130,2895,1235,2.344129555,2075,4920,1926,904,1,903,1,184,0,0.069767442,empty,mBC-0716-1
"E8,F1",17315,17920,13322,4598,9444,0,4230,4242,3010,1232,2.443181818,2055,1244,722,377,0,377,0,109,0,0.029177719,empty,mBC-0716-1
"E8,F2",786766,892553,532605,359948,472890,0,292011,292389,234633,57756,4.062487014,167816,115664,80164,37754,16,37738,2,2885,0,0.001775399,mm10,mBC-0716-1
"E8,F3",17245,18122,12897,5225,9742,1,4744,4758,3370,1388,2.42795389,2383,1260,816,417,0,417,0,153,0,0.035971223,empty,mBC-0716-1
"E8,F4",18898,19295,14206,5089,10658,0,4980,4991,3646,1345,2.710780669,2447,516,313,176,0,176,0,81,0,0.068181818,empty,mBC-0716-1
"E8,F5",28548,29876,21838,8038,15753,0,7181,7198,5030,2168,2.320110701,3532,1741,1164,562,0,562,0,179,0,0.021352313,empty,mBC-0716-1
"E8,F6",24612,25331,18347,6984,13539,0,6302,6319,4487,1832,2.449235808,3088,20807,7033,3669,3,3666,1,600,0,0.123295145,empty,mBC-0716-1
"E8,F7",19280,19824,14623,5201,10661,0,4869,4879,3427,1452,2.360192837,2353,3348,1214,670,1,669,1,158,0,0.11509716,empty,mBC-0716-1
"E8,F8",679303,760576,473513,287063,408172,0,238674,239009,144245,94764,1.522149762,139716,1457,961,413,0,413,0,128,0,0,empty,mBC-0716-1
"E8,F9",1021348,1146240,687593,458647,600164,1,369857,370312,299265,71047,4.212211635,211078,232256,153855,72924,26,72898,5,4269,0,0.001111142,mm10,mBC-0716-1
"E8,F10",914097,991338,647753,343585,523102,2,302149,302531,208880,93651,2.230408645,163967,35372,22487,10836,8,10828,4,1360,0,0,mm10,mBC-0716-1
"E8,F11",12657,13116,9776,3340,7009,1,3185,3191,2396,795,3.013836478,1524,1197,713,337,0,337,0,101,0,0.035608309,empty,mBC-0716-1
"E8,F12",13064,13553,9879,3674,7122,0,3305,3310,2320,990,2.343434343,1556,127,77,44,0,44,0,17,0,0,empty,mBC-0716-1
"E8,G1",9648,9924,7451,2473,5245,0,2271,2279,1541,738,2.088075881,1120,2285,1371,695,2,693,1,166,0,0.04040404,empty,mBC-0716-1
"E8,G2",19321,19797,14706,5091,10371,0,4565,4579,3137,1442,2.175450763,2218,528,390,190,0,190,0,48,0,0.105263158,empty,mBC-0716-1
"E8,G3",19774,20652,15144,5508,10907,0,5026,5036,3507,1529,2.293655984,2471,2071,1425,692,0,692,0,178,0,0.018786127,empty,mBC-0716-1
"E8,G4",1154864,1296016,765507,530509,672931,1,428898,429427,339126,90301,3.755506584,245317,889,683,328,0,328,0,73,0,0,empty,mBC-0716-1
"E8,G5",530092,570652,390403,180249,305582,0,154963,155215,125413,29802,4.208207503,81937,117942,62695,30293,20,30273,5,2680,0,0.008059987,mm10,mBC-0716-1
"E8,G6",23511,24089,18119,5970,12874,0,5711,5732,4051,1681,2.409875074,2713,178,106,68,0,68,0,30,0,0,empty,mBC-0716-1
"E8,G7",811057,872116,602974,269142,463169,1,241087,241475,186259,55216,3.373279484,124447,65118,45419,22033,7,22026,2,2096,0,0.008308363,mm10,mBC-0716-1
"E8,G8",14342,15133,10899,4234,7932,0,3716,3728,2578,1150,2.24173913,1814,1577,943,500,1,499,1,138,0,0.102204409,empty,mBC-0716-1
"E8,G9",694141,791060,482466,308594,421397,0,254838,255143,166489,88654,1.877963769,147242,65348,45880,22112,8,22104,1,1940,0,0.001176258,mm10,mBC-0716-1
"E8,G10",13099,13477,9959,3518,7215,0,3403,3409,2443,966,2.528985507,1601,1352,867,492,0,492,0,158,0,0.052845528,empty,mBC-0716-1
"E8,G11",12210,12506,9341,3165,6728,0,3035,3046,2109,937,2.250800427,1483,759,524,275,0,275,0,103,0,0,empty,mBC-0716-1
"E8,G12",11515,11776,8714,3062,6375,0,2988,2993,2131,862,2.472157773,1415,1172,784,412,0,412,0,123,0,0.058252427,empty,mBC-0716-1
"E8,H1",1420672,1620231,970771,649460,852108,2,523115,523789,386351,137438,2.811093002,306080,70583,48589,22998,11,22987,2,2277,0,0.000478531,mm10,mBC-0716-1
"E8,H2",22812,23405,17495,5910,12343,0,5574,5584,3977,1607,2.47479776,2679,12656,4379,2215,2,2213,2,373,0,0.065070041,empty,mBC-0716-1
"E8,H3",20148,20913,15189,5724,11071,0,5157,5170,3691,1479,2.495605139,2470,1313,805,421,0,421,0,123,0,0.019002375,empty,mBC-0716-1
"E8,H4",13599,14270,10259,4011,7686,0,3640,3651,2633,1018,2.586444008,1798,113,82,49,0,49,0,26,0,0,empty,mBC-0716-1
"E8,H5",19603,20020,14421,5599,10439,0,5020,5029,3626,1403,2.584461867,2447,17039,6319,3227,5,3222,2,431,0,0.26443203,empty,mBC-0716-1
"E8,H6",15674,16612,11958,4654,9064,0,4343,4350,3148,1202,2.618968386,2182,1441,950,465,0,465,0,131,0,0.066666667,empty,mBC-0716-1
"E8,H7",18567,19187,13924,5263,10310,0,4825,4831,3462,1369,2.528853178,2432,1414,920,467,0,467,0,166,0,0.012847966,empty,mBC-0716-1
"E8,H8",14086,14500,10712,3788,7746,0,3612,3616,2562,1054,2.430740038,1762,18721,5859,2906,1,2905,1,491,0,0.032013769,empty,mBC-0716-1
"E8,H9",16371,16969,12401,4568,9129,0,4314,4317,3112,1205,2.582572614,2080,1129,602,345,1,344,1,123,0,0.01744186,empty,mBC-0716-1
"E8,H10",16163,17030,12019,5011,9087,2,4495,4514,3259,1255,2.596812749,2270,11717,3853,1914,4,1910,1,356,0,0.02513089,empty,mBC-0716-1
"E8,H11",17796,18880,13448,5432,10053,0,4767,4774,3411,1363,2.502567865,2410,150,106,64,0,64,0,38,0,0.015625,empty,mBC-0716-1
"E8,H12",6406,6796,4799,1997,3707,0,1753,1759,1280,479,2.67223382,932,754,471,256,0,256,0,66,0,0.0546875,empty,mBC-0716-1
"E9,A1",14198,14714,10534,4180,8000,1,3866,3876,2705,1171,2.30999146,1948,923,653,309,0,309,0,99,0,0.009708738,empty,mBC-0716-1
"E9,A2",19135,19380,14448,4932,10142,0,4556,4562,3226,1336,2.414670659,2166,6324,2472,1336,2,1334,1,198,0,0.313343328,empty,mBC-0716-1
"E9,A3",16086,16623,12109,4514,8744,0,4029,4037,2765,1272,2.173742138,1961,776,503,279,0,279,0,79,0,0.025089606,empty,mBC-0716-1
"E9,A4",950286,1033846,689814,344032,538587,0,296544,296964,224174,72790,3.079736228,158026,24457,15258,7385,6,7379,2,1040,0,0.003387993,mm10,mBC-0716-1
"E9,A5",16265,16567,12388,4179,8916,0,4117,4124,2936,1188,2.471380471,1922,1080,652,342,1,341,1,110,0,0.085043988,empty,mBC-0716-1
"E9,A6",13038,13380,9884,3496,7053,0,3301,3307,2302,1005,2.290547264,1577,5827,1948,1003,4,999,2,206,0,0.007007007,empty,mBC-0716-1
"E9,A7",644384,694619,476425,218194,368915,1,187500,187794,150233,37561,3.999707143,97971,62567,43423,21078,10,21068,1,1984,0,0.003322575,mm10,mBC-0716-1
"E9,A8",10741,10899,8233,2666,5890,0,2693,2699,1907,792,2.407828283,1231,871,549,334,0,334,0,115,0,0.125748503,empty,mBC-0716-1
"E9,A9",20616,20822,15418,5404,10620,1,4800,4813,3389,1424,2.37991573,2312,19032,6266,3122,5,3117,1,500,0,0.099133782,empty,mBC-0716-1
"E9,A10",15649,15875,11893,3982,8258,0,3680,3687,2591,1096,2.364051095,1679,1942,813,411,0,411,0,87,0,0.063260341,empty,mBC-0716-1
"E9,A11",17862,18099,13629,4470,9557,0,4241,4248,2932,1316,2.227963526,1993,890,574,255,0,255,0,80,0,0,empty,mBC-0716-1
"E9,A12",20624,20835,16057,4778,10821,0,4677,4694,3240,1454,2.228335626,2091,1767,1164,569,0,569,0,134,0,0.050966608,empty,mBC-0716-1
"E9,B1",19059,19699,14358,5341,10332,0,4708,4717,3243,1474,2.200135685,2349,2582,1071,564,0,564,0,135,0,0.086879433,empty,mBC-0716-1
"E9,B2",20142,20407,15431,4976,10674,0,4679,4691,3247,1444,2.248614958,2216,307,170,103,0,103,0,44,0,0,empty,mBC-0716-1
"E9,B3",1018641,1111198,717722,393476,576946,0,330959,331475,271834,59641,4.557837729,180437,54987,38102,18512,8,18504,2,1885,0,0.001783398,mm10,mBC-0716-1
"E9,B4",16698,16784,12899,3885,8955,0,3970,3976,2826,1150,2.457391304,1793,986,531,307,0,307,0,91,0,0.078175896,empty,mBC-0716-1
"E9,B5",1514558,921302,626848,294454,613294,21,319521,321419,253153,68266,3.708332113,177681,71003,41401,19740,4,19736,1,2210,0,0.008563032,mm10,mBC-0716-1
"E9,B6",12034,12297,9128,3169,6523,0,3029,3037,2141,896,2.389508929,1445,719,474,261,0,261,0,87,0,0.099616858,empty,mBC-0716-1
"E9,B7",16555,17038,12784,4254,8944,0,3976,3980,2739,1241,2.207091056,1867,495,286,156,0,156,0,62,0,0.019230769,empty,mBC-0716-1
"E9,B8",13523,13515,10237,3278,7194,0,3198,3206,2214,992,2.231854839,1474,12554,4309,2256,3,2253,2,379,0,0.102086107,empty,mBC-0716-1
"E9,B9",15129,15416,11659,3757,8074,0,3583,3588,2497,1091,2.28872594,1736,388,228,129,0,129,0,42,0,0.046511628,empty,mBC-0716-1
"E9,B10",16009,15694,11481,4213,8704,0,3987,4008,2694,1314,2.050228311,1977,353,185,114,0,114,0,40,0,0,empty,mBC-0716-1
"E9,B11",17648,18735,13354,5381,9979,0,4694,4704,3303,1401,2.357601713,2459,111,80,42,0,42,0,25,0,0,empty,mBC-0716-1
"E9,B12",17615,17843,13569,4274,9615,0,4379,4384,3046,1338,2.276532138,1996,944,562,267,0,267,0,78,0,0.003745318,empty,mBC-0716-1
"E9,C1",1222509,1265393,932844,332549,641244,1,292619,293254,247332,45922,5.385915248,143367,67810,43441,20825,19,20806,3,2098,0,0.004133423,mm10,mBC-0716-1
"E9,C2",19209,19659,14483,5176,10308,0,4808,4813,3306,1507,2.193762442,2305,1550,995,503,0,503,0,139,0,0.043737575,empty,mBC-0716-1
"E9,C3",1802055,1940486,1304230,636256,994777,4,545471,546280,435210,111070,3.918339786,290227,50808,30281,14547,3,14544,1,1723,0,0.005775578,mm10,mBC-0716-1
"E9,C4",17929,17854,13341,4513,9314,0,4129,4138,2904,1234,2.353322528,1942,27323,9101,4679,4,4675,3,600,0,0.217326203,empty,mBC-0716-1
"E9,C5",16256,16618,12356,4262,8816,0,3940,3949,2782,1167,2.383890317,1902,580,335,182,0,182,0,63,0,0.065934066,empty,mBC-0716-1
"E9,C6",1484753,1663317,1016243,647074,900496,1,555502,556235,438045,118190,3.706278027,315761,109306,69916,33438,11,33427,3,2865,0,0.007179825,mm10,mBC-0716-1
"E9,C7",16794,17352,12697,4655,9117,0,4231,4243,2996,1247,2.402566159,2044,303,231,140,0,140,0,44,0,0,empty,mBC-0716-1
"E9,C8",574262,565925,433416,132509,305159,0,132743,133004,93498,39506,2.366678479,64038,19396,8882,4299,5,4294,2,801,0,0.030973451,mm10,mBC-0716-1
"E9,C9",13244,13758,9952,3806,7159,0,3330,3335,2337,998,2.341683367,1608,1059,528,270,0,270,0,60,0,0.040740741,empty,mBC-0716-1
"E9,C10",13563,13747,10476,3271,7287,0,3211,3217,2230,987,2.259371834,1492,614,397,201,0,201,0,72,0,0.054726368,empty,mBC-0716-1
"E9,C11",436376,445312,323760,121552,241655,0,116900,117117,89717,27400,3.274343066,58987,4163,2996,1431,0,1431,0,334,0,0.00698812,mm10,mBC-0716-1
"E9,C12",19784,20022,14896,5126,10629,0,4839,4852,3317,1535,2.160912052,2286,911,543,283,0,283,0,86,0,0.035335689,empty,mBC-0716-1
"E9,D1",11102,11621,8391,3230,6102,0,2880,2887,1986,901,2.204217536,1426,595,320,179,0,179,0,65,0,0,empty,mBC-0716-1
"E9,D2",20752,21158,16138,5020,11018,0,4777,4787,3344,1443,2.317394317,2178,1945,1278,640,1,639,1,171,0,0.073552426,empty,mBC-0716-1
"E9,D3",407577,419809,307615,112194,228406,1,106280,106480,70216,36264,1.936245312,53986,18571,7101,3373,4,3369,2,623,0,0.016622143,mm10,mBC-0716-1
"E9,D4",14000,14188,10734,3454,7474,0,3314,3324,2283,1041,2.193083573,1534,1015,685,338,0,338,0,112,0,0.103550296,empty,mBC-0716-1
"E9,D5",13870,14557,10576,3981,7594,0,3475,3482,2413,1069,2.257249766,1729,671,426,227,0,227,0,86,0,0.070484581,empty,mBC-0716-1
"E9,D6",11989,12158,9023,3135,6590,0,3095,3102,2122,980,2.165306122,1493,693,455,258,0,258,0,93,0,0.131782946,empty,mBC-0716-1
"E9,D7",851079,920600,607684,312916,482101,1,265239,265690,206882,58808,3.517922732,142872,90130,63277,30023,16,30007,1,2650,0,0.001266371,mm10,mBC-0716-1
"E9,D8",15926,16487,12097,4390,8773,0,4000,4001,2843,1158,2.455094991,1963,680,446,236,0,236,0,89,0,0.06779661,empty,mBC-0716-1
"E9,D9",4593,4792,3369,1423,2647,0,1273,1275,877,398,2.203517588,675,1186,794,431,0,431,0,115,0,0.060324826,empty,mBC-0716-1
"E9,D10",629948,723321,434806,288515,388734,1,238391,238697,164225,74472,2.205191213,138095,25685,14534,6908,5,6903,2,1026,0,0.013472403,mm10,mBC-0716-1
"E9,D11",674874,722621,489996,232625,383154,2,200676,200978,161641,39337,4.109133894,106584,85325,60610,28275,9,28266,1,2444,0,0.000742942,mm10,mBC-0716-1
"E9,D12",20026,20386,15184,5202,10745,0,4789,4800,3390,1410,2.404255319,2226,1342,883,468,0,468,0,154,0,0.066239316,empty,mBC-0716-1
"E9,E1",20992,21537,16038,5499,11436,0,5062,5073,3514,1559,2.25400898,2479,1316,917,456,0,456,0,144,0,0.041666667,empty,mBC-0716-1
"E9,E2",16164,16740,12187,4553,8807,2,4049,4070,2900,1170,2.478632479,1995,1094,633,349,1,348,1,111,0,0.037356322,empty,mBC-0716-1
"E9,E3",675394,746580,463464,283116,396748,1,242106,242449,192074,50375,3.812883375,135119,22371,14957,7388,4,7384,1,1063,0,0.005823402,mm10,mBC-0716-1
"E9,E4",15961,15780,11937,3843,8352,0,3696,3698,2599,1099,2.364877161,1730,1206,727,395,1,394,1,126,0,0.149746193,empty,mBC-0716-1
"E9,E5",20547,21105,15893,5212,11026,0,4811,4825,3410,1415,2.409893993,2223,2105,893,462,1,461,1,114,0,0.130151844,empty,mBC-0716-1
"E9,E6",13251,13645,10028,3617,7195,0,3263,3271,2266,1005,2.254726368,1609,936,567,316,0,316,0,89,0,0.050632911,empty,mBC-0716-1
"E9,E7",13841,14045,10476,3569,7326,0,3231,3236,2219,1017,2.181907571,1550,713,450,240,0,240,0,71,0,0.008333333,empty,mBC-0716-1
"E9,E8",17651,17696,13560,4136,9318,0,4069,4073,2843,1230,2.311382114,1783,1379,825,453,1,452,1,135,0,0.07079646,empty,mBC-0716-1
"E9,E9",9009,9315,6675,2640,4919,0,2389,2389,1673,716,2.336592179,1152,5385,1977,1021,2,1019,1,197,0,0.030421982,empty,mBC-0716-1
"E9,E10",12971,13561,9916,3645,7131,1,3296,3302,2261,1041,2.171950048,1603,824,522,275,0,275,0,85,0,0.003636364,empty,mBC-0716-1
"E9,E11",599156,702796,380651,322145,376994,0,251417,251704,196181,55523,3.533328531,152628,2880,1476,711,0,711,0,270,0,0.019690577,empty,mBC-0716-1
"E9,E12",14757,15181,11131,4050,8110,0,3783,3796,2604,1192,2.184563758,1808,769,504,261,0,261,0,78,0,0.091954023,empty,mBC-0716-1
"E9,F1",18198,18880,13882,4998,9811,0,4479,4488,3081,1407,2.189765458,2205,1143,688,351,1,350,1,92,0,0.091428571,empty,mBC-0716-1
"E9,F2",23966,24760,17915,6845,12942,0,5956,5974,4203,1771,2.37323546,2936,6722,2495,1344,1,1343,1,292,0,0.046909903,empty,mBC-0716-1
"E9,F3",646155,709334,470471,238863,378496,0,203666,203962,150624,53338,2.823952904,111227,82979,57922,28162,15,28147,2,2504,0,0.001207944,mm10,mBC-0716-1
"E9,F4",16662,16874,12580,4294,9131,0,4167,4178,2947,1231,2.393988627,2018,635,355,193,0,193,0,78,0,0.025906736,empty,mBC-0716-1
"E9,F5",1011667,1157206,667987,489219,605613,0,391069,391563,298425,93138,3.204116472,229290,59508,36493,17572,9,17563,1,1961,0,0.012811023,mm10,mBC-0716-1
"E9,F6",23222,23990,17643,6347,12734,0,5857,5868,4115,1753,2.34740445,2889,1441,960,494,0,494,0,131,0,0.103238866,empty,mBC-0716-1
"E9,F7",19358,20236,14888,5348,10720,0,4792,4799,3356,1443,2.325710326,2263,1731,554,296,0,296,0,93,0,0.091216216,empty,mBC-0716-1
"E9,F8",23313,23376,17425,5951,12453,0,5750,5753,4015,1738,2.310126582,2748,715,336,169,0,169,0,43,0,0.213017751,empty,mBC-0716-1
"E9,F9",15304,15741,11673,4068,8378,0,3775,3790,2669,1121,2.380909902,1822,1325,871,456,0,456,0,159,0,0.035087719,empty,mBC-0716-1
"E9,F10",22160,22287,16763,5524,11484,0,5095,5104,3617,1487,2.432414257,2368,23003,7636,3865,3,3862,1,528,0,0.15717245,empty,mBC-0716-1
"E9,F11",11303,11591,8557,3034,6069,0,2698,2703,1850,853,2.168815944,1313,549,322,157,0,157,0,69,0,0.038216561,empty,mBC-0716-1
"E9,F12",13900,13999,10415,3584,7390,0,3392,3398,2442,956,2.554393305,1567,133,69,40,0,40,0,16,0,0,empty,mBC-0716-1
"E9,G1",10236,10412,7833,2579,5607,0,2541,2545,1687,858,1.966200466,1183,2517,1362,660,0,660,0,153,0,0.086363636,empty,mBC-0716-1
"E9,G2",20657,20936,15920,5016,10893,0,4783,4790,3322,1468,2.262942779,2183,546,278,122,0,122,0,48,0,0.057377049,empty,mBC-0716-1
"E9,G3",1533716,1691319,1053258,638061,880125,2,532297,533126,417579,115547,3.613931993,295378,111670,76846,36884,13,36871,2,3070,0,0.002874888,mm10,mBC-0716-1
"E9,G4",28004,27857,21575,6282,14734,0,6316,6331,4480,1851,2.420313344,2874,108,34,28,0,28,0,19,0,0,empty,mBC-0716-1
"E9,G5",665331,752845,466288,286557,400220,1,233882,234170,182972,51198,3.573811477,133371,53915,38391,18429,4,18425,1,1921,0,0.002279512,mm10,mBC-0716-1
"E9,G6",24561,24911,18954,5957,12968,0,5686,5702,4007,1695,2.364011799,2627,172,107,66,0,66,0,33,0,0.075757576,empty,mBC-0716-1
"E9,G7",20771,20741,16021,4720,10928,0,4683,4689,3333,1356,2.457964602,2103,1291,720,388,0,388,0,113,0,0.018041237,empty,mBC-0716-1
"E9,G8",13696,14132,10403,3729,7656,0,3536,3543,2478,1065,2.326760563,1697,1038,709,389,0,389,0,116,0,0.087403599,empty,mBC-0716-1
"E9,G9",10636,10855,8096,2759,5679,0,2547,2556,1785,771,2.315175097,1208,777,520,278,0,278,0,103,0,0.089928058,empty,mBC-0716-1
"E9,G10",13778,14106,10638,3468,7395,0,3312,3322,2364,958,2.467640919,1493,1777,738,395,1,394,1,115,0,0.010152284,empty,mBC-0716-1
"E9,G11",12153,12384,9293,3091,6630,0,2935,2944,2003,941,2.12858661,1392,468,323,183,0,183,0,76,0,0.005464481,empty,mBC-0716-1
"E9,G12",11341,11468,8725,2743,6222,0,2810,2815,1974,841,2.347205707,1274,1212,665,331,0,331,0,80,0,0.075528701,empty,mBC-0716-1
"E9,H1",736002,810531,520747,289784,430405,0,244194,244533,195312,49221,3.968062412,134910,35605,22818,10593,8,10585,3,1363,0,0.005384979,mm10,mBC-0716-1
"E9,H2",23999,24661,18342,6319,12779,0,5695,5699,4025,1674,2.40442055,2703,3078,1409,658,1,657,1,169,0,0.076103501,empty,mBC-0716-1
"E9,H3",19603,20114,14833,5281,10645,1,4831,4848,3416,1432,2.38547486,2365,1186,840,406,0,406,0,110,0,0.009852217,empty,mBC-0716-1
"E9,H4",14785,15079,11172,3907,8026,0,3634,3636,2533,1103,2.296464189,1772,90,60,42,0,42,0,13,0,0,empty,mBC-0716-1
"E9,H5",18445,18874,13925,4949,9996,0,4596,4616,3256,1360,2.394117647,2223,963,621,313,0,313,0,104,0,0.015974441,empty,mBC-0716-1
"E9,H6",13962,14214,10523,3691,7593,0,3571,3576,2527,1049,2.408960915,1717,983,628,325,0,325,0,126,0,0.036923077,empty,mBC-0716-1
"E9,H7",17166,17238,12816,4422,9250,0,4173,4181,2940,1241,2.369057212,1988,773,535,282,0,282,0,114,0,0.024822695,empty,mBC-0716-1
"E9,H8",13317,13763,9835,3928,7330,1,3478,3492,2456,1036,2.370656371,1742,1212,729,373,0,373,0,107,0,0.053619303,empty,mBC-0716-1
"E9,H9",16009,16347,12340,4007,8609,0,3904,3916,2807,1109,2.531109107,1820,613,387,215,0,215,0,75,0,0.037209302,empty,mBC-0716-1
"E9,H10",14160,14533,10738,3795,7796,0,3551,3564,2414,1150,2.099130435,1665,998,646,354,1,353,1,98,0,0.050991501,empty,mBC-0716-1
"E9,H11",18299,18840,13457,5383,9749,0,4627,4636,3318,1318,2.517450683,2298,1866,648,321,0,321,0,72,0,0.07788162,empty,mBC-0716-1
"E9,H12",5908,6209,4472,1737,3361,0,1562,1569,1108,461,2.403470716,757,297,173,108,0,108,0,46,0,0.092592593,empty,mBC-0716-1
"E10,A1",13208,13749,9945,3804,7576,0,3564,3582,2551,1031,2.474296799,1820,1291,755,379,0,379,0,134,0,0.044854881,empty,mBC-0716-1
"E10,A2",2121793,2219697,1570964,648733,1136696,3,596556,597496,439425,158071,2.779921681,302874,116213,81525,39154,18,39136,1,3184,0,0.001839738,mm10,mBC-0716-1
"E10,A3",15137,15569,11477,4092,8252,0,3893,3896,2713,1183,2.293322063,1851,1084,663,336,1,335,1,103,0,0.056716418,empty,mBC-0716-1
"E10,A4",19809,19665,15233,4432,10460,0,4477,4499,3175,1324,2.398036254,1978,3112,1210,668,1,667,1,147,0,0.101949025,empty,mBC-0716-1
"E10,A5",651418,678094,496862,181232,360007,0,163487,163797,138986,24811,5.601789529,80129,132535,93018,44229,13,44216,1,3030,0,0.001017731,mm10,mBC-0716-1
"E10,A6",11982,12554,8923,3631,6732,0,3258,3266,2202,1064,2.069548872,1589,1729,1096,596,0,596,0,181,0,0.010067114,empty,mBC-0716-1
"E10,A7",14560,14974,11167,3807,8059,0,3654,3662,2537,1125,2.255111111,1767,1564,1005,519,0,519,0,168,0,0.046242775,empty,mBC-0716-1
"E10,A8",10289,10809,7664,3145,5813,0,2747,2752,1936,816,2.37254902,1398,2030,1226,625,0,625,0,207,0,0.0896,empty,mBC-0716-1
"E10,A9",16546,16822,12807,4015,8934,0,3806,3817,2732,1085,2.51797235,1790,1656,1111,590,0,590,0,146,0,0.027118644,empty,mBC-0716-1
"E10,A10",13997,14525,10758,3767,7734,0,3507,3516,2472,1044,2.367816092,1635,482,312,153,0,153,0,69,0,0.032679739,empty,mBC-0716-1
"E10,A11",16042,16285,12114,4171,8875,0,3958,3965,2781,1184,2.348817568,1910,1233,782,435,0,435,0,140,0,0.108045977,empty,mBC-0716-1
"E10,A12",633508,666333,477230,189103,351845,1,167612,167921,129129,38792,3.328753351,84380,233067,168989,80512,25,80487,2,4418,0,0.000795159,mm10,mBC-0716-1
"E10,B1",16995,17404,13080,4324,9318,0,4184,4196,2924,1272,2.298742138,2008,1659,1040,545,0,545,0,155,0,0.067889908,empty,mBC-0716-1
"E10,B2",18083,18675,13736,4939,9810,0,4409,4419,3011,1408,2.138494318,2094,594,356,200,0,200,0,69,0,0.08,empty,mBC-0716-1
"E10,B3",16673,17180,12864,4316,9356,0,4250,4258,3015,1243,2.425583266,2004,1134,654,362,0,362,0,138,0,0.016574586,empty,mBC-0716-1
"E10,B4",15569,16036,12044,3992,8356,0,3724,3738,2649,1089,2.432506887,1747,1584,876,461,0,461,0,177,0,0.043383948,empty,mBC-0716-1
"E10,B5",8366,5220,3684,1536,3562,0,1757,1766,1233,533,2.313320826,938,903,535,277,0,277,0,101,0,0.014440433,empty,mBC-0716-1
"E10,B6",11020,11432,8247,3185,6054,0,2816,2819,1990,829,2.400482509,1387,5882,2213,1054,4,1050,1,231,0,0.015238095,empty,mBC-0716-1
"E10,B7",14738,15175,11342,3833,8075,0,3637,3647,2581,1066,2.42120075,1663,1160,667,351,0,351,0,115,0,0.056980057,empty,mBC-0716-1
"E10,B8",11833,12388,9023,3365,6582,0,3044,3046,2138,908,2.354625551,1489,1220,699,398,0,398,0,140,0,0.030150754,empty,mBC-0716-1
"E10,B9",637523,711067,444572,266495,377099,0,221591,221889,148366,73523,2.017953566,126206,21668,14030,6551,5,6546,1,942,0,0.005499542,mm10,mBC-0716-1
"E10,B10",15214,14852,10741,4111,8284,0,3832,3854,2648,1206,2.195688226,1892,651,402,218,0,218,0,66,0,0.004587156,empty,mBC-0716-1
"E10,B11",15297,15617,11691,3926,8262,0,3854,3863,2712,1151,2.35621199,1770,230,149,87,0,87,0,49,0,0.034482759,empty,mBC-0716-1
"E10,B12",16029,16675,12168,4507,8972,0,4127,4134,2837,1297,2.187355436,2007,1516,882,447,1,446,1,144,0,0.062780269,empty,mBC-0716-1
"E10,C1",20271,20125,15620,4505,10501,4,4490,4499,3169,1330,2.382706767,1974,977,517,276,0,276,0,120,0,0.101449275,empty,mBC-0716-1
"E10,C2",480289,504286,356887,147399,272408,2,135572,135781,100978,34803,2.901416545,69301,78476,34365,16439,13,16426,5,1955,0,0.014550103,mm10,mBC-0716-1
"E10,C3",18178,18789,13656,5133,9831,0,4491,4497,3132,1365,2.294505495,2209,5412,1964,976,1,975,1,198,0,0.048205128,empty,mBC-0716-1
"E10,C4",16520,16623,12605,4018,8959,1,3983,3991,2860,1131,2.528735632,1895,15045,4523,2234,2,2232,2,417,0,0.04390681,empty,mBC-0716-1
"E10,C5",15335,15594,11623,3971,8210,0,3681,3686,2573,1113,2.311769991,1763,13889,4055,2098,7,2091,3,312,0,0.162601626,empty,mBC-0716-1
"E10,C6",585745,626327,424995,201332,344529,3,180867,181137,142613,38524,3.701926072,95481,100065,64063,30725,13,30712,2,2562,0,0.0046236,mm10,mBC-0716-1
"E10,C7",14728,15095,11110,3985,8169,0,3805,3819,2727,1092,2.497252747,1860,493,334,163,0,163,0,60,0,0,empty,mBC-0716-1
"E10,C8",13455,13990,10178,3812,7529,0,3464,3473,2410,1063,2.267168391,1699,1650,1034,568,0,568,0,186,0,0.052816901,empty,mBC-0716-1
"E10,C9",11400,11716,8563,3153,6231,0,2933,2940,2065,875,2.36,1444,972,700,347,0,347,0,105,0,0.040345821,empty,mBC-0716-1
"E10,C10",12620,13118,9689,3429,6916,0,3162,3173,2244,929,2.415500538,1513,1236,763,383,0,383,0,111,0,0.096605744,empty,mBC-0716-1
"E10,C11",10791,11231,8214,3017,6020,0,2824,2832,2001,831,2.407942238,1371,1340,883,465,0,465,0,126,0,0.047311828,empty,mBC-0716-1
"E10,C12",18073,18572,13659,4913,9817,0,4465,4478,3202,1276,2.509404389,2164,1322,864,443,0,443,0,131,0,0.085778781,empty,mBC-0716-1
"E10,D1",10394,10871,7902,2969,5963,0,2875,2877,2063,814,2.534398034,1409,3403,1151,574,1,573,1,125,0,0.055846422,empty,mBC-0716-1
"E10,D2",19484,19679,15039,4640,10509,0,4573,4589,3136,1453,2.158293187,2150,2853,1809,875,0,875,0,228,0,0.045714286,empty,mBC-0716-1
"E10,D3",415874,429723,308914,120809,233924,0,111441,111644,83584,28060,2.9787598,56620,28381,17704,8603,2,8601,1,1181,0,0.008022323,mm10,mBC-0716-1
"E10,D4",798905,861182,584687,276495,452666,0,238179,238593,197532,41061,4.810696281,124803,156455,109717,51204,26,51178,3,3406,0,0.002657392,mm10,mBC-0716-1
"E10,D5",13129,13803,10018,3785,7442,0,3508,3511,2445,1066,2.293621013,1736,1346,825,409,1,408,1,161,0,0.044117647,empty,mBC-0716-1
"E10,D6",11436,11521,8551,2970,6184,0,2921,2928,2071,857,2.416569428,1344,20856,6844,3525,0,3525,0,598,0,0.048510638,empty,mBC-0716-1
"E10,D7",12439,12826,9348,3478,6874,0,3240,3247,2349,898,2.615812918,1627,1693,1078,555,0,555,0,203,0,0.01981982,empty,mBC-0716-1
"E10,D8",569542,630537,405461,225076,339535,0,189950,190201,151050,39151,3.858139,104823,60940,43466,20345,12,20333,1,1973,0,0.0026066,mm10,mBC-0716-1
"E10,D9",4894,4941,3669,1272,2841,0,1376,1383,977,406,2.406403941,670,1438,789,428,0,428,0,149,0,0.023364486,empty,mBC-0716-1
"E10,D10",14636,15278,11084,4194,8235,0,3964,3974,2868,1106,2.593128391,1933,1074,720,394,1,393,1,115,0,0.081424936,empty,mBC-0716-1
"E10,D11",12423,12728,9230,3498,6702,0,3104,3121,2183,938,2.327292111,1542,1812,1156,612,0,612,0,193,0,0.055555556,empty,mBC-0716-1
"E10,D12",769372,847386,544168,303218,448978,0,257791,258172,203475,54697,3.72003949,141542,100031,66072,31149,19,31130,4,2626,0,0.001959525,mm10,mBC-0716-1
"E10,E1",20753,21364,15924,5440,11055,0,4829,4845,3421,1424,2.40238764,2274,24377,7926,4004,2,4002,2,661,0,0.047226387,empty,mBC-0716-1
"E10,E2",15026,15108,11414,3694,8280,0,3692,3703,2607,1096,2.378649635,1761,2086,1299,659,0,659,0,180,0,0.069802731,empty,mBC-0716-1
"E10,E3",641919,731520,419946,311574,390696,1,256262,256572,192634,63938,3.012824924,150880,21669,11044,5330,1,5329,1,971,0,0.081253518,mm10,mBC-0716-1
"E10,E4",13498,13879,10214,3665,7308,0,3294,3308,2342,966,2.424430642,1591,1735,1109,552,0,552,0,165,0,0.048913043,empty,mBC-0716-1
"E10,E5",19446,19467,14961,4506,10269,0,4377,4391,3151,1240,2.541129032,1965,1884,1224,625,2,623,2,190,0,0.025682183,empty,mBC-0716-1
"E10,E6",12426,12752,9528,3224,6773,0,3051,3062,2092,970,2.156701031,1458,1643,1049,469,0,469,0,142,0,0.031982942,empty,mBC-0716-1
"E10,E7",12824,12787,9870,2917,6844,0,3045,3053,2068,985,2.099492386,1389,1685,918,452,0,452,0,135,0,0.075221239,empty,mBC-0716-1
"E10,E8",15890,16043,12164,3879,8540,0,3739,3747,2598,1149,2.261096606,1712,2557,1551,821,1,820,1,217,0,0.046341463,empty,mBC-0716-1
"E10,E9",781816,864449,554290,310159,463025,0,262586,262948,207697,55251,3.75915368,144734,249338,173962,83030,40,82990,6,4613,0,0.002229184,mm10,mBC-0716-1
"E10,E10",11849,12448,8911,3537,6630,0,3165,3172,2094,1078,1.942486085,1586,4826,1903,1012,0,1012,0,246,0,0.052371542,empty,mBC-0716-1
"E10,E11",8524,8984,6465,2519,4851,0,2243,2248,1589,659,2.411229135,1130,1436,958,470,0,470,0,148,0,0.042553191,empty,mBC-0716-1
"E10,E12",13659,14331,10395,3936,7735,0,3573,3584,2453,1131,2.1688771,1756,1509,891,499,1,498,1,166,0,0.044176707,empty,mBC-0716-1
"E10,F1",16082,16398,12242,4156,8669,0,3893,3903,2698,1205,2.239004149,1801,1688,1151,571,0,571,0,146,0,0.126094571,empty,mBC-0716-1
"E10,F2",20551,21327,15629,5698,11302,0,5225,5243,3667,1576,2.32677665,2552,2748,1732,870,0,870,0,277,0,0.054022989,empty,mBC-0716-1
"E10,F3",14921,15760,11182,4578,8379,0,4025,4031,2858,1173,2.436487639,1973,1671,1104,570,0,570,0,216,0,0.01754386,empty,mBC-0716-1
"E10,F4",16393,16917,12431,4486,9237,0,4308,4325,3113,1212,2.568481848,2059,9406,2794,1446,0,1446,0,313,0,0.034578147,empty,mBC-0716-1
"E10,F5",814334,862438,596307,266131,454132,3,237867,238272,191086,47186,4.049633366,122476,109214,77732,36327,10,36317,2,2792,0,0.000908665,mm10,mBC-0716-1
"E10,F6",21864,22325,16560,5765,11827,0,5422,5433,3813,1620,2.353703704,2563,8716,3597,1820,2,1818,1,341,0,0.166666667,empty,mBC-0716-1
"E10,F7",17917,18203,13622,4581,10039,0,4418,4427,3040,1387,2.191780822,2092,951,539,301,0,301,0,135,0,0.049833887,empty,mBC-0716-1
"E10,F8",23419,23722,17577,6145,12748,0,5886,5892,4213,1679,2.509231686,2772,512,243,136,0,136,0,66,0,0.007352941,empty,mBC-0716-1
"E10,F9",14115,14433,10868,3565,7820,0,3455,3466,2391,1075,2.224186047,1638,2095,1367,778,0,778,0,262,0,0.061696658,empty,mBC-0716-1
"E10,F10",807679,878370,585309,293061,463417,3,250070,250481,195246,55235,3.534823934,133361,118329,81300,38049,13,38036,3,2966,0,0.001288253,mm10,mBC-0716-1
"E10,F11",10253,10277,7846,2431,5492,0,2372,2376,1682,694,2.423631124,1084,1346,949,466,1,465,1,146,0,0.040860215,empty,mBC-0716-1
"E10,F12",12909,13239,9847,3392,6989,0,3106,3118,2179,939,2.320553781,1504,143,99,64,0,64,0,26,0,0,empty,mBC-0716-1
"E10,G1",9318,9491,7318,2173,5040,0,2174,2180,1516,664,2.28313253,983,2040,1419,738,0,738,0,191,0,0.020325203,empty,mBC-0716-1
"E10,G2",18499,18654,14336,4318,9891,0,4367,4375,3054,1321,2.311884936,2017,547,289,152,0,152,0,64,0,0,empty,mBC-0716-1
"E10,G3",674133,743539,481101,262438,392374,0,213561,213900,184746,29154,6.336900597,116615,220436,155084,72696,21,72675,1,4172,0,0.001609907,mm10,mBC-0716-1
"E10,G4",25915,26315,19718,6597,13922,1,6091,6108,4291,1817,2.36158503,2914,147,56,35,0,35,0,24,0,0,empty,mBC-0716-1
"E10,G5",12756,12843,9260,3583,6748,0,3176,3187,2172,1015,2.139901478,1570,37505,12694,6402,4,6398,1,860,0,0.160675211,empty,mBC-0716-1
"E10,G6",21912,22361,17016,5345,11794,0,5159,5182,3648,1534,2.37809648,2363,466,233,116,0,116,0,53,0,0.00862069,empty,mBC-0716-1
"E10,G7",18394,18519,14167,4352,9815,0,4357,4369,3148,1221,2.578214578,1977,5672,2490,1304,0,1304,0,328,0,0.080521472,empty,mBC-0716-1
"E10,G8",1540285,1672321,1097523,574798,862971,4,489110,489791,396793,92998,4.266683154,265272,217912,153823,73373,32,73341,7,4281,0,0.001418034,mm10,mBC-0716-1
"E10,G9",10056,10646,7683,2963,5621,0,2582,2582,1847,735,2.51292517,1296,4399,1667,873,0,873,0,227,0,0.081328751,empty,mBC-0716-1
"E10,G10",657222,719068,474973,244095,384794,1,212305,212607,165569,47038,3.519898805,113954,144282,90162,43308,19,43289,4,3026,0,0.002656564,mm10,mBC-0716-1
"E10,G11",11019,11180,8541,2639,6011,0,2683,2690,1876,814,2.304668305,1233,1009,658,361,0,361,0,123,0,0.011080332,empty,mBC-0716-1
"E10,G12",1049292,1105081,756835,348246,595897,2,318790,319287,258763,60524,4.275378362,166891,67192,44669,20887,5,20882,2,2248,0,0.011014271,mm10,mBC-0716-1
"E10,H1",1636761,1804799,1154705,650094,936747,2,545228,545990,446529,99461,4.489488342,299117,180006,124759,59066,14,59052,4,3721,0,0.002167581,mm10,mBC-0716-1
"E10,H2",23538,24159,17993,6166,12648,0,5653,5664,4144,1520,2.726315789,2659,4302,2183,1089,1,1088,1,272,0,0.061580882,empty,mBC-0716-1
"E10,H3",18927,19145,14221,4924,10200,0,4709,4715,3359,1356,2.477138643,2217,10798,4106,2041,2,2039,1,398,0,0.178028445,empty,mBC-0716-1
"E10,H4",12047,12392,9080,3312,6645,0,3053,3057,2117,940,2.25212766,1528,351,116,71,0,71,0,32,0,0,empty,mBC-0716-1
"E10,H5",17034,17349,12806,4543,9189,0,4196,4204,2984,1220,2.445901639,2014,3150,1614,821,0,821,0,226,0,0.03045067,empty,mBC-0716-1
"E10,H6",13447,14149,10197,3952,7611,0,3595,3605,2534,1071,2.366013072,1787,1873,1270,642,0,642,0,218,0,0.03894081,empty,mBC-0716-1
"E10,H7",15707,16428,11790,4638,8889,0,4078,4091,2912,1179,2.469889737,2031,1563,1034,538,0,538,0,192,0,0.035315985,empty,mBC-0716-1
"E10,H8",29571,32466,21721,10745,17252,0,8865,8873,6707,2166,3.096491228,4736,1953,1283,689,0,689,0,178,0,0.030478955,empty,mBC-0716-1
"E10,H9",584179,614798,428036,186762,328322,1,161427,161693,138678,23015,6.025548555,83776,130673,88682,42141,23,42118,4,3083,0,0.00201814,mm10,mBC-0716-1
"E10,H10",13324,13660,9893,3767,7249,0,3412,3415,2456,959,2.561001043,1719,28710,9188,4802,4,4798,2,720,0,0.119841601,empty,mBC-0716-1
"E10,H11",16182,16594,12106,4488,9018,1,4267,4280,3052,1228,2.48534202,2098,544,237,155,0,155,0,67,0,0.032258065,empty,mBC-0716-1
"E10,H12",5765,6085,4384,1701,3159,0,1443,1444,1001,443,2.259593679,686,830,489,234,0,234,0,86,0,0.064102564,empty,mBC-0716-1
"E11,A1",12961,13342,9735,3607,7155,0,3380,3394,2434,960,2.535416667,1636,1170,736,376,0,376,0,91,0,0.111702128,empty,mBC-0716-1
"E11,A2",1232136,1314710,895237,419473,692480,1,372085,372587,283986,88601,3.205223417,195306,73074,51138,24473,16,24457,2,2457,0,0.002289733,mm10,mBC-0716-1
"E11,A3",1076098,1116060,797508,318552,592797,1,292351,292824,225346,67478,3.339547704,149459,4862,3398,1593,1,1592,1,412,0,0.001884422,mm10,mBC-0716-1
"E11,A4",19834,19819,15243,4576,10345,0,4461,4485,3130,1355,2.3099631,2056,378,205,103,0,103,0,38,0,0.116504854,empty,mBC-0716-1
"E11,A5",15450,15772,11657,4115,8476,0,3887,3893,2727,1166,2.338765009,1829,1056,640,290,0,290,0,89,0,0.079310345,empty,mBC-0716-1
"E11,A6",716564,777308,505247,272061,410020,2,231343,231693,186472,45221,4.123570907,125391,26794,17959,8377,5,8372,2,1172,0,0.002866699,mm10,mBC-0716-1
"E11,A7",15246,15791,11594,4197,8390,1,3837,3848,2642,1206,2.190713101,1867,1057,649,329,3,326,2,104,0,0.076687117,empty,mBC-0716-1
"E11,A8",10551,11089,7962,3127,6039,0,2872,2884,2048,836,2.449760766,1447,6521,2237,1052,0,1052,0,218,0,0.051330798,empty,mBC-0716-1
"E11,A9",17614,17525,13277,4248,9265,0,4072,4088,2832,1256,2.25477707,1931,16807,5607,2885,1,2884,1,431,0,0.120319001,empty,mBC-0716-1
"E11,A10",604821,657307,431285,226022,350204,0,190158,190468,161744,28724,5.630970617,102290,39198,24346,11797,4,11793,1,1414,0,0.00195031,mm10,mBC-0716-1
"E11,A11",524140,567306,370181,197125,305487,0,171864,172133,143120,29013,4.932961086,92962,61884,43957,21309,6,21303,1,2075,0,0.000375534,mm10,mBC-0716-1
"E11,A12",19267,19417,14825,4592,10174,0,4413,4426,3113,1313,2.370906321,2076,2323,1392,668,1,667,1,161,0,0.076461769,empty,mBC-0716-1
"E11,B1",17827,18394,13621,4773,9634,0,4288,4304,3017,1287,2.344211344,2037,971,591,303,0,303,0,92,0,0.095709571,empty,mBC-0716-1
"E11,B2",19986,20357,15228,5129,10740,0,4776,4787,3358,1429,2.349895031,2284,462,245,125,0,125,0,47,0,0.024,empty,mBC-0716-1
"E11,B3",18661,19416,14111,5305,10240,0,4754,4769,3391,1378,2.460812772,2320,1161,738,358,0,358,0,99,0,0.05027933,empty,mBC-0716-1
"E11,B4",15419,15861,11755,4106,8426,0,3885,3891,2791,1100,2.537272727,1854,743,434,240,0,240,0,81,0,0.05,empty,mBC-0716-1
"E11,B5",9999,6891,4882,2009,4536,0,2203,2218,1597,621,2.571658615,1176,700,412,200,0,200,0,57,0,0.005,empty,mBC-0716-1
"E11,B6",11170,11387,8446,2941,6005,0,2772,2774,1867,907,2.058434399,1303,970,581,324,0,324,0,98,0,0.098765432,empty,mBC-0716-1
"E11,B7",15009,15472,11647,3825,8222,0,3598,3607,2467,1140,2.164035088,1686,907,598,308,0,308,0,95,0,0.029220779,empty,mBC-0716-1
"E11,B8",12787,13105,9739,3366,7025,0,3209,3213,2263,950,2.382105263,1571,2331,1172,626,0,626,0,155,0,0.022364217,empty,mBC-0716-1
"E11,B9",2138326,2360862,1481433,879429,1217862,2,749871,750947,604068,146879,4.112691399,416908,37379,25302,12056,8,12048,2,1596,0,0.011703187,mm10,mBC-0716-1
"E11,B10",609935,569051,404303,164748,316838,6,153800,155166,115832,39334,2.944831444,79509,16711,11716,5675,1,5674,1,802,0,0.00070497,mm10,mBC-0716-1
"E11,B11",16699,17104,12627,4477,9190,0,4264,4270,3042,1228,2.477198697,2031,143,108,58,0,58,0,26,0,0,empty,mBC-0716-1
"E11,B12",16713,17079,12649,4430,9060,0,4165,4170,2908,1262,2.304278922,1977,1101,662,332,0,332,0,96,0,0.045180723,empty,mBC-0716-1
"E11,C1",20984,21412,16030,5382,11229,0,4780,4784,3347,1437,2.329157968,2318,1125,544,281,0,281,0,76,0,0.128113879,empty,mBC-0716-1
"E11,C2",18100,18435,13464,4971,9913,1,4598,4608,3250,1358,2.393225331,2235,3490,1632,757,0,757,0,192,0,0.05680317,empty,mBC-0716-1
"E11,C3",346546,369379,246329,123050,195200,1,105749,105899,78201,27698,2.823344646,56540,19214,13979,6636,0,6636,0,885,0,0.002712477,mm10,mBC-0716-1
"E11,C4",16146,16141,12180,3961,8721,0,3860,3863,2651,1212,2.187293729,1872,988,563,274,0,274,0,87,0,0.00729927,empty,mBC-0716-1
"E11,C5",15590,15979,11623,4356,8511,0,3957,3966,2783,1183,2.35249366,2019,857,551,285,0,285,0,90,0,0.059649123,empty,mBC-0716-1
"E11,C6",16419,17012,12197,4815,9494,0,4601,4621,3258,1363,2.390315481,2308,2634,930,475,0,475,0,126,0,0.098947368,empty,mBC-0716-1
"E11,C7",14846,15267,11116,4151,8178,0,3851,3862,2691,1171,2.298035867,1920,247,173,83,0,83,0,33,0,0,empty,mBC-0716-1
"E11,C8",14717,14515,10712,3803,7614,0,3524,3532,2437,1095,2.225570776,1677,46595,15182,7803,4,7799,2,998,0,0.152327221,empty,mBC-0716-1
"E11,C9",11614,12029,8705,3324,6496,0,3109,3120,2162,958,2.256784969,1524,629,404,222,0,222,0,71,0,0.121621622,empty,mBC-0716-1
"E11,C10",12603,12737,9720,3017,6848,0,3076,3091,2178,913,2.385542169,1406,889,560,266,0,266,0,78,0,0.045112782,empty,mBC-0716-1
"E11,C11",11459,11917,8582,3335,6349,0,2987,2991,2056,935,2.198930481,1486,803,509,271,0,271,0,76,0,0.136531365,empty,mBC-0716-1
"E11,C12",18279,18628,13795,4833,10072,1,4663,4675,3330,1345,2.475836431,2232,952,529,286,0,286,0,99,0,0.097902098,empty,mBC-0716-1
"E11,D1",10489,10866,7860,3006,6002,0,2878,2882,1996,886,2.25282167,1456,468,319,155,0,155,0,48,0,0,empty,mBC-0716-1
"E11,D2",18934,19234,14732,4502,10279,0,4404,4419,3133,1286,2.436236392,2049,3927,1700,847,1,846,1,199,0,0.044917258,empty,mBC-0716-1
"E11,D3",594869,659956,424371,235585,352951,1,195541,195799,163210,32589,5.008131578,107471,81548,57180,27473,8,27465,1,2390,0,0.001492809,mm10,mBC-0716-1
"E11,D4",16954,17566,13034,4532,9319,0,4254,4271,2997,1274,2.352433281,2056,7101,2549,1278,2,1276,2,245,0,0.01645768,empty,mBC-0716-1
"E11,D5",12821,13205,9649,3556,7013,0,3297,3306,2366,940,2.517021277,1639,926,613,306,0,306,0,105,0,0.065359477,empty,mBC-0716-1
"E11,D6",11451,11786,8668,3118,6319,0,2928,2931,2053,878,2.338268793,1393,942,592,297,0,297,0,101,0,0.033670034,empty,mBC-0716-1
"E11,D7",12021,12213,9057,3156,6546,2,3032,3037,2158,879,2.455062571,1428,1234,837,409,0,409,0,115,0,0.122249389,empty,mBC-0716-1
"E11,D8",14276,14779,10929,3850,7934,0,3717,3723,2591,1132,2.288869258,1817,2500,1036,519,0,519,0,134,0,0.032755299,empty,mBC-0716-1
"E11,D9",4298,4534,3249,1285,2453,0,1185,1190,850,340,2.5,579,1213,719,361,2,359,2,102,0,0.038997214,empty,mBC-0716-1
"E11,D10",739572,836863,497009,339854,445777,2,283085,283427,217938,65489,3.327856587,163063,6987,4590,2277,1,2276,1,428,0,0.004393673,mm10,mBC-0716-1
"E11,D11",12554,12775,9541,3234,6883,0,3196,3201,2260,941,2.401700319,1533,1309,822,442,0,442,0,117,0,0.095022624,empty,mBC-0716-1
"E11,D12",18892,19542,14477,5065,10240,0,4763,4776,3383,1393,2.428571429,2274,1853,1181,584,0,584,0,163,0,0.126712329,empty,mBC-0716-1
"E11,E1",20607,20672,15802,4870,11089,0,4868,4874,3437,1437,2.391788448,2214,3507,1395,717,1,716,1,165,0,0.100558659,empty,mBC-0716-1
"E11,E2",610113,666798,425462,241336,356556,2,204073,204390,163546,40844,4.004162178,113144,104073,70111,34220,18,34202,1,2715,0,0.000526285,mm10,mBC-0716-1
"E11,E3",11549,11841,8730,3111,6249,0,2809,2817,1927,890,2.165168539,1335,2150,1072,538,1,537,1,126,0,0.063314711,empty,mBC-0716-1
"E11,E4",14127,14394,10703,3691,7691,0,3524,3528,2457,1071,2.294117647,1690,1027,662,336,0,336,0,105,0,0.080357143,empty,mBC-0716-1
"E11,E5",1179065,1272995,856457,416538,658863,2,357311,357845,286618,71227,4.02400775,188430,87937,61865,29929,12,29917,3,2545,0,0.004713039,mm10,mBC-0716-1
"E11,E6",12471,12494,9362,3132,6715,1,2963,2978,2073,905,2.290607735,1474,1146,738,373,0,373,0,100,0,0.058981233,empty,mBC-0716-1
"E11,E7",451475,483689,323642,160047,260894,1,145314,145521,88162,57359,1.537021217,79043,8452,5600,2612,2,2610,1,483,0,0.009195402,mm10,mBC-0716-1
"E11,E8",16654,17010,12829,4181,8994,0,3918,3923,2734,1189,2.29941127,1833,17335,5052,2572,4,2568,3,395,0,0.062694704,empty,mBC-0716-1
"E11,E9",8185,8285,6181,2104,4500,0,2049,2052,1463,589,2.483870968,985,837,520,282,0,282,0,73,0,0.109929078,empty,mBC-0716-1
"E11,E10",12509,12565,9186,3379,6713,0,3065,3067,2149,918,2.340958606,1490,6933,2474,1268,2,1266,1,220,0,0.164296998,empty,mBC-0716-1
"E11,E11",8531,8805,6483,2322,4765,0,2233,2237,1496,741,2.018893387,1113,1111,710,328,0,328,0,97,0,0.051829268,empty,mBC-0716-1
"E11,E12",13709,14109,10375,3734,7622,0,3462,3470,2411,1059,2.27667611,1678,954,546,279,0,279,0,98,0,0.017921147,empty,mBC-0716-1
"E11,F1",16563,17413,12712,4701,9066,0,4125,4132,2884,1248,2.310897436,2019,1334,890,414,0,414,0,106,0,0.125603865,empty,mBC-0716-1
"E11,F2",491322,508269,374738,133531,273857,0,124952,125174,89199,35975,2.479471855,61477,35236,23675,11511,5,11506,2,1440,0,0.004693204,mm10,mBC-0716-1
"E11,F3",967254,1111017,644458,466559,585086,1,374001,374464,262708,111756,2.350728373,220068,48025,32674,15676,3,15673,2,1729,0,0.001531296,mm10,mBC-0716-1
"E11,F4",15820,16077,11781,4296,8778,0,4081,4088,2921,1167,2.502999143,1957,557,409,218,0,218,0,62,0,0,empty,mBC-0716-1
"E11,F5",745857,784544,549336,235208,413478,0,210134,210476,177544,32932,5.391230414,107783,56531,40523,19070,1,19069,1,2001,0,0.001048823,mm10,mBC-0716-1
"E11,F6",21886,22731,16482,6249,12031,0,5596,5605,3964,1641,2.415600244,2754,1946,1286,640,1,639,1,163,0,0.043818466,empty,mBC-0716-1
"E11,F7",18325,18657,13777,4880,10230,0,4656,4669,3313,1356,2.443215339,2281,791,537,252,0,252,0,83,0,0.015873016,empty,mBC-0716-1
"E11,F8",22871,23787,17315,6472,12802,0,5926,5939,4257,1682,2.530915577,2872,259,190,87,0,87,0,38,0,0.149425287,empty,mBC-0716-1
"E11,F9",13925,14344,10617,3727,7675,0,3533,3533,2478,1055,2.348815166,1676,1654,1100,537,0,537,0,145,0,0.033519553,empty,mBC-0716-1
"E11,F10",19074,19308,14828,4480,10244,0,4338,4351,3054,1297,2.354664611,1957,1207,751,409,0,409,0,106,0,0.019559902,empty,mBC-0716-1
"E11,F11",10730,10748,8215,2533,5721,0,2529,2537,1787,750,2.382666667,1141,862,587,324,0,324,0,85,0,0.070987654,empty,mBC-0716-1
"E11,F12",12601,12886,9384,3502,6798,0,3042,3052,2118,934,2.267665953,1495,78,38,16,0,16,0,10,0,0,empty,mBC-0716-1
"E11,G1",9278,9518,7221,2297,5143,0,2283,2285,1553,732,2.121584699,1036,1517,1043,556,0,556,0,140,0,0.01618705,empty,mBC-0716-1
"E11,G2",19822,20075,14978,5097,10575,0,4703,4712,3308,1404,2.356125356,2258,1487,711,331,0,331,0,80,0,0.051359517,empty,mBC-0716-1
"E11,G3",19168,19368,14639,4729,10378,0,4692,4698,3366,1332,2.527027027,2233,1359,822,448,0,448,0,141,0,0.053571429,empty,mBC-0716-1
"E11,G4",26449,26773,20351,6422,14169,0,6110,6125,4260,1865,2.284182306,2867,49,36,30,0,30,0,23,0,0,empty,mBC-0716-1
"E11,G5",12181,12490,9286,3204,6625,1,2963,2969,2035,934,2.178800857,1423,1017,511,286,0,286,0,85,0,0.090909091,empty,mBC-0716-1
"E11,G6",22179,22255,17200,5055,11771,0,5080,5098,3610,1488,2.426075269,2270,86,57,34,0,34,0,20,0,0,empty,mBC-0716-1
"E11,G7",18453,18710,14263,4447,9853,0,4264,4277,2980,1297,2.297609869,1967,1194,710,366,0,366,0,126,0,0.090163934,empty,mBC-0716-1
"E11,G8",13316,13641,10039,3602,7228,0,3328,3333,2312,1021,2.264446621,1597,1263,848,400,1,399,1,117,0,0.062656642,empty,mBC-0716-1
"E11,G9",10153,10362,7692,2670,5474,0,2525,2525,1722,803,2.144458281,1225,833,492,263,0,263,0,91,0,0.007604563,empty,mBC-0716-1
"E11,G10",12600,12816,9591,3225,6913,0,3151,3158,2136,1022,2.090019569,1499,939,644,354,0,354,0,91,0,0.056497175,empty,mBC-0716-1
"E11,G11",11303,11288,8470,2818,6139,0,2737,2744,1935,809,2.39184178,1305,686,477,226,0,226,0,76,0,0.026548673,empty,mBC-0716-1
"E11,G12",10865,11133,8148,2985,5990,0,2793,2799,2014,785,2.565605096,1371,939,541,244,0,244,0,84,0,0.06147541,empty,mBC-0716-1
"E11,H1",25455,26240,19153,7087,13783,0,6275,6292,4584,1708,2.683840749,3067,19423,5940,2921,4,2917,2,503,0,0.04045252,empty,mBC-0716-1
"E11,H2",21952,22306,16831,5475,11601,0,5145,5165,3613,1552,2.327963918,2438,1682,1067,486,0,486,0,140,0,0.127572016,empty,mBC-0716-1
"E11,H3",618987,635170,460260,174910,339654,2,165454,165727,117525,48202,2.438176839,82655,15594,10691,5333,1,5332,1,815,0,0.002063016,mm10,mBC-0716-1
"E11,H4",537389,568791,398059,170732,303255,0,151047,151282,119455,31827,3.753259811,77941,5320,3707,1768,2,1766,1,332,0,0,mm10,mBC-0716-1
"E11,H5",16583,17078,12604,4474,9058,0,4157,4166,2958,1208,2.448675497,1985,1260,817,432,0,432,0,131,0,0.039351852,empty,mBC-0716-1
"E11,H6",13244,13560,9813,3747,7368,0,3481,3483,2460,1023,2.404692082,1742,1440,956,458,0,458,0,120,0,0.043668122,empty,mBC-0716-1
"E11,H7",15777,16441,11912,4529,8870,1,4069,4087,2902,1185,2.448945148,2046,1094,663,333,0,333,0,112,0,0,empty,mBC-0716-1
"E11,H8",12420,12734,9389,3345,6939,0,3246,3250,2278,972,2.343621399,1597,1342,872,431,0,431,0,140,0,0.009280742,empty,mBC-0716-1
"E11,H9",14199,14336,10622,3714,7689,0,3464,3470,2434,1036,2.349420849,1640,3637,1313,664,0,664,0,164,0,0.031626506,empty,mBC-0716-1
"E11,H10",13092,13623,9875,3748,7274,0,3367,3376,2374,1002,2.369261477,1699,1495,888,420,0,420,0,113,0,0.042857143,empty,mBC-0716-1
"E11,H11",15556,16080,11691,4389,8723,0,4143,4159,2942,1217,2.417419885,2081,106,69,42,0,42,0,22,0,0,empty,mBC-0716-1
"E11,H12",5727,5981,4250,1731,3292,0,1560,1563,1101,462,2.383116883,801,9604,3014,1530,1,1529,1,299,0,0.062132112,empty,mBC-0716-1
"E12,A1",12155,12356,9202,3154,6657,0,3005,3012,2160,852,2.535211268,1395,4071,1427,727,0,727,0,176,0,0.044016506,empty,mBC-0716-1
"E12,A2",16176,16697,12543,4154,8759,0,3783,3794,2608,1186,2.198988196,1779,1037,655,325,0,325,0,103,0,0.021538462,empty,mBC-0716-1
"E12,A3",14499,14828,11056,3772,7805,0,3593,3597,2542,1055,2.409478673,1663,801,543,271,0,271,0,92,0,0.029520295,empty,mBC-0716-1
"E12,A4",19151,19642,14588,5054,10435,0,4648,4658,3285,1373,2.392571012,2250,563,378,185,0,185,0,61,0,0.027027027,empty,mBC-0716-1
"E12,A5",545442,598904,396294,202610,325045,2,178747,179007,140160,38847,3.608000618,96688,54575,35408,16550,6,16544,2,1825,0,0.00483559,mm10,mBC-0716-1
"E12,A6",11216,11445,8505,2940,6056,0,2736,2742,1986,756,2.626984127,1270,916,602,296,0,296,0,106,0,0.003378378,empty,mBC-0716-1
"E12,A7",14239,14607,10804,3803,7835,0,3578,3590,2392,1198,1.996661102,1698,1011,617,311,0,311,0,98,0,0.045016077,empty,mBC-0716-1
"E12,A8",1109546,1221918,776551,445367,658371,0,393726,394233,264268,129965,2.033378217,220568,28328,14573,7175,1,7174,1,1093,0,0.015890716,mm10,mBC-0716-1
"E12,A9",2210195,2354360,1554333,800027,1188265,8,693446,694502,553220,141282,3.91571467,369701,107830,77408,37375,11,37364,2,2964,0,0.003613104,mm10,mBC-0716-1
"E12,A10",438886,449131,332278,116853,243479,1,113752,113932,88950,24982,3.560563606,55128,9485,4371,2111,1,2110,1,401,0,0.02985782,mm10,mBC-0716-1
"E12,A11",15591,15816,11823,3993,8506,0,3809,3813,2598,1215,2.138271605,1762,1107,660,339,1,338,1,96,0,0.068047337,empty,mBC-0716-1
"E12,A12",18704,19040,14357,4683,9874,1,4387,4394,3037,1357,2.238025055,2061,7983,2881,1472,1,1471,1,272,0,0.110129164,empty,mBC-0716-1
"E12,B1",17523,18057,13348,4709,9542,0,4291,4297,2969,1328,2.235692771,2067,1129,736,372,0,372,0,82,0,0.172043011,empty,mBC-0716-1
"E12,B2",1353317,1451486,972093,479393,765764,2,425248,425939,348163,77776,4.476483748,226755,6380,4109,2031,2,2029,1,388,0,0.002957122,mm10,mBC-0716-1
"E12,B3",1069714,1214324,716353,497971,631436,2,397862,398409,312740,85669,3.650562047,230236,75888,47512,22404,5,22399,1,2120,0,0.00138399,mm10,mBC-0716-1
"E12,B4",947073,1012261,691381,320880,526660,2,278028,278416,240223,38193,6.289712775,144018,82743,56155,27270,12,27258,2,2386,0,0.0013574,mm10,mBC-0716-1
"E12,B5",8225,5359,3737,1622,3599,0,1708,1729,1187,542,2.1900369,948,10409,3565,1808,1,1807,1,313,0,0.091311566,empty,mBC-0716-1
"E12,B6",10372,10461,7957,2504,5627,0,2520,2529,1741,788,2.209390863,1143,877,567,282,0,282,0,78,0,0.010638298,empty,mBC-0716-1
"E12,B7",14797,15085,11379,3706,7932,0,3461,3469,2375,1094,2.170932358,1630,3179,1108,566,0,566,0,120,0,0.053003534,empty,mBC-0716-1
"E12,B8",11713,12141,9093,3048,6321,0,2819,2832,2025,807,2.50929368,1280,889,573,302,0,302,0,86,0,0.01986755,empty,mBC-0716-1
"E12,B9",13536,13865,10414,3451,7290,0,3204,3213,2222,991,2.242179617,1524,544,342,173,1,172,1,56,0,0.023255814,empty,mBC-0716-1
"E12,B10",14042,13372,10065,3307,7535,0,3391,3405,2375,1030,2.305825243,1647,440,288,141,0,141,0,36,0,0.141843972,empty,mBC-0716-1
"E12,B11",14281,14895,10994,3901,7858,0,3574,3589,2560,1029,2.487852284,1726,171,127,64,0,64,0,26,0,0,empty,mBC-0716-1
"E12,B12",16492,17011,12626,4385,8891,0,3980,3989,2782,1207,2.304888152,1859,1050,669,339,1,338,1,92,0,0.050295858,empty,mBC-0716-1
"E12,C1",968931,1001085,719109,281976,520017,0,261713,262163,189102,73061,2.588275551,130707,10743,7119,3472,2,3470,1,589,0,0.001152738,mm10,mBC-0716-1
"E12,C2",404819,445655,289096,156559,238721,0,139400,139586,87452,52134,1.67744658,77039,7162,4318,2060,0,2060,0,438,0,0.02184466,mm10,mBC-0716-1
"E12,C3",18170,18823,13760,5063,9893,0,4514,4528,3114,1414,2.202263083,2202,578,316,167,0,167,0,46,0,0.119760479,empty,mBC-0716-1
"E12,C4",15313,15403,11627,3776,8224,0,3623,3633,2579,1054,2.44686907,1710,1280,865,422,0,422,0,111,0,0.049763033,empty,mBC-0716-1
"E12,C5",14172,14603,10783,3820,7677,0,3446,3455,2445,1010,2.420792079,1681,729,451,257,0,257,0,92,0,0.038910506,empty,mBC-0716-1
"E12,C6",15059,15393,11123,4270,8431,0,3999,4014,2851,1163,2.451418745,1980,861,527,288,0,288,0,88,0,0.128472222,empty,mBC-0716-1
"E12,C7",1541139,1747075,1049486,697589,913948,0,570166,570902,410657,160245,2.562682143,328667,16717,12006,5752,2,5750,1,878,0,0.000173913,mm10,mBC-0716-1
"E12,C8",657913,694221,487076,207145,369137,0,181908,182246,157443,24803,6.347740193,92879,172304,118515,55995,20,55975,2,3494,0,0.000857526,mm10,mBC-0716-1
"E12,C9",93384,106551,65539,41012,56944,0,33429,33479,27638,5841,4.73172402,19155,8054,5471,2621,0,2621,0,387,0,0.018313621,empty,mBC-0716-1
"E12,C10",11902,12149,9137,3012,6560,0,2901,2906,1997,909,2.196919692,1381,701,361,199,1,198,1,77,0,0.03030303,empty,mBC-0716-1
"E12,C11",10653,10936,8144,2792,5829,0,2730,2743,1899,844,2.25,1304,1867,754,408,0,408,0,100,0,0.068627451,empty,mBC-0716-1
"E12,C12",18205,18726,13803,4923,9806,0,4492,4504,3152,1352,2.331360947,2114,892,607,332,0,332,0,100,0,0.048192771,empty,mBC-0716-1
"E12,D1",9208,9650,7047,2603,5260,0,2466,2476,1720,756,2.275132275,1230,559,342,179,0,179,0,73,0,0.005586592,empty,mBC-0716-1
"E12,D2",19126,19170,14721,4449,10016,0,4171,4182,2897,1285,2.254474708,1872,2005,1289,609,0,609,0,146,0,0.105090312,empty,mBC-0716-1
"E12,D3",11964,12413,9005,3408,6526,0,2978,2988,1998,990,2.018181818,1430,985,631,322,0,322,0,90,0,0.037267081,empty,mBC-0716-1
"E12,D4",12638,13075,9666,3409,6821,0,3083,3090,2155,935,2.304812834,1483,935,559,301,0,301,0,105,0,0.049833887,empty,mBC-0716-1
"E12,D5",11848,12412,9047,3365,6698,0,3147,3152,2229,923,2.414951246,1567,682,423,241,0,241,0,82,0,0.091286307,empty,mBC-0716-1
"E12,D6",10671,11277,7993,3284,5900,0,2786,2788,1869,919,2.033732318,1395,1238,721,355,0,355,0,102,0,0.064788732,empty,mBC-0716-1
"E12,D7",11295,11468,8461,3007,6027,0,2676,2678,1851,827,2.238210399,1293,8657,3198,1582,0,1582,0,298,0,0.082806574,empty,mBC-0716-1
"E12,D8",14703,15403,11136,4267,8086,0,3795,3805,2616,1189,2.200168209,1871,631,401,194,0,194,0,66,0,0.087628866,empty,mBC-0716-1
"E12,D9",3783,3803,2803,1000,2091,0,997,997,714,283,2.522968198,474,1126,676,336,0,336,0,120,0,0.005952381,empty,mBC-0716-1
"E12,D10",13709,14490,10449,4041,7677,0,3728,3730,2627,1103,2.38168631,1816,622,352,194,0,194,0,75,0,0.015463918,empty,mBC-0716-1
"E12,D11",11741,11968,8839,3129,6381,0,2904,2907,1985,922,2.152928416,1363,7659,2633,1277,0,1277,0,279,0,0.032889585,empty,mBC-0716-1
"E12,D12",18481,19217,14076,5141,10026,0,4535,4544,3168,1376,2.302325581,2219,1794,1110,576,0,576,0,154,0,0.045138889,empty,mBC-0716-1
"E12,E1",19323,19252,14896,4356,10137,0,4388,4401,3077,1324,2.324018127,1962,1562,948,488,0,488,0,144,0,0.053278689,empty,mBC-0716-1
"E12,E2",14223,14421,10794,3627,7662,0,3411,3423,2392,1031,2.320077595,1613,1483,923,485,1,484,1,134,0,0.012396694,empty,mBC-0716-1
"E12,E3",39142,40211,30143,10068,21028,0,9097,9127,7114,2013,3.534028813,4350,9107,6194,2826,1,2825,1,538,0,0.002123894,empty,mBC-0716-1
"E12,E4",14164,14452,10897,3555,7602,0,3347,3351,2356,995,2.367839196,1566,1096,684,375,0,375,0,129,0,0.002666667,empty,mBC-0716-1
"E12,E5",18559,18877,14481,4396,10047,0,4342,4350,3009,1341,2.243847875,2021,906,574,300,0,300,0,105,0,0.03,empty,mBC-0716-1
"E12,E6",11720,11821,8964,2857,6320,0,2788,2789,1891,898,2.105790646,1273,1039,633,322,0,322,0,89,0,0.062111801,empty,mBC-0716-1
"E12,E7",11977,12317,9157,3160,6559,0,2857,2864,1936,928,2.086206897,1383,1982,934,461,0,461,0,133,0,0.034707158,empty,mBC-0716-1
"E12,E8",15748,15805,12115,3690,8453,0,3708,3715,2535,1180,2.148305085,1697,1636,932,472,0,472,0,154,0,0.055084746,empty,mBC-0716-1
"E12,E9",7962,8192,5971,2221,4337,0,1996,2002,1357,645,2.103875969,995,711,495,215,0,215,0,71,0,0.004651163,empty,mBC-0716-1
"E12,E10",11574,11961,8895,3066,6408,0,2879,2882,1951,931,2.095596133,1366,3658,1453,726,0,726,0,145,0,0.045454545,empty,mBC-0716-1
"E12,E11",7990,8025,5997,2028,4326,0,1965,1968,1317,651,2.023041475,932,1784,710,339,0,339,0,111,0,0.09439528,empty,mBC-0716-1
"E12,E12",13138,13585,9983,3602,7254,0,3343,3346,2277,1069,2.130028064,1638,858,556,294,0,294,0,84,0,0.108843537,empty,mBC-0716-1
"E12,F1",501268,516836,389486,127350,275972,4,118376,118629,98569,20060,4.913708873,56792,58033,41217,19756,6,19750,2,1998,0,0.00121519,mm10,mBC-0716-1
"E12,F2",20077,20556,15336,5220,10785,3,4906,4922,3421,1501,2.279147235,2325,1824,1175,602,0,602,0,186,0,0.074750831,empty,mBC-0716-1
"E12,F3",14333,14830,10756,4074,7859,0,3581,3592,2534,1058,2.395085066,1783,1620,1063,538,0,538,0,162,0,0.00929368,empty,mBC-0716-1
"E12,F4",626784,715632,405523,310109,386183,0,248268,248579,197891,50688,3.90409959,145851,24588,17305,8348,4,8344,1,1111,0,0.001318313,mm10,mBC-0716-1
"E12,F5",21201,21567,16027,5540,11380,0,5168,5179,3558,1621,2.194941394,2485,1135,669,376,0,376,0,129,0,0.037234043,empty,mBC-0716-1
"E12,F6",20536,21120,15755,5365,11092,0,4997,5008,3574,1434,2.492329149,2342,1981,1337,659,0,659,0,169,0,0.048558422,empty,mBC-0716-1
"E12,F7",698981,742370,518838,223532,400936,2,200006,200353,168438,31915,5.277706408,103273,55621,35325,17275,8,17267,2,1856,0,0.003996062,mm10,mBC-0716-1
"E12,F8",20113,20632,15440,5192,10913,0,4946,4950,3514,1436,2.447075209,2317,211,164,93,0,93,0,36,0,0,empty,mBC-0716-1
"E12,F9",13180,13357,9943,3414,7120,0,3240,3247,2265,982,2.306517312,1518,1963,1119,560,0,560,0,155,0,0.041071429,empty,mBC-0716-1
"E12,F10",928896,985115,685941,299174,514422,0,263953,264420,208859,55561,3.759093609,136548,73345,49376,23375,13,23362,2,2150,0,0.000299632,mm10,mBC-0716-1
"E12,F11",1369241,1445047,1013470,431577,751862,3,383536,384135,305498,78637,3.884914226,197051,123914,86579,41643,13,41630,3,3209,0,0.004732164,mm10,mBC-0716-1
"E12,F12",12515,12955,9547,3408,6817,0,3142,3146,2143,1003,2.136590229,1517,89,65,31,0,31,0,12,0,0,empty,mBC-0716-1
"E12,G1",1214375,1376035,832887,543148,726125,1,452207,452714,351521,101193,3.473767948,256308,123318,87323,42127,11,42116,1,3223,0,0.000237439,mm10,mBC-0716-1
"E12,G2",18671,18944,14440,4504,9874,0,4389,4402,3079,1323,2.32728647,1998,488,313,160,0,160,0,47,0,0.04375,empty,mBC-0716-1
"E12,G3",610542,644240,453022,191218,344083,0,175050,175325,130672,44653,2.926387925,89783,76989,30125,15381,7,15374,5,1793,0,0.080785742,mm10,mBC-0716-1
"E12,G4",25274,25530,19373,6157,13440,0,5836,5853,4063,1790,2.269832402,2745,148,72,46,0,46,0,19,0,0,empty,mBC-0716-1
"E12,G5",12580,12859,9195,3664,6801,0,3108,3115,2144,971,2.208032956,1603,858,519,267,2,265,1,86,0,0.018867925,empty,mBC-0716-1
"E12,G6",21858,22532,16985,5547,11765,0,5205,5209,3716,1493,2.488948426,2384,224,89,49,0,49,0,26,0,0,empty,mBC-0716-1
"E12,G7",18262,18686,14089,4597,9844,0,4305,4313,3047,1266,2.406793049,2018,1382,649,347,0,347,0,125,0,0.037463977,empty,mBC-0716-1
"E12,G8",12925,13244,9786,3458,6954,0,3208,3212,2242,970,2.311340206,1534,1139,555,314,0,314,0,111,0,0.057324841,empty,mBC-0716-1
"E12,G9",9403,9584,7152,2432,5146,0,2336,2339,1658,681,2.434654919,1144,793,534,277,0,277,0,101,0,0.02166065,empty,mBC-0716-1
"E12,G10",12121,12551,9279,3272,6659,0,3013,3017,2081,936,2.223290598,1458,1424,712,360,0,360,0,94,0,0.138888889,empty,mBC-0716-1
"E12,G11",11474,11743,8657,3086,6256,0,2827,2838,1934,904,2.139380531,1395,1549,631,348,1,347,1,94,0,0.069164265,empty,mBC-0716-1
"E12,G12",10513,10715,7947,2768,5851,0,2674,2682,1848,834,2.215827338,1295,842,511,269,0,269,0,84,0,0.059479554,empty,mBC-0716-1
"E12,H1",655178,735941,438011,297930,394724,0,252120,252375,196290,56085,3.499866274,145014,3595,2642,1220,0,1220,0,296,0,0.01147541,mm10,mBC-0716-1
"E12,H2",21344,21863,16214,5649,11366,0,5055,5064,3550,1514,2.344782034,2450,4272,1740,894,1,893,1,196,0,0.064949608,empty,mBC-0716-1
"E12,H3",17706,18323,13484,4839,9695,0,4445,4456,3118,1338,2.330343797,2131,1130,627,336,0,336,0,106,0,0.116071429,empty,mBC-0716-1
"E12,H4",12045,12450,9126,3324,6495,0,2963,2967,2070,897,2.307692308,1454,128,105,47,0,47,0,21,0,0,empty,mBC-0716-1
"E12,H5",16008,16489,12207,4282,8815,0,3974,3990,2793,1197,2.333333333,1909,1301,665,374,0,374,0,124,0,0.077540107,empty,mBC-0716-1
"E12,H6",11824,12269,8863,3406,6735,0,3146,3152,2152,1000,2.152,1538,1967,977,487,0,487,0,133,0,0.071868583,empty,mBC-0716-1
"E12,H7",15100,15143,11236,3907,8265,1,3733,3735,2639,1096,2.407846715,1776,3925,1318,721,1,720,1,180,0,0.055555556,empty,mBC-0716-1
"E12,H8",11596,12080,8826,3254,6340,0,2921,2924,2077,847,2.452184179,1424,1292,839,416,0,416,0,113,0,0.009615385,empty,mBC-0716-1
"E12,H9",13644,14115,10472,3643,7405,0,3345,3353,2372,981,2.417940877,1567,2675,1052,559,0,559,0,131,0,0.02862254,empty,mBC-0716-1
"E12,H10",12667,12713,9548,3165,6672,0,2980,2986,2032,954,2.129979036,1389,6899,2384,1142,1,1141,1,195,0,0.128834356,empty,mBC-0716-1
"E12,H11",14674,14816,11294,3522,7910,0,3520,3528,2461,1067,2.306466729,1637,102,52,25,0,25,0,18,0,0,empty,mBC-0716-1
"E12,H12",5500,5605,4110,1495,2946,0,1363,1368,970,398,2.43718593,653,10704,3641,1799,2,1797,2,321,0,0.050083472,empty,mBC-0716-1
"F1,A1",12087,12616,9173,3443,6743,0,3201,3204,2264,940,2.408510638,1528,994,514,284,0,284,0,90,0,0.031690141,empty,mBC-0716-1
"F1,A2",15921,16065,12019,4046,8582,0,3839,3853,2731,1122,2.434046346,1826,1440,692,356,0,356,0,90,0,0.148876404,empty,mBC-0716-1
"F1,A3",14062,14577,10752,3825,7562,0,3466,3470,2439,1031,2.365664403,1602,822,515,250,1,249,1,81,0,0.032128514,empty,mBC-0716-1
"F1,A4",18524,18862,14280,4582,9699,0,4188,4197,2968,1229,2.414971522,1988,8318,2624,1314,1,1313,1,201,0,0.105102818,empty,mBC-0716-1
"F1,A5",14354,14599,10974,3625,7644,0,3450,3456,2423,1033,2.345595353,1582,1464,906,429,0,429,0,110,0,0.037296037,empty,mBC-0716-1
"F1,A6",15765,16686,11745,4941,9031,0,4489,4501,3325,1176,2.827380952,2245,1014,654,347,0,347,0,102,0,0.103746398,empty,mBC-0716-1
"F1,A7",578587,640301,414395,225906,342623,1,191179,191472,156342,35130,4.450384287,104540,49050,35323,16743,5,16738,2,1707,0,0.000955909,mm10,mBC-0716-1
"F1,A8",9470,9668,7214,2454,5261,0,2456,2464,1712,752,2.276595745,1170,1182,770,384,1,383,1,103,0,0.078328982,empty,mBC-0716-1
"F1,A9",1484568,1559314,1098319,460995,804722,0,411289,411979,340697,71282,4.779565669,209076,183725,115590,55016,34,54982,6,3873,0,0.003855807,mm10,mBC-0716-1
"F1,A10",13422,14032,10230,3802,7425,0,3380,3397,2408,989,2.434782609,1631,685,274,140,0,140,0,36,0,0.107142857,empty,mBC-0716-1
"F1,A11",15254,15191,11816,3375,8203,0,3424,3437,2419,1018,2.376227898,1556,1901,1044,510,0,510,0,125,0,0.029411765,empty,mBC-0716-1
"F1,A12",17235,17333,13416,3917,9165,0,3932,3955,2760,1195,2.309623431,1825,1946,1260,619,0,619,0,142,0,0.054927302,empty,mBC-0716-1
"F1,B1",16427,16775,12471,4304,8888,0,3971,3976,2752,1224,2.248366013,1922,1239,788,452,0,452,0,112,0,0.07079646,empty,mBC-0716-1
"F1,B2",499545,503472,367052,136420,273759,0,129388,129595,79891,49704,1.607335426,65992,3601,1783,897,0,897,0,205,0,0.005574136,empty,mBC-0716-1
"F1,B3",15557,15837,11849,3988,8484,0,3803,3806,2657,1149,2.312445605,1785,768,470,227,0,227,0,77,0,0.013215859,empty,mBC-0716-1
"F1,B4",14602,14847,11214,3633,7901,0,3570,3577,2575,1002,2.569860279,1678,6149,2297,1144,0,1144,0,219,0,0.041083916,empty,mBC-0716-1
"F1,B5",7750,4900,3501,1399,3353,0,1552,1562,1105,457,2.417943107,816,571,315,127,0,127,0,49,0,0.031496063,empty,mBC-0716-1
"F1,B6",10334,10427,7801,2626,5539,0,2486,2491,1751,740,2.366216216,1200,5142,1735,917,1,916,1,198,0,0.062227074,empty,mBC-0716-1
"F1,B7",13912,14348,10892,3456,7559,0,3327,3335,2309,1026,2.250487329,1527,681,472,260,0,260,0,70,0,0.1,empty,mBC-0716-1
"F1,B8",11200,11621,8609,3012,6156,0,2766,2773,1932,841,2.297265161,1301,639,470,225,1,224,1,75,0,0.111607143,empty,mBC-0716-1
"F1,B9",13150,13666,10129,3537,7095,0,3117,3123,2169,954,2.273584906,1481,309,191,102,0,102,0,42,0,0,empty,mBC-0716-1
"F1,B10",14274,13728,10276,3452,7570,5,3474,3501,2382,1119,2.128686327,1661,430,240,104,0,104,0,34,0,0.028846154,empty,mBC-0716-1
"F1,B11",16287,16784,12440,4344,8848,0,3967,3979,2827,1152,2.453993056,1968,109,64,40,0,40,0,21,0,0,empty,mBC-0716-1
"F1,B12",674403,738337,479364,258973,396483,1,225450,225834,169844,55990,3.033470263,123087,28805,20220,9680,3,9677,1,1196,0,0.003513486,mm10,mBC-0716-1
"F1,C1",19145,18865,14949,3916,9900,0,4088,4094,2886,1208,2.389072848,1749,412,251,148,0,148,0,49,0,0.067567568,empty,mBC-0716-1
"F1,C2",15814,16274,11975,4299,8660,0,3979,3996,2803,1193,2.349538977,1973,1358,875,435,0,435,0,119,0,0.011494253,empty,mBC-0716-1
"F1,C3",17129,17498,13089,4409,9180,0,4107,4122,2850,1272,2.240566038,1942,327,197,95,0,95,0,38,0,0.178947368,empty,mBC-0716-1
"F1,C4",14709,15123,11237,3886,7957,0,3512,3514,2484,1030,2.411650485,1656,993,655,361,1,360,1,101,0,0.033333333,empty,mBC-0716-1
"F1,C5",13265,13644,10138,3506,7200,0,3295,3300,2311,989,2.336703741,1510,2872,1178,613,2,611,2,129,0,0.047463175,empty,mBC-0716-1
"F1,C6",601687,609541,437239,172302,334855,2,167505,167794,134059,33735,3.973884689,83799,22767,16324,7963,4,7959,1,1065,0,0.001130795,mm10,mBC-0716-1
"F1,C7",841698,940124,573376,366748,494556,0,300945,301372,249773,51599,4.840655827,170243,13884,9821,4777,3,4774,2,703,0,0.00104734,mm10,mBC-0716-1
"F1,C8",12736,12992,9570,3422,6918,0,3136,3140,2115,1025,2.063414634,1504,9288,3347,1691,0,1691,0,312,0,0.013010053,empty,mBC-0716-1
"F1,C9",10693,11291,8197,3094,5956,0,2756,2761,1917,844,2.271327014,1390,698,469,223,0,223,0,55,0,0,empty,mBC-0716-1
"F1,C10",497672,513963,362188,151775,276559,1,139761,140026,101429,38597,2.627898541,72276,20754,13703,6709,3,6706,1,948,0,0.002684163,mm10,mBC-0716-1
"F1,C11",10252,10667,7746,2921,5654,0,2635,2639,1857,782,2.374680307,1292,567,392,204,0,204,0,61,0,0.083333333,empty,mBC-0716-1
"F1,C12",16935,17793,12768,5025,9362,0,4275,4292,2992,1300,2.301538462,2138,2492,1104,549,1,548,1,126,0,0.025547445,empty,mBC-0716-1
"F1,D1",417915,445076,307879,137197,241430,0,120730,120919,88935,31984,2.780609055,63226,23919,16876,8092,5,8087,2,1077,0,0.001112897,mm10,mBC-0716-1
"F1,D2",18425,18532,14249,4283,9626,0,4075,4077,2902,1175,2.469787234,1794,6300,2646,1318,0,1318,0,272,0,0.080424886,empty,mBC-0716-1
"F1,D3",11527,12045,8728,3317,6509,0,3078,3080,2082,998,2.086172345,1531,889,539,252,0,252,0,73,0,0.055555556,empty,mBC-0716-1
"F1,D4",11835,12039,9028,3011,6458,0,2915,2917,2050,867,2.364475202,1353,1322,617,321,0,321,0,100,0,0.059190031,empty,mBC-0716-1
"F1,D5",11479,11788,8755,3033,6322,0,2843,2852,1992,860,2.31627907,1362,7139,2506,1287,1,1286,1,248,0,0.064541213,empty,mBC-0716-1
"F1,D6",10288,10618,7805,2813,5697,0,2638,2638,1827,811,2.252774353,1266,989,693,327,0,327,0,94,0,0.067278287,empty,mBC-0716-1
"F1,D7",11104,11574,8290,3284,6139,0,2902,2904,1993,911,2.187705818,1447,5680,1951,922,1,921,1,205,0,0.055374593,empty,mBC-0716-1
"F1,D8",13509,13826,10198,3628,7483,0,3490,3504,2399,1105,2.171040724,1718,768,527,290,0,290,0,90,0,0.117241379,empty,mBC-0716-1
"F1,D9",167928,171643,120875,50768,95374,0,47902,47988,36132,11856,3.04757085,24776,23251,14934,7170,0,7170,0,1018,0,0.005578801,empty,mBC-0716-1
"F1,D10",696073,750775,499044,251731,397679,2,218299,218597,172084,46513,3.699696859,116965,32089,20433,10095,5,10090,1,1321,0,0.000792864,mm10,mBC-0716-1
"F1,D11",11203,11438,8486,2952,6077,0,2821,2829,1936,893,2.167973124,1345,3857,1526,717,0,717,0,169,0,0.015341702,empty,mBC-0716-1
"F1,D12",17620,18135,13462,4673,9602,0,4317,4325,3091,1234,2.504862237,2052,5727,1966,1026,0,1026,0,233,0,0.100389864,empty,mBC-0716-1
"F1,E1",18104,18321,13790,4531,9752,0,4350,4359,3074,1285,2.392217899,2037,1103,687,364,0,364,0,115,0,0.085164835,empty,mBC-0716-1
"F1,E2",13931,14219,10580,3639,7629,0,3461,3472,2470,1002,2.46506986,1681,6990,2416,1193,1,1192,1,247,0,0.063758389,empty,mBC-0716-1
"F1,E3",10418,10723,8099,2624,5719,0,2510,2519,1759,760,2.314473684,1149,1671,958,501,0,501,0,140,0,0.045908184,empty,mBC-0716-1
"F1,E4",13277,13715,10135,3580,7290,0,3334,3340,2370,970,2.443298969,1615,3680,1270,631,0,631,0,151,0,0.026941363,empty,mBC-0716-1
"F1,E5",881207,912102,674792,237310,475922,2,217241,217674,183221,34453,5.317998433,105084,84824,55669,26188,14,26174,2,2351,0,0.001986704,mm10,mBC-0716-1
"F1,E6",432364,460736,314559,146177,248098,2,131106,131294,90685,40609,2.233125662,69446,18557,13025,5980,2,5978,1,895,0,0.004516561,mm10,mBC-0716-1
"F1,E7",529478,571803,374778,197025,307772,1,174312,174574,138287,36287,3.810924022,94848,8945,6195,3064,1,3063,1,562,0,0.006529546,mm10,mBC-0716-1
"F1,E8",15191,15535,11784,3751,8236,0,3493,3508,2406,1102,2.183303085,1621,1638,994,484,0,484,0,122,0,0.053719008,empty,mBC-0716-1
"F1,E9",7791,7979,5958,2021,4249,0,1920,1922,1351,571,2.366024518,892,1172,824,433,0,433,0,104,0,0.032332564,empty,mBC-0716-1
"F1,E10",11229,11368,8653,2715,5971,0,2663,2668,1869,799,2.339173967,1203,874,532,229,0,229,0,77,0,0.026200873,empty,mBC-0716-1
"F1,E11",7756,7917,5899,2018,4382,0,2030,2037,1455,582,2.5,965,859,616,298,0,298,0,70,0,0.197986577,empty,mBC-0716-1
"F1,E12",13142,13402,9896,3506,7223,0,3365,3373,2401,972,2.470164609,1607,1931,788,398,0,398,0,101,0,0.092964824,empty,mBC-0716-1
"F1,F1",16395,16508,12117,4391,8605,0,3902,3913,2707,1206,2.244610282,1910,26709,8539,4344,3,4341,1,597,0,0.157797742,empty,mBC-0716-1
"F1,F2",18793,19325,14446,4879,10295,0,4661,4674,3225,1449,2.225672878,2221,2735,1580,815,1,814,1,202,0,0.07985258,empty,mBC-0716-1
"F1,F3",14089,14864,10551,4313,7930,0,3777,3781,2588,1193,2.169321039,1942,4513,2062,1031,0,1031,0,183,0,0.247332687,empty,mBC-0716-1
"F1,F4",14131,14394,10632,3762,7837,0,3620,3621,2498,1123,2.224398931,1762,655,369,193,0,193,0,50,0,0.015544041,empty,mBC-0716-1
"F1,F5",20088,20659,15132,5527,11001,1,5025,5043,3556,1487,2.391392065,2415,942,583,289,0,289,0,97,0,0.024221453,empty,mBC-0716-1
"F1,F6",1197527,1303842,836480,467362,693586,0,396853,397400,329145,68255,4.822284082,218939,201123,133306,63564,21,63543,3,3969,0,0.003556647,mm10,mBC-0716-1
"F1,F7",16650,16855,12855,4000,9211,0,4073,4084,2886,1198,2.409015025,1840,627,387,200,1,199,1,61,0,0.045226131,empty,mBC-0716-1
"F1,F8",19649,20176,14871,5305,10768,0,4939,4949,3491,1458,2.394375857,2378,206,137,70,0,70,0,32,0,0,empty,mBC-0716-1
"F1,F9",13111,13667,10030,3637,7133,0,3261,3273,2285,988,2.312753036,1595,2306,1124,562,0,562,0,147,0,0.06227758,empty,mBC-0716-1
"F1,F10",17673,18065,13716,4349,9524,0,4161,4170,2896,1274,2.273155416,1928,3510,1253,631,1,630,1,146,0,0.044444444,empty,mBC-0716-1
"F1,F11",9216,9632,7108,2524,5120,0,2224,2224,1581,643,2.458786936,1063,763,463,246,0,246,0,66,0,0.028455285,empty,mBC-0716-1
"F1,F12",11895,12146,9123,3023,6412,0,2933,2936,2000,936,2.136752137,1346,48,12,11,0,11,0,10,0,0,empty,mBC-0716-1
"F1,G1",8601,8858,6587,2271,4770,0,2175,2178,1508,670,2.250746269,1048,1308,874,434,0,434,0,114,0,0.069124424,empty,mBC-0716-1
"F1,G2",17229,17294,13181,4113,9255,0,3974,3986,2754,1232,2.23538961,1826,354,242,121,0,121,0,30,0,0,empty,mBC-0716-1
"F1,G3",17419,18031,13253,4778,9578,0,4408,4414,3053,1361,2.243203527,2172,1582,1009,530,0,530,0,148,0,0.071698113,empty,mBC-0716-1
"F1,G4",24090,24810,18605,6205,12987,0,5687,5696,4070,1626,2.503075031,2673,81,52,37,0,37,0,20,0,0,empty,mBC-0716-1
"F1,G5",11765,12037,8708,3329,6448,0,3067,3072,2155,917,2.350054526,1557,4258,1674,810,4,806,2,170,0,0.071960298,empty,mBC-0716-1
"F1,G6",21312,21825,16305,5520,11518,0,5104,5117,3584,1533,2.337899543,2449,302,171,81,0,81,0,29,0,0.172839506,empty,mBC-0716-1
"F1,G7",16932,17352,13090,4262,9196,0,4012,4025,2769,1256,2.204617834,1848,1300,826,404,0,404,0,123,0,0.084158416,empty,mBC-0716-1
"F1,G8",12244,12862,9280,3582,6820,0,3216,3226,2257,969,2.329205366,1577,1077,668,354,0,354,0,105,0,0.028248588,empty,mBC-0716-1
"F1,G9",8700,8877,6660,2217,4717,1,2148,2162,1517,645,2.351937984,993,968,621,320,0,320,0,112,0,0.03125,empty,mBC-0716-1
"F1,G10",11460,11782,8709,3073,6200,0,2773,2777,1927,850,2.267058824,1316,1143,809,377,0,377,0,99,0,0.013262599,empty,mBC-0716-1
"F1,G11",10472,10709,7969,2740,5696,0,2594,2599,1813,786,2.306615776,1204,535,409,173,0,173,0,70,0,0,empty,mBC-0716-1
"F1,G12",9762,10002,7392,2610,5372,0,2378,2382,1723,659,2.614567527,1165,929,589,278,0,278,0,94,0,0.107913669,empty,mBC-0716-1
"F1,H1",17335,18082,13080,5002,9732,0,4540,4548,3225,1323,2.437641723,2256,735,526,278,0,278,0,83,0,0.089928058,empty,mBC-0716-1
"F1,H2",20812,21053,15601,5452,10787,0,4872,4887,3428,1459,2.349554489,2312,21617,7653,3911,4,3907,2,574,0,0.132326593,empty,mBC-0716-1
"F1,H3",16788,17590,12613,4977,9252,0,4307,4314,3072,1242,2.473429952,2119,1496,980,474,0,474,0,132,0,0.008438819,empty,mBC-0716-1
"F1,H4",11212,11632,8401,3231,6185,0,2792,2797,1938,859,2.256111758,1407,170,91,36,0,36,0,25,0,0.138888889,empty,mBC-0716-1
"F1,H5",15529,16587,11765,4822,8709,1,4039,4049,2905,1144,2.539335664,2044,2170,1130,539,0,539,0,148,0,0.001855288,empty,mBC-0716-1
"F1,H6",423382,457234,296551,160683,248084,0,137308,137516,115927,21589,5.369725323,75041,129274,93925,44455,13,44442,2,3116,0,0.001395077,mm10,mBC-0716-1
"F1,H7",14428,14968,10897,4071,7985,0,3620,3621,2564,1057,2.425733207,1796,1496,740,386,1,385,1,113,0,0.085714286,empty,mBC-0716-1
"F1,H8",11445,11679,8601,3078,6207,0,2830,2841,2019,822,2.45620438,1382,3184,1242,626,1,625,1,161,0,0.0112,empty,mBC-0716-1
"F1,H9",13222,13527,10100,3427,7286,0,3214,3226,2315,911,2.541163557,1553,1035,722,359,0,359,0,89,0,0.072423398,empty,mBC-0716-1
"F1,H10",11972,12376,8998,3378,6541,0,3038,3045,2133,912,2.338815789,1513,1130,665,365,0,365,0,119,0,0.008219178,empty,mBC-0716-1
"F1,H11",14835,15168,11027,4141,8069,0,3752,3753,2604,1149,2.266318538,1853,90,46,32,0,32,0,16,0,0,empty,mBC-0716-1
"F1,H12",4984,5187,3812,1375,2849,0,1315,1316,927,389,2.383033419,639,540,359,172,0,172,0,62,0,0,empty,mBC-0716-1
"F2,A1",14147,14734,10481,4253,8275,0,4023,4044,2854,1190,2.398319328,2052,1255,825,420,0,420,0,130,0,0.057142857,empty,mBC-0716-1
"F2,A2",17728,17785,13638,4147,9594,0,4257,4260,3032,1228,2.469055375,1980,1682,1012,544,1,543,1,146,0,0.047882136,empty,mBC-0716-1
"F2,A3",15768,16304,12103,4201,8708,0,3965,3973,2805,1168,2.401541096,1900,910,611,297,0,297,0,80,0,0.117845118,empty,mBC-0716-1
"F2,A4",19498,20034,15077,4957,10423,0,4520,4525,3216,1309,2.45683728,2111,3003,1002,478,1,477,1,108,0,0.025157233,empty,mBC-0716-1
"F2,A5",15608,15957,11842,4115,8688,0,3981,3989,2755,1234,2.232576985,1934,1840,1103,551,1,550,1,136,0,0.023636364,empty,mBC-0716-1
"F2,A6",364083,372519,275833,96686,202698,1,92225,92400,73731,18669,3.949381327,44592,31700,21847,10568,7,10561,2,1436,0,0.0023672,mm10,mBC-0716-1
"F2,A7",14731,15028,11235,3793,8130,0,3727,3731,2626,1105,2.376470588,1775,1591,1038,520,0,520,0,151,0,0.051923077,empty,mBC-0716-1
"F2,A8",10329,10941,7825,3116,5744,0,2725,2739,1980,759,2.608695652,1336,4225,1764,888,0,888,0,203,0,0.131756757,empty,mBC-0716-1
"F2,A9",580343,579068,443847,135221,308438,0,133760,134012,104838,29174,3.593542195,61891,39936,23644,11198,9,11189,2,1437,0,0.009652337,mm10,mBC-0716-1
"F2,A10",14947,15396,11343,4053,8091,0,3632,3643,2516,1127,2.232475599,1790,1655,661,330,0,330,0,102,0,0.036363636,empty,mBC-0716-1
"F2,A11",16646,16852,12652,4200,9047,0,4096,4106,2866,1240,2.311290323,1901,3042,1426,670,1,669,1,151,0,0.058295964,empty,mBC-0716-1
"F2,A12",18447,18713,14052,4661,9786,0,4399,4404,3042,1362,2.233480176,2151,20093,6150,3069,2,3067,2,499,0,0.037495924,empty,mBC-0716-1
"F2,B1",17680,17886,13630,4256,9632,0,4302,4310,3045,1265,2.407114625,1936,1797,1162,611,0,611,0,149,0,0.063829787,empty,mBC-0716-1
"F2,B2",18471,18486,14272,4214,9790,0,4177,4186,2943,1243,2.36765889,1918,2029,791,371,0,371,0,80,0,0.043126685,empty,mBC-0716-1
"F2,B3",658214,716854,469077,247777,383147,1,212253,212537,163656,48881,3.348049344,115521,67812,47219,22201,7,22194,3,2183,0,0.001937461,mm10,mBC-0716-1
"F2,B4",879851,944941,631980,312961,495607,1,270296,270750,221377,49373,4.483766431,143723,72098,48422,22444,6,22438,1,2203,0,0.001381585,mm10,mBC-0716-1
"F2,B5",10005,6998,4725,2273,4574,1,2355,2371,1657,714,2.320728291,1279,780,464,238,1,237,1,77,0,0.008438819,empty,mBC-0716-1
"F2,B6",11121,11741,8441,3300,6195,0,2932,2935,2087,848,2.461084906,1451,1145,748,386,0,386,0,112,0,0.059585492,empty,mBC-0716-1
"F2,B7",15697,15935,11953,3982,8764,0,3880,3890,2770,1120,2.473214286,1861,2450,943,490,1,489,1,122,0,0.114519427,empty,mBC-0716-1
"F2,B8",650158,689287,483608,205679,366635,0,182287,182601,143690,38911,3.692786102,93379,129084,85011,39961,22,39939,2,3094,0,0.0068855,mm10,mBC-0716-1
"F2,B9",13306,13635,10098,3537,7292,0,3249,3252,2225,1027,2.166504382,1559,2031,840,446,0,446,0,104,0,0.038116592,empty,mBC-0716-1
"F2,B10",491363,497977,309516,188461,279803,3,168313,169150,123743,45407,2.725196556,95881,6899,3757,1718,2,1716,1,389,0,0.01048951,mm10,mBC-0716-1
"F2,B11",15330,15961,11654,4307,8448,0,3954,3966,2807,1159,2.421915444,1903,167,97,53,0,53,0,24,0,0,empty,mBC-0716-1
"F2,B12",16207,16342,12465,3877,8729,0,3953,3963,2772,1191,2.327455919,1783,1760,988,465,1,464,1,117,0,0.038793103,empty,mBC-0716-1
"F2,C1",20404,20583,15963,4620,10524,0,4463,4476,3173,1303,2.435149655,2035,1053,665,339,0,339,0,101,0,0.091445428,empty,mBC-0716-1
"F2,C2",587584,614862,423130,191732,331123,0,171422,171703,127771,43932,2.908381134,90531,39547,28569,13868,6,13862,3,1576,0,0.004472659,mm10,mBC-0716-1
"F2,C3",18891,19226,14311,4915,10206,0,4612,4616,3233,1383,2.337671728,2162,726,464,240,0,240,0,59,0,0.0125,empty,mBC-0716-1
"F2,C4",16524,16518,12577,3941,9189,0,4047,4061,2917,1144,2.549825175,1944,4497,1843,921,2,919,2,195,0,0.072905332,empty,mBC-0716-1
"F2,C5",15374,15594,11570,4024,8547,0,3926,3940,2810,1130,2.486725664,1912,793,463,232,0,232,0,83,0,0.068965517,empty,mBC-0716-1
"F2,C6",15743,15996,11850,4146,8803,0,4113,4121,2861,1260,2.270634921,1931,1439,922,460,0,460,0,132,0,0.036956522,empty,mBC-0716-1
"F2,C7",15662,16274,11776,4498,8595,0,4087,4092,2890,1202,2.404326123,2023,1892,771,384,0,384,0,90,0,0.072916667,empty,mBC-0716-1
"F2,C8",746218,802556,537993,264563,426636,0,227853,228175,197017,31158,6.323159381,121380,194443,120867,57937,23,57914,4,3653,0,0.012535829,mm10,mBC-0716-1
"F2,C9",11578,12332,8742,3590,6460,0,3113,3118,2219,899,2.468298109,1520,945,634,291,0,291,0,81,0,0.065292096,empty,mBC-0716-1
"F2,C10",12312,12463,9457,3006,6700,0,3039,3048,2119,929,2.280947255,1410,1131,687,364,0,364,0,117,0,0.14010989,empty,mBC-0716-1
"F2,C11",10636,11060,8077,2983,5759,0,2613,2623,1853,770,2.406493506,1249,913,536,254,0,254,0,85,0,0.031496063,empty,mBC-0716-1
"F2,C12",17212,17371,13083,4288,9927,0,4486,4502,3140,1362,2.305433186,2158,1539,953,458,0,458,0,120,0,0.093886463,empty,mBC-0716-1
"F2,D1",1454025,1587230,1009248,577982,844455,2,495157,495879,395989,99890,3.964250676,275128,104463,67370,31572,13,31559,2,2752,0,0.001584334,mm10,mBC-0716-1
"F2,D2",18991,19109,14703,4406,10171,0,4413,4419,3124,1295,2.412355212,2022,2874,1734,886,0,886,0,210,0,0.069977427,empty,mBC-0716-1
"F2,D3",13082,13629,10008,3621,7263,0,3409,3415,2401,1014,2.367850099,1642,1215,805,406,0,406,0,118,0,0.027093596,empty,mBC-0716-1
"F2,D4",13329,13992,10231,3761,7429,1,3405,3417,2413,1004,2.403386454,1669,1324,868,467,0,467,0,137,0,0.068522484,empty,mBC-0716-1
"F2,D5",13854,14191,10337,3854,7756,0,3641,3645,2677,968,2.765495868,1821,5788,2212,1049,1,1048,1,216,0,0.050572519,empty,mBC-0716-1
"F2,D6",11889,12399,8875,3524,6527,0,3056,3060,2098,962,2.180873181,1505,1485,958,470,1,469,1,140,0,0.031982942,empty,mBC-0716-1
"F2,D7",12411,12785,9392,3393,6837,0,3194,3200,2277,923,2.46695558,1546,2798,1523,717,1,716,1,170,0,0.12150838,empty,mBC-0716-1
"F2,D8",15472,16264,11716,4548,8564,0,3948,3956,2770,1186,2.335581788,1950,1356,892,409,0,409,0,128,0,0.107579462,empty,mBC-0716-1
"F2,D9",5614,6013,4114,1899,3250,0,1643,1644,1160,484,2.396694215,860,1702,1119,546,0,546,0,148,0,0.04029304,empty,mBC-0716-1
"F2,D10",12272,12505,9353,3152,6660,0,3037,3053,2117,936,2.261752137,1428,966,567,275,0,275,0,103,0,0.010909091,empty,mBC-0716-1
"F2,D11",12420,12751,9436,3315,6851,0,3120,3133,2168,965,2.246632124,1468,5446,2233,1155,0,1155,0,214,0,0.097835498,empty,mBC-0716-1
"F2,D12",19101,19628,14690,4938,10328,0,4675,4691,3378,1313,2.572734196,2241,1799,1165,535,0,535,0,169,0,0.03364486,empty,mBC-0716-1
"F2,E1",21054,21420,15976,5444,11357,0,5100,5114,3591,1523,2.357846356,2471,20115,6368,3266,3,3263,3,455,0,0.164878946,empty,mBC-0716-1
"F2,E2",617782,672506,443111,229395,362011,0,200737,201048,141839,59209,2.395564863,111161,13028,8455,3996,0,3996,0,687,0,0.013013013,mm10,mBC-0716-1
"F2,E3",729570,830770,495310,335460,439090,1,271847,272214,202159,70055,2.885718364,155802,199872,139587,66105,24,66081,4,3915,0,0.002905525,mm10,mBC-0716-1
"F2,E4",14001,14399,10814,3585,7623,0,3382,3385,2343,1042,2.248560461,1621,1649,990,480,0,480,0,145,0,0.120833333,empty,mBC-0716-1
"F2,E5",1235474,1358017,855352,502665,707190,1,421833,422497,333117,89380,3.726974715,232608,119457,84632,39643,13,39630,3,2834,0,0.001564471,mm10,mBC-0716-1
"F2,E6",12915,13057,9799,3258,6938,1,3088,3105,2175,930,2.338709677,1463,1754,1028,561,0,561,0,132,0,0.080213904,empty,mBC-0716-1
"F2,E7",12968,13244,9906,3338,7130,0,3215,3221,2284,937,2.437566702,1537,1409,860,444,0,444,0,130,0,0.033783784,empty,mBC-0716-1
"F2,E8",15922,15989,12357,3632,8669,0,3737,3750,2749,1001,2.746253746,1655,1970,1295,659,0,659,0,187,0,0.08952959,empty,mBC-0716-1
"F2,E9",8589,9000,6533,2467,4921,0,2301,2311,1597,714,2.236694678,1136,1120,671,348,0,348,0,95,0,0.08908046,empty,mBC-0716-1
"F2,E10",884710,1017895,597966,419929,537414,0,342907,343303,234982,108321,2.169311583,199874,52866,37062,17636,2,17634,2,1776,0,0.001020755,mm10,mBC-0716-1
"F2,E11",8894,9222,6805,2417,5042,0,2306,2310,1593,717,2.221757322,1115,1268,820,412,0,412,0,107,0,0.019417476,empty,mBC-0716-1
"F2,E12",14086,14821,10586,4235,7976,0,3768,3782,2590,1192,2.172818792,1876,1444,874,440,0,440,0,110,0,0.054545455,empty,mBC-0716-1
"F2,F1",16253,16785,12429,4356,8804,0,3899,3910,2680,1230,2.178861789,1832,1555,981,466,0,466,0,122,0,0.124463519,empty,mBC-0716-1
"F2,F2",21089,21962,15899,6063,11919,2,5610,5629,3992,1637,2.438607208,2804,2914,1877,964,0,964,0,244,0,0.081950207,empty,mBC-0716-1
"F2,F3",15752,16319,11807,4512,8770,0,4228,4236,2957,1279,2.311962471,2069,1494,914,511,0,511,0,164,0,0.080234834,empty,mBC-0716-1
"F2,F4",16964,17228,12703,4525,9453,0,4315,4319,3070,1249,2.457966373,2115,599,373,222,0,222,0,78,0,0.013513514,empty,mBC-0716-1
"F2,F5",1469398,1601380,1016182,585198,835077,2,488997,489777,375877,113900,3.300061457,272086,166689,117562,55257,18,55239,2,3887,0,0.000543095,mm10,mBC-0716-1
"F2,F6",467823,470233,355916,114317,254093,1,111407,111597,84829,26768,3.169045129,53459,45437,29541,14338,6,14332,2,1621,0,0.015350265,mm10,mBC-0716-1
"F2,F7",18079,18767,14074,4693,10262,0,4550,4561,3250,1311,2.479023646,2146,4260,1558,782,1,781,1,178,0,0.053777209,empty,mBC-0716-1
"F2,F8",21586,22133,16369,5764,11966,0,5595,5613,3949,1664,2.373197115,2706,321,184,112,1,111,1,58,0,0,empty,mBC-0716-1
"F2,F9",15399,15417,11540,3877,8511,0,3901,3908,2774,1134,2.446208113,1816,5992,2652,1372,0,1372,0,255,0,0.233965015,empty,mBC-0716-1
"F2,F10",19709,19868,15045,4823,10747,0,4773,4783,3364,1419,2.37068358,2137,1659,1130,616,0,616,0,141,0,0.099025974,empty,mBC-0716-1
"F2,F11",10621,10943,8224,2719,5826,0,2577,2580,1833,747,2.453815261,1175,1319,848,395,0,395,0,134,0,0.053164557,empty,mBC-0716-1
"F2,F12",13176,13400,9964,3436,7174,0,3358,3371,2309,1062,2.174199623,1613,543,164,85,0,85,0,23,0,0.223529412,empty,mBC-0716-1
"F2,G1",9405,9479,7162,2317,5005,0,2240,2246,1564,682,2.293255132,999,22093,6807,3398,3,3395,2,524,0,0.050662739,empty,mBC-0716-1
"F2,G2",18668,19055,14405,4650,10099,0,4478,4485,3194,1291,2.474051123,2159,2275,687,342,0,342,0,105,0,0.043859649,empty,mBC-0716-1
"F2,G3",20446,21295,15246,6049,11416,0,5365,5371,3763,1608,2.340174129,2690,2882,1475,804,0,804,0,204,0,0.027363184,empty,mBC-0716-1
"F2,G4",26379,26463,20102,6361,14365,0,6356,6373,4599,1774,2.592446449,2958,91,59,42,0,42,0,23,0,0,empty,mBC-0716-1
"F2,G5",12536,12907,9490,3417,6968,0,3220,3229,2247,982,2.288187373,1577,2911,1283,612,1,611,1,159,0,0.052373159,empty,mBC-0716-1
"F2,G6",1705650,1804994,1248070,556924,930016,2,492305,493123,400218,92905,4.307819816,253979,9700,6790,3302,2,3300,1,549,0,0.002121212,mm10,mBC-0716-1
"F2,G7",18716,18987,14529,4458,10320,0,4552,4560,3270,1290,2.534883721,2037,2116,1265,640,0,640,0,173,0,0.0484375,empty,mBC-0716-1
"F2,G8",378763,375622,293445,82177,204136,0,81224,81388,64783,16605,3.901415236,37434,53323,30897,14972,2,14970,2,1812,0,0.018102872,mm10,mBC-0716-1
"F2,G9",12092,12446,9049,3397,6814,0,3310,3318,2317,1001,2.314685315,1622,4974,2483,1218,1,1217,1,229,0,0.072308956,empty,mBC-0716-1
"F2,G10",12436,12814,9708,3106,6814,0,3024,3040,2121,919,2.307943417,1411,1747,1178,600,0,600,0,164,0,0.075,empty,mBC-0716-1
"F2,G11",13157,13507,10099,3408,7163,0,3149,3164,2319,845,2.744378698,1489,971,573,284,0,284,0,99,0,0,empty,mBC-0716-1
"F2,G12",10486,11006,7900,3106,5875,0,2760,2766,1945,821,2.369062119,1320,1570,1039,490,0,490,0,129,0,0.012244898,empty,mBC-0716-1
"F2,H1",20447,21123,15348,5775,11662,0,5534,5553,3968,1585,2.503470032,2702,967,558,275,0,275,0,98,0,0.036363636,empty,mBC-0716-1
"F2,H2",21035,21754,16115,5639,11443,0,5169,5193,3724,1469,2.535057862,2500,2764,1743,836,1,835,1,185,0,0.044311377,empty,mBC-0716-1
"F2,H3",21271,21784,16090,5694,11489,0,5266,5276,3778,1498,2.522029372,2476,4080,1808,923,0,923,0,207,0,0.041170098,empty,mBC-0716-1
"F2,H4",12944,13432,9821,3611,7312,0,3453,3454,2442,1012,2.413043478,1720,659,231,109,0,109,0,19,0,0.100917431,empty,mBC-0716-1
"F2,H5",17254,18008,13081,4927,9509,0,4448,4471,3195,1276,2.503918495,2195,1767,1124,601,1,600,1,153,0,0.06,empty,mBC-0716-1
"F2,H6",13837,14424,10509,3915,7787,0,3651,3660,2623,1037,2.529411765,1798,1950,1182,625,0,625,0,174,0,0.0368,empty,mBC-0716-1
"F2,H7",16159,16721,12202,4519,9157,0,4271,4284,3003,1281,2.344262295,2067,2111,1024,519,0,519,0,167,0,0.04238921,empty,mBC-0716-1
"F2,H8",13484,13836,10069,3767,7292,0,3403,3416,2394,1022,2.342465753,1655,1747,1178,602,0,602,0,149,0,0.058139535,empty,mBC-0716-1
"F2,H9",14973,14980,11265,3715,8303,0,3828,3830,2783,1047,2.658070678,1785,13866,4814,2298,0,2298,0,387,0,0.080504787,empty,mBC-0716-1
"F2,H10",13785,14349,10378,3971,7569,0,3567,3576,2498,1078,2.317254174,1746,1095,747,347,0,347,0,111,0,0.014409222,empty,mBC-0716-1
"F2,H11",792766,831148,590535,240613,436898,1,214459,214828,183409,31419,5.837518699,108181,6686,4221,1956,0,1956,0,329,0,0,mm10,mBC-0716-1
"F2,H12",5902,6168,4425,1743,3360,0,1599,1607,1135,472,2.404661017,784,893,576,289,0,289,0,74,0,0.048442907,empty,mBC-0716-1
"F3,A1",15870,16417,12133,4284,9159,0,4366,4374,3134,1240,2.527419355,2112,1405,792,437,1,436,1,121,0,0.075688073,empty,mBC-0716-1
"F3,A2",20361,20835,15799,5036,11170,0,5019,5028,3572,1456,2.453296703,2310,1506,941,467,0,467,0,136,0,0.066381156,empty,mBC-0716-1
"F3,A3",17792,19063,13513,5550,10132,0,4869,4877,3385,1492,2.268766756,2460,963,618,338,0,338,0,131,0,0.026627219,empty,mBC-0716-1
"F3,A4",21549,21928,16706,5222,11671,0,5026,5049,3553,1496,2.375,2358,3701,1309,669,1,668,1,154,0,0.04491018,empty,mBC-0716-1
"F3,A5",17234,18075,13229,4846,9687,0,4429,4434,3059,1375,2.224727273,2117,1505,973,517,1,516,1,136,0,0.065891473,empty,mBC-0716-1
"F3,A6",15854,16398,12036,4362,8946,0,4238,4246,3062,1184,2.586148649,2115,2220,1451,712,0,712,0,188,0,0.03511236,empty,mBC-0716-1
"F3,A7",613579,637970,446997,190973,344127,1,178805,179097,144344,34753,4.153425604,92101,8702,6313,2971,0,2971,0,625,0,0.007068327,mm10,mBC-0716-1
"F3,A8",12113,13068,9161,3907,6923,0,3372,3380,2342,1038,2.256262042,1715,13563,4454,2255,2,2253,2,412,0,0.07723036,empty,mBC-0716-1
"F3,A9",572468,576645,430941,145704,309564,1,143154,143438,111888,31550,3.54637084,68857,18405,9562,4600,4,4596,2,813,0,0.039382071,mm10,mBC-0716-1
"F3,A10",18203,18582,13882,4700,10210,0,4581,4591,3240,1351,2.398223538,2214,306,172,109,0,109,0,57,0,0.027522936,empty,mBC-0716-1
"F3,A11",18914,19354,14499,4855,10356,0,4630,4635,3277,1358,2.413107511,2161,1425,715,360,0,360,0,118,0,0.063888889,empty,mBC-0716-1
"F3,A12",20683,21299,15730,5569,11278,0,5006,5012,3514,1498,2.345794393,2454,25193,7945,3881,4,3877,2,578,0,0.066546299,empty,mBC-0716-1
"F3,B1",19087,18899,14683,4216,10136,0,4400,4417,3096,1321,2.343679031,1962,1230,770,390,1,389,1,130,0,0.010282776,empty,mBC-0716-1
"F3,B2",1120297,1179669,831226,348443,612100,1,305772,306287,241693,64594,3.741725238,155748,29210,20459,9852,2,9850,1,1217,0,0.000812183,mm10,mBC-0716-1
"F3,B3",20258,21010,15484,5526,11338,0,5261,5282,3736,1546,2.416558862,2520,1341,838,448,0,448,0,142,0,0.037946429,empty,mBC-0716-1
"F3,B4",17007,17513,13034,4479,9502,1,4335,4348,3083,1265,2.43715415,2119,1298,758,379,0,379,0,119,0,0.058047493,empty,mBC-0716-1
"F3,B5",530278,356334,211884,144450,244237,7,149034,149693,112125,37568,2.984587947,88643,44781,31598,14929,4,14925,1,1707,0,0.003953099,mm10,mBC-0716-1
"F3,B6",12431,13087,9450,3637,7105,0,3352,3357,2371,986,2.404665314,1657,1205,732,334,0,334,0,96,0,0.053892216,empty,mBC-0716-1
"F3,B7",16596,17265,12798,4467,9119,0,4117,4127,2898,1229,2.358014646,1922,1039,600,326,0,326,0,105,0,0.021472393,empty,mBC-0716-1
"F3,B8",479929,488888,367329,121559,265008,1,120367,120580,95687,24893,3.843932029,57389,10868,6368,3139,1,3138,1,589,0,0.033142129,mm10,mBC-0716-1
"F3,B9",15410,16024,11914,4110,8626,0,3911,3927,2770,1157,2.394122731,1937,1929,831,435,0,435,0,108,0,0.103448276,empty,mBC-0716-1
"F3,B10",632219,633280,416084,217196,349605,2,187600,188569,143794,44775,3.21147962,103360,38845,28151,13434,6,13428,1,1431,0,0.001563896,mm10,mBC-0716-1
"F3,B11",17208,18048,13228,4820,9659,0,4448,4459,3173,1286,2.467340591,2126,207,148,103,0,103,0,45,0,0,empty,mBC-0716-1
"F3,B12",18759,19233,14407,4826,10266,0,4675,4682,3286,1396,2.353868195,2175,1712,884,448,0,448,0,150,0,0.020089286,empty,mBC-0716-1
"F3,C1",22460,22951,17422,5529,12104,0,5183,5187,3674,1513,2.428288169,2463,816,498,244,0,244,0,83,0,0.045081967,empty,mBC-0716-1
"F3,C2",20710,21353,15715,5638,11353,0,5243,5251,3803,1448,2.626381215,2529,3185,1554,789,0,789,0,200,0,0.053231939,empty,mBC-0716-1
"F3,C3",20860,21798,15893,5905,11459,0,5324,5331,3680,1651,2.22895215,2554,728,385,190,1,189,1,71,0,0.063492063,empty,mBC-0716-1
"F3,C4",18941,19191,14476,4715,10326,0,4568,4583,3242,1341,2.417598807,2129,1193,693,391,0,391,0,132,0,0.132992327,empty,mBC-0716-1
"F3,C5",16484,16552,12515,4037,9096,0,4122,4137,2927,1210,2.419008264,1933,1149,713,349,0,349,0,104,0,0.088825215,empty,mBC-0716-1
"F3,C6",18518,19065,13736,5329,10597,0,5004,5006,3649,1357,2.689019897,2474,1727,1074,558,0,558,0,209,0,0.05734767,empty,mBC-0716-1
"F3,C7",17385,17976,13185,4791,9660,0,4381,4396,3071,1325,2.317735849,2128,550,368,188,0,188,0,57,0,0,empty,mBC-0716-1
"F3,C8",720498,758653,536990,221663,405431,0,198585,198913,165031,33882,4.870757334,100618,138300,87549,42687,14,42673,2,3218,0,0.0068193,mm10,mBC-0716-1
"F3,C9",13846,14176,10368,3808,7491,0,3559,3572,2517,1055,2.385781991,1742,7644,2506,1263,1,1262,1,217,0,0.072900158,empty,mBC-0716-1
"F3,C10",14148,14745,10837,3908,7869,0,3559,3570,2460,1110,2.216216216,1729,1052,702,378,0,378,0,112,0,0.002645503,empty,mBC-0716-1
"F3,C11",12079,12773,9140,3633,6831,1,3252,3263,2269,994,2.282696177,1642,1209,776,363,0,363,0,101,0,0,empty,mBC-0716-1
"F3,C12",2211849,2388555,1603809,784746,1220728,9,673384,674409,541933,132476,4.090801353,360724,149426,104266,49863,19,49844,2,3566,0,0.000983067,mm10,mBC-0716-1
"F3,D1",12684,13145,9540,3605,7127,0,3406,3415,2430,985,2.467005076,1661,571,358,178,0,178,0,48,0,0.095505618,empty,mBC-0716-1
"F3,D2",20601,20827,15929,4898,11213,0,4775,4782,3360,1422,2.362869198,2249,5164,2322,1167,1,1166,1,287,0,0.060891938,empty,mBC-0716-1
"F3,D3",14347,14883,10599,4284,8114,0,3869,3875,2782,1093,2.545288198,1933,1145,597,347,0,347,0,120,0,0.080691643,empty,mBC-0716-1
"F3,D4",15457,16231,11861,4370,8727,0,3981,3987,2853,1134,2.515873016,1921,3663,1573,825,0,825,0,230,0,0.04,empty,mBC-0716-1
"F3,D5",14827,15240,11345,3895,8248,0,3863,3873,2784,1089,2.556473829,1836,1527,946,496,0,496,0,165,0,0.032258065,empty,mBC-0716-1
"F3,D6",13523,14046,10443,3603,7474,0,3442,3452,2435,1017,2.394296952,1604,1222,810,430,1,429,1,133,0,0.079254079,empty,mBC-0716-1
"F3,D7",14338,14805,10789,4016,8082,0,3815,3818,2686,1132,2.372791519,1876,1404,950,480,0,480,0,147,0,0.06875,empty,mBC-0716-1
"F3,D8",16148,16760,12165,4595,9142,0,4294,4309,2958,1351,2.189489267,2181,1080,705,373,0,373,0,116,0,0.085790885,empty,mBC-0716-1
"F3,D9",6278,6567,4632,1935,3679,0,1843,1845,1352,493,2.742393509,940,1286,760,378,0,378,0,126,0,0.018518519,empty,mBC-0716-1
"F3,D10",15849,16744,11999,4745,9111,0,4273,4279,3114,1165,2.672961373,2156,886,494,269,0,269,0,88,0,0.074349442,empty,mBC-0716-1
"F3,D11",13638,13970,10411,3559,7517,0,3502,3507,2447,1060,2.308490566,1652,1626,1045,542,0,542,0,158,0,0.086715867,empty,mBC-0716-1
"F3,D12",20394,21021,15522,5499,11284,0,5203,5214,3627,1587,2.285444234,2513,2120,1264,652,0,652,0,206,0,0.033742331,empty,mBC-0716-1
"F3,E1",23737,24197,18131,6066,12937,0,5743,5757,4257,1500,2.838,2673,1966,1122,623,0,623,0,199,0,0.109149278,empty,mBC-0716-1
"F3,E2",17359,17863,13283,4580,9590,0,4373,4388,3083,1305,2.362452107,2095,1636,988,508,0,508,0,146,0,0.057086614,empty,mBC-0716-1
"F3,E3",12427,12641,9660,2981,6756,0,2981,2991,2126,865,2.457803468,1352,1367,847,456,1,455,1,148,0,0.035164835,empty,mBC-0716-1
"F3,E4",670483,731255,488832,242423,390610,0,212203,212567,163022,49545,3.290382481,113715,43499,30508,14705,3,14702,1,1709,0,0.001904503,mm10,mBC-0716-1
"F3,E5",878463,919595,662635,256960,484130,2,229338,229781,200838,28943,6.939087171,113488,113290,81410,38996,15,38981,2,2897,0,0.000487417,mm10,mBC-0716-1
"F3,E6",33461,36286,25774,10512,19158,0,9509,9532,7020,2512,2.794585987,4800,16860,5492,2737,2,2735,2,440,0,0.043510055,empty,mBC-0716-1
"F3,E7",14522,14659,11003,3656,7939,0,3475,3492,2423,1069,2.266604303,1680,1585,978,473,0,473,0,143,0,0.063424947,empty,mBC-0716-1
"F3,E8",694781,743133,520491,222642,395682,0,193828,194175,155241,38934,3.987286177,99536,201429,145851,69303,24,69279,1,4007,0,0.000505204,mm10,mBC-0716-1
"F3,E9",10178,10397,7704,2693,5505,0,2517,2525,1782,743,2.398384926,1162,1155,749,367,0,367,0,123,0,0.013623978,empty,mBC-0716-1
"F3,E10",783384,852890,573779,279111,452277,0,238119,238476,198140,40336,4.912237207,126597,129806,91839,43879,12,43867,2,3085,0,0.001755306,mm10,mBC-0716-1
"F3,E11",9691,9900,7365,2535,5470,3,2468,2478,1747,731,2.389876881,1163,2724,1064,523,0,523,0,141,0,0.066921606,empty,mBC-0716-1
"F3,E12",16007,16642,12193,4449,8961,0,4218,4225,2967,1258,2.358505564,2044,1330,807,431,0,431,0,131,0,0.122969838,empty,mBC-0716-1
"F3,F1",18216,18335,14037,4298,9786,0,4318,4324,2993,1331,2.248685199,2001,1965,1054,528,0,528,0,125,0,0.125,empty,mBC-0716-1
"F3,F2",33651,35752,23448,12304,19216,0,10306,10331,5396,4935,1.093414387,5670,14281,4910,2469,2,2467,1,466,0,0.026347791,empty,mBC-0716-1
"F3,F3",672780,727013,489688,237325,390479,1,206969,207284,158702,48582,3.266683134,110246,66838,47391,22038,11,22027,1,2195,0,0.000862578,mm10,mBC-0716-1
"F3,F4",19064,19671,14308,5363,10636,0,4948,4967,3578,1389,2.575953924,2442,754,504,293,0,293,0,104,0,0.037542662,empty,mBC-0716-1
"F3,F5",24925,25550,18959,6591,13510,0,6129,6138,4260,1878,2.268370607,2948,1858,1167,600,0,600,0,195,0,0.028333333,empty,mBC-0716-1
"F3,F6",3573313,3742545,2634457,1108088,1869828,7,1020563,1022137,779210,242927,3.207589111,522636,181800,120957,57283,14,57269,1,4301,0,0.001519146,mm10,mBC-0716-1
"F3,F7",46374,50253,33942,16311,27086,0,14536,14562,10342,4220,2.4507109,7526,4176,1798,872,0,872,0,230,0,0.066513761,empty,mBC-0716-1
"F3,F8",851049,893010,634877,258133,469839,2,228995,229395,196876,32519,6.054183708,115237,15298,10444,4994,2,4992,1,772,0,0,mm10,mBC-0716-1
"F3,F9",17210,17330,12773,4557,9160,0,4226,4243,2957,1286,2.299377916,2000,47832,15360,7836,10,7826,3,1026,0,0.101584462,empty,mBC-0716-1
"F3,F10",988505,1033530,744650,288880,540743,6,260350,260880,227438,33442,6.800968842,129356,113282,80117,38180,21,38159,3,3010,0,0.001257895,mm10,mBC-0716-1
"F3,F11",11943,12245,9123,3122,6594,0,2963,2970,2085,885,2.355932203,1391,973,666,364,0,364,0,128,0,0.013736264,empty,mBC-0716-1
"F3,F12",14314,14671,10915,3756,7809,0,3633,3637,2516,1121,2.244424621,1699,114,89,55,0,55,0,13,0,0.218181818,empty,mBC-0716-1
"F3,G1",593552,635875,445954,189921,341606,0,171840,172130,142979,29151,4.904771706,87720,103544,70347,33862,13,33849,1,2709,0,0.000679488,mm10,mBC-0716-1
"F3,G2",1239078,1346640,865684,480956,696578,2,404608,405141,351327,53814,6.528542758,218649,21765,14372,6924,6,6918,1,977,0,0.000722752,mm10,mBC-0716-1
"F3,G3",20897,21320,15730,5590,11380,0,5250,5262,3741,1521,2.459566075,2538,15199,5162,2552,5,2547,2,480,0,0.02552022,empty,mBC-0716-1
"F3,G4",915509,972191,675200,296991,512616,2,260352,260803,222793,38010,5.861431202,134387,1042,769,391,0,391,0,96,0,0.023017903,empty,mBC-0716-1
"F3,G5",13521,13898,10364,3534,7426,0,3393,3395,2340,1055,2.218009479,1648,984,663,338,1,337,1,107,0,0.133531157,empty,mBC-0716-1
"F3,G6",25091,25562,19433,6129,13806,0,6085,6101,4286,1815,2.361432507,2798,150,92,56,0,56,0,26,0,0,empty,mBC-0716-1
"F3,G7",21599,21820,16184,5636,11403,0,5080,5087,3557,1530,2.324836601,2368,52875,15943,8109,11,8098,5,979,0,0.120894048,empty,mBC-0716-1
"F3,G8",15487,16178,11824,4354,8554,0,4055,4068,2830,1238,2.285945073,1975,2710,1329,715,1,714,1,207,0,0.072829132,empty,mBC-0716-1
"F3,G9",764556,821547,557894,263653,433286,1,226285,226626,188407,38219,4.929668489,119094,163234,103338,49258,35,49223,4,3397,0,0.002397253,mm10,mBC-0716-1
"F3,G10",13819,14141,10579,3562,7595,0,3414,3417,2413,1004,2.403386454,1637,1496,1055,593,0,593,0,170,0,0.097807757,empty,mBC-0716-1
"F3,G11",897396,1024636,600667,423969,540890,2,338117,338563,273362,65201,4.192604408,195909,85842,60709,27988,12,27976,3,2389,0,0.001143838,mm10,mBC-0716-1
"F3,G12",12048,12508,8998,3510,6771,0,3170,3181,2273,908,2.503303965,1597,8133,2772,1342,1,1341,1,276,0,0.01715138,empty,mBC-0716-1
"F3,H1",1431881,1565215,1002046,563169,829224,1,483838,484508,400222,84286,4.748380514,267061,62026,43115,20343,6,20337,1,2073,0,0.00201603,mm10,mBC-0716-1
"F3,H2",24938,25418,19287,6131,13288,0,5930,5943,4217,1726,2.443221321,2733,2125,1394,655,0,655,0,186,0,0.039694656,empty,mBC-0716-1
"F3,H3",21147,21761,16129,5632,11692,0,5376,5386,3841,1545,2.486084142,2671,1419,887,482,1,481,1,155,0,0.027027027,empty,mBC-0716-1
"F3,H4",14444,15258,10955,4303,8176,0,3840,3844,2730,1114,2.450628366,1906,89,72,43,0,43,0,26,0,0,empty,mBC-0716-1
"F3,H5",22724,24201,17373,6828,12821,0,6213,6223,4444,1779,2.498032603,3091,2107,1201,643,0,643,0,183,0,0.062208398,empty,mBC-0716-1
"F3,H6",15945,16738,12060,4678,9117,0,4263,4273,3113,1160,2.68362069,2102,8559,3203,1635,3,1632,1,340,0,0.034313725,empty,mBC-0716-1
"F3,H7",19183,20009,14323,5686,10747,0,5071,5078,3660,1418,2.581100141,2505,1688,1081,556,0,556,0,161,0,0.055755396,empty,mBC-0716-1
"F3,H8",14984,15541,11372,4169,8364,0,3931,3934,2852,1082,2.635859519,1912,1643,1073,562,0,562,0,178,0,0.026690391,empty,mBC-0716-1
"F3,H9",17000,17430,12808,4622,9365,0,4332,4340,3119,1221,2.554463554,2109,3112,1468,798,2,796,1,186,0,0.109296482,empty,mBC-0716-1
"F3,H10",1268461,1386000,915560,470440,728950,0,401566,402174,305513,96661,3.160664591,218850,106471,73225,35325,10,35315,1,2849,0,0.001868894,mm10,mBC-0716-1
"F3,H11",668669,763732,454843,308889,412374,0,255776,256116,199809,56307,3.548564122,147511,2247,1489,738,0,738,0,155,0,0,empty,mBC-0716-1
"F3,H12",6441,6905,4839,2066,3813,0,1739,1741,1221,520,2.348076923,894,500,302,189,0,189,0,67,0,0.111111111,empty,mBC-0716-1
"F4,A1",14954,15349,11246,4103,8387,0,4020,4022,2774,1248,2.22275641,1971,928,595,349,0,349,0,117,0,0.020057307,empty,mBC-0716-1
"F4,A2",19624,19834,15078,4756,10565,0,4708,4717,3333,1384,2.408236994,2152,1220,784,382,0,382,0,119,0,0.115183246,empty,mBC-0716-1
"F4,A3",16958,17447,12856,4591,9401,0,4387,4396,3094,1302,2.376344086,2073,1272,888,428,0,428,0,123,0,0.028037383,empty,mBC-0716-1
"F4,A4",2280495,2413052,1688086,724966,1199257,0,615902,616961,522430,94531,5.526546847,316192,69236,48066,22684,10,22674,2,2180,0,0.001543618,mm10,mBC-0716-1
"F4,A5",16956,17554,12993,4561,9370,1,4258,4266,2961,1305,2.268965517,2049,1274,744,400,0,400,0,128,0,0.08,empty,mBC-0716-1
"F4,A6",13490,14118,10244,3874,7490,0,3501,3515,2509,1006,2.494035785,1727,1264,684,391,0,391,0,139,0,0.132992327,empty,mBC-0716-1
"F4,A7",788956,838074,584173,253901,440111,1,219638,220015,185846,34169,5.439023676,112360,115604,85083,40979,17,40962,2,2916,0,0.001098579,mm10,mBC-0716-1
"F4,A8",11935,12492,9014,3478,6774,0,3171,3173,2287,886,2.581264108,1613,3416,1303,702,0,702,0,198,0,0.028490028,empty,mBC-0716-1
"F4,A9",19280,19334,15066,4268,10114,0,4246,4259,3042,1217,2.499589154,1872,1081,683,327,0,327,0,97,0,0.137614679,empty,mBC-0716-1
"F4,A10",17471,18199,13116,5083,9666,0,4588,4590,3094,1496,2.068181818,2229,303,200,131,0,131,0,48,0,0.007633588,empty,mBC-0716-1
"F4,A11",655661,685241,484811,200430,363631,3,180510,180795,149783,31012,4.829840062,91228,65501,36770,17881,9,17872,4,1912,0,0.006378693,mm10,mBC-0716-1
"F4,A12",20719,20905,15976,4929,10858,0,4640,4644,3290,1354,2.429837518,2068,2155,1431,695,0,695,0,173,0,0.061870504,empty,mBC-0716-1
"F4,B1",1013609,1113685,707027,406658,577644,0,332864,333312,287548,45764,6.283279434,182882,90352,64787,31238,9,31229,1,2561,0,0.001248839,mm10,mBC-0716-1
"F4,B2",21386,21749,16231,5518,11329,1,5052,5066,3506,1560,2.247435897,2404,981,457,231,0,231,0,59,0,0.008658009,empty,mBC-0716-1
"F4,B3",913281,983211,656873,326338,514609,1,279576,279994,208561,71433,2.91967298,150575,61357,41635,19610,4,19606,2,1970,0,0.001530144,mm10,mBC-0716-1
"F4,B4",17351,18114,13389,4725,9460,0,4298,4304,3008,1296,2.320987654,2064,1093,772,386,0,386,0,105,0,0.069948187,empty,mBC-0716-1
"F4,B5",981569,597036,398101,198935,405871,8,209476,210723,171449,39274,4.365458064,118365,79874,54808,26090,16,26074,2,2458,0,0.003988648,mm10,mBC-0716-1
"F4,B6",12706,13107,9693,3414,7074,0,3254,3263,2287,976,2.343237705,1538,824,525,292,0,292,0,96,0,0.058219178,empty,mBC-0716-1
"F4,B7",16952,17646,13087,4559,9254,0,4162,4169,2913,1256,2.319267516,2031,1460,643,317,0,317,0,105,0,0.028391167,empty,mBC-0716-1
"F4,B8",14221,14134,10869,3265,7473,0,3322,3331,2340,991,2.361251261,1507,1094,763,380,1,379,1,133,0,0.050131926,empty,mBC-0716-1
"F4,B9",15370,16060,11818,4242,8412,0,3845,3851,2677,1174,2.280238501,1900,361,226,103,0,103,0,52,0,0.038834951,empty,mBC-0716-1
"F4,B10",503302,473931,336976,136955,264915,4,130430,131317,99490,31827,3.125962233,67525,4477,2395,1162,1,1161,1,260,0,0.035314384,mm10,mBC-0716-1
"F4,B11",1090460,1093074,830045,263029,572692,3,255482,255976,193392,62584,3.09011888,121072,3396,2019,933,1,932,1,199,0,0.002145923,empty,mBC-0716-1
"F4,B12",19354,20034,14730,5304,10624,0,4869,4883,3421,1462,2.33994528,2389,1181,778,381,0,381,0,122,0,0.057742782,empty,mBC-0716-1
"F4,C1",24011,23910,18601,5309,12546,1,5314,5323,3737,1586,2.356242119,2380,705,398,205,0,205,0,87,0,0.063414634,empty,mBC-0716-1
"F4,C2",19980,20630,14971,5659,11006,0,5128,5143,3642,1501,2.426382412,2538,5035,2073,1060,1,1059,1,262,0,0.056657224,empty,mBC-0716-1
"F4,C3",23497,24155,17717,6438,12971,0,5982,5988,4157,1831,2.270344074,2955,394,195,126,0,126,0,58,0,0.047619048,empty,mBC-0716-1
"F4,C4",898008,965707,635538,330169,507759,0,280456,280834,230649,50185,4.595974893,151277,86876,59746,28656,13,28643,3,2488,0,0.000558601,mm10,mBC-0716-1
"F4,C5",684918,722762,484941,237821,388120,2,215562,215851,169376,46475,3.644454008,115672,8324,4547,2246,0,2246,0,470,0,0.011576135,mm10,mBC-0716-1
"F4,C6",18088,18190,13491,4699,9931,0,4579,4601,3258,1343,2.425912137,2169,2678,1225,610,0,610,0,163,0,0.090163934,empty,mBC-0716-1
"F4,C7",614799,651609,446106,205503,348364,0,183806,184119,131677,52442,2.510907288,98184,5192,2790,1335,0,1335,0,269,0,0.009737828,mm10,mBC-0716-1
"F4,C8",16076,16382,12151,4231,8832,0,4133,4143,2914,1229,2.37103336,2023,1490,984,521,0,521,0,145,0,0.034548944,empty,mBC-0716-1
"F4,C9",14318,14967,10715,4252,7912,0,3738,3740,2620,1120,2.339285714,1867,4430,1564,809,0,809,0,168,0,0.021013597,empty,mBC-0716-1
"F4,C10",14255,14654,10941,3713,7837,0,3539,3544,2481,1063,2.333960489,1691,1007,636,321,0,321,0,87,0,0.018691589,empty,mBC-0716-1
"F4,C11",12002,12103,9075,3028,6509,0,3032,3036,2119,917,2.310796074,1403,643,424,237,0,237,0,82,0,0.016877637,empty,mBC-0716-1
"F4,C12",20847,21359,15780,5579,11273,0,5077,5089,3562,1527,2.332678454,2418,998,565,292,0,292,0,91,0,0,empty,mBC-0716-1
"F4,D1",12253,12743,9008,3735,6894,0,3275,3281,2252,1029,2.188532556,1647,1131,474,247,0,247,0,82,0,0.028340081,empty,mBC-0716-1
"F4,D2",21665,21915,16714,5201,11569,0,5023,5033,3542,1491,2.375586854,2290,2575,1496,776,0,776,0,224,0,0.048969072,empty,mBC-0716-1
"F4,D3",14523,15060,11003,4057,8071,0,3792,3801,2694,1107,2.433604336,1843,1279,693,386,0,386,0,111,0,0.183937824,empty,mBC-0716-1
"F4,D4",831439,891219,602505,288714,468276,1,248779,249189,212794,36395,5.846792142,131289,86815,59310,28333,10,28323,1,2512,0,0.001730043,mm10,mBC-0716-1
"F4,D5",892092,965921,630953,334968,509051,2,287371,287758,234474,53284,4.400457924,155977,78096,53076,24852,10,24842,3,2306,0,0.004146204,mm10,mBC-0716-1
"F4,D6",14107,14426,10495,3931,7729,0,3603,3606,2522,1084,2.326568266,1775,944,632,349,0,349,0,117,0,0.017191977,empty,mBC-0716-1
"F4,D7",13814,14145,10525,3620,7550,0,3482,3487,2448,1039,2.356111646,1650,1331,786,425,0,425,0,148,0,0.011764706,empty,mBC-0716-1
"F4,D8",16816,17073,12815,4258,9039,0,4113,4121,2836,1285,2.207003891,1958,700,409,231,0,231,0,104,0,0.021645022,empty,mBC-0716-1
"F4,D9",174456,191259,118703,72556,104916,0,61081,61176,47818,13358,3.579727504,34618,64268,43697,20582,8,20574,3,2170,0,0.002624672,mm10,mBC-0716-1
"F4,D10",14827,15660,11353,4307,8343,0,3920,3926,2708,1218,2.223316913,1956,775,524,276,0,276,0,92,0,0.010869565,empty,mBC-0716-1
"F4,D11",14448,14782,10751,4031,7960,0,3684,3691,2560,1131,2.263483643,1751,17586,5303,2511,2,2509,2,441,0,0.036667995,empty,mBC-0716-1
"F4,D12",21367,21572,16219,5353,11435,0,5253,5261,3702,1559,2.374599102,2437,1689,1067,557,0,557,0,162,0,0.0502693,empty,mBC-0716-1
"F4,E1",23175,23711,17680,6031,12596,0,5637,5647,3984,1663,2.395670475,2678,1148,699,365,0,365,0,164,0,0.019178082,empty,mBC-0716-1
"F4,E2",17464,17631,13368,4263,9621,0,4357,4378,3123,1255,2.488446215,2059,1445,702,372,0,372,0,135,0,0.051075269,empty,mBC-0716-1
"F4,E3",12874,13217,9805,3412,7012,0,3128,3135,2181,954,2.286163522,1449,1344,846,434,0,434,0,152,0,0.062211982,empty,mBC-0716-1
"F4,E4",16117,16649,12283,4366,8694,6,3952,3961,2826,1135,2.489867841,1877,1126,736,368,1,367,1,133,0,0.081743869,empty,mBC-0716-1
"F4,E5",795069,845523,596447,249076,446120,2,222342,222757,177230,45527,3.892854789,113377,51502,35211,17100,4,17096,1,1854,0,0.001520824,mm10,mBC-0716-1
"F4,E6",790736,860157,551576,308581,451478,1,264049,264454,175666,88788,1.978488084,147101,32739,15980,7821,7,7814,1,1175,0,0.018428462,mm10,mBC-0716-1
"F4,E7",14254,14614,10800,3814,7715,0,3400,3404,2358,1046,2.254302103,1618,1293,803,397,0,397,0,117,0,0.095717884,empty,mBC-0716-1
"F4,E8",703726,755096,514142,240954,401651,3,210944,211310,166107,45203,3.674689733,110264,108911,79128,37237,13,37224,4,2846,0,0.001504406,mm10,mBC-0716-1
"F4,E9",9826,10144,7424,2720,5368,0,2526,2536,1770,766,2.310704961,1213,864,572,351,0,351,0,122,0,0.01994302,empty,mBC-0716-1
"F4,E10",13953,14436,10649,3787,7578,0,3494,3504,2454,1050,2.337142857,1666,2644,1118,550,1,549,1,149,0,0.06557377,empty,mBC-0716-1
"F4,E11",9621,9854,7276,2578,5410,0,2503,2510,1715,795,2.157232704,1217,1159,753,386,0,386,0,116,0,0.044041451,empty,mBC-0716-1
"F4,E12",16363,16654,12218,4436,8953,0,4143,4153,2876,1277,2.252153485,2043,981,594,291,0,291,0,89,0,0.103092784,empty,mBC-0716-1
"F4,F1",18374,18935,14129,4806,10092,0,4612,4622,3214,1408,2.282670455,2226,1172,742,381,0,381,0,108,0,0.057742782,empty,mBC-0716-1
"F4,F2",1011635,1099056,741612,357444,582162,2,315866,316347,241271,75076,3.213690127,168389,80818,55141,26549,12,26537,4,2560,0,0.002600143,mm10,mBC-0716-1
"F4,F3",17266,18070,12871,5199,9644,0,4619,4632,3316,1316,2.519756839,2336,1535,1004,499,0,499,0,181,0,0.028056112,empty,mBC-0716-1
"F4,F4",17516,17736,13119,4617,9853,0,4525,4537,3222,1315,2.450190114,2148,607,332,196,0,196,0,88,0,0,empty,mBC-0716-1
"F4,F5",24848,25247,18719,6528,13338,0,6011,6028,4324,1704,2.537558685,2882,9917,3264,1658,1,1657,1,321,0,0.024743512,empty,mBC-0716-1
"F4,F6",24503,25341,18519,6822,13531,0,6282,6298,4474,1824,2.452850877,3129,2049,1271,645,1,644,1,177,0,0.041925466,empty,mBC-0716-1
"F4,F7",21065,21214,16196,5018,11690,4,5164,5183,3648,1535,2.376547231,2385,856,531,266,0,266,0,84,0,0.007518797,empty,mBC-0716-1
"F4,F8",22990,23414,17703,5711,12537,0,5609,5617,3957,1660,2.38373494,2577,302,199,114,0,114,0,41,0,0.052631579,empty,mBC-0716-1
"F4,F9",15863,16213,12122,4091,8567,0,3786,3801,2663,1138,2.340070299,1789,1736,1072,566,0,566,0,186,0,0.072438163,empty,mBC-0716-1
"F4,F10",21710,21731,16708,5023,11635,0,5096,5111,3612,1499,2.409606404,2341,2830,1348,650,0,650,0,166,0,0.06,empty,mBC-0716-1
"F4,F11",11849,11863,9132,2731,6332,0,2722,2728,1904,824,2.310679612,1245,1070,715,339,0,339,0,110,0,0.064896755,empty,mBC-0716-1
"F4,F12",13795,14334,10433,3901,7608,0,3506,3521,2455,1066,2.303001876,1722,96,59,44,0,44,0,14,0,0,empty,mBC-0716-1
"F4,G1",705802,785210,502590,282620,415592,0,241647,241958,184375,57583,3.201899866,130975,124150,85174,41164,18,41146,3,3081,0,0.001749866,mm10,mBC-0716-1
"F4,G2",1001468,1101531,707874,393657,574994,3,325829,326317,276042,50275,5.490641472,178172,30062,21502,10255,2,10253,2,1275,0,0.003413635,mm10,mBC-0716-1
"F4,G3",533958,555939,404259,151680,298754,0,142833,143087,104815,38272,2.738686246,70884,18243,11215,5381,1,5380,1,929,0,0.010780669,mm10,mBC-0716-1
"F4,G4",774802,775444,592442,183002,409336,1,180410,180792,144518,36274,3.984065722,84657,231,147,80,0,80,0,34,0,0,empty,mBC-0716-1
"F4,G5",14356,14326,10984,3342,7661,0,3436,3447,2446,1001,2.443556444,1559,910,547,315,0,315,0,112,0,0.066666667,empty,mBC-0716-1
"F4,G6",25648,26231,19689,6542,13784,0,6098,6113,4325,1788,2.418903803,2860,162,104,69,0,69,0,43,0,0.014492754,empty,mBC-0716-1
"F4,G7",1083720,1187579,778771,408808,616503,1,342222,342707,290476,52231,5.561371599,183474,135079,95044,45095,21,45074,2,3221,0,0.000621201,mm10,mBC-0716-1
"F4,G8",14989,15489,11522,3967,8127,0,3711,3717,2604,1113,2.339622642,1741,1332,831,447,0,447,0,139,0,0.073825503,empty,mBC-0716-1
"F4,G9",12638,12945,9783,3162,7027,0,3214,3225,2324,901,2.579356271,1531,1473,963,458,1,457,1,140,0,0.037199125,empty,mBC-0716-1
"F4,G10",14306,14739,10811,3928,8010,0,3660,3668,2554,1114,2.292639138,1837,743,429,234,0,234,0,113,0,0.025641026,empty,mBC-0716-1
"F4,G11",13386,13621,10051,3570,7232,0,3345,3354,2318,1036,2.237451737,1614,560,392,226,0,226,0,89,0,0.061946903,empty,mBC-0716-1
"F4,G12",12122,12536,9250,3286,6627,0,3027,3042,2035,1007,2.020854022,1450,794,512,281,0,281,0,110,0,0.09252669,empty,mBC-0716-1
"F4,H1",22386,22764,17047,5717,12302,0,5622,5631,4064,1567,2.593490747,2653,1531,750,358,1,357,1,123,0,0.036414566,empty,mBC-0716-1
"F4,H2",813013,859943,598963,260980,449983,1,223561,223915,189314,34601,5.471344759,116968,225755,137413,61855,34,61821,2,4344,0,0.001083774,mm10,mBC-0716-1
"F4,H3",20951,21391,15922,5469,11383,0,5237,5237,3628,1609,2.254816656,2519,1333,877,510,2,508,1,147,0,0.084645669,empty,mBC-0716-1
"F4,H4",1194313,1253490,871940,381550,657027,0,337569,338110,286155,51955,5.507747089,173806,6674,4337,2184,1,2183,1,417,0,0.004122767,mm10,mBC-0716-1
"F4,H5",19093,19588,14629,4959,10591,0,4868,4878,3388,1490,2.273825503,2352,1280,841,431,0,431,0,143,0,0.041763341,empty,mBC-0716-1
"F4,H6",15788,16354,11832,4522,8620,1,4096,4106,2895,1211,2.390586292,2028,1578,1053,530,0,530,0,168,0,0.041509434,empty,mBC-0716-1
"F4,H7",776746,860267,532814,327453,457668,2,271034,271420,222894,48526,4.593290195,151193,160028,112329,53216,17,53199,1,3519,0,0.000676704,mm10,mBC-0716-1
"F4,H8",14052,14724,10598,4126,7999,0,3802,3813,2661,1152,2.309895833,1939,1383,819,413,0,413,0,138,0,0.050847458,empty,mBC-0716-1
"F4,H9",16995,17536,12906,4630,9336,0,4288,4293,3063,1230,2.490243902,2050,1154,597,310,0,310,0,104,0,0.129032258,empty,mBC-0716-1
"F4,H10",15528,15740,11942,3798,8368,1,3761,3774,2601,1173,2.217391304,1757,886,559,306,0,306,0,107,0,0.075163399,empty,mBC-0716-1
"F4,H11",18023,18599,13625,4974,10013,0,4696,4701,3254,1447,2.248790601,2316,187,110,65,0,65,0,37,0,0.015384615,empty,mBC-0716-1
"F4,H12",1192396,1348282,815702,532580,713905,3,434175,434712,320258,114454,2.798137243,250655,135279,91686,43734,12,43722,3,3228,0,0.00064041,mm10,mBC-0716-1
"F5,A1",14792,15278,11114,4164,8268,0,3897,3903,2737,1166,2.347341338,1900,1343,807,412,0,412,0,113,0,0.084951456,empty,mBC-0716-1
"F5,A2",1836332,1956042,1284953,671089,1004531,2,569232,570157,452487,117670,3.845389649,305586,206924,144200,68315,26,68289,3,4295,0,0.000790757,mm10,mBC-0716-1
"F5,A3",16715,17405,12824,4581,9241,0,4321,4330,3031,1299,2.333333333,2057,1036,694,392,0,392,0,110,0,0.007653061,empty,mBC-0716-1
"F5,A4",21035,21572,16334,5238,11193,0,4921,4936,3444,1492,2.308310992,2269,730,468,236,0,236,0,68,0,0.025423729,empty,mBC-0716-1
"F5,A5",16994,17430,13046,4384,9527,0,4343,4358,3031,1327,2.284099472,2114,1209,716,385,0,385,0,105,0,0.051948052,empty,mBC-0716-1
"F5,A6",16325,17117,12289,4828,9145,0,4443,4454,3256,1198,2.717863105,2222,1352,911,418,0,418,0,133,0,0.040669856,empty,mBC-0716-1
"F5,A7",16206,16440,12282,4158,8836,0,4031,4040,2797,1243,2.250201126,1924,1764,1006,476,0,476,0,145,0,0.075630252,empty,mBC-0716-1
"F5,A8",11154,11367,8494,2873,6193,0,2844,2849,2010,839,2.395709178,1358,1876,1166,616,0,616,0,170,0,0.032467532,empty,mBC-0716-1
"F5,A9",823308,865481,611345,254136,452579,0,221466,221872,194400,27472,7.076295865,112652,213285,115532,55836,24,55812,4,3662,0,0.002436752,mm10,mBC-0716-1
"F5,A10",16103,16432,12257,4175,8707,0,3976,3981,2818,1163,2.423043852,1829,814,418,203,0,203,0,60,0,0.044334975,empty,mBC-0716-1
"F5,A11",17960,18188,13809,4379,9716,0,4336,4343,3079,1264,2.435917722,1975,2411,1054,514,0,514,0,134,0,0.06614786,empty,mBC-0716-1
"F5,A12",20752,21255,16043,5212,11014,0,4766,4786,3406,1380,2.468115942,2184,2636,1631,788,0,788,0,181,0,0.063451777,empty,mBC-0716-1
"F5,B1",18757,19201,14553,4648,10074,0,4423,4437,3076,1361,2.260102866,1960,1195,813,373,0,373,0,105,0,0.018766756,empty,mBC-0716-1
"F5,B2",1206364,1350466,812787,537679,701359,2,441291,441782,346024,95758,3.613525763,249948,19075,12966,6211,4,6207,2,873,0,0.00306106,mm10,mBC-0716-1
"F5,B3",18700,19021,14417,4604,10172,0,4569,4573,3208,1365,2.35018315,2130,1499,976,484,0,484,0,128,0,0.037190083,empty,mBC-0716-1
"F5,B4",17680,18398,13221,5177,9498,0,4419,4429,3134,1295,2.42007722,2223,2384,1329,681,0,681,0,207,0,0.070484581,empty,mBC-0716-1
"F5,B5",9277,5774,4061,1713,3950,0,1888,1904,1344,560,2.4,1025,610,328,191,0,191,0,73,0,0.041884817,empty,mBC-0716-1
"F5,B6",12010,12662,9049,3613,6635,0,3071,3083,2097,986,2.126774848,1507,3046,1288,673,0,673,0,126,0,0.133729569,empty,mBC-0716-1
"F5,B7",15618,15774,12201,3573,8318,0,3679,3682,2581,1101,2.344232516,1620,1401,956,452,0,452,0,103,0,0.095132743,empty,mBC-0716-1
"F5,B8",774032,830130,553578,276552,438716,0,240204,240555,204311,36244,5.637098554,126826,103917,75502,35747,16,35731,1,2749,0,0.002854664,mm10,mBC-0716-1
"F5,B9",14947,15224,11400,3824,8121,0,3570,3583,2503,1080,2.317592593,1752,1894,869,432,0,432,0,111,0,0.043981481,empty,mBC-0716-1
"F5,B10",16803,16473,11980,4493,9121,0,4238,4253,2987,1266,2.359399684,2114,483,309,164,0,164,0,56,0,0,empty,mBC-0716-1
"F5,B11",16532,17016,12660,4356,8964,0,4069,4072,2830,1242,2.278582931,1924,92,52,39,0,39,0,24,0,0,empty,mBC-0716-1
"F5,B12",468711,500138,342109,158029,273491,1,144952,145185,113750,31435,3.618578018,76587,12221,8566,4168,3,4165,1,678,0,0.006242497,mm10,mBC-0716-1
"F5,C1",21775,22161,16695,5466,11577,0,5002,5006,3569,1437,2.483646486,2353,876,553,289,0,289,0,93,0,0.131487889,empty,mBC-0716-1
"F5,C2",20052,21101,15094,6007,11070,0,5203,5218,3672,1546,2.375161708,2562,3413,1663,816,2,814,1,210,0,0.073710074,empty,mBC-0716-1
"F5,C3",19846,20295,14974,5321,10685,0,4908,4919,3420,1499,2.281521014,2347,642,446,210,0,210,0,64,0,0.00952381,empty,mBC-0716-1
"F5,C4",17804,18046,13456,4590,9744,0,4319,4333,3081,1252,2.46086262,2064,1447,928,437,0,437,0,124,0,0.057208238,empty,mBC-0716-1
"F5,C5",16204,16829,12275,4554,8847,0,4056,4067,2783,1284,2.167445483,1969,981,589,316,0,316,0,109,0,0.041139241,empty,mBC-0716-1
"F5,C6",17844,18213,13334,4879,10137,0,4742,4757,3438,1319,2.606520091,2313,1622,978,511,0,511,0,143,0,0.035225049,empty,mBC-0716-1
"F5,C7",16002,16511,12059,4452,8885,0,4128,4142,2855,1287,2.218337218,2054,448,299,137,0,137,0,53,0,0.04379562,empty,mBC-0716-1
"F5,C8",15032,15382,11357,4025,8343,0,3837,3846,2611,1235,2.11417004,1857,1582,984,564,0,564,0,155,0,0.031914894,empty,mBC-0716-1
"F5,C9",12716,13123,9765,3358,6900,0,3093,3105,2173,932,2.331545064,1470,876,595,286,0,286,0,73,0,0.08041958,empty,mBC-0716-1
"F5,C10",13661,13879,10517,3362,7431,0,3344,3347,2365,982,2.408350305,1583,1195,708,362,0,362,0,109,0,0.143646409,empty,mBC-0716-1
"F5,C11",11469,11639,8851,2788,6224,0,2798,2802,1922,880,2.184090909,1326,2238,1053,526,0,526,0,135,0,0.068441065,empty,mBC-0716-1
"F5,C12",777995,873612,529454,344158,461590,0,284354,284736,228437,56299,4.05756763,161849,56765,39896,18989,7,18982,1,1909,0,0.0014224,mm10,mBC-0716-1
"F5,D1",11579,12119,8541,3578,6609,0,3138,3148,2253,895,2.517318436,1621,633,408,200,0,200,0,52,0,0.13,empty,mBC-0716-1
"F5,D2",20053,20236,15624,4612,10768,0,4539,4553,3163,1390,2.275539568,2072,2725,1793,865,0,865,0,188,0,0.070520231,empty,mBC-0716-1
"F5,D3",13999,14450,10677,3773,7867,0,3652,3658,2558,1100,2.325454545,1795,1353,758,402,0,402,0,115,0,0.05721393,empty,mBC-0716-1
"F5,D4",14263,14722,10871,3851,7811,0,3580,3589,2507,1082,2.317005545,1691,14637,4924,2451,2,2449,2,417,0,0.053082891,empty,mBC-0716-1
"F5,D5",641668,687902,463129,224773,369459,1,196684,196946,161671,35275,4.583160879,104475,128252,89134,42280,22,42258,2,2993,0,0.00097023,mm10,mBC-0716-1
"F5,D6",13209,13970,9678,4292,7385,0,3594,3608,2588,1020,2.537254902,1876,19966,6235,3168,1,3167,1,498,0,0.049573729,empty,mBC-0716-1
"F5,D7",13456,13991,10096,3895,7445,0,3556,3562,2448,1114,2.197486535,1765,15535,5121,2652,5,2647,4,424,0,0.091424254,empty,mBC-0716-1
"F5,D8",15893,16267,12007,4260,8800,0,4168,4177,2915,1262,2.309825674,2030,10349,3604,1811,1,1810,1,292,0,0.139779006,empty,mBC-0716-1
"F5,D9",5622,5890,4137,1753,3277,0,1683,1684,1215,469,2.590618337,884,2441,1202,607,0,607,0,140,0,0.057660626,empty,mBC-0716-1
"F5,D10",646801,694038,482306,211732,371545,0,194048,194332,141018,53314,2.645046329,101610,33661,22063,10685,8,10677,2,1333,0,0.001498548,mm10,mBC-0716-1
"F5,D11",18245,18995,13817,5178,10052,1,4543,4553,3154,1399,2.254467477,2276,5194,2225,1064,0,1064,0,239,0,0.041353383,empty,mBC-0716-1
"F5,D12",20018,20448,15211,5237,10828,0,4953,4967,3517,1450,2.425517241,2391,2541,1635,837,2,835,1,219,0,0.064670659,empty,mBC-0716-1
"F5,E1",982727,1044709,712574,332135,547963,1,294630,295116,220480,74636,2.954070422,154309,60745,43115,20167,12,20155,2,1975,0,0.001488464,mm10,mBC-0716-1
"F5,E2",16078,16650,12200,4450,9093,1,4174,4195,2968,1227,2.418907905,2049,1787,1117,526,1,525,1,135,0,0.028571429,empty,mBC-0716-1
"F5,E3",12592,13013,9629,3384,6873,0,3064,3076,2078,998,2.082164329,1509,2077,1249,614,1,613,1,150,0,0.039151713,empty,mBC-0716-1
"F5,E4",880206,982759,614636,368123,517200,1,318585,318997,158551,160446,0.988189173,179136,13548,8474,3802,2,3800,2,779,0,0.005789474,empty,mBC-0716-1
"F5,E5",20853,21283,16219,5064,11170,0,4834,4846,3432,1414,2.427157001,2269,2071,1036,533,0,533,0,125,0,0.110694184,empty,mBC-0716-1
"F5,E6",13633,14012,10523,3489,7517,0,3385,3395,2397,998,2.401803607,1616,1636,930,490,0,490,0,118,0,0.104081633,empty,mBC-0716-1
"F5,E7",14085,14367,10521,3846,7546,0,3425,3435,2363,1072,2.204291045,1678,1515,962,450,1,449,1,127,0,0.102449889,empty,mBC-0716-1
"F5,E8",17347,17706,13246,4460,9361,1,4148,4173,2932,1241,2.362610798,1945,4213,1938,995,0,995,0,212,0,0.101507538,empty,mBC-0716-1
"F5,E9",9202,9395,6932,2463,5000,0,2290,2297,1624,673,2.41307578,1090,4362,1958,865,0,865,0,183,0,0.093641618,empty,mBC-0716-1
"F5,E10",12712,13385,9657,3728,7008,0,3293,3304,2278,1026,2.220272904,1631,1303,818,378,1,377,1,115,0,0.026525199,empty,mBC-0716-1
"F5,E11",9457,9567,7130,2437,5243,0,2430,2432,1708,724,2.359116022,1150,2399,1042,555,2,553,2,140,0,0.054249548,empty,mBC-0716-1
"F5,E12",15029,15460,11428,4032,8380,0,3893,3899,2739,1160,2.361206897,1881,993,667,334,0,334,0,104,0,0.02994012,empty,mBC-0716-1
"F5,F1",569088,605946,420354,185592,326347,0,170344,170607,132873,37734,3.521307044,88769,31064,17092,8091,3,8088,1,1061,0,0.015702275,mm10,mBC-0716-1
"F5,F2",22731,23740,17131,6609,12604,0,5867,5877,4176,1701,2.455026455,2971,2990,1987,975,0,975,0,248,0,0.04,empty,mBC-0716-1
"F5,F3",17195,17786,12887,4899,9607,0,4572,4576,3235,1341,2.412378822,2285,5076,2457,1200,2,1198,1,275,0,0.156928214,empty,mBC-0716-1
"F5,F4",18209,18614,13635,4979,10216,0,4733,4743,3405,1338,2.544843049,2354,820,542,286,0,286,0,91,0,0,empty,mBC-0716-1
"F5,F5",23896,24926,17823,7103,13091,0,6128,6136,4368,1768,2.470588235,3062,2672,1519,702,2,700,1,173,0,0.057142857,empty,mBC-0716-1
"F5,F6",688669,762248,482454,279794,404839,1,230804,231168,194130,37038,5.241373724,128803,197983,120927,57136,16,57120,6,3667,0,0.006092437,mm10,mBC-0716-1
"F5,F7",19756,20587,15153,5434,11139,0,5118,5121,3603,1518,2.373517787,2472,819,502,285,0,285,0,88,0,0.073684211,empty,mBC-0716-1
"F5,F8",25635,26628,19428,7200,14006,0,6591,6613,4743,1870,2.536363636,3183,292,207,106,0,106,0,51,0,0,empty,mBC-0716-1
"F5,F9",890395,1041342,584149,457193,551353,3,367510,367913,283411,84502,3.353896949,217932,84726,59331,27934,8,27926,1,2462,0,0.001897873,mm10,mBC-0716-1
"F5,F10",22684,23214,17714,5500,12189,0,5330,5339,3762,1577,2.385542169,2450,1632,973,500,0,500,0,137,0,0.098,empty,mBC-0716-1
"F5,F11",11399,11907,8756,3151,6440,0,2919,2933,2024,909,2.226622662,1480,5548,1975,1027,0,1027,0,225,0,0.123661149,empty,mBC-0716-1
"F5,F12",13820,14190,10492,3698,7416,0,3365,3368,2353,1015,2.318226601,1566,114,45,26,0,26,0,16,0,0,empty,mBC-0716-1
"F5,G1",9864,10201,7719,2482,5365,1,2347,2357,1584,773,2.04915912,1117,1773,1103,577,0,577,0,132,0,0.005199307,empty,mBC-0716-1
"F5,G2",1140506,1243760,803204,440556,644765,5,366432,366964,282029,84935,3.320527462,200671,34109,22545,10717,2,10715,1,1306,0,0.001026598,mm10,mBC-0716-1
"F5,G3",20143,20675,15298,5377,10871,0,4905,4915,3438,1477,2.327691266,2380,2092,1227,639,0,639,0,174,0,0.089201878,empty,mBC-0716-1
"F5,G4",27679,28013,21391,6622,14834,0,6410,6420,4552,1868,2.436830835,2969,78,42,29,0,29,0,16,0,0,empty,mBC-0716-1
"F5,G5",13348,13900,10127,3773,7369,1,3342,3355,2343,1012,2.315217391,1675,1231,787,402,0,402,0,113,0,0.082089552,empty,mBC-0716-1
"F5,G6",24842,25313,19124,6189,13257,0,5776,5804,4168,1636,2.547677262,2651,281,188,94,0,94,0,44,0,0,empty,mBC-0716-1
"F5,G7",19982,20506,15515,4991,10795,0,4693,4701,3369,1332,2.529279279,2177,2065,1202,638,0,638,0,167,0,0.020376176,empty,mBC-0716-1
"F5,G8",14725,15469,11299,4170,8161,0,3785,3797,2662,1135,2.345374449,1823,1757,1158,575,0,575,0,151,0,0.066086957,empty,mBC-0716-1
"F5,G9",10311,10855,7782,3073,5805,0,2701,2714,1882,832,2.262019231,1349,3173,1278,668,2,666,1,180,0,0.084084084,empty,mBC-0716-1
"F5,G10",13694,13829,10320,3509,7516,0,3474,3486,2414,1072,2.251865672,1711,2014,958,493,0,493,0,138,0,0.077079108,empty,mBC-0716-1
"F5,G11",12191,12803,9189,3614,6839,0,3162,3167,2288,879,2.602957907,1557,2256,985,500,0,500,0,118,0,0.092,empty,mBC-0716-1
"F5,G12",587320,633563,431875,201688,342813,1,175976,176277,149332,26945,5.542104287,92488,163653,116744,55447,18,55429,1,3612,0,0.000757726,mm10,mBC-0716-1
"F5,H1",21195,21534,15957,5577,11411,0,5176,5191,3659,1532,2.388381201,2447,3410,1567,796,0,796,0,167,0,0.227386935,empty,mBC-0716-1
"F5,H2",23886,24790,18359,6431,12923,0,5747,5755,3919,1836,2.13453159,2804,2348,1484,689,0,689,0,178,0,0.029027576,empty,mBC-0716-1
"F5,H3",20184,20996,15354,5642,11125,0,5164,5183,3625,1558,2.326700899,2531,1761,1083,508,0,508,0,138,0,0.102362205,empty,mBC-0716-1
"F5,H4",13595,14261,10180,4081,7627,0,3673,3677,2642,1035,2.552657005,1839,294,135,82,0,82,0,28,0,0,empty,mBC-0716-1
"F5,H5",18311,19076,13729,5347,10149,0,4698,4718,3363,1355,2.481918819,2344,1581,1122,578,0,578,0,147,0,0.001730104,empty,mBC-0716-1
"F5,H6",14936,15208,11398,3810,8132,0,3771,3779,2755,1024,2.690429688,1816,1624,1124,540,0,540,0,146,0,0.046296296,empty,mBC-0716-1
"F5,H7",17866,18440,13512,4928,9942,0,4576,4589,3294,1295,2.543629344,2235,1578,1004,529,0,529,0,166,0,0.054820416,empty,mBC-0716-1
"F5,H8",14205,14448,10801,3647,7745,0,3529,3533,2453,1080,2.271296296,1701,1637,1000,535,0,535,0,145,0,0.03364486,empty,mBC-0716-1
"F5,H9",16171,17008,12309,4699,9140,0,4257,4271,3046,1225,2.486530612,2117,1271,866,421,0,421,0,118,0,0.040380048,empty,mBC-0716-1
"F5,H10",14675,15191,10975,4216,8132,0,3763,3774,2610,1164,2.242268041,1864,1212,785,410,0,410,0,130,0,0.080487805,empty,mBC-0716-1
"F5,H11",17819,18537,13550,4987,10011,0,4704,4711,3380,1331,2.539444027,2349,206,145,77,0,77,0,27,0,0,empty,mBC-0716-1
"F5,H12",6405,6665,4824,1841,3712,0,1777,1781,1282,499,2.569138277,903,798,469,188,0,188,0,62,0,0.10106383,empty,mBC-0716-1
"F6,A1",18164,19152,13442,5710,10316,0,5091,5104,3673,1431,2.566736548,2575,8288,3689,1909,0,1909,0,307,0,0.321634364,empty,mBC-0716-1
"F6,A2",22580,22878,17217,5661,12153,0,5432,5437,3884,1553,2.500965873,2518,3376,1529,780,0,780,0,189,0,0.026923077,empty,mBC-0716-1
"F6,A3",19237,19932,14491,5441,10512,0,4959,4975,3489,1486,2.347913863,2427,1006,669,351,0,351,0,113,0,0.017094017,empty,mBC-0716-1
"F6,A4",1231905,1369409,839687,529722,706619,2,430671,431257,342911,88346,3.881454735,241628,47074,33167,15597,2,15595,1,1608,0,0.002308432,mm10,mBC-0716-1
"F6,A5",18518,19332,14229,5103,10279,0,4652,4669,3296,1373,2.400582666,2195,1794,1141,548,0,548,0,147,0,0.083941606,empty,mBC-0716-1
"F6,A6",18639,19426,14005,5421,10455,0,4995,5003,3564,1439,2.476719944,2508,1717,1118,589,0,589,0,197,0,0.032258065,empty,mBC-0716-1
"F6,A7",18483,19016,14204,4812,10129,0,4560,4574,3208,1366,2.348462665,2171,1614,1046,503,0,503,0,133,0,0.019880716,empty,mBC-0716-1
"F6,A8",1123642,1231350,809721,421629,652483,0,359400,359888,285329,74559,3.826888773,194329,236816,163627,77461,29,77432,2,4513,0,0.001820953,mm10,mBC-0716-1
"F6,A9",20258,20384,15580,4804,10692,0,4637,4643,3321,1322,2.512102874,2136,1662,1050,520,0,520,0,146,0,0.009615385,empty,mBC-0716-1
"F6,A10",18145,18849,13668,5181,10023,0,4705,4709,3419,1290,2.650387597,2252,531,283,125,0,125,0,55,0,0.04,empty,mBC-0716-1
"F6,A11",20780,21157,15706,5451,11477,0,5258,5275,3819,1456,2.62293956,2469,1468,927,436,0,436,0,131,0,0.103211009,empty,mBC-0716-1
"F6,A12",22122,22457,16997,5460,11625,0,5046,5073,3614,1459,2.477039068,2292,5306,2886,1432,1,1431,1,280,0,0.078266946,empty,mBC-0716-1
"F6,B1",950334,1039154,688373,350781,545026,2,294447,294851,242340,52511,4.615033041,158965,138627,99978,46918,14,46904,2,3133,0,0.000298482,mm10,mBC-0716-1
"F6,B2",687513,754056,473587,280469,409334,0,244107,244402,188240,56162,3.351732488,137336,4810,3356,1531,0,1531,0,355,0,0.019595036,mm10,mBC-0716-1
"F6,B3",21083,21127,16196,4931,11323,0,5032,5044,3635,1409,2.579843861,2285,5692,2192,1124,0,1124,0,239,0,0.055160142,empty,mBC-0716-1
"F6,B4",18384,18866,14097,4769,9960,0,4472,4483,3192,1291,2.472501936,2138,1382,852,445,0,445,0,129,0,0.056179775,empty,mBC-0716-1
"F6,B5",10462,6454,4426,2028,4454,0,2136,2155,1534,621,2.47020934,1202,924,633,297,0,297,0,89,0,0.04040404,empty,mBC-0716-1
"F6,B6",13175,13937,10098,3839,7618,0,3657,3661,2579,1082,2.383548983,1826,1234,730,378,1,377,1,102,0,0.071618037,empty,mBC-0716-1
"F6,B7",17118,17693,12983,4710,9303,0,4265,4278,2986,1292,2.311145511,2064,2936,1337,651,0,651,0,165,0,0.035330261,empty,mBC-0716-1
"F6,B8",597918,652595,427656,224939,351372,0,193850,194128,156955,37173,4.222284992,104841,106488,77859,36946,9,36937,1,2902,0,0.000893413,mm10,mBC-0716-1
"F6,B9",16022,16416,12308,4108,8743,0,3961,3974,2733,1241,2.202256245,1808,844,559,283,0,283,0,85,0,0.049469965,empty,mBC-0716-1
"F6,B10",18831,18598,13767,4831,10376,0,4859,4883,3424,1459,2.346812886,2333,1724,633,316,0,316,0,81,0,0.075949367,empty,mBC-0716-1
"F6,B11",19140,19906,14660,5246,10700,0,5016,5023,3574,1449,2.46652864,2430,187,138,76,0,76,0,30,0,0,empty,mBC-0716-1
"F6,B12",755577,795152,576006,219146,421749,2,196327,196675,160925,35750,4.501398601,97827,82596,56687,26552,9,26543,3,2390,0,0.001243266,mm10,mBC-0716-1
"F6,C1",23588,23680,18323,5357,12497,0,5340,5346,3821,1525,2.50557377,2401,872,585,296,0,296,0,105,0,0,empty,mBC-0716-1
"F6,C2",23038,24339,17224,7115,13046,0,6248,6258,4486,1772,2.531602709,3144,2084,1340,727,0,727,0,192,0,0.096286107,empty,mBC-0716-1
"F6,C3",1510087,1572109,1152231,419878,819236,1,379122,379762,294106,85656,3.433571495,190427,113016,67670,31626,18,31608,2,2867,0,0.005599848,mm10,mBC-0716-1
"F6,C4",20056,20358,15293,5065,10989,0,4968,4980,3561,1419,2.509513742,2380,1657,998,541,0,541,0,166,0,0.01663586,empty,mBC-0716-1
"F6,C5",18421,19229,14033,5196,10126,0,4706,4715,3392,1323,2.563869992,2312,3201,1429,722,0,722,0,174,0,0.119113573,empty,mBC-0716-1
"F6,C6",623645,638540,459395,179145,351078,2,171321,171609,117700,53909,2.183308909,87800,28865,18707,8979,3,8976,1,1168,0,0.005124777,mm10,mBC-0716-1
"F6,C7",18308,19151,13749,5402,10175,0,4825,4831,3374,1457,2.315717227,2383,355,226,108,0,108,0,53,0,0,empty,mBC-0716-1
"F6,C8",1009993,1164545,658818,505727,614576,1,402431,402881,295074,107807,2.73705789,238935,132772,89133,41717,13,41704,1,3163,0,0.001246883,mm10,mBC-0716-1
"F6,C9",14137,14583,10756,3827,7821,0,3632,3639,2560,1079,2.372567192,1741,1125,592,327,0,327,0,93,0,0.079510703,empty,mBC-0716-1
"F6,C10",14666,15381,11198,4183,8265,0,3767,3780,2715,1065,2.549295775,1848,1251,861,447,0,447,0,132,0,0.011185682,empty,mBC-0716-1
"F6,C11",510341,538490,376294,162196,291898,1,149276,149490,116944,32546,3.593191176,76569,24049,16344,7785,3,7782,1,1091,0,0.001927525,mm10,mBC-0716-1
"F6,C12",22641,23022,16973,6049,12300,0,5623,5631,4028,1603,2.512788522,2719,2806,1422,677,0,677,0,189,0,0.039881832,empty,mBC-0716-1
"F6,D1",14334,15244,10705,4539,8338,0,4123,4133,2909,1224,2.376633987,2139,728,407,228,0,228,0,74,0,0.035087719,empty,mBC-0716-1
"F6,D2",22004,22415,17104,5311,11703,0,4928,4947,3540,1407,2.515991471,2310,2688,1787,888,0,888,0,220,0,0.120495495,empty,mBC-0716-1
"F6,D3",15989,16815,11948,4867,9032,0,4328,4343,3033,1310,2.315267176,2197,3781,1484,747,1,746,1,168,0,0.028150134,empty,mBC-0716-1
"F6,D4",16382,17256,12435,4821,9287,3,4437,4451,3052,1399,2.181558256,2207,3440,1511,789,1,788,1,209,0,0.049492386,empty,mBC-0716-1
"F6,D5",16477,17326,12517,4809,9435,0,4476,4491,3284,1207,2.72079536,2282,1310,769,406,1,405,1,156,0,0.039506173,empty,mBC-0716-1
"F6,D6",13980,14518,10496,4022,7821,0,3775,3776,2686,1090,2.464220183,1854,1635,1125,553,0,553,0,133,0,0.09403255,empty,mBC-0716-1
"F6,D7",18333,19210,13876,5334,10374,0,5042,5056,3597,1459,2.465387252,2459,3322,1681,833,0,833,0,225,0,0.040816327,empty,mBC-0716-1
"F6,D8",18110,18895,13786,5109,10191,0,4772,4785,3443,1342,2.56557377,2292,2254,1126,517,0,517,0,136,0,0.050290135,empty,mBC-0716-1
"F6,D9",7835,8234,5639,2595,4496,0,2286,2288,1665,623,2.672552167,1183,2037,1248,616,0,616,0,159,0,0.107142857,empty,mBC-0716-1
"F6,D10",15410,16456,11688,4768,8739,0,4131,4134,2880,1254,2.296650718,2057,912,559,289,0,289,0,102,0,0.114186851,empty,mBC-0716-1
"F6,D11",1237112,1336252,885818,450434,707645,2,400927,401485,314175,87310,3.598385065,215333,82659,42625,20265,9,20256,2,2421,0,0.013625592,mm10,mBC-0716-1
"F6,D12",24342,25186,18536,6650,13322,0,6098,6119,4382,1737,2.522740357,2961,3002,1813,876,0,876,0,223,0,0.073059361,empty,mBC-0716-1
"F6,E1",24891,25072,19145,5927,13414,2,5943,5959,4309,1650,2.611515152,2691,3483,1585,823,1,822,1,208,0,0.094890511,empty,mBC-0716-1
"F6,E2",613438,618795,451812,166983,333673,1,163544,163825,131479,32346,4.064768441,80299,110062,41477,20254,13,20241,4,2342,0,0.042932661,mm10,mBC-0716-1
"F6,E3",13330,13763,10312,3451,7320,0,3248,3252,2245,1007,2.22939424,1511,7099,2708,1339,3,1336,1,277,0,0.047904192,empty,mBC-0716-1
"F6,E4",16722,17075,12722,4353,9079,0,4092,4102,2919,1183,2.467455621,1925,1529,939,504,0,504,0,159,0,0.115079365,empty,mBC-0716-1
"F6,E5",22455,22947,17489,5458,12134,0,5259,5274,3759,1515,2.481188119,2419,1765,1097,543,0,543,0,173,0,0.014732965,empty,mBC-0716-1
"F6,E6",16056,16587,12209,4378,8888,0,4059,4067,2794,1273,2.194815397,1965,1412,914,504,0,504,0,146,0,0.013888889,empty,mBC-0716-1
"F6,E7",16467,16816,12325,4491,8804,0,4028,4039,2824,1215,2.324279835,1963,6968,2857,1459,0,1459,0,244,0,0.186429061,empty,mBC-0716-1
"F6,E8",19532,20209,15016,5193,10704,0,4796,4809,3373,1436,2.348885794,2254,9514,3424,1721,1,1720,1,367,0,0.04127907,empty,mBC-0716-1
"F6,E9",508230,541923,365197,176726,292889,0,163613,163846,110550,53296,2.074264485,86544,18456,12210,5601,2,5599,1,954,0,0.002857653,mm10,mBC-0716-1
"F6,E10",433651,446931,320767,126164,243225,0,120218,120405,94770,25635,3.696898771,60202,18705,9629,4487,5,4482,2,838,0,0.01762606,mm10,mBC-0716-1
"F6,E11",10853,11278,8189,3089,6121,0,2912,2917,2052,865,2.372254335,1405,1430,982,483,0,483,0,139,0,0.057971014,empty,mBC-0716-1
"F6,E12",18405,19032,13791,5241,10128,0,4741,4757,3410,1347,2.531551596,2343,24034,7321,3687,5,3682,1,616,0,0.0320478,empty,mBC-0716-1
"F6,F1",18949,19460,14548,4912,10329,3,4599,4611,3276,1335,2.453932584,2193,1851,1223,605,0,605,0,163,0,0.06446281,empty,mBC-0716-1
"F6,F2",25948,26793,19749,7044,14331,0,6554,6573,4599,1974,2.329787234,3140,3048,1981,1000,2,998,2,255,0,0.069138277,empty,mBC-0716-1
"F6,F3",19199,20272,14303,5969,10947,0,5299,5309,3761,1548,2.429586563,2655,1921,1225,637,0,637,0,199,0,0.064364207,empty,mBC-0716-1
"F6,F4",21989,22809,16617,6192,12516,0,5899,5904,4362,1542,2.828793774,2860,6008,2209,1097,4,1093,1,220,0,0.039341263,empty,mBC-0716-1
"F6,F5",26389,27119,20056,7063,14239,0,6544,6555,4599,1956,2.351226994,3204,2002,1232,650,0,650,0,202,0,0.058461538,empty,mBC-0716-1
"F6,F6",28225,29314,21210,8104,15620,0,7314,7328,5073,2255,2.249667406,3681,26450,8731,4245,4,4241,3,698,0,0.022164584,empty,mBC-0716-1
"F6,F7",1440940,1460486,1072445,388041,776758,2,376158,376833,258301,118532,2.179166807,186906,40012,19944,9627,5,9622,2,1431,0,0.018811058,mm10,mBC-0716-1
"F6,F8",25723,26894,19566,7328,14340,0,6708,6724,4829,1895,2.54828496,3307,1572,520,282,0,282,0,90,0,0.021276596,empty,mBC-0716-1
"F6,F9",17489,17897,13227,4670,9639,0,4447,4454,3216,1238,2.597738288,2140,1941,1206,643,2,641,1,198,0,0.053042122,empty,mBC-0716-1
"F6,F10",1046722,1132598,756735,375863,591511,0,320934,321415,273126,48289,5.656070741,170615,135540,95679,44341,18,44323,2,3144,0,0.000315863,mm10,mBC-0716-1
"F6,F11",12860,13317,9698,3619,7178,0,3261,3264,2300,964,2.385892116,1599,1236,800,370,0,370,0,115,0,0.02972973,empty,mBC-0716-1
"F6,F12",14924,15251,11382,3869,8127,0,3753,3766,2560,1206,2.122719735,1751,249,163,85,0,85,0,22,0,0,empty,mBC-0716-1
"F6,G1",10691,11061,8305,2756,5983,0,2689,2696,1867,829,2.252110977,1254,3644,1880,999,0,999,0,223,0,0.034034034,empty,mBC-0716-1
"F6,G2",22101,22602,17062,5540,11837,0,5244,5254,3737,1517,2.463414634,2421,503,279,130,0,130,0,52,0,0.061538462,empty,mBC-0716-1
"F6,G3",869903,932569,634456,298113,489263,1,252002,252371,209198,43173,4.845574781,132642,185531,125656,59440,23,59417,2,3673,0,0.001784001,mm10,mBC-0716-1
"F6,G4",30540,30884,23603,7281,16341,0,7106,7131,5092,2039,2.497302599,3368,72,47,32,0,32,0,24,0,0,empty,mBC-0716-1
"F6,G5",14739,15190,11243,3947,8073,0,3736,3741,2628,1113,2.361185984,1807,1509,902,473,0,473,0,142,0,0.109936575,empty,mBC-0716-1
"F6,G6",27051,27511,20715,6796,14669,0,6559,6573,4709,1864,2.526287554,3088,295,121,73,0,73,0,43,0,0.054794521,empty,mBC-0716-1
"F6,G7",22084,22793,16861,5932,11989,0,5485,5497,3900,1597,2.442078898,2613,2349,1465,744,0,744,0,199,0,0.099462366,empty,mBC-0716-1
"F6,G8",15913,16639,12208,4431,8873,1,4080,4106,2893,1213,2.384995878,1973,2014,1274,668,0,668,0,184,0,0.070359281,empty,mBC-0716-1
"F6,G9",12262,12750,9218,3532,6759,0,3190,3199,2301,898,2.562360802,1538,1491,937,501,0,501,0,161,0,0.047904192,empty,mBC-0716-1
"F6,G10",15109,15570,11540,4030,8280,0,3839,3847,2772,1075,2.578604651,1820,1720,1160,529,0,529,0,182,0,0.041587902,empty,mBC-0716-1
"F6,G11",420710,418083,328870,89213,227336,0,89262,89454,69102,20352,3.395341981,40769,19896,13251,6189,3,6186,1,934,0,0.008891044,mm10,mBC-0716-1
"F6,G12",13363,13864,10111,3753,7489,0,3501,3507,2461,1046,2.352772467,1765,1241,782,403,1,402,1,116,0,0.02238806,empty,mBC-0716-1
"F6,H1",24120,24921,18087,6834,13346,0,6174,6186,4429,1757,2.520774047,3066,1715,815,426,0,426,0,144,0,0.025821596,empty,mBC-0716-1
"F6,H2",26856,27265,20403,6862,14384,0,6449,6469,4581,1888,2.426377119,3070,2323,1562,799,0,799,0,201,0,0.066332916,empty,mBC-0716-1
"F6,H3",23253,24393,17752,6641,12904,0,6067,6080,4330,1750,2.474285714,2942,1699,1063,540,0,540,0,163,0,0.062962963,empty,mBC-0716-1
"F6,H4",30064,32652,22461,10191,17131,0,8714,8740,6651,2089,3.18382001,4572,355,215,115,0,115,0,53,0,0.008695652,empty,mBC-0716-1
"F6,H5",21665,23285,16312,6973,12299,0,5851,5857,4231,1626,2.602091021,3076,1863,1194,623,0,623,0,206,0,0.07223114,empty,mBC-0716-1
"F6,H6",17971,18854,13692,5162,10179,0,4838,4847,3488,1359,2.566593083,2411,2179,1322,721,0,721,0,204,0,0.097087379,empty,mBC-0716-1
"F6,H7",2411198,2725878,1621305,1104573,1425618,3,907488,908687,682899,225788,3.024514146,523864,402989,267007,125069,40,125029,5,5532,0,0.001791584,mm10,mBC-0716-1
"F6,H8",22441,23543,16912,6631,12861,0,6312,6321,4367,1954,2.234902764,3141,2001,1084,510,0,510,0,178,0,0.035294118,empty,mBC-0716-1
"F6,H9",19780,20307,14922,5385,11028,0,5034,5044,3734,1310,2.850381679,2412,1459,975,460,0,460,0,139,0,0.093478261,empty,mBC-0716-1
"F6,H10",17242,18013,12887,5126,9495,0,4507,4513,3175,1338,2.372944694,2226,6731,2526,1287,5,1282,1,265,0,0.077223089,empty,mBC-0716-1
"F6,H11",551278,612287,393913,218374,333849,0,190487,190740,144720,46020,3.144719687,105848,1407,841,401,0,401,0,111,0,0,empty,mBC-0716-1
"F6,H12",7412,7586,5474,2112,4258,1,2020,2026,1445,581,2.487091222,1016,4845,1720,866,2,864,1,202,0,0.078703704,empty,mBC-0716-1
"F7,A1",14647,15232,11025,4207,8228,0,3957,3966,2889,1077,2.682451253,1930,800,496,258,0,258,0,80,0,0.112403101,empty,mBC-0716-1
"F7,A2",890654,987705,592844,394861,516399,2,323186,323559,257239,66320,3.878754524,183402,42584,30024,14265,5,14260,1,1597,0,0.002173913,mm10,mBC-0716-1
"F7,A3",16325,17397,12475,4922,9410,0,4519,4527,3228,1299,2.484988453,2305,609,371,195,0,195,0,63,0,0.117948718,empty,mBC-0716-1
"F7,A4",20491,20791,15904,4887,10752,0,4617,4627,3278,1349,2.42994811,2042,407,249,100,0,100,0,44,0,0.02,empty,mBC-0716-1
"F7,A5",16815,17686,12744,4942,9179,0,4204,4208,2913,1295,2.249420849,2045,28730,8950,4482,3,4479,2,659,0,0.042420183,empty,mBC-0716-1
"F7,A6",535153,577088,393821,183267,307232,0,156628,156841,130120,26721,4.869578234,81899,99440,67981,32076,12,32064,3,2679,0,0.001497006,mm10,mBC-0716-1
"F7,A7",592991,656390,429366,227024,351782,0,192882,193144,147853,45291,3.264511713,105139,55921,39102,18574,4,18570,1,1815,0,0.001292407,mm10,mBC-0716-1
"F7,A8",10954,11426,8404,3022,6118,0,2785,2791,1983,808,2.454207921,1346,1032,697,316,0,316,0,98,0,0.028481013,empty,mBC-0716-1
"F7,A9",18544,19189,14328,4861,10103,0,4534,4549,3297,1252,2.633386581,2227,773,430,198,0,198,0,68,0,0.055555556,empty,mBC-0716-1
"F7,A10",15623,16075,11828,4247,8583,0,3942,3946,2828,1118,2.529516995,1906,496,206,105,0,105,0,33,0,0.085714286,empty,mBC-0716-1
"F7,A11",17379,17499,13297,4202,9499,0,4142,4159,2918,1241,2.351329573,1929,855,536,235,0,235,0,74,0,0.063829787,empty,mBC-0716-1
"F7,A12",19804,19877,15265,4612,10331,0,4445,4458,3182,1276,2.493730408,2001,5309,2199,1046,0,1046,0,210,0,0.0583174,empty,mBC-0716-1
"F7,B1",18469,19112,14267,4845,9932,0,4374,4386,3072,1314,2.337899543,2044,765,505,259,0,259,0,74,0,0.111969112,empty,mBC-0716-1
"F7,B2",19867,20062,15032,5030,10346,0,4614,4619,3228,1391,2.320632638,2114,1469,528,256,0,256,0,67,0,0.0625,empty,mBC-0716-1
"F7,B3",17751,18070,13680,4390,9637,0,4286,4294,3028,1266,2.39178515,1918,4378,1475,738,3,735,1,157,0,0.072108844,empty,mBC-0716-1
"F7,B4",15814,16518,12127,4391,8757,0,3935,3945,2777,1168,2.377568493,1938,715,446,218,0,218,0,73,0,0.064220183,empty,mBC-0716-1
"F7,B5",8946,5583,3944,1639,3857,0,1804,1813,1258,555,2.266666667,1000,522,313,159,0,159,0,55,0,0.062893082,empty,mBC-0716-1
"F7,B6",11614,12169,8900,3269,6555,0,3057,3063,2091,972,2.151234568,1459,881,495,270,0,270,0,72,0,0.074074074,empty,mBC-0716-1
"F7,B7",15688,16023,12285,3738,8650,0,3813,3821,2687,1134,2.369488536,1741,879,479,244,0,244,0,72,0,0.143442623,empty,mBC-0716-1
"F7,B8",1525563,1648417,1090759,557658,855083,0,473965,474692,403374,71318,5.655991475,252742,129671,90799,42475,13,42462,2,3134,0,0.001436579,mm10,mBC-0716-1
"F7,B9",14075,14358,10836,3522,7653,0,3391,3402,2355,1047,2.249283668,1588,479,290,149,0,149,0,57,0,0.067114094,empty,mBC-0716-1
"F7,B10",16838,16549,12144,4405,9157,0,4252,4278,2944,1334,2.206896552,2099,408,237,122,0,122,0,43,0,0,empty,mBC-0716-1
"F7,B11",15744,16510,11850,4660,8735,0,4067,4071,2891,1180,2.45,2027,389,221,100,0,100,0,35,0,0,empty,mBC-0716-1
"F7,B12",18202,18344,13751,4593,9819,0,4419,4427,3153,1274,2.474882261,2076,5437,2059,1063,3,1060,2,198,0,0.206603774,empty,mBC-0716-1
"F7,C1",21222,21489,16561,4928,11161,0,4674,4679,3292,1387,2.373467916,2171,444,289,139,0,139,0,46,0,0.107913669,empty,mBC-0716-1
"F7,C2",712655,789632,497241,292391,420513,0,246629,246997,179679,67318,2.669107817,138141,38384,27041,13050,6,13044,2,1479,0,0.002376572,mm10,mBC-0716-1
"F7,C3",19524,20196,14994,5202,10531,0,4796,4806,3377,1429,2.363191043,2256,492,250,144,0,144,0,53,0,0,empty,mBC-0716-1
"F7,C4",29774,31553,22658,8895,16745,0,7953,7964,5737,2227,2.576111361,3943,1602,1052,508,0,508,0,128,0,0.021653543,empty,mBC-0716-1
"F7,C5",16084,16816,12166,4650,8992,0,4206,4212,2934,1278,2.295774648,2079,697,405,197,0,197,0,72,0,0.055837563,empty,mBC-0716-1
"F7,C6",16491,17056,12312,4744,9501,0,4519,4527,3183,1344,2.368303571,2221,1074,710,363,0,363,0,98,0,0.101928375,empty,mBC-0716-1
"F7,C7",16619,17304,12537,4767,9283,0,4306,4316,3053,1263,2.417260491,2121,348,166,66,0,66,0,38,0,0,empty,mBC-0716-1
"F7,C8",14840,15066,11110,3956,8054,0,3666,3680,2574,1106,2.327305606,1754,1430,848,371,0,371,0,113,0,0.045822102,empty,mBC-0716-1
"F7,C9",12438,12933,9469,3464,6824,0,3203,3209,2243,966,2.32194617,1542,946,543,280,0,280,0,71,0,0.060714286,empty,mBC-0716-1
"F7,C10",1235380,1364862,866056,498806,724037,0,432047,432605,357657,74948,4.772068634,237689,57374,41350,19606,8,19598,1,1996,0,0.003928972,mm10,mBC-0716-1
"F7,C11",11460,11818,8655,3163,6306,0,3001,3008,2110,898,2.349665924,1468,411,230,131,0,131,0,59,0,0,empty,mBC-0716-1
"F7,C12",1122064,1198669,831017,367652,631424,1,327800,328383,271253,57130,4.747995799,171067,62858,43069,20489,5,20484,2,2016,0,0.00483304,mm10,mBC-0716-1
"F7,D1",608286,674672,416190,258482,365137,1,218936,219222,155602,63620,2.445803207,125388,10192,5342,2460,3,2457,1,459,0,0.012617013,mm10,mBC-0716-1
"F7,D2",20207,20654,15848,4806,10734,0,4680,4687,3214,1473,2.181941616,2074,1506,1034,498,0,498,0,148,0,0.018072289,empty,mBC-0716-1
"F7,D3",720149,796518,500095,296423,425014,0,248455,248795,202870,45925,4.417419706,139041,55482,34150,16160,4,16156,2,1797,0,0.002413964,mm10,mBC-0716-1
"F7,D4",13796,14053,10477,3576,7570,0,3453,3460,2397,1063,2.254938852,1637,793,480,256,0,256,0,89,0,0.03515625,empty,mBC-0716-1
"F7,D5",515012,552336,377144,175192,299437,2,157134,157389,124044,33345,3.720017994,82578,36516,25563,12068,4,12064,1,1494,0,0.009366711,mm10,mBC-0716-1
"F7,D6",12384,13068,9272,3796,6994,0,3343,3352,2349,1003,2.341974078,1749,1388,708,356,0,356,0,110,0,0.098314607,empty,mBC-0716-1
"F7,D7",13228,13633,10038,3595,7340,0,3413,3416,2389,1027,2.326192795,1653,1051,671,356,0,356,0,108,0,0.025280899,empty,mBC-0716-1
"F7,D8",714813,780253,523391,256862,414648,1,222885,223262,170228,53034,3.209789946,118827,40027,26423,12685,4,12681,1,1358,0,0.001971453,mm10,mBC-0716-1
"F7,D9",312770,356412,205740,150672,194882,0,125485,125630,88846,36784,2.415343628,74870,6647,4323,1930,1,1929,1,371,0,0.01244168,mm10,mBC-0716-1
"F7,D10",12988,13599,9760,3839,7211,0,3390,3407,2347,1060,2.214150943,1660,526,292,143,1,142,1,69,0,0.056338028,empty,mBC-0716-1
"F7,D11",13165,13825,10011,3814,7371,0,3371,3381,2393,988,2.422064777,1641,1058,710,373,0,373,0,101,0,0.040214477,empty,mBC-0716-1
"F7,D12",19606,20156,14945,5211,10742,0,4907,4919,3467,1452,2.387741047,2382,1485,1046,508,0,508,0,147,0,0.041338583,empty,mBC-0716-1
"F7,E1",21681,22237,16701,5536,11764,0,5296,5307,3680,1627,2.261831592,2450,1136,694,369,1,368,1,110,0,0.059782609,empty,mBC-0716-1
"F7,E2",16629,17187,12684,4503,9112,0,4165,4178,2934,1244,2.3585209,2001,1927,862,416,2,414,1,130,0,0.074879227,empty,mBC-0716-1
"F7,E3",12202,12539,9444,3095,6697,0,2995,3006,2095,911,2.299670692,1408,1095,731,388,0,388,0,113,0,0.056701031,empty,mBC-0716-1
"F7,E4",14667,15245,11251,3994,8076,0,3602,3615,2500,1115,2.242152466,1811,937,636,335,0,335,0,85,0,0.062686567,empty,mBC-0716-1
"F7,E5",20318,20807,15808,4999,10943,0,4812,4832,3421,1411,2.424521616,2245,1432,792,382,0,382,0,102,0,0.015706806,empty,mBC-0716-1
"F7,E6",13586,13464,10430,3034,7203,0,3104,3111,2139,972,2.200617284,1436,845,467,233,0,233,0,66,0,0.008583691,empty,mBC-0716-1
"F7,E7",14413,14869,10975,3894,7825,0,3559,3567,2506,1061,2.361922714,1732,983,597,257,0,257,0,85,0,0.06614786,empty,mBC-0716-1
"F7,E8",17182,17392,13153,4239,9248,0,4044,4061,2819,1242,2.269726248,1862,1703,965,444,0,444,0,132,0,0.004504505,empty,mBC-0716-1
"F7,E9",9385,9762,7183,2579,5241,0,2490,2499,1766,733,2.409276944,1186,893,646,327,0,327,0,79,0,0,empty,mBC-0716-1
"F7,E10",15565,16561,11611,4950,8798,0,4379,4385,2635,1750,1.505714286,2250,10318,3449,1702,2,1700,1,327,0,0.024705882,empty,mBC-0716-1
"F7,E11",9273,9830,7008,2822,5305,0,2561,2572,1768,804,2.199004975,1310,937,634,310,0,310,0,74,0,0.087096774,empty,mBC-0716-1
"F7,E12",15428,16142,11642,4500,8683,0,4051,4056,2859,1197,2.388471178,2014,693,448,234,0,234,0,86,0,0.017094017,empty,mBC-0716-1
"F7,F1",17238,17763,13219,4544,9515,0,4321,4324,3090,1234,2.504051864,2060,3726,1494,774,1,773,1,157,0,0.072445019,empty,mBC-0716-1
"F7,F2",21866,22881,16555,6326,12229,0,5779,5780,4111,1669,2.463151588,2844,2147,1435,716,0,716,0,198,0,0.069832402,empty,mBC-0716-1
"F7,F3",16518,17245,12502,4743,9345,0,4484,4496,3130,1366,2.29136164,2172,1065,698,387,0,387,0,139,0,0.005167959,empty,mBC-0716-1
"F7,F4",659046,692641,483588,209053,373767,1,188104,188415,145470,42945,3.38735592,97656,19701,14019,6790,3,6787,1,864,0,0,mm10,mBC-0716-1
"F7,F5",23114,23968,17492,6476,12592,0,5707,5715,3985,1730,2.303468208,2851,1313,886,403,0,403,0,119,0,0.104218362,empty,mBC-0716-1
"F7,F6",23803,24469,18004,6465,13274,0,6118,6143,4368,1775,2.46084507,2991,1551,958,441,0,441,0,137,0,0.079365079,empty,mBC-0716-1
"F7,F7",19904,20562,15166,5396,11027,0,4947,4961,3357,1604,2.092892768,2448,788,473,240,0,240,0,70,0,0.120833333,empty,mBC-0716-1
"F7,F8",955208,1101646,636720,464926,580383,4,376982,377450,263325,114125,2.307338445,220978,6856,4362,2095,0,2095,0,403,0,0.001431981,mm10,mBC-0716-1
"F7,F9",836428,884988,600324,284664,467096,0,252902,253313,178941,74372,2.406026462,134812,30136,17327,8336,6,8330,2,1135,0,0.094597839,mm10,mBC-0716-1
"F7,F10",1501689,1632827,1045081,587746,854484,0,503365,504083,394084,109999,3.582614387,276368,37782,27118,12697,5,12692,1,1589,0,0.004806177,mm10,mBC-0716-1
"F7,F11",11195,11574,8585,2989,6210,0,2802,2809,1957,852,2.296948357,1337,689,441,243,0,243,0,76,0,0.144032922,empty,mBC-0716-1
"F7,F12",13437,13749,10051,3698,7308,0,3437,3447,2395,1052,2.27661597,1678,137,69,40,0,40,0,12,0,0,empty,mBC-0716-1
"F7,G1",9482,9664,7510,2154,5089,0,2222,2224,1577,647,2.4374034,958,1392,964,460,0,460,0,112,0,0.080434783,empty,mBC-0716-1
"F7,G2",19971,20344,15190,5154,10695,0,4694,4706,3259,1447,2.252246026,2243,251,167,102,0,102,0,37,0,0,empty,mBC-0716-1
"F7,G3",19178,19769,14328,5441,10518,0,4918,4920,3470,1450,2.393103448,2439,3591,1699,876,0,876,0,179,0,0.194063927,empty,mBC-0716-1
"F7,G4",26465,27134,20588,6546,14325,0,6313,6323,4499,1824,2.466557018,2987,79,58,40,0,40,0,22,0,0,empty,mBC-0716-1
"F7,G5",737203,794960,539530,255430,416672,3,216733,217081,184766,32315,5.71765434,113849,91070,60935,29236,10,29226,1,2500,0,0.002531992,mm10,mBC-0716-1
"F7,G6",749897,791588,557211,234377,418592,1,209663,210020,177030,32990,5.366171567,106908,3106,2180,1019,1,1018,1,225,0,0.00589391,mm10,mBC-0716-1
"F7,G7",19765,20018,15012,5006,10570,0,4688,4696,3308,1388,2.383285303,2176,9009,3185,1554,0,1554,0,267,0,0.208494208,empty,mBC-0716-1
"F7,G8",14247,14562,10784,3778,7774,0,3560,3568,2509,1059,2.369216242,1654,1133,680,379,0,379,0,124,0,0.023746702,empty,mBC-0716-1
"F7,G9",562171,616472,403075,213397,330277,0,183491,183724,150893,32831,4.596052511,98939,60975,43010,20503,9,20494,4,2027,0,0.006392115,mm10,mBC-0716-1
"F7,G10",813294,862324,594604,267720,455154,1,238446,238857,198885,39972,4.975607926,122612,91485,58982,28073,9,28064,3,2499,0,0.004810433,mm10,mBC-0716-1
"F7,G11",12377,12647,9683,2964,6764,0,3005,3018,2152,866,2.484988453,1349,501,353,192,0,192,0,60,0,0.036458333,empty,mBC-0716-1
"F7,G12",11178,11660,8453,3207,6185,0,2855,2862,2001,861,2.324041812,1369,976,624,283,1,282,1,82,0,0.042553191,empty,mBC-0716-1
"F7,H1",20429,20842,15481,5361,11415,0,5197,5214,3674,1540,2.385714286,2556,626,375,208,0,208,0,80,0,0.086538462,empty,mBC-0716-1
"F7,H2",22851,23455,17598,5857,12369,0,5454,5469,3863,1606,2.405354919,2557,1322,828,417,0,417,0,120,0,0.014388489,empty,mBC-0716-1
"F7,H3",793094,875181,549284,325897,463846,0,277897,278226,206073,72153,2.856055881,154225,33637,24160,11422,4,11418,1,1404,0,0.004203889,mm10,mBC-0716-1
"F7,H4",13950,14599,10438,4161,7811,0,3676,3688,2564,1124,2.28113879,1871,117,80,42,0,42,0,22,0,0,empty,mBC-0716-1
"F7,H5",18118,18789,13675,5114,10040,0,4688,4698,3349,1349,2.482579689,2329,1186,789,448,1,447,1,114,0,0.002237136,empty,mBC-0716-1
"F7,H6",14943,15322,11227,4095,8411,0,3908,3914,2761,1153,2.394622723,1948,3175,1341,627,4,623,2,163,0,0.032102729,empty,mBC-0716-1
"F7,H7",470052,498478,344953,153525,271954,0,141327,141556,108156,33400,3.238203593,73600,7815,4932,2365,1,2364,1,466,0,0.01142132,mm10,mBC-0716-1
"F7,H8",13688,14009,10268,3741,7487,0,3485,3491,2521,970,2.598969072,1703,9938,3319,1684,1,1683,1,326,0,0.144979204,empty,mBC-0716-1
"F7,H9",16073,16462,11987,4475,8874,0,4107,4115,2946,1169,2.520102652,2013,854,541,269,0,269,0,102,0,0.018587361,empty,mBC-0716-1
"F7,H10",14609,15444,10959,4485,8344,0,4033,4040,2824,1216,2.322368421,2079,835,535,298,0,298,0,93,0,0.016778523,empty,mBC-0716-1
"F7,H11",17604,17931,13330,4601,9598,0,4426,4439,3100,1339,2.315160568,2086,891,280,155,0,155,0,44,0,0.006451613,empty,mBC-0716-1
"F7,H12",6367,6608,4854,1754,3589,1,1720,1726,1191,535,2.226168224,817,553,353,161,0,161,0,47,0,0.155279503,empty,mBC-0716-1
"F8,A1",14488,14773,10697,4076,7938,1,3676,3696,2575,1121,2.2970562,1801,3509,1627,850,0,850,0,153,0,0.327058824,empty,mBC-0716-1
"F8,A2",18325,18821,14080,4741,9828,0,4264,4274,3026,1248,2.424679487,1977,958,641,324,0,324,0,120,0,0.015432099,empty,mBC-0716-1
"F8,A3",16435,16724,12585,4139,8949,0,4098,4116,2871,1245,2.306024096,1922,1651,690,332,0,332,0,100,0,0.141566265,empty,mBC-0716-1
"F8,A4",22099,22310,17091,5219,11578,0,5033,5050,3575,1475,2.423728814,2301,391,231,119,0,119,0,48,0,0.008403361,empty,mBC-0716-1
"F8,A5",17070,17748,12969,4779,9207,0,4161,4174,2853,1321,2.159727479,2012,1022,638,332,0,332,0,111,0,0.03313253,empty,mBC-0716-1
"F8,A6",1180931,1252480,873793,378687,656405,3,337436,337983,260385,77598,3.355563288,174171,87050,59516,29137,10,29127,2,2769,0,0.00827411,mm10,mBC-0716-1
"F8,A7",16712,17160,12709,4451,8929,0,4061,4081,2854,1227,2.32599837,1925,4186,1602,787,1,786,1,163,0,0.131043257,empty,mBC-0716-1
"F8,A8",10955,11421,8245,3176,6088,0,2884,2887,2032,855,2.376608187,1439,2160,947,489,0,489,0,150,0,0.079754601,empty,mBC-0716-1
"F8,A9",19385,19854,14945,4909,10365,0,4520,4524,3230,1294,2.496136012,2170,929,571,325,0,325,0,105,0,0.043076923,empty,mBC-0716-1
"F8,A10",15660,15801,11967,3834,8387,0,3746,3757,2673,1084,2.465867159,1721,264,179,96,0,96,0,41,0,0.010416667,empty,mBC-0716-1
"F8,A11",808360,893477,542433,351044,470777,1,291328,291766,237662,54104,4.392688156,164280,45799,32879,15672,5,15667,1,1679,0,0.002872279,mm10,mBC-0716-1
"F8,A12",20424,21058,15771,5287,10894,0,4850,4867,3406,1461,2.331279945,2244,2529,1681,814,0,814,0,168,0,0.068796069,empty,mBC-0716-1
"F8,B1",19232,19666,15112,4554,10390,0,4593,4600,3164,1436,2.203342618,2118,989,634,359,0,359,0,109,0,0.013927577,empty,mBC-0716-1
"F8,B2",20024,20529,15316,5213,10734,0,4808,4814,3359,1455,2.308591065,2251,1847,670,330,1,329,1,76,0,0.100303951,empty,mBC-0716-1
"F8,B3",20016,20634,15345,5289,10943,0,5045,5052,3513,1539,2.282651072,2416,1255,804,389,0,389,0,127,0,0.074550129,empty,mBC-0716-1
"F8,B4",16967,17678,12967,4711,9280,0,4219,4227,2938,1289,2.279286268,2089,1112,651,350,0,350,0,114,0,0.017142857,empty,mBC-0716-1
"F8,B5",8942,5587,3942,1645,3798,0,1862,1880,1298,582,2.23024055,992,700,464,234,0,234,0,71,0,0,empty,mBC-0716-1
"F8,B6",11845,12488,8932,3556,6499,0,3067,3073,2081,992,2.097782258,1561,1046,625,367,0,367,0,101,0,0.108991826,empty,mBC-0716-1
"F8,B7",615781,645350,462826,182524,347169,0,170074,170368,105714,64654,1.635072849,87115,11519,7047,3390,0,3390,0,612,0,0.013274336,mm10,mBC-0716-1
"F8,B8",13787,14371,10501,3870,7578,0,3434,3436,2411,1025,2.352195122,1688,1163,645,355,0,355,0,99,0,0.109859155,empty,mBC-0716-1
"F8,B9",15020,15267,11590,3677,8109,0,3581,3591,2478,1113,2.226415094,1632,567,297,138,0,138,0,50,0,0.036231884,empty,mBC-0716-1
"F8,B10",16382,15984,12023,3961,8746,0,3877,3902,2672,1230,2.172357724,1794,439,282,167,0,167,0,67,0,0,empty,mBC-0716-1
"F8,B11",810897,894667,565642,329025,468982,1,272400,272763,227742,45021,5.058572666,151836,10987,7549,3531,1,3530,1,589,0,0.005382436,mm10,mBC-0716-1
"F8,B12",18037,18618,13841,4777,9789,0,4367,4377,3023,1354,2.232644018,1997,1153,704,360,0,360,0,105,0,0.033333333,empty,mBC-0716-1
"F8,C1",1149924,1237017,831828,405189,634518,2,346684,347158,271705,75453,3.600983394,182805,50490,36453,17498,6,17492,2,1861,0,0.001257718,mm10,mBC-0716-1
"F8,C2",18564,19227,13911,5316,10026,0,4615,4634,3254,1380,2.357971014,2261,1513,955,478,0,478,0,150,0,0.058577406,empty,mBC-0716-1
"F8,C3",20338,20681,15221,5460,10946,0,5113,5129,3640,1489,2.444593687,2572,3692,1141,562,0,562,0,135,0,0.078291815,empty,mBC-0716-1
"F8,C4",1566310,1660207,1130076,530131,864901,2,461963,462688,384161,78527,4.892088072,242802,141903,96793,46017,17,46000,2,3411,0,0.000978261,mm10,mBC-0716-1
"F8,C5",16566,17090,12636,4454,8864,0,4051,4054,2882,1172,2.459044369,1941,983,657,355,0,355,0,101,0,0.081690141,empty,mBC-0716-1
"F8,C6",17233,17164,13038,4126,9499,0,4321,4331,3100,1231,2.518277823,1999,982,614,302,2,300,1,93,0,0.11,empty,mBC-0716-1
"F8,C7",16947,17536,12773,4763,9286,0,4394,4400,3046,1354,2.249630724,2110,3107,1101,586,1,585,1,113,0,0.138461538,empty,mBC-0716-1
"F8,C8",14710,15284,11110,4174,8190,1,3765,3779,2657,1122,2.368092692,1823,1617,908,471,0,471,0,132,0,0.061571125,empty,mBC-0716-1
"F8,C9",12548,12855,9453,3402,6701,0,3041,3046,2112,934,2.26124197,1477,828,474,229,0,229,0,63,0,0.030567686,empty,mBC-0716-1
"F8,C10",13347,13754,10409,3345,7281,0,3224,3229,2275,954,2.384696017,1442,944,528,262,0,262,0,95,0,0.083969466,empty,mBC-0716-1
"F8,C11",11901,12274,9016,3258,6370,0,2960,2964,2064,900,2.293333333,1412,645,448,211,0,211,0,71,0,0.047393365,empty,mBC-0716-1
"F8,C12",1470766,1581943,1071729,510214,817580,2,445975,446715,338198,108517,3.116543952,235882,75850,50113,24028,7,24021,1,2366,0,0.011240165,mm10,mBC-0716-1
"F8,D1",10924,11141,8153,2988,6038,0,2775,2785,1959,826,2.371670702,1340,584,396,206,0,206,0,54,0,0.004854369,empty,mBC-0716-1
"F8,D2",21452,21510,16652,4858,11306,0,4805,4814,3367,1447,2.326883207,2156,2240,1369,677,0,677,0,182,0,0.013293944,empty,mBC-0716-1
"F8,D3",13609,14029,10148,3881,7591,0,3586,3588,2449,1139,2.150131694,1715,12007,3923,2021,1,2020,1,341,0,0.04950495,empty,mBC-0716-1
"F8,D4",13906,14649,10557,4092,7536,0,3417,3422,2407,1015,2.371428571,1677,1381,748,396,1,395,1,119,0,0.017721519,empty,mBC-0716-1
"F8,D5",20671,20928,13994,6934,10959,0,5906,5914,3217,2697,1.192806822,3217,10606,3974,1950,4,1946,1,366,0,0.161356629,empty,mBC-0716-1
"F8,D6",12462,12878,9431,3447,6728,0,3160,3171,2184,987,2.212765957,1546,1319,787,385,0,385,0,128,0,0.023376623,empty,mBC-0716-1
"F8,D7",12999,13226,9913,3313,7077,0,3223,3232,2321,911,2.547749726,1522,1207,768,371,0,371,0,114,0,0.002695418,empty,mBC-0716-1
"F8,D8",712343,773541,514332,259209,412542,0,223654,224029,190033,33996,5.589863513,120327,55411,37985,18257,1,18256,1,1816,0,0.000931201,mm10,mBC-0716-1
"F8,D9",4522,4592,3356,1236,2551,0,1218,1220,863,357,2.417366947,600,5971,1885,923,0,923,0,189,0,0.03900325,empty,mBC-0716-1
"F8,D10",14253,14772,10846,3926,7722,0,3543,3545,2515,1030,2.441747573,1715,785,462,233,0,233,0,71,0,0.137339056,empty,mBC-0716-1
"F8,D11",13962,14337,10597,3740,7610,0,3482,3486,2509,977,2.568065507,1715,1283,652,373,2,371,1,127,0,0.02425876,empty,mBC-0716-1
"F8,D12",20648,20942,15791,5151,11114,0,5022,5035,3530,1505,2.34551495,2375,3385,1825,920,1,919,1,207,0,0.07616975,empty,mBC-0716-1
"F8,E1",569519,563686,434103,129583,302849,2,131100,131349,98578,32771,3.008086418,61080,8995,5311,2529,2,2527,1,566,0,0.013058963,mm10,mBC-0716-1
"F8,E2",773127,832667,548261,284406,441108,0,246281,246622,188925,57697,3.274433679,132987,110925,52823,25272,11,25261,2,2434,0,0.026681446,mm10,mBC-0716-1
"F8,E3",12473,12682,9514,3168,6673,0,2953,2954,2038,916,2.22489083,1379,1255,796,398,0,398,0,131,0,0.057788945,empty,mBC-0716-1
"F8,E4",15860,16113,12156,3957,8348,0,3790,3802,2751,1051,2.617507136,1697,5643,2146,1142,0,1142,0,246,0,0.049036778,empty,mBC-0716-1
"F8,E5",26083,26750,20294,6456,14115,0,6377,6386,4514,1872,2.411324786,2949,1320,903,430,0,430,0,123,0,0.058139535,empty,mBC-0716-1
"F8,E6",13048,13232,10091,3141,7029,0,3055,3065,2085,980,2.12755102,1413,1358,891,438,0,438,0,114,0,0.020547945,empty,mBC-0716-1
"F8,E7",604918,608911,464249,144662,323303,1,141350,141607,108212,33395,3.240365324,66513,11944,7979,3839,1,3838,1,660,0,0.008598228,mm10,mBC-0716-1
"F8,E8",17664,18052,13559,4493,9433,0,4182,4202,2929,1273,2.300864101,2004,2477,1337,643,0,643,0,184,0,0.090202177,empty,mBC-0716-1
"F8,E9",8812,9158,6681,2477,4810,0,2228,2228,1562,666,2.345345345,1060,1134,675,369,0,369,0,116,0,0.135501355,empty,mBC-0716-1
"F8,E10",13102,13466,10059,3407,7236,0,3296,3302,2331,971,2.40061792,1576,1004,580,289,0,289,0,95,0,0.062283737,empty,mBC-0716-1
"F8,E11",9293,9554,7046,2508,5082,0,2322,2330,1655,675,2.451851852,1108,985,630,326,1,325,1,104,0,0.052307692,empty,mBC-0716-1
"F8,E12",14435,14928,10865,4063,7985,0,3742,3747,2611,1136,2.298415493,1846,907,555,274,1,273,1,93,0,0.014652015,empty,mBC-0716-1
"F8,F1",961679,1119068,637369,481699,585710,1,378097,378606,295477,83129,3.554439486,223749,94471,63921,30611,19,30592,4,2617,0,0.001046025,mm10,mBC-0716-1
"F8,F2",21793,22288,16444,5844,11741,0,5363,5369,3763,1606,2.343088418,2540,2383,1598,805,0,805,0,214,0,0.052173913,empty,mBC-0716-1
"F8,F3",1076955,1137181,797355,339826,603374,2,306611,307065,233446,73619,3.171002051,159171,100008,67642,32726,12,32714,1,2762,0,0.001314422,mm10,mBC-0716-1
"F8,F4",16466,16366,12521,3845,8922,0,3997,4010,2817,1193,2.361274099,1819,780,528,259,0,259,0,84,0,0.027027027,empty,mBC-0716-1
"F8,F5",27727,28274,21305,6969,14781,0,6625,6637,4671,1966,2.375890132,3063,1628,1004,522,1,521,1,152,0,0.040307102,empty,mBC-0716-1
"F8,F6",617121,635820,455640,180180,340213,0,167108,167403,135110,32293,4.183878859,84198,34717,22534,11119,4,11115,2,1423,0,0.007287449,mm10,mBC-0716-1
"F8,F7",19817,20027,15170,4857,10844,0,4811,4823,3377,1446,2.335408022,2236,816,561,308,0,308,0,84,0,0.029220779,empty,mBC-0716-1
"F8,F8",23112,23927,17680,6247,12511,0,5809,5814,4065,1749,2.324185249,2811,204,92,52,0,52,0,29,0,0,empty,mBC-0716-1
"F8,F9",15186,15473,11759,3714,8205,0,3692,3701,2566,1135,2.260792952,1706,6721,2252,1150,1,1149,1,250,0,0.07745866,empty,mBC-0716-1
"F8,F10",21312,21566,16514,5052,11240,5,4781,4792,3410,1382,2.467438495,2186,2047,1080,516,0,516,0,152,0,0.019379845,empty,mBC-0716-1
"F8,F11",12499,12693,9722,2971,6887,0,3021,3034,2107,927,2.272923409,1430,946,604,332,0,332,0,102,0,0.036144578,empty,mBC-0716-1
"F8,F12",13728,14049,10362,3687,7529,0,3462,3469,2474,995,2.486432161,1694,64,38,18,0,18,0,12,0,0,empty,mBC-0716-1
"F8,G1",10448,10692,8129,2563,5683,0,2439,2445,1650,795,2.075471698,1127,1398,850,443,0,443,0,123,0,0.013544018,empty,mBC-0716-1
"F8,G2",20631,21206,15729,5477,11008,0,4928,4944,3411,1533,2.225048924,2347,454,338,156,0,156,0,55,0,0.08974359,empty,mBC-0716-1
"F8,G3",703571,712202,527136,185066,378439,0,176424,176691,137406,39285,3.497670867,85968,28521,15773,7535,1,7534,1,1171,0,0.006769312,mm10,mBC-0716-1
"F8,G4",1316692,1390284,914762,475522,719088,3,400896,401459,290400,111059,2.614826354,216388,1346,940,463,0,463,0,112,0,0,empty,mBC-0716-1
"F8,G5",511378,543111,372025,171086,292325,2,155103,155356,119676,35680,3.354147982,81311,35759,17310,8652,8,8644,3,1258,0,0.01723739,mm10,mBC-0716-1
"F8,G6",24277,24632,18744,5888,12953,0,5695,5709,4066,1643,2.474741327,2646,130,85,59,0,59,0,24,0,0.016949153,empty,mBC-0716-1
"F8,G7",20061,20672,15579,5093,10819,1,4789,4797,3369,1428,2.359243697,2288,1694,969,536,0,536,0,167,0,0.03358209,empty,mBC-0716-1
"F8,G8",588044,653331,421963,231368,348598,2,194036,194372,165128,29244,5.646559978,106783,88562,57115,28074,13,28061,1,2274,0,0.002637112,mm10,mBC-0716-1
"F8,G9",629834,696811,448652,248159,370774,1,205458,205778,168931,36847,4.584660895,112792,151660,103731,49746,15,49731,2,3239,0,0.002131467,mm10,mBC-0716-1
"F8,G10",13706,14299,10856,3443,7514,0,3325,3338,2331,1007,2.314796425,1523,1226,855,433,0,433,0,130,0,0.064665127,empty,mBC-0716-1
"F8,G11",12344,12763,9425,3338,6800,1,3091,3101,2171,930,2.334408602,1515,723,505,252,0,252,0,90,0,0,empty,mBC-0716-1
"F8,G12",11478,11768,8685,3083,6278,0,2924,2930,2045,885,2.310734463,1376,977,621,314,0,314,0,92,0,0.092356688,empty,mBC-0716-1
"F8,H1",603664,629479,453161,176318,337961,0,165464,165732,124998,40734,3.068640448,83133,10233,6683,3125,1,3124,1,554,0,0.000960307,mm10,mBC-0716-1
"F8,H2",26234,26904,19764,7140,14116,0,6501,6529,4605,1924,2.393451143,3257,1601,1075,539,0,539,0,147,0,0.055658627,empty,mBC-0716-1
"F8,H3",871646,927757,625359,302398,486480,1,257298,257711,220445,37266,5.915445715,136137,96145,67445,32604,17,32587,3,2502,0,0.000490993,mm10,mBC-0716-1
"F8,H4",13515,13807,10201,3606,7227,0,3258,3268,2242,1026,2.185185185,1590,115,70,44,0,44,0,20,0,0.272727273,empty,mBC-0716-1
"F8,H5",487210,504252,342128,162124,265175,1,137515,137741,111369,26372,4.223001668,72888,50003,32717,15937,9,15928,1,1770,0,0.000878955,mm10,mBC-0716-1
"F8,H6",400470,414536,306456,108080,225806,0,102226,102422,75576,26846,2.815167995,50877,17860,10408,4925,2,4923,2,814,0,0.015437741,mm10,mBC-0716-1
"F8,H7",17024,17765,12696,5069,9435,0,4393,4403,3130,1273,2.458758837,2177,1270,783,435,0,435,0,150,0,0.034482759,empty,mBC-0716-1
"F8,H8",13424,13685,10072,3613,7193,0,3283,3296,2235,1061,2.106503299,1589,1277,791,393,0,393,0,119,0,0.050890585,empty,mBC-0716-1
"F8,H9",755146,826055,530390,295665,438397,0,249471,249794,185896,63898,2.909261636,138494,90191,58307,28231,20,28211,2,2465,0,0.005033498,mm10,mBC-0716-1
"F8,H10",15228,15724,11484,4240,8338,0,3860,3871,2672,1199,2.22852377,1925,1145,659,308,0,308,0,120,0,0.032467532,empty,mBC-0716-1
"F8,H11",678435,762797,470986,291811,406685,1,237970,238333,189643,48690,3.894906552,135290,9056,4439,2171,2,2169,1,419,0,0.007837713,mm10,mBC-0716-1
"F8,H12",5828,6031,4311,1720,3241,0,1556,1564,1087,477,2.278825996,775,629,404,229,0,229,0,65,0,0.043668122,empty,mBC-0716-1
"F9,A1",623988,670056,456051,214005,362208,0,188470,188776,144465,44311,3.260251405,99890,66308,46345,22112,8,22104,2,2102,0,0.000180963,mm10,mBC-0716-1
"F9,A2",685309,765532,458471,307061,411459,0,258383,258668,172455,86213,2.000336376,151179,7123,4749,2338,1,2337,1,466,0,0.008985879,mm10,mBC-0716-1
"F9,A3",2235334,2515975,1516024,999951,1311359,4,831716,832696,641600,191096,3.357474777,475424,134484,86237,41088,9,41079,5,3353,0,0.002896857,mm10,mBC-0716-1
"F9,A4",20968,21113,16304,4809,11399,3,4960,4977,3588,1389,2.583153348,2219,576,327,189,0,189,0,61,0,0.137566138,empty,mBC-0716-1
"F9,A5",16816,17356,12829,4527,9298,0,4266,4270,2980,1290,2.310077519,2036,12286,5657,2829,8,2821,2,453,0,0.013115916,empty,mBC-0716-1
"F9,A6",13055,13182,9771,3411,7139,0,3307,3314,2303,1011,2.277942631,1638,1624,1136,557,0,557,0,180,0,0.023339318,empty,mBC-0716-1
"F9,A7",16587,16990,12551,4439,9044,0,4174,4180,2949,1231,2.395613323,1964,6371,2630,1338,1,1337,1,263,0,0.039640987,empty,mBC-0716-1
"F9,A8",574458,633652,404810,228842,340862,1,192237,192524,160673,31851,5.044519795,106043,86616,57387,27051,8,27043,1,2544,0,0.003808749,mm10,mBC-0716-1
"F9,A9",19411,19456,15128,4328,10078,0,4367,4373,3038,1335,2.275655431,1907,1198,726,375,0,375,0,115,0,0.021333333,empty,mBC-0716-1
"F9,A10",15844,16006,12090,3916,8400,0,3709,3713,2640,1073,2.460391426,1710,410,247,131,0,131,0,56,0,0,empty,mBC-0716-1
"F9,A11",17763,18251,13525,4726,9752,0,4431,4436,3080,1356,2.271386431,2167,872,519,261,0,261,0,109,0,0.026819923,empty,mBC-0716-1
"F9,A12",558076,591450,417457,173993,315373,0,155998,156283,130708,25575,5.110772239,79678,219061,152220,73682,24,73658,6,3821,0,0.001031796,mm10,mBC-0716-1
"F9,B1",715419,761727,541940,219787,401846,3,191629,191973,151019,40954,3.68752747,97726,111543,79007,37251,12,37239,3,2872,0,0.000966728,mm10,mBC-0716-1
"F9,B2",953169,1064461,664509,399952,562279,1,328947,329369,264819,64550,4.102540666,184468,42766,27969,13312,1,13311,1,1508,0,0.000601007,mm10,mBC-0716-1
"F9,B3",18894,19277,14513,4764,10128,1,4468,4474,3147,1327,2.371514695,2069,1285,750,400,1,399,1,140,0,0.037593985,empty,mBC-0716-1
"F9,B4",17398,17516,13080,4436,9248,0,4286,4301,2996,1305,2.295785441,1973,7667,3128,1576,0,1576,0,266,0,0.335659898,empty,mBC-0716-1
"F9,B5",573529,351611,219615,131996,243586,6,138687,139449,108593,30856,3.519347939,80707,47863,33542,15814,7,15807,3,1755,0,0.006263048,mm10,mBC-0716-1
"F9,B6",12126,12444,9209,3235,6613,0,3012,3015,2114,901,2.346281909,1442,1780,1223,593,0,593,0,141,0,0.02529511,empty,mBC-0716-1
"F9,B7",16552,16888,12827,4061,8948,0,3975,3981,2792,1189,2.348191758,1840,994,674,338,0,338,0,114,0,0.01183432,empty,mBC-0716-1
"F9,B8",13426,13788,10393,3395,7327,0,3276,3280,2219,1061,2.091423186,1521,3371,1317,687,0,687,0,185,0,0.045123726,empty,mBC-0716-1
"F9,B9",15647,16132,12107,4025,8428,0,3877,3887,2645,1242,2.12962963,1837,669,461,193,0,193,0,59,0,0.046632124,empty,mBC-0716-1
"F9,B10",16321,15770,11748,4022,8653,0,3864,3884,2657,1227,2.165444173,1843,514,339,186,1,185,1,66,0,0.027027027,empty,mBC-0716-1
"F9,B11",18120,18828,13657,5171,10094,0,4769,4780,3356,1424,2.356741573,2354,267,157,102,0,102,0,54,0,0,empty,mBC-0716-1
"F9,B12",18614,18721,14152,4569,10092,0,4486,4493,3192,1301,2.45349731,2060,1382,844,446,0,446,0,154,0,0.047085202,empty,mBC-0716-1
"F9,C1",1390503,1541349,978150,563199,789605,1,460501,461153,312240,148913,2.096794773,258737,40535,28734,13788,5,13783,2,1556,0,0.001451063,mm10,mBC-0716-1
"F9,C2",18979,19300,14268,5032,10383,0,4724,4738,3355,1383,2.425885756,2229,8978,3248,1525,2,1523,2,306,0,0.082731451,empty,mBC-0716-1
"F9,C3",20416,21214,15524,5690,11037,0,4989,5000,3455,1545,2.236245955,2436,1755,696,309,0,309,0,101,0,0.012944984,empty,mBC-0716-1
"F9,C4",17044,17360,13085,4275,9425,0,4120,4141,2882,1259,2.289118348,1977,1251,771,393,0,393,0,130,0,0.066157761,empty,mBC-0716-1
"F9,C5",16368,16556,12485,4071,8765,0,4028,4037,2828,1209,2.339123242,1832,9225,3588,1776,3,1773,1,329,0,0.009024253,empty,mBC-0716-1
"F9,C6",1566630,1752373,1064270,688103,945435,2,574220,575043,472022,103021,4.58180371,328475,234724,156551,74640,25,74615,4,4261,0,0.000964953,mm10,mBC-0716-1
"F9,C7",16547,17456,12417,5039,9282,0,4301,4307,2942,1365,2.155311355,2168,556,413,209,0,209,0,73,0,0.04784689,empty,mBC-0716-1
"F9,C8",1403334,1493134,1027943,465191,785180,2,408915,409553,330101,79452,4.154722348,213233,206800,141689,68736,20,68716,3,4171,0,0.000756738,mm10,mBC-0716-1
"F9,C9",13120,13613,10068,3545,7241,1,3336,3352,2266,1086,2.086556169,1607,702,394,209,0,209,0,75,0,0.043062201,empty,mBC-0716-1
"F9,C10",842239,957942,568051,389891,509059,0,320349,320770,260827,59943,4.351250355,184430,94411,63322,30264,18,30246,2,2499,0,0.003736031,mm10,mBC-0716-1
"F9,C11",824081,940231,559987,380244,498540,1,313051,313407,239402,74005,3.234943585,180424,28795,20319,9783,3,9780,1,1215,0,0.000204499,mm10,mBC-0716-1
"F9,C12",19665,20763,14996,5767,10924,0,4987,5012,3557,1455,2.44467354,2524,1374,923,469,0,469,0,139,0,0.057569296,empty,mBC-0716-1
"F9,D1",10934,11390,8061,3329,6275,0,3061,3071,2106,965,2.18238342,1584,612,408,206,0,206,0,66,0,0.009708738,empty,mBC-0716-1
"F9,D2",788941,855624,577069,278555,451997,1,236006,236322,203676,32646,6.238926668,124533,187968,132639,63051,23,63028,3,3550,0,0.000380783,mm10,mBC-0716-1
"F9,D3",13473,13957,10023,3934,7441,0,3523,3529,2435,1094,2.225776965,1757,3439,1369,683,0,683,0,164,0,0.019033675,empty,mBC-0716-1
"F9,D4",702700,781977,502638,279339,415764,1,231555,231883,179996,51887,3.468999942,127731,107298,72935,34295,8,34287,2,2756,0,0.002012425,mm10,mBC-0716-1
"F9,D5",13662,14144,10332,3812,7552,0,3546,3553,2515,1038,2.422928709,1724,2436,1662,876,0,876,0,219,0,0.014840183,empty,mBC-0716-1
"F9,D6",12482,13009,9486,3523,6918,0,3203,3218,2237,981,2.280326198,1627,1306,882,476,0,476,0,145,0,0.021008403,empty,mBC-0716-1
"F9,D7",13272,13910,10039,3871,7352,0,3483,3487,2411,1076,2.24070632,1703,2054,1388,734,0,734,0,186,0,0.046321526,empty,mBC-0716-1
"F9,D8",621238,675790,451600,224190,362818,0,193859,194157,146902,47255,3.108708073,104166,44781,32004,15346,5,15341,1,1637,0,0.002281468,mm10,mBC-0716-1
"F9,D9",4477,4578,3290,1288,2520,0,1191,1193,821,372,2.206989247,606,1266,682,354,1,353,1,119,0,0.059490085,empty,mBC-0716-1
"F9,D10",14386,15083,10989,4094,8001,0,3797,3806,2682,1124,2.386120996,1846,1019,549,267,0,267,0,81,0,0.101123596,empty,mBC-0716-1
"F9,D11",13310,13361,10079,3282,7165,0,3154,3161,2199,962,2.285862786,1471,1229,800,418,0,418,0,132,0,0.045454545,empty,mBC-0716-1
"F9,D12",20830,21346,15929,5417,11127,0,4987,4996,3500,1496,2.339572193,2357,1872,1212,576,0,576,0,183,0,0.012152778,empty,mBC-0716-1
"F9,E1",22196,22535,17049,5486,11816,0,5147,5159,3640,1519,2.396313364,2389,1622,1021,543,0,543,0,185,0,0.014732965,empty,mBC-0716-1
"F9,E2",654522,678066,493137,184929,361330,1,167060,167392,141671,25721,5.50798958,82322,156997,107259,50775,24,50751,4,3342,0,0.001320171,mm10,mBC-0716-1
"F9,E3",12977,13010,10123,2887,6968,0,3072,3079,2139,940,2.275531915,1357,1665,1024,538,0,538,0,166,0,0.053903346,empty,mBC-0716-1
"F9,E4",932497,1011986,669761,342225,528047,1,286823,287260,252167,35093,7.185678055,153935,147525,106941,51355,15,51340,3,3395,0,0.000525906,mm10,mBC-0716-1
"F9,E5",20861,21321,16079,5242,11277,0,4919,4941,3455,1486,2.325033647,2292,3231,2295,1192,0,1192,0,255,0,0.013422819,empty,mBC-0716-1
"F9,E6",13666,13623,10474,3149,7260,0,3168,3176,2212,964,2.294605809,1416,2245,1517,781,0,781,0,193,0,0.010243278,empty,mBC-0716-1
"F9,E7",13889,14164,10552,3612,7545,0,3328,3338,2346,992,2.364919355,1591,1424,906,522,1,521,1,133,0,0.030710173,empty,mBC-0716-1
"F9,E8",17646,18043,13757,4286,9594,0,4135,4146,2940,1206,2.437810945,1896,2313,1475,762,0,762,0,212,0,0.044619423,empty,mBC-0716-1
"F9,E9",629739,694262,422047,272215,368701,1,225851,226161,187135,39026,4.795136576,128264,107307,71457,34087,8,34079,1,2781,0,0.001056369,mm10,mBC-0716-1
"F9,E10",13350,13951,10261,3690,7393,0,3412,3419,2338,1081,2.162812211,1610,8485,2854,1422,0,1422,0,289,0,0.040787623,empty,mBC-0716-1
"F9,E11",9319,9535,7051,2484,5116,0,2373,2377,1601,776,2.06314433,1146,1081,691,350,0,350,0,116,0,0.042857143,empty,mBC-0716-1
"F9,E12",14452,14963,10962,4001,7931,0,3664,3668,2543,1125,2.260444444,1747,1340,736,367,0,367,0,124,0,0.038147139,empty,mBC-0716-1
"F9,F1",18250,18206,14037,4169,9661,0,4221,4237,2968,1269,2.338849488,1891,1212,766,388,0,388,0,112,0,0.038659794,empty,mBC-0716-1
"F9,F2",22685,23573,17295,6278,12428,0,5698,5706,3983,1723,2.311665699,2773,2529,1572,830,0,830,0,258,0,0.048192771,empty,mBC-0716-1
"F9,F3",16504,17361,12360,5001,9112,0,4445,4453,3059,1394,2.194404591,2234,1449,890,456,1,455,1,198,0,0.028571429,empty,mBC-0716-1
"F9,F4",16486,16907,12599,4308,9216,0,4126,4138,2893,1245,2.323694779,1978,1262,602,305,0,305,0,116,0,0.029508197,empty,mBC-0716-1
"F9,F5",24586,25067,18789,6278,13188,0,5909,5917,4119,1798,2.290878754,2869,3943,2504,1250,0,1250,0,287,0,0.028,empty,mBC-0716-1
"F9,F6",23043,23899,17420,6479,12666,0,5823,5837,4125,1712,2.409462617,2788,2426,1580,775,1,774,1,205,0,0.0374677,empty,mBC-0716-1
"F9,F7",19804,20285,15289,4996,11089,0,4869,4878,3443,1435,2.399303136,2331,956,569,297,0,297,0,111,0,0.003367003,empty,mBC-0716-1
"F9,F8",1008383,1178751,652603,526148,620811,2,413420,413895,328974,84921,3.873882785,247644,9825,6837,3134,1,3133,1,540,0,0,mm10,mBC-0716-1
"F9,F9",15610,15835,11903,3932,8437,0,3753,3766,2623,1143,2.294838145,1762,8655,2827,1449,2,1447,2,343,0,0.047684865,empty,mBC-0716-1
"F9,F10",21121,21605,16260,5345,11302,0,4929,4933,3451,1482,2.328609987,2308,1256,805,431,0,431,0,142,0,0.053364269,empty,mBC-0716-1
"F9,F11",11421,11787,8884,2903,6281,0,2828,2839,1918,921,2.082519001,1346,1099,654,334,0,334,0,120,0,0.062874251,empty,mBC-0716-1
"F9,F12",14412,14859,10953,3906,7942,0,3636,3639,2555,1084,2.35701107,1791,136,86,46,0,46,0,17,0,0,empty,mBC-0716-1
"F9,G1",10275,10499,7887,2612,5537,0,2425,2429,1692,737,2.295793758,1105,7519,2519,1220,2,1218,1,243,0,0.030377668,empty,mBC-0716-1
"F9,G2",20244,20837,15236,5601,10990,0,4878,4884,3377,1507,2.240875912,2372,490,348,185,0,185,0,59,0,0.005405405,empty,mBC-0716-1
"F9,G3",19944,20523,15188,5335,10768,3,5024,5038,3416,1622,2.106041924,2382,3733,1743,941,1,940,1,242,0,0.140425532,empty,mBC-0716-1
"F9,G4",27939,28290,21582,6708,14947,0,6405,6425,4489,1936,2.318698347,2971,80,51,39,0,39,0,27,0,0,empty,mBC-0716-1
"F9,G5",13237,13614,10177,3437,7309,0,3317,3324,2364,960,2.4625,1574,2178,1504,789,0,789,0,212,0,0.013941698,empty,mBC-0716-1
"F9,G6",24913,25477,19151,6326,13535,0,5969,5987,4193,1794,2.337235229,2826,272,199,107,0,107,0,40,0,0.018691589,empty,mBC-0716-1
"F9,G7",20517,20959,15971,4988,11111,0,4863,4875,3471,1404,2.472222222,2221,1944,1109,587,0,587,0,185,0,0.069846678,empty,mBC-0716-1
"F9,G8",14838,15202,11251,3951,8018,0,3632,3637,2531,1106,2.288426763,1702,1828,1132,595,0,595,0,175,0,0.042016807,empty,mBC-0716-1
"F9,G9",10869,11425,8158,3267,5991,0,2772,2779,1930,849,2.273262662,1415,1393,927,490,0,490,0,138,0,0.057142857,empty,mBC-0716-1
"F9,G10",13851,13898,10698,3200,7301,0,3168,3173,2200,973,2.261048304,1423,1080,663,363,2,361,1,138,0,0.03601108,empty,mBC-0716-1
"F9,G11",12358,12756,9505,3251,6743,0,3048,3056,2118,938,2.257995736,1469,716,512,248,0,248,0,98,0,0,empty,mBC-0716-1
"F9,G12",11793,12027,8888,3139,6480,0,2964,2978,2160,818,2.640586797,1375,6255,2220,1137,1,1136,1,229,0,0.044014085,empty,mBC-0716-1
"F9,H1",21040,21142,15934,5208,11366,0,5157,5167,3670,1497,2.451569806,2474,1259,789,412,0,412,0,139,0,0,empty,mBC-0716-1
"F9,H2",25946,26291,19966,6325,13971,0,6288,6305,4527,1778,2.546119235,2845,1904,1322,621,0,621,0,190,0,0.019323671,empty,mBC-0716-1
"F9,H3",19540,20042,14787,5255,10598,0,4852,4861,3446,1415,2.435335689,2263,1419,889,477,0,477,0,156,0,0.056603774,empty,mBC-0716-1
"F9,H4",754941,836330,534509,301821,443803,0,249463,249841,185769,64072,2.899378824,140132,4672,3231,1512,2,1510,1,282,0,0.005298013,mm10,mBC-0716-1
"F9,H5",18382,18994,13905,5089,10213,0,4726,4739,3344,1395,2.397132616,2298,2981,2083,1086,0,1086,0,254,0,0.025782689,empty,mBC-0716-1
"F9,H6",13584,14262,10145,4117,7739,0,3721,3733,2658,1075,2.47255814,1855,2110,1313,699,0,699,0,205,0,0.027181688,empty,mBC-0716-1
"F9,H7",17145,17345,12955,4390,9441,0,4330,4345,3124,1221,2.558558559,2084,1754,1040,566,0,566,0,193,0,0.044169611,empty,mBC-0716-1
"F9,H8",21702,23410,15898,7512,12674,0,6583,6589,5023,1566,3.207535121,3511,1472,935,510,0,510,0,174,0,0.031372549,empty,mBC-0716-1
"F9,H9",646150,679439,475351,204088,363363,0,180037,180334,150837,29497,5.113638675,93216,94192,68247,32259,15,32244,1,2777,0,0.001271554,mm10,mBC-0716-1
"F9,H10",13949,14173,10456,3717,7529,0,3465,3472,2352,1120,2.1,1677,1140,770,428,1,427,1,129,0,0.06088993,empty,mBC-0716-1
"F9,H11",1452382,1630429,1002365,628064,855650,2,514574,515296,387554,127742,3.033880791,291718,4305,2991,1442,2,1440,1,300,0,0.009722222,mm10,mBC-0716-1
"F9,H12",6132,6115,4681,1434,3310,0,1480,1480,993,487,2.039014374,682,545,345,199,0,199,0,74,0,0.055276382,empty,mBC-0716-1
"F10,A1",16198,16881,12191,4690,9148,0,4289,4300,3080,1220,2.524590164,2103,1271,822,441,0,441,0,121,0,0.065759637,empty,mBC-0716-1
"F10,A2",20734,20937,15894,5043,11310,0,4936,4951,3500,1451,2.412129566,2344,1198,759,404,0,404,0,132,0,0.056930693,empty,mBC-0716-1
"F10,A3",17695,18202,13218,4984,9661,0,4474,4486,3154,1332,2.367867868,2187,1075,705,336,1,335,1,105,0,0.050746269,empty,mBC-0716-1
"F10,A4",21918,22065,16852,5213,11600,1,4999,5008,3574,1434,2.492329149,2284,632,341,175,0,175,0,70,0,0.045714286,empty,mBC-0716-1
"F10,A5",18012,18729,13756,4973,9923,0,4484,4489,3143,1346,2.335066865,2210,1577,937,438,0,438,0,121,0,0.066210046,empty,mBC-0716-1
"F10,A6",448519,471447,337832,133615,253451,1,119965,120152,90760,29392,3.087915079,60607,58090,40500,19424,6,19418,1,2004,0,0.001802451,mm10,mBC-0716-1
"F10,A7",17480,17941,13391,4550,9630,1,4325,4335,3063,1272,2.408018868,2078,1285,898,480,0,480,0,119,0,0.070833333,empty,mBC-0716-1
"F10,A8",12077,12657,9087,3570,6934,0,3305,3316,2286,1030,2.219417476,1650,1486,947,476,0,476,0,144,0,0.039915966,empty,mBC-0716-1
"F10,A9",19673,19610,15111,4499,10298,0,4412,4419,3054,1365,2.237362637,2037,1434,938,468,0,468,0,127,0,0.034188034,empty,mBC-0716-1
"F10,A10",17194,17471,13110,4361,9292,0,4114,4118,2881,1237,2.329021827,1946,435,262,129,0,129,0,38,0,0.007751938,empty,mBC-0716-1
"F10,A11",19198,19686,14722,4964,10451,0,4709,4717,3296,1421,2.319493315,2186,1206,745,376,1,375,1,124,0,0.061333333,empty,mBC-0716-1
"F10,A12",21498,22375,16615,5760,11730,0,5230,5239,3681,1558,2.362644416,2477,2787,1703,837,0,837,0,194,0,0.123058542,empty,mBC-0716-1
"F10,B1",20265,20780,15454,5326,10794,0,4861,4867,3427,1440,2.379861111,2283,7018,2641,1375,0,1375,0,280,0,0.045818182,empty,mBC-0716-1
"F10,B2",20845,21250,15939,5311,11286,0,4976,4985,3475,1510,2.301324503,2365,757,431,216,1,215,1,58,0,0.037209302,empty,mBC-0716-1
"F10,B3",19948,20466,15226,5240,10971,0,4932,4944,3539,1405,2.51886121,2380,1338,873,422,0,422,0,129,0,0.035545024,empty,mBC-0716-1
"F10,B4",17916,18719,13542,5177,9814,0,4560,4578,3218,1360,2.366176471,2206,3475,1236,660,0,660,0,163,0,0.025757576,empty,mBC-0716-1
"F10,B5",12083,8710,5895,2815,5629,0,2864,2876,2098,778,2.696658098,1553,586,331,184,0,184,0,67,0,0.043478261,empty,mBC-0716-1
"F10,B6",747913,842591,511678,330913,447081,1,269168,269518,228207,41311,5.524121905,153249,136594,98243,47673,25,47648,2,3236,0,0.001028375,mm10,mBC-0716-1
"F10,B7",17570,18134,13478,4656,9479,0,4262,4266,2975,1291,2.304415182,1972,1163,744,387,0,387,0,87,0,0.124031008,empty,mBC-0716-1
"F10,B8",650643,684597,482963,201634,366394,0,187563,187853,145059,42794,3.389704164,95097,40397,20747,10322,2,10320,1,1416,0,0.01996124,mm10,mBC-0716-1
"F10,B9",16244,16618,12471,4147,8772,0,3898,3907,2728,1179,2.313825276,1802,847,547,277,1,276,1,78,0,0.115942029,empty,mBC-0716-1
"F10,B10",520484,499362,322774,176588,282643,3,159870,161426,118114,43312,2.72705024,89641,6322,3788,1796,0,1796,0,350,0,0.01169265,mm10,mBC-0716-1
"F10,B11",1708060,1920797,1176695,744102,992133,1,604779,605585,497341,108244,4.594628802,341289,13234,9165,4383,1,4382,1,708,0,0,mm10,mBC-0716-1
"F10,B12",19348,20127,14822,5305,10531,0,4771,4779,3366,1413,2.382165605,2263,1579,1004,497,0,497,0,131,0,0.104627767,empty,mBC-0716-1
"F10,C1",23325,23334,18063,5271,12285,0,5200,5228,3701,1527,2.423706614,2378,768,512,239,0,239,0,88,0,0.037656904,empty,mBC-0716-1
"F10,C2",22391,23051,16766,6285,12343,0,5858,5872,4179,1693,2.468399291,2872,1740,1186,576,0,576,0,161,0,0.048611111,empty,mBC-0716-1
"F10,C3",21388,21806,16217,5589,11554,1,5266,5280,3659,1621,2.257248612,2532,660,417,192,0,192,0,72,0,0.041666667,empty,mBC-0716-1
"F10,C4",19086,19772,14527,5245,10632,0,4794,4810,3431,1379,2.488034808,2396,1288,854,435,0,435,0,134,0,0.043678161,empty,mBC-0716-1
"F10,C5",20039,20735,15139,5596,11103,0,5125,5136,3595,1541,2.332900714,2484,1136,734,382,0,382,0,114,0,0.034031414,empty,mBC-0716-1
"F10,C6",837521,860916,615955,244961,467175,2,232544,232992,189079,43913,4.305763669,116297,68460,47575,22903,9,22894,2,2073,0,0.001397746,mm10,mBC-0716-1
"F10,C7",17678,18301,13466,4835,9754,0,4599,4609,3253,1356,2.398967552,2204,408,237,136,0,136,0,49,0,0.058823529,empty,mBC-0716-1
"F10,C8",16741,17172,12762,4410,9234,0,4215,4228,2958,1270,2.329133858,2043,1866,1194,561,0,561,0,165,0,0.024955437,empty,mBC-0716-1
"F10,C9",13825,14506,10473,4033,7663,0,3591,3605,2516,1089,2.310376492,1760,2301,799,371,0,371,0,99,0,0.002695418,empty,mBC-0716-1
"F10,C10",14865,15077,11313,3764,8169,0,3651,3661,2609,1052,2.480038023,1759,1154,732,404,0,404,0,113,0,0.017326733,empty,mBC-0716-1
"F10,C11",12579,12902,9313,3589,6820,0,3195,3203,2257,946,2.385835095,1560,967,617,300,1,299,1,93,0,0.033444816,empty,mBC-0716-1
"F10,C12",685114,730685,499459,231226,392613,0,207698,208035,164265,43770,3.752912954,108929,59006,41709,19624,4,19620,1,1930,0,0.002497452,mm10,mBC-0716-1
"F10,D1",13194,13395,9823,3572,7291,0,3580,3585,2510,1075,2.334883721,1725,1972,770,397,0,397,0,98,0,0,empty,mBC-0716-1
"F10,D2",22523,22345,16957,5388,11676,0,5064,5073,3536,1537,2.300585556,2301,18829,7103,3603,1,3602,1,519,0,0.188784009,empty,mBC-0716-1
"F10,D3",15232,15912,11643,4269,8573,0,3912,3924,2720,1204,2.259136213,1919,1097,636,352,0,352,0,119,0,0.042613636,empty,mBC-0716-1
"F10,D4",16167,16757,12188,4569,8968,0,4159,4168,2977,1191,2.499580185,2071,1822,938,515,0,515,0,151,0,0.033009709,empty,mBC-0716-1
"F10,D5",651448,700131,472304,227827,376752,3,206424,206700,152274,54426,2.79781722,109111,27434,18572,8963,1,8962,1,1168,0,0.001896898,mm10,mBC-0716-1
"F10,D6",1148867,1250382,833202,417180,659279,1,356155,356735,282361,74374,3.796501466,191660,163833,114889,54699,10,54689,3,3618,0,0.003766754,mm10,mBC-0716-1
"F10,D7",1444423,1589702,1013522,576180,833194,3,485468,486264,366592,119672,3.063306371,269405,203122,143179,69221,30,69191,4,3935,0,0.00057811,mm10,mBC-0716-1
"F10,D8",17646,18128,13465,4663,9659,0,4520,4529,3173,1356,2.339970501,2148,925,590,321,0,321,0,106,0,0,empty,mBC-0716-1
"F10,D9",6571,6917,4707,2210,3765,0,1957,1957,1398,559,2.500894454,995,3541,1372,681,0,681,0,180,0,0.061674009,empty,mBC-0716-1
"F10,D10",16242,16910,12401,4509,9171,0,4339,4346,3093,1253,2.468475658,2128,5553,1824,908,2,906,2,192,0,0.036423841,empty,mBC-0716-1
"F10,D11",1594261,1703566,1140153,563413,891332,1,503463,504232,389619,114613,3.399431129,265966,61000,37344,17918,12,17906,2,2092,0,0.008097844,mm10,mBC-0716-1
"F10,D12",21792,22215,16455,5760,11846,0,5370,5377,3772,1605,2.350155763,2571,2986,2054,947,0,947,0,250,0,0.060190074,empty,mBC-0716-1
"F10,E1",1875260,1989154,1313428,675726,1030606,0,592174,593073,458838,134235,3.418169628,322471,17468,12392,5707,7,5700,2,1032,0,0.004736842,mm10,mBC-0716-1
"F10,E2",17621,18077,13357,4720,9844,0,4460,4472,3196,1276,2.504702194,2151,1554,837,425,0,425,0,123,0,0.098823529,empty,mBC-0716-1
"F10,E3",13408,13446,10144,3302,7416,0,3286,3294,2321,973,2.385405961,1532,1463,906,467,0,467,0,148,0,0.051391863,empty,mBC-0716-1
"F10,E4",16939,17113,12751,4362,9294,0,4182,4192,2937,1255,2.340239044,1997,1093,703,368,0,368,0,119,0,0.08423913,empty,mBC-0716-1
"F10,E5",22243,22485,17038,5447,11967,0,5213,5226,3749,1477,2.538253216,2521,1316,848,432,0,432,0,142,0,0.078703704,empty,mBC-0716-1
"F10,E6",15177,15325,11603,3722,8197,0,3648,3657,2658,999,2.660660661,1673,2538,1362,693,0,693,0,151,0,0.076479076,empty,mBC-0716-1
"F10,E7",15609,15853,11761,4092,8520,0,3770,3781,2680,1101,2.434150772,1799,1569,938,491,1,490,1,131,0,0.067346939,empty,mBC-0716-1
"F10,E8",18705,19292,14335,4957,10146,0,4509,4516,3154,1362,2.315712188,2127,2132,1364,683,0,683,0,190,0,0.05124451,empty,mBC-0716-1
"F10,E9",10187,10474,7665,2809,5632,0,2601,2605,1844,761,2.423127464,1269,11641,3730,1936,1,1935,1,315,0,0.149870801,empty,mBC-0716-1
"F10,E10",13937,14171,10702,3469,7602,0,3478,3482,2412,1070,2.254205607,1612,1255,719,335,0,335,0,105,0,0.041791045,empty,mBC-0716-1
"F10,E11",10520,10602,7725,2877,5838,0,2709,2719,1897,822,2.307785888,1351,3769,1676,801,1,800,1,194,0,0.10375,empty,mBC-0716-1
"F10,E12",16976,17328,12681,4647,9395,0,4315,4321,3062,1259,2.432088959,2059,975,541,288,1,287,1,108,0,0.034843206,empty,mBC-0716-1
"F10,F1",18615,18969,14133,4836,10180,0,4599,4618,3175,1443,2.2002772,2206,16299,5107,2679,3,2676,2,415,0,0.061285501,empty,mBC-0716-1
"F10,F2",24264,24761,18322,6439,13295,0,6101,6121,4367,1754,2.489737742,2909,10445,3844,1985,1,1984,1,376,0,0.044858871,empty,mBC-0716-1
"F10,F3",18410,19452,13959,5493,10256,0,4909,4919,3480,1439,2.418346074,2462,1557,999,551,0,551,0,176,0,0.029038113,empty,mBC-0716-1
"F10,F4",886101,961047,602430,358617,514043,2,301525,302000,251814,50186,5.017614474,167778,43698,27777,13153,3,13150,3,1599,0,0.003041825,mm10,mBC-0716-1
"F10,F5",987528,1115886,662881,453005,583058,1,363057,363550,292024,71526,4.082767106,209508,131829,89935,43037,23,43014,3,3364,0,0.000139489,mm10,mBC-0716-1
"F10,F6",25829,26489,19449,7040,14076,0,6493,6506,4596,1910,2.406282723,3098,2613,1705,855,1,854,1,203,0,0.038641686,empty,mBC-0716-1
"F10,F7",20972,21244,16241,5003,11544,0,5173,5178,3621,1557,2.325626204,2341,1638,747,364,0,364,0,105,0,0.027472527,empty,mBC-0716-1
"F10,F8",1347527,1374022,1005210,368812,715732,1,342240,342883,283161,59722,4.741318107,168601,14174,9457,4447,0,4447,0,719,0,0.000224871,mm10,mBC-0716-1
"F10,F9",17011,17841,12893,4948,9489,0,4388,4397,3115,1282,2.429797192,2179,3391,1756,869,1,868,1,233,0,0.091013825,empty,mBC-0716-1
"F10,F10",21536,21575,16776,4799,11553,0,4824,4841,3369,1472,2.288722826,2118,1770,1171,557,0,557,0,138,0,0.007181329,empty,mBC-0716-1
"F10,F11",12612,13236,9566,3670,7080,0,3236,3242,2243,999,2.245245245,1643,1008,677,351,1,350,1,110,0,0.114285714,empty,mBC-0716-1
"F10,F12",630950,650816,482649,168167,343416,0,156884,157221,131426,25795,5.095018414,75804,4437,3108,1474,0,1474,0,261,0,0.004748982,mm10,mBC-0716-1
"F10,G1",10804,10841,8400,2441,5827,0,2505,2518,1765,753,2.343957503,1135,2028,1419,694,0,694,0,161,0,0.097982709,empty,mBC-0716-1
"F10,G2",21924,22351,16673,5678,11729,0,5207,5220,3634,1586,2.291298865,2499,649,443,221,0,221,0,63,0,0.004524887,empty,mBC-0716-1
"F10,G3",838703,916999,591374,325625,482772,2,273335,273717,209585,64132,3.268025323,149803,129293,84815,40883,16,40867,4,2957,0,0.003499156,mm10,mBC-0716-1
"F10,G4",29603,29916,22890,7026,15820,0,6732,6766,4862,1904,2.553571429,3151,68,44,27,0,27,0,18,0,0,empty,mBC-0716-1
"F10,G5",14558,15060,11209,3851,7955,0,3714,3725,2583,1142,2.261821366,1760,1174,709,332,0,332,0,117,0,0.039156627,empty,mBC-0716-1
"F10,G6",26089,26786,20055,6731,14058,0,6182,6195,4422,1773,2.494077834,2960,178,124,76,0,76,0,40,0,0,empty,mBC-0716-1
"F10,G7",446682,449289,337181,112108,244357,2,110599,110818,79232,31586,2.508453112,53454,10873,7547,3502,2,3500,1,671,0,0.012857143,mm10,mBC-0716-1
"F10,G8",15805,16196,12076,4120,8639,0,3920,3922,2688,1234,2.17828201,1852,10661,3518,1733,1,1732,1,305,0,0.084295612,empty,mBC-0716-1
"F10,G9",11146,11589,8352,3237,6324,0,2944,2950,2086,864,2.414351852,1500,1194,744,427,1,426,1,139,0,0.028169014,empty,mBC-0716-1
"F10,G10",15185,15426,11577,3849,8187,0,3653,3659,2575,1084,2.375461255,1718,1281,855,454,0,454,0,142,0,0.09030837,empty,mBC-0716-1
"F10,G11",13282,13700,10065,3635,7330,0,3393,3405,2420,985,2.456852792,1668,3509,1487,804,0,804,0,161,0,0.031094527,empty,mBC-0716-1
"F10,G12",12618,12792,9453,3339,6931,0,3168,3176,2235,941,2.375132837,1527,1228,715,392,0,392,0,107,0,0.196428571,empty,mBC-0716-1
"F10,H1",23000,23521,17401,6120,12677,0,5770,5780,4162,1618,2.572311496,2743,1021,659,320,0,320,0,107,0,0.053125,empty,mBC-0716-1
"F10,H2",1015026,1066055,736043,330012,555366,1,291383,291878,243738,48140,5.063107603,150252,105748,75159,36317,17,36300,4,2748,0,0.000909091,mm10,mBC-0716-1
"F10,H3",2297418,2511459,1616009,895450,1290136,2,749241,750319,620973,129346,4.800867441,413552,322724,216376,102477,38,102439,5,5083,0,0.001415477,mm10,mBC-0716-1
"F10,H4",14939,15141,11300,3841,8071,0,3639,3647,2624,1023,2.565004888,1686,173,110,59,0,59,0,26,0,0,empty,mBC-0716-1
"F10,H5",20525,21383,15344,6039,11388,0,5404,5413,3906,1507,2.591904446,2676,1819,1287,641,0,641,0,166,0,0.049921997,empty,mBC-0716-1
"F10,H6",16668,17027,12302,4725,9276,0,4507,4520,3212,1308,2.455657492,2235,1636,1067,548,0,548,0,172,0,0.060218978,empty,mBC-0716-1
"F10,H7",19105,19482,14491,4991,10770,0,4890,4894,3433,1461,2.349760438,2381,4751,1979,963,0,963,0,244,0,0.055036345,empty,mBC-0716-1
"F10,H8",22871,24419,17256,7163,12833,0,6231,6243,4469,1774,2.519165727,3206,1917,1234,675,1,674,1,170,0,0.043026706,empty,mBC-0716-1
"F10,H9",20243,21053,15205,5848,11452,0,5443,5455,3986,1469,2.713410483,2704,1186,642,356,0,356,0,110,0,0.028089888,empty,mBC-0716-1
"F10,H10",16287,16537,12275,4262,8850,1,4075,4084,2893,1191,2.429051217,1953,2513,1058,556,2,554,1,144,0,0.068592058,empty,mBC-0716-1
"F10,H11",1345737,1512817,920853,591964,803692,2,501178,501859,381849,120010,3.181809849,285953,2636,1367,669,1,668,1,153,0,0.058383234,empty,mBC-0716-1
"F10,H12",6754,6898,5178,1720,3764,0,1720,1722,1239,483,2.565217391,825,585,299,154,0,154,0,57,0,0.12987013,empty,mBC-0716-1
"F11,A1",13273,14078,9878,4200,7592,0,3687,3698,2550,1148,2.221254355,1934,856,561,274,0,274,0,80,0,0.054744526,empty,mBC-0716-1
"F11,A2",17205,17507,13169,4338,9270,0,4075,4088,2880,1208,2.38410596,1892,966,549,301,0,301,0,89,0,0.046511628,empty,mBC-0716-1
"F11,A3",15166,15631,11540,4091,8255,0,3748,3751,2626,1125,2.334222222,1766,646,365,210,1,209,1,73,0,0.081339713,empty,mBC-0716-1
"F11,A4",19654,19825,15345,4480,10379,0,4412,4422,3045,1377,2.211328976,1968,440,305,152,0,152,0,47,0,0.092105263,empty,mBC-0716-1
"F11,A5",15955,16030,12152,3878,8394,0,3780,3786,2658,1128,2.356382979,1696,38181,9973,4996,4,4992,2,608,0,0.096354167,empty,mBC-0716-1
"F11,A6",11766,12386,9000,3386,6601,0,3094,3095,2162,933,2.317256163,1513,903,536,284,0,284,0,94,0,0.049295775,empty,mBC-0716-1
"F11,A7",14903,15397,11230,4167,8207,0,3752,3752,2637,1115,2.365022422,1816,943,567,321,0,321,0,106,0,0.049844237,empty,mBC-0716-1
"F11,A8",10131,10550,7775,2775,5636,0,2571,2586,1778,808,2.20049505,1218,1162,782,373,0,373,0,108,0,0.085790885,empty,mBC-0716-1
"F11,A9",19124,19674,14718,4956,10264,0,4610,4621,3336,1285,2.596108949,2261,1354,759,395,0,395,0,98,0,0.058227848,empty,mBC-0716-1
"F11,A10",14588,14840,11052,3788,7954,0,3645,3661,2520,1141,2.208588957,1718,734,296,166,0,166,0,56,0,0,empty,mBC-0716-1
"F11,A11",16717,17217,12971,4246,9046,0,4051,4064,2873,1191,2.412258606,1916,4099,1503,723,1,722,1,162,0,0.020775623,empty,mBC-0716-1
"F11,A12",769092,804734,587049,217685,418835,1,194335,194699,168142,26557,6.331362729,95582,120904,86116,41532,15,41517,1,3073,0,0.002480911,mm10,mBC-0716-1
"F11,B1",17965,18420,13800,4620,9567,0,4263,4265,3044,1221,2.493038493,1988,839,584,275,0,275,0,80,0,0.018181818,empty,mBC-0716-1
"F11,B2",1103140,1199739,776367,423372,624678,1,359571,360077,295922,64155,4.612610085,194436,20336,13291,6333,1,6332,1,891,0,0.001737208,mm10,mBC-0716-1
"F11,B3",17982,18698,13534,5164,9781,1,4472,4481,3158,1323,2.386999244,2229,881,547,296,0,296,0,91,0,0.111486486,empty,mBC-0716-1
"F11,B4",754738,807846,555452,252394,426799,1,221582,221922,183792,38130,4.820141621,115144,58750,41950,20301,8,20293,2,2054,0,0.000985562,mm10,mBC-0716-1
"F11,B5",8649,5659,3912,1747,3833,1,1859,1875,1299,576,2.255208333,1030,615,407,170,0,170,0,52,0,0.094117647,empty,mBC-0716-1
"F11,B6",10956,11428,8295,3133,6023,0,2775,2783,1936,847,2.285714286,1412,617,355,216,0,216,0,75,0,0.00462963,empty,mBC-0716-1
"F11,B7",709620,752799,529664,223135,400946,1,201143,201473,165920,35553,4.666835429,102078,47339,33017,15461,12,15449,2,1632,0,0.000258916,mm10,mBC-0716-1
"F11,B8",12503,13174,9498,3676,6926,0,3236,3249,2261,988,2.288461538,1652,839,487,278,0,278,0,87,0,0.09352518,empty,mBC-0716-1
"F11,B9",14767,15256,11280,3976,7991,0,3632,3638,2405,1233,1.95052717,1755,2007,717,359,0,359,0,90,0,0.08913649,empty,mBC-0716-1
"F11,B10",15500,15022,11150,3872,8332,0,3803,3837,2582,1255,2.057370518,1854,351,152,88,0,88,0,37,0,0,empty,mBC-0716-1
"F11,B11",15635,16043,12141,3902,8472,0,3828,3838,2605,1233,2.112733171,1758,81,44,23,0,23,0,19,0,0,empty,mBC-0716-1
"F11,B12",16577,16921,12764,4157,9081,0,4052,4058,2807,1251,2.243804956,1915,850,533,277,0,277,0,86,0,0.0433213,empty,mBC-0716-1
"F11,C1",21139,21189,16422,4767,10971,0,4591,4609,3238,1371,2.361779723,2026,433,281,150,0,150,0,61,0,0.033333333,empty,mBC-0716-1
"F11,C2",17692,18153,13308,4845,9538,0,4345,4354,3064,1290,2.375193798,2100,1323,860,453,0,453,0,124,0,0.037527594,empty,mBC-0716-1
"F11,C3",636707,690300,452641,237659,370223,2,210504,210795,165767,45028,3.681420449,113737,5321,3101,1566,0,1566,0,326,0,0.004469987,mm10,mBC-0716-1
"F11,C4",16316,16379,12523,3856,8735,0,3730,3742,2604,1138,2.288224956,1741,3405,1274,674,0,674,0,146,0,0.111275964,empty,mBC-0716-1
"F11,C5",14992,15450,11437,4013,8290,0,3816,3824,2657,1167,2.276778063,1821,770,517,260,0,260,0,81,0,0.092307692,empty,mBC-0716-1
"F11,C6",1563528,1719428,1069623,649805,923834,2,551525,552374,457576,94798,4.826852887,310158,170390,118424,56990,18,56972,3,3721,0,0.001386646,mm10,mBC-0716-1
"F11,C7",15713,16248,11807,4441,8717,0,4226,4234,2999,1235,2.428340081,2107,269,161,78,0,78,0,25,0,0,empty,mBC-0716-1
"F11,C8",13975,14332,10719,3613,7603,0,3443,3451,2392,1059,2.258734655,1655,1313,877,417,0,417,0,111,0,0.052757794,empty,mBC-0716-1
"F11,C9",11863,12350,9044,3306,6377,0,2913,2920,1967,953,2.064008395,1436,626,413,219,0,219,0,62,0,0.01826484,empty,mBC-0716-1
"F11,C10",12997,13252,9850,3402,6884,0,3078,3083,2161,922,2.343817787,1419,12654,3744,1830,0,1830,0,305,0,0.059562842,empty,mBC-0716-1
"F11,C11",398962,407333,305380,101953,221861,0,98518,98713,79196,19517,4.057795768,47288,15972,11542,5600,3,5597,1,827,0,0.000536001,mm10,mBC-0716-1
"F11,C12",18672,18625,14081,4544,9752,0,4344,4352,3107,1245,2.495582329,2013,1001,663,322,0,322,0,83,0,0.037267081,empty,mBC-0716-1
"F11,D1",10434,10735,7716,3019,5846,0,2777,2789,1937,852,2.273474178,1373,436,211,107,0,107,0,39,0,0,empty,mBC-0716-1
"F11,D2",19252,19483,14836,4647,10320,0,4533,4550,3143,1407,2.233830846,2098,5033,2204,1143,0,1143,0,238,0,0.183727034,empty,mBC-0716-1
"F11,D3",12598,13303,9507,3796,7152,0,3385,3389,2375,1014,2.342209073,1731,877,596,290,0,290,0,87,0,0.024137931,empty,mBC-0716-1
"F11,D4",512743,563236,351056,212180,298224,0,176777,177020,121538,55482,2.190584334,98590,124413,85494,40160,13,40147,2,2986,0,0.003213192,mm10,mBC-0716-1
"F11,D5",12804,13445,9822,3623,7168,0,3363,3367,2366,1001,2.363636364,1656,957,598,271,1,270,1,84,0,0.081481481,empty,mBC-0716-1
"F11,D6",11673,12076,8876,3200,6364,0,2955,2962,2066,896,2.305803571,1438,873,545,314,0,314,0,97,0,0.050955414,empty,mBC-0716-1
"F11,D7",362018,369005,269898,99107,201739,2,95027,95201,73267,21934,3.340339199,47299,4043,2382,1098,2,1096,1,286,0,0.032846715,mm10,mBC-0716-1
"F11,D8",15835,16409,11941,4468,8757,0,4054,4064,2822,1242,2.272141707,1988,629,456,237,0,237,0,80,0,0.046413502,empty,mBC-0716-1
"F11,D9",4528,4718,3342,1376,2570,0,1246,1248,911,337,2.703264095,624,1051,678,336,1,335,1,102,0,0.062686567,empty,mBC-0716-1
"F11,D10",12767,13110,9697,3413,7050,0,3308,3317,2276,1041,2.18635927,1526,754,395,217,0,217,0,72,0,0.046082949,empty,mBC-0716-1
"F11,D11",414197,420411,322009,98402,228423,0,99781,99992,76068,23924,3.179568634,46708,10786,7557,3485,3,3482,1,603,0,0.012062033,mm10,mBC-0716-1
"F11,D12",18595,18568,14223,4345,9843,0,4344,4352,3069,1283,2.392049883,1938,2029,1079,545,0,545,0,155,0,0.027522936,empty,mBC-0716-1
"F11,E1",20577,20712,15630,5082,10940,0,4901,4911,3515,1396,2.517908309,2358,16660,5239,2647,2,2645,2,469,0,0.027221172,empty,mBC-0716-1
"F11,E2",15022,15412,11509,3903,8226,0,3706,3714,2593,1121,2.313113292,1761,1188,746,388,0,388,0,104,0,0.028350515,empty,mBC-0716-1
"F11,E3",11598,11839,8865,2974,6261,0,2733,2740,1916,824,2.325242718,1288,1370,771,397,0,397,0,122,0,0.037783375,empty,mBC-0716-1
"F11,E4",14345,14763,10941,3822,7816,0,3706,3709,2604,1105,2.356561086,1782,4382,1677,807,2,805,1,163,0,0.195031056,empty,mBC-0716-1
"F11,E5",19628,19870,15376,4494,10499,0,4557,4571,3188,1383,2.305133767,2021,931,560,284,0,284,0,90,0,0.024647887,empty,mBC-0716-1
"F11,E6",12344,12431,9541,2890,6667,0,2906,2909,2048,861,2.378629501,1316,1010,665,319,0,319,0,78,0,0.122257053,empty,mBC-0716-1
"F11,E7",12923,13127,9891,3236,6997,0,3098,3104,2119,985,2.151269036,1470,684,430,218,0,218,0,86,0,0.027522936,empty,mBC-0716-1
"F11,E8",16230,16575,12328,4247,8754,0,3855,3868,2688,1180,2.277966102,1812,1274,733,366,1,365,1,122,0,0.101369863,empty,mBC-0716-1
"F11,E9",8379,8384,6316,2068,4539,0,2095,2099,1491,608,2.452302632,982,2021,858,426,1,425,1,106,0,0.023529412,empty,mBC-0716-1
"F11,E10",11724,12134,8968,3166,6393,0,2954,2958,2046,912,2.243421053,1342,1032,664,299,0,299,0,96,0,0.110367893,empty,mBC-0716-1
"F11,E11",8604,9137,6483,2654,4902,0,2294,2298,1613,685,2.354744526,1133,838,556,307,0,307,0,92,0,0.055374593,empty,mBC-0716-1
"F11,E12",13713,14316,10324,3992,7735,0,3600,3610,2513,1097,2.290793072,1802,732,423,235,0,235,0,76,0,0.140425532,empty,mBC-0716-1
"F11,F1",16603,16950,12616,4334,8926,0,3964,3969,2799,1170,2.392307692,1890,1031,672,330,0,330,0,93,0,0.051515152,empty,mBC-0716-1
"F11,F2",692970,758474,494036,264438,405367,1,225001,225304,177139,48165,3.677753555,123369,80914,56367,27283,14,27269,1,2446,0,0.001980271,mm10,mBC-0716-1
"F11,F3",15253,15762,11535,4227,8450,0,4049,4051,2758,1293,2.133023975,2030,5616,1826,942,0,942,0,204,0,0.112526539,empty,mBC-0716-1
"F11,F4",1343881,1453186,955840,497346,774917,0,432657,433239,301234,132005,2.281989319,237056,30210,20776,9702,4,9698,1,1242,0,0.000928026,mm10,mBC-0716-1
"F11,F5",22078,22996,16827,6169,12005,0,5386,5395,3756,1639,2.291641245,2617,1402,789,391,1,390,1,114,0,0.056410256,empty,mBC-0716-1
"F11,F6",656406,731733,445854,285879,391962,1,240166,240458,188614,51844,3.638106628,136966,24025,16717,7942,6,7936,1,1215,0,0.002394153,mm10,mBC-0716-1
"F11,F7",18116,18522,13830,4692,10052,0,4459,4463,3133,1330,2.355639098,2142,734,513,271,0,271,0,83,0,0.044280443,empty,mBC-0716-1
"F11,F8",21059,21584,15999,5585,11498,0,5216,5225,3767,1458,2.583676269,2509,256,198,102,0,102,0,43,0,0.166666667,empty,mBC-0716-1
"F11,F9",14106,14242,10681,3561,7565,0,3340,3357,2375,982,2.418533605,1597,1216,757,403,0,403,0,127,0,0.099255583,empty,mBC-0716-1
"F11,F10",18987,19052,14862,4190,10189,0,4246,4259,3014,1245,2.420883534,1966,1018,651,323,0,323,0,103,0,0.018575851,empty,mBC-0716-1
"F11,F11",10692,10768,8333,2435,5707,0,2520,2523,1791,732,2.446721311,1144,849,570,304,0,304,0,88,0,0.082236842,empty,mBC-0716-1
"F11,F12",12823,12938,9489,3449,6944,0,3237,3241,2280,961,2.372528616,1591,102,82,38,0,38,0,13,0,0.078947368,empty,mBC-0716-1
"F11,G1",9772,10261,7534,2727,5415,5,2468,2477,1720,757,2.272126816,1183,2041,1037,526,0,526,0,142,0,0.043726236,empty,mBC-0716-1
"F11,G2",863035,946722,609217,337505,499748,1,284692,285104,238444,46660,5.110244321,155851,19549,12602,6059,0,6059,0,826,0,0.005611487,mm10,mBC-0716-1
"F11,G3",18881,19090,14406,4684,10001,0,4453,4462,3164,1298,2.437596302,2076,13922,4630,2265,2,2263,2,419,0,0.039328325,empty,mBC-0716-1
"F11,G4",29179,29923,22471,7452,15789,0,7057,7075,5083,1992,2.551706827,3370,81,66,32,0,32,0,16,0,0,empty,mBC-0716-1
"F11,G5",744316,865724,494517,371207,457147,0,297589,297961,226002,71959,3.140705124,175472,48648,34441,16846,4,16842,1,1728,0,0.002137513,mm10,mBC-0716-1
"F11,G6",22533,22825,17507,5318,11993,0,5199,5211,3741,1470,2.544897959,2320,247,129,69,0,69,0,26,0,0,empty,mBC-0716-1
"F11,G7",1047247,1159486,727321,432165,607580,3,364984,365469,290557,74912,3.878644276,202190,93713,57172,27895,13,27882,4,2577,0,0.00204433,mm10,mBC-0716-1
"F11,G8",13890,14289,10209,4080,7413,0,3502,3511,2422,1089,2.22405877,1723,35361,10932,5460,6,5454,3,770,0,0.090942428,empty,mBC-0716-1
"F11,G9",9868,10251,7441,2810,5488,0,2531,2539,1765,774,2.280361757,1237,886,629,322,1,321,1,109,0,0.040498442,empty,mBC-0716-1
"F11,G10",12654,12915,9753,3162,6802,0,3060,3061,2137,924,2.312770563,1394,998,701,348,0,348,0,110,0,0.028735632,empty,mBC-0716-1
"F11,G11",11349,11734,8698,3036,6302,0,2889,2893,2081,812,2.562807882,1384,1337,533,278,0,278,0,95,0,0.010791367,empty,mBC-0716-1
"F11,G12",10518,10880,7996,2884,5753,0,2571,2574,1851,723,2.560165975,1180,706,470,276,0,276,0,88,0,0.130434783,empty,mBC-0716-1
"F11,H1",23582,24700,18261,6439,13011,0,5872,5879,4302,1577,2.72796449,2794,1090,681,349,0,349,0,93,0,0.063037249,empty,mBC-0716-1
"F11,H2",22001,22612,16766,5846,11784,0,5373,5380,3784,1596,2.370927318,2556,4336,1678,829,0,829,0,169,0,0.059107358,empty,mBC-0716-1
"F11,H3",18365,18918,13957,4961,10072,0,4708,4713,3330,1383,2.407809111,2271,1248,816,442,0,442,0,114,0,0.011312217,empty,mBC-0716-1
"F11,H4",12756,13179,9567,3612,7032,0,3218,3222,2215,1007,2.199602781,1578,530,164,80,0,80,0,29,0,0.0125,empty,mBC-0716-1
"F11,H5",652919,738160,451861,286299,392902,1,232713,233058,190355,42703,4.457649345,132703,50995,35889,17238,6,17232,1,1797,0,0.003075673,mm10,mBC-0716-1
"F11,H6",13288,13545,10207,3338,7175,0,3308,3314,2354,960,2.452083333,1559,1284,829,444,0,444,0,115,0,0.105855856,empty,mBC-0716-1
"F11,H7",15905,16425,11922,4503,8871,0,4164,4168,2985,1183,2.523245985,2049,970,587,339,0,339,0,128,0,0.05899705,empty,mBC-0716-1
"F11,H8",12366,12591,9162,3429,6820,0,3118,3130,2175,955,2.277486911,1573,1211,825,413,0,413,0,121,0,0.024213075,empty,mBC-0716-1
"F11,H9",14798,15256,11258,3998,8031,0,3670,3675,2555,1120,2.28125,1760,1635,752,377,0,377,0,106,0,0.098143236,empty,mBC-0716-1
"F11,H10",13330,13668,10266,3402,7292,0,3399,3403,2405,998,2.409819639,1580,912,579,318,0,318,0,91,0,0.053459119,empty,mBC-0716-1
"F11,H11",16153,16712,12413,4299,8880,0,4118,4132,2904,1228,2.364820847,1980,88,51,34,0,34,0,21,0,0,empty,mBC-0716-1
"F11,H12",5681,5949,4354,1595,3182,0,1447,1449,967,482,2.006224066,700,773,369,190,0,190,0,48,0,0.073684211,empty,mBC-0716-1
"F12,A1",15244,15707,11434,4273,8505,0,4026,4026,2891,1135,2.547136564,1946,1103,738,347,1,346,1,109,0,0.026011561,empty,mBC-0716-1
"F12,A2",18884,19087,14483,4604,10089,0,4426,4432,3116,1316,2.367781155,2067,993,623,288,0,288,0,110,0,0.034722222,empty,mBC-0716-1
"F12,A3",933117,1028798,636767,392031,538040,0,325719,326158,268328,57830,4.639944665,181834,70994,46339,21909,13,21896,1,2092,0,0.003836317,mm10,mBC-0716-1
"F12,A4",20318,20846,15671,5175,10879,0,4782,4790,3366,1424,2.363764045,2251,541,292,163,0,163,0,55,0,0,empty,mBC-0716-1
"F12,A5",16463,16528,12642,3886,8908,0,4027,4037,2824,1213,2.328112119,1839,1296,886,470,0,470,0,143,0,0.010638298,empty,mBC-0716-1
"F12,A6",511691,546785,380976,165809,291713,0,145421,145683,120371,25312,4.755491466,75005,88011,61934,29371,6,29365,1,2515,0,0.000783245,mm10,mBC-0716-1
"F12,A7",16038,16796,12371,4425,8909,0,4024,4034,2758,1276,2.161442006,1944,1004,665,338,0,338,0,109,0,0.00887574,empty,mBC-0716-1
"F12,A8",11038,11634,8470,3164,6233,0,2931,2935,2072,863,2.400926999,1427,1364,821,467,0,467,0,151,0,0.087794433,empty,mBC-0716-1
"F12,A9",18121,18492,13968,4524,9597,0,4249,4257,2983,1274,2.34144427,1984,2126,881,423,0,423,0,138,0,0.035460993,empty,mBC-0716-1
"F12,A10",656884,736120,455135,280985,389745,1,227034,227331,182323,45008,4.050902062,127758,24068,16959,7959,6,7953,1,972,0,0.000377216,mm10,mBC-0716-1
"F12,A11",17789,18152,13542,4610,9758,0,4363,4369,3007,1362,2.207782673,2123,1081,676,404,0,404,0,110,0,0.024752475,empty,mBC-0716-1
"F12,A12",19709,20107,15147,4960,10494,0,4553,4565,3254,1311,2.482074752,2189,2146,1250,708,0,708,0,175,0,0.09180791,empty,mBC-0716-1
"F12,B1",18525,18835,14217,4618,9946,0,4443,4450,3031,1419,2.136011276,2009,1049,672,351,0,351,0,120,0,0.017094017,empty,mBC-0716-1
"F12,B2",19624,19976,15081,4895,10626,0,4719,4724,3291,1433,2.2965806,2183,703,440,224,0,224,0,65,0,0.116071429,empty,mBC-0716-1
"F12,B3",19430,20190,14770,5420,10729,0,4952,4969,3459,1510,2.290728477,2458,1182,733,364,0,364,0,140,0,0.06043956,empty,mBC-0716-1
"F12,B4",17223,17254,12824,4430,9058,0,4133,4141,2947,1194,2.468174204,1951,22889,7628,3865,1,3864,1,623,0,0.105848861,empty,mBC-0716-1
"F12,B5",466413,286886,181539,105347,198378,5,107971,108585,84875,23710,3.579713201,62491,71766,50441,23513,5,23508,1,2096,0,0.002722477,mm10,mBC-0716-1
"F12,B6",11743,11870,8970,2900,6406,0,2941,2947,2037,910,2.238461538,1361,919,553,257,0,257,0,83,0,0.058365759,empty,mBC-0716-1
"F12,B7",15726,16089,12076,4013,8526,0,3828,3839,2663,1176,2.264455782,1846,1121,641,346,0,346,0,85,0,0.170520231,empty,mBC-0716-1
"F12,B8",13523,13925,10429,3496,7270,0,3224,3233,2280,953,2.392444911,1483,829,549,301,0,301,0,116,0,0.043189369,empty,mBC-0716-1
"F12,B9",14790,15317,11438,3879,8039,0,3600,3606,2485,1121,2.21677074,1733,694,420,221,1,220,1,75,0,0.045454545,empty,mBC-0716-1
"F12,B10",16418,16271,11914,4357,9023,0,4147,4170,2884,1286,2.242612753,2093,562,282,139,0,139,0,58,0,0.079136691,empty,mBC-0716-1
"F12,B11",18608,19402,13958,5444,10217,0,4754,4760,3323,1437,2.312456507,2409,133,84,65,0,65,0,35,0,0.092307692,empty,mBC-0716-1
"F12,B12",17487,17691,13323,4368,9402,0,4199,4207,2978,1229,2.423108218,1955,1384,816,385,0,385,0,116,0,0.031168831,empty,mBC-0716-1
"F12,C1",21946,22195,17171,5024,11514,0,4862,4872,3425,1447,2.366966137,2207,496,324,178,0,178,0,78,0,0.033707865,empty,mBC-0716-1
"F12,C2",494344,509822,361531,148291,275672,0,137022,137246,99500,37746,2.636040905,70430,29802,20580,9838,3,9835,1,1300,0,0.002541942,mm10,mBC-0716-1
"F12,C3",19261,19953,14594,5359,10508,0,4844,4857,3298,1559,2.115458627,2302,569,291,127,0,127,0,52,0,0.007874016,empty,mBC-0716-1
"F12,C4",985587,1092231,665658,426573,575489,3,358024,358475,241553,116922,2.065932844,203963,45182,28993,13529,4,13525,2,1597,0,0.000443623,mm10,mBC-0716-1
"F12,C5",768684,847720,537328,310392,449394,1,259442,259781,201578,58203,3.463360995,143815,64986,46408,22073,12,22061,1,2078,0,0.000951906,mm10,mBC-0716-1
"F12,C6",17546,17964,13323,4641,9808,0,4558,4567,3285,1282,2.562402496,2203,1281,829,424,0,424,0,136,0,0.037735849,empty,mBC-0716-1
"F12,C7",744700,778207,551151,227056,411156,1,207710,208042,155396,52646,2.95171523,105655,5059,3370,1524,3,1521,1,311,0,0.002629849,mm10,mBC-0716-1
"F12,C8",14882,15465,11330,4135,8298,0,3845,3855,2600,1255,2.071713147,1885,1613,1048,569,0,569,0,151,0,0.059753954,empty,mBC-0716-1
"F12,C9",12462,12836,9447,3389,6899,0,3183,3194,2231,963,2.316718588,1611,592,368,188,0,188,0,73,0,0,empty,mBC-0716-1
"F12,C10",13609,14079,10405,3674,7410,0,3384,3391,2289,1102,2.077132486,1616,918,612,318,0,318,0,87,0,0.072327044,empty,mBC-0716-1
"F12,C11",11257,11507,8603,2904,6113,0,2816,2820,1966,854,2.302107728,1330,947,552,280,0,280,0,86,0,0.078571429,empty,mBC-0716-1
"F12,C12",20279,20762,15337,5425,10721,0,4950,4954,3529,1425,2.476491228,2346,3019,1439,675,0,675,0,157,0,0.031111111,empty,mBC-0716-1
"F12,D1",11903,12188,9010,3178,6765,0,3240,3247,2294,953,2.407135362,1594,3817,1322,646,0,646,0,141,0,0.027863777,empty,mBC-0716-1
"F12,D2",19880,20346,15393,4953,10710,0,4594,4600,3226,1374,2.347889374,2138,1910,1209,621,0,621,0,177,0,0.030595813,empty,mBC-0716-1
"F12,D3",13684,14715,10380,4335,7929,0,3695,3707,2690,1017,2.645034415,1907,795,474,275,0,275,0,101,0,0.061818182,empty,mBC-0716-1
"F12,D4",15660,16370,11900,4470,8578,0,3929,3932,2716,1216,2.233552632,1873,1257,660,348,1,347,1,114,0,0.051873199,empty,mBC-0716-1
"F12,D5",606439,676048,422609,253439,362319,1,214254,214544,168327,46217,3.642101391,119686,64478,46353,22184,8,22176,3,2071,0,0.003427128,mm10,mBC-0716-1
"F12,D6",12302,13001,9255,3746,7018,0,3396,3400,2380,1020,2.333333333,1750,2410,1085,529,0,529,0,149,0,0.003780718,empty,mBC-0716-1
"F12,D7",13373,13728,10150,3578,7387,0,3418,3424,2415,1009,2.39345887,1602,1552,1010,488,0,488,0,141,0,0.034836066,empty,mBC-0716-1
"F12,D8",16196,17040,12178,4862,9003,0,4309,4316,3009,1307,2.302218822,2194,658,420,244,0,244,0,88,0,0.008196721,empty,mBC-0716-1
"F12,D9",5876,5809,4254,1555,3291,1,1580,1582,1139,443,2.571106095,781,2269,1036,516,1,515,1,150,0,0.009708738,empty,mBC-0716-1
"F12,D10",16479,16433,11659,4774,8554,0,4195,4215,2845,1370,2.076642336,2117,44422,13596,6727,8,6719,3,944,0,0.0507516,empty,mBC-0716-1
"F12,D11",13425,13812,10087,3725,7292,0,3376,3387,2362,1025,2.304390244,1632,2710,1347,679,0,679,0,171,0,0.106038292,empty,mBC-0716-1
"F12,D12",721938,793749,524623,269126,418383,1,225654,225998,185147,40851,4.532251352,121623,188157,128053,61249,24,61225,5,3770,0,0.002057983,mm10,mBC-0716-1
"F12,E1",21880,22286,16728,5558,11772,0,5152,5160,3665,1495,2.451505017,2464,8119,2703,1420,2,1418,2,312,0,0.054301834,empty,mBC-0716-1
"F12,E2",16675,17111,12696,4415,8986,0,4142,4157,2997,1160,2.58362069,1950,1560,931,447,0,447,0,136,0,0.07606264,empty,mBC-0716-1
"F12,E3",36953,37751,27790,9961,19459,0,8667,8694,6724,1970,3.41319797,4226,42567,16044,8059,6,8053,3,1155,0,0.099838569,empty,mBC-0716-1
"F12,E4",15400,15885,11765,4120,8360,0,3805,3816,2703,1113,2.428571429,1883,1174,720,384,0,384,0,123,0,0.049479167,empty,mBC-0716-1
"F12,E5",647164,711573,454959,256614,377033,1,219094,219415,174665,44750,3.903128492,119901,29200,19051,9131,4,9127,1,1126,0,0.00175304,mm10,mBC-0716-1
"F12,E6",753911,816149,535222,280927,428427,0,238418,238798,191897,46901,4.09153323,129185,83988,55922,26324,11,26313,2,2307,0,0.002698286,mm10,mBC-0716-1
"F12,E7",965106,1079541,648175,431366,562853,1,351470,351952,277180,74772,3.707002621,200511,81966,55330,26256,11,26245,1,2359,0,0.003467327,mm10,mBC-0716-1
"F12,E8",671953,691753,495123,196630,367616,2,179600,179916,120106,59810,2.008125731,93341,38258,22764,10915,0,10915,0,1422,0,0.011085662,mm10,mBC-0716-1
"F12,E9",9396,9866,7103,2763,5289,0,2467,2475,1751,724,2.418508287,1243,1200,773,357,0,357,0,129,0,0.019607843,empty,mBC-0716-1
"F12,E10",12641,13137,9759,3378,6872,0,3146,3156,2138,1018,2.100196464,1469,1285,835,389,0,389,0,114,0,0.089974293,empty,mBC-0716-1
"F12,E11",9497,9571,7304,2267,5180,0,2335,2338,1636,702,2.33048433,1023,848,489,258,0,258,0,89,0,0.124031008,empty,mBC-0716-1
"F12,E12",15255,15879,11598,4281,8411,1,3931,3946,2699,1247,2.164394547,1927,1185,666,384,1,383,1,119,0,0.08616188,empty,mBC-0716-1
"F12,F1",803849,877083,584852,292231,460952,1,252669,253042,175230,77812,2.251966278,135792,60877,34690,16554,6,16548,1,1755,0,0.023990815,mm10,mBC-0716-1
"F12,F2",22788,23630,17224,6406,12559,0,5816,5831,4172,1659,2.514767932,2846,2076,1324,715,0,715,0,222,0,0.036363636,empty,mBC-0716-1
"F12,F3",748627,853606,511660,341946,452143,0,274307,274697,193000,81697,2.362387848,160167,82634,59151,27730,17,27713,1,2367,0,0.000757767,mm10,mBC-0716-1
"F12,F4",18331,18842,13671,5171,10313,0,4798,4808,3408,1400,2.434285714,2362,445,217,126,0,126,0,63,0,0.095238095,empty,mBC-0716-1
"F12,F5",704506,710046,527096,182950,375954,0,176031,176382,138978,37404,3.715591915,85208,23060,16106,7424,5,7419,1,1043,0,0.001752258,mm10,mBC-0716-1
"F12,F6",827026,883595,600663,282932,462834,1,244042,244427,205759,38668,5.32116996,128474,123442,87736,41239,16,41223,2,2982,0,0.00099459,mm10,mBC-0716-1
"F12,F7",641960,700951,467122,233829,381785,1,206287,206588,154899,51689,2.996749792,111037,28081,19939,9603,2,9601,1,1189,0,0.000520779,mm10,mBC-0716-1
"F12,F8",22530,23362,17167,6195,12437,0,5674,5692,4042,1650,2.44969697,2751,432,216,128,0,128,0,56,0,0,empty,mBC-0716-1
"F12,F9",15397,15838,11874,3964,8350,0,3804,3807,2642,1165,2.267811159,1781,1639,975,469,0,469,0,173,0,0.057569296,empty,mBC-0716-1
"F12,F10",19977,20237,15495,4742,10610,5,4552,4571,3253,1318,2.468133536,2123,1861,964,513,1,512,1,140,0,0.076171875,empty,mBC-0716-1
"F12,F11",11262,11681,8739,2942,6222,0,2800,2803,2033,770,2.64025974,1352,888,545,275,1,274,1,97,0,0.04379562,empty,mBC-0716-1
"F12,F12",13757,14257,10416,3841,7407,1,3380,3398,2319,1079,2.149212234,1654,123,46,22,0,22,0,13,0,0,empty,mBC-0716-1
"F12,G1",9787,10001,7610,2391,5259,0,2249,2254,1573,681,2.309838473,1025,1473,984,508,0,508,0,131,0,0.021653543,empty,mBC-0716-1
"F12,G2",19923,20716,15436,5280,10864,0,4824,4831,3360,1471,2.284160435,2306,447,318,165,0,165,0,47,0,0.096969697,empty,mBC-0716-1
"F12,G3",20741,21203,15754,5449,11254,0,5181,5193,3602,1591,2.263984915,2490,3689,1527,754,2,752,2,208,0,0.031914894,empty,mBC-0716-1
"F12,G4",27507,28181,21213,6968,14627,0,6446,6459,4607,1852,2.487580994,3017,95,77,48,0,48,0,27,0,0,empty,mBC-0716-1
"F12,G5",13139,13408,10005,3403,7125,0,3326,3334,2325,1009,2.304261645,1576,5206,1911,992,1,991,1,190,0,0.044399596,empty,mBC-0716-1
"F12,G6",911351,985193,641149,344044,515803,0,293171,293595,242591,51004,4.75631323,158812,4501,3136,1562,0,1562,0,290,0,0,mm10,mBC-0716-1
"F12,G7",1266697,1290696,983171,307525,674101,0,306649,307212,215650,91562,2.355234704,143458,68820,34725,16564,7,16557,1,1906,0,0.026091683,mm10,mBC-0716-1
"F12,G8",14711,15210,11117,4093,8103,0,3726,3742,2637,1105,2.386425339,1807,3964,1606,815,1,814,1,211,0,0.029484029,empty,mBC-0716-1
"F12,G9",1398662,1536165,1002125,534040,801670,1,455140,455816,366023,89793,4.076297707,247253,200729,131915,62723,26,62697,4,3834,0,0.001291928,mm10,mBC-0716-1
"F12,G10",13725,14058,10550,3508,7499,0,3410,3420,2396,1024,2.33984375,1621,932,582,348,0,348,0,113,0,0.066091954,empty,mBC-0716-1
"F12,G11",815599,861605,604680,256925,452116,3,227555,227941,193850,34091,5.686251503,116429,28518,20582,9672,2,9670,1,1208,0,0,mm10,mBC-0716-1
"F12,G12",11258,11535,8644,2891,6206,0,2814,2820,2023,797,2.538268507,1341,1173,796,403,0,403,0,114,0,0.096774194,empty,mBC-0716-1
"F12,H1",714019,794055,500164,293891,422627,0,249007,249293,180121,69172,2.603958249,138685,23467,16782,7770,2,7768,2,1067,0,0.000901133,mm10,mBC-0716-1
"F12,H2",27272,28522,20963,7559,14866,0,6815,6836,4930,1906,2.58656873,3235,1479,991,506,0,506,0,165,0,0.067193676,empty,mBC-0716-1
"F12,H3",21323,22100,16051,6049,11715,0,5469,5485,3915,1570,2.493630573,2704,1457,955,521,0,521,0,148,0,0.049904031,empty,mBC-0716-1
"F12,H4",590383,636931,427085,209846,339327,1,179630,179862,116873,62989,1.855450952,99550,556,375,163,0,163,0,50,0,0,empty,mBC-0716-1
"F12,H5",737662,811106,529810,281296,427891,0,235295,235651,200983,34668,5.797363563,127589,108851,72911,35000,9,34991,1,2670,0,0.008802263,mm10,mBC-0716-1
"F12,H6",15853,16025,12045,3980,8600,0,3983,3991,2848,1143,2.491688539,1875,1701,1106,521,0,521,0,167,0,0.032629559,empty,mBC-0716-1
"F12,H7",17597,17917,13267,4650,9707,0,4528,4542,3220,1322,2.43570348,2207,1396,906,499,0,499,0,147,0,0.082164329,empty,mBC-0716-1
"F12,H8",13890,14264,10344,3920,7612,0,3532,3540,2493,1047,2.381088825,1752,1349,876,461,0,461,0,152,0,0.013015184,empty,mBC-0716-1
"F12,H9",1291480,1369776,938843,430933,718738,0,379185,379767,302860,76907,3.938003043,199494,86079,54936,26348,11,26337,5,2529,0,0.003872878,mm10,mBC-0716-1
"F12,H10",14980,15588,11201,4387,8160,0,3817,3820,2720,1100,2.472727273,1900,6019,2137,1067,1,1066,1,221,0,0.156660413,empty,mBC-0716-1
"F12,H11",17438,18451,13274,5177,9731,0,4576,4587,3233,1354,2.38774003,2277,181,90,56,0,56,0,27,0,0.160714286,empty,mBC-0716-1
"F12,H12",6472,6788,4899,1889,3557,0,1635,1637,1162,475,2.446315789,811,462,304,156,0,156,0,67,0,0.032051282,empty,mBC-0716-1
"G1,A1",13089,13447,9721,3726,7305,0,3455,3461,2463,998,2.467935872,1701,2763,945,509,0,509,0,138,0,0.068762279,empty,mBC-0716-1
"G1,A2",17132,17095,13316,3779,9000,0,4035,4040,2885,1155,2.497835498,1771,1060,595,290,0,290,0,94,0,0.024137931,empty,mBC-0716-1
"G1,A3",14016,14731,10643,4088,7923,0,3735,3742,2701,1041,2.594620557,1875,601,414,211,0,211,0,71,0,0.004739336,empty,mBC-0716-1
"G1,A4",18371,18473,14142,4331,9747,0,4215,4225,2985,1240,2.407258065,1926,450,312,173,0,173,0,47,0,0.040462428,empty,mBC-0716-1
"G1,A5",1149486,1265984,806171,459813,676314,1,396439,396957,315597,81360,3.879019174,220588,85022,58152,27569,14,27555,3,2580,0,0.001125023,mm10,mBC-0716-1
"G1,A6",393841,412537,291907,120630,224438,0,114042,114280,89893,24387,3.686103252,57859,9740,6584,3094,1,3093,1,565,0,0.005819593,mm10,mBC-0716-1
"G1,A7",14076,14395,10786,3609,7660,0,3480,3486,2463,1023,2.407624633,1630,1461,727,362,0,362,0,87,0,0.129834254,empty,mBC-0716-1
"G1,A8",9831,10375,7474,2901,5643,0,2696,2709,1873,836,2.240430622,1344,906,565,284,0,284,0,101,0,0.038732394,empty,mBC-0716-1
"G1,A9",16248,16336,12529,3807,8600,1,3730,3744,2653,1091,2.431714024,1694,787,455,246,0,246,0,87,0,0.12601626,empty,mBC-0716-1
"G1,A10",14225,14521,10920,3601,7673,0,3414,3424,2449,975,2.511794872,1619,251,130,69,0,69,0,37,0,0.028985507,empty,mBC-0716-1
"G1,A11",15611,15955,11795,4160,8620,0,3906,3916,2695,1221,2.207207207,1883,3062,1002,529,0,529,0,118,0,0.200378072,empty,mBC-0716-1
"G1,A12",17902,17895,13664,4231,9348,0,4007,4016,2835,1181,2.400508044,1818,12515,4379,2303,0,2303,0,398,0,0.069474598,empty,mBC-0716-1
"G1,B1",15996,16460,12254,4206,8675,0,3919,3923,2758,1165,2.367381974,1854,828,550,291,0,291,0,82,0,0.041237113,empty,mBC-0716-1
"G1,B2",17391,17765,13367,4398,9411,0,4179,4185,2916,1269,2.29787234,1962,383,195,112,0,112,0,46,0,0.116071429,empty,mBC-0716-1
"G1,B3",16379,17014,12441,4573,8879,0,4056,4067,2852,1215,2.347325103,1918,8727,2934,1484,0,1484,0,282,0,0.035040431,empty,mBC-0716-1
"G1,B4",14467,15071,10909,4162,7856,0,3571,3582,2478,1104,2.244565217,1746,669,407,228,0,228,0,78,0,0.026315789,empty,mBC-0716-1
"G1,B5",523842,328622,205735,122887,228353,8,130491,131169,98954,32215,3.071674686,75747,49120,27821,13315,8,13307,2,1621,0,0.02186819,mm10,mBC-0716-1
"G1,B6",10467,10788,8000,2788,5843,0,2666,2668,1894,774,2.447028424,1270,719,428,214,0,214,0,84,0,0.028037383,empty,mBC-0716-1
"G1,B7",13684,13983,10451,3532,7548,0,3333,3343,2314,1029,2.248785228,1608,530,301,165,0,165,0,60,0,0.090909091,empty,mBC-0716-1
"G1,B8",11826,12296,9098,3198,6460,0,2946,2950,2144,806,2.660049628,1410,890,625,329,0,329,0,97,0,0.036474164,empty,mBC-0716-1
"G1,B9",599538,662483,426700,235783,352094,0,199816,200080,147121,52959,2.778016957,109230,33876,23287,11105,4,11101,1,1287,0,0.00090082,mm10,mBC-0716-1
"G1,B10",14753,13976,10539,3437,7776,0,3565,3587,2554,1033,2.472410455,1668,432,273,121,0,121,0,40,0,0.008264463,empty,mBC-0716-1
"G1,B11",15901,16195,12105,4090,8552,0,3855,3862,2802,1060,2.643396226,1858,417,194,91,0,91,0,35,0,0.010989011,empty,mBC-0716-1
"G1,B12",595570,661109,410299,250810,358524,1,217198,217523,156227,61296,2.548730749,122243,14920,10152,4750,1,4749,1,822,0,0,mm10,mBC-0716-1
"G1,C1",19036,19296,14755,4541,10021,0,4221,4233,2990,1243,2.405470636,1894,538,374,174,0,174,0,56,0,0,empty,mBC-0716-1
"G1,C2",16866,17184,12660,4524,9248,0,4332,4344,3036,1308,2.321100917,2088,1121,739,384,0,384,0,111,0,0.072916667,empty,mBC-0716-1
"G1,C3",17219,17501,13029,4472,9384,1,4291,4316,2932,1384,2.11849711,2038,398,211,113,0,113,0,42,0,0.026548673,empty,mBC-0716-1
"G1,C4",15419,15409,11712,3697,8437,0,3747,3748,2644,1104,2.394927536,1774,879,583,325,0,325,0,97,0,0.083076923,empty,mBC-0716-1
"G1,C5",753604,825822,532536,293286,437679,2,245229,245612,204951,40661,5.040481051,134523,75507,49322,23789,12,23777,4,2170,0,0.000672919,mm10,mBC-0716-1
"G1,C6",751096,816977,521463,295514,449072,0,267232,267621,207897,59724,3.480962427,147090,20979,12234,5864,1,5863,1,827,0,0.005116834,mm10,mBC-0716-1
"G1,C7",14282,14668,10875,3793,7862,1,3702,3721,2647,1074,2.46461825,1748,208,145,85,0,85,0,34,0,0.011764706,empty,mBC-0716-1
"G1,C8",13043,13534,10105,3429,7362,0,3371,3380,2366,1014,2.333333333,1655,997,681,342,1,341,1,110,0,0.041055718,empty,mBC-0716-1
"G1,C9",11027,11623,8405,3218,6176,0,2854,2861,1985,876,2.265981735,1365,625,377,213,0,213,0,57,0,0.215962441,empty,mBC-0716-1
"G1,C10",12168,12551,9312,3239,6634,1,3061,3066,2094,972,2.154320988,1495,560,354,183,0,183,0,67,0,0.076502732,empty,mBC-0716-1
"G1,C11",510385,549386,379576,169810,296020,1,146469,146721,124154,22567,5.501573093,76645,56477,39505,18851,14,18837,5,1895,0,0.000424696,mm10,mBC-0716-1
"G1,C12",17632,18129,13456,4673,9627,0,4319,4330,2983,1347,2.214550854,2050,796,502,250,0,250,0,82,0,0.04,empty,mBC-0716-1
"G1,D1",497489,543314,343653,199661,295750,0,169522,169746,141097,28649,4.925023561,94120,22752,15010,7279,2,7277,1,1016,0,0.002473547,mm10,mBC-0716-1
"G1,D2",17861,17951,13945,4006,9603,0,4092,4101,2861,1240,2.307258065,1830,1588,1039,512,0,512,0,127,0,0.02734375,empty,mBC-0716-1
"G1,D3",508346,544673,376541,168132,293449,1,146588,146836,124124,22712,5.465128566,76133,80262,52256,25107,11,25096,3,2314,0,0.001354798,mm10,mBC-0716-1
"G1,D4",12621,12994,9664,3330,6940,0,3184,3191,2291,900,2.545555556,1499,4015,1275,659,1,658,1,144,0,0.06231003,empty,mBC-0716-1
"G1,D5",1240913,1385425,851792,533633,738220,0,448463,449065,341253,107812,3.165259897,255673,61740,41995,19706,12,19694,4,2161,0,0.000406215,mm10,mBC-0716-1
"G1,D6",11116,11582,8349,3233,6032,0,2882,2888,2031,857,2.369894982,1382,828,521,273,1,272,1,94,0,0.044117647,empty,mBC-0716-1
"G1,D7",11862,12573,8946,3627,6759,0,3246,3267,2303,964,2.389004149,1672,1046,702,375,0,375,0,100,0,0.069333333,empty,mBC-0716-1
"G1,D8",14646,15401,11072,4329,8089,0,3796,3801,2665,1136,2.345950704,1877,562,319,146,0,146,0,59,0,0.123287671,empty,mBC-0716-1
"G1,D9",5754,6210,4135,2075,3469,0,1784,1784,1309,475,2.755789474,967,942,578,260,1,259,1,86,0,0.034749035,empty,mBC-0716-1
"G1,D10",12016,12490,9145,3345,6670,0,3098,3101,2185,916,2.385371179,1509,615,381,201,0,201,0,61,0,0.07960199,empty,mBC-0716-1
"G1,D11",11543,11804,8779,3025,6362,0,2854,2857,2043,814,2.50982801,1348,1039,683,318,0,318,0,101,0,0.091194969,empty,mBC-0716-1
"G1,D12",17316,17807,13158,4649,9588,0,4427,4440,3034,1406,2.157894737,2144,11234,4155,2145,4,2141,3,420,0,0.040635217,empty,mBC-0716-1
"G1,E1",19047,19234,14642,4592,10305,0,4571,4585,3325,1260,2.638888889,2141,1120,725,376,0,376,0,119,0,0.031914894,empty,mBC-0716-1
"G1,E2",14904,15112,11472,3640,8049,0,3658,3660,2698,962,2.804573805,1731,928,598,279,0,279,0,89,0,0.039426523,empty,mBC-0716-1
"G1,E3",11025,11645,8494,3151,6148,0,2783,2786,1953,833,2.344537815,1352,1077,618,319,0,319,0,98,0,0.065830721,empty,mBC-0716-1
"G1,E4",761751,827880,541846,286034,437504,0,250099,250497,190238,60259,3.157005593,135708,13370,8375,4094,4,4090,3,691,0,0.005867971,mm10,mBC-0716-1
"G1,E5",19141,19450,14652,4798,10293,0,4563,4581,3161,1420,2.226056338,2109,1031,682,349,0,349,0,103,0,0.011461318,empty,mBC-0716-1
"G1,E6",12200,12641,9317,3324,6723,0,3093,3099,2127,972,2.188271605,1492,957,609,285,0,285,0,81,0,0.129824561,empty,mBC-0716-1
"G1,E7",12387,12763,9491,3272,6875,0,3105,3120,2198,922,2.383947939,1495,863,516,269,0,269,0,87,0,0.007434944,empty,mBC-0716-1
"G1,E8",791645,845011,580371,264640,447232,0,230920,231253,194665,36588,5.32046026,120443,125861,84250,39752,13,39739,2,3047,0,0.0020383,mm10,mBC-0716-1
"G1,E9",8275,8733,6197,2536,4640,0,2184,2191,1558,633,2.461295419,1089,1032,667,332,0,332,0,98,0,0.042168675,empty,mBC-0716-1
"G1,E10",11424,11838,8824,3014,6321,0,2857,2867,1961,906,2.164459161,1366,803,537,268,0,268,0,86,0,0,empty,mBC-0716-1
"G1,E11",478376,533220,330674,202546,291903,1,173169,173395,126949,46446,2.73326013,97856,45902,28594,13649,4,13645,1,1581,0,0.049835104,mm10,mBC-0716-1
"G1,E12",13319,14040,10123,3917,7527,0,3592,3597,2529,1068,2.367977528,1746,733,475,254,0,254,0,85,0,0.007874016,empty,mBC-0716-1
"G1,F1",777550,827654,567210,260444,436321,2,229057,229405,196933,32472,6.064701897,119521,48774,33353,16136,8,16128,1,1786,0,0.003162202,mm10,mBC-0716-1
"G1,F2",19887,20732,15030,5702,10912,0,5060,5074,3539,1535,2.305537459,2532,6363,2406,1223,0,1223,0,275,0,0.031071137,empty,mBC-0716-1
"G1,F3",14996,15616,11248,4368,8378,0,4085,4088,2907,1181,2.461473328,2036,3358,1304,717,0,717,0,170,0,0.135285914,empty,mBC-0716-1
"G1,F4",15936,16676,12150,4526,9135,0,4224,4229,3049,1180,2.583898305,2067,563,365,206,0,206,0,56,0,0.067961165,empty,mBC-0716-1
"G1,F5",20619,20989,15593,5396,11113,0,4973,4983,3553,1430,2.484615385,2391,934,616,348,0,348,0,104,0,0.068965517,empty,mBC-0716-1
"G1,F6",21098,21616,15969,5647,11621,1,5287,5302,3723,1579,2.357821406,2584,1435,927,466,0,466,0,127,0,0.068669528,empty,mBC-0716-1
"G1,F7",17547,17917,13269,4648,9594,0,4318,4329,3068,1261,2.432989691,2046,7057,2118,1134,1,1133,1,253,0,0.052074139,empty,mBC-0716-1
"G1,F8",20055,20726,15154,5572,11188,0,5112,5125,3623,1502,2.412117177,2537,170,110,66,0,66,0,28,0,0,empty,mBC-0716-1
"G1,F9",13883,14071,10729,3342,7691,0,3431,3443,2472,971,2.545829042,1604,1419,840,399,0,399,0,136,0,0.025062657,empty,mBC-0716-1
"G1,F10",18052,18025,13876,4149,9501,0,4197,4206,2918,1288,2.26552795,1889,1349,727,366,0,366,0,99,0,0.183060109,empty,mBC-0716-1
"G1,F11",9948,10138,7554,2584,5402,0,2451,2455,1718,737,2.331071913,1169,797,518,291,0,291,0,77,0,0,empty,mBC-0716-1
"G1,F12",12628,12961,9530,3431,6886,0,3128,3138,2221,917,2.422028353,1569,113,61,31,1,30,1,14,0,0,empty,mBC-0716-1
"G1,G1",376107,382992,281827,101165,208473,0,98428,98604,71521,27083,2.640807887,47781,11428,6122,2873,4,2869,1,543,0,0.041477867,mm10,mBC-0716-1
"G1,G2",17626,18084,13506,4578,9624,0,4305,4316,3036,1280,2.371875,2066,235,136,52,0,52,0,29,0,0.038461538,empty,mBC-0716-1
"G1,G3",17358,17653,13257,4396,9348,0,4167,4172,2908,1264,2.300632911,1956,1469,934,463,0,463,0,119,0,0.034557235,empty,mBC-0716-1
"G1,G4",24514,24996,18927,6069,13167,0,5810,5820,4149,1671,2.482944345,2729,50,34,25,0,25,0,20,0,0,empty,mBC-0716-1
"G1,G5",11482,11901,8782,3119,6246,0,2823,2829,1985,844,2.351895735,1342,718,425,230,0,230,0,74,0,0.047826087,empty,mBC-0716-1
"G1,G6",881788,938175,655915,282260,490817,0,245819,246213,199112,47101,4.227341245,125313,8835,6163,2982,0,2982,0,459,0,0.004024145,mm10,mBC-0716-1
"G1,G7",17138,17437,13313,4124,9329,0,4122,4139,2860,1279,2.23612197,1875,1395,898,453,0,453,0,130,0,0.048565121,empty,mBC-0716-1
"G1,G8",1366249,1527200,956595,570605,801910,1,475327,475931,368369,107562,3.424713189,266499,147620,103502,49751,19,49732,3,3572,0,0.000482587,mm10,mBC-0716-1
"G1,G9",9122,9478,6903,2575,5114,0,2386,2386,1664,722,2.304709141,1201,1068,606,317,0,317,0,103,0,0.028391167,empty,mBC-0716-1
"G1,G10",539649,555166,399213,155953,299763,1,147731,148007,119251,28756,4.14699541,73494,17390,12308,6185,2,6183,1,928,0,0.004043345,mm10,mBC-0716-1
"G1,G11",14249,15187,10372,4815,8052,0,4117,4127,2859,1268,2.254731861,2096,9977,3207,1575,5,1570,2,301,0,0.024203822,empty,mBC-0716-1
"G1,G12",10241,10480,7664,2816,5691,0,2625,2635,1883,752,2.503989362,1282,877,583,282,0,282,0,95,0,0.031914894,empty,mBC-0716-1
"G1,H1",18221,18723,13778,4945,10153,0,4672,4679,3313,1366,2.425329429,2309,469,294,179,0,179,0,68,0,0.016759777,empty,mBC-0716-1
"G1,H2",20264,20615,15555,5060,10901,0,4853,4869,3410,1459,2.337217272,2209,1255,800,429,0,429,0,120,0,0.032634033,empty,mBC-0716-1
"G1,H3",18347,18674,13791,4883,9881,0,4618,4625,3256,1369,2.378378378,2246,1591,870,418,0,418,0,122,0,0.081339713,empty,mBC-0716-1
"G1,H4",12289,12517,9439,3078,6648,0,3033,3039,2138,901,2.372918979,1396,81,56,31,0,31,0,14,0,0.096774194,empty,mBC-0716-1
"G1,H5",580776,634899,419212,215687,338731,0,180857,181129,152446,28683,5.314855489,97989,100746,71156,34116,7,34109,1,2829,0,0.000850215,mm10,mBC-0716-1
"G1,H6",242762,275403,174061,101342,147858,0,85191,85320,63715,21605,2.94908586,48025,17692,11100,5342,4,5338,1,792,0,0.011052829,mm10,mBC-0716-1
"G1,H7",15540,16475,11922,4553,8849,0,4150,4163,2926,1237,2.365400162,2070,944,538,306,0,306,0,105,0,0.045751634,empty,mBC-0716-1
"G1,H8",12560,13083,9527,3556,6968,0,3259,3261,2321,940,2.469148936,1593,1568,818,432,0,432,0,107,0,0.023148148,empty,mBC-0716-1
"G1,H9",14200,14247,10922,3325,7701,0,3429,3443,2442,1001,2.43956044,1547,959,622,280,0,280,0,85,0,0.05,empty,mBC-0716-1
"G1,H10",13302,13573,10067,3506,7192,0,3288,3298,2316,982,2.358452138,1613,2875,1201,579,0,579,0,141,0,0.025906736,empty,mBC-0716-1
"G1,H11",15287,16162,11592,4570,8785,0,4146,4153,2959,1194,2.478224456,2078,168,92,61,0,61,0,26,0,0,empty,mBC-0716-1
"G1,H12",5922,6015,4346,1669,3238,0,1548,1549,1103,446,2.47309417,763,5409,1957,1020,0,1020,0,140,0,0.381372549,empty,mBC-0716-1
"G2,A1",12672,13170,9544,3626,7157,0,3388,3392,2335,1057,2.209082308,1661,1110,802,374,0,374,0,105,0,0.026737968,empty,mBC-0716-1
"G2,A2",16843,16852,12997,3855,8982,0,3840,3848,2700,1148,2.351916376,1749,1034,670,324,0,324,0,109,0,0.046296296,empty,mBC-0716-1
"G2,A3",15082,15426,11464,3962,8145,0,3758,3763,2696,1067,2.526710403,1773,870,485,250,2,248,1,75,0,0.068548387,empty,mBC-0716-1
"G2,A4",19842,20014,15396,4618,10388,0,4506,4510,3216,1294,2.485316847,1984,655,410,190,0,190,0,54,0,0.068421053,empty,mBC-0716-1
"G2,A5",497033,517233,380040,137193,279663,1,128754,128982,100956,28026,3.602226504,63208,32612,22647,10789,5,10784,1,1293,0,0.002503709,mm10,mBC-0716-1
"G2,A6",423403,488951,278956,209995,263821,0,169141,169337,140557,28780,4.883842946,99692,102082,62659,29996,23,29973,7,2592,0,0.020518467,mm10,mBC-0716-1
"G2,A7",14901,15428,11527,3901,8256,0,3717,3725,2498,1227,2.035859821,1781,1210,761,409,0,409,0,103,0,0.051344743,empty,mBC-0716-1
"G2,A8",10135,10283,7713,2570,5514,0,2485,2499,1708,791,2.159292035,1198,4137,1531,782,1,781,1,191,0,0.080665813,empty,mBC-0716-1
"G2,A9",17053,17187,13114,4073,8973,0,3858,3864,2784,1080,2.577777778,1766,3541,1519,799,1,798,1,160,0,0.155388471,empty,mBC-0716-1
"G2,A10",14379,14336,10996,3340,7669,0,3416,3426,2390,1036,2.306949807,1559,334,191,100,0,100,0,38,0,0,empty,mBC-0716-1
"G2,A11",16103,16529,12234,4295,8823,0,3991,3991,2720,1271,2.140047207,1907,888,475,245,0,245,0,77,0,0.069387755,empty,mBC-0716-1
"G2,A12",19107,19481,14589,4892,10073,0,4445,4466,3128,1338,2.337817638,2057,17775,5568,2756,0,2756,0,456,0,0.062772134,empty,mBC-0716-1
"G2,B1",17846,18442,13786,4656,9529,0,4269,4277,2990,1287,2.323232323,1980,870,589,322,0,322,0,110,0,0.043478261,empty,mBC-0716-1
"G2,B2",18461,18828,14132,4696,9888,0,4449,4464,3135,1329,2.358916479,2074,332,175,105,0,105,0,48,0,0.095238095,empty,mBC-0716-1
"G2,B3",18561,19039,14234,4805,9920,0,4540,4553,3218,1335,2.410486891,2108,825,480,263,0,263,0,97,0,0.053231939,empty,mBC-0716-1
"G2,B4",15948,16323,11906,4417,8595,0,3890,3891,2695,1196,2.253344482,1883,7871,3009,1631,3,1628,1,291,0,0.21007371,empty,mBC-0716-1
"G2,B5",8281,5113,3623,1490,3518,0,1724,1735,1210,525,2.304761905,922,645,429,225,0,225,0,64,0,0.088888889,empty,mBC-0716-1
"G2,B6",693830,812054,452347,359707,431672,0,284341,284682,223028,61654,3.617413307,170411,74507,48651,22951,16,22935,1,2193,0,0.000697624,mm10,mBC-0716-1
"G2,B7",15027,15592,11691,3901,8148,0,3666,3680,2562,1118,2.291592129,1699,1033,634,331,0,331,0,86,0,0.129909366,empty,mBC-0716-1
"G2,B8",14649,15193,11257,3936,8015,0,3643,3657,2609,1048,2.489503817,1690,1615,729,384,0,384,0,122,0,0.0625,empty,mBC-0716-1
"G2,B9",14029,14218,10696,3522,7384,0,3292,3298,2342,956,2.449790795,1504,338,213,131,0,131,0,50,0,0.083969466,empty,mBC-0716-1
"G2,B10",14999,14754,10993,3761,8133,0,3671,3679,2552,1127,2.264418811,1744,859,371,206,0,206,0,63,0,0.106796117,empty,mBC-0716-1
"G2,B11",14756,14945,11163,3782,7814,0,3521,3531,2479,1052,2.356463878,1687,912,381,185,0,185,0,46,0,0.108108108,empty,mBC-0716-1
"G2,B12",16016,16486,12215,4271,8834,0,3975,3980,2764,1216,2.273026316,1931,1105,652,349,0,349,0,92,0,0.100286533,empty,mBC-0716-1
"G2,C1",20455,20738,15819,4919,10670,0,4530,4541,3224,1317,2.447987851,2080,11597,3702,1861,1,1860,1,324,0,0.042473118,empty,mBC-0716-1
"G2,C2",17525,18227,13172,5055,9634,0,4553,4561,3291,1270,2.591338583,2273,4956,2118,991,1,990,1,235,0,0.103030303,empty,mBC-0716-1
"G2,C3",18252,18647,13705,4942,9780,0,4490,4494,3079,1415,2.175971731,2175,543,310,157,0,157,0,45,0,0.171974522,empty,mBC-0716-1
"G2,C4",719696,767036,510246,256790,409887,1,230824,231160,176219,54941,3.207422508,123879,19146,9756,4640,1,4639,1,761,0,0.023927571,mm10,mBC-0716-1
"G2,C5",761249,828534,543649,284885,438181,3,243419,243802,206049,37753,5.457817922,131806,99495,64996,31015,15,31000,3,2560,0,0.000903226,mm10,mBC-0716-1
"G2,C6",15071,15176,11561,3615,8296,0,3813,3816,2651,1165,2.275536481,1747,1107,661,339,0,339,0,92,0,0.135693215,empty,mBC-0716-1
"G2,C7",14567,15210,10996,4214,8056,3,3690,3706,2557,1149,2.225413403,1840,470,246,134,0,134,0,46,0,0.037313433,empty,mBC-0716-1
"G2,C8",13400,13505,10207,3298,7151,0,3206,3208,2306,902,2.55654102,1439,1419,944,452,0,452,0,119,0,0.053097345,empty,mBC-0716-1
"G2,C9",11880,12132,8968,3164,6234,0,2814,2815,1962,853,2.300117233,1286,6378,1988,985,1,984,1,206,0,0.024390244,empty,mBC-0716-1
"G2,C10",12316,12789,9491,3298,6796,0,3041,3044,2082,962,2.164241164,1441,832,543,276,0,276,0,76,0,0.108695652,empty,mBC-0716-1
"G2,C11",10876,11176,8318,2858,5869,3,2693,2704,1899,805,2.359006211,1265,904,619,305,0,305,0,89,0,0.006557377,empty,mBC-0716-1
"G2,C12",17898,18547,13516,5031,9805,0,4504,4512,3178,1334,2.382308846,2253,1132,671,347,0,347,0,95,0,0.074927954,empty,mBC-0716-1
"G2,D1",10441,10765,7913,2852,5756,0,2652,2658,1851,807,2.293680297,1303,427,220,108,1,107,1,42,0,0,empty,mBC-0716-1
"G2,D2",591604,623532,433841,189691,333791,1,174724,175034,131027,44007,2.977412684,89852,20914,12685,6239,2,6237,1,1004,0,0.024210358,mm10,mBC-0716-1
"G2,D3",12225,12486,9154,3332,6650,0,3145,3147,2207,940,2.34787234,1513,841,530,267,0,267,0,90,0,0.003745318,empty,mBC-0716-1
"G2,D4",13184,13642,10190,3452,7065,0,3250,3256,2241,1015,2.207881773,1588,1090,683,288,0,288,0,93,0,0.072916667,empty,mBC-0716-1
"G2,D5",12603,13339,9629,3710,7093,0,3317,3319,2283,1036,2.203667954,1624,884,526,286,0,286,0,99,0,0.031468531,empty,mBC-0716-1
"G2,D6",343837,367644,253229,114415,201955,0,103520,103670,76019,27651,2.749231493,55103,8477,5599,2677,1,2676,1,529,0,0.001494768,mm10,mBC-0716-1
"G2,D7",12145,12545,9146,3399,6604,0,3067,3072,2133,939,2.271565495,1488,1076,692,370,0,370,0,124,0,0.059459459,empty,mBC-0716-1
"G2,D8",18270,18988,13564,5424,10003,1,4742,4754,3443,1311,2.626239512,2426,23921,6747,3312,4,3308,3,419,0,0.178355502,empty,mBC-0716-1
"G2,D9",4276,4232,3153,1079,2392,0,1127,1129,816,313,2.607028754,538,1060,566,286,0,286,0,89,0,0.031468531,empty,mBC-0716-1
"G2,D10",12836,13293,9798,3495,7024,0,3286,3292,2347,945,2.483597884,1562,770,453,226,0,226,0,81,0,0,empty,mBC-0716-1
"G2,D11",12133,12413,9085,3328,6670,0,3047,3058,2118,940,2.253191489,1560,1322,840,416,0,416,0,117,0,0.028846154,empty,mBC-0716-1
"G2,D12",584951,632496,430668,201828,336963,0,174269,174553,121508,53045,2.290658875,92266,74507,46769,22104,9,22095,1,2138,0,0.006653089,mm10,mBC-0716-1
"G2,E1",908928,934187,703502,230685,483507,1,208702,209100,170636,38464,4.43625208,99303,123213,86944,41050,16,41034,3,3046,0,0.002071453,mm10,mBC-0716-1
"G2,E2",512610,552573,374302,178271,298180,0,155725,155947,128915,27032,4.768977508,82936,85581,59264,28090,13,28077,2,2543,0,0.005698615,mm10,mBC-0716-1
"G2,E3",11276,11319,8671,2648,6092,0,2701,2707,1889,818,2.309290954,1245,1286,838,432,0,432,0,122,0,0.0625,empty,mBC-0716-1
"G2,E4",14187,14270,10900,3370,7649,0,3425,3428,2434,994,2.448692153,1608,1261,720,368,0,368,0,129,0,0.057065217,empty,mBC-0716-1
"G2,E5",517382,530590,389533,141057,286835,1,136347,136603,105403,31200,3.378301282,67131,12185,8426,4187,1,4186,1,674,0,0.020305781,mm10,mBC-0716-1
"G2,E6",12450,12474,9495,2979,6568,0,2917,2925,1991,934,2.131691649,1363,2033,839,415,0,415,0,111,0,0.043373494,empty,mBC-0716-1
"G2,E7",12973,13378,9874,3504,7091,0,3294,3299,2301,998,2.305611222,1595,1169,698,382,0,382,0,110,0,0.060209424,empty,mBC-0716-1
"G2,E8",740943,793556,543147,250409,419706,0,218182,218523,178942,39581,4.520906496,113845,97092,68188,32306,9,32297,2,2725,0,0.001207542,mm10,mBC-0716-1
"G2,E9",8265,8455,6285,2170,4495,0,2008,2021,1368,653,2.094946401,968,1065,665,334,0,334,0,88,0,0.122754491,empty,mBC-0716-1
"G2,E10",12167,12392,9417,2975,6433,0,2829,2835,1935,900,2.15,1282,1314,864,434,1,433,1,110,0,0.043879908,empty,mBC-0716-1
"G2,E11",8327,8371,6385,1986,4603,0,2048,2049,1451,598,2.426421405,936,3329,1393,718,0,718,0,145,0,0.013927577,empty,mBC-0716-1
"G2,E12",13576,13968,10393,3575,7511,0,3460,3462,2411,1051,2.294005709,1616,1311,725,332,0,332,0,107,0,0.075301205,empty,mBC-0716-1
"G2,F1",16247,16253,12433,3820,8733,0,3912,3919,2701,1218,2.217569787,1781,2564,1283,655,3,652,1,129,0,0.076687117,empty,mBC-0716-1
"G2,F2",20626,21492,15598,5894,11319,0,5232,5245,3678,1567,2.347160179,2577,2016,1253,612,0,612,0,170,0,0.08496732,empty,mBC-0716-1
"G2,F3",696650,786131,488538,297593,419697,1,243309,243643,199577,44066,4.529047338,137679,97795,69265,32911,18,32893,2,2773,0,0.002614538,mm10,mBC-0716-1
"G2,F4",15430,15573,11807,3766,8445,0,3744,3751,2659,1092,2.434981685,1787,412,265,127,0,127,0,58,0,0,empty,mBC-0716-1
"G2,F5",22117,22622,16795,5827,11994,0,5407,5420,3836,1584,2.421717172,2623,1351,799,428,0,428,0,138,0,0.03271028,empty,mBC-0716-1
"G2,F6",21560,22304,16438,5866,11565,0,5223,5234,3731,1503,2.482368596,2456,2111,1337,683,0,683,0,186,0,0.058565154,empty,mBC-0716-1
"G2,F7",17777,18247,13700,4547,9905,0,4432,4447,3047,1400,2.176428571,2036,866,542,276,0,276,0,82,0,0.094202899,empty,mBC-0716-1
"G2,F8",21033,21660,16118,5542,11347,0,5124,5133,3637,1496,2.431149733,2355,117,67,39,0,39,0,23,0,0.025641026,empty,mBC-0716-1
"G2,F9",13466,13850,10331,3519,7320,0,3299,3307,2298,1009,2.277502478,1553,2328,1061,555,0,555,0,154,0,0.05045045,empty,mBC-0716-1
"G2,F10",18887,19098,14624,4474,10056,0,4432,4440,3092,1348,2.293768546,1987,1145,734,361,0,361,0,105,0,0.022160665,empty,mBC-0716-1
"G2,F11",1702027,1850830,1197123,653707,954828,3,543506,544274,438604,105670,4.150695562,298009,206161,133649,64070,20,64050,4,4082,0,0.001842311,mm10,mBC-0716-1
"G2,F12",13056,13189,10059,3130,7022,0,3120,3128,2121,1007,2.106256207,1431,445,158,95,0,95,0,22,0,0.063157895,empty,mBC-0716-1
"G2,G1",9677,9909,7568,2341,5269,0,2342,2349,1691,658,2.569908815,1036,1441,912,440,0,440,0,125,0,0.022727273,empty,mBC-0716-1
"G2,G2",19192,19694,14571,5123,10254,0,4573,4582,3099,1483,2.089683075,2222,740,400,219,0,219,0,60,0,0.095890411,empty,mBC-0716-1
"G2,G3",17615,18302,13447,4855,9629,0,4391,4400,2974,1426,2.085553997,2193,1679,1041,546,0,546,0,151,0,0.098901099,empty,mBC-0716-1
"G2,G4",920421,979037,668012,311025,512366,1,270405,270831,229415,41416,5.539284335,141159,1126,736,347,0,347,0,80,0,0,empty,mBC-0716-1
"G2,G5",12050,12203,9195,3008,6499,0,2887,2894,2011,883,2.277463194,1334,849,562,314,0,314,0,99,0,0.035031847,empty,mBC-0716-1
"G2,G6",22507,22925,17326,5599,12089,0,5282,5296,3719,1577,2.358275206,2429,100,71,43,0,43,0,28,0,0.023255814,empty,mBC-0716-1
"G2,G7",19140,19746,14749,4997,10306,0,4610,4616,3261,1355,2.406642066,2219,3046,1354,700,0,700,0,173,0,0.144285714,empty,mBC-0716-1
"G2,G8",13190,13706,9966,3740,7143,0,3268,3270,2279,991,2.299697275,1592,2025,1025,532,0,532,0,150,0,0.080827068,empty,mBC-0716-1
"G2,G9",9709,9995,7433,2562,5327,0,2333,2339,1652,687,2.404657933,1133,958,619,293,0,293,0,96,0,0.071672355,empty,mBC-0716-1
"G2,G10",12288,12620,9489,3131,6726,0,2985,2993,2094,899,2.329254727,1411,1449,879,475,0,475,0,130,0,0.086315789,empty,mBC-0716-1
"G2,G11",950415,1064372,645201,419171,559087,0,346529,346953,264337,82616,3.199586037,197177,38143,26965,12987,3,12984,1,1439,0,0.00107825,mm10,mBC-0716-1
"G2,G12",10553,11075,8020,3055,5918,0,2777,2784,1910,874,2.185354691,1385,842,534,280,0,280,0,91,0,0.085714286,empty,mBC-0716-1
"G2,H1",19245,19855,14354,5501,10524,0,4827,4836,3399,1437,2.365344468,2414,7818,2311,1127,3,1124,1,212,0,0.144128114,empty,mBC-0716-1
"G2,H2",21744,22250,16736,5514,11563,0,5138,5153,3618,1535,2.357003257,2403,1485,976,449,0,449,0,125,0,0.093541203,empty,mBC-0716-1
"G2,H3",21774,22341,16588,5753,11734,0,5334,5338,3861,1477,2.6140826,2502,1391,886,468,0,468,0,128,0,0.042735043,empty,mBC-0716-1
"G2,H4",12281,12581,9275,3306,6588,0,2960,2963,2009,954,2.105870021,1409,847,284,149,0,149,0,32,0,0.073825503,empty,mBC-0716-1
"G2,H5",774306,854896,550610,304286,449509,4,257256,257648,191017,66631,2.866788732,141418,63972,45276,21716,5,21711,1,2121,0,0.000875132,mm10,mBC-0716-1
"G2,H6",13174,13760,9830,3930,7358,1,3472,3480,2416,1064,2.270676692,1706,2507,1458,753,0,753,0,180,0,0.078353254,empty,mBC-0716-1
"G2,H7",16058,16563,12313,4250,8836,0,4045,4053,2800,1253,2.234636872,1968,1245,815,437,0,437,0,129,0,0.025171625,empty,mBC-0716-1
"G2,H8",12506,12729,9385,3344,6668,0,3045,3053,2140,913,2.343921139,1450,1465,886,479,0,479,0,127,0,0.043841336,empty,mBC-0716-1
"G2,H9",13851,13811,10669,3142,7455,0,3277,3290,2296,994,2.309859155,1466,1081,694,369,0,369,0,113,0,0.070460705,empty,mBC-0716-1
"G2,H10",13128,13484,9875,3609,7234,0,3287,3290,2327,963,2.416407061,1585,837,516,223,0,223,0,83,0,0.112107623,empty,mBC-0716-1
"G2,H11",563235,575030,409555,165475,311410,1,158160,158427,129236,29191,4.427254976,79975,688,289,137,0,137,0,48,0,0.01459854,empty,mBC-0716-1
"G2,H12",5586,5870,4169,1701,3106,0,1476,1476,1020,456,2.236842105,732,722,481,234,1,233,1,64,0,0.060085837,empty,mBC-0716-1
"G3,A1",15086,15454,11569,3885,8278,0,3756,3767,2664,1103,2.415231188,1754,6915,2524,1328,1,1327,1,256,0,0.033911078,empty,mBC-0716-1
"G3,A2",19495,19907,15119,4788,10389,0,4486,4491,3107,1384,2.244942197,2041,1212,847,409,0,409,0,101,0,0.056234719,empty,mBC-0716-1
"G3,A3",594113,622736,433574,189162,337008,0,175926,176246,125879,50367,2.499235611,91826,23422,13524,6445,4,6441,1,948,0,0.007918025,mm10,mBC-0716-1
"G3,A4",785308,831099,593007,238092,439320,0,216849,217202,172772,44430,3.888633806,108685,15764,11000,5172,0,5172,0,781,0,0.002900232,mm10,mBC-0716-1
"G3,A5",17588,17805,13398,4407,9472,0,4233,4238,2903,1335,2.174531835,1972,1291,917,408,0,408,0,126,0,0.004901961,empty,mBC-0716-1
"G3,A6",18374,19057,13938,5119,10325,0,4807,4820,3445,1375,2.505454545,2331,1524,926,497,0,497,0,132,0,0.084507042,empty,mBC-0716-1
"G3,A7",17477,18215,13323,4892,9692,0,4431,4445,3041,1404,2.165954416,2180,1313,820,392,0,392,0,110,0,0.06377551,empty,mBC-0716-1
"G3,A8",11338,11738,8752,2986,6338,0,2889,2897,2118,779,2.718870347,1325,1229,772,390,0,390,0,128,0,0.020512821,empty,mBC-0716-1
"G3,A9",19221,19616,14672,4944,10273,1,4464,4478,3147,1331,2.364387678,2110,9345,3190,1564,0,1564,0,283,0,0.042838875,empty,mBC-0716-1
"G3,A10",19258,19808,14565,5243,10664,0,4932,4939,3523,1416,2.48799435,2410,451,258,117,0,117,0,52,0,0.017094017,empty,mBC-0716-1
"G3,A11",18558,18642,14145,4497,9981,0,4382,4391,3057,1334,2.291604198,2032,1021,655,335,0,335,0,97,0,0.113432836,empty,mBC-0716-1
"G3,A12",21350,21665,16413,5252,11354,0,5039,5051,3574,1477,2.419769804,2300,2642,1599,802,0,802,0,177,0,0.056109726,empty,mBC-0716-1
"G3,B1",20077,20863,15488,5375,10995,0,4900,4917,3425,1492,2.295576408,2368,824,524,261,0,261,0,88,0,0.019157088,empty,mBC-0716-1
"G3,B2",22133,21999,16913,5086,11934,0,5251,5271,3732,1539,2.424951267,2358,381,244,122,0,122,0,41,0,0.016393443,empty,mBC-0716-1
"G3,B3",20687,21276,15801,5475,11391,1,5143,5156,3619,1537,2.354586858,2418,2369,955,526,0,526,0,135,0,0.100760456,empty,mBC-0716-1
"G3,B4",17770,18147,13516,4631,9690,0,4432,4443,3078,1365,2.254945055,2072,1282,845,405,1,404,1,111,0,0.091584158,empty,mBC-0716-1
"G3,B5",9355,5814,4113,1701,4001,0,1966,1976,1359,617,2.202593193,1032,3549,1292,602,1,601,1,123,0,0.009983361,empty,mBC-0716-1
"G3,B6",12764,13213,9490,3723,6956,0,3272,3282,2231,1051,2.122740247,1650,2379,1005,553,1,552,1,128,0,0.074275362,empty,mBC-0716-1
"G3,B7",17246,17775,13303,4472,9432,0,4216,4237,2916,1321,2.207418622,1944,919,603,297,1,296,1,73,0,0.010135135,empty,mBC-0716-1
"G3,B8",1270907,1318627,954864,363763,693842,2,339632,340155,277508,62647,4.429709324,167989,68287,47474,22485,17,22468,2,2282,0,0.001424248,mm10,mBC-0716-1
"G3,B9",16047,16332,12291,4041,8503,0,3862,3878,2679,1199,2.234361968,1772,801,505,253,0,253,0,69,0,0.011857708,empty,mBC-0716-1
"G3,B10",17782,17136,12700,4436,9431,0,4357,4380,2920,1460,2,2063,499,272,135,0,135,0,51,0,0.037037037,empty,mBC-0716-1
"G3,B11",881408,951755,621469,330286,502786,3,291638,292072,223845,68227,3.280885866,158361,681,466,221,0,221,0,67,0,0,empty,mBC-0716-1
"G3,B12",19312,19386,14421,4965,10629,0,4767,4774,3367,1407,2.393034826,2281,1233,807,394,0,394,0,115,0,0.07106599,empty,mBC-0716-1
"G3,C1",24269,24359,18775,5584,12876,0,5403,5413,3838,1575,2.436825397,2485,680,484,283,0,283,0,78,0,0.053003534,empty,mBC-0716-1
"G3,C2",21019,21363,15860,5503,11635,0,5436,5446,3819,1627,2.347264905,2593,4459,1961,967,1,966,1,223,0,0.057971014,empty,mBC-0716-1
"G3,C3",21604,21759,16358,5401,11671,0,5254,5261,3672,1589,2.310887351,2422,800,318,177,0,177,0,63,0,0.056497175,empty,mBC-0716-1
"G3,C4",916330,965890,650861,315029,510435,1,278036,278446,232628,45818,5.07721856,145428,88448,59621,28104,12,28092,1,2355,0,0.00598035,mm10,mBC-0716-1
"G3,C5",17014,17460,13001,4459,9310,0,4171,4184,2883,1301,2.215987702,2008,1100,667,328,0,328,0,109,0,0.073170732,empty,mBC-0716-1
"G3,C6",18637,19405,13986,5419,10591,0,4963,4985,3573,1412,2.530453258,2512,1389,931,446,0,446,0,116,0,0.107623318,empty,mBC-0716-1
"G3,C7",906679,1037971,611556,426415,549597,1,341991,342481,252964,89517,2.825876649,200225,29053,20573,9939,4,9935,1,1187,0,0.001509814,mm10,mBC-0716-1
"G3,C8",15380,15912,11557,4355,8525,0,3816,3831,2634,1197,2.200501253,1831,1724,1008,474,0,474,0,139,0,0.044303797,empty,mBC-0716-1
"G3,C9",13724,14269,10340,3929,7780,0,3657,3664,2584,1080,2.392592593,1830,861,499,228,0,228,0,64,0,0.105263158,empty,mBC-0716-1
"G3,C10",14448,14985,11210,3775,7969,0,3563,3567,2449,1118,2.190518784,1705,1168,776,360,0,360,0,100,0,0.011111111,empty,mBC-0716-1
"G3,C11",12259,12895,9368,3527,6875,0,3191,3200,2185,1015,2.15270936,1567,1008,642,328,0,328,0,83,0,0.076219512,empty,mBC-0716-1
"G3,C12",21365,22227,16174,6053,11702,0,5301,5317,3685,1632,2.257965686,2582,1118,678,361,0,361,0,94,0,0.063711911,empty,mBC-0716-1
"G3,D1",11937,12186,8969,3217,6712,0,3094,3101,2171,930,2.334408602,1481,515,280,129,0,129,0,48,0,0.046511628,empty,mBC-0716-1
"G3,D2",22545,22668,17352,5316,12052,0,5197,5207,3624,1583,2.289324068,2324,1969,1285,644,0,644,0,179,0,0.080745342,empty,mBC-0716-1
"G3,D3",14115,14301,10718,3583,7633,0,3398,3404,2356,1048,2.248091603,1595,1215,777,365,0,365,0,102,0,0.030136986,empty,mBC-0716-1
"G3,D4",15216,15411,11651,3760,8180,0,3655,3660,2521,1139,2.21334504,1673,1762,937,444,0,444,0,132,0,0.117117117,empty,mBC-0716-1
"G3,D5",13971,14049,10664,3385,7635,0,3469,3476,2397,1079,2.22150139,1636,1064,727,369,0,369,0,109,0,0.037940379,empty,mBC-0716-1
"G3,D6",13216,13242,9895,3347,7287,0,3326,3332,2361,971,2.431513903,1561,1127,754,395,0,395,0,99,0,0.025316456,empty,mBC-0716-1
"G3,D7",14603,14673,10886,3787,7980,0,3594,3601,2548,1053,2.419753086,1684,1398,928,466,0,466,0,140,0,0.075107296,empty,mBC-0716-1
"G3,D8",17104,17419,12896,4523,9515,0,4419,4430,3049,1381,2.20782042,2091,771,494,268,0,268,0,86,0,0.067164179,empty,mBC-0716-1
"G3,D9",4677,4776,3433,1343,2697,0,1293,1293,931,362,2.571823204,645,3436,1299,675,1,674,1,155,0,0.066765579,empty,mBC-0716-1
"G3,D10",796490,866332,574165,292167,461468,1,250772,251137,216492,34645,6.24886708,134480,96012,62711,30840,11,30829,1,2583,0,0.013234292,mm10,mBC-0716-1
"G3,D11",13497,13653,10322,3331,7394,0,3296,3308,2319,989,2.34479272,1593,1290,859,447,1,446,1,141,0,0.022421525,empty,mBC-0716-1
"G3,D12",21477,22157,16203,5954,11647,0,5350,5362,3724,1638,2.273504274,2624,2589,1681,811,0,811,0,212,0,0.038224414,empty,mBC-0716-1
"G3,E1",1027956,1100042,730279,369763,578377,0,318831,319321,270387,48934,5.525544611,171321,85289,57909,27639,9,27630,1,2361,0,0.000941006,mm10,mBC-0716-1
"G3,E2",16807,17190,12829,4361,9335,0,4235,4248,3015,1233,2.445255474,1939,1189,737,382,0,382,0,122,0,0.034031414,empty,mBC-0716-1
"G3,E3",632820,697871,460326,237545,375282,0,207439,207699,138507,69192,2.001777662,112947,63192,42246,20197,6,20191,1,1932,0,0.002624932,mm10,mBC-0716-1
"G3,E4",16716,17210,12808,4402,8975,0,4064,4079,2906,1173,2.477408355,1931,1315,864,411,0,411,0,116,0,0.141119221,empty,mBC-0716-1
"G3,E5",22575,23135,17362,5773,12239,0,5294,5297,3696,1601,2.308557152,2506,1318,868,414,0,414,0,130,0,0.028985507,empty,mBC-0716-1
"G3,E6",481557,499929,353446,146483,270455,0,137618,137874,111895,25979,4.307132684,70161,28536,19613,9626,5,9621,2,1287,0,0.002390604,mm10,mBC-0716-1
"G3,E7",14378,14371,10913,3458,7639,0,3419,3433,2362,1071,2.2054155,1556,3604,1547,764,5,759,1,172,0,0.098814229,empty,mBC-0716-1
"G3,E8",19789,20020,14905,5115,11036,0,4909,4927,3549,1378,2.575471698,2296,2134,1476,678,0,678,0,166,0,0.038348083,empty,mBC-0716-1
"G3,E9",9714,9886,7396,2490,5322,0,2421,2423,1732,691,2.506512301,1137,1241,758,368,0,368,0,86,0,0.114130435,empty,mBC-0716-1
"G3,E10",14107,14415,10714,3701,7589,0,3392,3405,2355,1050,2.242857143,1633,7865,2732,1278,0,1278,0,262,0,0.021909233,empty,mBC-0716-1
"G3,E11",9912,10094,7467,2627,5426,1,2481,2494,1744,750,2.325333333,1199,1727,939,450,0,450,0,112,0,0.108888889,empty,mBC-0716-1
"G3,E12",555601,575593,420755,154838,312917,1,149209,149448,110065,39383,2.794733768,74767,21841,8958,4489,6,4483,2,764,0,0.052643319,mm10,mBC-0716-1
"G3,F1",19015,19696,14406,5290,10177,0,4571,4591,3188,1403,2.272273699,2216,3622,1367,678,1,677,1,142,0,0.11816839,empty,mBC-0716-1
"G3,F2",23594,24474,18033,6441,13024,0,5946,5957,4223,1734,2.435409458,2926,2426,1636,884,0,884,0,225,0,0.071266968,empty,mBC-0716-1
"G3,F3",646894,701347,465180,236167,377443,1,204385,204638,163824,40814,4.013916793,110773,73813,52130,24744,10,24734,1,2315,0,0.001132045,mm10,mBC-0716-1
"G3,F4",755287,822487,531274,291213,445536,1,251105,251491,200855,50636,3.966644285,138223,30259,19471,9199,6,9193,1,1190,0,0.000435114,mm10,mBC-0716-1
"G3,F5",25475,26191,19530,6661,13685,0,6105,6116,4315,1801,2.395891172,2862,1872,1158,570,0,570,0,150,0,0.007017544,empty,mBC-0716-1
"G3,F6",1473075,1568370,1054838,513532,820168,2,448718,449457,358879,90578,3.962098964,239124,142715,97320,46303,19,46284,2,3365,0,0.000496932,mm10,mBC-0716-1
"G3,F7",653161,686485,484078,202407,375149,2,191708,192031,143095,48936,2.924125388,97902,33898,12347,6067,8,6059,3,962,0,0.008582274,mm10,mBC-0716-1
"G3,F8",23741,24353,18016,6337,12861,1,5906,5917,4107,1810,2.269060773,2800,215,136,74,0,74,0,34,0,0.094594595,empty,mBC-0716-1
"G3,F9",16873,17027,12758,4269,9334,0,4308,4322,3110,1212,2.566006601,2001,3060,1701,843,0,843,0,231,0,0.020166074,empty,mBC-0716-1
"G3,F10",21955,22501,16886,5615,11755,0,5199,5213,3610,1603,2.252027449,2450,1109,682,355,0,355,0,108,0,0.061971831,empty,mBC-0716-1
"G3,F11",712557,749976,533482,216494,400189,0,193411,193721,154085,39636,3.887501261,97963,107224,72112,35069,16,35053,3,2647,0,0.000256754,mm10,mBC-0716-1
"G3,F12",14452,14470,11051,3419,7747,0,3425,3433,2376,1057,2.247871334,1558,72,46,31,0,31,0,14,0,0,empty,mBC-0716-1
"G3,G1",10855,11085,8357,2728,5887,1,2598,2607,1763,844,2.088862559,1197,1813,1209,611,0,611,0,159,0,0.027823241,empty,mBC-0716-1
"G3,G2",21869,21831,16698,5133,11427,0,5002,5015,3509,1506,2.33001328,2263,509,285,147,0,147,0,40,0,0,empty,mBC-0716-1
"G3,G3",20615,21240,15658,5582,11236,0,5091,5103,3561,1542,2.309338521,2431,11366,3785,1941,2,1939,1,367,0,0.100567303,empty,mBC-0716-1
"G3,G4",30221,30539,23155,7384,16081,0,6866,6871,4866,2005,2.426932668,3134,85,48,30,0,30,0,18,0,0,empty,mBC-0716-1
"G3,G5",14398,14811,10961,3850,7781,0,3557,3564,2441,1123,2.17364203,1691,1239,785,414,0,414,0,109,0,0.014492754,empty,mBC-0716-1
"G3,G6",28328,28312,21028,7284,15114,0,6819,6828,4830,1998,2.417417417,3238,1427,471,255,0,255,0,73,0,0.211764706,empty,mBC-0716-1
"G3,G7",21089,21645,16377,5268,11449,0,5034,5044,3494,1550,2.254193548,2345,1482,914,454,0,454,0,137,0,0.063876652,empty,mBC-0716-1
"G3,G8",16195,16514,11844,4670,9075,0,4272,4287,2977,1310,2.272519084,2098,13808,5174,2645,3,2642,1,495,0,0.0999243,empty,mBC-0716-1
"G3,G9",11192,11451,8623,2828,6205,0,2802,2813,1942,871,2.229621125,1322,982,629,334,0,334,0,109,0,0.098802395,empty,mBC-0716-1
"G3,G10",14293,14487,11017,3470,7678,0,3360,3368,2300,1068,2.153558052,1520,1109,717,403,0,403,0,119,0,0.124069479,empty,mBC-0716-1
"G3,G11",14063,14088,10594,3494,7653,0,3455,3474,2527,947,2.66842661,1659,886,658,324,0,324,0,86,0,0.052469136,empty,mBC-0716-1
"G3,G12",12195,12428,9106,3322,6723,0,3071,3076,2172,904,2.402654867,1533,1641,912,427,0,427,0,110,0,0.103044496,empty,mBC-0716-1
"G3,H1",22121,22552,16943,5609,12244,0,5510,5521,3916,1605,2.439875389,2553,1102,718,346,0,346,0,97,0,0.052023121,empty,mBC-0716-1
"G3,H2",37331,39463,28051,11412,20685,0,10258,10284,7174,3110,2.306752412,5144,6568,2834,1442,0,1442,0,270,0,0.025658807,empty,mBC-0716-1
"G3,H3",21366,22012,15924,6088,11580,0,5449,5465,3816,1649,2.314129776,2656,19970,6547,3256,4,3252,2,515,0,0.080258303,empty,mBC-0716-1
"G3,H4",14568,15019,11023,3996,7921,0,3646,3650,2499,1151,2.171155517,1812,78,52,32,0,32,0,16,0,0.3125,empty,mBC-0716-1
"G3,H5",1961384,2203734,1355090,848644,1131040,3,672329,673317,537040,136277,3.940797053,384812,113668,78901,37279,9,37270,1,2973,0,0.002012342,mm10,mBC-0716-1
"G3,H6",15546,15925,11795,4130,8398,0,3877,3880,2714,1166,2.32761578,1840,1622,1070,549,0,549,0,150,0,0.083788707,empty,mBC-0716-1
"G3,H7",18310,18530,13803,4727,9954,0,4520,4527,3206,1321,2.426949281,2109,4085,1847,942,0,942,0,201,0,0.231422505,empty,mBC-0716-1
"G3,H8",14578,14757,11022,3735,7999,0,3697,3713,2611,1102,2.369328494,1791,1764,1118,560,0,560,0,146,0,0.017857143,empty,mBC-0716-1
"G3,H9",657747,713301,458812,254489,385771,0,221916,222227,162244,59983,2.704833036,122191,26975,16656,8197,4,8193,1,1139,0,0.012937874,mm10,mBC-0716-1
"G3,H10",578351,603964,425807,178157,326568,0,167198,167443,122980,44463,2.765895239,85688,19152,10039,4862,7,4855,4,811,0,0.009474768,mm10,mBC-0716-1
"G3,H11",17858,18376,13381,4995,9759,0,4461,4478,3136,1342,2.33681073,2131,216,103,66,0,66,0,33,0,0,empty,mBC-0716-1
"G3,H12",6483,6578,4843,1735,3468,0,1583,1585,1134,451,2.514412417,744,737,447,232,0,232,0,70,0,0.004310345,empty,mBC-0716-1
"G4,A1",16522,17480,12404,5076,9310,0,4372,4382,3080,1302,2.365591398,2193,1127,726,360,0,360,0,98,0,0.063888889,empty,mBC-0716-1
"G4,A2",21281,21415,16276,5139,11245,0,4810,4826,3401,1425,2.386666667,2212,1188,759,385,0,385,0,115,0,0.077922078,empty,mBC-0716-1
"G4,A3",18481,19287,13815,5472,10164,0,4812,4823,3359,1464,2.294398907,2403,10813,3578,1779,4,1775,1,311,0,0.073239437,empty,mBC-0716-1
"G4,A4",834332,901814,617410,284404,473260,2,249511,249857,180121,69736,2.58289836,130912,21448,14762,7028,3,7025,1,957,0,0.000711744,mm10,mBC-0716-1
"G4,A5",17926,18758,13671,5087,9979,3,4580,4597,3169,1428,2.219187675,2287,4788,1857,923,2,921,1,209,0,0.095548317,empty,mBC-0716-1
"G4,A6",14221,14620,10871,3749,7876,0,3673,3676,2582,1094,2.360146252,1750,1533,880,428,0,428,0,122,0,0.063084112,empty,mBC-0716-1
"G4,A7",17005,17785,12903,4882,9477,0,4441,4455,3151,1304,2.416411043,2190,1091,727,380,0,380,0,121,0,0.081578947,empty,mBC-0716-1
"G4,A8",11346,11632,8602,3030,6307,0,2894,2896,2038,858,2.375291375,1398,5311,2089,1033,0,1033,0,221,0,0.021297193,empty,mBC-0716-1
"G4,A9",19679,19954,14969,4985,10433,0,4647,4661,3335,1326,2.515082956,2182,1162,748,359,0,359,0,97,0,0.072423398,empty,mBC-0716-1
"G4,A10",18937,19663,14423,5240,10338,0,4896,4903,3433,1470,2.33537415,2315,368,214,106,0,106,0,40,0,0,empty,mBC-0716-1
"G4,A11",19498,19844,14998,4846,10528,0,4610,4621,3215,1406,2.286628734,2142,1535,830,403,0,403,0,108,0,0.049627792,empty,mBC-0716-1
"G4,A12",21631,22226,16681,5545,11595,0,5102,5110,3559,1551,2.294648614,2441,2365,1497,765,2,763,1,155,0,0.077326343,empty,mBC-0716-1
"G4,B1",20001,20560,15455,5105,10736,0,4753,4775,3373,1402,2.405848787,2271,1129,706,345,0,345,0,95,0,0.07826087,empty,mBC-0716-1
"G4,B2",21231,21585,16221,5364,11331,0,4991,5003,3469,1534,2.261408083,2284,543,353,194,0,194,0,67,0,0.056701031,empty,mBC-0716-1
"G4,B3",931052,1063768,640477,423291,559816,0,341471,341914,253430,88484,2.864133629,196621,59847,35338,16772,13,16759,3,1793,0,0.006921654,mm10,mBC-0716-1
"G4,B4",782624,835762,573786,261976,444769,0,233942,234300,165917,68383,2.42629016,124115,19423,10907,5378,2,5376,2,947,0,0.008556548,mm10,mBC-0716-1
"G4,B5",14201,10493,7622,2871,6716,0,3187,3200,2244,956,2.347280335,1645,1870,876,441,0,441,0,97,0,0.111111111,empty,mBC-0716-1
"G4,B6",13219,14028,9947,4081,7261,0,3421,3426,2402,1024,2.345703125,1706,1530,861,439,2,437,2,103,0,0.112128146,empty,mBC-0716-1
"G4,B7",17050,17689,13152,4537,9332,0,4188,4199,2912,1287,2.262626263,2002,963,578,283,0,283,0,72,0,0.053003534,empty,mBC-0716-1
"G4,B8",13879,14417,10722,3695,7549,0,3428,3432,2394,1038,2.306358382,1620,893,525,259,0,259,0,98,0,0.038610039,empty,mBC-0716-1
"G4,B9",15527,15723,11970,3753,8284,0,3614,3618,2502,1116,2.241935484,1667,561,353,165,0,165,0,62,0,0.036363636,empty,mBC-0716-1
"G4,B10",17932,17207,13117,4090,9494,0,4132,4149,2891,1258,2.29809221,1922,513,286,141,0,141,0,47,0,0.035460993,empty,mBC-0716-1
"G4,B11",1423725,1473348,1067634,405714,760556,1,374750,375387,294609,80778,3.647144024,185773,10879,6651,3177,3,3174,1,554,0,0.006616257,mm10,mBC-0716-1
"G4,B12",19134,20195,14605,5590,10467,0,4843,4855,3415,1440,2.371527778,2375,2220,989,473,2,471,1,128,0,0.044585987,empty,mBC-0716-1
"G4,C1",23252,23514,18045,5469,12298,0,5209,5223,3657,1566,2.335249042,2430,1869,635,314,0,314,0,86,0,0.063694268,empty,mBC-0716-1
"G4,C2",21504,22045,16172,5873,11646,0,5360,5371,3796,1575,2.41015873,2566,1824,1172,580,0,580,0,160,0,0.044827586,empty,mBC-0716-1
"G4,C3",21231,22009,16120,5889,11762,0,5456,5473,3810,1663,2.291040289,2711,562,356,191,0,191,0,51,0,0,empty,mBC-0716-1
"G4,C4",19616,19854,14968,4886,10518,0,4689,4708,3375,1333,2.531882971,2196,2655,1248,636,0,636,0,159,0,0.044025157,empty,mBC-0716-1
"G4,C5",18978,19522,14494,5028,10338,0,4727,4736,3388,1348,2.513353116,2229,1169,682,314,0,314,0,101,0,0.044585987,empty,mBC-0716-1
"G4,C6",18740,19132,14204,4928,10524,0,4879,4894,3497,1397,2.503221188,2376,1382,870,387,1,386,1,113,0,0.064766839,empty,mBC-0716-1
"G4,C7",17998,18537,13567,4970,9813,0,4555,4568,3144,1424,2.207865169,2235,1576,604,312,0,312,0,83,0,0.051282051,empty,mBC-0716-1
"G4,C8",15945,16320,11985,4335,8850,0,4101,4121,2857,1264,2.26028481,1996,1761,1071,552,0,552,0,140,0,0.063405797,empty,mBC-0716-1
"G4,C9",667528,694329,506693,187636,366367,0,173158,173504,117262,56242,2.084954305,87752,9017,6326,3088,1,3087,1,523,0,0.006154843,mm10,mBC-0716-1
"G4,C10",14587,15169,11069,4100,7975,0,3629,3638,2558,1080,2.368518519,1758,7797,2481,1258,0,1258,0,222,0,0.054848967,empty,mBC-0716-1
"G4,C11",11980,12311,9209,3102,6674,0,3188,3188,2169,1019,2.128557409,1508,897,586,272,0,272,0,80,0,0.003676471,empty,mBC-0716-1
"G4,C12",700345,688978,553408,135570,362451,1,140602,140934,110140,30794,3.57667078,63507,2234,1342,651,0,651,0,196,0,0.058371736,empty,mBC-0716-1
"G4,D1",13316,13996,10046,3950,7578,0,3692,3696,2571,1125,2.285333333,1826,572,400,221,0,221,0,59,0,0.067873303,empty,mBC-0716-1
"G4,D2",21569,21826,16735,5091,11497,0,4841,4848,3454,1394,2.477761836,2203,7758,3022,1563,0,1563,0,298,0,0.046705054,empty,mBC-0716-1
"G4,D3",15092,15665,11376,4289,8389,0,3906,3921,2780,1141,2.436459246,1908,2455,1158,612,0,612,0,130,0,0.111111111,empty,mBC-0716-1
"G4,D4",2400293,2800927,1586156,1214771,1444853,2,967442,968693,647997,320696,2.020595829,574077,117929,79578,37508,11,37497,2,3198,0,0.005973811,mm10,mBC-0716-1
"G4,D5",675733,727872,491067,236805,388624,2,206462,206741,174995,31746,5.512348012,109061,83614,58602,28554,12,28542,1,2324,0,0.00063065,mm10,mBC-0716-1
"G4,D6",783713,864387,558580,305807,456234,0,256999,257414,220069,37345,5.892863837,140598,60705,42565,20648,11,20637,2,1938,0,0.013422494,mm10,mBC-0716-1
"G4,D7",664106,695880,493645,202235,369461,1,181525,181858,150453,31405,4.79073396,92266,126571,88235,42133,15,42118,2,3102,0,0.000830999,mm10,mBC-0716-1
"G4,D8",17616,18096,13332,4764,9799,0,4496,4501,3155,1346,2.343982169,2239,793,469,257,0,257,0,96,0,0.035019455,empty,mBC-0716-1
"G4,D9",6826,6981,5019,1962,3880,0,1883,1885,1349,536,2.516791045,925,1350,830,391,0,391,0,126,0,0.071611253,empty,mBC-0716-1
"G4,D10",16476,17753,12368,5385,9522,0,4710,4720,3403,1317,2.583902809,2481,1019,688,342,0,342,0,95,0,0.105263158,empty,mBC-0716-1
"G4,D11",14001,14665,10749,3916,7787,0,3585,3597,2570,1027,2.502434275,1732,9947,3370,1699,0,1699,0,305,0,0.015303119,empty,mBC-0716-1
"G4,D12",621967,664416,452259,212157,356210,1,193460,193752,149868,43884,3.41509434,102343,36953,26320,12683,5,12678,2,1569,0,0.004890361,mm10,mBC-0716-1
"G4,E1",23125,23931,17855,6076,12753,0,5620,5633,3942,1691,2.331164991,2688,1399,828,426,0,426,0,146,0,0.082159624,empty,mBC-0716-1
"G4,E2",17955,18316,13918,4398,9556,1,4265,4277,3050,1227,2.485737571,1886,1090,592,306,0,306,0,114,0,0.068627451,empty,mBC-0716-1
"G4,E3",13343,13663,10228,3435,7120,0,3219,3220,2292,928,2.469827586,1470,1548,959,513,0,513,0,136,0,0.07797271,empty,mBC-0716-1
"G4,E4",16159,16694,12356,4338,8596,1,3924,3933,2826,1107,2.552845528,1864,1114,744,408,0,408,0,120,0,0.06127451,empty,mBC-0716-1
"G4,E5",21573,22039,16556,5483,11657,0,5174,5180,3676,1504,2.444148936,2449,1509,835,417,0,417,0,125,0,0.112709832,empty,mBC-0716-1
"G4,E6",16391,16809,12563,4246,8870,1,3930,3946,2771,1175,2.358297872,1913,1512,944,469,0,469,0,115,0,0.059701493,empty,mBC-0716-1
"G4,E7",14535,14830,11199,3631,8042,0,3632,3643,2511,1132,2.21819788,1726,1556,883,445,0,445,0,117,0,0.056179775,empty,mBC-0716-1
"G4,E8",18366,18736,14115,4621,9989,0,4518,4523,3194,1329,2.40331076,2100,1777,1127,527,0,527,0,160,0,0.036053131,empty,mBC-0716-1
"G4,E9",10459,10683,7942,2741,5693,0,2621,2624,1804,820,2.2,1205,1613,913,480,0,480,0,116,0,0.158333333,empty,mBC-0716-1
"G4,E10",13679,14144,10445,3699,7575,0,3497,3503,2393,1110,2.155855856,1678,1141,669,309,0,309,0,87,0,0.03236246,empty,mBC-0716-1
"G4,E11",10252,10614,7870,2744,5633,0,2484,2492,1699,793,2.142496847,1150,965,650,331,0,331,0,89,0,0.090634441,empty,mBC-0716-1
"G4,E12",16606,17188,12490,4698,9318,0,4462,4471,3134,1337,2.344053852,2189,835,522,254,0,254,0,97,0,0.094488189,empty,mBC-0716-1
"G4,F1",18294,18784,14098,4686,10034,0,4470,4477,3157,1320,2.391666667,2172,1278,792,388,0,388,0,102,0,0.074742268,empty,mBC-0716-1
"G4,F2",23620,24915,17911,7004,13181,0,6104,6109,4347,1762,2.46708286,3024,2295,1602,802,0,802,0,195,0,0.056109726,empty,mBC-0716-1
"G4,F3",17720,18746,13254,5492,10022,0,4828,4830,3402,1428,2.382352941,2475,2356,1364,668,0,668,0,171,0,0.034431138,empty,mBC-0716-1
"G4,F4",19809,20589,14915,5674,11070,0,5174,5184,3669,1515,2.421782178,2562,348,210,130,0,130,0,54,0,0,empty,mBC-0716-1
"G4,F5",893079,944467,664008,280459,490310,3,239556,240001,203677,36324,5.60722938,122004,201553,138446,64996,21,64975,1,3930,0,0.000461716,mm10,mBC-0716-1
"G4,F6",25911,26746,19899,6847,14005,0,6372,6393,4558,1835,2.483923706,3056,2143,1245,603,0,603,0,166,0,0.053067993,empty,mBC-0716-1
"G4,F7",21200,21250,16213,5037,11450,0,5063,5079,3566,1513,2.356906808,2287,1066,638,314,0,314,0,86,0,0.054140127,empty,mBC-0716-1
"G4,F8",24189,24764,18479,6285,13211,0,6083,6094,4302,1792,2.400669643,2881,220,153,84,0,84,0,42,0,0,empty,mBC-0716-1
"G4,F9",16646,17070,12813,4257,9120,0,4097,4102,2950,1152,2.560763889,1982,1677,1154,575,1,574,1,151,0,0.069686411,empty,mBC-0716-1
"G4,F10",21193,21642,16347,5295,11358,0,4991,4998,3526,1472,2.395380435,2334,1179,733,356,0,356,0,104,0,0.036516854,empty,mBC-0716-1
"G4,F11",12190,12590,9450,3140,6653,0,2989,2997,2115,882,2.397959184,1420,2070,983,541,1,540,1,124,0,0.064814815,empty,mBC-0716-1
"G4,F12",14559,15019,11092,3927,7895,0,3547,3550,2488,1062,2.342749529,1777,74,49,28,0,28,0,14,0,0,empty,mBC-0716-1
"G4,G1",10516,10783,8102,2681,5751,0,2479,2487,1682,805,2.089440994,1175,2493,1592,726,0,726,0,182,0,0.049586777,empty,mBC-0716-1
"G4,G2",21864,22487,16995,5492,11600,0,5163,5176,3663,1513,2.421017845,2380,1439,674,360,0,360,0,80,0,0.038888889,empty,mBC-0716-1
"G4,G3",23152,24220,17963,6257,12657,0,5778,5787,4135,1652,2.503026634,2731,1766,1088,558,0,558,0,154,0,0.098566308,empty,mBC-0716-1
"G4,G4",29938,30128,22950,7178,15778,0,6855,6873,4908,1965,2.497709924,3203,156,69,46,0,46,0,22,0,0.260869565,empty,mBC-0716-1
"G4,G5",14083,14759,10648,4111,7795,0,3552,3559,2444,1115,2.191928251,1764,1131,696,340,0,340,0,89,0,0.067647059,empty,mBC-0716-1
"G4,G6",4842332,5420171,3303398,2116773,2656865,2,1725515,1727790,1314746,413044,3.183065242,978210,23106,16459,8027,3,8024,1,1098,0,0.001744766,mm10,mBC-0716-1
"G4,G7",21169,21600,16109,5491,11411,0,5018,5024,3473,1551,2.239200516,2368,21483,7048,3525,2,3523,1,560,0,0.036332671,empty,mBC-0716-1
"G4,G8",15551,15904,11668,4236,8433,0,3976,3982,2867,1115,2.571300448,1962,1245,841,431,0,431,0,131,0,0.039443155,empty,mBC-0716-1
"G4,G9",12873,13479,9712,3767,7144,0,3369,3371,2413,958,2.518789144,1646,1704,1094,531,1,530,1,141,0,0.011320755,empty,mBC-0716-1
"G4,G10",14421,14500,10988,3512,7711,1,3434,3447,2438,1009,2.416253717,1591,1133,693,368,0,368,0,110,0,0.070652174,empty,mBC-0716-1
"G4,G11",13733,14284,10648,3636,7460,0,3332,3335,2315,1020,2.269607843,1585,664,468,251,0,251,0,90,0,0.023904382,empty,mBC-0716-1
"G4,G12",12634,13180,9537,3643,6850,0,3174,3182,2207,975,2.263589744,1550,2618,1214,609,0,609,0,121,0,0.159277504,empty,mBC-0716-1
"G4,H1",936728,1091231,625881,465350,575275,0,370716,371205,289060,82145,3.518899507,219582,71561,48340,23228,14,23214,2,2112,0,0.003446196,mm10,mBC-0716-1
"G4,H2",24911,25576,19108,6468,13438,0,5959,5973,4227,1746,2.420962199,2870,5517,2198,1057,1,1056,1,236,0,0.050189394,empty,mBC-0716-1
"G4,H3",677934,711066,485261,225805,380037,3,206227,206568,153014,53554,2.857190873,108531,7194,4854,2262,0,2262,0,504,0,0.019893899,mm10,mBC-0716-1
"G4,H4",14985,15178,11363,3815,8054,0,3695,3707,2604,1103,2.360834089,1744,80,42,26,0,26,0,18,0,0,empty,mBC-0716-1
"G4,H5",19622,20488,14852,5636,10956,0,5160,5176,3662,1514,2.418758256,2573,3343,1376,655,0,655,0,158,0,0.041221374,empty,mBC-0716-1
"G4,H6",16749,17270,12637,4633,9227,0,4254,4265,3050,1215,2.510288066,2063,3936,1728,804,1,803,1,194,0,0.124533001,empty,mBC-0716-1
"G4,H7",806901,863395,585905,277490,458622,0,241918,242332,203605,38727,5.257443128,127884,108177,70556,33722,13,33709,2,2893,0,0.003114895,mm10,mBC-0716-1
"G4,H8",15174,15538,11577,3961,8232,0,3720,3723,2617,1106,2.366184448,1812,2207,1421,699,2,697,1,158,0,0.032998565,empty,mBC-0716-1
"G4,H9",17947,18521,13644,4877,9827,0,4501,4511,3166,1345,2.353903346,2104,1049,608,334,1,333,1,109,0,0.057057057,empty,mBC-0716-1
"G4,H10",15926,16199,12044,4155,8653,0,3922,3932,2789,1143,2.440069991,1865,1143,779,361,0,361,0,110,0,0.060941828,empty,mBC-0716-1
"G4,H11",18920,19730,14264,5466,10546,0,4954,4965,3390,1575,2.152380952,2484,185,119,64,0,64,0,38,0,0.0625,empty,mBC-0716-1
"G4,H12",7290,7488,5656,1832,3967,0,1757,1760,1271,489,2.599182004,851,861,501,259,0,259,0,66,0,0.11969112,empty,mBC-0716-1
"G5,A1",15432,16248,11525,4723,8849,0,4250,4258,2993,1265,2.366007905,2162,1039,612,291,0,291,0,88,0,0.065292096,empty,mBC-0716-1
"G5,A2",20220,20769,15427,5342,11003,0,4887,4903,3483,1420,2.452816901,2369,965,651,344,0,344,0,120,0,0,empty,mBC-0716-1
"G5,A3",17530,18279,13340,4939,9631,0,4518,4531,3216,1315,2.445627376,2212,2613,1067,523,0,523,0,126,0,0.038240918,empty,mBC-0716-1
"G5,A4",21359,21678,16538,5140,11409,0,5000,5011,3529,1482,2.381241565,2325,1910,644,351,0,351,0,70,0,0.025641026,empty,mBC-0716-1
"G5,A5",17737,18440,13683,4757,9701,0,4459,4466,3126,1340,2.332835821,2093,1371,843,432,0,432,0,117,0,0.034722222,empty,mBC-0716-1
"G5,A6",604775,663119,437739,225380,352362,0,192267,192562,144185,48377,2.980445253,103735,82192,56421,27624,16,27608,3,2428,0,0.003513474,mm10,mBC-0716-1
"G5,A7",17011,17976,13059,4917,9495,0,4443,4465,3086,1379,2.237853517,2194,1149,786,362,0,362,0,112,0,0.016574586,empty,mBC-0716-1
"G5,A8",190436,189226,143856,45370,104907,1,46039,46119,35970,10149,3.544191546,21804,9808,5965,2890,3,2887,1,587,0,0.011430551,empty,mBC-0716-1
"G5,A9",1003929,1036486,731424,305062,536196,1,278461,278986,221316,57670,3.837627883,140060,23182,14056,6761,2,6759,1,1002,0,0.003994674,mm10,mBC-0716-1
"G5,A10",16302,16811,12305,4506,8915,0,4041,4049,2843,1206,2.357379768,1978,1318,479,221,0,221,0,67,0,0,empty,mBC-0716-1
"G5,A11",18656,19068,14119,4949,10187,0,4643,4649,3246,1403,2.313613685,2196,1142,733,363,0,363,0,93,0,0.085399449,empty,mBC-0716-1
"G5,A12",21041,21776,16044,5732,11281,0,5018,5037,3459,1578,2.192015209,2403,2398,1692,820,0,820,0,172,0,0.063414634,empty,mBC-0716-1
"G5,B1",635504,667231,485665,181566,352474,1,161863,162171,137600,24571,5.600097676,80182,46303,32796,15542,6,15536,1,1729,0,0.001222966,mm10,mBC-0716-1
"G5,B2",20693,21066,15641,5425,10912,0,4821,4827,3409,1418,2.404090268,2282,418,224,125,0,125,0,52,0,0.104,empty,mBC-0716-1
"G5,B3",903580,974501,652586,321915,510569,1,275888,276266,233526,42740,5.463874591,146476,55780,39870,19164,8,19156,1,1969,0,0.001879307,mm10,mBC-0716-1
"G5,B4",17147,17379,13126,4253,9197,0,4081,4090,2861,1229,2.327908869,1881,841,591,328,0,328,0,100,0,0.054878049,empty,mBC-0716-1
"G5,B5",15333,12542,8382,4160,7705,1,3902,3917,2974,943,3.153764581,2131,775,569,260,0,260,0,75,0,0.023076923,empty,mBC-0716-1
"G5,B6",12250,12887,9185,3702,6897,0,3289,3290,2309,981,2.353720693,1691,1149,685,314,0,314,0,87,0,0.070063694,empty,mBC-0716-1
"G5,B7",16138,16624,12629,3995,8794,0,3863,3873,2696,1177,2.290569244,1813,836,559,287,0,287,0,86,0,0.076655052,empty,mBC-0716-1
"G5,B8",726732,828699,500075,328624,438969,2,268345,268682,214293,54389,3.940006251,152873,65338,46683,22442,3,22439,1,2100,0,0.000891305,mm10,mBC-0716-1
"G5,B9",14852,15145,11306,3839,7952,0,3481,3491,2395,1096,2.185218978,1649,487,285,132,0,132,0,43,0,0.053030303,empty,mBC-0716-1
"G5,B10",17553,17201,12552,4649,9551,0,4484,4513,3140,1373,2.286962855,2228,413,207,106,0,106,0,43,0,0,empty,mBC-0716-1
"G5,B11",16884,17730,12837,4893,9472,0,4433,4444,3140,1304,2.40797546,2229,159,119,78,0,78,0,33,0,0,empty,mBC-0716-1
"G5,B12",18839,19740,14347,5393,10430,0,4782,4790,3354,1436,2.335654596,2370,1150,658,294,0,294,0,102,0,0.057823129,empty,mBC-0716-1
"G5,C1",22128,22321,17311,5010,11554,0,4845,4850,3439,1411,2.437278526,2165,726,332,189,0,189,0,70,0,0.015873016,empty,mBC-0716-1
"G5,C2",20899,21790,15766,6024,11386,0,5448,5454,3869,1585,2.441009464,2672,1701,1136,528,1,527,1,148,0,0.024667932,empty,mBC-0716-1
"G5,C3",21070,21434,15943,5491,11118,0,5108,5124,3603,1521,2.368836292,2414,557,393,189,0,189,0,57,0,0,empty,mBC-0716-1
"G5,C4",529902,541189,397586,143603,291400,1,136587,136824,105945,30879,3.430972506,66980,17968,11174,5362,0,5362,0,837,0,0.003729952,mm10,mBC-0716-1
"G5,C5",17947,18346,13581,4765,9706,0,4469,4477,3085,1392,2.216235632,2176,950,544,265,0,265,0,86,0,0.049056604,empty,mBC-0716-1
"G5,C6",18190,18508,13802,4706,10301,0,4764,4777,3429,1348,2.543768546,2324,1052,661,319,0,319,0,103,0,0.028213166,empty,mBC-0716-1
"G5,C7",16619,17488,12478,5010,9383,0,4509,4513,3142,1371,2.291757841,2268,238,151,88,0,88,0,46,0,0.056818182,empty,mBC-0716-1
"G5,C8",15899,16387,11938,4449,8752,0,4030,4041,2839,1202,2.361896839,1972,1663,1005,529,0,529,0,142,0,0.088846881,empty,mBC-0716-1
"G5,C9",655647,715779,469590,246189,381838,3,209872,210156,169291,40865,4.142689343,114520,44865,28099,13310,8,13302,1,1497,0,0.003909187,mm10,mBC-0716-1
"G5,C10",14079,14664,10753,3911,7648,0,3436,3442,2389,1053,2.268755935,1661,3649,1546,768,1,767,1,155,0,0.033898305,empty,mBC-0716-1
"G5,C11",12645,13058,9261,3797,6619,0,3195,3198,2291,907,2.525909592,1538,27207,7581,3893,3,3890,2,601,0,0.096401028,empty,mBC-0716-1
"G5,C12",20464,21171,15589,5582,11166,0,5086,5097,3575,1522,2.348883049,2446,1243,793,355,0,355,0,84,0,0.011267606,empty,mBC-0716-1
"G5,D1",608480,656973,422703,234270,351715,1,199550,199825,153192,46633,3.285055647,109346,18323,12478,5858,1,5857,1,923,0,0.004268397,mm10,mBC-0716-1
"G5,D2",838295,905279,614647,290632,474592,0,250020,250427,209100,41327,5.059646236,130486,249531,174693,82525,35,82490,3,4349,0,0.000824342,mm10,mBC-0716-1
"G5,D3",1142039,1263526,821890,441636,672734,1,375265,375882,279661,96221,2.906444539,206813,81037,58552,28160,10,28150,1,2538,0,0.00053286,mm10,mBC-0716-1
"G5,D4",844679,923047,601440,321607,485299,1,281924,282289,209285,73004,2.866760725,151842,26218,18254,8800,6,8794,1,1175,0,0.003411417,mm10,mBC-0716-1
"G5,D5",14798,15247,11167,4080,8093,0,3694,3700,2603,1097,2.372835005,1795,2839,1173,575,1,574,1,140,0,0.040069686,empty,mBC-0716-1
"G5,D6",12794,13548,9711,3837,7223,0,3461,3467,2389,1078,2.216141002,1727,921,575,293,0,293,0,105,0,0.040955631,empty,mBC-0716-1
"G5,D7",14084,14531,10573,3958,7636,0,3548,3552,2524,1028,2.455252918,1684,1327,824,395,0,395,0,139,0,0.010126582,empty,mBC-0716-1
"G5,D8",16582,17067,12628,4439,9113,0,4281,4288,2998,1290,2.324031008,2045,797,483,249,0,249,0,81,0,0.112449799,empty,mBC-0716-1
"G5,D9",6269,6504,4498,2006,3556,0,1775,1778,1304,474,2.751054852,921,1174,671,308,0,308,0,88,0,0.029220779,empty,mBC-0716-1
"G5,D10",15186,15698,11620,4078,8408,0,3915,3925,2748,1177,2.334749363,1828,1637,705,352,0,352,0,95,0,0.076704545,empty,mBC-0716-1
"G5,D11",17549,18052,13617,4435,9625,0,4298,4304,3009,1295,2.323552124,1970,1408,914,460,0,460,0,127,0,0.036956522,empty,mBC-0716-1
"G5,D12",20573,21418,15680,5738,11401,0,5222,5228,3657,1571,2.327816677,2523,2300,1418,736,2,734,1,181,0,0.072207084,empty,mBC-0716-1
"G5,E1",22709,23288,17406,5882,12228,0,5486,5495,3846,1649,2.33232262,2571,1451,907,430,0,430,0,131,0,0.051162791,empty,mBC-0716-1
"G5,E2",16863,17309,12834,4475,9335,0,4209,4216,3009,1207,2.492957746,1997,2105,1108,547,0,547,0,166,0,0.096892139,empty,mBC-0716-1
"G5,E3",12564,12851,9725,3126,6812,0,3032,3041,2117,924,2.291125541,1413,1248,802,440,0,440,0,127,0,0.079545455,empty,mBC-0716-1
"G5,E4",15688,15814,11978,3836,8374,1,3672,3687,2534,1153,2.197745013,1736,1353,879,426,0,426,0,125,0,0.035211268,empty,mBC-0716-1
"G5,E5",2105042,2250401,1515868,734533,1151025,4,648622,649707,515675,134032,3.847402113,342844,81214,53763,25787,18,25769,2,2425,0,0.000698514,mm10,mBC-0716-1
"G5,E6",13929,14159,10684,3475,7514,0,3330,3339,2335,1004,2.325697211,1551,1184,666,366,2,364,1,94,0,0.054945055,empty,mBC-0716-1
"G5,E7",617230,641677,470775,170902,339643,0,155802,156090,131449,24641,5.334564344,76493,68014,48311,23285,14,23271,3,2156,0,0.001976709,mm10,mBC-0716-1
"G5,E8",18007,18187,14107,4080,9589,0,4023,4032,2866,1166,2.457975986,1796,1731,1092,553,0,553,0,154,0,0.08318264,empty,mBC-0716-1
"G5,E9",10021,10306,7576,2730,5558,0,2631,2635,1872,763,2.453473132,1245,926,637,328,0,328,0,96,0,0.039634146,empty,mBC-0716-1
"G5,E10",13066,13715,10036,3679,7361,0,3468,3471,2442,1029,2.373177843,1692,998,715,358,0,358,0,111,0,0.069832402,empty,mBC-0716-1
"G5,E11",9884,10378,7588,2790,5564,0,2615,2618,1814,804,2.256218905,1184,847,528,279,0,279,0,79,0,0.146953405,empty,mBC-0716-1
"G5,E12",1120595,1221519,786569,434950,648695,1,373347,373940,306217,67723,4.521610088,204512,88815,62222,30308,8,30300,1,2576,0,0.001947195,mm10,mBC-0716-1
"G5,F1",17944,18383,13778,4605,9706,0,4306,4318,3028,1290,2.347286822,2065,1286,801,405,0,405,0,114,0,0.012345679,empty,mBC-0716-1
"G5,F2",23049,24029,17474,6555,12683,0,5918,5929,4184,1745,2.397707736,2911,22238,7276,3663,4,3659,2,590,0,0.041814703,empty,mBC-0716-1
"G5,F3",894517,975452,638255,337197,510530,1,281334,281772,235449,46323,5.08276666,153042,111741,77921,37166,14,37152,1,2868,0,0.001265073,mm10,mBC-0716-1
"G5,F4",19150,19257,14153,5104,10502,0,4919,4937,3551,1386,2.562049062,2386,463,247,148,0,148,0,72,0,0,empty,mBC-0716-1
"G5,F5",689313,709082,513426,195656,374958,0,179734,180021,140896,39125,3.601175719,89708,19781,14055,6832,3,6829,1,1010,0,0.00541807,mm10,mBC-0716-1
"G5,F6",28193,29367,21321,8046,15274,0,7001,7020,5053,1967,2.568886629,3389,31365,9401,4682,7,4675,2,692,0,0.075721925,empty,mBC-0716-1
"G5,F7",20420,21298,15537,5761,11439,0,5147,5159,3607,1552,2.324097938,2533,970,613,324,0,324,0,93,0,0.077160494,empty,mBC-0716-1
"G5,F8",23194,23837,17732,6105,12695,0,5815,5830,4090,1740,2.350574713,2775,313,210,115,0,115,0,51,0,0,empty,mBC-0716-1
"G5,F9",877236,999800,581937,417863,526455,2,334332,334738,276972,57766,4.79472354,194183,163299,103077,49093,19,49074,3,3205,0,0.002649061,mm10,mBC-0716-1
"G5,F10",24520,25144,19069,6075,13166,0,5786,5794,4224,1570,2.69044586,2585,1352,742,364,0,364,0,101,0,0.027472527,empty,mBC-0716-1
"G5,F11",12060,12505,9259,3246,6561,0,2975,2980,2087,893,2.337066069,1433,858,549,275,0,275,0,81,0,0.029090909,empty,mBC-0716-1
"G5,F12",14314,14710,10783,3927,7845,0,3569,3577,2524,1053,2.396961064,1779,358,137,78,0,78,0,19,0,0.012820513,empty,mBC-0716-1
"G5,G1",9996,10455,7798,2657,5581,0,2435,2441,1632,809,2.017305315,1203,1398,905,424,0,424,0,113,0,0.014150943,empty,mBC-0716-1
"G5,G2",20849,21669,15990,5679,11384,0,5141,5157,3532,1625,2.173538462,2520,478,321,178,2,176,1,40,0,0,empty,mBC-0716-1
"G5,G3",21546,21839,16527,5312,11638,0,5304,5318,3797,1521,2.496383958,2453,1717,1107,571,1,570,1,161,0,0.029824561,empty,mBC-0716-1
"G5,G4",28715,29300,22266,7034,15431,0,6672,6678,4767,1911,2.494505495,3090,68,28,20,0,20,0,13,0,0,empty,mBC-0716-1
"G5,G5",14179,14757,10797,3960,7708,0,3473,3486,2488,998,2.492985972,1689,976,509,315,3,312,1,103,0,0.092948718,empty,mBC-0716-1
"G5,G6",906171,960933,665998,294935,501711,0,258328,258763,206213,52550,3.924129401,133780,5267,3343,1572,1,1571,1,316,0,0.001273074,mm10,mBC-0716-1
"G5,G7",20983,21246,16388,4858,11221,0,4955,4975,3511,1464,2.398224044,2210,1572,965,521,0,521,0,159,0,0.078694818,empty,mBC-0716-1
"G5,G8",14901,15231,11259,3972,8136,0,3728,3735,2638,1097,2.404740201,1816,1246,795,407,0,407,0,114,0,0.012285012,empty,mBC-0716-1
"G5,G9",11016,11317,8293,3024,5933,0,2701,2708,1924,784,2.454081633,1316,924,595,291,1,290,1,107,0,0.051724138,empty,mBC-0716-1
"G5,G10",14189,14657,10641,4016,7688,0,3528,3545,2530,1015,2.492610837,1713,5525,2347,1238,0,1238,0,218,0,0.251211632,empty,mBC-0716-1
"G5,G11",12712,13004,9695,3309,6921,0,3176,3183,2234,949,2.354056902,1503,630,396,224,1,223,1,84,0,0.004484305,empty,mBC-0716-1
"G5,G12",12004,12471,9186,3285,6681,0,3048,3057,2140,917,2.333696838,1400,967,570,312,1,311,1,103,0,0.019292605,empty,mBC-0716-1
"G5,H1",608382,648521,437457,211064,346991,0,186218,186480,146397,40083,3.652346381,99192,17343,10615,5144,2,5142,1,819,0,0.005445352,mm10,mBC-0716-1
"G5,H2",26508,27298,20011,7287,14448,0,6819,6840,4861,1979,2.456291056,3327,1389,963,459,0,459,0,141,0,0.061002179,empty,mBC-0716-1
"G5,H3",20984,21339,15868,5471,11290,0,5207,5225,3618,1607,2.251400124,2497,2252,979,530,0,530,0,127,0,0.022641509,empty,mBC-0716-1
"G5,H4",14749,14970,11100,3870,8004,0,3638,3644,2544,1100,2.312727273,1745,181,79,46,0,46,0,28,0,0,empty,mBC-0716-1
"G5,H5",843393,964512,567475,397037,508939,1,328087,328513,247548,80965,3.057469277,191037,12143,8000,3805,1,3804,1,652,0,0.008412198,mm10,mBC-0716-1
"G5,H6",16151,16641,12360,4281,8827,0,4085,4097,2924,1173,2.492753623,1957,1215,763,398,0,398,0,126,0,0.025125628,empty,mBC-0716-1
"G5,H7",18906,19590,14176,5414,10367,0,4840,4846,3538,1308,2.704892966,2333,3345,1459,741,1,740,1,186,0,0.041891892,empty,mBC-0716-1
"G5,H8",475746,498633,353436,145197,268419,1,136503,136713,104824,31889,3.28715231,69411,23229,11573,5559,2,5557,1,882,0,0.038509987,mm10,mBC-0716-1
"G5,H9",792948,900956,522154,378802,476909,0,303699,304114,220976,83138,2.657942217,178766,58170,39249,18782,4,18778,1,1937,0,0.002556183,mm10,mBC-0716-1
"G5,H10",15520,16016,11610,4406,8589,0,4013,4022,2887,1135,2.543612335,1969,993,607,302,0,302,0,96,0,0.036423841,empty,mBC-0716-1
"G5,H11",18241,18847,13648,5199,10160,0,4855,4863,3381,1482,2.281376518,2365,1589,426,215,1,214,1,54,0,0.051401869,empty,mBC-0716-1
"G5,H12",6793,7037,5144,1893,3740,0,1747,1751,1245,506,2.460474308,829,687,381,203,1,202,1,57,0,0.089108911,empty,mBC-0716-1
"G6,A1",15633,15936,11877,4059,8681,0,4020,4034,2869,1165,2.462660944,1922,1101,693,368,0,368,0,116,0,0.032608696,empty,mBC-0716-1
"G6,A2",20506,20858,15816,5042,10967,0,4797,4809,3398,1411,2.40822112,2214,1052,674,340,0,340,0,124,0,0.091176471,empty,mBC-0716-1
"G6,A3",17870,18406,13749,4657,9780,0,4477,4488,3136,1352,2.319526627,2134,1091,737,436,0,436,0,122,0,0.084862385,empty,mBC-0716-1
"G6,A4",858400,926152,632808,293344,485430,1,247237,247652,214868,32784,6.554050756,129485,40349,25362,11765,7,11758,1,1382,0,0.001956115,mm10,mBC-0716-1
"G6,A5",579892,624360,435209,189151,335495,1,162846,163128,133540,29588,4.513316209,84341,144978,99886,47856,17,47839,3,3315,0,0.001003365,mm10,mBC-0716-1
"G6,A6",1276984,1416214,905337,510877,744632,0,426064,426627,354405,72222,4.907161253,234445,257325,167734,80200,25,80175,3,4501,0,0.001559089,mm10,mBC-0716-1
"G6,A7",2241728,2482845,1553073,929772,1288730,2,782037,783064,595707,187357,3.179528921,439871,128698,87788,41955,17,41938,2,3359,0,0.00216987,mm10,mBC-0716-1
"G6,A8",12134,12526,9144,3382,6694,0,3070,3077,2159,918,2.351851852,1474,3288,1352,742,2,740,2,197,0,0.141891892,empty,mBC-0716-1
"G6,A9",20935,21197,16032,5165,11036,0,4799,4810,3340,1470,2.272108844,2222,1460,838,456,0,456,0,127,0,0.024122807,empty,mBC-0716-1
"G6,A10",17261,17408,13032,4376,9148,0,4169,4177,2935,1242,2.363123994,1944,6725,2336,1163,1,1162,1,195,0,0.110154905,empty,mBC-0716-1
"G6,A11",19331,19393,14721,4672,10337,0,4640,4652,3281,1371,2.393143691,2120,1263,786,403,0,403,0,126,0,0.089330025,empty,mBC-0716-1
"G6,A12",21850,22126,16845,5281,11614,0,5082,5089,3544,1545,2.293851133,2319,6592,2640,1298,1,1297,1,275,0,0.068619892,empty,mBC-0716-1
"G6,B1",19853,20042,15207,4835,10620,0,4576,4589,3195,1394,2.291965567,2185,1070,714,351,0,351,0,113,0,0.028490028,empty,mBC-0716-1
"G6,B2",1200772,1304194,847616,456578,677554,0,391074,391605,277189,114416,2.422641938,211266,14639,10404,5013,1,5012,1,752,0,0.002394254,mm10,mBC-0716-1
"G6,B3",19489,20121,15094,5027,10723,0,4757,4770,3315,1455,2.278350515,2274,1168,702,364,0,364,0,125,0,0.074175824,empty,mBC-0716-1
"G6,B4",17591,17950,13654,4296,9591,0,4307,4313,3036,1277,2.377447142,2018,1500,810,416,0,416,0,129,0,0.036057692,empty,mBC-0716-1
"G6,B5",10557,6527,4587,1940,4501,0,2168,2190,1555,635,2.448818898,1204,847,548,276,0,276,0,81,0,0.061594203,empty,mBC-0716-1
"G6,B6",13293,13818,9900,3918,7382,0,3476,3483,2370,1113,2.129380054,1737,1047,712,362,0,362,0,98,0,0.096685083,empty,mBC-0716-1
"G6,B7",17075,17544,13242,4302,9323,0,4049,4056,2875,1181,2.434377646,1928,928,614,309,0,309,0,83,0,0,empty,mBC-0716-1
"G6,B8",14766,15463,11403,4060,8164,0,3616,3620,2585,1035,2.497584541,1717,1138,746,384,0,384,0,118,0,0.036458333,empty,mBC-0716-1
"G6,B9",15469,16056,11883,4173,8395,0,3825,3828,2706,1122,2.411764706,1851,581,354,222,0,222,0,72,0,0,empty,mBC-0716-1
"G6,B10",18738,17949,13320,4629,9944,0,4565,4589,3231,1358,2.379234168,2184,9479,2918,1495,1,1494,1,264,0,0.060910308,empty,mBC-0716-1
"G6,B11",18910,19535,14368,5167,10605,0,4979,4996,3519,1477,2.38253216,2422,178,86,53,0,53,0,34,0,0,empty,mBC-0716-1
"G6,B12",19509,19656,14871,4785,10513,0,4717,4733,3378,1355,2.49298893,2257,6230,2601,1336,1,1335,1,266,0,0.154307116,empty,mBC-0716-1
"G6,C1",1135247,1231211,823815,407396,636488,4,343187,343691,273538,70153,3.899163257,182944,51293,32939,15977,4,15973,3,1733,0,0.003255494,mm10,mBC-0716-1
"G6,C2",2054562,2243348,1438240,805108,1144166,3,661640,662598,545787,116811,4.672393867,364062,312745,218333,104487,35,104452,4,5040,0,0.001397771,mm10,mBC-0716-1
"G6,C3",21063,21366,15762,5604,11382,0,5118,5137,3560,1577,2.257450856,2525,5248,1507,775,0,775,0,158,0,0.020645161,empty,mBC-0716-1
"G6,C4",18543,18531,14252,4279,9864,0,4278,4289,3036,1253,2.422984836,1915,1313,816,440,0,440,0,149,0,0.047727273,empty,mBC-0716-1
"G6,C5",1494498,1569050,1122558,446492,816715,3,400979,401635,316016,85619,3.690956447,202732,138451,98556,47115,22,47093,2,3470,0,0.001295309,mm10,mBC-0716-1
"G6,C6",17676,18215,13291,4924,9904,0,4652,4661,3326,1335,2.491385768,2213,1342,854,440,1,439,1,139,0,0.041002278,empty,mBC-0716-1
"G6,C7",738011,797159,544828,252331,423559,0,218014,218366,178044,40322,4.415554784,114427,16542,10923,5106,6,5100,2,763,0,0.004509804,mm10,mBC-0716-1
"G6,C8",16028,16461,12194,4267,8676,0,3948,3962,2775,1187,2.337826453,1840,2055,1181,648,0,648,0,170,0,0.030864198,empty,mBC-0716-1
"G6,C9",13799,14101,10465,3636,7597,0,3464,3474,2428,1046,2.321223709,1682,859,566,298,0,298,0,85,0,0.05033557,empty,mBC-0716-1
"G6,C10",525819,548867,390396,158471,298588,0,149184,149434,117789,31645,3.7221994,75496,23542,15066,7407,2,7405,1,1102,0,0.008507765,mm10,mBC-0716-1
"G6,C11",12339,12994,9366,3628,6831,0,3149,3159,2236,923,2.422535211,1591,665,414,217,0,217,0,79,0,0.013824885,empty,mBC-0716-1
"G6,C12",21393,21833,16199,5634,11579,0,5204,5218,3676,1542,2.383916991,2516,4963,1821,932,1,931,1,204,0,0.102040816,empty,mBC-0716-1
"G6,D1",12542,13088,9329,3759,7088,0,3386,3390,2394,996,2.403614458,1726,690,376,178,0,178,0,65,0,0.033707865,empty,mBC-0716-1
"G6,D2",21400,21639,16775,4864,11528,0,4949,4973,3480,1493,2.330877428,2231,1908,1198,610,0,610,0,183,0,0.018032787,empty,mBC-0716-1
"G6,D3",14849,15279,11092,4187,8286,0,3875,3881,2711,1170,2.317094017,1903,11831,3721,1948,1,1947,1,342,0,0.025166923,empty,mBC-0716-1
"G6,D4",16644,17670,12567,5103,9387,0,4473,4476,3088,1388,2.224783862,2251,3097,1387,671,1,670,1,166,0,0.065671642,empty,mBC-0716-1
"G6,D5",15443,16037,11806,4231,8472,0,3912,3918,2738,1180,2.320338983,1872,1618,923,492,0,492,0,134,0,0.06504065,empty,mBC-0716-1
"G6,D6",13036,13774,9897,3877,7246,0,3350,3360,2352,1008,2.333333333,1700,1077,652,326,0,326,0,122,0,0.012269939,empty,mBC-0716-1
"G6,D7",794614,875415,555168,320247,464158,0,269980,270343,212109,58234,3.642356699,149499,97821,68971,32638,10,32628,2,2670,0,0.002758367,mm10,mBC-0716-1
"G6,D8",17039,17411,12869,4542,9296,0,4312,4316,2964,1352,2.192307692,2075,1109,604,294,0,294,0,109,0,0.040816327,empty,mBC-0716-1
"G6,D9",6157,6330,4639,1691,3548,0,1694,1694,1246,448,2.78125,837,1285,741,389,0,389,0,132,0,0.115681234,empty,mBC-0716-1
"G6,D10",14805,15232,11256,3976,8138,0,3824,3829,2700,1129,2.3914969,1830,668,431,234,0,234,0,96,0,0.042735043,empty,mBC-0716-1
"G6,D11",14117,14593,10827,3766,7828,0,3638,3644,2546,1098,2.318761384,1734,1703,979,510,0,510,0,141,0,0.047058824,empty,mBC-0716-1
"G6,D12",25131,25896,19213,6683,13617,0,6233,6251,4413,1838,2.400979325,2981,3077,2013,936,0,936,0,232,0,0.038461538,empty,mBC-0716-1
"G6,E1",23581,24044,18067,5977,12621,0,5531,5545,3916,1629,2.403928791,2644,2081,1114,583,0,583,0,184,0,0.063464837,empty,mBC-0716-1
"G6,E2",17616,17896,13338,4558,9578,0,4326,4332,3075,1257,2.446300716,2058,1790,987,514,0,514,0,159,0,0.023346304,empty,mBC-0716-1
"G6,E3",13488,13653,10331,3322,7506,0,3432,3440,2389,1051,2.273073264,1587,1534,1000,529,0,529,0,159,0,0.039697543,empty,mBC-0716-1
"G6,E4",16379,17147,12644,4503,8917,0,4014,4018,2819,1199,2.351125938,1934,1287,806,434,1,433,1,132,0,0.011547344,empty,mBC-0716-1
"G6,E5",1469366,1611277,1008434,602843,827180,0,502583,503257,411551,91706,4.487721632,275992,104033,72392,34407,12,34395,4,2699,0,0.00029074,mm10,mBC-0716-1
"G6,E6",14579,15139,11182,3957,7955,0,3545,3551,2406,1145,2.101310044,1690,1417,820,434,0,434,0,124,0,0.055299539,empty,mBC-0716-1
"G6,E7",828368,887263,591387,295876,467574,1,260087,260465,201789,58676,3.439038108,138216,40487,28885,14137,9,14128,1,1486,0,0.003892978,mm10,mBC-0716-1
"G6,E8",19012,19423,14584,4839,10241,0,4494,4507,3173,1334,2.37856072,2109,1844,1089,552,1,551,1,180,0,0.047186933,empty,mBC-0716-1
"G6,E9",9875,10013,7480,2533,5375,0,2400,2404,1713,691,2.479015919,1158,1192,784,381,0,381,0,106,0,0.023622047,empty,mBC-0716-1
"G6,E10",14139,14527,10737,3790,7748,0,3508,3518,2430,1088,2.233455882,1663,8631,3048,1542,5,1537,1,286,0,0.041639558,empty,mBC-0716-1
"G6,E11",9968,10526,7614,2912,5673,1,2664,2680,1885,795,2.371069182,1267,1050,729,353,0,353,0,97,0,0.099150142,empty,mBC-0716-1
"G6,E12",744150,850506,494550,355956,455295,1,290083,290391,235511,54880,4.291381195,168634,69028,43048,20833,8,20825,1,2055,0,0.004609844,mm10,mBC-0716-1
"G6,F1",18838,19436,14409,5027,10201,0,4632,4639,3218,1421,2.264602393,2226,1718,1034,522,0,522,0,137,0,0.120689655,empty,mBC-0716-1
"G6,F2",23866,24566,18041,6525,13030,1,5995,6017,4172,1845,2.261246612,2862,16984,5912,2959,4,2955,3,545,0,0.024703892,empty,mBC-0716-1
"G6,F3",17962,18431,13334,5097,10003,0,4831,4839,3360,1479,2.271805274,2415,8455,3043,1609,4,1605,2,360,0,0.057320872,empty,mBC-0716-1
"G6,F4",19065,19226,14278,4948,10445,0,4802,4816,3445,1371,2.512764406,2250,11665,3651,1818,4,1814,1,300,0,0.02370452,empty,mBC-0716-1
"G6,F5",25086,25355,19277,6078,13378,0,5927,5942,4203,1739,2.416906268,2791,1566,1051,489,0,489,0,167,0,0.061349693,empty,mBC-0716-1
"G6,F6",930527,1020572,636111,384461,539851,2,330198,330610,246920,83690,2.950412236,185685,27303,18515,8927,1,8926,1,1308,0,0.005265516,mm10,mBC-0716-1
"G6,F7",21194,21661,16101,5560,11570,0,5143,5149,3591,1558,2.304878049,2451,2198,841,426,0,426,0,134,0,0.056338028,empty,mBC-0716-1
"G6,F8",24092,24591,18325,6266,13063,0,5900,5913,4178,1735,2.408069164,2755,197,126,80,0,80,0,51,0,0,empty,mBC-0716-1
"G6,F9",16149,16680,12475,4205,8919,0,4057,4065,2818,1247,2.259823577,1963,1628,1040,510,1,509,1,170,0,0.027504912,empty,mBC-0716-1
"G6,F10",21304,21605,16351,5254,11463,0,4979,4997,3506,1491,2.351441985,2333,1027,654,334,0,334,0,134,0,0.008982036,empty,mBC-0716-1
"G6,F11",12220,12473,9267,3206,6686,0,2964,2969,2102,867,2.424452134,1401,13880,4300,2191,1,2190,1,392,0,0.071232877,empty,mBC-0716-1
"G6,F12",15055,15466,11517,3949,8105,0,3695,3708,2590,1118,2.316636852,1753,76,56,28,0,28,0,17,0,0,empty,mBC-0716-1
"G6,G1",10939,11105,8498,2607,5965,0,2593,2598,1832,766,2.391644909,1153,1826,1129,565,0,565,0,153,0,0.017699115,empty,mBC-0716-1
"G6,G2",21974,22154,16831,5323,11536,0,4976,4983,3457,1526,2.265399738,2270,354,234,144,0,144,0,47,0,0.104166667,empty,mBC-0716-1
"G6,G3",21310,21640,16180,5460,11555,0,5164,5178,3568,1610,2.216149068,2524,4822,2009,1097,0,1097,0,249,0,0.04284412,empty,mBC-0716-1
"G6,G4",29419,30148,22806,7342,15786,0,6790,6808,4837,1971,2.454084221,3170,81,54,39,0,39,0,30,0,0.025641026,empty,mBC-0716-1
"G6,G5",460398,473175,343215,129960,256765,0,121853,122070,90241,31829,2.835181752,61308,37538,18238,9302,6,9296,2,1306,0,0.016135972,mm10,mBC-0716-1
"G6,G6",3746930,4003088,2685241,1317847,1998633,2,1182494,1184448,875930,308518,2.839153631,626251,3981,2537,1285,0,1285,0,311,0,0.023346304,mm10,mBC-0716-1
"G6,G7",939742,1015046,681186,333860,534905,2,293168,293614,218773,74841,2.923170455,155266,48118,33633,16076,11,16065,3,1789,0,0.003610333,mm10,mBC-0716-1
"G6,G8",15598,16221,11866,4355,8524,0,3991,3999,2831,1168,2.42380137,1971,4364,1898,956,0,956,0,234,0,0.091004184,empty,mBC-0716-1
"G6,G9",11485,11782,8741,3041,6162,0,2841,2855,1980,875,2.262857143,1325,1039,655,362,1,361,1,130,0,0.038781163,empty,mBC-0716-1
"G6,G10",14534,14940,11064,3876,7893,0,3577,3593,2529,1064,2.376879699,1710,1178,801,437,1,436,1,145,0,0.041284404,empty,mBC-0716-1
"G6,G11",13451,13807,10339,3468,7240,0,3171,3174,2229,945,2.358730159,1477,1742,726,358,0,358,0,105,0,0.008379888,empty,mBC-0716-1
"G6,G12",12367,13162,9406,3756,6934,1,3145,3155,2250,905,2.486187845,1579,4304,1533,779,1,778,1,170,0,0.151670951,empty,mBC-0716-1
"G6,H1",22251,22786,16737,6049,12209,0,5575,5584,4034,1550,2.602580645,2690,993,697,363,0,363,0,124,0,0.052341598,empty,mBC-0716-1
"G6,H2",537899,542225,416184,126041,292965,1,121956,122206,96184,26022,3.696257013,57657,32152,21164,10005,5,10000,3,1368,0,0.0056,mm10,mBC-0716-1
"G6,H3",21741,22454,16543,5911,11905,1,5446,5468,3831,1637,2.340256567,2654,1747,989,522,0,522,0,152,0,0.070881226,empty,mBC-0716-1
"G6,H4",14809,15024,11241,3783,7906,0,3559,3567,2469,1098,2.24863388,1680,673,310,151,0,151,0,42,0,0.01986755,empty,mBC-0716-1
"G6,H5",2159713,2287111,1585072,702039,1166267,0,609345,610360,505943,104417,4.845408315,317677,243306,161301,76678,36,76642,4,4544,0,0.006980507,mm10,mBC-0716-1
"G6,H6",15771,16016,11838,4178,8776,0,4015,4026,2790,1236,2.257281553,1904,1339,851,442,1,441,1,164,0,0.058956916,empty,mBC-0716-1
"G6,H7",634975,689039,456881,232158,371988,3,201108,201444,168575,32869,5.128692689,108148,72321,46839,22442,12,22430,3,2148,0,0.009050379,mm10,mBC-0716-1
"G6,H8",14626,15209,10974,4235,8184,0,3844,3851,2732,1119,2.441465594,1938,1487,916,493,0,493,0,159,0,0.048681542,empty,mBC-0716-1
"G6,H9",17650,17768,13403,4365,9536,1,4324,4330,3075,1255,2.450199203,2022,1537,902,479,0,479,0,130,0,0.043841336,empty,mBC-0716-1
"G6,H10",15266,15716,11641,4075,8533,0,3936,3949,2784,1165,2.389699571,1895,1108,767,388,0,388,0,128,0,0.097938144,empty,mBC-0716-1
"G6,H11",18360,19320,13719,5601,10242,0,4773,4785,3412,1373,2.485069192,2462,117,69,48,0,48,0,36,0,0,empty,mBC-0716-1
"G6,H12",6790,7016,5242,1774,3799,0,1761,1769,1243,526,2.363117871,834,6881,2151,1100,0,1100,0,203,0,0.033636364,empty,mBC-0716-1
"G7,A1",11772,12092,9001,3091,6535,0,3013,3021,2137,884,2.417420814,1377,785,483,262,0,262,0,82,0,0.099236641,empty,mBC-0716-1
"G7,A2",16227,16116,12480,3636,8444,0,3589,3592,2515,1077,2.335190344,1593,963,627,317,0,317,0,84,0,0.025236593,empty,mBC-0716-1
"G7,A3",14527,15000,11053,3947,7945,0,3647,3665,2569,1096,2.343978102,1743,801,478,248,0,248,0,79,0,0.040322581,empty,mBC-0716-1
"G7,A4",18991,19399,14649,4750,10195,0,4427,4435,3110,1325,2.347169811,2032,531,319,166,1,165,1,55,0,0.012121212,empty,mBC-0716-1
"G7,A5",14810,15177,11206,3971,8151,0,3731,3742,2541,1201,2.115736886,1780,1014,609,300,0,300,0,84,0,0.003333333,empty,mBC-0716-1
"G7,A6",11470,11760,8690,3070,6317,0,2860,2870,1988,882,2.253968254,1386,1217,746,355,0,355,0,90,0,0.090140845,empty,mBC-0716-1
"G7,A7",14086,14500,10810,3690,7776,0,3500,3511,2516,995,2.528643216,1682,907,568,300,0,300,0,84,0,0.083333333,empty,mBC-0716-1
"G7,A8",9976,9931,7605,2326,5514,0,2497,2509,1776,733,2.422919509,1204,1074,677,378,0,378,0,123,0,0.068783069,empty,mBC-0716-1
"G7,A9",16091,16082,12467,3615,8469,0,3653,3664,2545,1119,2.2743521,1650,1732,896,400,0,400,0,99,0,0.0575,empty,mBC-0716-1
"G7,A10",13697,13930,10513,3417,7413,0,3315,3322,2331,991,2.352169526,1533,290,194,98,0,98,0,36,0,0.040816327,empty,mBC-0716-1
"G7,A11",694581,743378,500202,243176,394742,0,212069,212362,175329,37033,4.734399049,112666,32965,23051,11473,4,11469,1,1340,0,0.002092597,mm10,mBC-0716-1
"G7,A12",400887,412601,304695,107906,224115,1,105360,105537,67433,38104,1.769709217,52295,12049,6580,3144,4,3140,1,586,0,0.029299363,mm10,mBC-0716-1
"G7,B1",17440,17763,13574,4189,9324,0,4095,4104,2893,1211,2.388934765,1891,6987,2273,1127,1,1126,1,208,0,0.036412078,empty,mBC-0716-1
"G7,B2",18330,18588,14048,4540,9834,0,4401,4415,3108,1307,2.377964805,2042,1263,451,225,0,225,0,51,0,0.022222222,empty,mBC-0716-1
"G7,B3",935402,980593,701617,278976,510244,1,249002,249359,211266,38093,5.546058331,124380,83800,57052,27400,7,27393,1,2382,0,0.000912642,mm10,mBC-0716-1
"G7,B4",14911,15075,11455,3620,8131,0,3663,3673,2668,1005,2.654726368,1741,656,379,182,0,182,0,64,0,0.043956044,empty,mBC-0716-1
"G7,B5",8014,5012,3529,1483,3418,0,1641,1647,1167,480,2.43125,890,808,475,185,0,185,0,50,0,0.005405405,empty,mBC-0716-1
"G7,B6",10363,10743,7958,2785,5731,0,2630,2636,1744,892,1.955156951,1266,985,663,333,0,333,0,82,0,0.072072072,empty,mBC-0716-1
"G7,B7",14533,14465,11305,3160,7771,1,3394,3400,2397,1003,2.389830508,1487,793,488,245,0,245,0,73,0,0.008163265,empty,mBC-0716-1
"G7,B8",12104,12347,9320,3027,6620,0,2934,2939,2011,928,2.167025862,1390,2570,1057,537,0,537,0,115,0,0.152700186,empty,mBC-0716-1
"G7,B9",13318,13775,10122,3653,7270,0,3251,3253,2193,1060,2.068867925,1582,605,396,202,0,202,0,49,0,0.014851485,empty,mBC-0716-1
"G7,B10",14625,14063,10582,3481,7811,0,3495,3530,2373,1157,2.05099395,1696,2908,1078,489,0,489,0,107,0,0.061349693,empty,mBC-0716-1
"G7,B11",14078,14271,10730,3541,7547,0,3370,3380,2320,1060,2.188679245,1576,94,33,23,0,23,0,16,0,0,empty,mBC-0716-1
"G7,B12",16095,16557,12328,4229,8802,0,3963,3976,2827,1149,2.460400348,1868,816,492,232,0,232,0,76,0,0.025862069,empty,mBC-0716-1
"G7,C1",20566,20659,15968,4691,10725,0,4506,4514,3133,1381,2.268645909,2045,652,441,180,0,180,0,47,0,0.1,empty,mBC-0716-1
"G7,C2",16485,16747,12494,4253,8897,0,4031,4046,2822,1224,2.305555556,1927,1369,900,434,2,432,1,127,0,0.113425926,empty,mBC-0716-1
"G7,C3",617982,635749,488021,147728,338081,0,143509,143797,110650,33147,3.338160316,66802,11225,6904,3424,2,3422,2,530,0,0.000584454,mm10,mBC-0716-1
"G7,C4",22524,23407,17301,6106,12454,0,5724,5731,4124,1607,2.566272558,2698,1953,1086,520,0,520,0,117,0,0.040384615,empty,mBC-0716-1
"G7,C5",15044,15540,11372,4168,8225,0,3828,3837,2651,1186,2.235244519,1892,1249,693,368,0,368,0,94,0,0.116847826,empty,mBC-0716-1
"G7,C6",14604,14950,11163,3787,8085,0,3678,3686,2551,1135,2.247577093,1729,1205,731,347,0,347,0,100,0,0.028818444,empty,mBC-0716-1
"G7,C7",14197,14569,10660,3909,7753,0,3563,3570,2442,1128,2.164893617,1720,764,279,149,0,149,0,44,0,0,empty,mBC-0716-1
"G7,C8",13404,13587,10197,3390,7228,0,3207,3217,2165,1052,2.057984791,1525,4733,1787,886,0,886,0,189,0,0.066591422,empty,mBC-0716-1
"G7,C9",11314,11370,8601,2769,6043,0,2700,2703,1862,841,2.214030916,1287,704,452,229,0,229,0,65,0,0.034934498,empty,mBC-0716-1
"G7,C10",12327,12404,9444,2960,6631,0,3027,3037,2143,894,2.397091723,1322,798,455,222,0,222,0,70,0,0.072072072,empty,mBC-0716-1
"G7,C11",10555,10932,8045,2887,5758,0,2672,2681,1864,817,2.281517748,1268,792,475,280,0,280,0,70,0,0.057142857,empty,mBC-0716-1
"G7,C12",17769,18157,13451,4706,9532,1,4353,4369,3120,1249,2.497998399,2130,916,642,319,0,319,0,84,0,0.068965517,empty,mBC-0716-1
"G7,D1",9844,10296,7250,3046,5631,0,2731,2738,1882,856,2.198598131,1392,443,276,154,0,154,0,39,0,0.064935065,empty,mBC-0716-1
"G7,D2",18827,19198,14614,4584,10141,0,4297,4312,3019,1293,2.334880124,2027,2074,1369,648,0,648,0,144,0,0.041666667,empty,mBC-0716-1
"G7,D3",12209,12412,9252,3160,6677,0,3087,3091,2109,982,2.147657841,1434,1102,726,366,0,366,0,101,0,0.032786885,empty,mBC-0716-1
"G7,D4",12458,12931,9622,3309,6822,0,3058,3071,2115,956,2.212343096,1464,837,506,261,0,261,0,71,0,0.057471264,empty,mBC-0716-1
"G7,D5",596114,617641,428568,189073,333210,1,176594,176913,143901,33012,4.359051254,91367,8099,5564,2695,0,2695,0,519,0,0.003710575,mm10,mBC-0716-1
"G7,D6",479675,498510,358425,140085,268807,0,129281,129509,107342,22167,4.842423422,64854,83757,57620,27620,9,27611,2,2533,0,0.00155735,mm10,mBC-0716-1
"G7,D7",11608,11797,8675,3122,6278,0,2817,2832,1946,886,2.196388262,1352,1110,686,333,1,332,1,111,0,0.021084337,empty,mBC-0716-1
"G7,D8",561121,608103,402175,205928,329828,0,183876,184119,141293,42826,3.29923411,100143,7683,5465,2535,1,2534,1,455,0,0.005130229,mm10,mBC-0716-1
"G7,D9",3863,3950,2844,1106,2138,0,1005,1006,678,328,2.067073171,499,2933,1226,611,0,611,0,149,0,0.022913257,empty,mBC-0716-1
"G7,D10",12480,12873,9541,3332,6843,0,3128,3128,2252,876,2.570776256,1428,721,457,214,0,214,0,57,0,0,empty,mBC-0716-1
"G7,D11",12406,12924,9299,3625,6853,0,3229,3245,2234,1011,2.209693373,1585,2090,986,522,0,522,0,124,0,0.101532567,empty,mBC-0716-1
"G7,D12",18443,19169,14198,4971,9899,0,4417,4430,3017,1413,2.13517339,2095,2204,1418,669,0,669,0,157,0,0.068759342,empty,mBC-0716-1
"G7,E1",19359,19852,14811,5041,10330,0,4553,4566,3180,1386,2.294372294,2208,1016,584,313,0,313,0,103,0,0.073482428,empty,mBC-0716-1
"G7,E2",14289,14558,11014,3544,7834,0,3443,3451,2436,1015,2.4,1649,1794,877,446,1,445,1,138,0,0.069662921,empty,mBC-0716-1
"G7,E3",11113,11482,8470,3012,6167,0,2774,2776,1925,851,2.262044653,1327,5249,2101,1024,2,1022,1,202,0,0.094911937,empty,mBC-0716-1
"G7,E4",13732,14117,10654,3463,7381,0,3245,3249,2276,973,2.339157246,1486,1183,721,336,0,336,0,94,0,0.074404762,empty,mBC-0716-1
"G7,E5",19447,19441,14885,4556,10153,0,4373,4388,3000,1388,2.161383285,2011,972,597,293,1,292,1,84,0,0,empty,mBC-0716-1
"G7,E6",11658,11950,8940,3010,6328,0,2816,2824,1916,908,2.110132159,1307,5578,1840,941,2,939,1,182,0,0.048988285,empty,mBC-0716-1
"G7,E7",12471,13179,9400,3779,6836,0,3228,3235,2237,998,2.241482966,1659,726,459,222,0,222,0,61,0,0.076576577,empty,mBC-0716-1
"G7,E8",15700,15985,12043,3942,8361,0,3624,3629,2609,1020,2.557843137,1675,6433,2389,1191,0,1191,0,234,0,0.087321579,empty,mBC-0716-1
"G7,E9",419857,450173,306270,143903,241664,0,124048,124192,105337,18855,5.586687881,65431,117501,79943,38485,17,38468,3,2830,0,0.000987834,mm10,mBC-0716-1
"G7,E10",11840,12034,8936,3098,6522,0,2934,2945,2038,907,2.246968026,1442,987,611,316,0,316,0,85,0,0,empty,mBC-0716-1
"G7,E11",7959,8299,6065,2234,4374,0,2018,2021,1430,591,2.41962775,952,914,496,270,0,270,0,78,0,0.007407407,empty,mBC-0716-1
"G7,E12",12871,13437,9732,3705,7178,0,3252,3259,2303,956,2.408995816,1651,2350,830,396,0,396,0,109,0,0.012626263,empty,mBC-0716-1
"G7,F1",16458,16800,12424,4376,8999,0,4055,4065,2874,1191,2.413098237,1958,1175,730,353,0,353,0,101,0,0.016997167,empty,mBC-0716-1
"G7,F2",2126372,2343959,1503291,840668,1215453,1,710467,711491,574060,137431,4.177077952,393929,252799,178053,85448,34,85414,3,4543,0,0.001135645,mm10,mBC-0716-1
"G7,F3",14153,14931,10678,4253,7952,0,3711,3725,2531,1194,2.119765494,1824,1471,875,452,0,452,0,117,0,0.048672566,empty,mBC-0716-1
"G7,F4",14230,14305,10746,3559,7836,0,3434,3445,2408,1037,2.322082932,1575,586,320,150,0,150,0,47,0,0.006666667,empty,mBC-0716-1
"G7,F5",21642,22284,16437,5847,11644,0,5274,5290,3672,1618,2.26946848,2492,1398,892,472,1,471,1,110,0,0.067940552,empty,mBC-0716-1
"G7,F6",20284,20672,15324,5348,11017,0,5008,5018,3577,1441,2.482303956,2424,1968,1256,580,0,580,0,149,0,0.05862069,empty,mBC-0716-1
"G7,F7",18330,18707,13836,4871,10021,0,4548,4563,3161,1402,2.254636234,2164,3934,1281,639,1,638,1,134,0,0.105015674,empty,mBC-0716-1
"G7,F8",20534,21078,15707,5371,11098,2,4980,5000,3505,1495,2.344481605,2350,198,113,66,0,66,0,29,0,0,empty,mBC-0716-1
"G7,F9",13716,14080,10456,3624,7524,0,3357,3364,2343,1021,2.294809011,1599,1201,749,404,0,404,0,116,0,0.02970297,empty,mBC-0716-1
"G7,F10",18646,18993,14609,4384,10015,0,4287,4295,3070,1225,2.506122449,1897,1024,696,369,0,369,0,92,0,0.035230352,empty,mBC-0716-1
"G7,F11",10256,10496,7851,2645,5545,0,2452,2453,1718,735,2.337414966,1135,3328,1123,599,1,598,1,130,0,0.112040134,empty,mBC-0716-1
"G7,F12",12758,13218,9738,3480,6944,0,3224,3231,2239,992,2.257056452,1567,921,416,229,0,229,0,52,0,0.074235808,empty,mBC-0716-1
"G7,G1",9668,10015,7462,2553,5182,0,2275,2280,1541,739,2.085250338,1060,1431,931,435,0,435,0,117,0,0.025287356,empty,mBC-0716-1
"G7,G2",18555,18977,14279,4698,9922,0,4379,4390,3022,1368,2.209064327,2036,325,201,94,0,94,0,27,0,0,empty,mBC-0716-1
"G7,G3",17425,17532,13280,4252,9314,1,4096,4121,2856,1265,2.25770751,1915,1493,1055,524,0,524,0,123,0,0.078244275,empty,mBC-0716-1
"G7,G4",25015,25038,19292,5746,13229,0,5644,5657,4000,1657,2.414001207,2567,126,63,40,0,40,0,14,0,0,empty,mBC-0716-1
"G7,G5",12067,12497,9213,3284,6514,0,2942,2946,2109,837,2.519713262,1393,968,540,272,0,272,0,87,0,0.003676471,empty,mBC-0716-1
"G7,G6",21643,22272,16793,5479,11771,0,5156,5165,3628,1537,2.36044242,2434,162,75,41,0,41,0,22,0,0,empty,mBC-0716-1
"G7,G7",17687,17945,13803,4142,9481,0,4115,4127,2881,1246,2.312199037,1894,1230,765,390,1,389,1,114,0,0.048843188,empty,mBC-0716-1
"G7,G8",652217,762730,426186,336544,407581,0,272348,272711,208207,64504,3.227815329,162927,19702,13466,6319,3,6316,1,1016,0,0.004274858,mm10,mBC-0716-1
"G7,G9",9323,9698,7105,2593,5127,0,2373,2375,1675,700,2.392857143,1127,1091,689,347,0,347,0,102,0,0.074927954,empty,mBC-0716-1
"G7,G10",740491,765333,569814,195519,404637,0,180972,181283,125839,55444,2.269659476,86818,19738,11950,5455,2,5453,1,1054,0,0.004034476,mm10,mBC-0716-1
"G7,G11",11161,11169,8618,2551,5960,0,2642,2647,1894,753,2.515272244,1128,7534,2681,1351,2,1349,1,250,0,0.014825797,empty,mBC-0716-1
"G7,G12",10404,10623,7821,2802,5714,0,2639,2649,1896,753,2.517928287,1244,1335,633,309,0,309,0,101,0,0.13592233,empty,mBC-0716-1
"G7,H1",18180,18699,13854,4845,9901,0,4527,4532,3200,1332,2.402402402,2140,829,442,228,0,228,0,76,0,0.061403509,empty,mBC-0716-1
"G7,H2",20669,21436,15902,5534,11142,0,5007,5015,3424,1591,2.152105594,2339,1581,1046,539,0,539,0,124,0,0.029684601,empty,mBC-0716-1
"G7,H3",18283,18726,13866,4860,9731,0,4375,4388,3060,1328,2.304216867,2069,1029,670,337,0,337,0,84,0,0.023738872,empty,mBC-0716-1
"G7,H4",28158,29374,18473,10901,15604,0,8848,8857,4875,3982,1.224259166,5038,469,235,120,0,120,0,31,0,0,empty,mBC-0716-1
"G7,H5",1055217,1212047,693349,518698,628699,1,410558,411138,324016,87122,3.71910654,240413,73289,48943,23555,4,23551,1,2260,0,0.001316292,mm10,mBC-0716-1
"G7,H6",12208,12371,9129,3242,6587,0,2963,2968,2002,966,2.072463768,1466,1131,754,380,0,380,0,119,0,0.042105263,empty,mBC-0716-1
"G7,H7",14871,15191,11288,3903,8162,0,3684,3695,2627,1068,2.459737828,1726,908,514,281,0,281,0,106,0,0.003558719,empty,mBC-0716-1
"G7,H8",17928,18783,13418,5365,10190,0,4782,4797,3661,1136,3.222711268,2437,1342,803,434,0,434,0,103,0,0.048387097,empty,mBC-0716-1
"G7,H9",13544,13414,10379,3035,7100,0,3130,3135,2189,946,2.313953488,1373,4764,1878,967,1,966,1,186,0,0.124223602,empty,mBC-0716-1
"G7,H10",12273,12490,9396,3094,6603,0,2968,2975,2042,933,2.1886388,1372,717,426,206,0,206,0,68,0,0.009708738,empty,mBC-0716-1
"G7,H11",15061,15653,11457,4196,8150,0,3766,3773,2623,1150,2.280869565,1780,103,62,27,0,27,0,19,0,0,empty,mBC-0716-1
"G7,H12",5325,5280,3959,1321,2827,0,1212,1216,869,347,2.504322767,562,551,329,165,0,165,0,51,0,0.127272727,empty,mBC-0716-1
"G8,A1",14486,15066,10953,4113,8152,0,3782,3784,2644,1140,2.319298246,1863,971,531,280,0,280,0,84,0,0.042857143,empty,mBC-0716-1
"G8,A2",18933,18980,14634,4346,10204,0,4432,4453,3123,1330,2.348120301,2069,811,513,284,2,282,1,77,0,0.088652482,empty,mBC-0716-1
"G8,A3",16616,17050,12601,4449,9100,0,4106,4115,2889,1226,2.356443719,1959,793,487,237,0,237,0,75,0,0.113924051,empty,mBC-0716-1
"G8,A4",574956,617549,425633,191916,321417,0,165665,165909,128727,37182,3.462078425,86221,10238,6141,2939,3,2936,2,555,0,0.017029973,mm10,mBC-0716-1
"G8,A5",17068,17571,12904,4667,9258,1,4251,4265,2970,1295,2.293436293,2009,1109,665,343,0,343,0,96,0,0.017492711,empty,mBC-0716-1
"G8,A6",14126,14317,10296,4021,7539,0,3546,3551,2449,1102,2.222323049,1713,8477,3501,1897,1,1896,1,286,0,0.32964135,empty,mBC-0716-1
"G8,A7",16797,17234,12893,4341,9236,0,4247,4250,2866,1384,2.070809249,2025,1052,596,260,0,260,0,83,0,0.038461538,empty,mBC-0716-1
"G8,A8",11026,11212,8400,2812,6069,0,2744,2745,1924,821,2.343483557,1306,998,628,347,0,347,0,111,0,0.011527378,empty,mBC-0716-1
"G8,A9",865334,919003,647931,271072,477119,1,235121,235509,177628,57881,3.068848154,120222,62615,45602,21704,7,21697,2,2094,0,0.000230447,mm10,mBC-0716-1
"G8,A10",15931,16211,12056,4155,8609,0,3924,3939,2755,1184,2.326858108,1847,1461,593,314,1,313,1,82,0,0.006389776,empty,mBC-0716-1
"G8,A11",18535,18930,14114,4816,10039,0,4629,4635,3125,1510,2.069536424,2214,5818,1904,950,0,950,0,206,0,0.014736842,empty,mBC-0716-1
"G8,A12",21014,21664,16276,5388,11175,0,4911,4927,3428,1499,2.286857905,2325,1957,1287,601,0,601,0,135,0,0.079866889,empty,mBC-0716-1
"G8,B1",19175,19415,14798,4617,10291,0,4574,4577,3185,1392,2.288074713,2115,658,421,224,0,224,0,65,0,0.071428571,empty,mBC-0716-1
"G8,B2",513993,524471,377440,147031,283776,2,140779,141050,114155,26895,4.244469232,70146,5304,2153,1102,0,1102,0,233,0,0.063520871,mm10,mBC-0716-1
"G8,B3",19165,19840,14721,5119,10487,1,4877,4883,3383,1500,2.255333333,2351,4160,1485,730,0,730,0,168,0,0.016438356,empty,mBC-0716-1
"G8,B4",17306,17661,13351,4310,9375,0,4194,4202,2969,1233,2.407948094,1985,819,463,244,0,244,0,77,0,0.069672131,empty,mBC-0716-1
"G8,B5",16699,13777,9519,4258,8424,0,4177,4198,3262,936,3.485042735,2167,418,286,147,0,147,0,41,0,0.115646259,empty,mBC-0716-1
"G8,B6",12389,12865,9381,3484,6783,0,3183,3187,2243,944,2.376059322,1573,711,414,219,0,219,0,68,0,0.01826484,empty,mBC-0716-1
"G8,B7",864075,936087,632781,303306,494744,0,266034,266443,199494,66949,2.979790587,140811,22999,14835,7021,2,7019,1,1095,0,0.001709645,mm10,mBC-0716-1
"G8,B8",13562,13842,10296,3546,7402,0,3298,3305,2289,1016,2.252952756,1521,737,419,224,0,224,0,83,0,0.09375,empty,mBC-0716-1
"G8,B9",15316,15596,11853,3743,8221,0,3628,3631,2580,1051,2.454804948,1689,493,287,143,0,143,0,41,0,0.076923077,empty,mBC-0716-1
"G8,B10",590338,592490,382672,209818,327587,1,179987,180806,153222,27584,5.554741879,99545,39331,27937,13417,4,13413,1,1456,0,0.002162082,mm10,mBC-0716-1
"G8,B11",738967,807244,503042,304202,424693,0,256754,257043,194610,62433,3.117101533,145168,376,280,119,0,119,0,44,0,0.008403361,empty,mBC-0716-1
"G8,B12",18240,18780,13973,4807,10038,0,4486,4499,3196,1303,2.452801228,2139,867,555,285,0,285,0,82,0,0.014035088,empty,mBC-0716-1
"G8,C1",23141,23370,17960,5410,12059,0,5040,5053,3501,1552,2.255798969,2242,542,337,174,0,174,0,64,0,0.005747126,empty,mBC-0716-1
"G8,C2",18948,19457,14214,5243,10326,0,4766,4780,3468,1312,2.643292683,2329,1251,835,444,1,443,1,135,0,0.065462754,empty,mBC-0716-1
"G8,C3",22073,22393,16780,5613,11694,0,5286,5298,3655,1643,2.224589166,2485,395,223,112,0,112,0,36,0,0.017857143,empty,mBC-0716-1
"G8,C4",17623,17785,13504,4281,9518,0,4191,4199,2911,1288,2.260093168,1894,5602,1733,864,0,864,0,210,0,0.024305556,empty,mBC-0716-1
"G8,C5",17605,18023,13330,4693,9449,0,4351,4360,3010,1350,2.22962963,2078,1017,586,315,0,315,0,83,0,0.047619048,empty,mBC-0716-1
"G8,C6",765218,786130,574933,211197,426109,0,198127,198485,166375,32110,5.181407661,97565,86149,54072,26300,11,26289,2,2470,0,0.00475484,mm10,mBC-0716-1
"G8,C7",735023,790418,544775,245643,418487,0,213185,213511,175394,38117,4.601463914,111631,25208,17350,8407,4,8403,1,1052,0,0.000595026,mm10,mBC-0716-1
"G8,C8",15446,15638,11784,3854,8341,1,3747,3754,2594,1160,2.236206897,1754,1443,782,402,0,402,0,118,0,0.067164179,empty,mBC-0716-1
"G8,C9",882735,921770,660568,261202,480262,1,230051,230409,196803,33606,5.856186395,115335,63998,45548,22145,4,22141,2,2121,0,0.002077594,mm10,mBC-0716-1
"G8,C10",13822,14532,10464,4068,7706,0,3537,3546,2509,1037,2.419479267,1759,945,607,296,0,296,0,81,0,0.077702703,empty,mBC-0716-1
"G8,C11",11932,12631,8966,3665,6730,0,3247,3259,2165,1094,1.978976234,1647,533,349,181,0,181,0,58,0,0,empty,mBC-0716-1
"G8,C12",20227,20524,15331,5193,10938,0,4936,4960,3431,1529,2.243950294,2353,1341,769,408,0,408,0,96,0,0.151960784,empty,mBC-0716-1
"G8,D1",12205,12460,8945,3515,6695,0,3235,3244,2277,967,2.354705274,1613,10830,3151,1657,1,1656,1,283,0,0.086352657,empty,mBC-0716-1
"G8,D2",808606,864435,603882,260553,454669,1,225888,226262,192917,33345,5.78548508,115221,147288,105410,51317,11,51306,1,3328,0,0.002650762,mm10,mBC-0716-1
"G8,D3",675472,760073,465247,294826,405925,0,239363,239650,199338,40312,4.944879936,136716,58356,41457,19668,6,19662,1,1990,0,0.000966331,mm10,mBC-0716-1
"G8,D4",14685,15113,11327,3786,7968,0,3638,3643,2574,1069,2.407857811,1726,878,512,227,1,226,1,87,0,0.044247788,empty,mBC-0716-1
"G8,D5",13915,14163,10661,3502,7609,0,3527,3536,2494,1042,2.393474088,1645,679,395,231,0,231,0,82,0,0.043290043,empty,mBC-0716-1
"G8,D6",12300,12964,9244,3720,7018,0,3335,3344,2283,1061,2.151743638,1725,1055,714,362,0,362,0,83,0,0.016574586,empty,mBC-0716-1
"G8,D7",13246,13599,10023,3576,7283,0,3419,3427,2373,1054,2.25142315,1653,910,531,261,0,261,0,96,0,0.091954023,empty,mBC-0716-1
"G8,D8",15930,16845,12073,4772,8897,0,4169,4176,2892,1284,2.252336449,2076,668,383,216,0,216,0,64,0,0.069444444,empty,mBC-0716-1
"G8,D9",217647,219840,157203,62637,121603,0,60084,60170,49062,11108,4.416816709,30620,9187,6012,2931,1,2930,1,568,0,0.009556314,mm10,mBC-0716-1
"G8,D10",14435,14963,11106,3857,7919,0,3740,3746,2544,1202,2.116472546,1808,661,383,198,0,198,0,61,0,0,empty,mBC-0716-1
"G8,D11",13838,14155,10660,3495,7645,1,3498,3514,2422,1092,2.217948718,1662,1151,747,391,0,391,0,118,0,0.030690537,empty,mBC-0716-1
"G8,D12",21041,21683,16133,5550,11292,0,5100,5113,3568,1545,2.309385113,2423,1460,882,489,0,489,0,144,0,0.034764826,empty,mBC-0716-1
"G8,E1",22782,23034,17452,5582,12082,0,5347,5359,3793,1566,2.422094508,2480,7367,2787,1450,2,1448,2,252,0,0.116022099,empty,mBC-0716-1
"G8,E2",16972,16869,12781,4088,9044,0,4069,4087,2927,1160,2.523275862,1869,4703,1720,931,0,931,0,200,0,0.066595059,empty,mBC-0716-1
"G8,E3",12706,13164,9672,3492,7047,0,3174,3181,2255,926,2.435205184,1568,4293,1772,900,2,898,1,162,0,0.111358575,empty,mBC-0716-1
"G8,E4",15923,16218,12258,3960,8423,0,3707,3713,2577,1136,2.268485915,1687,884,544,298,0,298,0,89,0,0.060402685,empty,mBC-0716-1
"G8,E5",24454,25010,18992,6018,13191,0,5917,5936,4184,1752,2.388127854,2698,2081,864,440,0,440,0,122,0,0.059090909,empty,mBC-0716-1
"G8,E6",13975,14361,10556,3805,7733,0,3413,3420,2454,966,2.540372671,1712,1355,841,383,0,383,0,83,0,0.010443864,empty,mBC-0716-1
"G8,E7",14114,14594,10895,3699,7786,0,3504,3516,2437,1079,2.258572753,1654,866,568,299,0,299,0,89,0,0.030100334,empty,mBC-0716-1
"G8,E8",18166,18298,14017,4281,9725,0,4181,4190,2962,1228,2.412052117,1926,1349,923,466,0,466,0,122,0,0.010729614,empty,mBC-0716-1
"G8,E9",835703,867714,622539,245175,464115,1,230681,231028,171261,59767,2.865477605,115895,47686,24175,11767,6,11761,2,1649,0,0.019981294,mm10,mBC-0716-1
"G8,E10",13345,13814,10050,3764,7410,0,3420,3427,2342,1085,2.158525346,1667,1054,676,347,0,347,0,87,0,0.080691643,empty,mBC-0716-1
"G8,E11",9636,10083,7406,2677,5268,0,2428,2433,1672,761,2.197109067,1169,822,554,297,0,297,0,84,0,0.057239057,empty,mBC-0716-1
"G8,E12",15623,16228,11843,4385,8765,0,4042,4053,2863,1190,2.405882353,2046,779,502,261,1,260,1,79,0,0.026923077,empty,mBC-0716-1
"G8,F1",18353,18665,14131,4534,9760,0,4273,4286,2960,1326,2.232277526,1967,1000,620,349,0,349,0,82,0,0.034383954,empty,mBC-0716-1
"G8,F2",524723,544634,396411,148223,294516,0,141119,141368,108128,33240,3.252948255,71094,12701,8656,4033,1,4032,1,711,0,0.007936508,mm10,mBC-0716-1
"G8,F3",17422,18068,12974,5094,9519,0,4477,4481,3083,1398,2.205293276,2244,5335,1844,905,0,905,0,217,0,0.04640884,empty,mBC-0716-1
"G8,F4",17793,18185,13322,4863,9977,0,4618,4623,3249,1374,2.364628821,2239,1092,408,213,0,213,0,75,0,0.009389671,empty,mBC-0716-1
"G8,F5",25396,25693,19490,6203,13474,0,5980,5989,4241,1748,2.426201373,2787,1138,706,375,0,375,0,118,0,0.050666667,empty,mBC-0716-1
"G8,F6",24349,25215,18484,6731,13448,0,6192,6206,4364,1842,2.369163952,3027,1447,926,494,0,494,0,121,0,0.111336032,empty,mBC-0716-1
"G8,F7",20177,20569,15270,5299,11148,0,5051,5064,3638,1426,2.551192146,2382,541,343,182,0,182,0,59,0,0.175824176,empty,mBC-0716-1
"G8,F8",23094,23750,17512,6238,12591,0,5749,5753,4061,1692,2.400118203,2749,556,300,163,0,163,0,45,0,0,empty,mBC-0716-1
"G8,F9",16126,16351,12367,3984,8719,0,3966,3975,2759,1216,2.268914474,1845,1078,696,351,0,351,0,112,0,0.002849003,empty,mBC-0716-1
"G8,F10",21264,21873,16307,5566,11469,0,5063,5073,3622,1451,2.496209511,2431,5437,1831,907,1,906,1,157,0,0.060706402,empty,mBC-0716-1
"G8,F11",13144,13528,9945,3583,7170,0,3211,3215,2270,945,2.402116402,1519,770,423,232,0,232,0,72,0,0.034482759,empty,mBC-0716-1
"G8,F12",14548,15125,11053,4072,7845,0,3582,3586,2530,1056,2.395833333,1753,60,33,10,0,10,0,6,0,0,empty,mBC-0716-1
"G8,G1",10514,10738,8065,2673,5782,0,2504,2508,1709,799,2.138923655,1227,1634,1100,564,0,564,0,136,0,0.008865248,empty,mBC-0716-1
"G8,G2",21141,21363,16176,5187,11204,0,4929,4941,3446,1495,2.305016722,2298,333,224,121,0,121,0,34,0,0,empty,mBC-0716-1
"G8,G3",20339,20992,15347,5645,11163,0,5134,5139,3588,1551,2.313346228,2566,1381,989,535,0,535,0,145,0,0.072897196,empty,mBC-0716-1
"G8,G4",734174,741900,544178,197722,394952,0,190792,191112,151604,39508,3.837298775,94306,64,45,24,0,24,0,13,0,0,empty,mBC-0716-1
"G8,G5",14234,14588,10836,3752,7718,0,3534,3547,2422,1125,2.152888889,1683,768,489,229,0,229,0,75,0,0.052401747,empty,mBC-0716-1
"G8,G6",24812,25519,19241,6278,13386,0,5877,5896,4212,1684,2.501187648,2744,91,59,42,0,42,0,24,0,0,empty,mBC-0716-1
"G8,G7",20412,20975,15627,5348,11190,0,5014,5029,3545,1484,2.388814016,2428,2408,1137,567,0,567,0,125,0,0.070546737,empty,mBC-0716-1
"G8,G8",14709,15180,11103,4077,8096,0,3729,3732,2621,1111,2.359135914,1883,1137,763,352,0,352,0,95,0,0.011363636,empty,mBC-0716-1
"G8,G9",638759,730907,442980,287927,389128,1,233275,233573,172433,61140,2.820297677,134754,89821,59796,28622,9,28613,1,2496,0,0.002935729,mm10,mBC-0716-1
"G8,G10",14169,14517,10709,3808,7704,0,3483,3492,2395,1097,2.183226983,1676,1857,917,475,0,475,0,112,0,0.252631579,empty,mBC-0716-1
"G8,G11",12874,13059,9903,3156,7051,0,3149,3150,2244,906,2.476821192,1454,489,317,182,0,182,0,59,0,0.005494505,empty,mBC-0716-1
"G8,G12",11644,11703,8947,2756,6258,0,2786,2795,1974,821,2.404384896,1303,975,647,317,0,317,0,88,0,0.075709779,empty,mBC-0716-1
"G8,H1",21383,21687,16141,5546,11671,0,5303,5317,3806,1511,2.518861681,2523,629,441,237,0,237,0,72,0,0.050632911,empty,mBC-0716-1
"G8,H2",23960,24582,18218,6364,12939,0,5834,5854,4116,1738,2.368239356,2828,1934,1198,593,0,593,0,139,0,0.092748735,empty,mBC-0716-1
"G8,H3",767683,837311,544242,293069,442560,0,248961,249321,200525,48796,4.109455693,136163,54229,38461,18619,17,18602,2,1856,0,0.000806365,mm10,mBC-0716-1
"G8,H4",14000,14548,10550,3998,7717,0,3574,3582,2479,1103,2.2475068,1771,89,58,31,0,31,0,17,0,0.032258065,empty,mBC-0716-1
"G8,H5",19320,20019,14632,5387,10473,0,4847,4859,3438,1421,2.419422942,2338,1119,742,409,0,409,0,123,0,0.036674817,empty,mBC-0716-1
"G8,H6",14132,14207,10611,3596,7824,0,3579,3587,2510,1077,2.330547818,1722,1947,960,515,0,515,0,122,0,0.054368932,empty,mBC-0716-1
"G8,H7",812651,866354,583011,283343,459609,1,242996,243405,203901,39504,5.161527947,129219,105787,73854,35148,15,35133,2,2919,0,0.000796972,mm10,mBC-0716-1
"G8,H8",24665,25714,18631,7083,14012,0,6737,6745,4843,1902,2.546267087,3346,1259,841,430,0,430,0,97,0,0.037209302,empty,mBC-0716-1
"G8,H9",16384,16990,12301,4689,8966,1,4144,4156,2941,1215,2.420576132,2031,1099,660,344,0,344,0,90,0,0.090116279,empty,mBC-0716-1
"G8,H10",15477,15765,11434,4331,8436,0,3867,3875,2743,1132,2.423144876,1904,8728,2741,1443,0,1443,0,250,0,0.139293139,empty,mBC-0716-1
"G8,H11",17727,18501,13429,5072,9891,0,4626,4639,3239,1400,2.313571429,2295,177,83,40,1,39,1,19,0,0,empty,mBC-0716-1
"G8,H12",6510,6703,4940,1763,3573,0,1650,1654,1162,492,2.361788618,829,372,244,133,0,133,0,46,0,0.060150376,empty,mBC-0716-1
"G9,A1",13775,14310,10229,4081,7789,0,3674,3680,2541,1139,2.230904302,1853,1147,702,357,0,357,0,134,0,0.030812325,empty,mBC-0716-1
"G9,A2",18948,19103,14450,4653,10068,0,4312,4325,2958,1367,2.163862473,2051,3011,1420,817,0,817,0,208,0,0.073439412,empty,mBC-0716-1
"G9,A3",16824,17565,12718,4847,9351,0,4416,4423,3094,1329,2.328066215,2225,1065,728,369,0,369,0,105,0,0.059620596,empty,mBC-0716-1
"G9,A4",808303,854906,604913,249993,449276,1,223646,224024,184739,39285,4.702532773,112959,11420,7582,3778,0,3778,0,652,0,0.002382213,mm10,mBC-0716-1
"G9,A5",17511,17817,13459,4358,9431,0,4214,4227,2956,1271,2.325727773,2025,3502,1638,883,0,883,0,207,0,0.169875425,empty,mBC-0716-1
"G9,A6",12783,13161,9884,3277,7080,0,3199,3207,2195,1012,2.168972332,1565,1408,813,473,0,473,0,148,0,0.046511628,empty,mBC-0716-1
"G9,A7",16033,16293,12130,4163,8720,0,3964,3974,2721,1253,2.171588188,1893,1412,944,477,0,477,0,150,0,0.031446541,empty,mBC-0716-1
"G9,A8",11426,11591,8392,3199,6117,0,2833,2841,1983,858,2.311188811,1394,30801,9999,5316,4,5312,2,797,0,0.153049699,empty,mBC-0716-1
"G9,A9",20001,20308,15474,4834,10695,0,4648,4657,3386,1271,2.66404406,2169,1240,841,429,0,429,0,137,0,0.009324009,empty,mBC-0716-1
"G9,A10",15603,15982,11907,4075,8528,1,3828,3845,2669,1176,2.269557823,1856,373,225,163,0,163,0,64,0,0,empty,mBC-0716-1
"G9,A11",780183,863854,551285,312569,458288,1,261484,261860,202534,59326,3.413916327,144786,86526,53246,26392,15,26377,5,2389,0,0.006027979,mm10,mBC-0716-1
"G9,A12",20666,21184,15989,5195,11068,1,4901,4916,3416,1500,2.277333333,2329,2715,1663,859,0,859,0,213,0,0.071012806,empty,mBC-0716-1
"G9,B1",18921,19212,14612,4600,10223,0,4524,4541,3116,1425,2.186666667,2108,939,578,322,0,322,0,117,0,0.068322981,empty,mBC-0716-1
"G9,B2",20604,21035,15522,5513,10879,0,4853,4861,3377,1484,2.275606469,2353,574,328,191,0,191,0,70,0,0,empty,mBC-0716-1
"G9,B3",1401446,1537616,1013763,523853,806453,2,444141,444782,336976,107806,3.125762945,243987,94208,60368,29995,9,29986,1,2950,0,0.003234843,mm10,mBC-0716-1
"G9,B4",16905,17334,13184,4150,9056,0,4005,4005,2821,1184,2.382601351,1814,1281,779,452,0,452,0,141,0,0.121681416,empty,mBC-0716-1
"G9,B5",9827,6366,4437,1929,4287,0,2022,2034,1451,583,2.488850772,1104,13279,4107,2091,3,2088,1,347,0,0.054597701,empty,mBC-0716-1
"G9,B6",1759782,1939011,1250590,688421,1016860,2,589881,590604,467022,123582,3.779045492,324449,217178,145960,73491,29,73462,3,4538,0,0.002001035,mm10,mBC-0716-1
"G9,B7",16042,16732,12261,4471,8740,0,3896,3902,2659,1243,2.139179405,1848,13865,4403,2205,1,2204,1,425,0,0.024500907,empty,mBC-0716-1
"G9,B8",13413,13745,10250,3495,7310,0,3331,3339,2388,951,2.511041009,1570,1345,881,454,0,454,0,147,0,0.004405286,empty,mBC-0716-1
"G9,B9",15077,15202,11636,3566,8030,0,3550,3560,2470,1090,2.266055046,1630,585,353,186,0,186,0,78,0,0.053763441,empty,mBC-0716-1
"G9,B10",16167,15663,11756,3907,8760,0,3939,3960,2733,1227,2.227383863,1871,538,286,158,0,158,0,66,0,0.03164557,empty,mBC-0716-1
"G9,B11",15911,16012,12027,3985,8538,0,3831,3846,2663,1183,2.251056636,1805,208,118,83,1,82,1,42,0,0,empty,mBC-0716-1
"G9,B12",18410,18357,14229,4128,9923,0,4389,4394,3042,1352,2.25,1970,1155,752,393,0,393,0,114,0,0.155216285,empty,mBC-0716-1
"G9,C1",22628,22705,17792,4913,11752,0,4935,4946,3446,1500,2.297333333,2172,671,358,197,1,196,1,83,0,0,empty,mBC-0716-1
"G9,C2",18943,19607,14259,5348,10346,0,4790,4796,3388,1408,2.40625,2333,1888,1196,641,1,640,1,194,0,0.06875,empty,mBC-0716-1
"G9,C3",1031657,1089476,767752,321724,563510,3,281922,282405,230322,52083,4.422210702,143571,35650,24721,12435,7,12428,1,1505,0,0.000160927,mm10,mBC-0716-1
"G9,C4",19032,18714,13751,4963,9695,0,4333,4346,3039,1307,2.32517215,2099,109385,33146,17263,31,17232,9,1853,0,0.110434076,empty,mBC-0716-1
"G9,C5",16684,17045,12728,4317,9040,0,4117,4121,2935,1186,2.47470489,1921,1171,768,410,0,410,0,121,0,0.073170732,empty,mBC-0716-1
"G9,C6",17102,17762,12962,4800,9638,0,4412,4423,3134,1289,2.431342126,2117,1223,751,415,0,415,0,140,0,0.06746988,empty,mBC-0716-1
"G9,C7",17024,17636,12898,4738,9288,0,4352,4362,3035,1327,2.287113791,2084,411,283,149,0,149,0,63,0,0.087248322,empty,mBC-0716-1
"G9,C8",14992,15416,11362,4054,8166,0,3746,3751,2619,1132,2.31360424,1759,6502,2424,1167,2,1165,2,263,0,0.092703863,empty,mBC-0716-1
"G9,C9",13219,13537,9746,3791,7079,0,3347,3356,2357,999,2.359359359,1675,30354,9117,4692,4,4688,2,627,0,0.120520478,empty,mBC-0716-1
"G9,C10",13347,13887,10254,3633,7397,0,3273,3287,2270,1017,2.232055064,1600,1152,737,366,0,366,0,118,0,0.024590164,empty,mBC-0716-1
"G9,C11",11738,12187,8859,3328,6552,0,3100,3107,2148,959,2.23983316,1451,822,434,251,0,251,0,101,0,0.059760956,empty,mBC-0716-1
"G9,C12",20114,20580,15290,5290,10788,0,4855,4867,3379,1488,2.270833333,2314,1203,861,414,0,414,0,115,0,0.09178744,empty,mBC-0716-1
"G9,D1",11109,11530,8334,3196,6232,0,2931,2941,2031,910,2.231868132,1447,2555,894,491,0,491,0,123,0,0.010183299,empty,mBC-0716-1
"G9,D2",21112,21450,16322,5128,11351,0,4969,4979,3436,1543,2.226830849,2305,2267,1445,826,0,826,0,240,0,0.060532688,empty,mBC-0716-1
"G9,D3",636363,704908,456777,248131,379083,1,210656,210993,167647,43346,3.86764638,116271,92530,63121,31357,9,31348,2,2666,0,0.001116499,mm10,mBC-0716-1
"G9,D4",14388,14525,10895,3630,7742,0,3443,3459,2359,1100,2.144545455,1632,2978,1224,655,1,654,1,179,0,0.071865443,empty,mBC-0716-1
"G9,D5",13955,14277,10605,3672,7626,0,3500,3504,2504,1000,2.504,1661,1251,807,419,0,419,0,132,0,0.069212411,empty,mBC-0716-1
"G9,D6",12125,12694,9100,3594,6803,0,3176,3185,2227,958,2.324634656,1611,1418,719,374,0,374,0,134,0,0.053475936,empty,mBC-0716-1
"G9,D7",12742,13273,9714,3559,7075,0,3288,3302,2287,1015,2.25320197,1593,1455,896,522,0,522,0,180,0,0.024904215,empty,mBC-0716-1
"G9,D8",750035,809144,553524,255620,429137,1,220658,221012,171905,49107,3.500621093,116439,63688,44374,21923,3,21920,2,2205,0,0.001186131,mm10,mBC-0716-1
"G9,D9",4639,4571,3457,1114,2512,0,1143,1145,838,307,2.729641694,535,1204,735,380,0,380,0,133,0,0.028947368,empty,mBC-0716-1
"G9,D10",15008,15684,11392,4292,8409,0,3967,3971,2861,1110,2.577477477,1962,825,534,283,0,283,0,102,0,0.070671378,empty,mBC-0716-1
"G9,D11",682139,756090,481213,274877,403782,1,231970,232257,192247,40010,4.804973757,127606,108441,75255,36930,10,36920,1,2945,0,0.004577465,mm10,mBC-0716-1
"G9,D12",20486,20769,15746,5023,10992,0,4855,4875,3435,1440,2.385416667,2258,2804,1800,885,1,884,1,223,0,0.102941176,empty,mBC-0716-1
"G9,E1",21589,22129,16632,5497,11713,0,5123,5127,3652,1475,2.475932203,2391,1832,1196,620,0,620,0,209,0,0.04516129,empty,mBC-0716-1
"G9,E2",1261942,1335102,913194,421908,705643,0,376832,377388,307665,69723,4.412675875,196967,169978,122084,60476,24,60452,2,3971,0,0.000479719,mm10,mBC-0716-1
"G9,E3",12919,13195,9715,3480,7116,0,3133,3143,2196,947,2.318901795,1563,16110,5360,2821,2,2819,1,524,0,0.015608372,empty,mBC-0716-1
"G9,E4",15371,15681,11874,3807,8328,0,3718,3732,2649,1083,2.44598338,1729,6900,2414,1265,0,1265,0,251,0,0.026086957,empty,mBC-0716-1
"G9,E5",21013,21581,16259,5322,11298,0,4874,4880,3394,1486,2.283983849,2295,10415,3463,1849,0,1849,0,347,0,0.056787453,empty,mBC-0716-1
"G9,E6",13461,13492,10477,3015,7228,0,3163,3167,2215,952,2.326680672,1432,1532,902,459,0,459,0,146,0,0.002178649,empty,mBC-0716-1
"G9,E7",13912,14000,10803,3197,7484,0,3316,3329,2283,1046,2.182600382,1467,1260,868,475,0,475,0,136,0,0.109473684,empty,mBC-0716-1
"G9,E8",17355,17414,13401,4013,9380,0,4078,4089,2874,1215,2.365432099,1804,2573,1602,844,0,844,0,208,0,0.129146919,empty,mBC-0716-1
"G9,E9",9397,9556,7098,2458,5123,0,2325,2332,1636,696,2.350574713,1148,904,590,324,0,324,0,122,0,0.077160494,empty,mBC-0716-1
"G9,E10",13369,13548,10112,3436,7246,0,3377,3382,2369,1013,2.338598223,1582,1495,923,519,0,519,0,135,0,0.098265896,empty,mBC-0716-1
"G9,E11",9107,9213,6980,2233,4941,0,2173,2178,1469,709,2.071932299,1013,919,576,321,0,321,0,126,0,0.021806854,empty,mBC-0716-1
"G9,E12",920840,981647,680991,300656,527095,3,268455,268940,212003,56937,3.723466287,140541,112811,78408,38709,9,38700,3,3100,0,0.001912145,mm10,mBC-0716-1
"G9,F1",17880,18071,13720,4351,9503,0,4131,4136,2920,1216,2.401315789,1932,1357,925,472,1,471,1,138,0,0.014861996,empty,mBC-0716-1
"G9,F2",23657,24745,17770,6975,13056,0,6180,6198,4277,1921,2.22644456,3044,2827,1835,903,1,902,1,269,0,0.017738359,empty,mBC-0716-1
"G9,F3",16244,16791,12341,4450,8991,0,4228,4239,2961,1278,2.316901408,2039,1665,1025,588,1,587,1,215,0,0.02044293,empty,mBC-0716-1
"G9,F4",16566,16850,12530,4320,9196,1,4105,4114,2853,1261,2.262490087,1911,623,375,214,0,214,0,93,0,0.03271028,empty,mBC-0716-1
"G9,F5",987506,1084821,693055,391766,567438,1,330100,330514,269013,61501,4.374123998,180843,101706,68867,34233,14,34219,2,2816,0,0.000847482,mm10,mBC-0716-1
"G9,F6",23016,23763,17396,6367,12566,0,5750,5763,4002,1761,2.272572402,2791,2234,1423,711,0,711,0,217,0,0.088607595,empty,mBC-0716-1
"G9,F7",783864,904201,511152,393049,491211,0,323645,324040,242983,81057,2.997680644,191986,39787,28669,14080,6,14074,2,1542,0,0.001207901,mm10,mBC-0716-1
"G9,F8",23557,24100,17971,6129,12582,0,5597,5608,3920,1688,2.322274882,2672,452,189,102,0,102,0,53,0,0.009803922,empty,mBC-0716-1
"G9,F9",825932,871454,604085,267369,460058,1,230882,231285,198966,32319,6.156316718,119380,211942,153655,76533,29,76504,5,4173,0,0.000339852,mm10,mBC-0716-1
"G9,F10",20771,21101,16049,5052,11095,0,4862,4869,3440,1429,2.407277817,2206,6249,2220,1145,0,1145,0,260,0,0.060262009,empty,mBC-0716-1
"G9,F11",11210,11300,8681,2619,6076,0,2646,2651,1900,751,2.529960053,1170,954,598,344,0,344,0,128,0,0.061046512,empty,mBC-0716-1
"G9,F12",14280,14422,10777,3645,7565,0,3422,3447,2446,1001,2.443556444,1643,865,303,163,0,163,0,42,0,0.030674847,empty,mBC-0716-1
"G9,G1",10248,10479,7967,2512,5552,0,2401,2414,1666,748,2.227272727,1119,1661,1108,550,1,549,1,147,0,0.014571949,empty,mBC-0716-1
"G9,G2",20673,20924,15810,5114,10989,0,4937,4946,3485,1461,2.385352498,2321,639,310,159,0,159,0,66,0,0.050314465,empty,mBC-0716-1
"G9,G3",21598,21997,16343,5654,11782,0,5512,5520,3914,1606,2.437110834,2551,2282,1352,698,0,698,0,219,0,0.018624642,empty,mBC-0716-1
"G9,G4",28380,29103,21845,7258,15194,0,6658,6674,4802,1872,2.56517094,3114,82,62,42,0,42,0,25,0,0.071428571,empty,mBC-0716-1
"G9,G5",789958,874586,553607,320979,461447,0,268213,268598,218843,49755,4.39841222,148618,60456,42661,21600,9,21591,1,2128,0,0.006252605,mm10,mBC-0716-1
"G9,G6",24446,24655,19001,5654,13052,0,5637,5650,3994,1656,2.411835749,2506,321,222,124,1,123,1,47,0,0.130081301,empty,mBC-0716-1
"G9,G7",20058,20321,15530,4791,10759,0,4678,4689,3316,1373,2.415149308,2101,11416,4289,2319,2,2317,2,461,0,0.047043591,empty,mBC-0716-1
"G9,G8",14388,14913,10916,3997,7929,0,3559,3569,2501,1068,2.3417603,1799,1288,802,448,0,448,0,167,0,0.055803571,empty,mBC-0716-1
"G9,G9",11031,11264,8239,3025,5986,0,2794,2800,1983,817,2.427172583,1388,1235,881,503,0,503,0,184,0,0.079522863,empty,mBC-0716-1
"G9,G10",997956,1093454,674862,418592,569468,0,350451,350936,277267,73669,3.763686218,195745,78160,52215,25765,11,25754,1,2397,0,0.002019104,mm10,mBC-0716-1
"G9,G11",12361,12705,9458,3247,6844,0,3146,3155,2235,920,2.429347826,1524,706,443,227,0,227,0,98,0,0.022026432,empty,mBC-0716-1
"G9,G12",11601,11841,8906,2935,6353,0,2846,2860,1993,867,2.298731257,1347,1056,627,346,0,346,0,124,0,0.028901734,empty,mBC-0716-1
"G9,H1",942622,1016168,680596,335572,532246,2,286922,287369,242856,44513,5.45584436,151867,76472,52810,26383,8,26375,1,2398,0,0.003450237,mm10,mBC-0716-1
"G9,H2",1189122,1302454,847445,455009,674923,3,380299,380773,295060,85713,3.442418303,207890,108865,78489,39608,11,39597,3,2933,0,0.001616284,mm10,mBC-0716-1
"G9,H3",742225,763388,552145,211243,402775,2,190651,190970,159700,31270,5.107131436,95211,82572,59445,29898,15,29883,2,2503,0,0.003513703,mm10,mBC-0716-1
"G9,H4",13761,14279,10346,3933,7607,0,3500,3516,2442,1074,2.273743017,1750,565,202,106,0,106,0,34,0,0.056603774,empty,mBC-0716-1
"G9,H5",18411,18978,14007,4971,10150,0,4720,4733,3360,1373,2.447195921,2248,1639,1113,587,0,587,0,164,0,0.073253833,empty,mBC-0716-1
"G9,H6",13921,14440,10623,3817,7785,0,3642,3646,2566,1080,2.375925926,1792,1400,929,510,0,510,0,160,0,0.098039216,empty,mBC-0716-1
"G9,H7",17711,17935,13376,4559,9591,0,4376,4388,3054,1334,2.289355322,2044,7040,2573,1411,0,1411,0,338,0,0.057406095,empty,mBC-0716-1
"G9,H8",742085,831487,505899,325588,438089,1,264134,264506,217823,46683,4.666002613,150380,116420,77071,38309,22,38287,2,3170,0,0.001436519,mm10,mBC-0716-1
"G9,H9",17318,17985,13134,4851,9608,0,4382,4388,3157,1231,2.564581641,2218,1818,994,505,0,505,0,156,0,0.027722772,empty,mBC-0716-1
"G9,H10",14040,14600,10578,4022,7815,0,3602,3611,2516,1095,2.297716895,1801,1238,823,426,0,426,0,142,0,0.056338028,empty,mBC-0716-1
"G9,H11",16982,17256,13039,4217,9082,0,4107,4118,2875,1243,2.312952534,1901,119,74,49,0,49,0,36,0,0.040816327,empty,mBC-0716-1
"G9,H12",6143,6348,4616,1732,3475,0,1619,1620,1161,459,2.529411765,771,716,486,254,0,254,0,80,0,0.114173228,empty,mBC-0716-1
"G10,A1",15273,15997,11652,4345,8561,0,4048,4053,2781,1272,2.186320755,1973,977,675,297,1,296,1,89,0,0.010135135,empty,mBC-0716-1
"G10,A2",19818,20217,15303,4914,10442,0,4543,4555,3128,1427,2.192011212,2070,1026,627,320,0,320,0,110,0,0.009375,empty,mBC-0716-1
"G10,A3",17585,18173,13398,4775,9598,0,4461,4477,3097,1380,2.244202899,2142,1443,611,329,0,329,0,98,0,0.124620061,empty,mBC-0716-1
"G10,A4",22478,22802,17374,5428,11808,0,5028,5042,3529,1513,2.332452082,2335,2255,746,403,0,403,0,93,0,0.05707196,empty,mBC-0716-1
"G10,A5",18035,18604,13660,4944,9680,0,4306,4310,3042,1268,2.399053628,2052,8816,2846,1326,0,1326,0,266,0,0.006033183,empty,mBC-0716-1
"G10,A6",390194,422646,282129,140517,229199,0,122819,123027,70866,52161,1.358601254,68681,9758,5242,2537,2,2535,1,480,0,0.016962525,mm10,mBC-0716-1
"G10,A7",942487,1078541,633473,445068,563310,0,353571,354087,255897,98190,2.606141155,206572,120417,80140,38308,22,38286,3,2945,0,0.001854464,mm10,mBC-0716-1
"G10,A8",11709,11946,8893,3053,6368,0,2976,2980,2073,907,2.285556781,1376,1271,787,390,0,390,0,129,0,0.025641026,empty,mBC-0716-1
"G10,A9",20803,21479,16077,5402,11002,0,4722,4745,3344,1401,2.386866524,2235,1295,856,393,0,393,0,104,0,0.086513995,empty,mBC-0716-1
"G10,A10",794346,904484,553278,351206,469553,3,289989,290425,186062,104363,1.782834913,162719,22357,13470,6443,0,6443,0,932,0,0.008536396,mm10,mBC-0716-1
"G10,A11",18912,19226,14552,4674,10265,0,4508,4521,3208,1313,2.443259711,2059,1353,692,343,1,342,1,97,0,0.035087719,empty,mBC-0716-1
"G10,A12",20915,20941,16232,4709,10801,0,4612,4624,3310,1314,2.519025875,2023,3076,1711,857,0,857,0,199,0,0.091015169,empty,mBC-0716-1
"G10,B1",20131,21031,15514,5517,10867,0,4774,4788,3341,1447,2.308914997,2290,1011,619,297,0,297,0,98,0,0.094276094,empty,mBC-0716-1
"G10,B2",20395,20558,15586,4972,10773,0,4671,4684,3232,1452,2.225895317,2178,466,280,151,0,151,0,55,0,0.01986755,empty,mBC-0716-1
"G10,B3",19060,19507,14585,4922,10366,0,4629,4644,3226,1418,2.275035261,2258,1084,667,378,0,378,0,129,0,0.079365079,empty,mBC-0716-1
"G10,B4",18142,18703,13761,4942,9715,0,4446,4452,3096,1356,2.283185841,2113,7924,3000,1564,1,1563,1,311,0,0.046705054,empty,mBC-0716-1
"G10,B5",589539,403766,212496,191270,276054,5,186752,187540,136316,51224,2.661174449,117675,33007,19620,9155,1,9154,1,1214,0,0.003604981,mm10,mBC-0716-1
"G10,B6",12519,12834,9584,3250,6946,0,3186,3192,2179,1013,2.151036525,1520,1185,751,395,0,395,0,105,0,0.078481013,empty,mBC-0716-1
"G10,B7",16688,16921,12910,4011,8957,0,3944,3952,2779,1173,2.36913896,1781,3301,1399,650,0,650,0,153,0,0.030769231,empty,mBC-0716-1
"G10,B8",13474,13596,10512,3084,7254,0,3187,3201,2223,978,2.273006135,1419,1028,688,312,0,312,0,96,0,0.057692308,empty,mBC-0716-1
"G10,B9",16647,17170,12765,4405,8916,0,4098,4099,2804,1295,2.165250965,1943,725,460,222,0,222,0,59,0,0.045045045,empty,mBC-0716-1
"G10,B10",17218,16845,12616,4229,9267,0,4176,4190,2840,1350,2.103703704,2010,586,346,191,0,191,0,53,0,0.120418848,empty,mBC-0716-1
"G10,B11",18703,19256,14198,5058,10025,0,4667,4672,3396,1276,2.661442006,2263,196,124,75,0,75,0,34,0,0,empty,mBC-0716-1
"G10,B12",18819,19119,14348,4771,10082,0,4448,4460,3112,1348,2.308605341,2120,6525,2285,1167,0,1167,0,237,0,0.025706941,empty,mBC-0716-1
"G10,C1",22788,23123,17852,5271,11842,0,4984,5003,3564,1439,2.476719944,2183,680,448,242,0,242,0,74,0,0.053719008,empty,mBC-0716-1
"G10,C2",20320,20901,15328,5573,10946,0,5030,5034,3543,1491,2.376257545,2443,2081,1264,644,0,644,0,174,0,0.071428571,empty,mBC-0716-1
"G10,C3",22967,23577,17278,6299,12471,0,5790,5815,4070,1745,2.332378223,2889,505,323,170,0,170,0,64,0,0.035294118,empty,mBC-0716-1
"G10,C4",18742,19255,14323,4932,10180,0,4507,4510,3139,1371,2.289569657,2174,998,652,317,0,317,0,102,0,0.059936909,empty,mBC-0716-1
"G10,C5",17633,18127,13439,4688,9336,0,4208,4214,2972,1242,2.392914654,2006,1388,862,429,0,429,0,104,0,0.020979021,empty,mBC-0716-1
"G10,C6",19254,19705,14474,5231,10635,0,4875,4883,3558,1325,2.685283019,2358,1282,809,402,0,402,0,116,0,0.029850746,empty,mBC-0716-1
"G10,C7",17633,18096,13338,4758,9581,0,4323,4329,2989,1340,2.230597015,2112,3010,1070,557,0,557,0,121,0,0.078994614,empty,mBC-0716-1
"G10,C8",15644,16195,11845,4350,8616,0,3990,4006,2788,1218,2.288998358,1988,2734,1207,552,0,552,0,153,0,0.012681159,empty,mBC-0716-1
"G10,C9",13427,13877,10171,3706,7236,0,3347,3354,2357,997,2.364092277,1647,770,498,227,0,227,0,63,0,0,empty,mBC-0716-1
"G10,C10",14636,14868,11343,3525,7824,0,3477,3479,2422,1057,2.291390728,1583,3745,1537,781,0,781,0,161,0,0.112676056,empty,mBC-0716-1
"G10,C11",12602,13179,9577,3602,6847,0,3230,3232,2246,986,2.277890467,1562,885,574,259,0,259,0,74,0,0.038610039,empty,mBC-0716-1
"G10,C12",21015,21567,16057,5510,11169,0,5023,5043,3544,1499,2.364242829,2391,1227,809,431,0,431,0,113,0,0.032482599,empty,mBC-0716-1
"G10,D1",12506,12729,9409,3320,6787,0,3183,3190,2221,969,2.292053664,1553,1029,435,228,0,228,0,66,0,0.048245614,empty,mBC-0716-1
"G10,D2",21825,22066,16764,5302,11444,0,4886,4897,3413,1484,2.299865229,2306,6686,2621,1269,2,1267,1,276,0,0.036306235,empty,mBC-0716-1
"G10,D3",880992,919371,653427,265944,481265,0,237722,238098,190954,47144,4.050441201,120664,79859,56824,26658,6,26652,1,2385,0,0.000975537,mm10,mBC-0716-1
"G10,D4",14971,15692,11365,4327,8189,0,3792,3802,2546,1256,2.027070064,1901,1083,680,296,0,296,0,112,0,0.02027027,empty,mBC-0716-1
"G10,D5",14973,15437,11254,4183,8149,0,3685,3695,2594,1101,2.356039964,1798,1136,735,377,0,377,0,121,0,0.01061008,empty,mBC-0716-1
"G10,D6",13025,13527,9912,3615,7039,0,3190,3200,2201,999,2.203203203,1584,1185,782,416,0,416,0,105,0,0.050480769,empty,mBC-0716-1
"G10,D7",796422,886013,550898,335115,464373,0,271505,271888,223163,48725,4.580051308,152398,194720,139511,66186,23,66163,2,3794,0,0.000589453,mm10,mBC-0716-1
"G10,D8",16242,16626,12316,4310,8789,0,4085,4091,2830,1261,2.244250595,1924,761,429,218,0,218,0,77,0,0.018348624,empty,mBC-0716-1
"G10,D9",5739,5973,4186,1787,3249,0,1603,1607,1123,484,2.320247934,812,1442,927,465,0,465,0,113,0,0.068817204,empty,mBC-0716-1
"G10,D10",1400258,1464285,1035074,429211,760408,0,386039,386697,308476,78221,3.943646847,196410,73672,46352,22592,8,22584,2,2237,0,0.002125399,mm10,mBC-0716-1
"G10,D11",14157,14421,10666,3755,7588,0,3448,3455,2383,1072,2.222947761,1608,1406,975,476,0,476,0,130,0,0.06512605,empty,mBC-0716-1
"G10,D12",686434,756605,477445,279160,402808,2,231084,231423,136241,95182,1.431373579,135317,13954,9567,4519,3,4516,1,730,0,0.007307352,mm10,mBC-0716-1
"G10,E1",22799,23267,17586,5681,12021,0,5214,5225,3689,1536,2.401692708,2403,1355,825,406,0,406,0,143,0,0.041871921,empty,mBC-0716-1
"G10,E2",17316,18103,13221,4882,9463,0,4300,4310,3012,1298,2.320493066,2068,3977,1566,732,0,732,0,177,0,0.050546448,empty,mBC-0716-1
"G10,E3",12650,12905,9753,3152,6906,0,3053,3057,2087,970,2.151546392,1430,7236,2481,1264,2,1262,2,250,0,0.027733756,empty,mBC-0716-1
"G10,E4",15855,16542,12132,4410,8487,0,3811,3815,2707,1108,2.443140794,1884,1105,676,351,0,351,0,116,0,0.042735043,empty,mBC-0716-1
"G10,E5",21905,22139,17050,5089,11689,0,5116,5128,3633,1495,2.430100334,2309,1148,739,391,0,391,0,130,0,0.028132992,empty,mBC-0716-1
"G10,E6",13886,13967,10673,3294,7388,0,3169,3183,2277,906,2.513245033,1427,5525,2211,1101,1,1100,1,208,0,0.034545455,empty,mBC-0716-1
"G10,E7",15251,15597,11782,3815,8092,0,3625,3632,2501,1131,2.211317418,1673,1434,942,444,0,444,0,110,0,0.101351351,empty,mBC-0716-1
"G10,E8",18687,18864,14452,4412,9905,0,4250,4262,2963,1299,2.280985373,1926,2187,1344,678,1,677,1,161,0,0.029542097,empty,mBC-0716-1
"G10,E9",9846,10197,7556,2641,5398,0,2493,2501,1792,709,2.527503526,1177,1126,657,348,0,348,0,101,0,0.037356322,empty,mBC-0716-1
"G10,E10",13830,14016,10490,3526,7373,0,3346,3353,2304,1049,2.196377502,1602,929,591,314,0,314,0,96,0,0.136942675,empty,mBC-0716-1
"G10,E11",10076,10313,7460,2853,5500,0,2553,2562,1746,816,2.139705882,1278,11424,4055,1972,2,1970,1,363,0,0.101015228,empty,mBC-0716-1
"G10,E12",16015,16426,12050,4376,8706,0,3997,4007,2775,1232,2.252435065,1954,1322,805,394,0,394,0,123,0,0.007614213,empty,mBC-0716-1
"G10,F1",18557,18864,14161,4703,9843,0,4371,4379,2975,1404,2.118945869,2062,3953,1716,867,1,866,1,175,0,0.053117783,empty,mBC-0716-1
"G10,F2",949659,1067061,644299,422762,558255,1,340561,341050,281499,59551,4.727023895,194260,151448,103384,49301,21,49280,2,3405,0,0.001988636,mm10,mBC-0716-1
"G10,F3",17078,17741,12876,4865,9255,0,4280,4292,2988,1304,2.291411043,2070,1540,986,476,0,476,0,148,0,0.069327731,empty,mBC-0716-1
"G10,F4",18561,18938,13910,5028,10076,1,4515,4528,3153,1375,2.293090909,2244,685,380,186,0,186,0,83,0,0.14516129,empty,mBC-0716-1
"G10,F5",25560,26517,19393,7124,13610,1,6144,6158,4360,1798,2.424916574,2964,1442,878,474,0,474,0,151,0,0.048523207,empty,mBC-0716-1
"G10,F6",25481,26214,19386,6828,13557,0,6195,6210,4383,1827,2.399014778,2965,1989,1253,614,0,614,0,176,0,0.07980456,empty,mBC-0716-1
"G10,F7",20561,21264,15788,5476,11308,0,5014,5054,3506,1548,2.264857881,2382,812,540,303,0,303,0,94,0,0.02640264,empty,mBC-0716-1
"G10,F8",23872,24774,18277,6497,12994,0,5977,5995,4257,1738,2.449367089,2877,327,188,109,0,109,0,43,0,0,empty,mBC-0716-1
"G10,F9",1601217,1703313,1142081,561232,885794,1,498072,498794,384539,114255,3.365620761,263949,165110,94162,44840,25,44815,7,3612,0,0.006604931,mm10,mBC-0716-1
"G10,F10",1754894,1906015,1269445,636570,979667,2,544311,545132,436727,108405,4.02866104,291382,180899,122351,57507,32,57475,3,3691,0,0.001705089,mm10,mBC-0716-1
"G10,F11",11823,12071,9081,2990,6349,0,2756,2761,1902,859,2.214202561,1274,13835,4311,2082,6,2076,3,381,0,0.01734104,empty,mBC-0716-1
"G10,F12",14524,14823,11000,3823,7698,0,3429,3435,2428,1007,2.411122145,1648,357,195,87,0,87,0,22,0,0,empty,mBC-0716-1
"G10,G1",10256,10513,7998,2515,5579,0,2375,2377,1631,746,2.186327078,1063,1804,1203,607,0,607,0,156,0,0.02306425,empty,mBC-0716-1
"G10,G2",21911,21954,16874,5080,11386,0,4938,4953,3449,1504,2.293218085,2256,2497,860,437,0,437,0,93,0,0.029748284,empty,mBC-0716-1
"G10,G3",21287,21797,16341,5456,11549,0,5172,5178,3517,1661,2.117399157,2466,2103,1362,696,0,696,0,186,0,0.028735632,empty,mBC-0716-1
"G10,G4",29446,29793,22669,7124,15623,0,6799,6808,4838,1970,2.455837563,3172,112,43,31,0,31,0,23,0,0,empty,mBC-0716-1
"G10,G5",652759,682678,498172,184506,359268,1,166017,166304,132671,33633,3.94466744,81963,62699,44421,21516,9,21507,2,1965,0,0.00092993,mm10,mBC-0716-1
"G10,G6",25776,25839,19991,5848,13605,0,5782,5786,4116,1670,2.464670659,2615,262,189,92,0,92,0,32,0,0.119565217,empty,mBC-0716-1
"G10,G7",21089,21779,16457,5322,11394,0,5051,5066,3545,1521,2.330703485,2413,1419,907,449,0,449,0,129,0,0.057906459,empty,mBC-0716-1
"G10,G8",15217,15649,11646,4003,8126,0,3746,3762,2665,1097,2.42935278,1770,1228,753,386,0,386,0,130,0,0.020725389,empty,mBC-0716-1
"G10,G9",11125,11524,8518,3006,6083,0,2826,2831,2017,814,2.477886978,1331,1012,556,303,1,302,1,118,0,0.033112583,empty,mBC-0716-1
"G10,G10",925484,1048910,628176,420734,552520,1,344717,345167,279969,65198,4.294134789,196584,85760,60974,28884,13,28871,1,2587,0,0.001697205,mm10,mBC-0716-1
"G10,G11",12976,13195,9870,3325,6928,0,3101,3114,2209,905,2.440883978,1481,3385,1460,737,1,736,1,144,0,0.044836957,empty,mBC-0716-1
"G10,G12",841293,907550,618163,289387,480662,1,251903,252305,201675,50630,3.98331029,132200,111669,78849,37961,15,37946,1,2677,0,0.003636747,mm10,mBC-0716-1
"G10,H1",22035,22586,16716,5870,11737,0,5270,5282,3789,1493,2.537843269,2500,1064,644,321,0,321,0,100,0,0.043613707,empty,mBC-0716-1
"G10,H2",25065,25931,19241,6690,13298,0,5916,5924,4128,1796,2.29844098,2857,7474,2383,1181,2,1179,2,240,0,0.016115352,empty,mBC-0716-1
"G10,H3",21485,22087,16382,5705,11512,0,5226,5239,3725,1514,2.460369881,2487,1595,1070,575,0,575,0,155,0,0.045217391,empty,mBC-0716-1
"G10,H4",14279,14689,10745,3944,7858,0,3729,3743,2559,1184,2.161317568,1824,151,105,52,0,52,0,18,0,0.019230769,empty,mBC-0716-1
"G10,H5",19208,19938,14449,5489,10379,0,4807,4813,3369,1444,2.333102493,2370,1381,938,450,0,450,0,122,0,0.055555556,empty,mBC-0716-1
"G10,H6",15758,16177,11908,4269,8527,0,3979,3982,2795,1187,2.354675653,1854,1355,902,462,0,462,0,143,0,0.047619048,empty,mBC-0716-1
"G10,H7",18467,18821,14177,4644,10070,0,4688,4701,3251,1450,2.242068966,2181,1121,771,398,0,398,0,146,0,0.035175879,empty,mBC-0716-1
"G10,H8",19351,19980,14533,5447,10577,1,5026,5035,3551,1484,2.392857143,2505,1296,826,432,0,432,0,135,0,0.009259259,empty,mBC-0716-1
"G10,H9",16650,16916,12777,4139,8978,0,3996,4004,2801,1203,2.328345802,1856,1225,814,396,1,395,1,119,0,0.091139241,empty,mBC-0716-1
"G10,H10",520646,573739,368770,204969,307313,1,173526,173782,134404,39378,3.413174869,96311,29240,20937,9960,4,9956,1,1242,0,0.000803536,mm10,mBC-0716-1
"G10,H11",18247,18627,13837,4790,9827,0,4541,4547,3145,1402,2.243223966,2147,147,68,42,0,42,0,26,0,0,empty,mBC-0716-1
"G10,H12",6742,6917,5019,1898,3643,0,1679,1679,1193,486,2.45473251,805,675,394,220,0,220,0,67,0,0.086363636,empty,mBC-0716-1
"G11,A1",14448,15121,10844,4277,8176,0,3923,3927,2765,1162,2.379518072,1936,1039,609,302,0,302,0,95,0,0.066225166,empty,mBC-0716-1
"G11,A2",19139,19577,14785,4792,10311,0,4525,4539,3198,1341,2.384787472,2121,946,540,319,0,319,0,113,0,0.062695925,empty,mBC-0716-1
"G11,A3",16547,16996,12543,4453,8980,0,4159,4170,2958,1212,2.440594059,2024,647,396,207,0,207,0,72,0,0.111111111,empty,mBC-0716-1
"G11,A4",21215,21379,16257,5122,11155,0,4814,4823,3432,1391,2.46728972,2281,612,357,196,0,196,0,68,0,0.035714286,empty,mBC-0716-1
"G11,A5",16784,17085,12767,4318,9078,0,4082,4098,2814,1284,2.191588785,1966,1288,744,385,0,385,0,126,0,0.088311688,empty,mBC-0716-1
"G11,A6",371053,383932,277295,106637,207937,0,98876,99076,70060,29016,2.414529915,49563,64000,24690,12326,11,12315,2,1724,0,0.025659765,mm10,mBC-0716-1
"G11,A7",16563,16878,12712,4166,9101,0,4186,4194,2930,1264,2.318037975,1987,1110,704,345,0,345,0,104,0,0.075362319,empty,mBC-0716-1
"G11,A8",589731,640471,438013,202458,340323,1,175143,175423,135478,39945,3.391613469,91875,72543,51249,24938,12,24926,3,2321,0,0.000882613,mm10,mBC-0716-1
"G11,A9",1038695,1100894,768177,332717,565899,1,288443,288896,238084,50812,4.685586082,147686,102406,52428,25838,13,25825,3,2371,0,0.018818974,mm10,mBC-0716-1
"G11,A10",15612,15721,11820,3901,8408,0,3809,3814,2619,1195,2.191631799,1763,2256,779,403,0,403,0,83,0,0,empty,mBC-0716-1
"G11,A11",17889,18254,13625,4629,9729,0,4411,4424,3156,1268,2.488958991,2097,1018,601,321,0,321,0,95,0,0.093457944,empty,mBC-0716-1
"G11,A12",20449,20689,15709,4980,10706,0,4710,4729,3296,1433,2.300069784,2203,2438,1539,746,0,746,0,178,0,0.065683646,empty,mBC-0716-1
"G11,B1",982538,1124330,667564,456766,585961,2,361534,362030,293595,68435,4.29012932,207533,105046,71259,34241,13,34228,1,2787,0,0.002161973,mm10,mBC-0716-1
"G11,B2",686642,717104,489790,227314,382774,2,202698,202982,142253,60729,2.342422895,108582,3645,2389,1195,0,1195,0,263,0,0.014225941,mm10,mBC-0716-1
"G11,B3",18789,19342,14519,4823,10226,1,4594,4603,3231,1372,2.354956268,2190,914,549,296,0,296,0,107,0,0.067567568,empty,mBC-0716-1
"G11,B4",17098,17410,13070,4340,9216,0,4158,4172,3022,1150,2.627826087,2017,1120,671,349,0,349,0,94,0,0.097421203,empty,mBC-0716-1
"G11,B5",9124,5511,3909,1602,3763,1,1761,1775,1230,545,2.256880734,937,534,335,173,0,173,0,61,0,0.098265896,empty,mBC-0716-1
"G11,B6",12298,12646,9353,3293,6712,0,3102,3109,2141,968,2.21177686,1491,14820,4684,2380,2,2378,2,412,0,0.120269134,empty,mBC-0716-1
"G11,B7",15814,16553,12226,4327,8630,0,3862,3872,2711,1161,2.335055986,1844,750,488,241,0,241,0,80,0,0.01659751,empty,mBC-0716-1
"G11,B8",13327,13521,10267,3254,7226,0,3254,3258,2264,994,2.277665996,1524,723,501,299,0,299,0,108,0,0.030100334,empty,mBC-0716-1
"G11,B9",536729,570359,401116,169243,303534,0,152738,153006,114848,38158,3.009801352,78500,15267,9685,4693,1,4692,1,774,0,0.002983802,mm10,mBC-0716-1
"G11,B10",16871,16908,12394,4514,9367,0,4407,4432,3075,1357,2.266028003,2114,2351,788,388,0,388,0,89,0,0.06185567,empty,mBC-0716-1
"G11,B11",857854,942752,595394,347358,490909,2,287338,287727,237297,50430,4.705472933,159270,11002,7676,3709,1,3708,1,614,0,0,mm10,mBC-0716-1
"G11,B12",18377,18546,13895,4651,9926,0,4491,4498,3171,1327,2.389600603,2134,3307,1378,711,0,711,0,165,0,0.180028129,empty,mBC-0716-1
"G11,C1",22307,22297,17494,4803,11576,0,4892,4906,3494,1412,2.474504249,2197,1569,567,319,0,319,0,101,0,0.037617555,empty,mBC-0716-1
"G11,C2",624524,677552,452514,225038,359912,1,190827,191130,159699,31431,5.0809392,101779,101401,71925,34720,15,34705,1,2801,0,0.002650915,mm10,mBC-0716-1
"G11,C3",623492,641740,463599,178141,342208,2,166365,166633,127736,38897,3.283955061,83809,7416,4301,2001,4,1997,2,403,0,0.007511267,mm10,mBC-0716-1
"G11,C4",17342,17415,13385,4030,9241,0,4031,4040,2919,1121,2.603925067,1750,3727,1270,655,0,655,0,173,0,0.038167939,empty,mBC-0716-1
"G11,C5",16181,16426,12356,4070,8792,0,3965,3983,2766,1217,2.272801972,1877,1062,638,356,0,356,0,102,0,0.056179775,empty,mBC-0716-1
"G11,C6",859827,912603,627226,285377,491279,1,253826,254220,208763,45457,4.592538003,132630,73922,52039,24643,6,24637,2,2309,0,0.000811787,mm10,mBC-0716-1
"G11,C7",841176,915974,599640,316334,478971,1,263654,264031,223263,40768,5.47642759,143161,20571,13005,6265,2,6263,2,907,0,0.000159668,mm10,mBC-0716-1
"G11,C8",15018,15340,11186,4154,8199,0,3783,3792,2673,1119,2.388739946,1830,4685,1783,934,0,934,0,229,0,0.028907923,empty,mBC-0716-1
"G11,C9",12415,12991,9296,3695,6860,0,3247,3255,2286,969,2.359133127,1637,659,425,224,0,224,0,74,0,0,empty,mBC-0716-1
"G11,C10",13559,13863,10274,3589,7387,0,3377,3390,2314,1076,2.150557621,1676,679,432,224,0,224,0,77,0,0.03125,empty,mBC-0716-1
"G11,C11",11598,12079,8715,3364,6501,0,3109,3114,2155,959,2.24713243,1548,982,506,248,0,248,0,91,0,0.100806452,empty,mBC-0716-1
"G11,C12",22780,23746,16962,6784,12352,1,5851,5866,4132,1734,2.382929642,2954,10643,3230,1652,1,1651,1,324,0,0.018776499,empty,mBC-0716-1
"G11,D1",11989,12429,8932,3497,6749,0,3244,3257,2327,930,2.502150538,1615,371,172,101,0,101,0,34,0,0.00990099,empty,mBC-0716-1
"G11,D2",20432,20909,16002,4907,10900,0,4670,4678,3214,1464,2.195355191,2104,1641,1040,551,0,551,0,167,0,0.039927405,empty,mBC-0716-1
"G11,D3",13860,14268,10397,3871,7625,0,3543,3548,2387,1161,2.055986219,1737,756,427,234,0,234,0,93,0,0.034188034,empty,mBC-0716-1
"G11,D4",1543186,1763800,1055075,708725,918237,0,562475,563133,429943,133190,3.228042646,325458,152842,100323,48080,19,48061,1,3534,0,0.000728241,mm10,mBC-0716-1
"G11,D5",789940,872796,554457,318339,461706,3,265316,265744,218034,47710,4.569985328,147218,63093,42834,20718,7,20711,1,2095,0,0.001303655,mm10,mBC-0716-1
"G11,D6",12459,13258,9315,3943,6986,0,3315,3321,2302,1019,2.259077527,1717,1323,807,426,0,426,0,119,0,0.077464789,empty,mBC-0716-1
"G11,D7",13502,14022,10074,3948,7345,0,3503,3508,2481,1027,2.415774099,1714,1311,821,405,1,404,1,143,0,0.024752475,empty,mBC-0716-1
"G11,D8",16135,16724,12161,4563,8915,0,4230,4244,2898,1346,2.153046062,2050,907,600,270,0,270,0,86,0,0.085185185,empty,mBC-0716-1
"G11,D9",5279,5474,3903,1571,2985,0,1468,1470,1091,379,2.878627968,722,11521,3545,1821,1,1820,1,329,0,0.043956044,empty,mBC-0716-1
"G11,D10",866256,992391,591410,400981,519878,1,321413,321804,245696,76108,3.228254586,185533,55937,36148,18047,6,18041,1,1842,0,0.002771465,mm10,mBC-0716-1
"G11,D11",12985,13611,10053,3558,7265,0,3331,3342,2382,960,2.48125,1593,1348,902,467,0,467,0,123,0,0.08993576,empty,mBC-0716-1
"G11,D12",19743,20230,15050,5180,10584,0,4817,4824,3411,1413,2.414012739,2299,2197,1403,686,0,686,0,190,0,0.087463557,empty,mBC-0716-1
"G11,E1",22052,22844,16710,6134,12126,0,5591,5602,3928,1674,2.346475508,2864,1376,898,483,1,482,1,144,0,0.109958506,empty,mBC-0716-1
"G11,E2",451601,441657,349433,92224,238196,1,94637,94832,76663,18169,4.219439705,42229,21253,14713,6959,4,6955,1,1028,0,0.009633357,mm10,mBC-0716-1
"G11,E3",12771,12962,9834,3128,6972,0,3105,3109,2138,971,2.201853759,1472,8965,2996,1615,1,1614,1,334,0,0.052664188,empty,mBC-0716-1
"G11,E4",15193,15466,11583,3883,8159,0,3690,3696,2584,1112,2.323741007,1714,1008,653,363,0,363,0,116,0,0.016528926,empty,mBC-0716-1
"G11,E5",20569,20834,16234,4600,10964,0,4781,4793,3383,1410,2.39929078,2083,881,569,302,0,302,0,97,0,0.102649007,empty,mBC-0716-1
"G11,E6",13931,14140,10575,3565,7420,0,3249,3255,2232,1023,2.181818182,1548,1180,694,338,1,337,1,95,0,0.130563798,empty,mBC-0716-1
"G11,E7",14551,14850,10979,3871,7826,0,3554,3559,2462,1097,2.244302644,1699,2006,993,519,0,519,0,127,0,0.08477842,empty,mBC-0716-1
"G11,E8",837383,894596,600731,293865,471411,0,253718,254132,203911,50221,4.060273591,134826,80567,52407,25032,10,25022,4,2296,0,0.002677644,mm10,mBC-0716-1
"G11,E9",9752,10093,7388,2705,5346,0,2449,2456,1770,686,2.580174927,1216,1161,717,357,0,357,0,100,0,0.044817927,empty,mBC-0716-1
"G11,E10",13074,13512,9951,3561,7140,0,3249,3255,2260,995,2.271356784,1563,1148,723,367,1,366,1,113,0,0.040983607,empty,mBC-0716-1
"G11,E11",9509,9916,7334,2582,5299,0,2453,2455,1696,759,2.234519104,1165,890,593,286,0,286,0,91,0,0.097902098,empty,mBC-0716-1
"G11,E12",15314,15849,11630,4219,8483,0,3909,3926,2751,1175,2.341276596,1874,2171,1079,505,1,504,1,129,0,0.113095238,empty,mBC-0716-1
"G11,F1",17628,18249,13586,4663,9456,0,4127,4145,2943,1202,2.448419301,1974,1025,706,390,0,390,0,113,0,0.064102564,empty,mBC-0716-1
"G11,F2",23104,24050,17417,6633,12753,0,5960,5975,4242,1733,2.447778419,2945,2291,1395,684,0,684,0,197,0,0.040935673,empty,mBC-0716-1
"G11,F3",16332,17255,12274,4981,9057,0,4298,4308,3055,1253,2.438148444,2146,1367,930,492,1,491,1,155,0,0.048879837,empty,mBC-0716-1
"G11,F4",17341,17725,12980,4745,9738,0,4457,4464,3106,1358,2.28718704,2202,428,222,101,0,101,0,55,0,0,empty,mBC-0716-1
"G11,F5",23475,23837,17961,5876,12635,0,5719,5726,4008,1718,2.332945285,2680,1461,823,450,0,450,0,139,0,0.008888889,empty,mBC-0716-1
"G11,F6",898823,1009958,623543,386415,527491,2,311441,311850,231515,80335,2.881869671,177653,97727,66381,32041,15,32026,2,2626,0,0.000936739,mm10,mBC-0716-1
"G11,F7",1372316,1476859,991761,485098,787517,0,436081,436681,353658,83023,4.259759344,230808,46511,29510,14292,6,14286,1,1701,0,0.012179756,mm10,mBC-0716-1
"G11,F8",1510116,1596571,1120983,475588,823751,2,422660,423340,343080,80260,4.274607526,216226,12136,8177,4018,3,4015,2,662,0,0.000498132,mm10,mBC-0716-1
"G11,F9",15229,15438,11937,3501,8191,1,3694,3698,2618,1080,2.424074074,1638,2848,1306,680,1,679,1,160,0,0.067746686,empty,mBC-0716-1
"G11,F10",20044,20326,15560,4766,10758,0,4734,4738,3387,1351,2.507031828,2157,4359,1479,741,0,741,0,189,0,0.04048583,empty,mBC-0716-1
"G11,F11",11640,12038,8911,3127,6413,0,2840,2843,1969,874,2.252860412,1374,646,395,211,0,211,0,90,0,0.014218009,empty,mBC-0716-1
"G11,F12",13696,14200,10446,3754,7405,0,3386,3389,2364,1025,2.306341463,1640,185,107,49,0,49,0,20,0,0.020408163,empty,mBC-0716-1
"G11,G1",10012,10394,7733,2661,5490,0,2504,2507,1679,828,2.027777778,1219,1580,1044,500,1,499,1,138,0,0.042084168,empty,mBC-0716-1
"G11,G2",1250480,1411696,825425,586271,727745,1,468968,469557,373384,96173,3.882420222,270476,16906,11077,5263,6,5257,3,742,0,0.002282671,mm10,mBC-0716-1
"G11,G3",814202,846124,614509,231615,439582,3,202729,203092,179941,23151,7.772493629,100666,126541,92269,43766,13,43753,1,3163,0,0.001005645,mm10,mBC-0716-1
"G11,G4",35070,36087,27072,9015,18829,0,8348,8372,5994,2378,2.520605551,3996,46,30,21,0,21,0,15,0,0,empty,mBC-0716-1
"G11,G5",14083,14117,10584,3533,7506,0,3382,3389,2448,941,2.601487779,1635,6213,2039,1037,0,1037,0,191,0,0.116682739,empty,mBC-0716-1
"G11,G6",24868,25074,18934,6140,13177,0,5872,5878,4055,1823,2.224355458,2687,934,368,185,0,185,0,66,0,0.027027027,empty,mBC-0716-1
"G11,G7",20110,19976,15279,4697,10607,0,4674,4692,3266,1426,2.290322581,2183,4500,1784,961,2,959,1,232,0,0.04379562,empty,mBC-0716-1
"G11,G8",481948,519016,348956,170060,275799,0,149247,149494,109335,40159,2.722552852,79753,17471,12102,5853,3,5850,1,882,0,0.004957265,mm10,mBC-0716-1
"G11,G9",10227,10708,7665,3043,5769,0,2708,2716,1871,845,2.214201183,1343,757,521,249,0,249,0,108,0,0.084337349,empty,mBC-0716-1
"G11,G10",13546,13900,10476,3424,7387,0,3337,3342,2380,962,2.474012474,1528,954,667,317,0,317,0,109,0,0.05362776,empty,mBC-0716-1
"G11,G11",12304,12223,9175,3048,6571,0,2977,2980,2049,931,2.200859291,1417,1693,790,441,0,441,0,107,0,0.095238095,empty,mBC-0716-1
"G11,G12",12013,12094,9165,2929,6421,1,2935,2941,2079,862,2.411832947,1321,996,685,337,0,337,0,116,0,0.023738872,empty,mBC-0716-1
"G11,H1",25146,26341,19198,7143,13718,0,6315,6330,4529,1801,2.514714048,3119,5009,2042,1088,0,1088,0,222,0,0.119485294,empty,mBC-0716-1
"G11,H2",24177,24550,18256,6294,12727,0,5672,5687,4044,1643,2.461351187,2733,13863,4526,2267,2,2265,2,381,0,0.087417219,empty,mBC-0716-1
"G11,H3",668949,704847,499629,205218,371129,1,178591,178883,148695,30188,4.925632702,90642,111917,78930,37839,15,37824,2,2802,0,0.001242597,mm10,mBC-0716-1
"G11,H4",13264,13564,10104,3460,7384,0,3404,3406,2397,1009,2.375619425,1614,113,63,35,0,35,0,26,0,0,empty,mBC-0716-1
"G11,H5",17902,18635,13682,4953,9857,0,4619,4621,3207,1414,2.268033946,2207,1246,763,376,0,376,0,129,0,0.034574468,empty,mBC-0716-1
"G11,H6",14450,14925,11049,3876,7935,0,3737,3742,2668,1074,2.484171322,1754,1361,879,473,0,473,0,132,0,0.002114165,empty,mBC-0716-1
"G11,H7",17530,18232,13279,4953,9622,0,4441,4448,3160,1288,2.453416149,2197,1161,664,363,0,363,0,153,0,0.022038567,empty,mBC-0716-1
"G11,H8",14024,14467,10683,3784,7640,0,3569,3573,2533,1040,2.435576923,1699,1357,863,453,0,453,0,136,0,0.037527594,empty,mBC-0716-1
"G11,H9",15779,16020,12027,3993,8578,0,3966,3980,2854,1126,2.534635879,1869,1272,790,410,0,410,0,128,0,0.048780488,empty,mBC-0716-1
"G11,H10",1155271,1235714,841724,393990,646789,1,334780,335317,266802,68515,3.894066993,179219,144262,92398,44298,18,44280,4,3353,0,0.00266486,mm10,mBC-0716-1
"G11,H11",17372,18495,13156,5339,9709,0,4579,4598,3203,1395,2.296057348,2366,188,78,50,1,49,1,34,0,0.020408163,empty,mBC-0716-1
"G11,H12",6282,6312,4701,1611,3464,0,1630,1632,1146,486,2.358024691,787,614,310,166,0,166,0,47,0,0.180722892,empty,mBC-0716-1
"G12,A1",14374,14964,10889,4075,8227,0,3899,3906,2797,1109,2.522091975,1922,1100,720,350,0,350,0,112,0,0.025714286,empty,mBC-0716-1
"G12,A2",18707,18956,14273,4683,9978,0,4363,4373,3024,1349,2.241660489,2010,914,592,341,0,341,0,124,0,0.04398827,empty,mBC-0716-1
"G12,A3",16575,16948,12550,4398,8989,1,4186,4208,2986,1222,2.443535188,1974,713,378,203,0,203,0,88,0,0.068965517,empty,mBC-0716-1
"G12,A4",21315,21686,16446,5240,11310,0,4928,4940,3460,1480,2.337837838,2299,561,257,141,0,141,0,52,0,0.063829787,empty,mBC-0716-1
"G12,A5",16924,17483,12902,4581,9189,0,4172,4180,2922,1258,2.322734499,2034,4498,1583,821,0,821,0,190,0,0.037758831,empty,mBC-0716-1
"G12,A6",534443,584387,389818,194569,309947,0,164262,164517,127559,36958,3.451458412,88234,115986,79118,37615,12,37603,2,2813,0,0.000638247,mm10,mBC-0716-1
"G12,A7",16497,17081,12435,4646,8925,0,4002,4010,2817,1193,2.361274099,1949,13813,4629,2304,0,2304,0,416,0,0.067274306,empty,mBC-0716-1
"G12,A8",11028,11428,8400,3028,6111,0,2861,2870,2035,835,2.437125749,1335,6948,2440,1282,0,1282,0,288,0,0.067862715,empty,mBC-0716-1
"G12,A9",18835,19212,14299,4913,9923,0,4361,4371,3091,1280,2.41484375,2079,980,627,309,0,309,0,119,0,0.045307443,empty,mBC-0716-1
"G12,A10",15721,16234,12033,4201,8554,0,3907,3919,2732,1187,2.301600674,1814,369,190,110,0,110,0,55,0,0,empty,mBC-0716-1
"G12,A11",18107,18245,13819,4426,9807,0,4378,4385,3101,1284,2.415109034,2004,915,546,304,0,304,0,118,0,0.042763158,empty,mBC-0716-1
"G12,A12",20591,20796,16063,4733,10824,0,4629,4643,3293,1350,2.439259259,2038,2466,1544,784,0,784,0,209,0,0.098214286,empty,mBC-0716-1
"G12,B1",19319,19881,14824,5057,10418,0,4704,4706,3256,1450,2.245517241,2230,1102,667,349,0,349,0,112,0,0.100286533,empty,mBC-0716-1
"G12,B2",972442,1052597,696403,356194,548052,0,301232,301612,255596,46016,5.554502782,161505,28493,17025,8185,8,8177,1,1174,0,0.00807142,mm10,mBC-0716-1
"G12,B3",18613,19135,14319,4816,10236,0,4631,4643,3273,1370,2.389051095,2241,1081,671,371,0,371,0,135,0,0.056603774,empty,mBC-0716-1
"G12,B4",16673,16969,12759,4210,9091,0,4087,4101,2889,1212,2.383663366,1945,1081,607,343,0,343,0,118,0,0.049562682,empty,mBC-0716-1
"G12,B5",14607,11494,7945,3549,7168,0,3624,3635,2690,945,2.846560847,1894,774,435,221,0,221,0,70,0,0.036199095,empty,mBC-0716-1
"G12,B6",12220,12622,9303,3319,6659,0,3076,3085,2137,948,2.254219409,1446,1285,823,435,0,435,0,128,0,0.016091954,empty,mBC-0716-1
"G12,B7",16028,16223,12208,4015,8703,0,3950,3966,2761,1205,2.291286307,1883,1018,619,299,0,299,0,100,0,0.110367893,empty,mBC-0716-1
"G12,B8",13501,13749,10370,3379,7398,0,3242,3248,2260,988,2.287449393,1512,778,501,287,0,287,0,113,0,0.055749129,empty,mBC-0716-1
"G12,B9",16516,16304,12118,4186,8224,0,3729,3738,2638,1100,2.398181818,1727,21270,6391,3338,2,3336,2,482,0,0.193345324,empty,mBC-0716-1
"G12,B10",16446,16297,11829,4468,9022,0,4178,4215,2856,1359,2.101545254,2093,483,300,154,1,153,1,64,0,0.026143791,empty,mBC-0716-1
"G12,B11",17460,17963,13435,4528,9602,0,4380,4389,3165,1224,2.585784314,2122,224,165,110,0,110,0,55,0,0,empty,mBC-0716-1
"G12,B12",808497,868042,586386,281656,456542,2,240848,241252,212217,29035,7.309006372,126771,126325,88955,41947,8,41939,2,2953,0,0.001716779,mm10,mBC-0716-1
"G12,C1",1170459,1242713,869836,372877,632750,2,319355,319884,276442,43442,6.363473137,162976,45271,31876,15166,3,15163,1,1689,0,0.00112115,mm10,mBC-0716-1
"G12,C2",752179,774678,576929,197749,405844,0,182824,183186,152116,31070,4.895912456,88756,3912,2143,1008,0,1008,0,378,0,0.029761905,mm10,mBC-0716-1
"G12,C3",755752,837320,544828,292492,440394,1,241946,242332,183517,58815,3.120241435,132702,38162,24895,12030,6,12024,2,1397,0,0.001829674,mm10,mBC-0716-1
"G12,C4",1321485,1391896,964601,427295,730968,2,383429,383937,308889,75048,4.115885833,198283,138898,98377,46851,24,46827,3,3282,0,0.000832853,mm10,mBC-0716-1
"G12,C5",17838,18266,13501,4765,9676,0,4389,4396,3111,1285,2.421011673,2121,577,348,197,0,197,0,80,0,0.020304569,empty,mBC-0716-1
"G12,C6",17407,17565,13154,4411,9792,0,4553,4564,3150,1414,2.227722772,2154,1271,793,360,0,360,0,134,0,0.019444444,empty,mBC-0716-1
"G12,C7",16463,17105,12582,4523,9137,0,4241,4249,3007,1242,2.421095008,2022,278,153,83,0,83,0,47,0,0.012048193,empty,mBC-0716-1
"G12,C8",15250,15784,11548,4236,8455,0,3867,3888,2652,1236,2.145631068,1970,1293,786,371,0,371,0,136,0,0.032345013,empty,mBC-0716-1
"G12,C9",696132,751876,507817,244059,396591,0,208121,208460,163029,45431,3.588496841,110237,55546,39913,19105,4,19101,1,1867,0,0.000366473,mm10,mBC-0716-1
"G12,C10",13124,13468,10098,3370,7264,0,3312,3315,2247,1068,2.103932584,1536,864,470,265,0,265,0,98,0,0.049056604,empty,mBC-0716-1
"G12,C11",11943,12551,8994,3557,6509,0,3023,3029,2090,939,2.225772098,1451,740,412,194,0,194,0,81,0,0.056701031,empty,mBC-0716-1
"G12,C12",20147,20367,14954,5413,10691,0,4827,4852,3391,1461,2.321013005,2379,9185,2863,1528,0,1528,0,281,0,0.147251309,empty,mBC-0716-1
"G12,D1",549925,596591,386214,210377,320925,2,178212,178518,147470,31048,4.749742334,97874,40394,26937,12686,4,12682,1,1395,0,0.002129002,mm10,mBC-0716-1
"G12,D2",756313,792975,561465,231510,415763,0,207352,207722,171444,36278,4.725839352,104125,57106,36790,17202,6,17196,2,2047,0,0.010583857,mm10,mBC-0716-1
"G12,D3",13948,14335,10485,3850,7561,0,3494,3498,2403,1095,2.194520548,1727,952,544,273,1,272,1,109,0,0.091911765,empty,mBC-0716-1
"G12,D4",14363,14678,10944,3734,7817,0,3551,3562,2453,1109,2.211902615,1675,1407,719,373,0,373,0,118,0,0.117962466,empty,mBC-0716-1
"G12,D5",13902,14196,10681,3515,7515,0,3449,3455,2522,933,2.703108253,1593,1004,634,317,0,317,0,132,0,0,empty,mBC-0716-1
"G12,D6",555073,610323,398391,211932,326549,0,179769,180019,149807,30212,4.958526413,98449,65060,43366,20849,12,20837,1,2015,0,0.002447569,mm10,mBC-0716-1
"G12,D7",631983,672344,458191,214153,357291,0,186320,186626,136984,49642,2.759437573,98735,71510,48138,22641,8,22633,1,2366,0,0.005169443,mm10,mBC-0716-1
"G12,D8",727646,803898,521909,281989,425262,0,234289,234593,183703,50890,3.609805463,127871,76268,55820,26520,10,26510,1,2328,0,0.000377216,mm10,mBC-0716-1
"G12,D9",5072,5188,3740,1448,2901,0,1371,1377,990,387,2.558139535,695,1176,717,350,0,350,0,114,0,0.077142857,empty,mBC-0716-1
"G12,D10",15191,15781,11568,4213,8551,0,4038,4047,2889,1158,2.494818653,1990,663,391,211,0,211,0,77,0,0.061611374,empty,mBC-0716-1
"G12,D11",13472,13692,10336,3356,7281,0,3278,3288,2291,997,2.297893681,1507,1414,869,470,1,469,1,161,0,0.023454158,empty,mBC-0716-1
"G12,D12",20766,21412,15776,5636,11086,0,5093,5104,3583,1521,2.355687048,2402,9552,3278,1609,1,1608,1,347,0,0.026119403,empty,mBC-0716-1
"G12,E1",1304716,1317265,983108,334157,689222,1,320599,321169,257388,63781,4.035496464,155400,42113,28347,13539,8,13531,2,1685,0,0.003916931,mm10,mBC-0716-1
"G12,E2",16609,16869,12710,4159,9086,0,4024,4042,2805,1237,2.267582862,1912,1484,923,485,0,485,0,152,0,0.057731959,empty,mBC-0716-1
"G12,E3",25813,26410,19957,6453,13921,0,6113,6128,4660,1468,3.174386921,2849,4511,3008,1458,0,1458,0,334,0,0.014403292,empty,mBC-0716-1
"G12,E4",16178,16644,12386,4258,8798,1,3986,4002,2805,1197,2.343358396,1905,2472,1071,537,0,537,0,163,0,0.037243948,empty,mBC-0716-1
"G12,E5",20707,20868,16032,4836,11006,0,4825,4833,3410,1423,2.396345748,2162,1104,719,398,0,398,0,138,0,0.06281407,empty,mBC-0716-1
"G12,E6",13822,14040,10616,3424,7332,0,3222,3223,2201,1022,2.153620352,1479,1170,702,359,0,359,0,102,0,0.027855153,empty,mBC-0716-1
"G12,E7",14293,15015,11081,3934,8021,0,3733,3738,2630,1108,2.373646209,1797,1290,641,369,0,369,0,130,0,0.056910569,empty,mBC-0716-1
"G12,E8",2731766,2929246,1976527,952719,1476712,1,819585,820833,631689,189144,3.339725289,433691,372624,255363,121830,48,121782,7,5443,0,0.003760819,mm10,mBC-0716-1
"G12,E9",9108,9581,6877,2704,5145,0,2443,2444,1708,736,2.320652174,1229,983,589,310,0,310,0,111,0,0.112903226,empty,mBC-0716-1
"G12,E10",13066,13466,10108,3358,7030,0,3163,3178,2182,996,2.190763052,1513,1129,747,384,0,384,0,113,0,0.059895833,empty,mBC-0716-1
"G12,E11",9517,9853,7164,2689,5330,0,2488,2495,1728,767,2.252933507,1207,15125,3804,1942,5,1937,2,335,0,0.069179143,empty,mBC-0716-1
"G12,E12",987064,1074290,722542,351748,571083,1,296789,297301,250798,46503,5.393157431,158304,212675,130534,62827,23,62804,3,4162,0,0.003295968,mm10,mBC-0716-1
"G12,F1",17658,17927,13351,4576,9485,0,4225,4241,2935,1306,2.247320061,2040,1519,766,424,0,424,0,125,0,0.011792453,empty,mBC-0716-1
"G12,F2",22619,23018,17237,5781,12287,0,5624,5634,3965,1669,2.375674056,2656,2001,1320,696,0,696,0,220,0,0.037356322,empty,mBC-0716-1
"G12,F3",16419,16975,12452,4523,9181,0,4405,4409,3082,1327,2.322532027,2157,1462,935,541,1,540,1,187,0,0.022222222,empty,mBC-0716-1
"G12,F4",1286471,1340735,942784,397951,708166,1,356085,356632,303025,53607,5.652713265,183292,68423,45838,21855,11,21844,3,2123,0,0.00274675,mm10,mBC-0716-1
"G12,F5",23450,24137,17813,6324,12836,0,5761,5781,4113,1668,2.465827338,2810,1427,888,458,0,458,0,167,0,0.017467249,empty,mBC-0716-1
"G12,F6",23304,24333,17672,6661,12743,0,5890,5896,4093,1803,2.27010538,2906,1466,898,470,0,470,0,156,0,0.036170213,empty,mBC-0716-1
"G12,F7",19932,20527,15299,5228,11131,1,5031,5037,3546,1491,2.378269618,2393,915,624,337,0,337,0,106,0,0.068249258,empty,mBC-0716-1
"G12,F8",23013,23485,17568,5917,12458,0,5715,5722,4034,1688,2.389810427,2692,308,228,130,0,130,0,55,0,0,empty,mBC-0716-1
"G12,F9",1419179,1520021,1031476,488545,795474,1,434517,435137,344175,90962,3.783722873,228627,161530,111074,52640,23,52617,2,3776,0,0.001919532,mm10,mBC-0716-1
"G12,F10",20700,21113,16041,5072,11143,3,4723,4741,3335,1406,2.37197724,2211,1275,874,440,0,440,0,120,0,0.072727273,empty,mBC-0716-1
"G12,F11",11450,11860,8765,3095,6324,0,2834,2839,1962,877,2.237172178,1402,997,680,375,0,375,0,114,0,0.074666667,empty,mBC-0716-1
"G12,F12",14375,14687,10697,3990,7689,0,3591,3599,2585,1014,2.549309665,1745,2062,611,297,1,296,1,66,0,0.067567568,empty,mBC-0716-1
"G12,G1",10081,10558,7869,2689,5568,0,2423,2426,1665,761,2.187910644,1128,1631,1111,599,1,598,1,144,0,0.035117057,empty,mBC-0716-1
"G12,G2",22273,22300,16310,5990,11197,0,5021,5036,3589,1447,2.480304077,2388,13560,4231,2168,1,2167,1,381,0,0.090447623,empty,mBC-0716-1
"G12,G3",19763,20603,14851,5752,10807,0,5053,5065,3444,1621,2.124614436,2460,11834,4117,2023,1,2022,1,381,0,0.036597428,empty,mBC-0716-1
"G12,G4",28274,28611,21782,6829,15127,0,6451,6465,4641,1824,2.544407895,2965,176,89,62,0,62,0,31,0,0,empty,mBC-0716-1
"G12,G5",13346,13662,10246,3416,7310,0,3239,3260,2250,1010,2.227722772,1576,1068,658,360,0,360,0,118,0,0.036111111,empty,mBC-0716-1
"G12,G6",1966344,2181191,1371238,809953,1118033,4,666377,667237,462206,205031,2.254322517,373714,9768,6590,3202,1,3201,1,590,0,0,mm10,mBC-0716-1
"G12,G7",20144,20344,15491,4853,10757,0,4761,4772,3356,1416,2.370056497,2257,1663,1032,557,1,556,1,170,0,0.052158273,empty,mBC-0716-1
"G12,G8",1323085,1478786,926996,551790,775985,1,464844,465463,344559,120904,2.849856084,262690,45354,31689,15169,3,15166,1,1789,0,0.00151655,mm10,mBC-0716-1
"G12,G9",10845,11237,8206,3031,5983,0,2760,2764,1947,817,2.383108935,1352,1221,722,373,0,373,0,136,0,0.021447721,empty,mBC-0716-1
"G12,G10",13937,14323,10686,3637,7563,0,3443,3455,2455,1000,2.455,1594,1064,707,392,0,392,0,148,0,0.068877551,empty,mBC-0716-1
"G12,G11",764924,842999,544170,298829,443201,0,247258,247626,203075,44551,4.558259074,135352,61956,42351,20521,8,20513,2,2008,0,0.001316238,mm10,mBC-0716-1
"G12,G12",11874,12258,8973,3285,6524,0,2984,2989,2066,923,2.238353196,1449,7589,2511,1263,1,1262,1,261,0,0.062599049,empty,mBC-0716-1
"G12,H1",822184,891629,591545,300084,468053,2,252593,252978,216042,36936,5.849090318,136187,46608,32308,15243,9,15234,1,1660,0,0.001050282,mm10,mBC-0716-1
"G12,H2",935434,1040356,647793,392563,544902,3,326964,327426,225943,101483,2.226412306,183697,41955,30543,14622,5,14617,1,1665,0,0.002326059,mm10,mBC-0716-1
"G12,H3",22749,23643,17143,6500,12397,0,5760,5765,3995,1770,2.257062147,2897,1115,718,389,0,389,0,147,0,0.064267352,empty,mBC-0716-1
"G12,H4",13431,13980,10284,3696,7415,0,3374,3385,2425,960,2.526041667,1670,93,62,35,0,35,0,25,0,0,empty,mBC-0716-1
"G12,H5",18171,19147,13856,5291,10104,0,4679,4692,3404,1288,2.642857143,2342,1392,867,471,0,471,0,168,0,0.063694268,empty,mBC-0716-1
"G12,H6",15369,15588,11603,3985,8447,0,3878,3891,2743,1148,2.389372822,1877,7831,2779,1406,1,1405,1,336,0,0.025622776,empty,mBC-0716-1
"G12,H7",18019,18046,13500,4546,9829,0,4498,4510,3193,1317,2.424449506,2170,3233,1417,730,0,730,0,211,0,0.12739726,empty,mBC-0716-1
"G12,H8",13490,13956,10081,3875,7531,0,3483,3492,2498,994,2.513078471,1759,1231,758,422,0,422,0,144,0,0.090047393,empty,mBC-0716-1
"G12,H9",854352,896911,610780,286131,471999,0,256489,256852,191371,65481,2.922542417,135286,32263,16948,8253,1,8252,1,1159,0,0.009573437,mm10,mBC-0716-1
"G12,H10",14390,14803,10823,3980,7929,0,3661,3668,2568,1100,2.334545455,1746,1586,778,438,1,437,1,140,0,0,empty,mBC-0716-1
"G12,H11",16858,17485,12777,4708,9447,0,4432,4440,3107,1333,2.330832708,2161,129,74,51,0,51,0,44,0,0,empty,mBC-0716-1
"G12,H12",6388,6451,4925,1526,3440,0,1526,1529,1107,422,2.623222749,720,815,483,251,0,251,0,74,0,0.007968127,empty,mBC-0716-1
"H1,A1",14700,15314,10955,4359,8290,0,3900,3906,2787,1119,2.490616622,1947,3118,1277,638,2,636,1,128,0,0.072327044,empty,mBC-0716-1
"H1,A2",18660,18669,14488,4181,9828,0,4272,4287,3046,1241,2.4544722,1885,1053,679,350,0,350,0,103,0,0.122857143,empty,mBC-0716-1
"H1,A3",508570,527723,367389,160334,283491,1,148625,148856,112166,36690,3.057127283,76866,9961,5594,2562,4,2558,1,501,0,0,mm10,mBC-0716-1
"H1,A4",19640,19841,15008,4833,10429,0,4641,4645,3254,1391,2.339324227,2172,511,358,180,0,180,0,59,0,0.055555556,empty,mBC-0716-1
"H1,A5",16195,16763,12423,4340,8973,0,4172,4183,2976,1207,2.465617233,2030,1939,1113,523,0,523,0,131,0,0.078393881,empty,mBC-0716-1
"H1,A6",13104,13812,9928,3884,7430,0,3561,3569,2470,1099,2.247497725,1760,2682,1193,635,1,634,1,156,0,0.14511041,empty,mBC-0716-1
"H1,A7",15461,15804,11787,4017,8527,0,3804,3811,2688,1123,2.393588602,1828,949,618,329,0,329,0,92,0,0.045592705,empty,mBC-0716-1
"H1,A8",10555,10710,8083,2627,5777,0,2638,2639,1834,805,2.27826087,1214,1159,642,294,1,293,1,103,0,0.013651877,empty,mBC-0716-1
"H1,A9",17964,18573,13919,4654,9650,0,4280,4286,3066,1220,2.513114754,2040,1122,708,354,0,354,0,92,0,0.081920904,empty,mBC-0716-1
"H1,A10",462040,488528,345243,143285,261512,0,125241,125439,104076,21363,4.87178767,63627,15991,10141,4751,3,4748,2,723,0,0.001053075,mm10,mBC-0716-1
"H1,A11",17327,17820,13317,4503,9402,0,4230,4242,2936,1306,2.248085758,2053,963,620,327,0,327,0,96,0,0.036697248,empty,mBC-0716-1
"H1,A12",18736,18900,14343,4557,9998,0,4356,4368,3084,1284,2.401869159,2010,2794,1564,788,0,788,0,161,0,0.126903553,empty,mBC-0716-1
"H1,B1",886152,963144,631147,331997,503008,0,280027,280515,226179,54336,4.162599382,151676,83133,46339,22782,8,22774,2,2187,0,0.007464653,mm10,mBC-0716-1
"H1,B2",558511,571216,422607,148609,306221,1,143215,143480,110766,32714,3.385889833,69689,14303,5953,2909,1,2908,1,497,0,0.037138927,mm10,mBC-0716-1
"H1,B3",17646,18155,13497,4658,9665,0,4323,4342,3094,1248,2.479166667,2100,8921,2760,1367,1,1366,1,279,0,0.02489019,empty,mBC-0716-1
"H1,B4",15633,16634,11853,4781,8782,0,4112,4127,2914,1213,2.402308326,2145,723,455,239,1,238,1,77,0,0.084033613,empty,mBC-0716-1
"H1,B5",581245,384750,205888,178862,267722,4,177711,178573,138246,40327,3.428125077,110798,54500,35833,17100,1,17099,1,1854,0,0.001228142,mm10,mBC-0716-1
"H1,B6",435179,475818,300618,175200,258632,0,153899,154093,121283,32810,3.69652545,85652,5716,3637,1787,0,1787,0,426,0,0.010632345,mm10,mBC-0716-1
"H1,B7",14983,15262,11447,3815,8151,0,3637,3646,2553,1093,2.335773102,1694,695,461,227,0,227,0,72,0,0.022026432,empty,mBC-0716-1
"H1,B8",12302,12672,9556,3116,6669,1,3004,3013,2100,913,2.300109529,1373,1110,458,246,0,246,0,81,0,0.024390244,empty,mBC-0716-1
"H1,B9",14188,14306,10867,3439,7450,0,3248,3263,2305,958,2.40605428,1485,435,218,111,0,111,0,47,0,0,empty,mBC-0716-1
"H1,B10",15704,15409,11548,3861,8456,0,3908,3927,2716,1211,2.242774566,1832,341,221,111,0,111,0,40,0,0.018018018,empty,mBC-0716-1
"H1,B11",739099,797187,536073,261114,417292,0,226051,226400,175836,50564,3.477493869,119597,4441,3021,1502,0,1502,0,270,0,0,mm10,mBC-0716-1
"H1,B12",17902,18538,13576,4962,9700,0,4413,4416,3121,1295,2.41003861,2104,1197,792,352,0,352,0,97,0,0.056818182,empty,mBC-0716-1
"H1,C1",1801683,1951107,1305342,645765,993253,4,550021,550838,431164,119674,3.602820997,292773,58932,41234,19919,12,19907,3,1981,0,0.00070327,mm10,mBC-0716-1
"H1,C2",796685,879344,560241,319103,461106,2,265533,265904,198561,67343,2.948502443,147294,69248,47320,22578,6,22572,1,2077,0,0.006468191,mm10,mBC-0716-1
"H1,C3",20217,21167,15359,5808,11002,0,5046,5057,3579,1478,2.421515562,2481,474,284,148,0,148,0,55,0,0.006756757,empty,mBC-0716-1
"H1,C4",16885,17143,12783,4360,9161,0,4101,4111,2897,1214,2.386326194,1921,1026,575,321,0,321,0,96,0,0.018691589,empty,mBC-0716-1
"H1,C5",15429,16042,11799,4243,8531,0,3882,3888,2777,1111,2.499549955,1882,693,391,206,0,206,0,81,0,0.067961165,empty,mBC-0716-1
"H1,C6",16116,16703,12146,4557,9095,0,4260,4265,2977,1288,2.311335404,2134,1102,635,358,0,358,0,98,0,0.078212291,empty,mBC-0716-1
"H1,C7",15851,16512,11921,4591,8782,0,4185,4196,2958,1238,2.389337641,2053,2705,976,489,0,489,0,111,0,0.047034765,empty,mBC-0716-1
"H1,C8",14454,14768,10814,3954,7841,1,3638,3656,2525,1131,2.232537577,1785,1290,862,425,1,424,1,125,0,0.049528302,empty,mBC-0716-1
"H1,C9",872990,943424,624336,319088,491194,0,270089,270490,224325,46165,4.859200693,144701,60692,39241,19134,8,19126,2,1995,0,0.004182788,mm10,mBC-0716-1
"H1,C10",572369,616115,423625,192490,326543,0,167115,167361,132502,34859,3.801084368,86929,56991,39580,19282,8,19274,1,1996,0,0.001608384,mm10,mBC-0716-1
"H1,C11",1183078,1322797,845711,477086,697882,1,399162,399747,318664,81083,3.930096321,221379,124896,85120,40932,10,40922,2,3182,0,0.001759445,mm10,mBC-0716-1
"H1,C12",19140,19874,14503,5371,10448,0,4786,4796,3334,1462,2.280437756,2329,923,482,265,1,264,1,79,0,0.083333333,empty,mBC-0716-1
"H1,D1",11633,12274,8736,3538,6742,0,3297,3308,2317,991,2.338042381,1722,616,346,182,0,182,0,65,0,0.010989011,empty,mBC-0716-1
"H1,D2",19445,19781,15012,4769,10217,0,4389,4403,3068,1335,2.298127341,2037,2190,1506,756,0,756,0,170,0,0.05026455,empty,mBC-0716-1
"H1,D3",13634,14105,10257,3848,7526,0,3585,3589,2495,1094,2.280621572,1758,711,448,228,1,227,1,87,0,0.066079295,empty,mBC-0716-1
"H1,D4",15694,16334,12085,4249,8643,0,3977,3987,2847,1140,2.497368421,1958,982,644,344,0,344,0,112,0,0.026162791,empty,mBC-0716-1
"H1,D5",717602,780182,503840,276342,410704,2,230910,231268,196645,34623,5.679606042,125272,99456,68928,32886,17,32869,2,2685,0,0.001673309,mm10,mBC-0716-1
"H1,D6",12317,12994,9340,3654,6743,0,3182,3194,2234,960,2.327083333,1569,1094,595,314,0,314,0,98,0,0.085987261,empty,mBC-0716-1
"H1,D7",12959,13225,9789,3436,7155,0,3347,3352,2326,1026,2.26705653,1611,1200,754,383,0,383,0,129,0,0.060052219,empty,mBC-0716-1
"H1,D8",15606,16096,11902,4194,8523,1,3915,3933,2791,1142,2.443957968,1852,689,460,244,0,244,0,80,0,0.06147541,empty,mBC-0716-1
"H1,D9",5849,6099,4387,1712,3350,0,1655,1659,1173,486,2.413580247,844,1298,747,387,0,387,0,113,0,0.067183463,empty,mBC-0716-1
"H1,D10",13212,13895,9871,4024,7307,0,3506,3510,2428,1082,2.243992606,1751,3626,1229,630,1,629,1,138,0,0.074721781,empty,mBC-0716-1
"H1,D11",12649,12877,9708,3169,6869,0,3123,3124,2147,977,2.197543501,1491,5409,1918,1032,1,1031,1,217,0,0.088263822,empty,mBC-0716-1
"H1,D12",19469,19730,14845,4885,10301,0,4629,4637,3224,1413,2.281670205,2137,1475,956,532,0,532,0,154,0,0.015037594,empty,mBC-0716-1
"H1,E1",21017,21577,16038,5539,11265,3,5079,5090,3544,1546,2.2923674,2416,1386,746,380,0,380,0,121,0,0.060526316,empty,mBC-0716-1
"H1,E2",15994,16621,12331,4290,8822,0,4089,4098,2934,1164,2.520618557,1955,1481,895,428,0,428,0,122,0,0.042056075,empty,mBC-0716-1
"H1,E3",11538,11710,8733,2977,6200,0,2827,2831,1968,863,2.280417149,1325,3298,1138,565,0,565,0,132,0,0.079646018,empty,mBC-0716-1
"H1,E4",834416,892494,614851,277643,461535,0,238049,238475,199414,39061,5.105194439,123104,80773,58068,27705,12,27693,2,2287,0,0.001155527,mm10,mBC-0716-1
"H1,E5",19637,20188,14989,5199,10645,0,4801,4817,3313,1504,2.202792553,2314,3340,1266,673,0,673,0,152,0,0.035661218,empty,mBC-0716-1
"H1,E6",13623,14019,10288,3731,7408,0,3402,3414,2463,951,2.589905363,1645,1129,659,314,0,314,0,97,0,0.070063694,empty,mBC-0716-1
"H1,E7",12922,13305,9934,3371,7099,1,3156,3165,2243,922,2.432754881,1524,1225,770,369,1,368,1,90,0,0.054347826,empty,mBC-0716-1
"H1,E8",16690,17008,12737,4271,8956,0,3967,3974,2805,1169,2.399486741,1882,11447,3666,1885,1,1884,1,335,0,0.070063694,empty,mBC-0716-1
"H1,E9",437953,480691,313707,166984,257529,0,141833,142032,117871,24161,4.878564629,77109,84335,59393,28591,10,28581,1,2430,0,0.002414191,mm10,mBC-0716-1
"H1,E10",12122,12532,9337,3195,6586,0,3033,3039,2150,889,2.418447694,1458,985,638,341,0,341,0,100,0,0.181818182,empty,mBC-0716-1
"H1,E11",9239,9445,7076,2369,5166,0,2360,2372,1697,675,2.514074074,1133,943,586,282,0,282,0,82,0,0.024822695,empty,mBC-0716-1
"H1,E12",14599,15086,11067,4019,8037,0,3652,3658,2552,1106,2.307414105,1750,973,607,307,0,307,0,86,0,0.06514658,empty,mBC-0716-1
"H1,F1",16470,16684,12650,4034,8808,0,3903,3917,2715,1202,2.258735441,1788,966,666,352,0,352,0,87,0,0.173295455,empty,mBC-0716-1
"H1,F2",683520,765868,486694,279174,404556,2,222241,222544,186480,36064,5.170807453,125023,4875,2652,1249,0,1249,0,390,0,0.035228183,mm10,mBC-0716-1
"H1,F3",16745,17542,12487,5055,9279,0,4414,4423,3075,1348,2.28115727,2199,4369,1558,840,1,839,1,202,0,0.054827175,empty,mBC-0716-1
"H1,F4",453592,472444,337188,135256,258996,1,126207,126465,96062,30403,3.159622406,64127,15203,7856,3754,6,3748,1,617,0,0.010138741,mm10,mBC-0716-1
"H1,F5",773637,813722,579858,233864,422236,2,201165,201561,167813,33748,4.972531706,101246,96436,58746,27841,11,27830,2,2439,0,0.007653611,mm10,mBC-0716-1
"H1,F6",23123,23842,17538,6304,12500,0,5738,5751,4062,1689,2.404973357,2755,1934,1242,579,0,579,0,166,0,0.075993092,empty,mBC-0716-1
"H1,F7",18700,18960,14194,4766,10406,0,4669,4682,3232,1450,2.228965517,2213,2457,949,452,0,452,0,122,0,0.002212389,empty,mBC-0716-1
"H1,F8",826881,890583,603501,287082,466819,1,248825,249224,209920,39304,5.340932221,131296,6116,3691,1847,1,1846,1,352,0,0,mm10,mBC-0716-1
"H1,F9",14651,15152,11247,3905,8008,0,3723,3729,2615,1114,2.347396768,1761,1448,966,492,0,492,0,149,0,0.040650407,empty,mBC-0716-1
"H1,F10",19132,19321,14668,4653,10048,0,4377,4384,3127,1257,2.487669053,2036,812,553,278,0,278,0,85,0,0.129496403,empty,mBC-0716-1
"H1,F11",10703,10951,8129,2822,5866,0,2658,2667,1842,825,2.232727273,1252,913,616,350,0,350,0,95,0,0.037142857,empty,mBC-0716-1
"H1,F12",300202,302780,232560,70220,164137,1,66918,67054,41047,26007,1.578305841,32785,1470,594,288,0,288,0,60,0,0.03125,empty,mBC-0716-1
"H1,G1",9341,9719,7258,2461,5110,0,2233,2239,1520,719,2.114047288,1081,1416,890,411,0,411,0,105,0,0.00486618,empty,mBC-0716-1
"H1,G2",19455,19962,14764,5198,10413,0,4670,4686,3254,1432,2.272346369,2260,382,239,131,0,131,0,47,0,0.038167939,empty,mBC-0716-1
"H1,G3",20550,21324,15458,5866,11298,0,5148,5155,3648,1507,2.420703384,2550,1542,978,518,0,518,0,141,0,0.044401544,empty,mBC-0716-1
"H1,G4",808603,835547,618667,216880,437507,1,199445,199795,168784,31011,5.442713876,96512,659,492,260,1,259,1,63,0,0,empty,mBC-0716-1
"H1,G5",521309,559873,383086,176787,299775,2,158262,158506,117754,40752,2.889526894,83726,18014,8599,4138,3,4135,2,678,0,0.056106409,mm10,mBC-0716-1
"H1,G6",23139,23588,17985,5603,12445,0,5336,5345,3790,1555,2.437299035,2443,141,73,40,0,40,0,22,0,0,empty,mBC-0716-1
"H1,G7",1432346,1500462,1062891,437571,773498,1,388859,389487,324135,65352,4.959832905,196705,136791,94045,45067,16,45051,2,3461,0,0.002597057,mm10,mBC-0716-1
"H1,G8",15188,15892,11451,4441,8154,0,3868,3877,2710,1167,2.322193659,1909,5645,2292,1257,1,1256,1,222,0,0.260350318,empty,mBC-0716-1
"H1,G9",9670,9998,7283,2715,5310,0,2538,2541,1817,724,2.509668508,1240,883,577,314,0,314,0,95,0,0.085987261,empty,mBC-0716-1
"H1,G10",12842,13034,9793,3241,6899,3,3037,3051,2112,939,2.249201278,1424,860,552,296,0,296,0,102,0,0.010135135,empty,mBC-0716-1
"H1,G11",11694,12151,9012,3139,6301,0,2816,2822,2003,819,2.445665446,1349,353,197,125,0,125,0,59,0,0.016,empty,mBC-0716-1
"H1,G12",10814,11048,8164,2884,6003,0,2701,2716,1936,780,2.482051282,1348,977,582,289,0,289,0,87,0,0.024221453,empty,mBC-0716-1
"H1,H1",19917,20512,15281,5231,10905,0,4843,4852,3404,1448,2.350828729,2331,3116,1064,548,0,548,0,132,0,0.018248175,empty,mBC-0716-1
"H1,H2",21838,22129,16781,5348,11618,0,5166,5175,3640,1535,2.371335505,2374,2263,1244,637,4,633,1,155,0,0.056872038,empty,mBC-0716-1
"H1,H3",19805,20336,15054,5282,10721,0,4952,4966,3500,1466,2.38744884,2343,1114,664,314,1,313,1,97,0,0.044728435,empty,mBC-0716-1
"H1,H4",13401,13962,10110,3852,7430,0,3504,3514,2463,1051,2.343482398,1744,84,70,44,0,44,0,16,0,0.272727273,empty,mBC-0716-1
"H1,H5",17989,19010,13569,5441,9990,0,4770,4781,3377,1404,2.405270655,2417,1082,674,323,0,323,0,106,0,0.018575851,empty,mBC-0716-1
"H1,H6",630471,667642,466428,201214,355379,0,184663,184916,126687,58229,2.175668481,94664,39930,25775,12604,5,12599,2,1510,0,0.009127709,mm10,mBC-0716-1
"H1,H7",17187,17769,12843,4926,9496,0,4473,4483,3129,1354,2.310930576,2208,19028,5983,3008,1,3007,1,516,0,0.026604589,empty,mBC-0716-1
"H1,H8",20155,21486,15166,6320,11451,0,5593,5606,4199,1407,2.984363895,2858,1154,673,370,0,370,0,130,0,0.062162162,empty,mBC-0716-1
"H1,H9",15417,15568,11664,3904,8332,0,3781,3788,2726,1062,2.566854991,1732,1769,868,469,0,469,0,120,0,0.070362473,empty,mBC-0716-1
"H1,H10",14546,14890,10846,4044,8019,0,3786,3793,2717,1076,2.525092937,1865,976,560,277,0,277,0,90,0,0.068592058,empty,mBC-0716-1
"H1,H11",666954,706835,472831,234004,376405,1,207735,208036,154107,53929,2.857590536,111232,332,234,136,0,136,0,50,0,0.066176471,empty,mBC-0716-1
"H1,H12",6339,6483,4911,1572,3402,0,1566,1570,1111,459,2.420479303,715,622,393,184,0,184,0,61,0,0.10326087,empty,mBC-0716-1
"H2,A1",14542,15228,10988,4240,8388,0,4052,4054,2852,1202,2.372712146,1957,1149,702,347,0,347,0,100,0,0.008645533,empty,mBC-0716-1
"H2,A2",688766,727061,497426,229635,387087,3,200205,200515,161244,39271,4.105930585,105301,122448,69409,33146,30,33116,8,2785,0,0.023100616,mm10,mBC-0716-1
"H2,A3",15857,16504,12109,4395,8855,0,4088,4097,2899,1198,2.419866444,1929,5533,2072,1096,1,1095,1,210,0,0.065753425,empty,mBC-0716-1
"H2,A4",658453,667108,504856,162252,355763,0,157796,158103,125486,32617,3.847257565,74657,12926,8463,4117,2,4115,1,645,0,0.000243013,mm10,mBC-0716-1
"H2,A5",15857,16685,12200,4485,9009,0,4182,4188,2824,1364,2.070381232,2040,1450,922,487,0,487,0,124,0,0.075975359,empty,mBC-0716-1
"H2,A6",13011,13678,9956,3722,7401,0,3528,3533,2478,1055,2.348815166,1725,1342,922,428,1,427,1,143,0,0.079625293,empty,mBC-0716-1
"H2,A7",767213,836501,528177,308324,447363,0,260233,260559,219128,41431,5.288986508,143413,131901,90676,42564,21,42543,1,3106,0,0.001198787,mm10,mBC-0716-1
"H2,A8",384179,397633,276757,120876,219315,1,115443,115623,94182,21441,4.392612285,59368,8454,6034,2705,0,2705,0,582,0,0.005175601,mm10,mBC-0716-1
"H2,A9",17761,17682,13555,4127,9475,0,4146,4160,2947,1213,2.429513603,1922,11566,3694,1807,0,1807,0,344,0,0.039845047,empty,mBC-0716-1
"H2,A10",656752,720727,462263,258464,384936,1,218623,218918,169764,49154,3.45371689,119840,25082,15836,7502,5,7497,1,1054,0,0.003601441,mm10,mBC-0716-1
"H2,A11",17194,17705,13172,4533,9486,0,4334,4343,2941,1402,2.097717546,2072,1334,883,384,0,384,0,120,0,0.0234375,empty,mBC-0716-1
"H2,A12",20419,20613,15535,5078,11170,0,5019,5024,3560,1464,2.431693989,2416,6335,2798,1417,0,1417,0,299,0,0.079745942,empty,mBC-0716-1
"H2,B1",17871,18373,13557,4816,9687,0,4275,4293,3024,1269,2.382978723,2058,4719,1785,900,0,900,0,219,0,0.034444444,empty,mBC-0716-1
"H2,B2",983060,1057514,711494,346020,553980,0,296061,296504,261810,34694,7.546261601,156203,40722,27603,13044,7,13037,1,1559,0,0.000690343,mm10,mBC-0716-1
"H2,B3",19307,19686,14424,5262,10543,1,4979,4992,3496,1496,2.336898396,2434,17330,5232,2694,2,2692,2,474,0,0.047548291,empty,mBC-0716-1
"H2,B4",884557,1062638,570758,491880,566065,2,385289,385671,286151,99520,2.875311495,235858,55399,33311,16043,5,16038,3,1788,0,0.00717047,mm10,mBC-0716-1
"H2,B5",10956,7842,5287,2555,5091,0,2551,2559,1878,681,2.757709251,1426,641,421,160,0,160,0,67,0,0.00625,empty,mBC-0716-1
"H2,B6",11394,11931,8606,3325,6512,0,3055,3063,2136,927,2.30420712,1546,2309,1053,547,1,546,1,138,0,0.034798535,empty,mBC-0716-1
"H2,B7",15566,15999,11883,4116,8501,0,3790,3807,2690,1117,2.408236347,1851,2400,1114,586,0,586,0,118,0,0.105802048,empty,mBC-0716-1
"H2,B8",15708,16337,12112,4225,8709,0,3942,3948,2830,1118,2.531305903,1860,1571,897,482,0,482,0,167,0,0.010373444,empty,mBC-0716-1
"H2,B9",1645194,1734974,1229692,505282,888043,2,447511,448179,379940,68239,5.567783819,225493,85654,54906,26014,12,26002,2,2381,0,0.002076763,mm10,mBC-0716-1
"H2,B10",15963,15679,11563,4116,8874,0,4173,4186,2885,1301,2.217524981,2045,590,318,147,1,146,1,55,0,0,empty,mBC-0716-1
"H2,B11",16692,17317,12698,4619,9281,0,4351,4363,3113,1250,2.4904,2167,163,85,54,0,54,0,34,0,0,empty,mBC-0716-1
"H2,B12",17031,17784,13072,4712,9412,0,4281,4294,2974,1320,2.253030303,2034,1547,938,423,1,422,1,125,0,0.073459716,empty,mBC-0716-1
"H2,C1",1513014,1581767,1152467,429300,814755,0,379877,380518,311034,69484,4.476339877,188716,128407,87774,41000,21,40979,1,3168,0,0.000146416,mm10,mBC-0716-1
"H2,C2",19418,19720,14374,5346,10654,0,5010,5029,3548,1481,2.395678596,2518,41655,13101,6603,2,6601,2,891,0,0.154522042,empty,mBC-0716-1
"H2,C3",19031,19741,14519,5222,10469,0,4774,4788,3363,1425,2.36,2380,732,390,194,1,193,1,72,0,0.010362694,empty,mBC-0716-1
"H2,C4",17373,17739,13189,4550,9598,0,4316,4325,3050,1275,2.392156863,2048,1262,797,427,0,427,0,134,0,0.049180328,empty,mBC-0716-1
"H2,C5",544571,560940,407025,153915,304031,0,146379,146663,109769,36894,2.975253429,73024,21055,9212,4576,6,4570,5,710,0,0.044420131,mm10,mBC-0716-1
"H2,C6",16315,16839,12241,4598,9357,0,4464,4474,3207,1267,2.531176006,2237,1356,826,431,0,431,0,134,0,0.076566125,empty,mBC-0716-1
"H2,C7",15598,16247,11867,4380,8783,0,4134,4142,2947,1195,2.466108787,1995,304,200,125,0,125,0,57,0,0,empty,mBC-0716-1
"H2,C8",14625,15182,11070,4112,8135,0,3862,3866,2742,1124,2.439501779,1873,2600,1525,761,0,761,0,187,0,0.055190539,empty,mBC-0716-1
"H2,C9",12613,13191,9414,3777,7119,0,3374,3386,2409,977,2.465711361,1699,1001,657,286,0,286,0,73,0,0,empty,mBC-0716-1
"H2,C10",13223,13872,10199,3673,7381,0,3376,3386,2392,994,2.406438632,1694,1261,685,342,0,342,0,112,0,0.026315789,empty,mBC-0716-1
"H2,C11",548229,606431,399298,207133,327335,0,178126,178343,135592,42751,3.171668499,96742,61175,40175,19073,2,19071,1,1923,0,0.002097425,mm10,mBC-0716-1
"H2,C12",19847,20368,14816,5552,10606,4,4845,4861,3481,1380,2.522463768,2361,10268,3172,1607,2,1605,1,289,0,0.184423676,empty,mBC-0716-1
"H2,D1",12021,12668,8992,3676,6881,0,3293,3306,2366,940,2.517021277,1673,730,392,193,0,193,0,62,0,0.005181347,empty,mBC-0716-1
"H2,D2",19269,19584,14968,4616,10452,0,4513,4516,3150,1366,2.306002928,2094,3873,1904,908,1,907,1,218,0,0.02646086,empty,mBC-0716-1
"H2,D3",13480,14131,10059,4072,7716,0,3686,3692,2585,1107,2.335140018,1896,4930,1871,921,2,919,2,206,0,0.035908596,empty,mBC-0716-1
"H2,D4",16170,16653,11845,4808,8963,0,4371,4377,3118,1259,2.476568705,2222,13719,4763,2448,3,2445,1,377,0,0.220858896,empty,mBC-0716-1
"H2,D5",13467,13946,10327,3619,7593,0,3527,3535,2486,1049,2.369876072,1694,1248,852,438,1,437,1,128,0,0.091533181,empty,mBC-0716-1
"H2,D6",659113,792921,426593,366328,427844,1,287040,287384,195020,92364,2.111428695,178617,61141,42050,19827,7,19820,1,1999,0,0.000201816,mm10,mBC-0716-1
"H2,D7",13275,13714,9851,3863,7295,0,3552,3559,2532,1027,2.465433301,1760,17579,5424,2748,3,2745,2,496,0,0.046630237,empty,mBC-0716-1
"H2,D8",22715,23510,16897,6613,12463,1,5941,5954,4397,1557,2.824020552,2958,17124,5943,3026,2,3024,1,457,0,0.194444444,empty,mBC-0716-1
"H2,D9",5680,5761,4237,1524,3251,0,1594,1601,1198,403,2.972704715,792,10083,3367,1670,1,1669,1,319,0,0.03055722,empty,mBC-0716-1
"H2,D10",13782,14315,10390,3925,7729,0,3717,3724,2615,1109,2.357980162,1805,670,402,234,0,234,0,75,0,0.034188034,empty,mBC-0716-1
"H2,D11",13213,13722,10151,3571,7391,0,3372,3377,2327,1050,2.216190476,1616,1423,844,454,0,454,0,149,0,0.050660793,empty,mBC-0716-1
"H2,D12",19185,20085,14478,5607,10699,0,4945,4957,3444,1513,2.276272307,2495,2356,1442,741,0,741,0,186,0,0.026990553,empty,mBC-0716-1
"H2,E1",802924,862680,579654,283026,458554,0,246610,246988,201220,45768,4.396521587,131645,68695,44971,21296,6,21290,1,1967,0,0.000751527,mm10,mBC-0716-1
"H2,E2",507921,531056,382261,148795,287641,1,139185,139431,107074,32357,3.309144853,69288,44748,25378,12309,5,12304,2,1530,0,0.013003901,mm10,mBC-0716-1
"H2,E3",12027,12286,9266,3020,6602,0,3030,3038,2111,927,2.277238403,1437,1502,1008,524,0,524,0,159,0,0.036259542,empty,mBC-0716-1
"H2,E4",14937,15418,11539,3879,8240,0,3713,3724,2584,1140,2.266666667,1819,1595,1005,472,0,472,0,139,0,0.036016949,empty,mBC-0716-1
"H2,E5",20645,20652,15730,4922,11301,0,5018,5028,3484,1544,2.256476684,2374,2403,1196,583,0,583,0,145,0,0.046312178,empty,mBC-0716-1
"H2,E6",483386,489469,360562,128907,263466,0,124443,124692,79817,44875,1.778651811,61527,10987,7477,3347,2,3345,1,698,0,0.005979073,mm10,mBC-0716-1
"H2,E7",13327,13826,10122,3704,7293,1,3335,3348,2432,916,2.655021834,1622,1202,786,389,0,389,0,119,0,0.159383033,empty,mBC-0716-1
"H2,E8",16908,17438,13109,4329,9388,0,4132,4140,2901,1239,2.341404358,1973,1799,1117,579,0,579,0,171,0,0.037996546,empty,mBC-0716-1
"H2,E9",9160,9658,6899,2759,5212,0,2496,2503,1796,707,2.540311174,1311,1100,661,328,0,328,0,99,0,0.12804878,empty,mBC-0716-1
"H2,E10",561062,611640,409896,201744,330178,1,175792,176087,127531,48556,2.626472527,94329,121823,71738,34379,14,34365,3,2856,0,0.001833261,mm10,mBC-0716-1
"H2,E11",9391,9523,7055,2468,5247,0,2465,2473,1724,749,2.301735648,1222,1021,643,349,0,349,0,113,0,0.126074499,empty,mBC-0716-1
"H2,E12",14507,14987,11072,3915,8207,0,3796,3801,2683,1118,2.399821109,1849,1280,750,378,1,377,1,128,0,0.092838196,empty,mBC-0716-1
"H2,F1",16511,17031,12756,4275,9071,0,4057,4072,2836,1236,2.294498382,1883,1217,808,399,0,399,0,119,0,0.007518797,empty,mBC-0716-1
"H2,F2",21263,21767,16010,5757,11773,0,5486,5496,3883,1613,2.407315561,2649,3178,1846,903,0,903,0,232,0,0.057585825,empty,mBC-0716-1
"H2,F3",15784,16052,11858,4194,8810,0,4202,4208,2957,1251,2.363709033,2004,1615,1074,587,0,587,0,177,0,0.085178876,empty,mBC-0716-1
"H2,F4",763081,822547,550495,272052,445443,3,240996,241390,177574,63816,2.782593707,129613,17112,11776,5559,3,5556,1,778,0,0.002159827,mm10,mBC-0716-1
"H2,F5",23080,23227,17630,5597,12429,0,5618,5630,3905,1725,2.263768116,2561,1501,879,481,0,481,0,159,0,0.047817048,empty,mBC-0716-1
"H2,F6",23421,24408,17810,6598,13027,0,6070,6079,4355,1724,2.526102088,2928,2240,1471,710,1,709,1,183,0,0.032440056,empty,mBC-0716-1
"H2,F7",591077,597265,455913,141352,326375,0,142434,142722,113391,29331,3.865909788,67147,14026,8433,4243,1,4242,1,684,0,0.002593116,mm10,mBC-0716-1
"H2,F8",22347,22912,17151,5761,12452,0,5680,5689,4015,1674,2.398446834,2656,625,285,172,0,172,0,75,0,0.040697674,empty,mBC-0716-1
"H2,F9",14692,14912,11241,3671,8151,0,3712,3720,2554,1166,2.190394511,1726,2496,1216,672,2,670,1,207,0,0.050746269,empty,mBC-0716-1
"H2,F10",19479,19980,15183,4797,10564,0,4548,4556,3225,1331,2.422990233,2112,1273,819,464,1,463,1,147,0,0.045356371,empty,mBC-0716-1
"H2,F11",11223,11485,8629,2856,6291,0,2759,2771,1960,811,2.41676942,1327,796,499,272,0,272,0,110,0,0.055147059,empty,mBC-0716-1
"H2,F12",792533,894267,555782,338485,469585,2,276635,277001,177445,99556,1.782363695,158499,1552,1023,532,0,532,0,115,0,0,empty,mBC-0716-1
"H2,G1",9380,9604,7317,2287,5212,0,2322,2324,1644,680,2.417647059,1056,1987,1382,649,1,648,1,159,0,0.038580247,empty,mBC-0716-1
"H2,G2",19071,19494,14555,4939,10338,0,4626,4636,3192,1444,2.210526316,2204,462,273,156,0,156,0,58,0,0.044871795,empty,mBC-0716-1
"H2,G3",18930,19483,14353,5130,10391,0,4752,4759,3318,1441,2.302567661,2265,1885,1172,639,0,639,0,201,0,0.06885759,empty,mBC-0716-1
"H2,G4",26645,26818,20462,6356,14254,1,6291,6301,4477,1824,2.454495614,2944,133,112,74,0,74,0,41,0,0.040540541,empty,mBC-0716-1
"H2,G5",13137,13633,9957,3676,7213,0,3308,3321,2309,1012,2.281620553,1605,1072,677,314,0,314,0,108,0,0.050955414,empty,mBC-0716-1
"H2,G6",839795,909327,607963,301364,479065,1,257673,258074,215147,42927,5.011927225,137017,6993,4981,2402,3,2399,1,398,0,0.002501042,mm10,mBC-0716-1
"H2,G7",1215919,1337846,845504,492342,695014,1,412153,412742,339634,73108,4.645647535,226289,149552,107340,50408,11,50397,1,3382,0,0.001408814,mm10,mBC-0716-1
"H2,G8",14589,14845,10902,3943,8063,0,3733,3740,2639,1101,2.396911898,1834,4951,1767,915,2,913,1,234,0,0.095290252,empty,mBC-0716-1
"H2,G9",10348,10703,7917,2786,5778,0,2634,2642,1822,820,2.22195122,1241,1239,820,432,0,432,0,145,0,0.002314815,empty,mBC-0716-1
"H2,G10",13094,13347,10105,3242,7158,0,3191,3198,2273,925,2.457297297,1480,3812,1514,797,0,797,0,198,0,0.022584693,empty,mBC-0716-1
"H2,G11",15705,16120,12116,4004,8622,0,3821,3827,2871,956,3.003138075,1792,1165,589,325,0,325,0,103,0,0.030769231,empty,mBC-0716-1
"H2,G12",11478,11797,8738,3059,6364,0,2951,2957,2101,856,2.454439252,1386,1336,821,437,0,437,0,120,0,0.080091533,empty,mBC-0716-1
"H2,H1",20604,21124,15709,5415,11420,0,5150,5166,3765,1401,2.687366167,2470,1056,608,351,0,351,0,122,0,0.05982906,empty,mBC-0716-1
"H2,H2",2138416,2283606,1573079,710527,1156804,7,610050,611041,510288,100753,5.064742489,318668,322548,228696,107426,36,107390,3,5041,0,0.000679765,mm10,mBC-0716-1
"H2,H3",634180,678927,457651,221276,362993,1,191231,191500,164634,26866,6.127968436,101378,117495,78349,36882,15,36867,4,2803,0,0.010036076,mm10,mBC-0716-1
"H2,H4",13253,13507,10240,3267,7311,0,3273,3273,2349,924,2.542207792,1484,88,57,28,0,28,0,16,0,0,empty,mBC-0716-1
"H2,H5",17623,18134,13209,4925,9722,0,4663,4673,3452,1221,2.827190827,2254,1430,858,421,1,420,1,158,0,0.035714286,empty,mBC-0716-1
"H2,H6",585206,615955,435303,180652,330777,2,161449,161750,129687,32063,4.044755637,82664,96431,69310,32437,11,32426,1,2731,0,0.001295257,mm10,mBC-0716-1
"H2,H7",1409077,1558771,976780,581991,830840,2,493015,493687,384342,109345,3.5149481,277011,167030,118160,56581,15,56566,2,3764,0,0.001166779,mm10,mBC-0716-1
"H2,H8",13738,14035,10266,3769,7622,0,3554,3559,2516,1043,2.412272291,1775,1548,989,498,0,498,0,159,0,0.016064257,empty,mBC-0716-1
"H2,H9",17437,17694,13212,4482,9617,0,4433,4440,3237,1203,2.690773067,2106,6026,1886,925,0,925,0,201,0,0.085405405,empty,mBC-0716-1
"H2,H10",14523,14972,10947,4025,8031,0,3672,3687,2608,1079,2.417052827,1803,1054,662,359,0,359,0,121,0,0.055710306,empty,mBC-0716-1
"H2,H11",17478,18001,13228,4773,9746,0,4464,4476,3175,1301,2.440430438,2234,203,87,51,0,51,0,28,0,0,empty,mBC-0716-1
"H2,H12",6206,6351,4656,1695,3425,0,1638,1642,1156,486,2.378600823,793,743,427,242,0,242,0,75,0,0.078512397,empty,mBC-0716-1
"H3,A1",649543,715810,461448,254362,387399,0,218980,219297,176549,42748,4.129994386,119876,53646,34869,16143,4,16139,2,1828,0,0.001982775,mm10,mBC-0716-1
"H3,A2",18534,18827,14116,4711,10055,0,4318,4331,3075,1256,2.448248408,2110,1662,1030,513,0,513,0,165,0,0.072124756,empty,mBC-0716-1
"H3,A3",649819,684920,481305,203615,365957,1,179006,179304,151844,27460,5.529643117,91683,85732,58967,28224,12,28212,3,2413,0,0.000921594,mm10,mBC-0716-1
"H3,A4",21636,21946,16661,5285,11579,0,5053,5064,3508,1556,2.254498715,2358,712,437,245,0,245,0,73,0,0.073469388,empty,mBC-0716-1
"H3,A5",1365970,1554080,937749,616331,823762,3,507028,507611,409708,97903,4.184836011,288499,246312,176512,84279,29,84250,5,4635,0,0.000902077,mm10,mBC-0716-1
"H3,A6",358935,374641,269771,104870,205232,0,99276,99427,74893,24534,3.052620853,49803,26816,18777,9300,3,9297,1,1280,0,0.005055394,mm10,mBC-0716-1
"H3,A7",16818,17373,12753,4620,9258,0,4307,4320,2960,1360,2.176470588,2109,1380,872,420,0,420,0,126,0,0.042857143,empty,mBC-0716-1
"H3,A8",11162,11479,8424,3055,6208,0,2843,2852,1957,895,2.186592179,1388,1687,1110,616,0,616,0,191,0,0.077922078,empty,mBC-0716-1
"H3,A9",44810,46775,34106,12669,24086,0,11071,11101,8223,2878,2.857192495,5295,2616,1744,889,0,889,0,247,0,0.028121485,empty,mBC-0716-1
"H3,A10",519757,547779,387439,160340,294677,0,142251,142478,120189,22289,5.392301135,72335,27744,18337,8750,7,8743,2,1154,0,0.000343132,mm10,mBC-0716-1
"H3,A11",17639,17871,13537,4334,9517,1,4210,4225,3002,1223,2.454619787,1909,1476,925,455,0,455,0,129,0,0.028571429,empty,mBC-0716-1
"H3,A12",21849,21815,16527,5288,11144,0,4879,4889,3396,1493,2.274614869,2263,36889,12880,6583,7,6576,4,1007,0,0.036192214,empty,mBC-0716-1
"H3,B1",919236,976341,679199,297142,512288,2,265115,265474,199010,66464,2.994252528,136773,31954,23254,10967,3,10964,1,1326,0,0.002918643,mm10,mBC-0716-1
"H3,B2",900777,990458,654048,336410,522199,0,289030,289433,213743,75690,2.823926542,154835,50227,31484,15306,10,15296,3,1671,0,0.006537657,mm10,mBC-0716-1
"H3,B3",20333,21404,15306,6098,11302,0,5318,5328,3684,1644,2.240875912,2756,1433,853,480,0,480,0,168,0,0.025,empty,mBC-0716-1
"H3,B4",16980,17609,13069,4540,9366,0,4188,4192,2932,1260,2.326984127,2029,1234,817,418,0,418,0,128,0,0.062200957,empty,mBC-0716-1
"H3,B5",8862,5607,3920,1687,3865,0,1847,1864,1291,573,2.253054101,1005,980,625,295,0,295,0,88,0,0.074576271,empty,mBC-0716-1
"H3,B6",11857,12317,9126,3191,6462,0,2933,2943,2020,923,2.18851571,1411,1343,877,447,1,446,1,124,0,0.022421525,empty,mBC-0716-1
"H3,B7",16995,17707,13090,4617,9385,0,4213,4222,2938,1284,2.288161994,2025,1062,685,340,0,340,0,112,0,0.064705882,empty,mBC-0716-1
"H3,B8",13836,13967,10635,3332,7488,0,3268,3273,2270,1003,2.263210369,1500,1370,893,459,0,459,0,157,0,0.021786492,empty,mBC-0716-1
"H3,B9",15769,15759,12071,3688,8258,0,3607,3609,2570,1039,2.473532243,1627,863,589,307,1,306,1,87,0,0.179738562,empty,mBC-0716-1
"H3,B10",16864,16185,11854,4331,9056,0,4151,4192,2809,1383,2.031091829,2109,785,450,241,0,241,0,75,0,0.087136929,empty,mBC-0716-1
"H3,B11",15856,16136,12149,3987,8561,0,3884,3889,2765,1124,2.459964413,1854,256,166,89,0,89,0,52,0,0.112359551,empty,mBC-0716-1
"H3,B12",17874,18253,13690,4563,9798,0,4303,4320,3041,1279,2.37763878,2036,2072,1116,564,0,564,0,181,0,0.030141844,empty,mBC-0716-1
"H3,C1",22877,22875,17668,5207,11882,0,4906,4918,3428,1490,2.300671141,2187,845,565,326,0,326,0,108,0,0.147239264,empty,mBC-0716-1
"H3,C2",5246488,5594033,3688570,1905463,2735609,4,1683053,1685491,1288286,397205,3.243378105,902943,439599,273711,130356,55,130301,8,6256,0,0.004604723,mm10,mBC-0716-1
"H3,C3",24355,25013,18449,6564,13215,0,6164,6178,4409,1769,2.49236857,2980,1014,534,269,0,269,0,94,0,0.048327138,empty,mBC-0716-1
"H3,C4",17438,17587,13376,4211,9337,0,4129,4138,2976,1162,2.561101549,1931,3538,1364,719,1,718,1,196,0,0.043175487,empty,mBC-0716-1
"H3,C5",18497,18781,14074,4707,9995,0,4496,4515,3261,1254,2.600478469,2101,1936,1152,581,0,581,0,160,0,0.063683305,empty,mBC-0716-1
"H3,C6",17094,17467,12987,4480,9548,0,4377,4390,3096,1294,2.392581144,2079,1402,910,473,0,473,0,145,0,0.033826638,empty,mBC-0716-1
"H3,C7",625698,648936,466894,182042,346783,3,166822,167078,134180,32898,4.078667396,83474,6086,4141,2114,0,2114,0,426,0,0.00756859,mm10,mBC-0716-1
"H3,C8",15264,15952,11541,4411,8465,0,3875,3890,2654,1236,2.147249191,1904,1924,1259,593,0,593,0,191,0,0.042158516,empty,mBC-0716-1
"H3,C9",13588,13892,10354,3538,7268,0,3312,3314,2291,1023,2.239491691,1497,1102,682,364,0,364,0,117,0,0.06043956,empty,mBC-0716-1
"H3,C10",14232,14567,10954,3613,7789,0,3510,3522,2367,1155,2.049350649,1716,1151,684,363,0,363,0,116,0,0.002754821,empty,mBC-0716-1
"H3,C11",12251,12725,9312,3413,6871,0,3214,3217,2249,968,2.323347107,1535,1154,674,315,0,315,0,108,0,0.073015873,empty,mBC-0716-1
"H3,C12",19884,20521,15185,5336,10823,0,4915,4929,3505,1424,2.461376404,2371,1527,890,447,0,447,0,136,0,0.078299776,empty,mBC-0716-1
"H3,D1",11004,11241,8242,2999,6131,0,2861,2869,2022,847,2.387249115,1377,609,416,211,0,211,0,76,0,0.033175355,empty,mBC-0716-1
"H3,D2",21892,22287,16830,5457,11593,0,5122,5143,3550,1593,2.228499686,2389,4942,2451,1265,1,1264,1,293,0,0.064873418,empty,mBC-0716-1
"H3,D3",13953,14312,10620,3692,7662,0,3509,3521,2479,1042,2.379078695,1675,1154,714,401,0,401,0,130,0,0.134663342,empty,mBC-0716-1
"H3,D4",14289,14836,10832,4004,7783,0,3553,3562,2422,1140,2.124561404,1717,1471,930,488,1,487,1,169,0,0.057494867,empty,mBC-0716-1
"H3,D5",13740,14128,10327,3801,7485,0,3468,3469,2405,1064,2.260338346,1678,4529,1723,914,0,914,0,228,0,0.035010941,empty,mBC-0716-1
"H3,D6",464671,490850,349137,141713,265816,3,125178,125412,105057,20355,5.161238025,64008,92259,65487,31173,11,31162,1,2671,0,0.001091072,mm10,mBC-0716-1
"H3,D7",13297,13461,9915,3546,7223,0,3319,3323,2369,954,2.483228512,1599,1834,1146,640,0,640,0,204,0,0.028125,empty,mBC-0716-1
"H3,D8",16262,16907,12258,4649,8913,0,4222,4225,2908,1317,2.208048595,2068,1066,611,316,0,316,0,119,0,0.047468354,empty,mBC-0716-1
"H3,D9",5198,5332,3887,1445,2973,0,1416,1421,1023,398,2.570351759,688,18310,5853,2998,2,2996,2,499,0,0.17222964,empty,mBC-0716-1
"H3,D10",15801,16284,11874,4410,8587,0,4071,4079,2840,1239,2.292171106,1987,5972,2101,1106,0,1106,0,251,0,0.039783002,empty,mBC-0716-1
"H3,D11",13407,13780,10155,3625,7364,0,3371,3380,2322,1058,2.194706994,1654,1537,966,518,0,518,0,177,0,0.021235521,empty,mBC-0716-1
"H3,D12",20757,22034,15987,6047,11407,1,5227,5247,3561,1686,2.112099644,2575,2756,1786,942,0,942,0,263,0,0.076433121,empty,mBC-0716-1
"H3,E1",22716,22998,16983,6015,11890,0,5318,5324,3695,1629,2.268262738,2553,25553,8279,4219,2,4217,1,670,0,0.123547546,empty,mBC-0716-1
"H3,E2",16845,17093,12793,4300,9066,0,4040,4053,2775,1278,2.171361502,1920,1684,1056,550,0,550,0,174,0,0.103636364,empty,mBC-0716-1
"H3,E3",390002,389178,300797,88381,211512,0,88029,88262,70024,18238,3.839456081,40422,35600,24255,11696,3,11693,1,1543,0,0.002394595,mm10,mBC-0716-1
"H3,E4",15935,16232,12287,3945,8576,0,3934,3943,2786,1157,2.407951599,1755,1641,1048,563,0,563,0,168,0,0.031971581,empty,mBC-0716-1
"H3,E5",21762,22031,16692,5339,11628,0,5139,5148,3609,1539,2.34502924,2363,1475,888,442,0,442,0,166,0,0.042986425,empty,mBC-0716-1
"H3,E6",17729,18086,13582,4504,9597,0,4411,4425,3145,1280,2.45703125,2136,1946,1257,630,0,630,0,170,0,0.03968254,empty,mBC-0716-1
"H3,E7",14165,14390,10785,3605,7727,0,3439,3451,2392,1059,2.258734655,1639,1467,944,472,0,472,0,137,0,0.086864407,empty,mBC-0716-1
"H3,E8",17936,18337,13779,4558,9754,0,4330,4336,3116,1220,2.554098361,2049,2101,1303,673,0,673,0,190,0,0.028231798,empty,mBC-0716-1
"H3,E9",394304,418818,291312,127506,226679,0,112854,113041,95538,17503,5.458378564,58014,168361,118366,56993,31,56962,3,3523,0,0.000438889,mm10,mBC-0716-1
"H3,E10",13154,13683,10004,3679,7194,0,3331,3337,2279,1058,2.154064272,1566,1643,993,530,0,530,0,161,0,0.028301887,empty,mBC-0716-1
"H3,E11",9218,9400,6838,2562,5177,0,2423,2433,1629,804,2.026119403,1160,1214,805,453,0,453,0,132,0,0.094922737,empty,mBC-0716-1
"H3,E12",14545,15199,10993,4206,8284,0,3900,3909,2645,1264,2.092563291,1939,1480,880,465,0,465,0,141,0,0.08172043,empty,mBC-0716-1
"H3,F1",791766,842163,580000,262163,446406,0,229549,229950,191236,38714,4.939711732,120003,145028,93131,44045,23,44022,3,3111,0,0.004179728,mm10,mBC-0716-1
"H3,F2",1518729,1622444,1108213,514231,843810,1,443178,443857,382385,61472,6.220474362,233050,314368,219437,105456,54,105402,9,5075,0,0.001081573,mm10,mBC-0716-1
"H3,F3",760089,914257,483531,430726,489198,2,339705,340077,220180,119897,1.836409585,209136,34389,20795,9884,8,9876,2,1395,0,0.002936412,mm10,mBC-0716-1
"H3,F4",17452,17519,13053,4466,9480,0,4333,4342,3089,1253,2.46528332,2059,926,572,331,0,331,0,123,0,0.033232628,empty,mBC-0716-1
"H3,F5",2703236,2919567,1937175,982392,1477523,6,846449,847754,658720,189034,3.484664134,452996,139033,96060,46398,26,46372,4,3451,0,0.003062193,mm10,mBC-0716-1
"H3,F6",302287,310120,227918,82202,166306,0,80298,80433,58190,22243,2.616103943,38755,3833,1888,902,1,901,1,262,0,0.039955605,empty,mBC-0716-1
"H3,F7",1252712,1424208,837897,586311,759974,3,483155,483734,401267,82467,4.86578874,277051,42013,29380,14075,9,14066,1,1609,0,0.001777335,mm10,mBC-0716-1
"H3,F8",861067,981455,580133,401322,520493,3,328003,328419,263283,65136,4.042050479,189852,8620,5959,2819,2,2817,1,518,0,0.002484913,mm10,mBC-0716-1
"H3,F9",15280,15907,11813,4094,8337,0,3749,3764,2658,1106,2.403254973,1791,1933,1227,649,1,648,1,211,0,0.021604938,empty,mBC-0716-1
"H3,F10",20874,21289,16084,5205,11191,0,4857,4861,3463,1398,2.477110157,2274,1671,1096,577,0,577,0,158,0,0.103986135,empty,mBC-0716-1
"H3,F11",11323,11704,8700,3004,6268,0,2771,2778,1965,813,2.41697417,1367,1083,718,390,0,390,0,132,0,0.041025641,empty,mBC-0716-1
"H3,F12",14075,14334,10694,3640,7496,0,3427,3438,2420,1018,2.377210216,1618,151,108,63,0,63,0,22,0,0,empty,mBC-0716-1
"H3,G1",10886,11041,8284,2757,5889,0,2613,2619,1857,762,2.437007874,1238,2623,1657,816,1,815,1,197,0,0.055214724,empty,mBC-0716-1
"H3,G2",20947,21278,16007,5271,11241,0,5031,5041,3611,1430,2.525174825,2413,352,218,127,0,127,0,52,0,0.204724409,empty,mBC-0716-1
"H3,G3",24661,25410,18538,6872,13543,0,6395,6401,4585,1816,2.524779736,3099,2096,1387,689,2,687,2,214,0,0.045123726,empty,mBC-0716-1
"H3,G4",28807,29387,22460,6927,15492,0,6626,6645,4742,1903,2.491854966,3085,101,71,51,0,51,0,32,0,0.156862745,empty,mBC-0716-1
"H3,G5",13576,14052,10178,3874,7416,0,3481,3485,2427,1058,2.293950851,1723,6583,2037,1070,1,1069,1,234,0,0.049579046,empty,mBC-0716-1
"H3,G6",24554,24712,19082,5630,12979,0,5495,5503,3817,1686,2.263938316,2435,199,119,79,0,79,0,52,0,0,empty,mBC-0716-1
"H3,G7",21209,21275,16293,4982,11300,1,4808,4817,3403,1414,2.406647808,2224,9367,3238,1599,3,1596,2,343,0,0.035714286,empty,mBC-0716-1
"H3,G8",14501,14701,10876,3825,7813,0,3666,3670,2574,1096,2.348540146,1748,1655,1050,543,0,543,0,169,0,0.033149171,empty,mBC-0716-1
"H3,G9",11292,11512,8536,2976,6097,0,2851,2853,2002,851,2.352526439,1331,8482,3164,1680,2,1678,2,339,0,0.226460072,empty,mBC-0716-1
"H3,G10",13929,14218,10658,3560,7465,0,3321,3328,2352,976,2.409836066,1573,1667,1080,540,1,539,1,156,0,0.038961039,empty,mBC-0716-1
"H3,G11",12687,12809,9765,3044,6860,0,3043,3043,2178,865,2.517919075,1393,1041,684,360,1,359,1,126,0,0.027855153,empty,mBC-0716-1
"H3,G12",11914,12195,9072,3123,6549,0,3009,3021,2099,922,2.276572668,1443,1342,808,379,0,379,0,143,0,0.018469657,empty,mBC-0716-1
"H3,H1",478263,481457,363185,118272,262446,0,118487,118731,89039,29692,2.998753873,56679,20757,8289,4097,3,4094,1,768,0,0.030288227,mm10,mBC-0716-1
"H3,H2",33576,34729,25236,9493,18087,0,8725,8748,6113,2635,2.319924099,4281,22362,7360,3625,4,3621,3,602,0,0.049986192,empty,mBC-0716-1
"H3,H3",19736,19939,14679,5260,10791,0,4924,4936,3503,1433,2.444521982,2389,1726,1087,585,0,585,0,178,0,0.044444444,empty,mBC-0716-1
"H3,H4",13549,13873,10279,3594,7357,0,3313,3329,2213,1116,1.98297491,1588,140,85,48,0,48,0,27,0,0,empty,mBC-0716-1
"H3,H5",2178297,2419469,1544999,874470,1244965,2,725953,727056,580943,146113,3.975984341,402462,299388,215990,102855,45,102810,4,4922,0,0.000885128,mm10,mBC-0716-1
"H3,H6",13782,14144,10465,3679,7525,0,3440,3448,2432,1016,2.393700787,1602,2044,1319,724,1,723,1,223,0,0.033195021,empty,mBC-0716-1
"H3,H7",1471954,1628614,1014673,613941,864352,0,518355,519061,376031,143030,2.629035867,292677,132634,91128,43965,20,43945,2,3377,0,0.000728183,mm10,mBC-0716-1
"H3,H8",630622,679563,448509,231054,361252,2,195660,195917,171712,24205,7.094071473,105138,147782,101906,48576,19,48557,4,3361,0,0.002409539,mm10,mBC-0716-1
"H3,H9",15280,15758,11608,4150,8463,0,3793,3804,2672,1132,2.360424028,1861,1494,914,474,1,473,1,159,0,0.069767442,empty,mBC-0716-1
"H3,H10",14001,14292,10491,3801,7564,0,3492,3497,2432,1065,2.283568075,1661,1253,791,423,0,423,0,136,0,0.070921986,empty,mBC-0716-1
"H3,H11",17291,18100,13045,5055,9682,0,4627,4639,3264,1375,2.373818182,2308,459,140,90,0,90,0,47,0,0.022222222,empty,mBC-0716-1
"H3,H12",6058,6316,4621,1695,3426,0,1567,1570,1119,451,2.481152993,772,971,591,312,0,312,0,77,0,0.150641026,empty,mBC-0716-1
"H4,A1",17983,18920,13393,5527,10317,0,5036,5041,3568,1473,2.422267481,2550,3046,1065,533,0,533,0,129,0,0.033771107,empty,mBC-0716-1
"H4,A2",22599,22890,16931,5959,12198,0,5539,5567,3968,1599,2.481550969,2691,31638,9067,4859,5,4854,2,715,0,0.060774619,empty,mBC-0716-1
"H4,A3",18761,19536,14310,5226,10362,0,4827,4836,3419,1417,2.412844037,2319,771,514,253,0,253,0,71,0,0.075098814,empty,mBC-0716-1
"H4,A4",21276,21734,16553,5181,11443,0,4893,4902,3477,1425,2.44,2307,476,278,143,0,143,0,52,0,0.076923077,empty,mBC-0716-1
"H4,A5",908674,1020637,611196,409441,540329,1,339642,340089,264879,75210,3.521858795,193567,62950,45312,21707,7,21700,1,2064,0,0.00078341,mm10,mBC-0716-1
"H4,A6",15254,15665,11311,4354,8490,0,4008,4013,2839,1174,2.418228279,2018,2654,1052,587,0,587,0,144,0,0.078364566,empty,mBC-0716-1
"H4,A7",17248,17762,13146,4616,9439,0,4273,4291,3014,1277,2.360219264,2028,975,583,331,0,331,0,90,0,0.009063444,empty,mBC-0716-1
"H4,A8",12067,12815,9010,3805,6745,0,3229,3237,2258,979,2.306435138,1644,1643,756,390,0,390,0,125,0,0.015384615,empty,mBC-0716-1
"H4,A9",19559,20196,14999,5197,10564,0,4727,4742,3357,1385,2.423826715,2297,853,499,247,0,247,0,81,0,0.085020243,empty,mBC-0716-1
"H4,A10",521742,556562,374266,182296,302223,1,163514,163783,120639,43144,2.796194141,87096,5310,2382,1217,1,1216,1,243,0,0.037006579,mm10,mBC-0716-1
"H4,A11",20502,20763,15664,5099,11068,0,4995,5004,3578,1426,2.50911641,2334,997,515,252,0,252,0,69,0,0.099206349,empty,mBC-0716-1
"H4,A12",21334,21947,16546,5401,11526,0,5055,5063,3593,1470,2.444217687,2260,1697,1104,518,0,518,0,133,0,0.032818533,empty,mBC-0716-1
"H4,B1",19647,20062,14906,5156,10667,0,4782,4791,3363,1428,2.355042017,2282,4670,1605,858,0,858,0,184,0,0.092074592,empty,mBC-0716-1
"H4,B2",2783367,2927114,2051548,875566,1477780,4,806846,808088,603911,204177,2.957781729,410578,29298,15905,7843,4,7839,2,1239,0,0.007654038,mm10,mBC-0716-1
"H4,B3",20489,21286,15638,5648,11119,0,5066,5078,3619,1459,2.480466073,2472,955,489,278,0,278,0,93,0,0.017985612,empty,mBC-0716-1
"H4,B4",17205,17718,13206,4512,9442,0,4389,4398,3118,1280,2.4359375,2103,683,445,244,0,244,0,76,0,0.040983607,empty,mBC-0716-1
"H4,B5",15478,11543,8046,3497,7425,0,3646,3669,2680,989,2.709807887,1970,758,370,210,0,210,0,66,0,0.10952381,empty,mBC-0716-1
"H4,B6",13649,14283,10319,3964,7614,0,3638,3647,2557,1090,2.34587156,1830,7867,2677,1326,0,1326,0,237,0,0.131975867,empty,mBC-0716-1
"H4,B7",17235,17398,13073,4325,9289,0,4130,4144,2863,1281,2.234972678,1958,10829,3378,1679,0,1679,0,280,0,0.025610482,empty,mBC-0716-1
"H4,B8",13952,14482,10713,3769,7696,0,3495,3508,2514,994,2.52917505,1666,523,357,210,0,210,0,82,0,0.038095238,empty,mBC-0716-1
"H4,B9",15671,16203,12028,4175,8485,0,3830,3835,2648,1187,2.230834035,1806,4276,1480,701,7,694,2,157,0,0.025936599,empty,mBC-0716-1
"H4,B10",18086,18069,13152,4917,10010,1,4605,4625,3182,1443,2.205128205,2252,466,272,112,0,112,0,30,0,0,empty,mBC-0716-1
"H4,B11",30252,30668,21684,8984,16262,0,8219,8228,5755,2473,2.327133037,4048,127,70,42,0,42,0,18,0,0.071428571,empty,mBC-0716-1
"H4,B12",1217530,1314618,892087,422531,696121,2,367129,367760,306172,61588,4.971293109,193617,143779,101459,48971,18,48953,1,3381,0,0.000796683,mm10,mBC-0716-1
"H4,C1",23272,23391,18109,5282,12171,0,5089,5094,3622,1472,2.460597826,2306,570,391,204,0,204,0,61,0,0.107843137,empty,mBC-0716-1
"H4,C2",22552,23464,16971,6493,12599,0,5991,6007,4310,1697,2.539776075,2940,1367,803,437,1,436,1,117,0,0.119266055,empty,mBC-0716-1
"H4,C3",21360,21811,16086,5725,11459,0,5310,5314,3713,1601,2.319175515,2543,2088,653,372,1,371,1,85,0,0.051212938,empty,mBC-0716-1
"H4,C4",20423,20737,15489,5248,11252,0,5056,5070,3628,1442,2.515950069,2399,886,543,252,0,252,0,92,0,0.03968254,empty,mBC-0716-1
"H4,C5",17448,18149,13484,4665,9544,0,4297,4302,2958,1344,2.200892857,2042,692,370,188,0,188,0,70,0,0.04787234,empty,mBC-0716-1
"H4,C6",19020,19516,14005,5511,10774,0,5094,5104,3591,1513,2.373430271,2529,11044,3962,2019,1,2018,1,309,0,0.200693756,empty,mBC-0716-1
"H4,C7",18332,19060,14015,5045,10148,0,4757,4772,3385,1387,2.440519106,2317,217,147,72,0,72,0,28,0,0.013888889,empty,mBC-0716-1
"H4,C8",17183,17797,13118,4679,9362,0,4275,4279,2976,1303,2.283960092,2054,3074,1267,635,2,633,1,152,0,0.02685624,empty,mBC-0716-1
"H4,C9",589954,634018,432247,201771,341201,0,176913,177219,137101,40118,3.417443542,93569,27842,19340,9423,0,9423,0,1223,0,0.001061233,mm10,mBC-0716-1
"H4,C10",14622,15286,11217,4069,8079,0,3670,3679,2603,1076,2.419144981,1735,859,533,256,0,256,0,72,0,0.0390625,empty,mBC-0716-1
"H4,C11",12400,13157,9331,3826,6832,0,3242,3248,2237,1011,2.212660732,1618,1974,768,414,1,413,1,98,0,0.004842615,empty,mBC-0716-1
"H4,C12",21778,22244,16631,5613,11862,1,5319,5333,3774,1559,2.420782553,2566,716,467,235,0,235,0,78,0,0.029787234,empty,mBC-0716-1
"H4,D1",14288,15093,10601,4492,8181,0,4070,4075,2913,1162,2.506884682,2121,429,238,127,0,127,0,45,0,0,empty,mBC-0716-1
"H4,D2",20978,21613,16054,5559,11342,0,4931,4949,3393,1556,2.18059126,2370,3070,1607,833,1,832,1,176,0,0.159855769,empty,mBC-0716-1
"H4,D3",15212,16040,11602,4438,8603,0,4054,4064,2865,1199,2.389491243,2002,681,414,212,0,212,0,77,0,0.047169811,empty,mBC-0716-1
"H4,D4",15957,16624,12192,4432,8868,0,4068,4079,2841,1238,2.294830372,2005,654,408,226,0,226,0,76,0,0.017699115,empty,mBC-0716-1
"H4,D5",16293,16840,12422,4418,9060,0,4183,4193,2990,1203,2.485453034,1995,783,477,243,1,242,1,102,0,0.078512397,empty,mBC-0716-1
"H4,D6",14000,14832,10466,4366,7986,0,3851,3865,2708,1157,2.340535869,1963,2202,894,424,0,424,0,114,0,0.051886792,empty,mBC-0716-1
"H4,D7",15513,16338,11716,4622,8658,0,4167,4172,2950,1222,2.414075286,2044,1232,808,417,0,417,0,128,0,0.040767386,empty,mBC-0716-1
"H4,D8",17797,18573,13290,5283,9985,0,4804,4813,3396,1417,2.396612562,2412,5283,1843,932,2,930,1,186,0,0.113978495,empty,mBC-0716-1
"H4,D9",8320,8834,6182,2652,4916,0,2523,2529,1810,719,2.517385257,1275,738,445,232,0,232,0,82,0,0.060344828,empty,mBC-0716-1
"H4,D10",14633,15199,11109,4090,8088,0,3815,3827,2658,1169,2.273738238,1778,579,336,169,0,169,0,59,0,0.053254438,empty,mBC-0716-1
"H4,D11",14756,15421,11326,4095,8224,0,3870,3880,2827,1053,2.684710351,1862,1186,786,385,0,385,0,106,0,0.077922078,empty,mBC-0716-1
"H4,D12",21578,22441,16497,5944,11926,0,5580,5592,3882,1710,2.270175439,2729,1634,1073,535,0,535,0,158,0,0.078504673,empty,mBC-0716-1
"H4,E1",24039,24632,18269,6363,13081,0,5862,5874,4200,1674,2.508960573,2832,1081,677,394,0,394,0,119,0,0.058375635,empty,mBC-0716-1
"H4,E2",19044,19923,14559,5364,10646,0,4906,4919,3524,1395,2.526164875,2395,5133,1891,970,3,967,2,198,0,0.045501551,empty,mBC-0716-1
"H4,E3",700928,792972,482608,310364,422452,0,259385,259776,188090,71686,2.623803811,147073,48479,34265,16750,3,16747,1,1846,0,0.001970502,mm10,mBC-0716-1
"H4,E4",958744,1024969,709570,315399,530446,1,270645,271083,226433,44650,5.071287794,139496,83325,58799,28114,14,28100,2,2502,0,0.002704626,mm10,mBC-0716-1
"H4,E5",21139,21624,16342,5282,11593,0,5156,5169,3563,1606,2.218555417,2434,870,554,297,0,297,0,99,0,0.033670034,empty,mBC-0716-1
"H4,E6",17147,17861,12766,5095,9302,0,4394,4395,3093,1302,2.375576037,2180,7754,2746,1368,0,1368,0,263,0,0.124269006,empty,mBC-0716-1
"H4,E7",15490,16140,11984,4156,8474,0,3763,3770,2608,1162,2.244406196,1774,1069,745,389,0,389,0,92,0,0.038560411,empty,mBC-0716-1
"H4,E8",20377,20426,15081,5345,10554,0,4793,4802,3426,1376,2.489825581,2230,58401,18388,9372,11,9361,3,1129,0,0.122422818,empty,mBC-0716-1
"H4,E9",10970,11349,8227,3122,6219,0,2929,2935,2078,857,2.424737456,1516,714,436,231,0,231,0,73,0,0.095238095,empty,mBC-0716-1
"H4,E10",13543,14163,10457,3706,7544,0,3530,3538,2440,1098,2.222222222,1683,913,578,273,0,273,0,86,0,0.04029304,empty,mBC-0716-1
"H4,E11",11033,11624,8451,3173,6292,0,2942,2949,2078,871,2.38576349,1468,668,419,235,0,235,0,76,0,0.059574468,empty,mBC-0716-1
"H4,E12",17105,17642,12951,4691,9501,0,4428,4432,3068,1364,2.249266862,2151,916,637,336,0,336,0,102,0,0.12202381,empty,mBC-0716-1
"H4,F1",18284,18596,14117,4479,9918,0,4415,4424,3095,1329,2.328818661,2081,977,631,358,0,358,0,83,0,0.041899441,empty,mBC-0716-1
"H4,F2",24320,25583,18431,7152,13556,5,6365,6382,4524,1858,2.434876211,3149,1477,908,498,0,498,0,162,0,0.012048193,empty,mBC-0716-1
"H4,F3",19359,20316,14484,5832,10769,0,5225,5238,3731,1507,2.475779695,2566,2990,1304,663,0,663,0,166,0,0.070889894,empty,mBC-0716-1
"H4,F4",21754,22090,16445,5645,12297,1,5770,5783,4287,1496,2.865641711,2751,366,215,104,0,104,0,46,0,0.067307692,empty,mBC-0716-1
"H4,F5",26005,26806,19743,7063,14421,0,6529,6536,4632,1904,2.432773109,3156,1451,837,416,1,415,1,106,0,0.089156627,empty,mBC-0716-1
"H4,F6",26575,27762,20371,7391,14772,0,6815,6827,4902,1925,2.546493506,3384,1449,920,499,0,499,0,152,0,0.078156313,empty,mBC-0716-1
"H4,F7",20927,21392,16041,5351,11774,0,5313,5321,3759,1562,2.40653009,2522,523,250,151,0,151,0,59,0,0.046357616,empty,mBC-0716-1
"H4,F8",25124,25772,19197,6575,13703,0,6241,6258,4375,1883,2.323420074,2933,220,166,79,0,79,0,27,0,0,empty,mBC-0716-1
"H4,F9",17288,17947,13188,4759,9607,0,4431,4439,3137,1302,2.4093702,2104,1157,706,372,0,372,0,118,0,0.083333333,empty,mBC-0716-1
"H4,F10",20664,20876,16045,4831,11122,0,4801,4811,3380,1431,2.361984626,2156,809,536,279,1,278,1,86,0,0.053956835,empty,mBC-0716-1
"H4,F11",12495,12964,9542,3422,7006,0,3210,3215,2238,977,2.290685773,1556,545,349,198,0,198,0,66,0,0.02020202,empty,mBC-0716-1
"H4,F12",14614,15161,11258,3903,7992,0,3641,3650,2506,1144,2.190559441,1744,67,32,16,0,16,0,15,0,0,empty,mBC-0716-1
"H4,G1",10129,10047,7780,2267,5423,0,2388,2393,1668,725,2.300689655,1096,1435,860,424,0,424,0,121,0,0.04009434,empty,mBC-0716-1
"H4,G2",521737,537114,399691,137423,291799,0,134797,135056,101403,33653,3.013193475,65615,3513,1591,836,0,836,0,188,0,0.020334928,empty,mBC-0716-1
"H4,G3",21374,22404,16331,6073,11850,0,5517,5531,3903,1628,2.397420147,2710,1341,825,386,1,385,1,128,0,0.025974026,empty,mBC-0716-1
"H4,G4",29967,30260,23000,7260,15969,0,6874,6885,4855,2030,2.391625616,3169,110,37,20,0,20,0,15,0,0.15,empty,mBC-0716-1
"H4,G5",14471,15260,11219,4041,7909,0,3687,3694,2588,1106,2.339963834,1712,718,464,238,0,238,0,79,0,0.021008403,empty,mBC-0716-1
"H4,G6",27095,27634,20907,6727,14556,0,6417,6445,4617,1828,2.52571116,3002,139,93,56,0,56,0,24,0,0.125,empty,mBC-0716-1
"H4,G7",20534,21211,15928,5283,11246,0,5011,5020,3600,1420,2.535211268,2366,1436,926,491,0,491,0,125,0,0.077393075,empty,mBC-0716-1
"H4,G8",16235,16887,12283,4604,8959,0,4115,4133,2990,1143,2.61592301,1993,1183,747,345,0,345,0,104,0,0.037681159,empty,mBC-0716-1
"H4,G9",13971,14528,10665,3863,7729,0,3636,3641,2641,1000,2.641,1784,1519,864,417,0,417,0,121,0,0.011990408,empty,mBC-0716-1
"H4,G10",14591,15021,11098,3923,8068,0,3728,3731,2606,1125,2.316444444,1836,941,621,292,0,292,0,102,0,0,empty,mBC-0716-1
"H4,G11",13674,14193,10435,3758,7633,0,3547,3556,2510,1046,2.399617591,1759,387,247,136,0,136,0,61,0,0.007352941,empty,mBC-0716-1
"H4,G12",13063,13773,9795,3978,7422,0,3615,3623,2516,1107,2.272809395,1845,795,473,243,0,243,0,74,0,0.053497942,empty,mBC-0716-1
"H4,H1",23075,23620,17534,6086,12718,0,5871,5877,4276,1601,2.670830731,2774,729,466,258,0,258,0,84,0,0.054263566,empty,mBC-0716-1
"H4,H2",24767,25139,19033,6106,13157,0,5810,5830,4164,1666,2.49939976,2662,1410,907,465,0,465,0,131,0,0.034408602,empty,mBC-0716-1
"H4,H3",2172632,2424331,1509412,914919,1258390,2,766098,767151,620835,146316,4.243110801,430825,126271,89971,42980,18,42962,2,3266,0,0.001838834,mm10,mBC-0716-1
"H4,H4",15870,16519,12113,4406,8829,0,4140,4145,2908,1237,2.350848828,2001,129,89,44,0,44,0,18,0,0,empty,mBC-0716-1
"H4,H5",20957,21777,15801,5976,11705,0,5515,5524,3987,1537,2.594014314,2732,6140,2033,1004,1,1003,1,228,0,0.005982054,empty,mBC-0716-1
"H4,H6",18054,18766,13797,4969,10188,0,4899,4902,3518,1384,2.541907514,2416,1167,784,379,0,379,0,101,0,0,empty,mBC-0716-1
"H4,H7",1777846,1950450,1246667,703783,1018268,2,600786,601591,470408,131183,3.585891465,332147,94299,66775,32495,15,32480,3,2725,0,0.001323892,mm10,mBC-0716-1
"H4,H8",15942,16874,12053,4821,9184,0,4366,4375,3105,1270,2.44488189,2183,2353,1099,504,0,504,0,142,0,0.049603175,empty,mBC-0716-1
"H4,H9",18331,19134,14094,5040,10221,0,4705,4719,3447,1272,2.70990566,2289,907,597,319,1,318,1,98,0,0.072327044,empty,mBC-0716-1
"H4,H10",17677,18100,13273,4827,9678,0,4498,4510,3221,1289,2.498836307,2202,1056,551,285,0,285,0,97,0,0.045614035,empty,mBC-0716-1
"H4,H11",19899,21212,14878,6334,11332,0,5447,5460,3933,1527,2.575638507,2786,101,63,45,0,45,0,30,0,0,empty,mBC-0716-1
"H4,H12",2190927,2391566,1567556,824010,1244518,1,701301,702296,558117,144179,3.871000631,382501,264956,186320,90306,29,90277,5,4866,0,0.000387696,mm10,mBC-0716-1
"H5,A1",13422,13908,10120,3788,7433,0,3514,3521,2445,1076,2.272304833,1756,1136,686,345,0,345,0,89,0,0.130434783,empty,mBC-0716-1
"H5,A2",771274,865841,508716,357125,459843,0,293820,294179,210494,83685,2.515313378,171069,32025,23084,11105,3,11102,1,1389,0,0.003512881,mm10,mBC-0716-1
"H5,A3",16241,16613,12460,4153,8821,0,3954,3962,2737,1225,2.234285714,1848,909,577,320,0,320,0,99,0,0.01875,empty,mBC-0716-1
"H5,A4",1075952,1147928,795136,352792,593375,3,307838,308372,245005,63367,3.866444679,158779,49362,29748,14099,6,14093,2,1538,0,0.003334989,mm10,mBC-0716-1
"H5,A5",17053,17391,13089,4302,9277,0,4188,4194,2906,1288,2.25621118,1977,1646,935,506,0,506,0,139,0,0.013833992,empty,mBC-0716-1
"H5,A6",12808,13240,9803,3437,7044,0,3267,3272,2307,965,2.390673575,1553,1548,892,423,0,423,0,142,0,0.016548463,empty,mBC-0716-1
"H5,A7",15587,16004,11666,4338,8647,0,3962,3966,2738,1228,2.229641694,1955,2107,944,456,0,456,0,132,0,0.103070175,empty,mBC-0716-1
"H5,A8",10765,11126,8156,2970,6086,0,2804,2811,1973,838,2.354415274,1402,5245,1936,916,1,915,1,208,0,0.028415301,empty,mBC-0716-1
"H5,A9",25339,26306,19436,6870,13774,0,6365,6383,4469,1914,2.334900731,3115,2158,1340,647,0,647,0,148,0,0.01236476,empty,mBC-0716-1
"H5,A10",14602,15067,11174,3893,8008,0,3496,3504,2523,981,2.571865443,1683,338,224,94,0,94,0,44,0,0.095744681,empty,mBC-0716-1
"H5,A11",17113,17495,13036,4459,9402,0,4257,4272,3039,1233,2.464720195,2005,16105,5042,2571,2,2569,2,426,0,0.047100039,empty,mBC-0716-1
"H5,A12",20283,21005,15490,5515,10928,0,4793,4805,3354,1451,2.311509304,2327,2332,1583,763,0,763,0,148,0,0.091743119,empty,mBC-0716-1
"H5,B1",18855,19158,14587,4571,10143,0,4529,4546,3213,1333,2.410352588,2063,1333,804,398,2,396,1,98,0,0.098484848,empty,mBC-0716-1
"H5,B2",20422,20536,15586,4950,10763,0,4789,4801,3312,1489,2.224311619,2145,2062,776,431,0,431,0,84,0,0.164733179,empty,mBC-0716-1
"H5,B3",986846,1051414,734642,316772,549400,2,279805,280263,229430,50833,4.513406645,142962,110540,78298,37593,10,37583,3,2950,0,0.001277173,mm10,mBC-0716-1
"H5,B4",1071506,1158000,766216,391784,600905,0,328135,328614,284092,44522,6.380935268,175485,165004,106334,50330,18,50312,3,3402,0,0.003657179,mm10,mBC-0716-1
"H5,B5",8906,5383,3680,1703,3661,0,1760,1772,1228,544,2.257352941,1017,864,442,267,0,267,0,86,0,0.018726592,empty,mBC-0716-1
"H5,B6",11866,12303,9019,3284,6544,0,3001,3009,2094,915,2.28852459,1489,1126,637,317,0,317,0,95,0,0.069400631,empty,mBC-0716-1
"H5,B7",15968,16125,12254,3871,8536,0,3829,3834,2612,1222,2.137479542,1730,1181,694,350,0,350,0,108,0,0.025714286,empty,mBC-0716-1
"H5,B8",12982,13301,10083,3218,7048,0,3042,3050,2212,838,2.639618138,1404,1082,669,349,0,349,0,114,0,0.068767908,empty,mBC-0716-1
"H5,B9",15167,15853,11592,4261,8281,0,3745,3754,2589,1165,2.222317597,1845,609,334,164,0,164,0,65,0,0.06097561,empty,mBC-0716-1
"H5,B10",15533,15391,11353,4038,8383,0,3852,3865,2664,1201,2.21815154,1872,2884,1082,540,0,540,0,133,0,0.07037037,empty,mBC-0716-1
"H5,B11",15735,16205,12137,4068,8462,0,3849,3855,2749,1106,2.485533454,1775,497,244,144,0,144,0,42,0,0,empty,mBC-0716-1
"H5,B12",18243,18752,13868,4884,9907,0,4554,4555,3248,1307,2.485080337,2156,15499,5035,2559,4,2555,1,429,0,0.065362035,empty,mBC-0716-1
"H5,C1",22606,22700,17526,5174,11921,0,5032,5042,3535,1507,2.345719973,2333,703,419,231,0,231,0,89,0,0.060606061,empty,mBC-0716-1
"H5,C2",18819,18948,14333,4615,9980,0,4470,4475,3116,1359,2.292862399,2077,12430,4048,2046,2,2044,1,363,0,0.045499022,empty,mBC-0716-1
"H5,C3",19655,20282,14961,5321,10641,0,4885,4888,3399,1489,2.282740094,2360,799,501,236,0,236,0,66,0,0.059322034,empty,mBC-0716-1
"H5,C4",112252,102179,97131,5048,58227,0,6453,6483,4318,2165,1.994457275,2223,4230,2666,1290,0,1290,0,339,0,0.017829457,empty,mBC-0716-1
"H5,C5",16037,16526,12166,4360,8698,0,3965,3976,2745,1231,2.229894395,1928,15930,5101,2657,2,2655,1,469,0,0.010546139,empty,mBC-0716-1
"H5,C6",17051,17397,12783,4614,9553,0,4497,4506,3185,1321,2.411052233,2139,1407,881,464,1,463,1,120,0,0.069114471,empty,mBC-0716-1
"H5,C7",15942,16677,11998,4679,8646,0,3997,4011,2780,1231,2.258326564,1969,473,298,160,0,160,0,52,0,0,empty,mBC-0716-1
"H5,C8",14375,15016,10990,4026,8026,0,3683,3690,2585,1105,2.339366516,1799,1684,1101,529,0,529,0,158,0,0.024574669,empty,mBC-0716-1
"H5,C9",12453,13020,9516,3504,6921,0,3260,3271,2275,996,2.284136546,1616,885,584,301,0,301,0,77,0,0.056478405,empty,mBC-0716-1
"H5,C10",13316,13787,10243,3544,7230,0,3199,3201,2236,965,2.317098446,1526,10156,3090,1532,2,1530,1,290,0,0.024183007,empty,mBC-0716-1
"H5,C11",11367,11905,8707,3198,6376,0,2999,3006,2088,918,2.274509804,1463,1108,706,320,0,320,0,98,0,0.075,empty,mBC-0716-1
"H5,C12",19944,20182,14908,5274,10580,1,4781,4801,3335,1466,2.274897681,2292,9685,3208,1565,1,1564,1,236,0,0.202046036,empty,mBC-0716-1
"H5,D1",10944,11594,8242,3352,6277,0,2967,2972,2124,848,2.504716981,1490,723,394,211,0,211,0,60,0,0.066350711,empty,mBC-0716-1
"H5,D2",20638,20812,16052,4760,11037,0,4682,4696,3240,1456,2.225274725,2164,2667,1820,860,1,859,1,193,0,0.067520373,empty,mBC-0716-1
"H5,D3",13178,13599,10079,3520,7353,0,3371,3378,2370,1008,2.351190476,1625,1261,747,358,0,358,0,110,0,0.016759777,empty,mBC-0716-1
"H5,D4",13612,13878,10358,3520,7262,0,3180,3190,2212,978,2.261758691,1491,1040,603,273,0,273,0,90,0,0.076923077,empty,mBC-0716-1
"H5,D5",13467,13483,10383,3100,7271,0,3219,3225,2278,947,2.405491024,1453,1300,813,401,0,401,0,122,0,0.072319202,empty,mBC-0716-1
"H5,D6",11901,12300,9010,3290,6548,0,3093,3098,2120,978,2.167689162,1483,1355,814,366,0,366,0,113,0,0.035519126,empty,mBC-0716-1
"H5,D7",12814,13252,9702,3550,7074,0,3304,3306,2275,1031,2.206595538,1608,8665,3051,1452,4,1448,2,299,0,0.028314917,empty,mBC-0716-1
"H5,D8",15851,16369,12047,4322,8697,0,4011,4014,2843,1171,2.427839453,1914,982,647,331,0,331,0,95,0,0.012084592,empty,mBC-0716-1
"H5,D9",667710,714053,453446,260607,391738,0,233879,234173,150000,84173,1.782044123,130847,121294,41792,20636,14,20622,7,2374,0,0.084763844,mm10,mBC-0716-1
"H5,D10",14993,15721,11158,4563,8494,0,4146,4151,2878,1273,2.260801257,2093,823,502,274,0,274,0,92,0,0.040145985,empty,mBC-0716-1
"H5,D11",14637,15018,11242,3776,8041,0,3642,3649,2564,1085,2.363133641,1710,1229,721,370,0,370,0,129,0,0.097297297,empty,mBC-0716-1
"H5,D12",20146,20730,15527,5203,10892,0,4911,4926,3444,1482,2.32388664,2327,2204,1335,689,0,689,0,199,0,0.033381713,empty,mBC-0716-1
"H5,E1",21285,21614,16388,5226,11285,0,4945,4962,3455,1507,2.292634373,2290,1461,880,434,0,434,0,139,0,0.064516129,empty,mBC-0716-1
"H5,E2",16014,16385,12159,4226,8729,0,3999,4009,2748,1261,2.179222839,1948,1491,833,450,0,450,0,133,0,0.082222222,empty,mBC-0716-1
"H5,E3",11696,11962,8974,2988,6357,0,2842,2850,1960,890,2.202247191,1290,3211,1526,806,0,806,0,198,0,0.047146402,empty,mBC-0716-1
"H5,E4",15089,15525,11527,3998,8118,0,3616,3623,2479,1144,2.166958042,1698,1086,721,398,0,398,0,108,0,0.042713568,empty,mBC-0716-1
"H5,E5",20568,21115,15891,5224,10965,0,4767,4780,3376,1404,2.404558405,2143,1424,841,426,0,426,0,142,0,0.030516432,empty,mBC-0716-1
"H5,E6",13443,13569,10232,3337,7091,0,3118,3123,2198,925,2.376216216,1417,23274,7267,3586,2,3584,1,544,0,0.083984375,empty,mBC-0716-1
"H5,E7",13143,13463,9953,3510,7137,0,3218,3221,2224,997,2.230692076,1539,1299,834,409,0,409,0,117,0,0.046454768,empty,mBC-0716-1
"H5,E8",16712,16862,12947,3915,8913,0,3794,3806,2604,1202,2.166389351,1716,1949,1179,589,0,589,0,157,0,0.098471986,empty,mBC-0716-1
"H5,E9",8822,9060,6708,2352,4831,0,2216,2221,1575,646,2.438080495,1041,1446,930,466,0,466,0,115,0,0.030042918,empty,mBC-0716-1
"H5,E10",12938,13285,9973,3312,7005,0,3157,3171,2177,994,2.190140845,1481,2159,1044,519,1,518,1,138,0,0.013513514,empty,mBC-0716-1
"H5,E11",9310,9450,6959,2491,5104,0,2401,2407,1666,741,2.24831309,1168,14279,4486,2343,3,2340,2,381,0,0.145726496,empty,mBC-0716-1
"H5,E12",15523,15795,11742,4053,8571,0,3925,3932,2772,1160,2.389655172,1921,1330,840,415,0,415,0,110,0,0.096385542,empty,mBC-0716-1
"H5,F1",17649,17904,13591,4313,9500,0,4217,4226,2978,1248,2.386217949,1980,1396,904,485,0,485,0,108,0,0.059793814,empty,mBC-0716-1
"H5,F2",21754,22534,16500,6034,11940,0,5392,5403,3716,1687,2.202726734,2608,2699,1673,842,0,842,0,231,0,0.032066508,empty,mBC-0716-1
"H5,F3",15716,16340,11946,4394,8675,0,4054,4072,2830,1242,2.278582931,1985,1781,1157,541,0,541,0,152,0,0.072088725,empty,mBC-0716-1
"H5,F4",16433,16741,12325,4416,9214,0,4256,4270,2989,1281,2.333333333,2096,1211,506,256,0,256,0,87,0,0.02734375,empty,mBC-0716-1
"H5,F5",901711,962794,655102,307692,505454,0,267050,267492,205374,62118,3.306191442,140253,110651,73754,34805,9,34796,3,3029,0,0.004253362,mm10,mBC-0716-1
"H5,F6",29062,30200,21673,8527,15920,1,7508,7528,5510,2018,2.730426165,3690,5099,2453,1187,0,1187,0,268,0,0.028643639,empty,mBC-0716-1
"H5,F7",19583,19940,14744,5196,10773,0,4868,4882,3376,1506,2.241699867,2346,2521,1077,519,0,519,0,130,0,0.246628131,empty,mBC-0716-1
"H5,F8",23119,23686,17494,6192,12710,0,5894,5912,4180,1732,2.413394919,2783,291,117,64,0,64,0,37,0,0,empty,mBC-0716-1
"H5,F9",15097,15419,11551,3868,8325,0,3770,3770,2645,1125,2.351111111,1773,1609,960,475,0,475,0,156,0,0.042105263,empty,mBC-0716-1
"H5,F10",21496,22106,16735,5371,11494,0,4968,4979,3543,1436,2.467270195,2343,1483,892,453,0,453,0,132,0,0.017660044,empty,mBC-0716-1
"H5,F11",11121,11328,8398,2930,6023,0,2691,2697,1867,830,2.24939759,1270,1009,613,285,0,285,0,90,0,0.070175439,empty,mBC-0716-1
"H5,F12",14002,14146,10647,3499,7410,0,3339,3349,2271,1078,2.106679035,1537,423,126,63,0,63,0,22,0,0,empty,mBC-0716-1
"H5,G1",9835,10224,7678,2546,5530,0,2443,2449,1668,781,2.135723431,1151,1466,880,446,0,446,0,135,0,0.044843049,empty,mBC-0716-1
"H5,G2",20376,20659,15609,5050,10722,0,4625,4641,3279,1362,2.407488987,2109,491,308,152,0,152,0,47,0,0.039473684,empty,mBC-0716-1
"H5,G3",21167,22123,16158,5965,11649,0,5390,5411,3788,1623,2.333949476,2679,1920,1188,580,1,579,1,178,0,0.041450777,empty,mBC-0716-1
"H5,G4",1194671,1303179,835832,467347,677525,1,391260,391844,324089,67755,4.783248469,215081,743,508,246,1,245,1,62,0,0,empty,mBC-0716-1
"H5,G5",12672,12756,9738,3018,6837,0,2956,2967,2020,947,2.133051742,1378,1285,804,404,1,403,1,97,0,0.126550868,empty,mBC-0716-1
"H5,G6",24238,24806,18584,6222,13028,0,5725,5735,3984,1751,2.275271274,2734,206,148,54,0,54,0,28,0,0,empty,mBC-0716-1
"H5,G7",19760,20440,15108,5332,10754,0,4766,4783,3424,1359,2.519499632,2290,1652,969,500,0,500,0,154,0,0.08,empty,mBC-0716-1
"H5,G8",13907,14358,10596,3762,7695,0,3515,3525,2467,1058,2.331758034,1773,1664,992,498,0,498,0,136,0,0.142570281,empty,mBC-0716-1
"H5,G9",10331,10928,7884,3044,5809,0,2734,2736,1952,784,2.489795918,1313,1460,985,466,0,466,0,123,0,0.0472103,empty,mBC-0716-1
"H5,G10",1598988,1822215,1079579,742636,957960,8,602872,603666,491722,111944,4.392571286,347050,212421,149552,70870,27,70843,2,4103,0,0.001157489,mm10,mBC-0716-1
"H5,G11",739246,818912,520076,298836,435753,0,251466,251811,205899,45912,4.484644537,138721,56185,37833,17788,4,17784,2,1766,0,0.001630679,mm10,mBC-0716-1
"H5,G12",687042,717526,508281,209245,386072,0,188199,188491,165750,22741,7.288597687,94618,161394,116135,55188,16,55172,4,3474,0,0.001015008,mm10,mBC-0716-1
"H5,H1",1495118,1622275,1031090,591185,851595,1,511493,512236,354500,157736,2.247426079,283188,59057,35931,17027,7,17020,1,1927,0,0.005875441,mm10,mBC-0716-1
"H5,H2",24307,24271,18239,6032,12501,0,5593,5612,3957,1655,2.390936556,2622,42316,12499,6431,8,6423,2,853,0,0.095438269,empty,mBC-0716-1
"H5,H3",19716,20321,15052,5269,10796,0,4857,4866,3440,1426,2.412342216,2329,10145,3285,1659,3,1656,2,320,0,0.027173913,empty,mBC-0716-1
"H5,H4",13088,13774,9919,3855,7295,0,3312,3324,2303,1021,2.255631734,1668,180,101,57,0,57,0,21,0,0.105263158,empty,mBC-0716-1
"H5,H5",17938,18354,13437,4917,9707,0,4515,4523,3247,1276,2.544670846,2159,28061,8427,4261,3,4258,2,666,0,0.0230155,empty,mBC-0716-1
"H5,H6",13417,14177,10141,4036,7618,0,3609,3616,2568,1048,2.450381679,1814,2296,1249,627,0,627,0,162,0,0.028708134,empty,mBC-0716-1
"H5,H7",17350,17728,12849,4879,9487,0,4448,4463,3105,1358,2.286450663,2211,6866,2629,1294,1,1293,1,327,0,0.020881671,empty,mBC-0716-1
"H5,H8",12924,13319,9747,3572,7131,0,3221,3230,2272,958,2.371607516,1591,1471,917,470,0,470,0,154,0,0.061702128,empty,mBC-0716-1
"H5,H9",15183,15241,11494,3747,8191,0,3692,3699,2614,1085,2.40921659,1673,1032,604,322,0,322,0,111,0,0.080745342,empty,mBC-0716-1
"H5,H10",14661,15298,11086,4212,8049,0,3680,3682,2656,1026,2.588693957,1782,1065,642,332,0,332,0,100,0,0.072289157,empty,mBC-0716-1
"H5,H11",495402,532945,365290,167655,288809,0,149499,149693,102193,47500,2.151431579,79066,215,124,69,0,69,0,39,0,0,empty,mBC-0716-1
"H5,H12",897005,945662,655249,290413,507707,2,266023,266425,199969,66456,3.009043578,139525,43741,26408,12636,5,12631,1,1646,0,0.003404323,mm10,mBC-0716-1
"H6,A1",2298970,2565194,1593397,971797,1350308,1,823806,824887,664620,160267,4.146954769,463901,237992,154913,72961,32,72929,2,4581,0,0.00578645,mm10,mBC-0716-1
"H6,A2",20828,20834,15772,5062,11215,0,4912,4922,3444,1478,2.330175913,2275,1528,1033,509,0,509,0,126,0,0.092337917,empty,mBC-0716-1
"H6,A3",18342,18771,13727,5044,10045,0,4730,4734,3352,1382,2.425470333,2276,5644,1957,1000,1,999,1,215,0,0.069069069,empty,mBC-0716-1
"H6,A4",22862,23249,17559,5690,12110,0,5288,5304,3709,1595,2.32539185,2518,720,423,207,0,207,0,70,0,0.077294686,empty,mBC-0716-1
"H6,A5",18438,18959,14100,4859,10116,0,4546,4564,3256,1308,2.489296636,2204,2076,1069,527,1,526,1,154,0,0.074144487,empty,mBC-0716-1
"H6,A6",18739,19567,14320,5247,10501,1,4865,4876,3534,1342,2.63338301,2377,1701,1124,555,0,555,0,157,0,0.045045045,empty,mBC-0716-1
"H6,A7",17800,18362,13570,4792,9758,0,4461,4470,3078,1392,2.211206897,2151,2672,1472,673,2,671,1,159,0,0.153502235,empty,mBC-0716-1
"H6,A8",11921,12569,9187,3382,6643,0,3081,3090,2238,852,2.626760563,1532,1485,869,418,0,418,0,137,0,0.071770335,empty,mBC-0716-1
"H6,A9",21448,21871,16541,5330,11403,0,5086,5098,3620,1478,2.449255751,2309,1180,690,330,0,330,0,114,0,0.03030303,empty,mBC-0716-1
"H6,A10",718423,747205,511570,235635,399053,0,216547,216898,166075,50823,3.267713437,111745,7301,4694,2287,0,2287,0,415,0,0,mm10,mBC-0716-1
"H6,A11",1476010,1587496,1060548,526948,831069,4,458071,458760,335430,123330,2.71977621,246777,49579,34154,15626,4,15622,1,1824,0,0.00140827,mm10,mBC-0716-1
"H6,A12",625273,651431,473637,177794,343706,2,160699,161026,126351,34675,3.643864456,79641,137275,94427,44699,21,44678,1,3262,0,0.001969649,mm10,mBC-0716-1
"H6,B1",20255,20757,15611,5146,10913,0,4787,4793,3359,1434,2.342398884,2185,5875,1914,950,1,949,1,197,0,0.025289779,empty,mBC-0716-1
"H6,B2",21709,21887,16524,5363,11466,0,5014,5021,3567,1454,2.453232462,2295,592,353,178,0,178,0,62,0,0.039325843,empty,mBC-0716-1
"H6,B3",20349,20599,15537,5062,10922,0,4856,4874,3465,1409,2.459190916,2268,1767,847,448,0,448,0,137,0,0.060267857,empty,mBC-0716-1
"H6,B4",18096,18662,13966,4696,9983,0,4487,4503,3097,1406,2.202702703,2148,1080,641,332,1,331,1,105,0,0.03021148,empty,mBC-0716-1
"H6,B5",22751,20253,13696,6557,12015,0,6199,6220,4608,1612,2.858560794,3307,10413,3169,1605,2,1603,1,302,0,0.066126014,empty,mBC-0716-1
"H6,B6",12981,13521,9870,3651,7305,0,3430,3436,2358,1078,2.187384045,1666,3848,1307,655,0,655,0,150,0,0.14351145,empty,mBC-0716-1
"H6,B7",17391,17693,13447,4246,9468,0,4103,4112,2890,1222,2.36497545,1852,1057,646,285,0,285,0,78,0,0.021052632,empty,mBC-0716-1
"H6,B8",14083,14384,10783,3601,7653,0,3396,3407,2384,1023,2.330400782,1584,1044,677,355,0,355,0,128,0,0.005633803,empty,mBC-0716-1
"H6,B9",16257,16867,12472,4395,8910,0,4042,4052,2764,1288,2.145962733,1954,622,386,198,0,198,0,68,0,0.080808081,empty,mBC-0716-1
"H6,B10",868708,853952,559510,294442,468848,4,262471,264068,193516,70552,2.742884681,143520,23917,15304,7219,2,7217,1,1012,0,0.001108494,mm10,mBC-0716-1
"H6,B11",1150184,1262991,793528,469463,648640,2,384833,385416,331430,53986,6.139184233,213085,5093,3470,1595,0,1595,0,316,0,0.001880878,mm10,mBC-0716-1
"H6,B12",19324,19886,14672,5214,10633,0,4887,4891,3415,1476,2.313685637,2300,1486,832,451,2,449,1,125,0,0.051224944,empty,mBC-0716-1
"H6,C1",25305,25326,19447,5879,13469,0,5822,5840,4091,1749,2.339050886,2683,922,593,339,1,338,1,81,0,0.029585799,empty,mBC-0716-1
"H6,C2",20793,21128,15722,5406,11344,0,5195,5204,3666,1538,2.383615085,2423,1765,1105,580,0,580,0,171,0,0.055172414,empty,mBC-0716-1
"H6,C3",23228,23926,17565,6361,12737,0,5907,5921,4216,1705,2.472727273,2879,752,511,242,0,242,0,75,0,0.024793388,empty,mBC-0716-1
"H6,C4",19279,19505,14551,4954,10504,0,4743,4756,3415,1341,2.54660701,2229,4092,1697,879,1,878,1,215,0,0.125284738,empty,mBC-0716-1
"H6,C5",18771,19145,14073,5072,10315,0,4742,4749,3329,1420,2.344366197,2351,1353,847,396,0,396,0,102,0,0.093434343,empty,mBC-0716-1
"H6,C6",19191,19406,14461,4945,10731,0,4901,4918,3486,1432,2.434357542,2374,1204,776,387,0,387,0,116,0,0.082687339,empty,mBC-0716-1
"H6,C7",17584,18188,13073,5115,9537,0,4486,4495,3110,1385,2.245487365,2232,397,259,110,0,110,0,51,0,0,empty,mBC-0716-1
"H6,C8",15964,16285,12113,4172,8778,0,4061,4068,2886,1182,2.441624365,1982,1517,1020,487,1,486,1,163,0,0.028806584,empty,mBC-0716-1
"H6,C9",1502952,1626519,1073114,553405,851104,1,475561,476238,366143,110095,3.325700531,256634,143525,86728,40788,16,40772,5,3199,0,0.001937604,mm10,mBC-0716-1
"H6,C10",666373,729347,467470,261877,391825,0,231899,232245,174334,57911,3.010377994,128150,22515,15502,7409,2,7407,1,1028,0,0.00054003,mm10,mBC-0716-1
"H6,C11",12633,13320,9631,3689,7165,0,3367,3373,2384,989,2.410515672,1651,1107,708,335,0,335,0,112,0,0.104477612,empty,mBC-0716-1
"H6,C12",2065565,2259990,1447839,812151,1152194,4,693567,694508,550770,143738,3.831763347,379040,78431,53085,25364,11,25353,3,2579,0,0.002366584,mm10,mBC-0716-1
"H6,D1",12656,13113,9499,3614,7077,0,3346,3352,2348,1004,2.338645418,1651,577,264,125,0,125,0,55,0,0,empty,mBC-0716-1
"H6,D2",21948,22350,17292,5058,11665,1,4955,4968,3458,1510,2.290066225,2144,2346,1482,742,0,742,0,185,0,0.035040431,empty,mBC-0716-1
"H6,D3",15318,15986,11329,4657,8573,0,4143,4150,2865,1285,2.229571984,2110,2656,1146,593,2,591,1,145,0,0.047377327,empty,mBC-0716-1
"H6,D4",15237,15473,11587,3886,8345,0,3783,3787,2597,1190,2.182352941,1756,1109,670,354,0,354,0,122,0,0.031073446,empty,mBC-0716-1
"H6,D5",15757,16458,11921,4537,8739,0,4084,4091,2858,1233,2.317923763,2045,1111,718,346,0,346,0,112,0,0.046242775,empty,mBC-0716-1
"H6,D6",536573,563467,393120,170347,304100,0,154778,155022,109078,45944,2.374151141,81391,18763,12764,6002,3,5999,1,897,0,0.003833972,mm10,mBC-0716-1
"H6,D7",23180,24888,17182,7706,13003,0,6670,6685,4701,1984,2.369455645,3400,2542,1319,657,0,657,0,189,0,0.066971081,empty,mBC-0716-1
"H6,D8",17152,18013,13093,4920,9565,0,4495,4504,3111,1393,2.233309404,2161,1164,674,341,0,341,0,107,0,0.04398827,empty,mBC-0716-1
"H6,D9",5646,5809,4105,1704,3181,0,1580,1587,1159,428,2.707943925,794,1386,816,436,0,436,0,145,0,0.096330275,empty,mBC-0716-1
"H6,D10",16731,17317,12424,4893,9353,0,4414,4423,3151,1272,2.477201258,2251,916,576,284,0,284,0,98,0,0,empty,mBC-0716-1
"H6,D11",14519,14973,10981,3992,7859,0,3625,3635,2588,1047,2.47182426,1727,1386,833,429,0,429,0,149,0,0.090909091,empty,mBC-0716-1
"H6,D12",26455,27461,19995,7466,14637,0,6905,6925,4969,1956,2.540388548,3396,2966,1931,938,0,938,0,251,0,0.051172708,empty,mBC-0716-1
"H6,E1",25099,24976,18964,6012,13350,0,5931,5952,4310,1642,2.624847747,2734,1553,975,514,0,514,0,155,0,0.079766537,empty,mBC-0716-1
"H6,E2",598991,603977,463685,140292,323227,0,135864,136136,111076,25060,4.432402235,63298,87418,62955,29381,15,29366,4,2412,0,0.003064769,mm10,mBC-0716-1
"H6,E3",13394,13900,10179,3721,7451,0,3423,3436,2413,1023,2.358748778,1693,1994,1301,621,0,621,0,162,0,0.114331723,empty,mBC-0716-1
"H6,E4",735841,818552,521233,297319,432847,0,244859,245209,195417,49792,3.924666613,135870,59875,40696,19203,7,19196,1,2085,0,0.002917274,mm10,mBC-0716-1
"H6,E5",22747,23218,17703,5515,12209,0,5324,5339,3748,1591,2.3557511,2464,1345,889,475,0,475,0,165,0,0,empty,mBC-0716-1
"H6,E6",638916,644378,462793,181585,341099,0,169395,169671,131852,37819,3.486395727,85062,13732,9673,4434,4,4430,1,731,0,0.008803612,mm10,mBC-0716-1
"H6,E7",554841,572869,419189,153680,305703,1,144696,144978,108097,36881,2.930967165,71666,36752,17914,8832,2,8830,1,1224,0,0.03612684,mm10,mBC-0716-1
"H6,E8",19276,19819,14785,5034,10403,0,4555,4568,3238,1330,2.434586466,2175,2008,1312,632,0,632,0,171,0,0.03164557,empty,mBC-0716-1
"H6,E9",10426,10747,7706,3041,5776,0,2663,2671,1862,809,2.301606922,1314,2219,951,486,0,486,0,130,0,0.055555556,empty,mBC-0716-1
"H6,E10",13904,14416,10571,3845,7768,0,3569,3579,2441,1138,2.144991213,1741,1114,667,324,0,324,0,106,0,0.135802469,empty,mBC-0716-1
"H6,E11",9862,10314,7389,2925,5564,0,2587,2593,1841,752,2.448138298,1280,1062,642,354,0,354,0,110,0,0.014124294,empty,mBC-0716-1
"H6,E12",797646,886165,546777,339388,470344,1,279476,279860,205295,74565,2.753235432,159178,91459,64114,30320,9,30311,2,2420,0,0.002309393,mm10,mBC-0716-1
"H6,F1",18875,19558,14575,4983,10234,0,4608,4614,3238,1376,2.353197674,2237,1579,999,516,0,516,0,146,0,0.042635659,empty,mBC-0716-1
"H6,F2",707818,758714,523734,234980,402838,1,202636,202943,168520,34423,4.895564012,106006,178507,122397,57829,20,57809,2,3703,0,0.003113702,mm10,mBC-0716-1
"H6,F3",18521,19318,13604,5714,10412,0,5097,5104,3612,1492,2.420911528,2550,8532,2980,1499,0,1499,0,297,0,0.034022682,empty,mBC-0716-1
"H6,F4",19387,19622,14477,5145,10724,0,4888,4909,3482,1427,2.440084093,2349,898,540,265,0,265,0,92,0,0.079245283,empty,mBC-0716-1
"H6,F5",25834,26662,19577,7085,14113,0,6417,6433,4460,1973,2.260516979,3216,1745,1085,583,0,583,0,179,0,0.042881647,empty,mBC-0716-1
"H6,F6",820371,857477,615058,242419,450042,2,216295,216650,185146,31504,5.87690452,108688,158073,106304,49816,19,49797,2,3455,0,0.002128642,mm10,mBC-0716-1
"H6,F7",1062090,1161191,737247,423944,621451,3,373506,374050,271069,102981,2.63222342,205326,17471,12566,5921,1,5920,1,876,0,0.001858108,mm10,mBC-0716-1
"H6,F8",24261,24948,18310,6638,13307,0,6066,6077,4328,1749,2.47455689,2981,314,216,105,0,105,0,52,0,0,empty,mBC-0716-1
"H6,F9",16681,17020,12748,4272,9028,0,4078,4084,2920,1164,2.508591065,1922,1828,1185,565,0,565,0,160,0,0.083185841,empty,mBC-0716-1
"H6,F10",22796,23044,17381,5663,11990,0,5284,5294,3679,1615,2.278018576,2447,10334,3672,1844,3,1841,1,315,0,0.107007061,empty,mBC-0716-1
"H6,F11",12236,12717,9397,3320,6833,0,3120,3137,2146,991,2.165489405,1556,993,599,326,0,326,0,114,0,0.009202454,empty,mBC-0716-1
"H6,F12",14795,15287,11245,4042,7938,0,3634,3649,2497,1152,2.167534722,1735,133,98,50,0,50,0,16,0,0,empty,mBC-0716-1
"H6,G1",11066,11457,8569,2888,6026,3,2709,2717,1867,850,2.196470588,1266,1834,1118,515,0,515,0,159,0,0.025242718,empty,mBC-0716-1
"H6,G2",22653,23216,17453,5763,12072,0,5339,5355,3776,1579,2.391386954,2505,542,357,180,0,180,0,56,0,0.066666667,empty,mBC-0716-1
"H6,G3",21237,21641,16162,5479,11394,0,5082,5099,3559,1540,2.311038961,2426,2326,1545,792,0,792,0,195,0,0.036616162,empty,mBC-0716-1
"H6,G4",711345,706309,534077,172232,373586,0,169355,169683,137240,32443,4.23018833,81255,219,129,66,0,66,0,31,0,0,empty,mBC-0716-1
"H6,G5",14278,14710,10902,3808,7842,0,3588,3595,2456,1139,2.156277436,1715,895,543,309,0,309,0,96,0,0.022653722,empty,mBC-0716-1
"H6,G6",27037,27320,20490,6830,14329,0,6327,6346,4467,1879,2.377328366,3013,247,140,76,0,76,0,40,0,0.184210526,empty,mBC-0716-1
"H6,G7",22096,22434,16892,5542,11776,0,5200,5213,3719,1494,2.489290495,2432,1912,1159,626,1,625,1,164,0,0.0704,empty,mBC-0716-1
"H6,G8",16144,16677,12173,4504,8752,0,4101,4111,2849,1262,2.257527734,2008,10008,3536,1685,0,1685,0,322,0,0.082492582,empty,mBC-0716-1
"H6,G9",11523,11987,8604,3383,6352,0,2993,2998,2104,894,2.353467562,1485,1494,918,435,1,434,1,163,0,0.034562212,empty,mBC-0716-1
"H6,G10",14737,15028,11245,3783,8013,1,3595,3602,2481,1121,2.213202498,1718,1345,842,404,0,404,0,134,0,0.051980198,empty,mBC-0716-1
"H6,G11",13465,13639,10303,3336,7332,0,3269,3278,2325,953,2.439664218,1531,526,314,189,0,189,0,78,0,0,empty,mBC-0716-1
"H6,G12",12994,13454,9747,3707,7331,0,3489,3495,2443,1052,2.322243346,1721,1364,874,434,0,434,0,122,0,0.112903226,empty,mBC-0716-1
"H6,H1",1319108,1391810,963352,428458,733078,1,386169,386779,320043,66736,4.795657516,199717,68770,47906,22188,8,22180,3,2245,0,0.000405771,mm10,mBC-0716-1
"H6,H2",25319,26258,19357,6901,13510,0,6024,6036,4210,1826,2.30558598,2830,1476,936,497,1,496,1,159,0,0.034274194,empty,mBC-0716-1
"H6,H3",21893,22696,16484,6212,12068,0,5619,5634,4016,1618,2.482076638,2777,1618,1044,551,0,551,0,153,0,0.038112523,empty,mBC-0716-1
"H6,H4",14904,15363,11239,4124,8234,0,3850,3853,2671,1182,2.259729272,1846,109,53,35,0,35,0,19,0,0,empty,mBC-0716-1
"H6,H5",20364,20983,15366,5617,11111,0,5225,5239,3752,1487,2.523201076,2579,4809,1780,937,0,937,0,254,0,0.035218783,empty,mBC-0716-1
"H6,H6",642641,672826,472683,200143,357610,1,175846,176111,147535,28576,5.162898936,90085,231971,160744,75440,31,75409,1,4088,0,0.001153708,mm10,mBC-0716-1
"H6,H7",19594,19958,14713,5245,10762,1,4935,4949,3546,1403,2.527441197,2309,1438,884,444,0,444,0,164,0,0.018018018,empty,mBC-0716-1
"H6,H8",705861,755838,508442,247396,398611,0,212977,213320,168915,44405,3.803963518,113920,98227,62580,29284,10,29274,4,2506,0,0.00099064,mm10,mBC-0716-1
"H6,H9",17463,17917,12884,5033,9585,0,4493,4501,3176,1325,2.396981132,2279,1124,766,408,0,408,0,116,0,0.075980392,empty,mBC-0716-1
"H6,H10",16513,17153,12415,4738,9304,0,4462,4475,3113,1362,2.285609398,2223,1306,792,407,0,407,0,115,0,0.036855037,empty,mBC-0716-1
"H6,H11",19088,19671,14373,5298,10603,0,4980,4998,3501,1497,2.338677355,2407,892,300,161,1,160,1,55,0,0.1,empty,mBC-0716-1
"H6,H12",6610,6864,5024,1840,3763,0,1737,1747,1244,503,2.473161034,875,3154,1215,594,0,594,0,137,0,0.031986532,empty,mBC-0716-1
"H7,A1",12965,13234,9661,3573,7148,0,3395,3409,2385,1024,2.329101563,1657,16712,5484,2746,7,2739,4,481,0,0.045271997,empty,mBC-0716-1
"H7,A2",16552,16922,12779,4143,8887,0,3895,3905,2675,1230,2.174796748,1822,1251,634,282,0,282,0,84,0,0.127659574,empty,mBC-0716-1
"H7,A3",692976,772757,474184,298573,414426,0,256120,256494,192322,64172,2.996976875,144614,12742,8252,3789,3,3786,1,640,0,0.008188061,mm10,mBC-0716-1
"H7,A4",20231,20897,15847,5050,10692,0,4639,4648,3200,1448,2.209944751,2173,328,151,78,0,78,0,39,0,0.076923077,empty,mBC-0716-1
"H7,A5",15513,16110,11922,4188,8523,0,3864,3877,2711,1166,2.325042882,1880,1210,744,372,0,372,0,100,0,0.043010753,empty,mBC-0716-1
"H7,A6",11634,12118,8912,3206,6397,0,2939,2950,2026,924,2.192640693,1420,1422,899,435,0,435,0,113,0,0.068965517,empty,mBC-0716-1
"H7,A7",14880,15194,11540,3654,8026,0,3571,3584,2491,1093,2.27904849,1667,2990,1268,636,0,636,0,139,0,0.056603774,empty,mBC-0716-1
"H7,A8",10033,10525,7692,2833,5675,0,2594,2603,1777,826,2.151331719,1274,1079,718,371,1,370,1,110,0,0.051351351,empty,mBC-0716-1
"H7,A9",18851,18998,14670,4328,10057,0,4368,4370,3186,1184,2.690878378,1955,868,479,234,0,234,0,71,0,0.038461538,empty,mBC-0716-1
"H7,A10",14124,14583,10734,3849,7661,0,3436,3445,2376,1069,2.222637979,1643,297,194,114,0,114,0,39,0,0.01754386,empty,mBC-0716-1
"H7,A11",16565,16555,12663,3892,8857,0,3893,3905,2707,1198,2.259599332,1725,986,572,288,0,288,0,81,0,0.0625,empty,mBC-0716-1
"H7,A12",19693,20021,15072,4949,10387,0,4562,4576,3168,1408,2.25,2127,4202,2123,1026,1,1025,1,208,0,0.04097561,empty,mBC-0716-1
"H7,B1",17684,17935,13756,4179,9365,0,4149,4159,2852,1307,2.182096404,1843,2156,850,423,1,422,1,110,0,0.120853081,empty,mBC-0716-1
"H7,B2",18957,19461,14424,5037,10101,0,4483,4498,3031,1467,2.066121336,2163,543,345,149,1,148,1,52,0,0.067567568,empty,mBC-0716-1
"H7,B3",16940,17454,12931,4523,9322,0,4145,4154,2964,1190,2.490756303,2034,2194,1010,490,0,490,0,140,0,0.097959184,empty,mBC-0716-1
"H7,B4",443550,458167,340043,118124,248418,0,114437,114637,90629,24008,3.774950017,55926,17030,8873,4147,2,4145,1,669,0,0.021712907,mm10,mBC-0716-1
"H7,B5",11492,8536,6157,2379,5407,0,2534,2546,1848,698,2.64756447,1302,591,391,184,0,184,0,59,0,0.02173913,empty,mBC-0716-1
"H7,B6",10965,11339,8254,3085,5946,0,2778,2790,1923,867,2.21799308,1333,18550,6015,2967,0,2967,0,473,0,0.070441523,empty,mBC-0716-1
"H7,B7",14656,14979,11184,3795,7858,0,3474,3484,2422,1062,2.280602637,1665,1862,684,351,0,351,0,80,0,0.13960114,empty,mBC-0716-1
"H7,B8",12410,12786,9457,3329,6816,0,3041,3048,2089,959,2.17831074,1519,897,546,284,0,284,0,87,0,0.084507042,empty,mBC-0716-1
"H7,B9",13663,14045,10404,3641,7331,0,3325,3335,2327,1008,2.308531746,1655,2652,874,467,0,467,0,91,0,0.068522484,empty,mBC-0716-1
"H7,B10",15480,15173,11347,3826,8403,0,3824,3845,2661,1184,2.247466216,1861,574,315,159,0,159,0,57,0,0,empty,mBC-0716-1
"H7,B11",766834,846385,535844,310541,443963,0,256272,256635,199086,57549,3.459417192,143533,5078,3414,1624,1,1623,1,316,0,0,mm10,mBC-0716-1
"H7,B12",16205,16823,12345,4478,8902,0,4113,4117,2853,1264,2.257120253,1936,3499,1414,659,0,659,0,134,0,0.033383915,empty,mBC-0716-1
"H7,C1",23996,24085,18533,5552,12490,0,5137,5150,3671,1479,2.482082488,2338,5537,2067,988,2,986,1,189,0,0.020283976,empty,mBC-0716-1
"H7,C2",17014,17669,12778,4891,9259,0,4243,4252,2956,1296,2.280864198,2117,9640,3784,1890,2,1888,2,358,0,0.111228814,empty,mBC-0716-1
"H7,C3",1551977,1725033,1104777,620256,893060,1,508655,509338,416874,92464,4.508500606,283013,83561,54964,26289,16,26273,3,2455,0,0.002359837,mm10,mBC-0716-1
"H7,C4",903539,964289,629036,335253,504829,1,283777,284223,245238,38985,6.290573297,152717,93797,65645,30763,15,30748,2,2730,0,0.001691167,mm10,mBC-0716-1
"H7,C5",14831,15085,11287,3798,7832,0,3474,3483,2449,1034,2.368471954,1633,751,471,236,3,233,1,76,0,0.030042918,empty,mBC-0716-1
"H7,C6",544985,559503,416378,143125,307744,1,142769,143047,107078,35969,2.976952376,69729,11204,7312,3602,1,3601,1,599,0,0.001110803,mm10,mBC-0716-1
"H7,C7",698182,743903,516580,227323,391329,2,192006,192313,161217,31096,5.184493182,99713,13149,8977,4377,2,4375,1,692,0,0.002514286,mm10,mBC-0716-1
"H7,C8",13211,13589,10045,3544,7201,0,3260,3267,2235,1032,2.165697674,1599,1740,1104,534,0,534,0,134,0,0.086142322,empty,mBC-0716-1
"H7,C9",519269,538200,397801,140399,287346,0,131567,131815,102226,29589,3.454864984,64331,35078,21275,10152,8,10144,2,1336,0,0.019124606,mm10,mBC-0716-1
"H7,C10",12895,13188,10022,3166,6896,0,3037,3052,2106,946,2.226215645,1404,784,492,254,1,253,1,75,0,0.015810277,empty,mBC-0716-1
"H7,C11",10617,11219,8049,3170,5969,0,2830,2832,1965,867,2.266435986,1426,731,474,260,0,260,0,81,0,0.080769231,empty,mBC-0716-1
"H7,C12",18345,18472,13915,4557,9844,0,4371,4381,3011,1370,2.197810219,2051,1205,859,422,0,422,0,107,0,0.087677725,empty,mBC-0716-1
"H7,D1",9766,10005,7269,2736,5441,0,2556,2563,1771,792,2.236111111,1236,977,366,172,0,172,0,54,0,0,empty,mBC-0716-1
"H7,D2",19576,19814,15231,4583,10423,0,4409,4421,3094,1327,2.331574981,2018,1785,1105,561,0,561,0,141,0,0.071301248,empty,mBC-0716-1
"H7,D3",13223,13359,9492,3867,6969,0,3193,3197,2177,1020,2.134313725,1598,18778,6506,3565,6,3559,4,448,0,0.271424557,empty,mBC-0716-1
"H7,D4",13232,13433,9825,3608,7000,0,3223,3226,2283,943,2.420996819,1573,6409,2442,1191,1,1190,1,232,0,0.142857143,empty,mBC-0716-1
"H7,D5",12791,12788,9704,3084,6829,0,3133,3144,2177,967,2.251292658,1482,3094,1411,654,0,654,0,154,0,0.074923547,empty,mBC-0716-1
"H7,D6",10907,11397,8249,3148,5973,2,2795,2808,1963,845,2.323076923,1374,956,551,282,0,282,0,88,0,0.039007092,empty,mBC-0716-1
"H7,D7",11815,12216,9059,3157,6482,0,2949,2959,2035,924,2.202380952,1394,1397,949,467,0,467,0,124,0,0.032119914,empty,mBC-0716-1
"H7,D8",631970,657689,466531,191158,350833,0,176653,176903,144828,32075,4.515292284,89257,7891,5618,2704,2,2702,1,512,0,0.001110289,mm10,mBC-0716-1
"H7,D9",3909,4044,2955,1089,2199,0,1017,1017,717,300,2.39,489,2216,899,476,0,476,0,126,0,0.079831933,empty,mBC-0716-1
"H7,D10",12435,12984,9412,3572,6897,0,3182,3187,2221,966,2.299171843,1547,1385,658,326,0,326,0,77,0,0.052147239,empty,mBC-0716-1
"H7,D11",718043,807163,500011,307152,427684,1,252728,253130,190490,62640,3.041028097,142277,84410,60332,28551,9,28542,3,2475,0,0.00080583,mm10,mBC-0716-1
"H7,D12",18835,19140,14437,4703,9886,1,4364,4378,3059,1319,2.319181198,1981,1830,1252,616,0,616,0,149,0,0.035714286,empty,mBC-0716-1
"H7,E1",20160,20413,15380,5033,10614,0,4589,4608,3156,1452,2.173553719,2155,1163,772,417,0,417,0,125,0,0.03117506,empty,mBC-0716-1
"H7,E2",620613,654950,456790,198160,349430,0,175199,175505,132185,43320,3.051361958,90910,70304,47014,22293,10,22283,1,2114,0,0.000538527,mm10,mBC-0716-1
"H7,E3",11750,12123,9126,2997,6226,0,2702,2708,1844,864,2.134259259,1248,1202,753,415,0,415,0,126,0,0.093975904,empty,mBC-0716-1
"H7,E4",14107,14599,10941,3658,7537,0,3338,3344,2302,1042,2.209213052,1607,934,588,327,0,327,0,103,0,0.051987768,empty,mBC-0716-1
"H7,E5",19692,20180,15175,5005,10428,0,4570,4588,3188,1400,2.277142857,2154,1150,775,393,0,393,0,113,0,0.007633588,empty,mBC-0716-1
"H7,E6",664113,698223,481385,216838,369228,0,192494,192794,149451,43343,3.448100039,100139,52715,35749,16983,7,16976,1,1715,0,0.001826107,mm10,mBC-0716-1
"H7,E7",12724,13029,9788,3241,6859,0,3031,3041,2075,966,2.148033126,1440,1311,757,390,0,390,0,94,0,0.102564103,empty,mBC-0716-1
"H7,E8",16450,16878,12657,4221,8871,0,3909,3920,2770,1150,2.408695652,1837,1337,797,406,1,405,1,122,0,0.041975309,empty,mBC-0716-1
"H7,E9",8366,8620,6292,2328,4623,0,2152,2158,1468,690,2.127536232,1073,909,578,285,0,285,0,87,0,0.014035088,empty,mBC-0716-1
"H7,E10",11830,12364,8973,3391,6502,0,3040,3052,2075,977,2.123848516,1486,830,486,242,0,242,0,71,0,0.045454545,empty,mBC-0716-1
"H7,E11",526612,586313,364211,222102,316589,0,187682,187925,147549,40376,3.654373885,105306,86334,59634,28231,8,28223,1,2418,0,0.001417284,mm10,mBC-0716-1
"H7,E12",13649,14048,10378,3670,7484,0,3462,3470,2408,1062,2.267419962,1701,2712,1229,569,2,567,1,130,0,0.047619048,empty,mBC-0716-1
"H7,F1",16602,16962,12736,4226,8744,0,3978,3988,2806,1182,2.37394247,1843,1069,674,328,0,328,0,86,0,0.006097561,empty,mBC-0716-1
"H7,F2",21698,22510,16483,6027,11903,0,5471,5486,3892,1594,2.441656211,2707,2258,1460,715,1,714,1,198,0,0.037815126,empty,mBC-0716-1
"H7,F3",14927,15317,11203,4114,8083,0,3814,3828,2631,1197,2.197994987,1863,1585,992,491,0,491,0,164,0,0.028513238,empty,mBC-0716-1
"H7,F4",14865,15199,11279,3920,8142,0,3710,3721,2636,1085,2.429493088,1804,763,490,250,0,250,0,73,0,0,empty,mBC-0716-1
"H7,F5",22056,22504,16907,5597,11851,0,5241,5244,3663,1581,2.316888046,2569,1431,872,464,0,464,0,127,0,0.040948276,empty,mBC-0716-1
"H7,F6",21391,22268,16273,5995,11622,0,5301,5312,3743,1569,2.385595921,2555,2023,1333,675,0,675,0,170,0,0.087407407,empty,mBC-0716-1
"H7,F7",1173798,1220058,888018,332040,652425,1,310962,311502,224483,87019,2.579700985,155942,60286,41502,19793,7,19786,1,2163,0,0.000808653,mm10,mBC-0716-1
"H7,F8",20683,21353,15641,5712,11180,0,5116,5131,3516,1615,2.177089783,2511,175,113,60,0,60,0,31,0,0,empty,mBC-0716-1
"H7,F9",14689,15308,11150,4158,8102,0,3647,3664,2530,1134,2.231040564,1813,3943,1692,891,0,891,0,180,0,0.205387205,empty,mBC-0716-1
"H7,F10",876571,958228,632312,325916,503293,0,278836,279281,226049,53232,4.246487075,150027,98318,67104,32177,6,32171,1,2653,0,0.000590594,mm10,mBC-0716-1
"H7,F11",10251,10507,7905,2602,5543,0,2500,2505,1729,776,2.228092784,1179,5508,1802,934,1,933,1,186,0,0.050375134,empty,mBC-0716-1
"H7,F12",12820,13253,9784,3469,6913,0,3136,3141,2207,934,2.362955032,1523,148,113,52,0,52,0,18,0,0,empty,mBC-0716-1
"H7,G1",559322,634050,389172,244878,339948,0,206884,207147,135124,72023,1.876122905,116958,52179,35955,17409,7,17402,1,1825,0,0.002183657,mm10,mBC-0716-1
"H7,G2",19806,20075,15029,5046,10437,0,4579,4592,3226,1366,2.361639824,2149,468,267,138,0,138,0,46,0,0.050724638,empty,mBC-0716-1
"H7,G3",546534,593735,390014,203721,319842,1,180615,180858,139253,41605,3.347025598,98285,12548,8048,3795,2,3793,2,674,0,0.013445821,mm10,mBC-0716-1
"H7,G4",25205,25386,19584,5802,13400,0,5793,5804,4097,1707,2.400117165,2639,91,49,22,0,22,0,15,0,0,empty,mBC-0716-1
"H7,G5",1056389,1101607,777178,324429,579533,1,293705,294179,239861,54318,4.415865827,149587,81153,54480,25501,4,25497,1,2493,0,0.006275248,mm10,mBC-0716-1
"H7,G6",22350,22362,17330,5032,11786,0,5101,5108,3558,1550,2.295483871,2309,204,163,96,0,96,0,28,0,0,empty,mBC-0716-1
"H7,G7",18844,19358,14482,4876,10091,0,4523,4529,3186,1343,2.372300819,2111,2284,1018,544,0,544,0,148,0,0.068014706,empty,mBC-0716-1
"H7,G8",13931,14169,10376,3793,7387,0,3433,3439,2421,1018,2.378192534,1645,8176,3213,1622,0,1622,0,328,0,0.085080148,empty,mBC-0716-1
"H7,G9",9646,9612,7299,2313,5088,0,2268,2270,1619,651,2.486943164,1023,972,686,353,0,353,0,107,0,0.059490085,empty,mBC-0716-1
"H7,G10",12730,12832,9713,3119,6781,0,2983,2989,2061,928,2.220905172,1424,1792,922,469,0,469,0,122,0,0.023454158,empty,mBC-0716-1
"H7,G11",11660,11853,8890,2963,6312,0,2824,2846,1960,886,2.212189616,1319,2888,1084,506,0,506,0,116,0,0.049407115,empty,mBC-0716-1
"H7,G12",10635,11009,8029,2980,5842,0,2650,2651,1831,820,2.232926829,1296,1250,639,330,0,330,0,96,0,0.160606061,empty,mBC-0716-1
"H7,H1",18627,19266,14356,4910,10205,0,4601,4610,3207,1403,2.285816108,2223,796,512,282,0,282,0,93,0,0.095744681,empty,mBC-0716-1
"H7,H2",22692,23163,17380,5783,11964,0,5344,5352,3702,1650,2.243636364,2432,1369,866,441,0,441,0,133,0,0.063492063,empty,mBC-0716-1
"H7,H3",17786,18650,13352,5298,9830,0,4643,4652,3230,1422,2.271448664,2318,4134,1440,675,0,675,0,163,0,0.022222222,empty,mBC-0716-1
"H7,H4",12542,12685,9337,3348,6715,0,3021,3028,2121,907,2.338478501,1462,162,68,25,0,25,0,19,0,0,empty,mBC-0716-1
"H7,H5",16571,17185,12676,4509,8926,0,4085,4091,2885,1206,2.392205638,1957,1169,760,390,0,390,0,122,0,0.020512821,empty,mBC-0716-1
"H7,H6",12998,13504,9773,3731,7164,0,3411,3421,2445,976,2.505122951,1696,1330,836,395,0,395,0,120,0,0.070886076,empty,mBC-0716-1
"H7,H7",14957,15113,11326,3787,8207,0,3746,3758,2604,1154,2.256499133,1757,5796,1878,986,0,986,0,232,0,0.04158215,empty,mBC-0716-1
"H7,H8",534556,569312,388349,180963,302289,1,157268,157506,129315,28191,4.587102267,82896,86991,62486,29466,5,29461,1,2456,0,0.00010183,mm10,mBC-0716-1
"H7,H9",15568,15924,11649,4275,8256,0,3733,3737,2647,1090,2.428440367,1794,21948,7380,3870,6,3864,3,583,0,0.056935818,empty,mBC-0716-1
"H7,H10",12700,13030,9536,3494,6896,0,3179,3183,2248,935,2.404278075,1563,9854,3312,1622,3,1619,2,268,0,0.017294626,empty,mBC-0716-1
"H7,H11",14881,15564,11184,4380,8198,0,3818,3822,2663,1159,2.297670406,1907,133,97,58,0,58,0,33,0,0,empty,mBC-0716-1
"H7,H12",5334,5587,3945,1642,3014,0,1473,1473,988,485,2.037113402,745,689,435,225,0,225,0,66,0,0.022222222,empty,mBC-0716-1
"H8,A1",13881,14271,10624,3647,7620,0,3521,3527,2447,1080,2.265740741,1637,747,484,253,0,253,0,67,0,0.071146245,empty,mBC-0716-1
"H8,A2",18341,18516,13947,4569,9752,0,4306,4315,3048,1267,2.405682715,2055,6647,2375,1241,5,1236,2,210,0,0.180420712,empty,mBC-0716-1
"H8,A3",16162,16888,12156,4732,8935,0,4134,4139,2926,1213,2.412201154,2015,3875,1394,660,0,660,0,139,0,0.054545455,empty,mBC-0716-1
"H8,A4",21320,21454,16373,5081,10921,0,4735,4747,3317,1430,2.31958042,2129,298,187,74,0,74,0,25,0,0.040540541,empty,mBC-0716-1
"H8,A5",16160,16720,12418,4302,8930,1,3976,3980,2759,1221,2.25962326,1914,1013,626,319,1,318,1,87,0,0.047169811,empty,mBC-0716-1
"H8,A6",12356,12528,9344,3184,6656,0,3083,3096,2139,957,2.235109718,1423,1290,846,401,0,401,0,107,0,0.029925187,empty,mBC-0716-1
"H8,A7",15928,16361,12257,4104,8581,0,3890,3895,2727,1168,2.334760274,1866,988,480,274,0,274,0,83,0,0.072992701,empty,mBC-0716-1
"H8,A8",10663,10763,8260,2503,5802,0,2562,2565,1805,760,2.375,1143,920,543,258,0,258,0,88,0,0.054263566,empty,mBC-0716-1
"H8,A9",18542,18406,14327,4079,9620,2,4142,4163,2886,1277,2.259984338,1849,849,540,295,0,295,0,65,0,0.145762712,empty,mBC-0716-1
"H8,A10",14765,15183,11390,3793,7949,0,3566,3576,2489,1087,2.289788408,1657,157,88,57,0,57,0,34,0,0.01754386,empty,mBC-0716-1
"H8,A11",17400,17714,13428,4286,9367,0,4135,4144,2858,1286,2.222395023,1898,1575,842,417,0,417,0,110,0,0.033573141,empty,mBC-0716-1
"H8,A12",20154,20910,15531,5379,10816,0,4775,4785,3335,1450,2.3,2257,2940,1514,757,0,757,0,151,0,0.104359313,empty,mBC-0716-1
"H8,B1",19547,19987,15004,4983,10183,0,4580,4584,3226,1358,2.375552283,2104,4217,1440,732,0,732,0,147,0,0.094262295,empty,mBC-0716-1
"H8,B2",865262,956947,612817,344130,504722,2,286642,287058,235804,51254,4.60069458,157885,23484,14804,7203,0,7203,0,1039,0,0.005692073,mm10,mBC-0716-1
"H8,B3",18465,19107,14326,4781,9999,0,4431,4440,3131,1309,2.391902215,2069,771,531,280,0,280,0,86,0,0.067857143,empty,mBC-0716-1
"H8,B4",16777,17183,12724,4459,8986,0,4098,4107,2834,1273,2.226237235,1958,5613,2092,1016,2,1014,1,197,0,0.045364892,empty,mBC-0716-1
"H8,B5",8855,5533,4039,1494,3733,0,1735,1741,1193,548,2.177007299,891,528,339,157,0,157,0,45,0,0,empty,mBC-0716-1
"H8,B6",11262,11482,8656,2826,6121,0,2717,2721,1868,853,2.189917937,1267,800,505,209,0,209,0,66,0,0.038277512,empty,mBC-0716-1
"H8,B7",16133,16529,12412,4117,8748,0,3911,3915,2711,1204,2.25166113,1848,707,496,228,0,228,0,59,0,0.061403509,empty,mBC-0716-1
"H8,B8",12977,13302,9971,3331,7044,0,3139,3145,2212,933,2.370846731,1510,702,469,229,1,228,1,67,0,0.057017544,empty,mBC-0716-1
"H8,B9",15287,15556,11812,3744,8162,0,3642,3647,2474,1173,2.10912191,1732,399,223,105,0,105,0,38,0,0.152380952,empty,mBC-0716-1
"H8,B10",16127,15737,11653,4084,8654,0,3959,3977,2771,1206,2.297678275,1918,3403,1105,556,1,555,1,101,0,0.073873874,empty,mBC-0716-1
"H8,B11",19284,20044,14390,5654,10686,0,5103,5110,3603,1507,2.390842734,2517,79,59,32,0,32,0,22,0,0.0625,empty,mBC-0716-1
"H8,B12",623967,689317,445152,244165,369429,0,207632,207867,156827,51040,3.07262931,114196,55343,37655,17796,3,17793,1,1840,0,0.005732591,mm10,mBC-0716-1
"H8,C1",22972,23318,17899,5419,11965,0,5146,5161,3585,1576,2.274746193,2354,553,329,174,0,174,0,61,0,0.074712644,empty,mBC-0716-1
"H8,C2",18553,18733,13939,4794,9849,0,4506,4515,3217,1298,2.478428351,2182,10704,3848,2004,2,2002,2,364,0,0.067932068,empty,mBC-0716-1
"H8,C3",19968,20713,15205,5508,10759,0,4936,4944,3381,1563,2.163147793,2415,288,191,102,0,102,0,32,0,0.078431373,empty,mBC-0716-1
"H8,C4",17377,17799,13143,4656,9335,0,4221,4226,3065,1161,2.639965547,2036,14189,4533,2206,0,2206,0,403,0,0.035811423,empty,mBC-0716-1
"H8,C5",770207,820583,560959,259624,432669,1,224712,225052,175108,49944,3.506086817,117967,76079,46534,22385,14,22371,3,2176,0,0.002950248,mm10,mBC-0716-1
"H8,C6",15713,16456,11847,4609,8840,0,4126,4139,2925,1214,2.409390445,2002,997,683,343,0,343,0,83,0,0.075801749,empty,mBC-0716-1
"H8,C7",15662,16100,11910,4190,8478,0,3897,3903,2692,1211,2.222956235,1847,220,129,67,0,67,0,29,0,0.059701493,empty,mBC-0716-1
"H8,C8",14797,15226,11047,4179,8078,0,3667,3674,2554,1120,2.280357143,1852,3791,1311,648,0,648,0,153,0,0.066358025,empty,mBC-0716-1
"H8,C9",12895,13088,9561,3527,6940,0,3269,3275,2253,1022,2.204500978,1594,7221,2217,1161,2,1159,1,229,0,0.083692839,empty,mBC-0716-1
"H8,C10",13309,13538,10227,3311,7105,0,3186,3192,2213,979,2.260469867,1470,712,440,224,0,224,0,69,0,0.084821429,empty,mBC-0716-1
"H8,C11",11448,11792,8680,3112,6208,0,2847,2854,1969,885,2.224858757,1382,619,427,176,0,176,0,62,0,0.056818182,empty,mBC-0716-1
"H8,C12",19560,19871,14874,4997,10434,0,4604,4615,3156,1459,2.163125428,2218,2397,939,463,0,463,0,114,0,0.056155508,empty,mBC-0716-1
"H8,D1",10886,11334,8251,3083,6048,0,2866,2869,2043,826,2.473365617,1399,2142,702,367,0,367,0,81,0,0.008174387,empty,mBC-0716-1
"H8,D2",20967,21411,16169,5242,11355,0,4983,4992,3404,1588,2.143576826,2372,3462,1524,780,0,780,0,151,0,0.125641026,empty,mBC-0716-1
"H8,D3",13423,14163,10009,4154,7412,0,3506,3509,2554,955,2.67434555,1732,3385,1349,674,1,673,1,140,0,0.092124814,empty,mBC-0716-1
"H8,D4",13842,14252,10552,3700,7390,0,3367,3377,2286,1091,2.09532539,1593,917,561,289,0,289,0,78,0,0.079584775,empty,mBC-0716-1
"H8,D5",13007,13700,9876,3824,7219,0,3301,3312,2279,1033,2.206195547,1633,2943,1139,561,0,561,0,133,0,0.055258467,empty,mBC-0716-1
"H8,D6",11958,12666,8909,3757,6649,0,3172,3183,2239,944,2.371822034,1612,3467,1591,828,1,827,1,156,0,0.267230955,empty,mBC-0716-1
"H8,D7",356876,364230,264524,99706,197305,0,93874,94055,73969,20086,3.682614757,46665,9099,6320,2905,0,2905,0,567,0,0.002409639,mm10,mBC-0716-1
"H8,D8",15253,15692,11561,4131,8345,0,3890,3894,2667,1227,2.173594132,1864,554,323,168,0,168,0,65,0,0.05952381,empty,mBC-0716-1
"H8,D9",4273,4386,3031,1355,2449,0,1220,1220,897,323,2.777089783,639,719,389,194,0,194,0,69,0,0.118556701,empty,mBC-0716-1
"H8,D10",13342,13722,10153,3569,7298,0,3320,3327,2257,1070,2.109345794,1607,630,377,183,1,182,1,59,0,0.016483516,empty,mBC-0716-1
"H8,D11",13260,13483,10095,3388,7109,0,3212,3219,2248,971,2.315139032,1496,1225,835,381,0,381,0,101,0,0.044619423,empty,mBC-0716-1
"H8,D12",19868,20184,15328,4856,10625,0,4757,4765,3326,1439,2.311327311,2181,1853,1140,577,1,576,1,142,0,0.076388889,empty,mBC-0716-1
"H8,E1",816114,845047,622767,222280,443957,1,206327,206660,170395,36265,4.698607473,100434,61614,42599,20341,9,20332,1,2046,0,0.002360811,mm10,mBC-0716-1
"H8,E2",15887,16385,12098,4287,8699,0,3955,3969,2750,1219,2.255947498,1929,1382,851,418,0,418,0,112,0,0.09569378,empty,mBC-0716-1
"H8,E3",1052198,1110326,774294,336032,589474,1,311453,311935,241126,70809,3.405301586,160536,22744,15961,7385,3,7382,1,1042,0,0.001354646,mm10,mBC-0716-1
"H8,E4",15234,15610,11678,3932,8100,0,3680,3685,2514,1171,2.146883006,1749,781,470,262,0,262,0,81,0,0.045801527,empty,mBC-0716-1
"H8,E5",22765,23415,17363,6052,12109,0,5310,5324,3752,1572,2.386768448,2495,1079,717,394,0,394,0,107,0,0.063451777,empty,mBC-0716-1
"H8,E6",13024,13086,9891,3195,6814,0,2994,3004,2124,880,2.413636364,1396,846,515,271,0,271,0,80,0,0.084870849,empty,mBC-0716-1
"H8,E7",13637,14009,10401,3608,7322,0,3292,3299,2300,999,2.302302302,1516,957,646,274,0,274,0,81,0,0.062043796,empty,mBC-0716-1
"H8,E8",17202,17505,13303,4202,9202,0,3941,3946,2798,1148,2.43728223,1875,3742,1723,858,0,858,0,186,0,0.097902098,empty,mBC-0716-1
"H8,E9",8856,9059,6826,2233,4734,0,2144,2148,1521,627,2.425837321,987,868,601,280,0,280,0,72,0,0.060714286,empty,mBC-0716-1
"H8,E10",12895,13620,9757,3863,7165,0,3356,3359,2286,1073,2.130475303,1688,861,574,304,0,304,0,69,0,0.0625,empty,mBC-0716-1
"H8,E11",9267,9543,6950,2593,5066,0,2324,2330,1603,727,2.204951857,1162,4990,1675,850,0,850,0,166,0,0.032941176,empty,mBC-0716-1
"H8,E12",14505,14934,10929,4005,7945,0,3647,3654,2610,1044,2.5,1764,1304,681,361,1,360,1,102,0,0.111111111,empty,mBC-0716-1
"H8,F1",626842,661134,457512,203622,352320,2,183836,184139,146258,37881,3.860985718,95187,15825,10893,5233,0,5233,0,823,0,0.004204089,mm10,mBC-0716-1
"H8,F2",21466,21719,16485,5234,11484,0,5143,5154,3572,1582,2.257901391,2359,14583,5116,2631,2,2629,1,435,0,0.079878281,empty,mBC-0716-1
"H8,F3",15833,16296,11730,4566,8693,0,4194,4202,2883,1319,2.185746778,2067,2959,1163,623,0,623,0,154,0,0.033707865,empty,mBC-0716-1
"H8,F4",15925,16243,12063,4180,8733,0,4051,4059,2815,1244,2.262861736,1896,385,254,152,0,152,0,55,0,0,empty,mBC-0716-1
"H8,F5",25010,25656,18777,6879,13320,0,5982,5996,4279,1717,2.492137449,2984,21823,6970,3404,6,3398,3,544,0,0.026486168,empty,mBC-0716-1
"H8,F6",22602,23387,17165,6222,12274,0,5618,5628,3962,1666,2.378151261,2692,1698,1170,557,0,557,0,144,0,0.037701975,empty,mBC-0716-1
"H8,F7",19529,19867,15071,4796,10708,0,4635,4649,3192,1457,2.19080302,2181,610,380,212,0,212,0,60,0,0.037735849,empty,mBC-0716-1
"H8,F8",22343,22785,17057,5728,11972,0,5456,5473,3785,1688,2.242298578,2574,100,54,38,0,38,0,20,0,0,empty,mBC-0716-1
"H8,F9",14729,15205,11391,3814,8168,0,3698,3707,2594,1113,2.330637916,1734,2325,1178,630,1,629,1,143,0,0.014308426,empty,mBC-0716-1
"H8,F10",1755828,1950302,1227642,722660,1006709,0,596611,597480,510948,86532,5.904728886,330803,178567,123162,58792,17,58775,4,3865,0,0.001259039,mm10,mBC-0716-1
"H8,F11",11959,12069,8929,3140,6369,0,2884,2890,1984,906,2.189845475,1346,5799,1914,1024,4,1020,1,198,0,0.105882353,empty,mBC-0716-1
"H8,F12",13795,14010,10456,3554,7246,0,3320,3335,2386,949,2.514225501,1577,139,79,48,0,48,0,13,0,0,empty,mBC-0716-1
"H8,G1",450638,458633,341634,116999,245769,1,114184,114383,85242,29141,2.925156995,54768,46535,17296,8563,8,8555,5,1299,0,0.050847458,mm10,mBC-0716-1
"H8,G2",20542,20994,15697,5297,11010,0,4900,4907,3437,1470,2.338095238,2322,568,203,104,0,104,0,33,0,0.067307692,empty,mBC-0716-1
"H8,G3",19498,20293,14587,5706,10505,1,4863,4869,3392,1477,2.296547055,2362,9063,2957,1545,2,1543,1,284,0,0.066753078,empty,mBC-0716-1
"H8,G4",28068,28358,21750,6608,14839,0,6360,6376,4444,1932,2.300207039,2974,65,42,29,0,29,0,13,0,0,empty,mBC-0716-1
"H8,G5",13045,13201,9752,3449,6979,0,3138,3144,2254,890,2.53258427,1491,5358,1828,880,0,880,0,175,0,0.040909091,empty,mBC-0716-1
"H8,G6",24008,24652,18431,6221,12871,0,5717,5737,4018,1719,2.337405468,2718,116,85,41,0,41,0,16,0,0,empty,mBC-0716-1
"H8,G7",20052,20403,15634,4769,10841,0,4771,4780,3376,1404,2.404558405,2231,1796,844,416,1,415,1,125,0,0.03373494,empty,mBC-0716-1
"H8,G8",14116,14453,10595,3858,7650,0,3591,3600,2503,1097,2.281677302,1722,7707,2570,1301,2,1299,1,244,0,0.093918399,empty,mBC-0716-1
"H8,G9",10679,11097,7930,3167,5719,0,2610,2618,1793,825,2.173333333,1278,12306,3790,1920,0,1920,0,350,0,0.0171875,empty,mBC-0716-1
"H8,G10",13646,14014,10481,3533,7334,0,3304,3308,2293,1015,2.2591133,1548,876,520,293,1,292,1,98,0,0.047945205,empty,mBC-0716-1
"H8,G11",12246,12421,9399,3022,6673,0,3023,3028,2094,934,2.241970021,1442,534,329,176,0,176,0,62,0,0.005681818,empty,mBC-0716-1
"H8,G12",11412,11785,8500,3285,6298,0,2932,2933,2041,892,2.288116592,1466,7591,2110,1079,0,1079,0,181,0,0.097312326,empty,mBC-0716-1
"H8,H1",20284,20476,15551,4925,10827,0,4787,4792,3359,1433,2.344033496,2259,998,513,292,1,291,1,77,0,0.068728522,empty,mBC-0716-1
"H8,H2",23012,23444,17525,5919,12238,0,5399,5413,3708,1705,2.174780059,2567,1762,1112,626,1,625,1,148,0,0.112,empty,mBC-0716-1
"H8,H3",19515,20138,14936,5202,10556,0,4765,4775,3343,1432,2.334497207,2271,931,521,281,0,281,0,81,0,0.028469751,empty,mBC-0716-1
"H8,H4",762117,861982,520896,341086,454196,1,277318,277652,205070,72582,2.825356149,158758,2456,1708,783,1,782,1,152,0,0,empty,mBC-0716-1
"H8,H5",720142,786858,521108,265750,414223,1,222911,223285,185649,37636,4.932750558,120195,36741,21917,10105,8,10097,2,1467,0,0.010795286,mm10,mBC-0716-1
"H8,H6",596020,637971,437874,200097,339856,0,172936,173197,136017,37180,3.658337816,91308,67111,47810,23247,11,23236,1,2134,0,0.000860733,mm10,mBC-0716-1
"H8,H7",16301,16383,12348,4035,8794,0,3946,3956,2820,1136,2.482394366,1866,713,416,226,1,225,1,88,0,0.022222222,empty,mBC-0716-1
"H8,H8",13038,13479,9937,3542,7012,0,3176,3180,2230,950,2.347368421,1475,1487,868,444,0,444,0,102,0,0.038288288,empty,mBC-0716-1
"H8,H9",14993,15193,11468,3725,8073,0,3553,3561,2501,1060,2.359433962,1654,1021,590,291,0,291,0,85,0,0.082474227,empty,mBC-0716-1
"H8,H10",14056,14458,10493,3965,7608,0,3531,3534,2484,1050,2.365714286,1783,5439,1755,922,1,921,1,190,0,0.026058632,empty,mBC-0716-1
"H8,H11",1844219,2062220,1256637,805583,1055919,3,641460,642376,543412,98964,5.491006831,363698,5127,3556,1718,0,1718,0,341,0,0,mm10,mBC-0716-1
"H8,H12",5789,5921,4328,1593,3213,0,1526,1534,1024,510,2.007843137,762,433,291,146,0,146,0,37,0,0.04109589,empty,mBC-0716-1
"H9,A1",13973,14392,10472,3920,7835,0,3659,3676,2574,1102,2.335753176,1812,1953,857,452,0,452,0,114,0,0.008849558,empty,mBC-0716-1
"H9,A2",19112,19260,14681,4579,10133,0,4330,4338,2991,1347,2.220489978,2023,938,610,322,0,322,0,108,0,0.027950311,empty,mBC-0716-1
"H9,A3",16294,16613,12396,4217,8850,0,4063,4066,2814,1252,2.247603834,1891,718,339,181,0,181,0,79,0,0.027624309,empty,mBC-0716-1
"H9,A4",22775,22988,17388,5600,11906,0,5213,5236,3662,1574,2.326556544,2422,9942,2853,1433,2,1431,1,255,0,0.074772886,empty,mBC-0716-1
"H9,A5",17103,17683,13029,4654,9325,0,4308,4321,2958,1363,2.170212766,2046,1167,690,341,0,341,0,102,0,0.082111437,empty,mBC-0716-1
"H9,A6",15223,15912,11568,4344,8465,0,4080,4087,2995,1092,2.742673993,1913,10130,3598,1882,2,1880,1,338,0,0.111702128,empty,mBC-0716-1
"H9,A7",452189,470362,345960,124402,255833,0,118978,119156,90863,28293,3.211501078,58678,16390,9969,4926,4,4922,1,801,0,0.006095083,mm10,mBC-0716-1
"H9,A8",11177,11414,8463,2951,6218,0,2894,2901,2040,861,2.369337979,1332,1380,921,455,0,455,0,133,0,0.074725275,empty,mBC-0716-1
"H9,A9",19157,19016,14730,4286,10108,0,4290,4304,3096,1208,2.562913907,1980,1047,660,341,0,341,0,111,0,0.129032258,empty,mBC-0716-1
"H9,A10",16012,16296,12193,4103,8633,0,3834,3846,2601,1245,2.089156627,1832,266,185,107,0,107,0,58,0,0,empty,mBC-0716-1
"H9,A11",726257,785509,521836,263673,416338,0,222209,222541,165812,56729,2.922878951,120773,69631,50056,24060,6,24054,1,2203,0,0.001496633,mm10,mBC-0716-1
"H9,A12",20595,20926,15829,5097,11071,0,4866,4876,3409,1467,2.323790048,2285,2638,1700,858,1,857,1,174,0,0.103850642,empty,mBC-0716-1
"H9,B1",586016,596748,438302,158446,320143,1,149628,149938,110250,39688,2.777917759,74814,21441,14337,7107,3,7104,1,1031,0,0.00365991,mm10,mBC-0716-1
"H9,B2",1033017,1097064,757438,339626,570020,3,291284,291746,257755,33991,7.583036686,150583,53767,33589,16370,3,16367,2,1774,0,0.002382844,mm10,mBC-0716-1
"H9,B3",1307740,1331492,993724,337768,696449,1,327713,328327,268519,59808,4.489683654,158429,68587,46361,22739,6,22733,1,2350,0,0.001363656,mm10,mBC-0716-1
"H9,B4",785137,864026,557156,306870,460239,0,262227,262612,219283,43329,5.060883011,143615,67816,45738,21975,8,21967,2,2052,0,0.000910457,mm10,mBC-0716-1
"H9,B5",9335,5832,4047,1785,3920,0,1895,1912,1323,589,2.246179966,1027,644,352,175,0,175,0,70,0,0.04,empty,mBC-0716-1
"H9,B6",12016,12233,8985,3248,6466,0,2914,2918,1978,940,2.104255319,1369,3329,1356,716,2,714,1,166,0,0.082633053,empty,mBC-0716-1
"H9,B7",16821,16934,13009,3925,9033,0,3932,3942,2773,1169,2.372112917,1792,866,503,293,0,293,0,95,0,0.017064846,empty,mBC-0716-1
"H9,B8",532660,564690,396217,168473,303353,1,149267,149512,126398,23114,5.468460673,76336,57348,40330,19474,10,19464,3,1869,0,0.0006679,mm10,mBC-0716-1
"H9,B9",15521,15829,11949,3880,8383,0,3695,3704,2556,1148,2.226480836,1752,2111,703,361,2,359,1,102,0,0.072423398,empty,mBC-0716-1
"H9,B10",17096,16510,12260,4250,9111,0,4173,4195,2868,1327,2.161266014,2025,322,172,116,0,116,0,50,0,0.043103448,empty,mBC-0716-1
"H9,B11",17346,17889,13054,4835,9445,0,4327,4335,2998,1337,2.242333583,2155,285,213,97,0,97,0,33,0,0.010309278,empty,mBC-0716-1
"H9,B12",1295715,1423576,936226,487350,748411,0,405636,406216,343201,63015,5.446338173,218912,241713,171880,82377,25,82352,3,4433,0,0.000655722,mm10,mBC-0716-1
"H9,C1",1367358,1483881,958378,525503,757516,0,441606,442275,342773,99502,3.44488553,240741,29364,20254,9591,2,9589,1,1237,0,0.001877151,mm10,mBC-0716-1
"H9,C2",18869,19230,14189,5041,10409,0,4745,4757,3367,1390,2.422302158,2251,1573,949,486,0,486,0,142,0,0.119341564,empty,mBC-0716-1
"H9,C3",20756,21234,15618,5616,11167,0,5167,5179,3664,1515,2.418481848,2487,515,284,139,0,139,0,45,0,0.028776978,empty,mBC-0716-1
"H9,C4",17036,17115,13010,4105,9147,0,3916,3932,2716,1216,2.233552632,1791,1088,667,336,0,336,0,102,0,0.047619048,empty,mBC-0716-1
"H9,C5",16350,16786,12328,4458,8786,1,3921,3934,2751,1183,2.325443787,1925,1016,605,311,0,311,0,107,0,0.035369775,empty,mBC-0716-1
"H9,C6",17800,18191,13292,4899,10031,0,4646,4648,3241,1407,2.303482587,2260,1162,771,398,0,398,0,109,0,0.025125628,empty,mBC-0716-1
"H9,C7",16626,17357,12441,4916,9114,0,4203,4214,2968,1246,2.382022472,2127,1748,572,325,1,324,1,74,0,0.092592593,empty,mBC-0716-1
"H9,C8",14916,15367,11375,3992,8090,0,3617,3631,2516,1115,2.256502242,1748,1402,852,432,0,432,0,132,0,0.041666667,empty,mBC-0716-1
"H9,C9",13069,13637,9874,3763,7255,0,3311,3318,2307,1011,2.28189911,1655,892,637,322,0,322,0,85,0,0.02173913,empty,mBC-0716-1
"H9,C10",14063,14159,10859,3300,7554,0,3392,3394,2324,1070,2.171962617,1492,1133,765,361,0,361,0,87,0,0.055401662,empty,mBC-0716-1
"H9,C11",13107,13400,9863,3537,7218,0,3270,3280,2265,1015,2.231527094,1588,910,585,302,0,302,0,95,0,0.066225166,empty,mBC-0716-1
"H9,C12",675685,740325,479409,260916,392683,3,219308,219596,185651,33945,5.469170717,120490,57553,39311,18859,4,18855,1,1901,0,0.000159109,mm10,mBC-0716-1
"H9,D1",10373,10783,7752,3031,5796,0,2682,2684,1847,837,2.206690562,1355,419,224,127,0,127,0,60,0,0.086614173,empty,mBC-0716-1
"H9,D2",21414,21694,16483,5211,11482,1,4936,4953,3436,1517,2.264996704,2303,2206,1409,691,0,691,0,166,0,0.102749638,empty,mBC-0716-1
"H9,D3",14125,14405,10424,3981,7588,0,3545,3555,2451,1104,2.220108696,1750,12794,4127,2151,2,2149,1,366,0,0.131223825,empty,mBC-0716-1
"H9,D4",14234,14442,10880,3562,7757,0,3494,3502,2463,1039,2.370548604,1672,939,582,311,0,311,0,113,0,0.032154341,empty,mBC-0716-1
"H9,D5",653362,662987,484303,178684,355228,2,170841,171123,136265,34858,3.909145677,84348,25230,17519,8772,7,8765,1,1119,0,0.003993155,mm10,mBC-0716-1
"H9,D6",12257,12772,9162,3610,6800,0,3200,3205,2215,990,2.237373737,1574,1130,746,389,0,389,0,119,0,0.048843188,empty,mBC-0716-1
"H9,D7",702207,782632,487220,295412,416214,0,243760,244082,189483,54599,3.470448177,137348,95891,68543,33313,15,33298,3,2614,0,0.000750796,mm10,mBC-0716-1
"H9,D8",16887,17698,12878,4820,9229,0,4324,4340,3000,1340,2.23880597,2057,666,437,238,1,237,1,90,0,0.063291139,empty,mBC-0716-1
"H9,D9",4433,4433,3252,1181,2507,0,1212,1215,874,341,2.563049853,626,3233,1213,649,0,649,0,146,0,0.107858243,empty,mBC-0716-1
"H9,D10",742196,843928,511513,332415,448819,1,273800,274151,205928,68223,3.018454187,156877,38306,27231,13218,8,13210,1,1496,0,0.001135503,mm10,mBC-0716-1
"H9,D11",13935,14111,10658,3453,7563,0,3375,3378,2441,937,2.605122732,1533,1098,653,353,1,352,1,111,0,0.042613636,empty,mBC-0716-1
"H9,D12",21018,21491,15953,5538,11381,0,5234,5246,3633,1613,2.252324861,2457,1508,996,547,0,547,0,151,0,0.042047532,empty,mBC-0716-1
"H9,E1",961552,1036931,676188,360743,544348,0,304064,304469,253887,50582,5.019315171,165487,99034,63421,31105,9,31096,2,2552,0,0.00189735,mm10,mBC-0716-1
"H9,E2",16204,16263,12261,4002,8700,0,3855,3869,2739,1130,2.423893805,1844,1656,917,490,0,490,0,138,0,0.053061224,empty,mBC-0716-1
"H9,E3",12711,12779,9781,2998,6812,0,3029,3034,2102,932,2.255364807,1372,1444,879,472,0,472,0,138,0,0.046610169,empty,mBC-0716-1
"H9,E4",16196,16519,12292,4227,8738,0,3931,3940,2746,1194,2.299832496,1852,1089,728,376,0,376,0,116,0,0.066489362,empty,mBC-0716-1
"H9,E5",21608,22134,16722,5412,11587,0,5101,5107,3562,1545,2.305501618,2365,1017,699,378,0,378,0,107,0,0.058201058,empty,mBC-0716-1
"H9,E6",12921,12920,9897,3023,7037,0,2998,3002,2059,943,2.183457052,1417,1243,735,413,0,413,0,109,0,0.062953995,empty,mBC-0716-1
"H9,E7",13694,14144,10496,3648,7496,0,3399,3402,2401,1001,2.398601399,1637,997,636,321,0,321,0,104,0,0.009345794,empty,mBC-0716-1
"H9,E8",17463,17989,13380,4609,9472,0,4200,4207,2935,1272,2.307389937,1989,2041,1144,571,0,571,0,157,0,0.077057793,empty,mBC-0716-1
"H9,E9",8982,9040,6791,2249,4819,0,2190,2196,1474,722,2.041551247,1024,1132,785,366,0,366,0,87,0,0.06284153,empty,mBC-0716-1
"H9,E10",13934,14043,10497,3546,7524,0,3405,3413,2443,970,2.518556701,1497,4547,1769,912,1,911,1,209,0,0.121844127,empty,mBC-0716-1
"H9,E11",9186,9148,7055,2093,4947,0,2152,2153,1516,637,2.379905808,927,4591,1573,833,2,831,2,198,0,0.046931408,empty,mBC-0716-1
"H9,E12",584465,613098,437762,175336,328399,1,157305,157578,128314,29264,4.384704757,79886,90008,57214,27448,16,27432,1,2428,0,0.000947798,mm10,mBC-0716-1
"H9,F1",18433,19285,14098,5187,9992,0,4503,4519,3166,1353,2.339985218,2283,1144,657,370,0,370,0,91,0,0.083783784,empty,mBC-0716-1
"H9,F2",23037,23907,17492,6415,12697,0,5850,5862,4067,1795,2.265738162,2869,2344,1497,815,0,815,0,204,0,0.035582822,empty,mBC-0716-1
"H9,F3",16677,17189,12506,4683,9178,0,4266,4272,2893,1379,2.097897027,2125,2312,1120,579,0,579,0,160,0,0.110535406,empty,mBC-0716-1
"H9,F4",17327,17572,13162,4410,9592,0,4211,4227,2899,1328,2.182981928,2017,440,259,133,1,132,1,53,0,0,empty,mBC-0716-1
"H9,F5",24380,24930,18662,6268,13144,0,5863,5877,4135,1742,2.373708381,2791,1497,854,468,0,468,0,157,0,0.040598291,empty,mBC-0716-1
"H9,F6",23824,24173,17865,6308,12737,0,5749,5759,4130,1629,2.535297729,2763,2108,1342,665,0,665,0,183,0,0.057142857,empty,mBC-0716-1
"H9,F7",735506,796271,538614,257657,431600,0,227874,228242,178598,49644,3.597574732,121106,30705,22085,10678,3,10675,1,1328,0,0.003278689,mm10,mBC-0716-1
"H9,F8",1717243,1833310,1209239,624071,952519,1,553114,553930,432718,121212,3.56992707,294888,1998,1241,602,1,601,1,158,0,0,empty,mBC-0716-1
"H9,F9",15475,15553,11856,3697,8370,0,3715,3721,2632,1089,2.416896235,1716,1565,1034,546,0,546,0,163,0,0.095238095,empty,mBC-0716-1
"H9,F10",21342,21771,16496,5275,11490,0,4917,4927,3511,1416,2.479519774,2295,1263,826,422,0,422,0,119,0,0.113744076,empty,mBC-0716-1
"H9,F11",11895,12015,8933,3082,6554,0,2934,2945,2075,870,2.385057471,1425,1587,749,381,0,381,0,107,0,0.05511811,empty,mBC-0716-1
"H9,F12",14075,14438,10748,3690,7489,0,3354,3363,2377,986,2.410750507,1600,72,31,27,0,27,0,16,0,0,empty,mBC-0716-1
"H9,G1",10474,10743,8001,2742,5698,0,2472,2481,1708,773,2.209573092,1209,1490,1008,558,0,558,0,136,0,0.039426523,empty,mBC-0716-1
"H9,G2",21793,22311,16671,5640,11774,0,5287,5296,3724,1572,2.368956743,2507,368,201,96,0,96,0,35,0,0,empty,mBC-0716-1
"H9,G3",19745,19966,15098,4868,10611,0,4742,4747,3313,1434,2.310320781,2197,1563,955,460,1,459,1,138,0,0.080610022,empty,mBC-0716-1
"H9,G4",28973,29054,22358,6696,15295,3,6478,6499,4591,1908,2.406184486,2967,48,36,31,0,31,0,23,0,0.032258065,empty,mBC-0716-1
"H9,G5",13166,13484,9901,3583,7204,0,3197,3209,2217,992,2.234879032,1576,1105,761,399,0,399,0,106,0,0.035087719,empty,mBC-0716-1
"H9,G6",25213,25817,19219,6598,13547,1,6030,6036,4307,1729,2.491035281,2872,408,215,130,1,129,1,39,0,0.062015504,empty,mBC-0716-1
"H9,G7",21093,21396,16341,5055,11306,0,4883,4887,3424,1463,2.340396446,2325,1854,1100,580,0,580,0,176,0,0.039655172,empty,mBC-0716-1
"H9,G8",14480,14993,11012,3981,7882,0,3605,3615,2525,1090,2.316513761,1772,1218,827,410,0,410,0,119,0,0.031707317,empty,mBC-0716-1
"H9,G9",1600200,1810364,1086510,723854,941434,2,589585,590307,467376,122931,3.801937672,336455,189125,120546,58398,26,58372,3,3882,0,0.002329884,mm10,mBC-0716-1
"H9,G10",13717,13983,10580,3403,7451,0,3243,3256,2283,973,2.34635149,1514,1173,734,369,0,369,0,112,0,0.051490515,empty,mBC-0716-1
"H9,G11",13336,13365,10072,3293,7273,0,3304,3308,2380,928,2.564655172,1508,931,568,280,0,280,0,103,0,0.042857143,empty,mBC-0716-1
"H9,G12",11568,11770,8742,3028,6244,0,2840,2846,1973,873,2.26002291,1289,3118,1533,794,1,793,1,184,0,0.141235813,empty,mBC-0716-1
"H9,H1",21405,21903,16264,5639,11632,0,5209,5220,3692,1528,2.416230366,2484,3775,1382,669,2,667,1,193,0,0.03898051,empty,mBC-0716-1
"H9,H2",24276,24703,18398,6305,13017,0,5768,5780,4010,1770,2.265536723,2736,1780,1076,575,0,575,0,156,0,0.055652174,empty,mBC-0716-1
"H9,H3",20200,20662,15374,5288,10810,0,4934,4941,3473,1468,2.365803815,2344,11891,4099,2119,1,2118,1,367,0,0.142587347,empty,mBC-0716-1
"H9,H4",14580,15035,11063,3972,8014,0,3710,3715,2641,1074,2.459031657,1752,107,45,22,0,22,0,12,0,0,empty,mBC-0716-1
"H9,H5",18528,19000,14226,4774,9857,0,4438,4441,3043,1398,2.176680973,2061,1275,831,400,0,400,0,136,0,0.015,empty,mBC-0716-1
"H9,H6",14088,14422,10500,3922,7927,0,3700,3705,2581,1124,2.296263345,1808,1473,811,412,0,412,0,126,0,0.038834951,empty,mBC-0716-1
"H9,H7",606354,634420,456356,178064,341901,1,162178,162465,136512,25953,5.259969946,81505,82508,57934,27626,10,27616,2,2345,0,0.001158749,mm10,mBC-0716-1
"H9,H8",13359,13670,10065,3605,7330,0,3388,3396,2383,1013,2.352418559,1628,1570,1032,508,0,508,0,136,0,0.043307087,empty,mBC-0716-1
"H9,H9",15461,15714,11796,3918,8373,1,3749,3756,2608,1148,2.271777003,1803,970,676,338,0,338,0,112,0,0.062130178,empty,mBC-0716-1
"H9,H10",14059,14608,10619,3989,7631,0,3478,3487,2410,1077,2.237697307,1730,1225,800,367,1,366,1,104,0,0.040983607,empty,mBC-0716-1
"H9,H11",17374,17899,13153,4746,9659,0,4453,4460,3078,1382,2.227206946,2177,182,84,55,0,55,0,35,0,0.018181818,empty,mBC-0716-1
"H9,H12",6390,6519,4781,1738,3578,0,1674,1682,1149,533,2.155722326,827,668,460,237,0,237,0,67,0,0.126582278,empty,mBC-0716-1
"H10,A1",13468,13792,10211,3581,7640,0,3523,3529,2440,1089,2.240587695,1645,2705,1224,620,0,620,0,139,0,0.006451613,empty,mBC-0716-1
"H10,A2",17984,18072,13834,4238,9651,0,4134,4147,2849,1298,2.194915254,1899,880,557,278,0,278,0,86,0,0.122302158,empty,mBC-0716-1
"H10,A3",423122,431772,314765,117007,234831,0,112022,112225,85508,26717,3.200509039,55451,7037,3802,1815,2,1813,1,379,0,0.023717595,mm10,mBC-0716-1
"H10,A4",21631,21880,16757,5123,11462,0,4970,4978,3478,1500,2.318666667,2300,554,347,154,0,154,0,54,0,0.045454545,empty,mBC-0716-1
"H10,A5",686319,737026,509553,227473,393159,1,197949,198236,160632,37604,4.271673226,103414,123091,88561,42519,5,42514,3,2978,0,0.001034953,mm10,mBC-0716-1
"H10,A6",17824,18648,13272,5376,10084,0,4897,4903,3380,1523,2.219304005,2467,1242,737,385,0,385,0,121,0,0.051948052,empty,mBC-0716-1
"H10,A7",16745,17183,12770,4413,9236,0,4208,4224,2897,1327,2.183119819,2042,1037,652,360,0,360,0,120,0,0.008333333,empty,mBC-0716-1
"H10,A8",11066,11589,8405,3184,6204,0,2878,2881,2043,838,2.437947494,1404,1905,1098,553,0,553,0,167,0,0.021699819,empty,mBC-0716-1
"H10,A9",836940,887243,624845,262398,463915,2,232611,233031,183090,49941,3.666126029,118678,67711,47190,22609,11,22598,2,2036,0,0.001283299,mm10,mBC-0716-1
"H10,A10",15536,15774,11864,3910,8270,0,3675,3690,2566,1124,2.282918149,1725,241,107,65,0,65,0,40,0,0,empty,mBC-0716-1
"H10,A11",18125,18507,13806,4701,10016,0,4441,4449,3150,1299,2.424942263,2054,943,602,286,0,286,0,87,0,0.045454545,empty,mBC-0716-1
"H10,A12",20744,20947,15949,4998,10748,0,4594,4606,3204,1402,2.285306705,2085,3645,2091,1050,1,1049,1,205,0,0.094375596,empty,mBC-0716-1
"H10,B1",19654,19943,14872,5071,10273,0,4636,4648,3292,1356,2.427728614,2155,14991,4748,2384,0,2384,0,386,0,0.122902685,empty,mBC-0716-1
"H10,B2",21325,21650,16396,5254,11403,4,4992,5009,3441,1568,2.194515306,2253,383,201,103,0,103,0,38,0,0,empty,mBC-0716-1
"H10,B3",18541,18751,14302,4449,9948,0,4448,4464,3162,1302,2.428571429,2038,1202,740,380,0,380,0,112,0,0.021052632,empty,mBC-0716-1
"H10,B4",16388,16715,12460,4255,8819,0,4040,4042,2816,1226,2.296900489,1887,1086,725,329,1,328,1,100,0,0.039634146,empty,mBC-0716-1
"H10,B5",9099,5585,4018,1567,3833,0,1819,1841,1266,575,2.20173913,968,839,462,218,0,218,0,63,0,0.133027523,empty,mBC-0716-1
"H10,B6",11765,12157,8993,3164,6476,1,2961,2973,2047,926,2.210583153,1403,1260,834,427,0,427,0,99,0,0.06323185,empty,mBC-0716-1
"H10,B7",16552,17155,12671,4484,9101,0,4144,4160,2932,1228,2.38762215,2030,1157,675,336,0,336,0,83,0,0.053571429,empty,mBC-0716-1
"H10,B8",595541,669893,407758,262135,358925,0,221732,222017,157556,64461,2.444206575,126145,17167,12087,5631,1,5630,1,883,0,0.001953819,mm10,mBC-0716-1
"H10,B9",889635,979347,632519,346828,511202,1,289180,289601,202625,86976,2.329665655,160737,17444,12161,5907,2,5905,1,867,0,0.000338696,mm10,mBC-0716-1
"H10,B10",16284,15792,11732,4060,8783,0,3982,4018,2770,1248,2.219551282,1939,401,289,153,0,153,0,43,0,0.052287582,empty,mBC-0716-1
"H10,B11",16406,16580,12314,4266,8692,0,4026,4027,2810,1217,2.30895645,1971,641,261,131,0,131,0,50,0,0.015267176,empty,mBC-0716-1
"H10,B12",17845,18310,13732,4578,9742,1,4247,4263,2983,1280,2.33046875,2001,1298,794,377,0,377,0,117,0,0.100795756,empty,mBC-0716-1
"H10,C1",23331,22985,18112,4873,12255,0,5196,5200,3712,1488,2.494623656,2216,666,380,210,0,210,0,74,0,0.080952381,empty,mBC-0716-1
"H10,C2",18588,19115,13789,5326,10005,0,4719,4730,3335,1395,2.390681004,2353,36007,11495,5682,6,5676,5,784,0,0.0431642,empty,mBC-0716-1
"H10,C3",1175091,1319765,809775,509990,682024,1,411652,412206,322013,90193,3.570265985,234179,33675,22721,10744,4,10740,1,1282,0,0.001117318,mm10,mBC-0716-1
"H10,C4",852724,890999,628000,262999,469145,2,230286,230661,187123,43538,4.297923653,117184,114804,78660,39018,14,39004,3,3210,0,0.001769049,mm10,mBC-0716-1
"H10,C5",15363,15595,11677,3918,8310,0,3792,3802,2606,1196,2.178929766,1769,787,501,269,0,269,0,93,0,0.003717472,empty,mBC-0716-1
"H10,C6",16128,16410,12081,4329,8997,0,4224,4240,2911,1329,2.190368698,2038,2019,1028,484,0,484,0,122,0,0.076446281,empty,mBC-0716-1
"H10,C7",1860851,2030564,1303399,727165,1044396,1,606659,607530,485415,122115,3.975064488,334268,26992,18467,8826,4,8822,2,1154,0,0.000453412,mm10,mBC-0716-1
"H10,C8",14529,15071,11021,4050,8019,0,3645,3647,2561,1086,2.358195212,1745,10225,3183,1613,0,1613,0,319,0,0.028518289,empty,mBC-0716-1
"H10,C9",12496,13075,9483,3592,6803,0,3093,3098,2159,939,2.299254526,1542,3537,1248,645,0,645,0,155,0,0.052713178,empty,mBC-0716-1
"H10,C10",13490,13778,10436,3342,7382,0,3302,3316,2312,1004,2.302788845,1527,836,500,261,0,261,0,86,0,0.042145594,empty,mBC-0716-1
"H10,C11",732848,771223,551036,220187,406582,1,195160,195458,163838,31620,5.181467426,98551,73174,52556,24459,5,24454,1,2233,0,0.000776969,mm10,mBC-0716-1
"H10,C12",19995,20525,15143,5382,10730,0,4827,4849,3369,1480,2.276351351,2349,1576,976,455,0,455,0,102,0,0.041758242,empty,mBC-0716-1
"H10,D1",708295,741145,507909,233236,396345,1,215673,215986,166167,49819,3.335414199,112334,16030,10465,5108,1,5107,1,794,0,0.000587429,mm10,mBC-0716-1
"H10,D2",21033,21629,16449,5180,11208,0,4800,4824,3349,1475,2.270508475,2183,1941,1208,620,1,619,1,178,0,0.045234249,empty,mBC-0716-1
"H10,D3",13239,13882,9984,3898,7350,0,3490,3497,2321,1176,1.973639456,1747,789,508,285,0,285,0,92,0,0.007017544,empty,mBC-0716-1
"H10,D4",13265,13515,10132,3383,7257,0,3305,3318,2273,1045,2.175119617,1534,1714,849,424,0,424,0,125,0,0.002358491,empty,mBC-0716-1
"H10,D5",13733,14011,10438,3573,7574,0,3437,3443,2437,1006,2.422465209,1602,1801,856,491,1,490,1,143,0,0.051020408,empty,mBC-0716-1
"H10,D6",11884,12450,8993,3457,6571,0,3034,3040,2133,907,2.351708931,1513,1464,824,420,0,420,0,111,0,0.030952381,empty,mBC-0716-1
"H10,D7",12866,13223,9823,3400,6965,0,3173,3177,2191,986,2.222109533,1516,1275,796,413,0,413,0,128,0,0.053268765,empty,mBC-0716-1
"H10,D8",15891,16396,11884,4512,8786,0,4040,4051,2780,1271,2.187254131,1985,814,521,281,0,281,0,83,0,0.071174377,empty,mBC-0716-1
"H10,D9",4518,4704,3289,1415,2654,0,1266,1268,886,382,2.319371728,656,1614,946,518,0,518,0,130,0,0.075289575,empty,mBC-0716-1
"H10,D10",14257,14777,10822,3955,7869,0,3674,3687,2623,1064,2.465225564,1758,1060,579,298,0,298,0,74,0,0.053691275,empty,mBC-0716-1
"H10,D11",1246265,1379438,879493,499945,729843,5,424014,424638,323174,101464,3.18510999,234237,156010,103862,49734,22,49712,3,3586,0,0.006115224,mm10,mBC-0716-1
"H10,D12",20149,20532,15690,4842,10774,0,4742,4753,3255,1498,2.172897196,2144,1395,927,526,0,526,0,138,0,0.045627376,empty,mBC-0716-1
"H10,E1",21723,21862,16620,5242,11571,0,5140,5150,3639,1511,2.408338848,2391,1601,938,469,1,468,1,134,0,0.036324786,empty,mBC-0716-1
"H10,E2",16066,16349,12257,4092,8859,1,4015,4021,2881,1140,2.527192982,1871,1907,1118,577,0,577,0,136,0,0.027729636,empty,mBC-0716-1
"H10,E3",12822,12870,9745,3125,6991,0,3133,3145,2149,996,2.157630522,1447,1375,839,436,0,436,0,126,0,0.089449541,empty,mBC-0716-1
"H10,E4",15329,16081,11713,4368,8271,0,3767,3775,2572,1203,2.137988362,1834,1194,742,407,0,407,0,120,0,0.039312039,empty,mBC-0716-1
"H10,E5",22057,22398,16805,5593,12024,0,5498,5500,3984,1516,2.627968338,2598,1241,791,392,0,392,0,119,0,0.06122449,empty,mBC-0716-1
"H10,E6",13174,13505,10051,3454,7042,0,3090,3093,2137,956,2.235355649,1460,1637,1011,516,0,516,0,129,0,0.085271318,empty,mBC-0716-1
"H10,E7",464306,464640,347399,117241,250473,0,114026,114243,87235,27008,3.229968898,55229,8867,6207,2952,0,2952,0,579,0,0.006775068,mm10,mBC-0716-1
"H10,E8",18891,19022,14310,4712,10525,0,4649,4657,3315,1342,2.470193741,2196,1719,1144,568,0,568,0,149,0,0.088028169,empty,mBC-0716-1
"H10,E9",9583,9546,7049,2497,5479,0,2641,2643,1841,802,2.295511222,1295,1006,651,354,0,354,0,115,0,0.02259887,empty,mBC-0716-1
"H10,E10",13250,13529,10009,3520,7424,1,3452,3464,2404,1060,2.267924528,1650,1307,773,411,0,411,0,97,0,0.133819951,empty,mBC-0716-1
"H10,E11",678760,731062,500598,230464,392006,0,205109,205414,140602,64812,2.169382213,108599,62334,41390,19698,9,19689,1,1867,0,0.000914216,mm10,mBC-0716-1
"H10,E12",14665,15159,11135,4024,8116,0,3648,3660,2599,1061,2.449575872,1811,1123,731,344,0,344,0,93,0,0.072674419,empty,mBC-0716-1
"H10,F1",17763,18228,13637,4591,9615,0,4357,4361,3081,1280,2.40703125,2032,1197,760,386,0,386,0,102,0,0.059585492,empty,mBC-0716-1
"H10,F2",23178,24047,17371,6676,12727,0,5948,5966,4187,1779,2.353569421,2895,2401,1444,761,0,761,0,195,0,0.084099869,empty,mBC-0716-1
"H10,F3",15764,16468,11844,4624,8716,0,4007,4021,2727,1294,2.107418856,2028,1073,585,299,0,299,0,120,0,0.003344482,empty,mBC-0716-1
"H10,F4",16836,16874,12699,4175,9456,0,4252,4263,3019,1244,2.426848875,1972,447,290,153,0,153,0,61,0,0,empty,mBC-0716-1
"H10,F5",24364,24699,18376,6323,13203,0,6026,6029,4263,1766,2.413929785,2934,2454,1239,635,2,633,1,155,0,0.086887836,empty,mBC-0716-1
"H10,F6",1728764,1813898,1264582,549316,932225,0,485433,486220,395828,90392,4.379015842,250817,184613,128856,60625,27,60598,4,3995,0,0.001155154,mm10,mBC-0716-1
"H10,F7",20639,20938,15677,5261,11721,0,5256,5268,3671,1597,2.298685034,2456,827,519,265,0,265,0,81,0,0.086792453,empty,mBC-0716-1
"H10,F8",22087,22848,16818,6030,12113,0,5492,5504,3812,1692,2.252955083,2723,237,143,78,0,78,0,37,0,0,empty,mBC-0716-1
"H10,F9",15189,15416,11575,3841,8238,0,3697,3702,2580,1122,2.299465241,1747,1659,1087,539,0,539,0,145,0,0.066790353,empty,mBC-0716-1
"H10,F10",20591,20844,15958,4886,10872,0,4674,4682,3293,1389,2.370770338,2155,1445,939,395,0,395,0,109,0,0.078481013,empty,mBC-0716-1
"H10,F11",10994,11279,8545,2734,6008,0,2634,2646,1876,770,2.436363636,1222,1234,648,340,0,340,0,95,0,0,empty,mBC-0716-1
"H10,F12",13646,13517,10525,2992,7268,0,3255,3258,2286,972,2.351851852,1410,53,26,17,0,17,0,10,0,0,empty,mBC-0716-1
"H10,G1",10524,10716,8093,2623,5768,0,2573,2584,1770,814,2.174447174,1206,2056,1306,647,0,647,0,160,0,0.027820711,empty,mBC-0716-1
"H10,G2",20771,21259,15784,5475,11138,0,4946,4952,3479,1473,2.361846572,2389,222,131,55,0,55,0,28,0,0.145454545,empty,mBC-0716-1
"H10,G3",655757,712610,487243,225367,377421,0,193667,193969,155992,37977,4.107538773,101669,111513,76474,36120,21,36099,3,2768,0,0.001495886,mm10,mBC-0716-1
"H10,G4",1008168,1048011,753020,294991,547240,1,263996,264531,209971,54560,3.848442082,132465,948,498,235,0,235,0,65,0,0,empty,mBC-0716-1
"H10,G5",13520,13869,10291,3578,7449,0,3492,3501,2372,1129,2.100974314,1657,1130,584,326,1,325,1,98,0,0.033846154,empty,mBC-0716-1
"H10,G6",24281,24639,18911,5728,12850,0,5543,5546,3882,1664,2.332932692,2541,231,165,104,0,104,0,49,0,0.019230769,empty,mBC-0716-1
"H10,G7",20141,19911,15439,4472,10534,0,4439,4448,3096,1352,2.289940828,2024,2205,1191,582,0,582,0,173,0,0.025773196,empty,mBC-0716-1
"H10,G8",14456,14960,10926,4034,8036,0,3713,3718,2570,1148,2.238675958,1753,1354,813,442,0,442,0,142,0,0.038461538,empty,mBC-0716-1
"H10,G9",10934,11317,8243,3074,5938,0,2724,2727,1910,817,2.337821297,1325,13808,4296,2182,1,2181,1,361,0,0.072902338,empty,mBC-0716-1
"H10,G10",13729,13827,10470,3357,7357,1,3229,3248,2252,996,2.261044177,1528,953,589,291,0,291,0,105,0,0.037800687,empty,mBC-0716-1
"H10,G11",12175,12521,9279,3242,6685,0,2993,2999,2156,843,2.557532622,1461,513,316,166,0,166,0,68,0,0.012048193,empty,mBC-0716-1
"H10,G12",11312,11584,8694,2890,6232,0,2837,2841,2033,808,2.516089109,1341,1342,897,449,0,449,0,95,0,0.122494432,empty,mBC-0716-1
"H10,H1",20535,21023,15666,5357,11206,0,5131,5138,3641,1497,2.432197729,2497,753,467,247,0,247,0,87,0,0.020242915,empty,mBC-0716-1
"H10,H2",24503,24707,18707,6000,13004,0,5744,5758,4087,1671,2.445840814,2656,2021,1178,633,0,633,0,156,0,0.071090047,empty,mBC-0716-1
"H10,H3",19249,19342,14579,4763,10260,0,4591,4599,3283,1316,2.494680851,2128,1356,911,460,0,460,0,127,0,0.02173913,empty,mBC-0716-1
"H10,H4",12976,13095,9876,3219,7011,0,3118,3128,2154,974,2.211498973,1499,217,80,46,0,46,0,25,0,0,empty,mBC-0716-1
"H10,H5",18118,18603,13571,5032,10027,0,4643,4655,3271,1384,2.363439306,2263,11238,3726,1857,1,1856,1,319,0,0.071659483,empty,mBC-0716-1
"H10,H6",473159,504654,342036,162618,273951,2,144170,144385,111427,32958,3.380878694,76697,54360,39250,18746,5,18741,1,1883,0,0.004108639,mm10,mBC-0716-1
"H10,H7",16554,17315,12495,4820,9127,0,4276,4286,3062,1224,2.501633987,2100,870,560,306,0,306,0,104,0,0.026143791,empty,mBC-0716-1
"H10,H8",433455,443200,329553,113647,238566,0,109008,109201,76734,32467,2.363445961,52950,45002,20501,9949,10,9939,4,1325,0,0.036925244,mm10,mBC-0716-1
"H10,H9",15850,16073,11910,4163,8749,0,4002,4013,2837,1176,2.412414966,1928,1763,844,469,0,469,0,123,0,0.085287846,empty,mBC-0716-1
"H10,H10",14213,14434,10773,3661,7746,0,3561,3568,2465,1103,2.234814143,1708,1234,814,385,0,385,0,116,0,0.07012987,empty,mBC-0716-1
"H10,H11",16455,17020,12570,4450,9155,0,4234,4252,2906,1346,2.158989599,2102,294,128,71,0,71,0,36,0,0.070422535,empty,mBC-0716-1
"H10,H12",5667,5804,4328,1476,3148,0,1449,1452,1023,429,2.384615385,724,474,281,140,1,139,1,54,0,0.09352518,empty,mBC-0716-1
"H11,A1",14173,14774,10730,4044,8034,0,3801,3812,2741,1071,2.559290383,1858,967,599,281,0,281,0,98,0,0.003558719,empty,mBC-0716-1
"H11,A2",18016,18445,13818,4627,9844,0,4422,4436,3122,1314,2.375951294,2093,865,549,295,0,295,0,96,0,0.040677966,empty,mBC-0716-1
"H11,A3",15740,16434,12125,4309,8818,0,4074,4085,2868,1217,2.356614626,1947,983,579,314,0,314,0,81,0,0.044585987,empty,mBC-0716-1
"H11,A4",19646,19823,15304,4519,10606,0,4614,4629,3288,1341,2.451901566,2100,544,383,204,0,204,0,56,0,0,empty,mBC-0716-1
"H11,A5",15758,16349,11972,4377,8772,0,4013,4015,2813,1202,2.340266223,1987,5238,2046,967,1,966,1,220,0,0.014492754,empty,mBC-0716-1
"H11,A6",12245,12689,9365,3324,6876,0,3231,3234,2296,938,2.447761194,1519,2120,1051,532,0,532,0,160,0,0.046992481,empty,mBC-0716-1
"H11,A7",15167,15456,11670,3786,8351,0,3790,3804,2642,1162,2.273666093,1748,2021,1276,621,0,621,0,169,0,0.032206119,empty,mBC-0716-1
"H11,A8",10197,10410,7779,2631,5706,0,2672,2676,1867,809,2.307787392,1274,1484,992,489,0,489,0,153,0,0.006134969,empty,mBC-0716-1
"H11,A9",17711,18164,13585,4579,9459,0,4207,4217,2910,1307,2.226472839,1985,2771,1284,652,0,652,0,140,0,0.032208589,empty,mBC-0716-1
"H11,A10",14878,15164,11428,3736,8188,0,3661,3674,2523,1151,2.19200695,1716,221,137,87,0,87,0,30,0,0,empty,mBC-0716-1
"H11,A11",16806,17181,12855,4326,9298,0,4142,4150,2895,1255,2.306772908,1932,1424,783,383,0,383,0,99,0,0.075718016,empty,mBC-0716-1
"H11,A12",18955,19028,14630,4398,10117,0,4375,4384,3042,1342,2.266766021,2017,2015,1297,658,0,658,0,152,0,0.139817629,empty,mBC-0716-1
"H11,B1",615462,651594,462293,189301,349751,0,169751,170063,136822,33241,4.11606149,86097,75833,49015,23104,7,23097,1,2152,0,0.002467853,mm10,mBC-0716-1
"H11,B2",507701,503645,400180,103465,272609,0,103598,103806,78524,25282,3.105925164,46536,8042,5180,2582,0,2582,0,480,0,0.015491867,mm10,mBC-0716-1
"H11,B3",826411,887783,594044,293739,471063,0,252927,253304,213094,40210,5.299527481,134252,80790,52724,25153,7,25146,1,2344,0,0.00159071,mm10,mBC-0716-1
"H11,B4",3359844,3611601,2438870,1172731,1811553,4,1024184,1025795,816057,209738,3.89084,538906,178973,124681,59705,13,59692,3,4157,0,0.000368559,mm10,mBC-0716-1
"H11,B5",490835,319703,186095,133608,219284,3,136489,137108,99415,37693,2.637492373,82914,11787,7867,3715,1,3714,1,594,0,0.011308562,mm10,mBC-0716-1
"H11,B6",11242,11493,8534,2959,6122,0,2759,2769,1912,857,2.231038506,1285,1419,908,422,0,422,0,114,0,0.030805687,empty,mBC-0716-1
"H11,B7",15202,15765,11647,4118,8364,0,3745,3748,2607,1141,2.284837862,1808,2080,1462,694,0,694,0,159,0,0.034582133,empty,mBC-0716-1
"H11,B8",12536,12841,9628,3213,6937,0,3076,3091,2179,912,2.389254386,1471,1170,788,392,0,392,0,123,0,0,empty,mBC-0716-1
"H11,B9",14068,14234,10805,3429,7591,0,3407,3415,2407,1008,2.387896825,1586,899,420,219,0,219,0,67,0,0.150684932,empty,mBC-0716-1
"H11,B10",16251,15013,11353,3660,8349,0,3861,3875,2723,1152,2.363715278,1777,18503,5934,3176,2,3174,1,467,0,0.143352237,empty,mBC-0716-1
"H11,B11",16243,16607,12364,4243,8950,0,4110,4123,2881,1242,2.319645733,1983,113,80,51,0,51,0,26,0,0,empty,mBC-0716-1
"H11,B12",16457,17071,12621,4450,9314,0,4315,4325,2999,1326,2.261689291,2102,2782,1107,574,0,574,0,138,0,0.033101045,empty,mBC-0716-1
"H11,C1",21013,21351,16234,5117,11200,0,4814,4833,3384,1449,2.335403727,2191,579,370,194,0,194,0,73,0,0.072164948,empty,mBC-0716-1
"H11,C2",18516,19166,13730,5436,10433,0,4991,5002,3571,1431,2.495457722,2471,2761,1273,670,0,670,0,179,0,0.011940299,empty,mBC-0716-1
"H11,C3",18898,19563,14527,5036,10386,0,4709,4716,3268,1448,2.256906077,2269,385,231,120,0,120,0,46,0,0.041666667,empty,mBC-0716-1
"H11,C4",16928,17224,12928,4296,9244,0,4119,4123,2939,1184,2.482263514,1913,1105,700,391,0,391,0,115,0,0.020460358,empty,mBC-0716-1
"H11,C5",640035,675689,468521,207168,363350,0,185144,185424,150477,34947,4.305863164,96324,89780,59172,28121,9,28112,1,2467,0,0.001814172,mm10,mBC-0716-1
"H11,C6",692511,727324,503311,224013,400576,1,204660,205052,172216,32836,5.244731392,106383,85258,61052,28896,9,28887,2,2514,0,0.001488559,mm10,mBC-0716-1
"H11,C7",15076,15605,11300,4305,8536,0,4042,4049,2786,1263,2.205859066,2041,524,358,187,0,187,0,46,0,0.112299465,empty,mBC-0716-1
"H11,C8",759287,855019,510232,344787,459390,0,286116,286450,222884,63566,3.506339867,164948,63898,46378,22357,10,22347,2,2070,0,0.001118718,mm10,mBC-0716-1
"H11,C9",12099,12404,9196,3208,6625,0,3127,3136,2217,919,2.412404788,1450,567,351,151,0,151,0,59,0,0.026490066,empty,mBC-0716-1
"H11,C10",12676,13235,9739,3496,7121,0,3378,3385,2423,962,2.518711019,1606,1311,752,376,0,376,0,101,0,0.10106383,empty,mBC-0716-1
"H11,C11",11189,11676,8320,3356,6282,0,3011,3019,2110,909,2.321232123,1527,2192,798,390,0,390,0,104,0,0.058974359,empty,mBC-0716-1
"H11,C12",18509,18717,14137,4580,10111,0,4587,4603,3224,1379,2.337926033,2096,842,552,274,0,274,0,95,0,0.03649635,empty,mBC-0716-1
"H11,D1",11238,11579,8424,3155,6218,0,2865,2880,2081,799,2.604505632,1382,348,228,119,0,119,0,40,0,0,empty,mBC-0716-1
"H11,D2",19442,20064,15051,5013,10615,0,4610,4624,3227,1397,2.309949893,2161,1925,1208,582,0,582,0,149,0,0.068728522,empty,mBC-0716-1
"H11,D3",13037,13809,9814,3995,7408,0,3532,3535,2470,1065,2.319248826,1753,1014,584,298,0,298,0,85,0,0.043624161,empty,mBC-0716-1
"H11,D4",14477,15082,11009,4073,8013,0,3552,3559,2447,1112,2.200539568,1759,1156,759,361,0,361,0,102,0,0.052631579,empty,mBC-0716-1
"H11,D5",13505,14003,10271,3732,7542,0,3526,3531,2495,1036,2.408301158,1683,1457,1015,493,0,493,0,131,0,0.004056795,empty,mBC-0716-1
"H11,D6",11687,12107,8823,3284,6506,0,3076,3088,2119,969,2.186790506,1508,1595,957,493,0,493,0,131,0,0.054766734,empty,mBC-0716-1
"H11,D7",493178,551017,337887,213130,301037,0,184040,184264,134809,49455,2.725892225,104937,15101,9783,4619,1,4618,1,799,0,0.02078822,mm10,mBC-0716-1
"H11,D8",17248,17950,12894,5056,9576,0,4524,4540,3295,1245,2.646586345,2257,1085,742,361,0,361,0,105,0,0.074792244,empty,mBC-0716-1
"H11,D9",5179,5441,3810,1631,3027,0,1505,1508,1097,411,2.669099757,777,1019,580,292,0,292,0,94,0,0.075342466,empty,mBC-0716-1
"H11,D10",13383,14049,10110,3939,7436,0,3452,3457,2426,1031,2.353055286,1699,671,425,217,0,217,0,72,0,0.050691244,empty,mBC-0716-1
"H11,D11",12721,13211,9638,3573,7125,0,3291,3303,2317,986,2.34989858,1634,1699,951,526,0,526,0,136,0,0.058935361,empty,mBC-0716-1
"H11,D12",19113,19510,14500,5010,10383,1,4717,4737,3273,1464,2.235655738,2225,2022,1297,688,0,688,0,176,0,0.081395349,empty,mBC-0716-1
"H11,E1",900352,990534,621077,369457,527335,1,312624,313055,233548,79507,2.937452048,175920,53789,37733,18065,12,18053,4,1860,0,0.001772559,mm10,mBC-0716-1
"H11,E2",15681,16224,11766,4458,8744,0,4043,4063,2835,1228,2.308631922,2033,2507,1073,547,1,546,1,143,0,0.053113553,empty,mBC-0716-1
"H11,E3",11602,11835,8863,2972,6273,0,2847,2848,1930,918,2.102396514,1326,1204,708,358,1,357,1,113,0,0.033613445,empty,mBC-0716-1
"H11,E4",14322,14730,11017,3713,7660,0,3387,3401,2376,1025,2.31804878,1631,737,389,222,0,222,0,93,0,0.045045045,empty,mBC-0716-1
"H11,E5",1054985,1142198,761305,380893,599635,2,329114,329659,272263,57396,4.743588403,174233,75558,52583,25373,8,25365,1,2308,0,0.000946186,mm10,mBC-0716-1
"H11,E6",519670,551461,378514,172947,297460,0,154878,155129,117364,37765,3.107745267,80796,61911,44889,21561,7,21554,1,1894,0,0.001206273,mm10,mBC-0716-1
"H11,E7",12818,13115,9834,3281,7055,0,3131,3139,2190,949,2.307692308,1502,3405,2006,1064,0,1064,0,200,0,0.040413534,empty,mBC-0716-1
"H11,E8",16435,16720,12714,4006,8960,0,3846,3853,2735,1118,2.446332737,1815,2276,1610,751,0,751,0,203,0,0.083888149,empty,mBC-0716-1
"H11,E9",9026,9321,6886,2435,5073,0,2361,2364,1656,708,2.338983051,1132,1307,711,342,0,342,0,100,0,0.116959064,empty,mBC-0716-1
"H11,E10",12070,12225,9217,3008,6519,0,2964,2970,2076,894,2.322147651,1365,942,601,320,0,320,0,90,0,0.04375,empty,mBC-0716-1
"H11,E11",504486,556839,361025,195814,304074,0,168963,169221,129041,40180,3.211572922,92303,67980,47179,22318,7,22311,2,2179,0,0.000224105,mm10,mBC-0716-1
"H11,E12",14233,14903,10565,4338,8125,0,3824,3832,2657,1175,2.261276596,1939,4965,1597,753,0,753,0,179,0,0.035856574,empty,mBC-0716-1
"H11,F1",16941,17441,12921,4520,9140,0,4093,4095,2858,1237,2.310428456,1950,920,598,316,1,315,1,102,0,0.06984127,empty,mBC-0716-1
"H11,F2",21039,21582,16083,5499,11655,0,5335,5350,3773,1577,2.392517438,2483,2163,1352,706,0,706,0,187,0,0.058073654,empty,mBC-0716-1
"H11,F3",15525,15929,11388,4541,8717,0,4144,4151,2860,1291,2.215336948,2051,1149,802,435,0,435,0,142,0,0.087356322,empty,mBC-0716-1
"H11,F4",16635,16684,12479,4205,9330,0,4269,4274,3072,1202,2.555740433,2019,398,268,162,0,162,0,65,0,0.012345679,empty,mBC-0716-1
"H11,F5",22414,22913,16958,5955,12118,0,5522,5533,3925,1608,2.440920398,2692,1515,1039,533,0,533,0,145,0,0.013133208,empty,mBC-0716-1
"H11,F6",23177,23683,17671,6012,12616,0,5826,5844,4065,1779,2.284991568,2766,1991,1234,663,0,663,0,183,0,0.031674208,empty,mBC-0716-1
"H11,F7",18847,19173,14401,4772,10551,0,4690,4699,3241,1458,2.222908093,2281,1403,923,464,0,464,0,134,0,0.028017241,empty,mBC-0716-1
"H11,F8",23067,23459,17364,6095,12539,0,5667,5686,4017,1669,2.406830437,2707,1298,445,270,0,270,0,84,0,0.007407407,empty,mBC-0716-1
"H11,F9",14429,14638,11100,3538,7842,0,3572,3579,2571,1008,2.550595238,1631,1376,851,423,0,423,0,124,0,0.002364066,empty,mBC-0716-1
"H11,F10",998488,1094710,713331,381379,573305,1,319571,320068,251639,68429,3.677373628,172662,168650,116807,55589,21,55568,3,3630,0,0.000323927,mm10,mBC-0716-1
"H11,F11",562978,579921,430719,149202,312730,1,139249,139502,118123,21379,5.525188269,67327,81530,56740,27407,3,27404,1,2404,0,0.00036491,mm10,mBC-0716-1
"H11,F12",13058,13260,9920,3340,7105,0,3252,3254,2305,949,2.428872497,1575,106,90,48,0,48,0,14,0,0.083333333,empty,mBC-0716-1
"H11,G1",9339,9479,7140,2339,5159,0,2300,2304,1570,734,2.138964578,1101,1404,985,473,1,472,1,110,0,0.031779661,empty,mBC-0716-1
"H11,G2",19448,19957,14803,5154,10615,0,4753,4755,3338,1417,2.355681016,2332,363,259,135,0,135,0,46,0,0.007407407,empty,mBC-0716-1
"H11,G3",18120,18617,13920,4697,9995,0,4495,4502,3119,1383,2.255242227,2061,1521,884,498,0,498,0,158,0,0.016064257,empty,mBC-0716-1
"H11,G4",1944535,2087424,1409828,677596,1073423,2,585050,585923,478505,107418,4.454607235,308982,1708,1178,566,0,566,0,129,0,0,empty,mBC-0716-1
"H11,G5",12748,13067,9689,3378,6901,0,3097,3106,2222,884,2.513574661,1478,1045,565,315,0,315,0,101,0,0.022222222,empty,mBC-0716-1
"H11,G6",23174,23477,17952,5525,12438,0,5538,5556,3970,1586,2.503152585,2504,113,46,32,0,32,0,22,0,0,empty,mBC-0716-1
"H11,G7",19245,19625,14835,4790,10407,0,4594,4605,3287,1318,2.493930197,2104,3423,1802,905,1,904,1,213,0,0.032079646,empty,mBC-0716-1
"H11,G8",13823,14192,10420,3772,7581,0,3529,3537,2473,1064,2.32424812,1710,1196,782,386,0,386,0,108,0,0.03626943,empty,mBC-0716-1
"H11,G9",10026,10509,7569,2940,5692,0,2699,2705,1876,829,2.262967431,1356,880,538,262,2,260,1,111,0,0.038461538,empty,mBC-0716-1
"H11,G10",827535,926165,570147,356018,494641,2,301379,301809,223790,78019,2.86840385,169941,92493,62154,29581,12,29569,3,2456,0,0.001149853,mm10,mBC-0716-1
"H11,G11",11706,11718,8977,2741,6293,0,2792,2799,2021,778,2.597686375,1281,479,286,174,0,174,0,61,0,0.068965517,empty,mBC-0716-1
"H11,G12",11131,11556,8460,3096,6290,0,2971,2973,2070,903,2.292358804,1440,1895,850,423,1,422,1,125,0,0.009478673,empty,mBC-0716-1
"H11,H1",23206,23953,17766,6187,12841,0,5805,5814,4180,1634,2.558139535,2760,1289,678,366,0,366,0,97,0,0.057377049,empty,mBC-0716-1
"H11,H2",22101,22528,16797,5731,11946,0,5340,5362,3718,1644,2.261557178,2547,1777,1167,561,0,561,0,162,0,0.067736185,empty,mBC-0716-1
"H11,H3",19670,19766,14562,5204,10547,0,4898,4917,3380,1537,2.199089135,2395,17431,6323,3179,2,3177,2,447,0,0.229146994,empty,mBC-0716-1
"H11,H4",12726,13340,9680,3660,7228,0,3371,3379,2364,1015,2.329064039,1687,53,23,18,0,18,0,13,0,0,empty,mBC-0716-1
"H11,H5",18024,18776,13391,5385,9860,0,4661,4673,3298,1375,2.398545455,2366,25778,7552,3728,5,3723,1,579,0,0.062852538,empty,mBC-0716-1
"H11,H6",13946,14580,10380,4200,7996,0,3824,3831,2696,1135,2.375330396,1947,1377,814,404,1,403,1,137,0,0.012406948,empty,mBC-0716-1
"H11,H7",16612,16799,12560,4239,9095,0,4088,4103,2930,1173,2.497868713,1937,1777,1148,582,0,582,0,167,0,0.018900344,empty,mBC-0716-1
"H11,H8",445324,450616,340202,110414,243079,1,104513,104743,86278,18465,4.67251557,50055,69539,45355,21549,8,21541,2,2113,0,0.001856924,mm10,mBC-0716-1
"H11,H9",15168,15496,11496,4000,8360,0,3729,3748,2601,1147,2.267654752,1833,985,626,337,1,336,1,100,0,0.074404762,empty,mBC-0716-1
"H11,H10",15590,16123,11479,4644,8650,0,4172,4177,2996,1181,2.536833192,2097,915,648,326,0,326,0,104,0,0,empty,mBC-0716-1
"H11,H11",16327,16885,12349,4536,8977,0,4152,4169,2977,1192,2.497483221,1996,120,75,46,0,46,0,25,0,0,empty,mBC-0716-1
"H11,H12",5864,6063,4408,1655,3352,0,1571,1574,1150,424,2.712264151,753,434,264,156,0,156,0,60,0,0,empty,mBC-0716-1
"H12,A1",9906,10309,7471,2838,6305,0,2987,2991,2094,897,2.334448161,1480,1061,669,310,0,310,0,86,0,0.074193548,empty,mBC-0716-1
"H12,A2",14496,14320,10990,3330,8259,0,3550,3556,2471,1085,2.277419355,1594,655,428,246,0,246,0,89,0,0.056910569,empty,mBC-0716-1
"H12,A3",572041,623923,401110,222813,360346,0,210794,211060,158063,52997,2.982489575,115648,14050,9758,4704,1,4703,1,739,0,0.002338933,mm10,mBC-0716-1
"H12,A4",15677,15538,12148,3390,9279,0,3974,3981,2777,1204,2.306478405,1791,419,258,140,0,140,0,48,0,0.085714286,empty,mBC-0716-1
"H12,A5",12174,12585,9473,3112,7482,0,3360,3366,2349,1017,2.309734513,1538,997,639,336,0,336,0,101,0,0.104166667,empty,mBC-0716-1
"H12,A6",9311,9566,7092,2474,5634,1,2548,2549,1803,746,2.41689008,1129,1101,614,320,0,320,0,110,0,0.140625,empty,mBC-0716-1
"H12,A7",11298,11579,8603,2976,7074,0,3202,3208,2224,984,2.260162602,1556,1024,707,379,0,379,0,93,0,0.039577836,empty,mBC-0716-1
"H12,A8",8010,8321,6088,2233,5033,0,2274,2280,1554,726,2.140495868,1112,1014,613,324,0,324,0,102,0,0.046296296,empty,mBC-0716-1
"H12,A9",13533,13733,10549,3184,8328,0,3644,3649,2566,1083,2.369344414,1638,918,563,284,0,284,0,74,0,0.144366197,empty,mBC-0716-1
"H12,A10",11434,11714,8671,3043,6975,0,3122,3122,2144,978,2.192229039,1499,215,117,58,0,58,0,30,0,0,empty,mBC-0716-1
"H12,A11",13082,13250,10072,3178,7906,0,3433,3441,2352,1089,2.159779614,1633,1160,707,337,1,336,1,94,0,0.142857143,empty,mBC-0716-1
"H12,A12",16359,16726,12564,4162,9424,0,4195,4199,2930,1269,2.308904649,1987,6885,2690,1358,0,1358,0,263,0,0.055964654,empty,mBC-0716-1
"H12,B1",14462,14832,11091,3741,8743,0,3856,3859,2686,1173,2.289855072,1829,1068,674,347,0,347,0,115,0,0.040345821,empty,mBC-0716-1
"H12,B2",14797,15191,11331,3860,9123,0,4051,4058,2853,1205,2.367634855,1996,1447,440,224,0,224,0,60,0,0.004464286,empty,mBC-0716-1
"H12,B3",650565,696457,479578,216879,419063,0,222879,223235,147589,75646,1.951048304,117134,20067,13007,6315,2,6313,1,1017,0,0.00190084,mm10,mBC-0716-1
"H12,B4",12765,13156,9663,3493,7598,0,3378,3384,2371,1013,2.340572557,1580,3196,1231,601,0,601,0,141,0,0.091514143,empty,mBC-0716-1
"H12,B5",6581,3995,2986,1009,2976,0,1315,1325,928,397,2.337531486,645,1737,880,437,1,436,1,95,0,0.100917431,empty,mBC-0716-1
"H12,B6",588131,647613,417642,229971,385784,1,216906,217207,153686,63521,2.419451835,120419,66785,47038,22826,6,22820,1,2119,0,0.000701139,mm10,mBC-0716-1
"H12,B7",784684,835741,580570,255171,477993,0,241710,242063,209036,33027,6.329245769,124058,116454,78070,36743,14,36729,1,2720,0,0.001061831,mm10,mBC-0716-1
"H12,B8",9756,9946,7487,2459,5960,0,2718,2723,1920,803,2.391033624,1233,487,286,143,0,143,0,68,0,0.048951049,empty,mBC-0716-1
"H12,B9",11487,11613,8971,2642,6847,0,2968,2974,2046,928,2.204741379,1383,1498,616,308,0,308,0,82,0,0.032467532,empty,mBC-0716-1
"H12,B10",12924,12805,9483,3322,7667,0,3524,3535,2434,1101,2.21071753,1700,410,237,126,0,126,0,37,0,0,empty,mBC-0716-1
"H12,B11",11805,11897,9055,2842,7108,0,3199,3214,2231,983,2.269582909,1500,150,88,43,0,43,0,28,0,0,empty,mBC-0716-1
"H12,B12",413961,441730,299177,142553,268921,0,146734,146943,106386,40557,2.623123012,77666,10371,6834,3122,2,3120,1,615,0,0.017307692,mm10,mBC-0716-1
"H12,C1",17033,17144,13210,3934,10018,0,4277,4291,3041,1250,2.4328,1917,584,409,196,0,196,0,74,0,0.066326531,empty,mBC-0716-1
"H12,C2",13109,13328,9865,3463,8066,0,3697,3703,2594,1109,2.339044184,1801,1318,895,471,0,471,0,124,0,0.055201699,empty,mBC-0716-1
"H12,C3",14853,15318,11314,4004,9050,0,4018,4028,2773,1255,2.209561753,1981,1088,511,254,0,254,0,62,0,0.047244094,empty,mBC-0716-1
"H12,C4",12544,12514,9439,3075,7478,1,3290,3295,2286,1009,2.265609514,1564,976,615,322,0,322,0,99,0,0.068322981,empty,mBC-0716-1
"H12,C5",13073,13495,9989,3506,8000,0,3555,3564,2553,1011,2.525222552,1690,1132,806,390,0,390,0,91,0,0.071794872,empty,mBC-0716-1
"H12,C6",13227,13846,9877,3969,8627,0,4099,4114,2881,1233,2.336577453,2088,3823,1347,736,0,736,0,161,0,0.048913043,empty,mBC-0716-1
"H12,C7",12706,13459,9517,3942,7684,0,3684,3686,2607,1079,2.416126043,1850,1719,589,292,0,292,0,72,0,0.130136986,empty,mBC-0716-1
"H12,C8",11169,11524,8391,3133,6811,0,3126,3126,2133,993,2.148036254,1485,1150,699,339,0,339,0,114,0,0,empty,mBC-0716-1
"H12,C9",9144,9233,6934,2299,5545,0,2499,2507,1715,792,2.16540404,1116,5426,1661,822,1,821,1,166,0,0.063337393,empty,mBC-0716-1
"H12,C10",9703,9764,7465,2299,5922,0,2604,2612,1839,773,2.379042691,1200,836,459,203,0,203,0,67,0,0.088669951,empty,mBC-0716-1
"H12,C11",553028,619362,391470,227892,370568,5,211862,212132,170131,42001,4.050641651,118169,78865,46366,21858,8,21850,2,2157,0,0.005446224,mm10,mBC-0716-1
"H12,C12",14671,15007,11164,3843,8832,0,3968,3978,2785,1193,2.334450964,1900,1078,603,310,0,310,0,84,0,0.016129032,empty,mBC-0716-1
"H12,D1",7997,8046,5979,2067,4845,0,2244,2251,1554,697,2.229555237,1078,421,272,140,0,140,0,47,0,0,empty,mBC-0716-1
"H12,D2",15485,15490,11987,3503,9231,0,4020,4029,2803,1226,2.2862969,1750,17570,5566,2877,1,2876,1,517,0,0.029554937,empty,mBC-0716-1
"H12,D3",9879,10113,7511,2602,6096,0,2795,2805,1931,874,2.209382151,1354,10367,3344,1650,3,1647,1,287,0,0.020643594,empty,mBC-0716-1
"H12,D4",10220,10615,7826,2789,6249,0,2859,2864,2050,814,2.518427518,1372,868,593,287,0,287,0,92,0,0.073170732,empty,mBC-0716-1
"H12,D5",9713,9969,7414,2555,6082,0,2772,2776,1936,840,2.304761905,1346,849,506,262,0,262,0,96,0,0.011450382,empty,mBC-0716-1
"H12,D6",364890,399916,262575,137341,241401,0,132807,132965,107323,25642,4.185437953,71913,47143,32171,15490,7,15483,1,1709,0,0.001743848,mm10,mBC-0716-1
"H12,D7",9205,9740,6957,2783,5900,1,2739,2756,1902,854,2.227166276,1400,1215,748,398,0,398,0,115,0,0.030150754,empty,mBC-0716-1
"H12,D8",415313,441557,304072,137485,272021,0,140799,140989,101896,39093,2.606502443,74738,9190,6593,3228,2,3226,1,547,0,0.002789833,mm10,mBC-0716-1
"H12,D9",3343,3260,2526,734,1972,0,889,893,603,290,2.079310345,396,1067,629,309,0,309,0,86,0,0.106796117,empty,mBC-0716-1
"H12,D10",803408,879260,586151,293109,529011,0,281926,282307,215789,66518,3.244069274,152129,90784,63724,30709,12,30697,1,2611,0,0.000586377,mm10,mBC-0716-1
"H12,D11",9550,9614,7337,2277,5814,0,2604,2615,1858,757,2.454425363,1219,1233,744,384,1,383,1,109,0,0.08616188,empty,mBC-0716-1
"H12,D12",581417,629036,405296,223740,370560,0,218039,218311,170814,47497,3.596311346,119242,10747,7590,3435,1,3434,1,713,0,0.025043681,mm10,mBC-0716-1
"H12,E1",19125,19369,14720,4649,10542,0,4598,4612,3162,1450,2.180689655,2125,1181,736,426,1,425,1,121,0,0.129411765,empty,mBC-0716-1
"H12,E2",11837,12094,9005,3089,7245,0,3288,3295,2282,1013,2.252714709,1551,1129,694,370,0,370,0,128,0,0.037837838,empty,mBC-0716-1
"H12,E3",14057,14357,10839,3518,8494,0,3677,3678,2698,980,2.753061224,1740,3759,2058,1014,1,1013,1,242,0,0.019743337,empty,mBC-0716-1
"H12,E4",12054,12019,9158,2861,7069,0,3129,3139,2230,909,2.453245325,1484,7153,2745,1392,0,1392,0,241,0,0.218390805,empty,mBC-0716-1
"H12,E5",14983,15182,11656,3526,9068,0,3956,3963,2752,1211,2.272502064,1789,981,606,310,0,310,0,91,0,0.093548387,empty,mBC-0716-1
"H12,E6",10142,10066,7832,2234,5892,0,2573,2579,1790,789,2.26869455,1205,1280,854,419,0,419,0,108,0,0.047732697,empty,mBC-0716-1
"H12,E7",10031,10102,7775,2327,6020,0,2662,2663,1838,825,2.227878788,1193,894,636,332,0,332,0,102,0,0.03313253,empty,mBC-0716-1
"H12,E8",12908,13027,9959,3068,7801,0,3362,3377,2281,1096,2.08120438,1523,4021,1863,919,1,918,1,203,0,0.122004357,empty,mBC-0716-1
"H12,E9",6277,6443,4777,1666,3804,0,1727,1727,1201,526,2.283269962,821,887,594,318,0,318,0,78,0,0.066037736,empty,mBC-0716-1
"H12,E10",10001,10322,7563,2759,5879,0,2660,2667,1830,837,2.186379928,1268,1130,725,377,0,377,0,99,0,0.042440318,empty,mBC-0716-1
"H12,E11",7937,8050,6069,1981,4650,0,2092,2095,1475,620,2.379032258,1030,903,591,294,0,294,0,95,0,0.030612245,empty,mBC-0716-1
"H12,E12",1516044,1684201,1064374,619827,1002611,0,592806,593578,458730,134848,3.401830209,332039,118185,82614,39177,18,39159,1,3177,0,0.000919329,mm10,mBC-0716-1
"H12,F1",13323,13590,10077,3513,8048,0,3565,3576,2475,1101,2.247956403,1679,1052,677,356,0,356,0,104,0,0.036516854,empty,mBC-0716-1
"H12,F2",16246,16600,12379,4221,9929,0,4411,4419,3125,1294,2.414992272,2102,1633,1066,509,0,509,0,154,0,0.025540275,empty,mBC-0716-1
"H12,F3",12738,13226,9576,3650,7575,0,3598,3608,2483,1125,2.207111111,1746,1225,718,374,0,374,0,110,0,0.077540107,empty,mBC-0716-1
"H12,F4",12017,12217,9093,3124,7429,0,3377,3382,2354,1028,2.289883268,1624,436,286,146,0,146,0,48,0,0,empty,mBC-0716-1
"H12,F5",17401,17707,13323,4384,10511,0,4795,4805,3379,1426,2.369565217,2206,1275,778,416,0,416,0,132,0,0.069711538,empty,mBC-0716-1
"H12,F6",559619,599762,405251,194511,358538,0,188889,189129,154229,34900,4.419169054,100688,99128,67010,32292,13,32279,1,2603,0,0.001548995,mm10,mBC-0716-1
"H12,F7",513520,572516,363792,208724,349820,0,198041,198292,162272,36020,4.505052748,110416,53391,37875,17895,4,17891,1,1842,0,0.000950198,mm10,mBC-0716-1
"H12,F8",1134696,1213390,842302,371088,708309,3,361556,362150,279495,82655,3.381465126,187706,16564,11594,5520,0,5520,0,856,0,0.000362319,mm10,mBC-0716-1
"H12,F9",690691,753841,487859,265982,443720,0,255934,256298,186041,70257,2.648006604,140111,88304,58806,27962,13,27949,3,2293,0,0.002289885,mm10,mBC-0716-1
"H12,F10",15353,15520,11980,3540,9226,0,4012,4022,2797,1225,2.283265306,1804,1157,766,400,0,400,0,112,0,0.0925,empty,mBC-0716-1
"H12,F11",8192,8333,6312,2021,4970,0,2116,2119,1505,614,2.451140065,1018,861,573,314,0,314,0,87,0,0.073248408,empty,mBC-0716-1
"H12,F12",10628,10660,8041,2619,6239,0,2839,2839,1991,848,2.347877358,1338,48,25,15,0,15,0,9,0,0,empty,mBC-0716-1
"H12,G1",7460,7583,5811,1772,4550,0,1996,2005,1374,631,2.177496038,930,1196,773,430,0,430,0,115,0,0.009302326,empty,mBC-0716-1
"H12,G2",15141,15481,11587,3894,9160,0,4093,4101,2826,1275,2.216470588,1930,364,221,110,0,110,0,34,0,0.145454545,empty,mBC-0716-1
"H12,G3",14745,14883,11351,3532,8722,0,3827,3836,2698,1138,2.370826011,1786,1873,1258,614,0,614,0,140,0,0.063517915,empty,mBC-0716-1
"H12,G4",695459,741283,505955,235328,432742,1,227668,228002,190620,37382,5.099245626,119826,572,326,163,0,163,0,43,0,0,empty,mBC-0716-1
"H12,G5",453399,479279,337469,141810,288956,1,146788,147030,112304,34726,3.23400334,74769,25957,15298,7576,4,7572,1,1102,0,0.013866878,mm10,mBC-0716-1
"H12,G6",732004,799039,515801,283238,450233,1,255476,255807,196310,59497,3.299494092,141003,4570,3142,1555,1,1554,1,322,0,0,mm10,mBC-0716-1
"H12,G7",14954,14919,11456,3463,8959,0,3900,3909,2726,1183,2.304311074,1744,7059,2648,1263,0,1263,0,252,0,0.044338876,empty,mBC-0716-1
"H12,G8",10902,11486,8334,3152,6721,0,3166,3170,2204,966,2.281573499,1576,936,509,291,0,291,0,101,0,0.051546392,empty,mBC-0716-1
"H12,G9",483497,519112,356326,162786,307632,0,158418,158665,135840,22825,5.951369113,82494,73264,52204,24704,13,24691,1,2301,0,0.001458021,mm10,mBC-0716-1
"H12,G10",574013,617330,423487,193843,367419,0,186471,186758,157306,29452,5.341097379,97039,113659,80890,38481,12,38469,1,3055,0,0.000857834,mm10,mBC-0716-1
"H12,G11",9389,9427,7257,2170,5578,0,2464,2481,1761,720,2.445833333,1139,905,528,275,0,275,0,80,0,0.014545455,empty,mBC-0716-1
"H12,G12",8595,8814,6526,2288,5322,0,2421,2421,1679,742,2.262803235,1174,969,592,249,0,249,0,74,0,0.02811245,empty,mBC-0716-1
"H12,H1",15253,15559,11689,3870,9355,0,4238,4242,2946,1296,2.273148148,1996,763,491,257,0,257,0,92,0,0.019455253,empty,mBC-0716-1
"H12,H2",17943,18367,13679,4688,10813,0,4855,4868,3392,1476,2.298102981,2328,5585,2411,1251,1,1250,1,217,0,0.1416,empty,mBC-0716-1
"H12,H3",15885,16792,12099,4693,9893,0,4610,4618,3279,1339,2.44884242,2285,1693,769,397,0,397,0,131,0,0.055415617,empty,mBC-0716-1
"H12,H4",11007,11239,8310,2929,6369,0,2890,2894,2044,850,2.404705882,1385,62,36,21,0,21,0,13,0,0.047619048,empty,mBC-0716-1
"H12,H5",13450,13704,10399,3305,8083,0,3641,3645,2535,1110,2.283783784,1700,2478,1116,598,0,598,0,163,0,0.073578595,empty,mBC-0716-1
"H12,H6",9928,10285,7415,2870,6235,0,2931,2933,2079,854,2.43442623,1438,1301,811,409,0,409,0,133,0,0,empty,mBC-0716-1
"H12,H7",12170,12696,9171,3525,7663,0,3552,3562,2461,1101,2.23524069,1751,1191,674,344,0,344,0,118,0,0.00872093,empty,mBC-0716-1
"H12,H8",46018,53436,30946,22490,32001,0,20201,20237,9168,11069,0.828259102,11996,5649,2281,1134,6,1128,1,237,0,0.085992908,empty,mBC-0716-1
"H12,H9",10680,10718,8153,2565,6516,0,2882,2888,2029,859,2.362048894,1290,1120,764,337,0,337,0,98,0,0.035608309,empty,mBC-0716-1
"H12,H10",10718,10967,8134,2833,6491,0,2894,2906,2060,846,2.43498818,1384,1320,783,389,0,389,0,109,0,0.038560411,empty,mBC-0716-1
"H12,H11",12349,12749,9450,3299,7588,0,3396,3411,2355,1056,2.230113636,1678,90,45,31,0,31,0,22,0,0.032258065,empty,mBC-0716-1
"H12,H12",4348,4638,3299,1339,2718,0,1205,1213,891,322,2.767080745,629,447,272,123,0,123,0,44,0,0.056910569,empty,mBC-0716-1
"A1,A1",13110,13594,9842,3752,6650,0,3103,3109,2155,954,2.258909853,1487,995,590,366,0,366,0,151,0,0.024590164,empty,mBC-0716-2
"A1,A2",1013769,1141101,661143,479958,547017,14,350279,350779,293285,57494,5.101140989,203050,79312,51142,28492,16,28476,2,3048,0,0.001861216,mm10,mBC-0716-2
"A1,A3",15620,16100,11892,4208,7975,0,3697,3704,2641,1063,2.484477893,1726,951,568,344,0,344,0,134,0,0.046511628,empty,mBC-0716-2
"A1,A4",1837306,2036953,1303698,733255,963490,9,566211,567010,427256,139754,3.057200509,311503,42515,24843,13839,6,13833,2,2065,0,0.0007952,mm10,mBC-0716-2
"A1,A5",16395,16850,12383,4467,8269,11,3791,3814,2731,1083,2.521698984,1831,1606,918,576,0,576,0,222,0,0.059027778,empty,mBC-0716-2
"A1,A6",16017,16844,12349,4495,8309,9,3927,3943,2903,1040,2.791346154,1932,2448,1419,814,1,813,1,271,0,0.033210332,empty,mBC-0716-2
"A1,A7",15216,16059,11641,4418,7767,0,3610,3615,2515,1100,2.286363636,1740,12774,4452,2761,1,2760,1,700,0,0.159782609,empty,mBC-0716-2
"A1,A8",350916,346431,271465,74966,172081,2,70080,70202,55559,14643,3.794236154,32184,39176,14744,8631,5,8626,2,1831,0,0.092626942,mm10,mBC-0716-2
"A1,A9",17595,17815,13623,4192,8686,0,3754,3761,2726,1035,2.633816425,1701,1296,798,474,0,474,0,191,0,0.073839662,empty,mBC-0716-2
"A1,A10",14476,15385,10958,4427,7409,1,3451,3462,2387,1075,2.220465116,1693,405,238,155,1,154,1,79,0,0.071428571,empty,mBC-0716-2
"A1,A11",16731,17041,12680,4361,8370,0,3799,3804,2660,1144,2.325174825,1792,3127,1158,686,1,685,1,230,0,0.052554745,empty,mBC-0716-2
"A1,A12",19424,19705,14799,4906,9551,0,4168,4183,2887,1296,2.227623457,2016,2456,1330,771,0,771,0,249,0,0.081712062,empty,mBC-0716-2
"A1,B1",18521,18800,14104,4696,9079,14,4006,4030,2812,1218,2.308702791,1913,829,497,297,0,297,0,129,0,0.03030303,empty,mBC-0716-2
"A1,B2",1141892,1313857,762215,551642,634035,16,403665,404156,322432,81724,3.945377123,236173,45165,27419,15419,7,15412,1,2098,0,0.000908383,mm10,mBC-0716-2
"A1,B3",17335,17976,13446,4530,8823,1,4001,4016,2863,1153,2.483087598,1885,1059,565,365,0,365,0,156,0,0.04109589,empty,mBC-0716-2
"A1,B4",15668,16178,11948,4230,8004,0,3750,3755,2598,1157,2.245462403,1833,941,508,286,0,286,0,120,0,0.129370629,empty,mBC-0716-2
"A1,B5",8236,4681,3298,1383,3039,0,1398,1419,944,475,1.987368421,805,894,422,275,0,275,0,114,0,0.141818182,empty,mBC-0716-2
"A1,B6",11656,12292,8822,3470,6025,0,2883,2889,2015,874,2.305491991,1410,964,557,334,1,333,1,157,0,0.078078078,empty,mBC-0716-2
"A1,B7",16347,16927,12098,4829,8037,0,3782,3789,2695,1094,2.463436929,1853,10804,3832,2306,3,2303,1,619,0,0.174554928,empty,mBC-0716-2
"A1,B8",12393,12735,9406,3329,6294,15,2853,2882,1938,944,2.052966102,1429,1225,765,481,0,481,0,204,0,0.029106029,empty,mBC-0716-2
"A1,B9",822151,928957,567819,361138,450238,6,273107,273495,209166,64329,3.251503987,155420,16401,10555,5822,1,5821,1,1065,0,0.001717918,mm10,mBC-0716-2
"A1,B10",15071,15188,11299,3889,7588,1,3446,3465,2335,1130,2.066371681,1612,421,243,138,0,138,0,69,0,0.007246377,empty,mBC-0716-2
"A1,B11",674048,734712,491669,243043,356492,0,190392,190635,153568,37067,4.142984326,102461,2604,1442,858,1,857,1,277,0,0.008168028,empty,mBC-0716-2
"A1,B12",17326,18135,13075,5060,8861,1,4116,4143,2897,1246,2.325040128,2036,2011,996,576,0,576,0,215,0,0.053819444,empty,mBC-0716-2
"A1,C1",20881,21112,15939,5173,10232,3,4444,4461,3138,1323,2.371882086,2092,1364,580,337,0,337,0,134,0,0.035608309,empty,mBC-0716-2
"A1,C2",17285,17914,13208,4706,8658,0,4041,4048,2843,1205,2.3593361,1908,1321,842,450,0,450,0,166,0,0.077777778,empty,mBC-0716-2
"A1,C3",18658,19429,14285,5144,9398,49,4323,4381,3046,1335,2.28164794,2103,618,363,213,0,213,0,102,0,0.004694836,empty,mBC-0716-2
"A1,C4",16021,16420,12166,4254,7962,1,3543,3554,2476,1078,2.296846011,1672,2666,1089,675,0,675,0,226,0,0.14962963,empty,mBC-0716-2
"A1,C5",14954,15548,11340,4208,7719,0,3655,3668,2596,1072,2.421641791,1824,2295,994,588,0,588,0,209,0,0.051020408,empty,mBC-0716-2
"A1,C6",15475,16043,11537,4506,8150,0,3737,3750,2602,1148,2.266550523,1866,2449,1023,622,1,621,1,228,0,0.072463768,empty,mBC-0716-2
"A1,C7",15144,15997,11315,4682,7747,0,3708,3712,2609,1103,2.36536718,1854,358,210,126,0,126,0,71,0,0.031746032,empty,mBC-0716-2
"A1,C8",13602,13878,10333,3545,6896,19,3025,3052,2130,922,2.310195228,1439,1215,692,424,0,424,0,169,0,0.047169811,empty,mBC-0716-2
"A1,C9",11710,12124,8695,3429,6043,23,2868,2892,2053,839,2.446960667,1491,1711,692,396,1,395,1,160,0,0.017721519,empty,mBC-0716-2
"A1,C10",13344,13686,10061,3625,6675,0,3096,3103,2228,875,2.546285714,1443,7529,2680,1571,2,1569,2,418,0,0.202039516,empty,mBC-0716-2
"A1,C11",11490,12128,8557,3571,5814,12,2800,2818,1938,880,2.202272727,1414,896,538,331,0,331,0,133,0,0.027190332,empty,mBC-0716-2
"A1,C12",18764,19200,14226,4974,9264,15,4238,4258,2972,1286,2.311041991,2049,1167,582,353,0,353,0,141,0,0.090651558,empty,mBC-0716-2
"A1,D1",10721,10975,8002,2973,5592,0,2692,2703,1948,755,2.58013245,1303,514,283,170,0,170,0,83,0,0.041176471,empty,mBC-0716-2
"A1,D2",19721,20118,15104,5014,9913,9,4455,4470,3178,1292,2.459752322,2078,2427,1385,842,0,842,0,298,0,0.034441805,empty,mBC-0716-2
"A1,D3",12394,12749,9377,3372,6434,0,3048,3052,2106,946,2.226215645,1429,1030,626,393,0,393,0,174,0,0.048346056,empty,mBC-0716-2
"A1,D4",13573,14305,10375,3930,6935,10,3249,3271,2289,982,2.33095723,1547,1218,757,455,0,455,0,216,0,0.054945055,empty,mBC-0716-2
"A1,D5",12726,13399,9695,3704,6591,0,3034,3045,2124,921,2.306188925,1492,1107,647,386,2,384,1,154,0,0.041666667,empty,mBC-0716-2
"A1,D6",11886,12246,8982,3264,6043,23,2855,2880,2031,849,2.392226148,1417,2388,1023,594,0,594,0,216,0,0.106060606,empty,mBC-0716-2
"A1,D7",670759,714750,483779,230971,347798,18,179657,179992,137636,42356,3.249504202,96875,143918,95148,52485,14,52471,1,3962,0,0.001124431,mm10,mBC-0716-2
"A1,D8",661277,717814,488236,229578,352193,4,180258,180573,146426,34147,4.288107301,95895,66216,41999,23353,8,23345,1,2565,0,0.000985222,mm10,mBC-0716-2
"A1,D9",4617,4730,3405,1325,2457,10,1173,1187,832,355,2.343661972,600,1615,832,509,0,509,0,229,0,0.019646365,empty,mBC-0716-2
"A1,D10",12607,13264,9582,3682,6382,0,2981,2990,2050,940,2.180851064,1436,815,452,266,0,266,0,96,0,0.041353383,empty,mBC-0716-2
"A1,D11",12316,12728,9362,3366,6251,0,2913,2918,2056,862,2.385150812,1371,1433,858,537,2,535,1,203,0,0.037383178,empty,mBC-0716-2
"A1,D12",19353,19736,14703,5033,9352,0,4281,4288,3041,1247,2.438652767,1967,1955,1192,672,0,672,0,253,0,0.0625,empty,mBC-0716-2
"A1,E1",20163,20330,15387,4943,9858,0,4273,4281,3059,1222,2.503273322,1920,1444,781,472,0,472,0,209,0,0.082627119,empty,mBC-0716-2
"A1,E2",14829,15119,11187,3932,7455,0,3320,3330,2354,976,2.411885246,1544,6016,2053,1266,0,1266,0,372,0,0.079778831,empty,mBC-0716-2
"A1,E3",11629,11965,9039,2926,5835,0,2616,2617,1762,855,2.060818713,1194,1459,875,523,1,522,1,190,0,0.03256705,empty,mBC-0716-2
"A1,E4",14103,14728,10836,3892,7180,0,3322,3333,2286,1047,2.183381089,1609,1078,631,367,1,366,1,159,0,0.027322404,empty,mBC-0716-2
"A1,E5",21113,21732,16151,5581,10507,0,4711,4734,3244,1490,2.177181208,2253,1540,979,570,1,569,1,223,0,0.029876977,empty,mBC-0716-2
"A1,E6",567987,601868,418808,183060,293245,15,147857,148094,124867,23227,5.375941792,76491,109178,70712,39646,11,39635,1,3485,0,0.001337202,mm10,mBC-0716-2
"A1,E7",13225,13514,9957,3557,6570,1,3015,3022,2148,874,2.457665904,1420,1192,692,387,0,387,0,165,0,0.015503876,empty,mBC-0716-2
"A1,E8",16472,16825,12734,4091,8107,28,3588,3627,2587,1040,2.4875,1676,1498,804,482,1,481,1,208,0,0.043659044,empty,mBC-0716-2
"A1,E9",8949,8794,6535,2259,4245,4,1932,1945,1404,541,2.595194085,909,23974,7623,4571,4,4567,2,982,0,0.187869499,empty,mBC-0716-2
"A1,E10",12531,13243,9423,3820,6364,0,2933,2951,2034,917,2.218102508,1448,10815,3109,1906,5,1901,1,535,0,0.072593372,empty,mBC-0716-2
"A1,E11",8564,8807,6467,2340,4415,7,2052,2060,1431,629,2.275039746,984,5124,1609,975,0,975,0,331,0,0.082051282,empty,mBC-0716-2
"A1,E12",442826,468223,323061,145162,235408,0,122059,122248,98221,24027,4.087942731,63949,25368,13223,7626,9,7617,2,1486,0,0.00918997,mm10,mBC-0716-2
"A1,F1",16891,17406,12909,4497,8563,0,3963,3967,2839,1128,2.516843972,1889,2881,1183,705,1,704,1,281,0,0.059659091,empty,mBC-0716-2
"A1,F2",21227,21791,16055,5736,10662,21,4915,4954,3498,1456,2.402472527,2406,2275,1387,794,1,793,1,315,0,0.061790668,empty,mBC-0716-2
"A1,F3",15140,15911,11470,4441,7761,1,3710,3713,2618,1095,2.39086758,1821,1501,924,592,0,592,0,254,0,0.018581081,empty,mBC-0716-2
"A1,F4",14441,14759,11052,3707,7398,11,3323,3341,2345,996,2.354417671,1603,376,174,117,0,117,0,65,0,0.008547009,empty,mBC-0716-2
"A1,F5",22785,23017,17057,5960,11304,0,5208,5223,3689,1534,2.40482399,2504,7566,3009,1739,1,1738,1,487,0,0.059263521,empty,mBC-0716-2
"A1,F6",22042,22586,16598,5988,10904,0,5152,5155,3680,1475,2.494915254,2507,1893,1044,635,0,635,0,252,0,0.042519685,empty,mBC-0716-2
"A1,F7",19000,19505,14361,5144,9652,0,4450,4456,3179,1277,2.489428348,2147,836,510,288,0,288,0,120,0,0.072916667,empty,mBC-0716-2
"A1,F8",22331,23099,16857,6242,11248,31,5319,5355,3840,1515,2.534653465,2582,518,229,157,0,157,0,88,0,0.012738854,empty,mBC-0716-2
"A1,F9",13864,14219,10581,3638,6892,0,3103,3108,2179,929,2.345532831,1471,1221,719,467,0,467,0,182,0,0.055674518,empty,mBC-0716-2
"A1,F10",19455,19956,15079,4877,9736,24,4283,4315,3089,1226,2.519575856,1983,1109,676,389,0,389,0,169,0,0.061696658,empty,mBC-0716-2
"A1,F11",10478,10771,8020,2751,5400,8,2409,2423,1606,817,1.965728274,1127,797,472,295,0,295,0,149,0,0.061016949,empty,mBC-0716-2
"A1,F12",13659,14118,10378,3740,6805,18,3159,3180,2221,959,2.315954119,1491,105,72,45,0,45,0,27,0,0,empty,mBC-0716-2
"A1,G1",9901,10156,7465,2691,4925,7,2183,2193,1524,669,2.278026906,1030,3925,1725,977,2,975,1,304,0,0.099487179,empty,mBC-0716-2
"A1,G2",1635471,1724764,1192885,531879,825445,20,437827,438538,367404,71134,5.16495628,227652,26571,17090,9475,1,9474,1,1538,0,0.001266624,mm10,mBC-0716-2
"A1,G3",661959,689000,500387,188613,335395,19,155499,155820,129984,25836,5.031119368,77556,98622,63096,34814,12,34802,1,3328,0,0.00252859,mm10,mBC-0716-2
"A1,G4",26698,27012,20498,6514,13065,12,5666,5685,4006,1679,2.385944014,2566,111,65,47,0,47,0,37,0,0,empty,mBC-0716-2
"A1,G5",13012,13618,9866,3752,6483,0,2993,2998,2136,862,2.477958237,1437,979,519,333,0,333,0,174,0,0.033033033,empty,mBC-0716-2
"A1,G6",676164,684820,503896,180924,337015,10,161621,161930,133366,28564,4.669023946,78977,756,380,217,2,215,1,92,0,0,empty,mBC-0716-2
"A1,G7",19102,19837,14568,5269,9715,0,4406,4415,3103,1312,2.365091463,2192,1708,1031,597,0,597,0,207,0,0.055276382,empty,mBC-0716-2
"A1,G8",13952,14775,10528,4247,7161,8,3405,3418,2335,1083,2.156048015,1728,1318,760,468,0,468,0,200,0,0.066239316,empty,mBC-0716-2
"A1,G9",9975,10597,7570,3027,5158,0,2458,2464,1749,715,2.446153846,1204,2232,1137,697,1,696,1,308,0,0.045977011,empty,mBC-0716-2
"A1,G10",12401,12830,9509,3321,6415,1,2887,2895,1975,920,2.14673913,1414,1382,832,495,0,495,0,220,0,0.012121212,empty,mBC-0716-2
"A1,G11",11391,11787,8732,3055,5793,1,2677,2686,1846,840,2.197619048,1270,602,358,207,0,207,0,77,0,0.111111111,empty,mBC-0716-2
"A1,G12",10604,11024,7914,3110,5484,0,2606,2612,1869,743,2.515477793,1319,953,617,379,0,379,0,149,0,0.055408971,empty,mBC-0716-2
"A1,H1",19108,19906,14535,5371,9651,8,4416,4439,3167,1272,2.489779874,2123,832,517,301,0,301,0,118,0,0.013289037,empty,mBC-0716-2
"A1,H2",22611,23057,17268,5789,11174,26,5086,5122,3651,1471,2.481985044,2361,2789,1286,746,0,746,0,273,0,0.054959786,empty,mBC-0716-2
"A1,H3",18991,19426,14239,5187,9622,1,4519,4522,3228,1294,2.494590417,2210,8167,2285,1345,1,1344,1,431,0,0.057291667,empty,mBC-0716-2
"A1,H4",13109,13620,9967,3653,6740,0,3192,3200,2209,991,2.229061554,1550,129,90,71,1,70,1,51,0,0.014285714,empty,mBC-0716-2
"A1,H5",17294,18217,13134,5083,8766,40,4068,4129,2918,1211,2.40957886,2046,4334,1582,945,0,945,0,309,0,0.027513228,empty,mBC-0716-2
"A1,H6",13114,13416,9757,3659,6733,0,3160,3172,2307,865,2.667052023,1532,2671,1322,785,0,785,0,234,0,0.141401274,empty,mBC-0716-2
"A1,H7",15449,15270,11800,3470,7585,29,3356,3394,2386,1008,2.367063492,1533,1659,910,538,0,538,0,200,0,0.037174721,empty,mBC-0716-2
"A1,H8",12407,12954,9403,3551,6266,1,2930,2935,2059,876,2.350456621,1420,1620,914,530,0,530,0,215,0,0.018867925,empty,mBC-0716-2
"A1,H9",14406,15110,10974,4136,7377,0,3330,3334,2404,930,2.584946237,1680,1443,843,491,0,491,0,208,0,0.085539715,empty,mBC-0716-2
"A1,H10",774284,775929,584690,191239,383655,46,171111,171473,128646,42827,3.00385271,83198,47173,21076,11954,12,11942,1,2306,0,0.027047396,mm10,mBC-0716-2
"A1,H11",15627,16237,11818,4419,7955,6,3702,3721,2568,1153,2.227233304,1854,301,129,81,0,81,0,48,0,0.098765432,empty,mBC-0716-2
"A1,H12",5614,5791,4174,1617,2850,0,1336,1340,945,395,2.392405063,661,648,418,227,1,226,1,87,0,0.053097345,empty,mBC-0716-2
"A2,A1",12209,12898,9324,3574,6434,0,2933,2939,2040,899,2.269187987,1469,1938,861,512,0,512,0,195,0,0.037109375,empty,mBC-0716-2
"A2,A2",16223,16334,12347,3987,8021,11,3506,3520,2491,1029,2.42079689,1642,1383,806,501,2,499,1,187,0,0.090180361,empty,mBC-0716-2
"A2,A3",812582,902239,555180,347059,440996,0,273060,273397,215832,57565,3.749361591,153172,13424,8530,4962,2,4960,1,1026,0,0.003830645,mm10,mBC-0716-2
"A2,A4",19109,19713,14644,5069,9457,0,4221,4239,2990,1249,2.393915132,2042,769,365,257,0,257,0,123,0,0.027237354,empty,mBC-0716-2
"A2,A5",15842,16599,12132,4467,8163,41,3761,3814,2624,1190,2.205042017,1863,3611,1565,973,1,972,1,328,0,0.075102881,empty,mBC-0716-2
"A2,A6",11187,11598,8625,2973,5833,0,2813,2825,1983,842,2.355106888,1328,1463,900,532,0,532,0,237,0,0.056390977,empty,mBC-0716-2
"A2,A7",14302,15003,10861,4142,7348,0,3373,3381,2331,1050,2.22,1651,2716,1208,700,0,700,0,225,0,0.144285714,empty,mBC-0716-2
"A2,A8",9887,10207,7407,2800,4905,0,2290,2292,1621,671,2.415797317,1075,3142,1383,802,0,802,0,324,0,0.071072319,empty,mBC-0716-2
"A2,A9",19334,19675,14605,5070,9728,0,4547,4559,3300,1259,2.621127879,2215,1126,659,416,0,416,0,201,0,0.067307692,empty,mBC-0716-2
"A2,A10",398111,409365,293144,116221,204817,0,101161,101313,74090,27223,2.72159571,51263,3626,2237,1290,0,1290,0,355,0,0.003100775,mm10,mBC-0716-2
"A2,A11",15956,16237,12135,4102,7938,0,3610,3618,2510,1108,2.26534296,1667,1166,624,394,1,393,1,188,0,0.025445293,empty,mBC-0716-2
"A2,A12",18523,19045,14393,4652,8881,1,3943,3950,2814,1136,2.477112676,1745,2246,1326,745,0,745,0,258,0,0.057718121,empty,mBC-0716-2
"A2,B1",17272,17664,13109,4555,8592,2,3896,3908,2816,1092,2.578754579,1852,1284,794,475,0,475,0,177,0,0.046315789,empty,mBC-0716-2
"A2,B2",18569,19472,14125,5347,9474,6,4353,4372,3055,1317,2.319665907,2103,626,327,195,0,195,0,79,0,0.148717949,empty,mBC-0716-2
"A2,B3",16542,17220,12621,4599,8301,7,3720,3730,2625,1105,2.375565611,1798,1130,670,417,0,417,0,187,0,0.007194245,empty,mBC-0716-2
"A2,B4",14625,15563,11197,4366,7586,2,3597,3602,2513,1089,2.307621671,1823,1192,746,449,0,449,0,161,0,0.080178174,empty,mBC-0716-2
"A2,B5",13446,10983,7183,3800,6317,0,3333,3348,2443,905,2.699447514,1874,2752,1017,574,2,572,2,199,0,0.015734266,empty,mBC-0716-2
"A2,B6",577622,651281,398080,253201,321161,1,191432,191676,157573,34103,4.620502595,109245,57670,38705,21586,7,21579,2,2565,0,0.001390241,mm10,mBC-0716-2
"A2,B7",587322,621517,447353,174164,306261,3,145312,145516,120013,25503,4.705838529,73072,48674,31630,17703,9,17694,2,2195,0,0.002260653,mm10,mBC-0716-2
"A2,B8",13014,13462,10036,3426,6549,9,2899,2913,2089,824,2.535194175,1363,8622,2508,1530,2,1528,1,454,0,0.043193717,empty,mBC-0716-2
"A2,B9",13383,13428,10273,3155,6527,0,2874,2887,1989,898,2.214922049,1357,649,411,249,0,249,0,133,0,0.080321285,empty,mBC-0716-2
"A2,B10",14734,14904,10815,4089,7304,5,3358,3372,2367,1005,2.355223881,1642,702,351,205,0,205,0,87,0,0.048780488,empty,mBC-0716-2
"A2,B11",725893,784975,522319,262656,378189,33,202742,203066,173069,29997,5.769543621,109035,4429,2856,1578,0,1578,0,408,0,0,mm10,mBC-0716-2
"A2,B12",17294,17669,13018,4651,8671,0,3995,4004,2826,1178,2.398981324,1944,1177,662,395,0,395,0,168,0,0.027848101,empty,mBC-0716-2
"A2,C1",1199816,1270567,889165,381402,592698,31,297504,298079,227984,70095,3.252500178,154536,45315,29315,16000,6,15994,1,2100,0,0.001312992,mm10,mBC-0716-2
"A2,C2",15617,16397,11803,4594,7974,0,3753,3766,2629,1137,2.312225154,1827,2509,1171,690,2,688,1,228,0,0.042151163,empty,mBC-0716-2
"A2,C3",17780,18631,13391,5240,8886,8,4132,4152,2947,1205,2.445643154,2064,631,387,251,0,251,0,94,0,0.051792829,empty,mBC-0716-2
"A2,C4",15287,15516,11808,3708,7644,0,3368,3385,2380,1005,2.368159204,1539,1040,594,362,0,362,0,153,0,0.091160221,empty,mBC-0716-2
"A2,C5",16938,17701,12532,5169,8814,46,4184,4244,2994,1250,2.3952,2201,1477,871,523,0,523,0,228,0,0.047801147,empty,mBC-0716-2
"A2,C6",15507,15857,11433,4424,8062,1,3872,3883,2688,1195,2.249372385,1994,10870,3394,2051,2,2049,2,537,0,0.121034651,empty,mBC-0716-2
"A2,C7",15452,16321,11646,4675,7973,1,3817,3824,2672,1152,2.319444444,1885,410,249,165,0,165,0,87,0,0.006060606,empty,mBC-0716-2
"A2,C8",13437,14075,9928,4147,6844,1,3181,3196,2234,962,2.322245322,1687,8833,3048,1836,1,1835,1,521,0,0.151498638,empty,mBC-0716-2
"A2,C9",882458,950449,635374,315075,457302,6,248645,249025,176355,72670,2.426792349,133432,32142,21045,11749,6,11743,1,1683,0,0.00502427,mm10,mBC-0716-2
"A2,C10",12405,12705,9580,3125,6339,12,2843,2872,2032,840,2.419047619,1337,5913,2043,1164,1,1163,1,361,0,0.03783319,empty,mBC-0716-2
"A2,C11",10628,11192,7965,3227,5440,3,2572,2582,1745,837,2.084826762,1255,2184,914,560,0,560,0,209,0,0.0375,empty,mBC-0716-2
"A2,C12",18220,18498,13918,4580,9032,16,4107,4133,2816,1317,2.138192863,1920,1130,637,408,0,408,0,163,0,0.041666667,empty,mBC-0716-2
"A2,D1",509733,545689,376194,169495,270022,6,132991,133205,109794,23411,4.689846653,70190,52669,34805,18755,6,18749,2,2294,0,0.001066724,mm10,mBC-0716-2
"A2,D2",778779,837666,544543,293123,408666,0,236893,237251,189269,47982,3.944583385,127989,46784,25894,14678,10,14668,2,2236,0,0.021611672,mm10,mBC-0716-2
"A2,D3",12085,12673,8941,3732,6273,0,3071,3082,2120,962,2.203742204,1543,1125,625,387,0,387,0,191,0,0.002583979,empty,mBC-0716-2
"A2,D4",817974,880556,593233,287323,425630,27,222666,223041,188943,34098,5.541175436,118459,120789,75971,42142,23,42119,3,3714,0,0.002540421,mm10,mBC-0716-2
"A2,D5",12005,12158,9262,2896,6061,0,2790,2797,1965,832,2.361778846,1265,1888,853,508,0,508,0,215,0,0.011811024,empty,mBC-0716-2
"A2,D6",968890,1053285,680708,372577,521007,0,298738,299129,223511,75618,2.955790949,165018,64362,28695,16376,9,16367,2,2783,0,0.010753345,mm10,mBC-0716-2
"A2,D7",11819,12293,8838,3455,6004,0,2849,2861,1999,862,2.319025522,1452,1246,734,447,0,447,0,189,0,0.03803132,empty,mBC-0716-2
"A2,D8",17958,18798,13627,5171,9110,3,4251,4268,3126,1142,2.737302977,2081,1323,731,459,0,459,0,193,0,0.030501089,empty,mBC-0716-2
"A2,D9",188314,206374,127805,78569,104477,0,61050,61126,46634,14492,3.217913331,34698,68155,42967,23532,13,23519,3,2808,0,0.003103873,mm10,mBC-0716-2
"A2,D10",13617,14057,10095,3962,6990,0,3469,3478,2495,983,2.538148525,1662,906,528,319,0,319,0,125,0,0.05015674,empty,mBC-0716-2
"A2,D11",11684,11986,8843,3143,5913,0,2690,2696,1871,825,2.267878788,1305,2678,1058,703,0,703,0,297,0,0.06401138,empty,mBC-0716-2
"A2,D12",18055,18927,13695,5232,9133,38,4182,4229,2938,1291,2.275755229,2064,2218,1332,771,1,770,1,252,0,0.024675325,empty,mBC-0716-2
"A2,E1",19031,19842,14468,5374,9664,0,4421,4442,3118,1324,2.354984894,2226,1320,739,469,0,469,0,226,0,0.019189765,empty,mBC-0716-2
"A2,E2",14001,14238,10670,3568,6929,19,3114,3138,2226,912,2.440789474,1443,1424,739,457,0,457,0,203,0,0.041575492,empty,mBC-0716-2
"A2,E3",11102,11463,8493,2970,5610,0,2555,2555,1777,778,2.284061697,1168,1740,1130,624,0,624,0,254,0,0.03525641,empty,mBC-0716-2
"A2,E4",13914,14202,10690,3512,6915,0,3151,3159,2262,897,2.52173913,1512,1419,822,508,1,507,1,191,0,0.01183432,empty,mBC-0716-2
"A2,E5",1993204,2082504,1496979,585525,970420,60,483227,484107,409129,74978,5.456653952,240871,162776,107101,58622,26,58596,1,4558,0,0.002645232,mm10,mBC-0716-2
"A2,E6",12236,12554,9295,3259,6220,0,2885,2895,2034,861,2.362369338,1365,1713,1029,620,0,620,0,251,0,0.046774194,empty,mBC-0716-2
"A2,E7",12124,12077,9265,2812,5889,0,2646,2655,1884,771,2.443579767,1171,1060,602,373,0,373,0,169,0,0.013404826,empty,mBC-0716-2
"A2,E8",15531,15833,11821,4012,7743,4,3469,3485,2410,1075,2.241860465,1632,1746,968,609,0,609,0,231,0,0.077175698,empty,mBC-0716-2
"A2,E9",7944,8328,6016,2312,4079,4,1872,1879,1271,608,2.090460526,934,1363,674,404,1,403,1,157,0,0.037220844,empty,mBC-0716-2
"A2,E10",11737,12291,8779,3512,5933,2,2785,2792,1946,846,2.300236407,1381,1198,703,422,0,422,0,204,0,0.049763033,empty,mBC-0716-2
"A2,E11",7906,8130,5958,2172,4075,12,1824,1843,1282,561,2.285204991,866,920,490,304,0,304,0,155,0,0.052631579,empty,mBC-0716-2
"A2,E12",14410,15234,10723,4511,7521,20,3571,3602,2510,1092,2.298534799,1823,1071,630,351,1,350,1,140,0,0.054285714,empty,mBC-0716-2
"A2,F1",16541,16587,12623,3964,8123,0,3600,3615,2563,1052,2.436311787,1602,9287,2975,1800,2,1798,1,518,0,0.061179088,empty,mBC-0716-2
"A2,F2",20230,20975,15152,5823,10312,3,4865,4877,3419,1458,2.344993141,2436,4444,2127,1249,0,1249,0,452,0,0.081665332,empty,mBC-0716-2
"A2,F3",14427,14616,10946,3670,7225,1,3423,3426,2408,1018,2.365422397,1605,1699,1022,630,0,630,0,256,0,0.038095238,empty,mBC-0716-2
"A2,F4",14007,14598,10582,4016,7191,48,3240,3292,2298,994,2.311871227,1585,633,380,221,0,221,0,85,0,0.027149321,empty,mBC-0716-2
"A2,F5",23076,23286,16821,6465,11122,0,5206,5227,3724,1503,2.477711244,2518,25817,8154,4954,1,4953,1,1121,0,0.109226731,empty,mBC-0716-2
"A2,F6",20667,21448,15746,5702,10382,0,4885,4899,3401,1498,2.270360481,2390,2117,1188,723,0,723,0,276,0,0.037344398,empty,mBC-0716-2
"A2,F7",1029635,1153505,700902,452603,562165,1,350372,350858,257980,92878,2.777622257,199501,12080,7611,4202,0,4202,0,915,0,0.004759638,mm10,mBC-0716-2
"A2,F8",1464949,1599626,1030275,569351,773824,29,447387,448074,347818,100256,3.469298596,247812,1177,724,446,1,445,1,216,0,0.04494382,empty,mBC-0716-2
"A2,F9",13283,13779,10216,3563,6692,28,2897,2940,1992,948,2.101265823,1370,9900,2961,1756,0,1756,0,519,0,0.065489749,empty,mBC-0716-2
"A2,F10",19082,19293,14583,4710,9204,34,3993,4036,2838,1198,2.368948247,1808,6813,2434,1447,2,1445,1,374,0,0.204844291,empty,mBC-0716-2
"A2,F11",10185,10580,7900,2680,5196,21,2254,2284,1608,676,2.378698225,1074,1012,609,379,0,379,0,175,0,0.034300792,empty,mBC-0716-2
"A2,F12",654730,736668,459968,276700,358329,0,208164,208508,164978,43530,3.789983919,117854,2562,1600,938,1,937,1,272,0,0.009605123,empty,mBC-0716-2
"A2,G1",9001,9263,7007,2256,4576,0,2030,2032,1384,648,2.135802469,887,1666,1058,619,0,619,0,229,0,0.030694669,empty,mBC-0716-2
"A2,G2",18818,19339,14361,4978,9566,20,4315,4341,3085,1256,2.456210191,2026,654,422,276,0,276,0,142,0,0.025362319,empty,mBC-0716-2
"A2,G3",17790,18152,13595,4557,8841,1,4050,4056,2847,1209,2.35483871,1930,1610,945,580,0,580,0,262,0,0.017241379,empty,mBC-0716-2
"A2,G4",25153,25256,19261,5995,12247,18,5376,5410,3904,1506,2.592297477,2447,290,136,97,0,97,0,60,0,0,empty,mBC-0716-2
"A2,G5",1339028,1518978,924402,594576,730298,1,438870,439450,363674,75776,4.799329603,251188,103018,68013,37239,17,37222,2,3478,0,0.001316426,mm10,mBC-0716-2
"A2,G6",21869,22038,17067,4971,10679,0,4676,4686,3302,1384,2.38583815,2058,196,123,79,0,79,0,46,0,0.050632911,empty,mBC-0716-2
"A2,G7",18688,19058,14398,4660,9223,0,4159,4162,2976,1186,2.509274874,1908,1810,1148,676,0,676,0,297,0,0.019230769,empty,mBC-0716-2
"A2,G8",12842,13477,9551,3926,6756,0,3216,3223,2269,954,2.378406709,1652,1517,894,539,1,538,1,238,0,0.031598513,empty,mBC-0716-2
"A2,G9",271103,273148,205896,67252,137799,0,60639,60754,48029,12725,3.774381139,29295,8783,5769,3246,1,3245,1,888,0,0.006779661,mm10,mBC-0716-2
"A2,G10",11927,12599,9064,3535,6110,27,2745,2779,1974,805,2.452173913,1392,1318,844,529,0,529,0,225,0,0.020793951,empty,mBC-0716-2
"A2,G11",14617,15030,11316,3714,7298,0,3234,3239,2438,801,3.043695381,1505,746,444,260,0,260,0,122,0,0.003846154,empty,mBC-0716-2
"A2,G12",10010,10315,7478,2837,5049,0,2341,2346,1629,717,2.271966527,1149,989,592,385,0,385,0,154,0,0.01038961,empty,mBC-0716-2
"A2,H1",747506,840621,525629,314992,411150,0,238278,238659,196206,42453,4.621722846,134278,60522,40093,21964,7,21957,1,2457,0,0.002322722,mm10,mBC-0716-2
"A2,H2",1064055,1180948,736598,444350,565261,9,332111,332601,282598,50003,5.651620903,185755,134031,85855,47588,14,47574,1,3761,0,0.001240173,mm10,mBC-0716-2
"A2,H3",604535,653761,433614,220147,318188,0,170527,170750,146437,24313,6.022991815,91769,48064,31628,17628,8,17620,1,2131,0,0.001702611,mm10,mBC-0716-2
"A2,H4",975569,1042384,708585,333799,506530,1,265679,266100,203746,62354,3.267569041,140386,6865,4485,2379,1,2378,1,574,0,0.001682086,mm10,mBC-0716-2
"A2,H5",15888,16619,12109,4510,8070,0,3761,3769,2662,1107,2.40469738,1822,1302,794,470,0,470,0,193,0,0.091489362,empty,mBC-0716-2
"A2,H6",553716,574757,412915,161842,283279,0,133863,134100,116534,17566,6.634065809,67446,107225,70273,39328,11,39317,3,3538,0,0.00106824,mm10,mBC-0716-2
"A2,H7",15007,15339,11298,4041,7711,1,3589,3599,2525,1074,2.351024209,1725,8719,3111,1871,0,1871,0,536,0,0.066809193,empty,mBC-0716-2
"A2,H8",11910,12475,8920,3555,6149,0,2924,2932,2069,863,2.397450753,1483,4164,1628,969,3,966,2,334,0,0.103519669,empty,mBC-0716-2
"A2,H9",14792,15376,11159,4217,7485,3,3497,3509,2532,977,2.59160696,1708,1203,711,472,0,472,0,225,0,0.084745763,empty,mBC-0716-2
"A2,H10",13139,13652,9750,3902,6685,0,3067,3071,2129,942,2.260084926,1564,1232,722,423,1,422,1,200,0,0.037914692,empty,mBC-0716-2
"A2,H11",1381282,1519541,984467,535074,734598,0,416653,417289,328489,88800,3.69920045,229770,2978,1773,1004,1,1003,1,306,0,0.004985045,mm10,mBC-0716-2
"A2,H12",5382,5545,4017,1528,2706,1,1260,1262,904,358,2.525139665,589,684,393,241,0,241,0,108,0,0.037344398,empty,mBC-0716-2
"A3,A1",16869,17638,12553,5085,8651,2,4200,4206,2945,1261,2.335448057,2096,13361,4262,2573,2,2571,1,715,0,0.033838973,empty,mBC-0716-2
"A3,A2",20789,20940,15809,5131,10166,2,4464,4470,3200,1270,2.519685039,2071,3436,1360,816,0,816,0,276,0,0.074754902,empty,mBC-0716-2
"A3,A3",1713614,1868684,1215551,653133,894718,1,512535,513261,368662,144599,2.549547369,279408,52212,33115,18706,6,18700,2,2368,0,0.002941176,mm10,mBC-0716-2
"A3,A4",23027,23415,17706,5709,11374,0,4952,4967,3578,1389,2.575953924,2312,525,274,160,0,160,0,106,0,0.05625,empty,mBC-0716-2
"A3,A5",19181,19544,14558,4986,9680,1,4519,4537,3143,1394,2.254662841,2147,1338,755,472,0,472,0,231,0,0.029661017,empty,mBC-0716-2
"A3,A6",23089,24630,17535,7095,12247,0,6048,6050,4294,1756,2.445330296,3013,1783,1093,698,0,698,0,253,0,0.028653295,empty,mBC-0716-2
"A3,A7",17149,17472,12934,4538,8850,0,4090,4105,2848,1257,2.265712013,1992,997,625,374,0,374,0,164,0,0.080213904,empty,mBC-0716-2
"A3,A8",11581,11742,8705,3037,5784,7,2621,2630,1903,727,2.617606602,1258,1253,736,415,0,415,0,178,0,0.040963855,empty,mBC-0716-2
"A3,A9",19807,20170,15322,4848,9689,0,4257,4277,3090,1187,2.603201348,1980,1183,764,481,0,481,0,197,0,0.024948025,empty,mBC-0716-2
"A3,A10",20520,21400,15438,5962,10545,0,4947,4960,3495,1465,2.385665529,2471,377,209,152,0,152,0,97,0,0.013157895,empty,mBC-0716-2
"A3,A11",860579,906671,631386,275285,442398,10,236109,236523,171783,64740,2.653429101,121228,14429,6500,3628,3,3625,2,926,0,0.029241379,mm10,mBC-0716-2
"A3,A12",22645,23192,17503,5689,10998,38,4898,4947,3518,1429,2.461861442,2220,2169,1250,730,0,730,0,248,0,0.032876712,empty,mBC-0716-2
"A3,B1",20471,21108,15584,5524,10326,0,4716,4721,3269,1452,2.25137741,2252,1354,763,455,0,455,0,174,0,0.046153846,empty,mBC-0716-2
"A3,B2",746206,792374,569232,223142,388418,3,187023,187366,137484,49882,2.756184596,94642,12236,6554,3647,2,3645,1,863,0,0.000548697,mm10,mBC-0716-2
"A3,B3",19957,20539,15311,5228,10087,39,4594,4648,3266,1382,2.363241679,2191,1265,664,422,0,422,0,195,0,0.021327014,empty,mBC-0716-2
"A3,B4",17748,18413,13625,4788,9066,16,4157,4188,2905,1283,2.264224474,2019,1077,602,355,0,355,0,142,0,0.050704225,empty,mBC-0716-2
"A3,B5",10101,6063,4108,1955,3846,13,1883,1908,1331,577,2.306759099,1094,809,511,296,1,295,1,124,0,0.037288136,empty,mBC-0716-2
"A3,B6",14328,14782,10700,4082,7338,0,3436,3438,2467,971,2.540679712,1697,1527,712,473,0,473,0,194,0,0.105708245,empty,mBC-0716-2
"A3,B7",17397,17899,13336,4563,8712,18,3923,3957,2820,1137,2.480211082,1809,912,561,368,0,368,0,155,0,0.105978261,empty,mBC-0716-2
"A3,B8",14374,14911,11076,3835,7283,0,3336,3337,2345,992,2.36391129,1575,2801,1146,683,0,683,0,285,0,0.007320644,empty,mBC-0716-2
"A3,B9",16030,16430,12284,4146,8061,17,3610,3640,2538,1102,2.303085299,1702,723,427,274,0,274,0,129,0,0.025547445,empty,mBC-0716-2
"A3,B10",18249,18307,13579,4728,9204,0,4224,4232,2970,1262,2.35340729,2059,467,281,183,0,183,0,97,0,0.054644809,empty,mBC-0716-2
"A3,B11",901345,984308,655996,328312,474287,29,260845,261218,220765,40453,5.457320841,141500,404,240,149,0,149,0,91,0,0.013422819,empty,mBC-0716-2
"A3,B12",19640,20244,14935,5309,9965,35,4554,4592,3335,1257,2.653142403,2199,1308,777,460,0,460,0,174,0,0.047826087,empty,mBC-0716-2
"A3,C1",23557,24143,17918,6225,11518,1,5008,5016,3602,1414,2.54738331,2398,611,342,218,0,218,0,114,0,0.02293578,empty,mBC-0716-2
"A3,C2",19995,20295,15248,5047,9847,1,4407,4424,3077,1347,2.284335561,2051,4112,1679,1001,2,999,1,318,0,0.028028028,empty,mBC-0716-2
"A3,C3",24776,25961,18591,7370,12767,0,6187,6196,4395,1801,2.440310938,3063,668,335,210,1,209,1,101,0,0.062200957,empty,mBC-0716-2
"A3,C4",18979,19320,14716,4604,9365,16,4133,4162,2911,1251,2.326938449,1886,1067,693,414,1,413,1,144,0,0.041162228,empty,mBC-0716-2
"A3,C5",945723,1039616,660905,378711,503999,11,289463,289902,253706,36196,7.009227539,159763,95472,58761,33174,16,33158,2,3372,0,0.001055552,mm10,mBC-0716-2
"A3,C6",17801,18343,13381,4962,9289,0,4348,4358,3094,1264,2.44778481,2106,1380,856,518,1,517,1,212,0,0.067698259,empty,mBC-0716-2
"A3,C7",17292,17813,13173,4640,8825,0,4156,4159,2857,1302,2.194316436,1964,424,270,161,0,161,0,91,0,0.01863354,empty,mBC-0716-2
"A3,C8",16162,16852,12285,4567,8241,14,3729,3749,2617,1132,2.311837456,1843,1112,668,385,0,385,0,156,0,0.072727273,empty,mBC-0716-2
"A3,C9",13965,14537,10556,3981,7192,15,3393,3415,2380,1035,2.299516908,1646,731,419,253,0,253,0,124,0,0.035573123,empty,mBC-0716-2
"A3,C10",14714,15005,11209,3796,7522,15,3418,3440,2396,1044,2.295019157,1649,1102,598,356,1,355,1,168,0,0.005633803,empty,mBC-0716-2
"A3,C11",12156,12410,9129,3281,6184,0,2926,2929,2023,906,2.232891832,1357,773,403,266,0,266,0,139,0,0.037593985,empty,mBC-0716-2
"A3,C12",21396,22140,16239,5901,10786,29,4979,5022,3531,1491,2.368209256,2438,1053,653,377,0,377,0,135,0,0.047745358,empty,mBC-0716-2
"A3,D1",13597,14067,10353,3714,7005,3,3303,3311,2278,1033,2.205227493,1558,679,401,248,0,248,0,104,0,0.064516129,empty,mBC-0716-2
"A3,D2",22325,23089,17167,5922,11360,17,5065,5095,3507,1588,2.208438287,2451,2492,1523,924,1,923,1,344,0,0.036836403,empty,mBC-0716-2
"A3,D3",15073,15974,11352,4622,7775,0,3814,3818,2669,1149,2.322889469,1892,1123,663,432,0,432,0,191,0,0.011574074,empty,mBC-0716-2
"A3,D4",602176,639811,426590,213221,318854,24,176897,177200,143492,33708,4.256912306,94616,7918,4963,2806,2,2804,2,767,0,0.004279601,mm10,mBC-0716-2
"A3,D5",505305,514068,374665,139403,257199,0,122017,122235,97767,24468,3.995708681,60536,5881,3726,2052,1,2051,1,632,0,0.010726475,mm10,mBC-0716-2
"A3,D6",14286,15113,10673,4440,7320,28,3494,3522,2454,1068,2.297752809,1811,2301,1000,583,0,583,0,237,0,0.048027444,empty,mBC-0716-2
"A3,D7",14339,14914,10804,4110,7295,16,3314,3339,2300,1039,2.213666987,1661,1107,682,402,0,402,0,161,0,0.044776119,empty,mBC-0716-2
"A3,D8",16981,17951,12875,5076,8825,9,4160,4180,2844,1336,2.128742515,2076,819,536,328,1,327,1,160,0,0.006116208,empty,mBC-0716-2
"A3,D9",6571,6948,4842,2106,3567,2,1787,1800,1305,495,2.636363636,907,1599,939,568,1,567,1,264,0,0.047619048,empty,mBC-0716-2
"A3,D10",14858,15453,11199,4254,7445,1,3545,3551,2507,1044,2.401340996,1813,3746,1226,724,1,723,1,243,0,0.042876902,empty,mBC-0716-2
"A3,D11",14176,14564,10835,3729,7269,3,3383,3397,2358,1039,2.269489894,1704,1443,774,485,0,485,0,239,0,0.041237113,empty,mBC-0716-2
"A3,D12",21684,22322,16552,5770,10850,0,4935,4942,3417,1525,2.240655738,2384,4496,2067,1187,1,1186,1,370,0,0.061551433,empty,mBC-0716-2
"A3,E1",23838,24229,18066,6163,11741,1,5390,5407,3771,1636,2.305012225,2518,4735,1996,1244,0,1244,0,376,0,0.25,empty,mBC-0716-2
"A3,E2",17988,18494,13658,4836,8970,0,4000,4008,2801,1207,2.32062966,1935,1854,1027,612,0,612,0,227,0,0.060457516,empty,mBC-0716-2
"A3,E3",13143,13562,10170,3392,6698,15,3034,3055,2023,1032,1.960271318,1433,1533,928,564,2,562,1,231,0,0.028469751,empty,mBC-0716-2
"A3,E4",16484,16938,12714,4224,8277,42,3755,3798,2692,1106,2.433996383,1797,980,547,348,0,348,0,166,0,0.014367816,empty,mBC-0716-2
"A3,E5",1554899,1678657,1090707,587950,787599,35,453349,454114,382261,71853,5.320042309,243700,70324,45110,25240,13,25227,2,2879,0,0.001942363,mm10,mBC-0716-2
"A3,E6",712936,782188,515249,266939,379399,6,204561,204890,178479,26411,6.757752452,110515,127536,77160,42745,21,42724,4,3972,0,0.008098493,mm10,mBC-0716-2
"A3,E7",933905,996801,686502,310299,476970,7,247654,248036,187186,60850,3.076187346,129579,57083,37550,21003,11,20992,3,2478,0,0.000142912,mm10,mBC-0716-2
"A3,E8",19230,19466,14697,4769,9573,0,4211,4224,2907,1317,2.207289294,1951,8417,3063,1859,0,1859,0,546,0,0.195266272,empty,mBC-0716-2
"A3,E9",10045,10404,7596,2808,5158,2,2408,2415,1755,660,2.659090909,1198,1093,639,351,0,351,0,145,0,0.037037037,empty,mBC-0716-2
"A3,E10",766183,856292,541079,315213,420511,4,240039,240321,192764,47557,4.053325483,135264,61459,36392,20573,4,20569,2,2560,0,0.001896057,mm10,mBC-0716-2
"A3,E11",672740,738977,483181,255796,367473,1,201491,201819,146677,55142,2.659986943,110255,70236,42591,23895,16,23879,1,2872,0,0.003266468,mm10,mBC-0716-2
"A3,E12",16528,17185,12460,4725,8655,0,4143,4153,2915,1238,2.3546042,2054,2148,939,565,0,565,0,179,0,0.02300885,empty,mBC-0716-2
"A3,F1",913470,1013248,659186,354062,490034,38,273730,274194,215366,58828,3.660943768,149414,93659,60276,34438,9,34429,2,3224,0,0.001800807,mm10,mBC-0716-2
"A3,F2",1595410,1744817,1147298,597519,837516,42,466258,467006,361777,105229,3.43799713,254090,129117,81422,45824,23,45801,2,4250,0,0.003056702,mm10,mBC-0716-2
"A3,F3",19356,19837,13810,6027,9467,0,4686,4691,3380,1311,2.578184592,2397,30941,10108,6357,5,6352,2,1212,0,0.274559194,empty,mBC-0716-2
"A3,F4",1063145,1159923,745790,414133,566682,3,325054,325535,251459,74076,3.39460824,178640,19778,12784,7074,2,7072,1,1294,0,0.002828054,mm10,mBC-0716-2
"A3,F5",702411,742406,527359,215047,362298,26,174265,174632,140562,34070,4.125682419,89343,57223,36236,20013,7,20006,1,2510,0,0.001449565,mm10,mBC-0716-2
"A3,F6",25466,26525,19262,7263,12837,0,6061,6078,4236,1842,2.299674267,3028,2454,1269,759,0,759,0,283,0,0.063241107,empty,mBC-0716-2
"A3,F7",41571,44784,30179,14605,21923,1,11898,11916,8610,3306,2.604355717,6216,971,574,356,0,356,0,154,0,0.005617978,empty,mBC-0716-2
"A3,F8",23603,24415,17880,6535,11932,1,5482,5500,3830,1670,2.293413174,2637,687,272,193,1,192,1,111,0,0.015625,empty,mBC-0716-2
"A3,F9",15645,15967,11910,4057,7927,5,3593,3613,2531,1082,2.339186691,1720,1420,851,484,0,484,0,189,0,0.037190083,empty,mBC-0716-2
"A3,F10",775994,796560,591462,205098,387805,25,183284,183656,138532,45124,3.070029253,89430,8662,5329,3052,5,3047,3,759,0,0.0078766,mm10,mBC-0716-2
"A3,F11",12564,13200,9527,3673,6546,2,3070,3079,2164,915,2.365027322,1530,1093,673,416,0,416,0,180,0,0.052884615,empty,mBC-0716-2
"A3,F12",15121,15661,11535,4126,7697,0,3574,3592,2573,1019,2.525024534,1755,139,86,48,0,48,0,35,0,0,empty,mBC-0716-2
"A3,G1",13062,12641,9157,3484,5774,0,2721,2729,1891,838,2.256563246,1267,6123,2449,1430,2,1428,1,407,0,0.154761905,empty,mBC-0716-2
"A3,G2",22712,23441,17314,6127,11525,44,5192,5247,3764,1483,2.538098449,2485,982,502,301,0,301,0,152,0,0,empty,mBC-0716-2
"A3,G3",23114,23833,17242,6591,11709,33,5485,5554,4028,1526,2.639580603,2738,14250,4736,2918,2,2916,1,765,0,0.164609053,empty,mBC-0716-2
"A3,G4",1529070,1703898,1039451,664447,804266,10,498495,499208,372184,127024,2.930028971,280718,555,349,208,0,208,0,89,0,0.028846154,empty,mBC-0716-2
"A3,G5",14500,15234,10865,4369,7577,17,3537,3568,2457,1111,2.211521152,1838,1368,801,485,0,485,0,220,0,0.022680412,empty,mBC-0716-2
"A3,G6",25789,26355,20054,6301,12741,1,5485,5498,3879,1619,2.39592341,2526,197,129,92,0,92,0,65,0,0,empty,mBC-0716-2
"A3,G7",21306,21971,16527,5444,10706,17,4743,4772,3353,1419,2.362931642,2255,1695,988,588,0,588,0,234,0,0.091836735,empty,mBC-0716-2
"A3,G8",15917,16187,12030,4157,8068,26,3731,3766,2648,1118,2.368515206,1750,1372,829,509,0,509,0,228,0,0.039292731,empty,mBC-0716-2
"A3,G9",11782,12272,8935,3337,5983,0,2875,2886,2024,862,2.348027842,1394,1176,770,486,0,486,0,225,0,0.041152263,empty,mBC-0716-2
"A3,G10",14261,14714,10985,3729,7241,0,3305,3310,2273,1037,2.191899711,1514,1352,794,479,0,479,0,219,0,0.027139875,empty,mBC-0716-2
"A3,G11",13200,13796,10193,3603,6783,5,3167,3177,2237,940,2.379787234,1528,617,368,223,0,223,0,105,0,0.004484305,empty,mBC-0716-2
"A3,G12",12190,12851,9180,3671,6321,24,2956,2991,1996,995,2.006030151,1457,11775,3165,1848,2,1846,2,491,0,0.037919827,empty,mBC-0716-2
"A3,H1",22605,22961,17444,5517,11237,15,5067,5091,3565,1526,2.336173001,2314,838,534,332,0,332,0,149,0,0.012048193,empty,mBC-0716-2
"A3,H2",40407,43190,30057,13133,20718,4,10421,10452,7462,2990,2.495652174,5361,2433,1534,892,0,892,0,333,0,0.060538117,empty,mBC-0716-2
"A3,H3",22608,23239,17111,6128,11346,20,5235,5259,3710,1549,2.395093609,2545,1517,868,519,0,519,0,233,0,0.063583815,empty,mBC-0716-2
"A3,H4",1671610,1852352,1164569,687783,883263,1,521676,522367,407874,114493,3.562436131,292339,6312,4194,2421,0,2421,0,557,0,0.000826105,mm10,mBC-0716-2
"A3,H5",1921145,2119535,1357379,762156,1000356,6,580610,581485,465082,116403,3.995446853,321181,113365,74610,41192,25,41167,3,3818,0,0.000898778,mm10,mBC-0716-2
"A3,H6",16602,17229,12367,4862,8390,0,3983,3995,2791,1204,2.318106312,1971,7304,2574,1500,3,1497,2,476,0,0.024048096,empty,mBC-0716-2
"A3,H7",18850,19195,14301,4894,9515,3,4374,4389,3171,1218,2.603448276,2098,1300,818,536,0,536,0,212,0,0.046641791,empty,mBC-0716-2
"A3,H8",743285,789873,540915,248958,382629,4,198299,198650,164172,34478,4.761645107,104036,79330,50442,28561,7,28554,1,2979,0,0.002591581,mm10,mBC-0716-2
"A3,H9",17704,18010,13509,4501,8930,0,4079,4082,2935,1147,2.558849172,1937,1846,966,616,0,616,0,275,0,0.071428571,empty,mBC-0716-2
"A3,H10",18113,19042,13543,5499,9414,7,4476,4490,3244,1246,2.6035313,2268,1346,802,470,0,470,0,225,0,0.029787234,empty,mBC-0716-2
"A3,H11",20048,20953,15172,5781,10202,7,4719,4740,3371,1369,2.4623813,2350,379,166,119,0,119,0,74,0,0.075630252,empty,mBC-0716-2
"A3,H12",893392,1006270,603990,402280,488634,0,301014,301486,242807,58679,4.137885785,172196,63513,39395,22071,6,22065,1,2592,0,0.001133016,mm10,mBC-0716-2
"A4,A1",12657,12775,9617,3158,6222,0,2809,2815,1987,828,2.399758454,1321,1342,770,464,1,463,1,215,0,0.041036717,empty,mBC-0716-2
"A4,A2",17583,17521,13297,4224,8295,0,3640,3653,2561,1092,2.345238095,1689,14043,4724,2823,3,2820,3,722,0,0.093617021,empty,mBC-0716-2
"A4,A3",15352,16171,11719,4452,7605,1,3501,3507,2456,1051,2.336822074,1701,1166,655,425,1,424,1,180,0,0.044811321,empty,mBC-0716-2
"A4,A4",20359,20919,15772,5147,9902,48,4263,4324,3024,1300,2.326153846,2024,674,415,289,0,289,0,175,0,0.044982699,empty,mBC-0716-2
"A4,A5",15537,16077,11944,4133,7986,2,3621,3627,2557,1070,2.389719626,1751,2050,1132,713,0,713,0,308,0,0.071528752,empty,mBC-0716-2
"A4,A6",627126,743307,408445,334862,360303,0,234264,234507,171590,62917,2.727243829,142575,90528,58227,32944,17,32927,1,3251,0,0.000607404,mm10,mBC-0716-2
"A4,A7",14589,15130,11172,3958,7307,0,3350,3362,2348,1014,2.315581854,1564,1481,890,532,1,531,1,212,0,0.054613936,empty,mBC-0716-2
"A4,A8",10105,10365,7725,2640,5074,4,2330,2344,1639,705,2.324822695,1097,1960,1075,659,1,658,1,272,0,0.074468085,empty,mBC-0716-2
"A4,A9",17186,17504,13216,4288,8265,11,3648,3664,2633,1031,2.553831232,1734,1641,950,580,1,579,1,261,0,0.029360967,empty,mBC-0716-2
"A4,A10",615907,679089,435042,244047,331257,1,186713,186993,143627,43366,3.311972513,103902,15528,8634,4836,1,4835,1,967,0,0.007859359,mm10,mBC-0716-2
"A4,A11",16317,16492,12565,3927,8132,1,3617,3624,2536,1088,2.330882353,1685,1493,904,526,0,526,0,253,0,0.024714829,empty,mBC-0716-2
"A4,A12",23572,24422,18154,6268,11685,1,5184,5204,3761,1443,2.606375606,2504,6370,3690,2015,0,2015,0,532,0,0.050620347,empty,mBC-0716-2
"A4,B1",742990,797192,554588,242604,382431,38,191300,191651,159288,32363,4.921917004,98827,79567,50299,27608,21,27587,2,2972,0,0.005002356,mm10,mBC-0716-2
"A4,B2",19126,19052,14432,4620,9011,6,4027,4038,2781,1257,2.212410501,1853,6762,2011,1197,2,1195,2,360,0,0.09958159,empty,mBC-0716-2
"A4,B3",17092,17317,13041,4276,8337,2,3694,3711,2658,1053,2.524216524,1731,3542,1641,1015,2,1013,2,342,0,0.181638697,empty,mBC-0716-2
"A4,B4",15337,16054,11733,4321,7632,28,3527,3566,2511,1055,2.380094787,1756,1150,709,418,0,418,0,181,0,0.076555024,empty,mBC-0716-2
"A4,B5",8615,5398,3823,1575,3404,0,1637,1646,1209,437,2.766590389,934,940,548,330,0,330,0,173,0,0.006060606,empty,mBC-0716-2
"A4,B6",11193,11425,8468,2957,5614,0,2627,2628,1816,812,2.236453202,1241,1441,886,565,1,564,1,258,0,0.042553191,empty,mBC-0716-2
"A4,B7",15112,15644,11570,4074,7425,9,3300,3311,2354,957,2.459770115,1538,1025,570,336,0,336,0,154,0,0.032738095,empty,mBC-0716-2
"A4,B8",12789,13421,9713,3708,6342,5,2893,2911,2024,887,2.281848929,1383,1342,774,504,0,504,0,258,0,0.023809524,empty,mBC-0716-2
"A4,B9",13737,14238,10429,3809,6844,1,3111,3113,2162,951,2.273396425,1539,836,497,309,0,309,0,167,0,0.029126214,empty,mBC-0716-2
"A4,B10",15037,15183,11374,3809,7474,0,3400,3406,2413,993,2.43001007,1606,561,312,190,0,190,0,98,0,0.052631579,empty,mBC-0716-2
"A4,B11",15302,15749,11662,4087,7558,11,3425,3444,2446,998,2.450901804,1640,351,211,155,0,155,0,101,0,0,empty,mBC-0716-2
"A4,B12",16653,17326,12562,4764,8494,1,3944,3957,2767,1190,2.325210084,1943,1964,1055,604,1,603,1,236,0,0.024875622,empty,mBC-0716-2
"A4,C1",21277,21277,16482,4795,10132,17,4350,4374,3136,1238,2.533117932,1929,978,575,350,0,350,0,170,0,0.042857143,empty,mBC-0716-2
"A4,C2",16899,17629,12664,4965,8322,0,3865,3874,2675,1199,2.231025855,1930,1594,922,566,0,566,0,211,0,0.045936396,empty,mBC-0716-2
"A4,C3",18154,18661,13776,4885,8854,1,4076,4094,2858,1236,2.312297735,1949,824,494,287,0,287,0,134,0,0.031358885,empty,mBC-0716-2
"A4,C4",810140,827775,618291,209484,396459,4,174792,175144,147514,27630,5.338906985,84847,80724,51927,28939,8,28931,1,3071,0,0.001693685,mm10,mBC-0716-2
"A4,C5",17982,18799,13262,5537,9260,0,4633,4636,3314,1322,2.506807867,2344,6050,2240,1324,1,1323,1,455,0,0.07558579,empty,mBC-0716-2
"A4,C6",15039,15186,11365,3821,7613,10,3432,3457,2410,1047,2.301814709,1684,1526,954,600,0,600,0,250,0,0.038333333,empty,mBC-0716-2
"A4,C7",14633,15214,11154,4060,7337,0,3430,3438,2376,1062,2.237288136,1645,455,255,172,0,172,0,89,0,0.040697674,empty,mBC-0716-2
"A4,C8",13800,13951,10396,3555,6888,3,3178,3181,2249,932,2.413090129,1556,2163,1181,668,0,668,0,299,0,0.032934132,empty,mBC-0716-2
"A4,C9",11876,12298,9106,3192,5931,3,2719,2724,1944,780,2.492307692,1285,1076,584,354,0,354,0,182,0,0.025423729,empty,mBC-0716-2
"A4,C10",12303,12807,9436,3371,6243,6,2806,2814,1923,891,2.158249158,1357,1481,840,512,0,512,0,213,0,0.0703125,empty,mBC-0716-2
"A4,C11",10841,11318,8148,3170,5447,6,2598,2608,1804,804,2.243781095,1299,974,607,375,1,374,1,170,0,0.050802139,empty,mBC-0716-2
"A4,C12",17552,18060,13375,4685,8832,0,4020,4030,2886,1144,2.522727273,1904,1413,934,541,0,541,0,200,0,0.053604436,empty,mBC-0716-2
"A4,D1",10240,10489,7603,2886,5175,23,2412,2440,1720,720,2.388888889,1220,863,509,310,0,310,0,140,0,0.003225806,empty,mBC-0716-2
"A4,D2",19998,20421,15352,5069,9845,0,4370,4388,3049,1339,2.277072442,1977,3033,1854,1114,1,1113,1,421,0,0.012578616,empty,mBC-0716-2
"A4,D3",558276,621903,401395,220508,306321,0,170855,171096,121988,49108,2.484075914,94725,45442,27080,15132,11,15121,1,2128,0,0.002314662,mm10,mBC-0716-2
"A4,D4",13209,13627,10144,3483,6561,4,2958,2968,2052,916,2.240174672,1398,2053,1134,717,1,716,1,329,0,0.032122905,empty,mBC-0716-2
"A4,D5",12438,12997,9413,3584,6340,0,2956,2964,2076,888,2.337837838,1501,1250,814,466,0,466,0,185,0,0.038626609,empty,mBC-0716-2
"A4,D6",1208130,1401599,806134,595465,680917,28,437801,438359,342373,95986,3.56690559,260254,95882,56486,31770,12,31758,1,3517,0,0.005290006,mm10,mBC-0716-2
"A4,D7",483010,502666,347405,155261,246782,20,128759,128951,96021,32930,2.915912542,66713,9127,5702,3072,2,3070,2,819,0,0.009120521,mm10,mBC-0716-2
"A4,D8",740670,800669,547159,253510,385200,1,198668,199001,168001,31000,5.419387097,104104,73733,47098,26195,9,26186,1,2717,0,0.001718476,mm10,mBC-0716-2
"A4,D9",4043,4052,2957,1095,2079,2,966,973,730,243,3.004115226,492,2035,1189,747,0,747,0,317,0,0.032128514,empty,mBC-0716-2
"A4,D10",13766,14675,10371,4304,7113,0,3474,3479,2493,986,2.528397566,1794,805,481,256,0,256,0,132,0,0.03125,empty,mBC-0716-2
"A4,D11",12443,12983,9392,3591,6203,22,2866,2895,2044,851,2.401880141,1418,2528,1242,769,0,769,0,321,0,0.015604681,empty,mBC-0716-2
"A4,D12",734981,802745,535311,267434,385171,0,203590,203877,174013,29864,5.826848379,109128,160217,105031,57827,18,57809,3,4343,0,0.000778426,mm10,mBC-0716-2
"A4,E1",19795,19934,15267,4667,9542,37,4090,4141,2897,1244,2.328778135,1942,1739,1023,641,0,641,0,300,0,0.020280811,empty,mBC-0716-2
"A4,E2",14581,15030,11273,3757,7237,32,3231,3270,2269,1001,2.266733267,1523,1559,903,532,0,532,0,222,0,0.063909774,empty,mBC-0716-2
"A4,E3",797273,842548,599433,243115,407631,0,203509,203890,157906,45984,3.433933542,102556,134248,86862,47930,21,47909,3,4119,0,0.003444029,mm10,mBC-0716-2
"A4,E4",14188,14457,10794,3663,6842,46,3069,3119,2194,925,2.371891892,1481,1313,762,464,0,464,0,208,0,0.077586207,empty,mBC-0716-2
"A4,E5",19330,19445,14888,4557,9419,0,4259,4268,2962,1306,2.267993874,1944,1738,1095,686,0,686,0,321,0,0.002915452,empty,mBC-0716-2
"A4,E6",1169340,1241852,853285,388567,591283,8,307339,307869,248654,59215,4.199172507,160625,241705,160466,88359,40,88319,2,5381,0,0.001313421,mm10,mBC-0716-2
"A4,E7",15397,15705,11707,3998,7722,18,3482,3506,2416,1090,2.216513761,1739,1452,861,546,0,546,0,279,0,0.04029304,empty,mBC-0716-2
"A4,E8",15713,16070,12075,3995,7788,0,3510,3516,2460,1056,2.329545455,1616,1939,1163,738,0,738,0,284,0,0.014905149,empty,mBC-0716-2
"A4,E9",1175663,1275521,847666,427855,607044,1,326773,327255,264017,63238,4.174973908,176099,286707,181303,100299,49,100250,2,5832,0,0.001416459,mm10,mBC-0716-2
"A4,E10",11963,12349,9049,3300,6014,8,2723,2736,1905,831,2.292418773,1338,1447,865,544,0,544,0,235,0,0.040441176,empty,mBC-0716-2
"A4,E11",8265,8620,6218,2402,4180,0,1942,1942,1333,609,2.188834154,956,1305,787,489,0,489,0,217,0,0.077709611,empty,mBC-0716-2
"A4,E12",13446,13990,9978,4012,6816,0,3230,3233,2243,990,2.265656566,1593,1141,650,386,0,386,0,165,0,0.012953368,empty,mBC-0716-2
"A4,F1",16845,17149,12833,4316,8260,0,3762,3769,2637,1132,2.3295053,1741,1640,1023,632,0,632,0,309,0,0.050632911,empty,mBC-0716-2
"A4,F2",19952,20517,15078,5439,10000,0,4570,4577,3148,1429,2.202939118,2178,3081,1909,1161,0,1161,0,485,0,0.024978467,empty,mBC-0716-2
"A4,F3",14481,15236,10883,4353,7379,1,3552,3561,2430,1131,2.148541114,1815,3047,1549,965,1,964,1,404,0,0.022821577,empty,mBC-0716-2
"A4,F4",14773,14814,11071,3743,7184,35,3204,3245,2215,1030,2.150485437,1521,579,350,214,0,214,0,121,0,0.004672897,empty,mBC-0716-2
"A4,F5",1625060,1759421,1182244,577177,827554,2,446502,447196,327496,119700,2.735973266,243039,111054,66222,36542,23,36519,2,3575,0,0.010378159,mm10,mBC-0716-2
"A4,F6",20723,21494,15765,5729,10299,0,4650,4659,3189,1470,2.169387755,2260,7418,2385,1324,1,1323,1,416,0,0.030990174,empty,mBC-0716-2
"A4,F7",541987,530951,410206,120745,261033,0,111098,111322,91186,20136,4.528506158,51948,3992,2613,1523,1,1522,1,507,0,0.007227332,mm10,mBC-0716-2
"A4,F8",20220,20926,15333,5593,10117,0,4744,4754,3247,1507,2.154611812,2260,556,348,225,0,225,0,132,0,0.026666667,empty,mBC-0716-2
"A4,F9",13681,13846,10475,3371,6777,0,3002,3011,2112,899,2.349276974,1394,1785,1087,666,1,665,1,253,0,0.048120301,empty,mBC-0716-2
"A4,F10",611295,629730,462401,167329,307445,0,147016,147300,116634,30666,3.803365291,72679,8974,5445,3006,1,3005,1,741,0,0.005324459,mm10,mBC-0716-2
"A4,F11",10173,10489,7778,2711,5057,0,2246,2260,1576,684,2.304093567,1095,1002,607,403,1,402,1,221,0,0.039800995,empty,mBC-0716-2
"A4,F12",13185,13413,10090,3323,6415,8,2839,2862,1960,902,2.172949002,1320,282,179,117,0,117,0,62,0,0,empty,mBC-0716-2
"A4,G1",9382,9540,7313,2227,4676,4,2046,2055,1416,639,2.215962441,933,1842,1197,690,0,690,0,253,0,0.030434783,empty,mBC-0716-2
"A4,G2",1049999,1119594,776040,343554,528622,0,271946,272409,214763,57646,3.725549041,141593,27769,17956,10303,9,10294,2,1488,0,0.012628716,mm10,mBC-0716-2
"A4,G3",20768,21617,15700,5917,10396,7,4853,4873,3363,1510,2.227152318,2392,2249,1386,867,0,867,0,379,0,0.041522491,empty,mBC-0716-2
"A4,G4",25564,26342,19669,6673,12633,2,5639,5650,3952,1698,2.327444052,2648,240,118,86,0,86,0,67,0,0,empty,mBC-0716-2
"A4,G5",12439,13067,9369,3698,6228,0,2878,2883,2027,856,2.367990654,1419,1477,865,560,0,560,0,270,0,0.039285714,empty,mBC-0716-2
"A4,G6",24206,24365,18724,5641,11643,15,5007,5032,3498,1534,2.280312907,2244,371,235,165,0,165,0,98,0,0,empty,mBC-0716-2
"A4,G7",18282,19050,14210,4840,9236,1,4184,4206,2915,1291,2.257939582,1976,2229,1305,791,0,791,0,319,0,0.046776233,empty,mBC-0716-2
"A4,G8",13296,13948,10094,3854,6701,0,3135,3146,2159,987,2.187436677,1563,1924,1107,686,1,685,1,297,0,0.045255474,empty,mBC-0716-2
"A4,G9",14106,14966,10745,4221,7207,3,3422,3428,2468,960,2.570833333,1664,1995,1179,679,0,679,0,294,0,0.045655376,empty,mBC-0716-2
"A4,G10",1794292,1920850,1298708,622142,902056,30,487692,488443,400632,87811,4.56243523,258106,189220,125250,69527,34,69493,4,4964,0,0.000748277,mm10,mBC-0716-2
"A4,G11",839961,945604,566707,378897,454527,1,279821,280236,201281,78955,2.5493129,162529,65712,42925,23502,10,23492,1,2601,0,0.001404734,mm10,mBC-0716-2
"A4,G12",943803,1130539,595674,534865,549818,70,379290,379740,292605,87135,3.358065071,232985,112993,75632,41654,27,41627,3,3623,0,0.000984938,mm10,mBC-0716-2
"A4,H1",18872,19327,14295,5032,9268,0,4209,4223,2995,1228,2.438925081,1972,1120,706,406,0,406,0,189,0,0.056650246,empty,mBC-0716-2
"A4,H2",913888,951403,687807,263596,452610,1,216435,216781,182068,34713,5.244951459,107925,96689,64477,35638,13,35625,2,3487,0,0.001347368,mm10,mBC-0716-2
"A4,H3",18257,19036,13720,5316,9207,5,4363,4374,3117,1257,2.479713604,2165,1873,1095,693,0,693,0,310,0,0.046176046,empty,mBC-0716-2
"A4,H4",12430,12831,9500,3331,6179,0,2826,2829,1980,849,2.332155477,1342,364,222,157,0,157,0,98,0,0,empty,mBC-0716-2
"A4,H5",34574,37047,26120,10927,17381,0,8318,8335,6235,2100,2.969047619,4255,1682,1036,667,0,667,0,286,0,0.00149925,empty,mBC-0716-2
"A4,H6",13129,13466,9899,3567,6609,6,3011,3024,2128,896,2.375,1501,2023,1129,703,0,703,0,290,0,0.021337127,empty,mBC-0716-2
"A4,H7",15417,15650,11617,4033,7850,0,3615,3626,2559,1067,2.398313027,1756,1807,1140,646,0,646,0,293,0,0.015479876,empty,mBC-0716-2
"A4,H8",27058,29028,19896,9132,14379,11,7336,7365,5548,1817,3.0533847,3743,1749,1013,647,0,647,0,308,0,0.052550232,empty,mBC-0716-2
"A4,H9",917568,1070747,586181,484566,513739,1,339825,340235,271118,69117,3.92259502,206141,71204,46574,25769,9,25760,1,2874,0,0.001940994,mm10,mBC-0716-2
"A4,H10",637370,669795,458179,211616,322212,1,167240,167580,143308,24272,5.904251813,87953,71545,47376,26323,11,26312,1,2902,0,0.000684099,mm10,mBC-0716-2
"A4,H11",14709,15286,11071,4215,7327,3,3363,3376,2305,1071,2.152194211,1583,275,174,118,0,118,0,92,0,0.008474576,empty,mBC-0716-2
"A4,H12",5707,6026,4292,1734,2928,1,1369,1370,941,429,2.193473193,693,671,386,236,0,236,0,118,0,0,empty,mBC-0716-2
"A5,A1",15842,16575,12117,4458,8356,0,3933,3939,2731,1208,2.260761589,1925,1524,786,416,0,416,0,169,0,0.057692308,empty,mBC-0716-2
"A5,A2",22095,22078,16303,5775,10589,0,4783,4792,3379,1413,2.391365888,2305,21736,6315,3933,1,3932,1,978,0,0.092573754,empty,mBC-0716-2
"A5,A3",684037,708987,514092,194895,348770,2,167475,167776,133191,34585,3.851120428,83587,21308,11161,6106,2,6104,1,1344,0,0.019495413,mm10,mBC-0716-2
"A5,A4",22091,22567,17093,5474,10933,0,4842,4859,3466,1393,2.488155061,2243,2780,847,534,0,534,0,230,0,0.013108614,empty,mBC-0716-2
"A5,A5",19832,20497,15076,5421,10137,15,4639,4668,3247,1421,2.285010556,2273,2270,1329,812,1,811,1,268,0,0.027127004,empty,mBC-0716-2
"A5,A6",13757,14284,10378,3906,7067,2,3342,3360,2372,988,2.400809717,1641,1285,772,492,0,492,0,233,0,0.042682927,empty,mBC-0716-2
"A5,A7",16864,17800,12736,5064,8606,2,4083,4094,2790,1304,2.139570552,2018,1050,627,386,0,386,0,149,0,0.049222798,empty,mBC-0716-2
"A5,A8",11769,12409,8857,3552,6242,0,2956,2963,2122,841,2.523186683,1492,1337,795,484,0,484,0,190,0,0.04338843,empty,mBC-0716-2
"A5,A9",21269,21565,16406,5159,10660,0,4794,4810,3412,1398,2.440629471,2187,7246,2456,1438,3,1435,2,456,0,0.048083624,empty,mBC-0716-2
"A5,A10",17053,17617,13065,4552,8604,0,3962,3971,2818,1153,2.444058977,1881,412,226,150,0,150,0,91,0,0.006666667,empty,mBC-0716-2
"A5,A11",19595,19743,14975,4768,9689,0,4300,4311,3042,1269,2.397163121,1986,1191,704,422,1,421,1,176,0,0.052256532,empty,mBC-0716-2
"A5,A12",21452,21942,16470,5472,10716,0,4801,4810,3399,1411,2.408929837,2297,5902,2419,1413,0,1413,0,415,0,0.048124558,empty,mBC-0716-2
"A5,B1",20328,21192,15714,5478,10166,24,4667,4700,3183,1517,2.098220171,2271,1308,716,464,0,464,0,208,0,0.092672414,empty,mBC-0716-2
"A5,B2",1106702,1189189,795350,393839,576624,20,310080,310547,219652,90895,2.416546565,167806,17153,10682,5907,1,5906,1,1138,0,0.001862513,mm10,mBC-0716-2
"A5,B3",21274,22153,16219,5934,10610,19,4892,4924,3400,1524,2.230971129,2271,1190,709,462,0,462,0,179,0,0.114718615,empty,mBC-0716-2
"A5,B4",17565,18135,13417,4718,8911,6,4081,4099,2877,1222,2.354337152,1981,2126,927,552,0,552,0,205,0,0.028985507,empty,mBC-0716-2
"A5,B5",11352,7421,5060,2361,4636,0,2279,2299,1637,662,2.472809668,1277,675,393,228,0,228,0,120,0,0.030701754,empty,mBC-0716-2
"A5,B6",478483,509563,353032,156531,254713,9,130887,131119,96397,34722,2.776251368,68682,17404,11087,6292,5,6287,2,1222,0,0.003658343,mm10,mBC-0716-2
"A5,B7",16986,17755,13008,4747,8655,11,3863,3882,2719,1163,2.337919175,1863,1044,583,353,1,352,1,154,0,0.076704545,empty,mBC-0716-2
"A5,B8",14470,14994,10997,3997,7322,73,3255,3330,2337,993,2.35347432,1570,1308,771,468,0,468,0,206,0,0.044871795,empty,mBC-0716-2
"A5,B9",833474,904479,602934,301545,436602,2,238728,239067,205436,33631,6.10853082,126651,34812,20433,11474,2,11472,1,1764,0,0.002179219,mm10,mBC-0716-2
"A5,B10",17663,17702,13233,4469,8918,0,4146,4157,2814,1343,2.09530901,1940,504,310,190,0,190,0,93,0,0.036842105,empty,mBC-0716-2
"A5,B11",1071278,1147223,784525,362698,544327,1,283556,284021,225522,58499,3.855142823,149799,2612,1688,943,1,942,1,281,0,0.002123142,empty,mBC-0716-2
"A5,B12",18733,19639,14228,5411,9784,2,4520,4535,3158,1377,2.293391431,2223,1518,930,546,2,544,1,184,0,0.036764706,empty,mBC-0716-2
"A5,C1",22917,23075,17911,5164,11264,0,4728,4741,3306,1435,2.303832753,2119,697,418,242,0,242,0,113,0,0.049586777,empty,mBC-0716-2
"A5,C2",812602,883301,585173,298128,431370,1,238577,238919,181717,57202,3.176759554,128948,33703,18210,10558,3,10555,1,1750,0,0.033728091,mm10,mBC-0716-2
"A5,C3",20939,21706,15760,5946,10522,8,4922,4940,3454,1486,2.3243607,2427,641,343,211,0,211,0,95,0,0.090047393,empty,mBC-0716-2
"A5,C4",18968,19161,14312,4849,9421,23,4138,4178,2883,1295,2.226254826,1979,1091,578,315,0,315,0,131,0,0.031746032,empty,mBC-0716-2
"A5,C5",1086349,1294943,708243,586700,630372,5,418112,418694,318781,99913,3.19058581,253608,78277,50488,28407,11,28396,1,2932,0,0.000739541,mm10,mBC-0716-2
"A5,C6",18425,19164,13754,5410,9598,0,4594,4599,3252,1347,2.414253898,2272,1331,824,480,0,480,0,191,0,0.072916667,empty,mBC-0716-2
"A5,C7",504452,515363,370021,145342,260257,32,128176,128443,103941,24502,4.242143498,64702,3469,1737,1008,1,1007,1,357,0,0.015888779,mm10,mBC-0716-2
"A5,C8",773842,840113,566083,274030,417694,0,222416,222769,161916,60853,2.660772682,118666,56937,37960,21404,5,21399,1,2630,0,0.002944063,mm10,mBC-0716-2
"A5,C9",13784,14380,10449,3931,7089,9,3370,3388,2369,1019,2.324828263,1689,682,402,285,0,285,0,129,0,0.049122807,empty,mBC-0716-2
"A5,C10",14868,15315,11391,3924,7504,0,3490,3496,2470,1026,2.407407407,1657,1156,712,410,0,410,0,163,0,0.048780488,empty,mBC-0716-2
"A5,C11",12431,12841,9326,3515,6318,21,2942,2969,2082,887,2.34723788,1449,1671,866,490,0,490,0,188,0,0.051020408,empty,mBC-0716-2
"A5,C12",20444,21398,15543,5855,10517,0,4888,4895,3406,1489,2.287441236,2460,1734,784,471,0,471,0,193,0,0.010615711,empty,mBC-0716-2
"A5,D1",12741,13566,9611,3955,6733,0,3301,3306,2319,987,2.349544073,1684,600,372,237,1,236,1,108,0,0.050847458,empty,mBC-0716-2
"A5,D2",21430,21832,16379,5453,11045,11,4893,4910,3479,1431,2.431167016,2340,2289,1348,850,1,849,1,323,0,0.00942285,empty,mBC-0716-2
"A5,D3",875788,984534,615808,368726,482674,31,283728,284117,231319,52798,4.381207622,159240,50104,30428,17282,7,17275,1,2257,0,0.003357453,mm10,mBC-0716-2
"A5,D4",15268,15895,11730,4165,7889,0,3559,3565,2524,1041,2.424591739,1689,1284,807,525,0,525,0,233,0,0.066666667,empty,mBC-0716-2
"A5,D5",15283,15505,11547,3958,7584,16,3426,3450,2457,993,2.474320242,1624,2907,1162,719,1,718,1,248,0,0.026462396,empty,mBC-0716-2
"A5,D6",13375,14133,10107,4026,6894,29,3330,3364,2299,1065,2.158685446,1623,1345,747,453,1,452,1,192,0,0.048672566,empty,mBC-0716-2
"A5,D7",13900,14635,10571,4064,7017,0,3276,3276,2269,1007,2.253227408,1626,1283,724,429,0,429,0,188,0,0.03962704,empty,mBC-0716-2
"A5,D8",16886,17599,12674,4925,8625,12,4015,4036,2818,1218,2.3136289,2000,2437,986,610,0,610,0,235,0,0.054098361,empty,mBC-0716-2
"A5,D9",6606,6926,4846,2080,3504,0,1696,1704,1211,493,2.456389452,851,12924,4266,2590,3,2587,1,751,0,0.06803247,empty,mBC-0716-2
"A5,D10",15117,16043,11344,4699,8034,0,3912,3912,2766,1146,2.413612565,2028,1463,629,329,2,327,1,130,0,0.119266055,empty,mBC-0716-2
"A5,D11",1254841,1300515,933531,366984,632660,2,316559,317112,249323,67789,3.677927097,159925,36007,21560,12269,6,12263,1,2111,0,0.004321944,mm10,mBC-0716-2
"A5,D12",20729,20842,15794,5048,10282,1,4670,4680,3294,1386,2.376623377,2113,2387,1508,825,0,825,0,261,0,0.071515152,empty,mBC-0716-2
"A5,E1",23458,23813,17998,5815,11591,1,5227,5239,3708,1531,2.42194644,2450,1490,918,567,0,567,0,234,0,0.05643739,empty,mBC-0716-2
"A5,E2",17421,18102,13145,4957,8894,4,4078,4091,2872,1219,2.356029532,1961,4666,1649,955,0,955,0,305,0,0.046073298,empty,mBC-0716-2
"A5,E3",12843,13177,9682,3495,6492,6,2985,2997,2128,869,2.448791715,1414,5387,1994,1218,0,1218,0,399,0,0.157635468,empty,mBC-0716-2
"A5,E4",1018935,1114824,716627,398197,535108,1,305233,305691,253378,52313,4.843499704,167040,65861,42762,24185,12,24173,2,2737,0,0.001116949,mm10,mBC-0716-2
"A5,E5",21619,21980,16760,5220,10839,0,4768,4772,3352,1420,2.36056338,2155,1307,759,464,0,464,0,205,0,0.060344828,empty,mBC-0716-2
"A5,E6",15070,15653,11432,4221,7661,27,3442,3480,2447,1033,2.368828654,1741,1442,830,527,1,526,1,224,0,0.032319392,empty,mBC-0716-2
"A5,E7",14564,14894,11148,3746,7288,0,3338,3348,2319,1029,2.253644315,1596,1169,684,421,1,420,1,159,0,0.1,empty,mBC-0716-2
"A5,E8",18311,18917,14056,4861,9175,0,4008,4014,2765,1249,2.213771017,1844,2453,1125,667,0,667,0,262,0,0.04047976,empty,mBC-0716-2
"A5,E9",9978,10478,7603,2875,5044,5,2302,2313,1623,690,2.352173913,1126,1680,777,450,1,449,1,171,0,0.035634744,empty,mBC-0716-2
"A5,E10",14095,14499,10743,3756,7104,32,3276,3320,2366,954,2.480083857,1596,1229,732,431,0,431,0,163,0,0.05800464,empty,mBC-0716-2
"A5,E11",10015,10362,7583,2779,5125,13,2356,2372,1652,720,2.294444444,1108,975,556,351,2,349,1,149,0,0.042979943,empty,mBC-0716-2
"A5,E12",16626,17380,12739,4641,8777,0,4152,4162,2851,1311,2.17467582,2047,1010,534,339,0,339,0,143,0,0.056047198,empty,mBC-0716-2
"A5,F1",19080,19620,14437,5183,9620,14,4364,4384,3070,1314,2.336377473,2063,1482,849,534,1,533,1,217,0,0.061913696,empty,mBC-0716-2
"A5,F2",24004,25059,18229,6830,12436,3,5742,5763,4036,1727,2.337000579,2813,3018,1682,1002,1,1001,1,377,0,0.021978022,empty,mBC-0716-2
"A5,F3",890747,1026866,603022,423844,504757,0,317111,317556,218505,99051,2.205984796,185560,92681,56912,32029,10,32019,1,3082,0,0.001686499,mm10,mBC-0716-2
"A5,F4",17890,17846,13325,4521,8889,1,3961,3971,2886,1085,2.659907834,1898,363,220,136,0,136,0,74,0,0.014705882,empty,mBC-0716-2
"A5,F5",26382,27142,20284,6858,13336,0,6115,6123,4250,1873,2.269087026,2927,1873,1101,718,0,718,0,303,0,0.022284123,empty,mBC-0716-2
"A5,F6",30753,32530,23488,9042,15720,8,7432,7458,5392,2066,2.609874153,3667,2550,1422,855,0,855,0,295,0,0.019883041,empty,mBC-0716-2
"A5,F7",21458,22006,16449,5557,10794,0,4867,4877,3440,1437,2.393876131,2320,717,452,302,0,302,0,139,0,0.023178808,empty,mBC-0716-2
"A5,F8",23647,24093,17633,6460,11825,0,5551,5560,3904,1656,2.357487923,2718,492,230,151,0,151,0,90,0,0.006622517,empty,mBC-0716-2
"A5,F9",15833,15707,12101,3606,7862,4,3545,3558,2464,1094,2.252285192,1579,1591,946,555,0,555,0,197,0,0.057657658,empty,mBC-0716-2
"A5,F10",28340,29295,21794,7501,14080,20,6366,6391,4548,1843,2.467715681,3064,1528,854,497,0,497,0,194,0,0.024144869,empty,mBC-0716-2
"A5,F11",679342,713357,509806,203551,349654,0,169948,170292,133370,36922,3.612209523,85470,68488,44165,25260,13,25247,3,2878,0,0.001465521,mm10,mBC-0716-2
"A5,F12",15193,15727,11379,4348,7525,0,3572,3585,2491,1094,2.276965265,1814,108,63,48,0,48,0,31,0,0,empty,mBC-0716-2
"A5,G1",10439,10839,8149,2690,5347,0,2413,2415,1686,729,2.312757202,1134,2120,1108,649,0,649,0,247,0,0.023112481,empty,mBC-0716-2
"A5,G2",23184,23414,17368,6046,11401,12,5158,5176,3602,1574,2.288437103,2472,6066,1996,1170,1,1169,1,401,0,0.015397776,empty,mBC-0716-2
"A5,G3",977726,1134574,648854,485720,549614,1,348657,349123,280646,68477,4.098398002,206032,126503,80744,45017,19,44998,3,3923,0,0.000933375,mm10,mBC-0716-2
"A5,G4",944393,980219,704711,275508,474146,3,236431,236829,181161,55668,3.254311274,119067,292,173,105,0,105,0,49,0,0.019047619,empty,mBC-0716-2
"A5,G5",14671,15358,11113,4245,7482,7,3464,3481,2455,1026,2.392787524,1695,3008,1210,790,0,790,0,289,0,0.136708861,empty,mBC-0716-2
"A5,G6",3955462,4135452,2922370,1213082,1871103,5,1009284,1010959,838446,172513,4.860190247,511050,16704,10573,5975,2,5973,1,1168,0,0.00100452,mm10,mBC-0716-2
"A5,G7",20895,21384,16039,5345,10745,2,4869,4878,3489,1389,2.51187905,2308,1649,959,586,0,586,0,263,0,0.059726962,empty,mBC-0716-2
"A5,G8",16010,16938,12134,4804,8179,6,3915,3932,2739,1193,2.295892707,1965,1401,852,485,0,485,0,209,0,0.041237113,empty,mBC-0716-2
"A5,G9",11317,11435,8562,2873,5622,0,2566,2577,1791,786,2.278625954,1198,1114,655,416,0,416,0,189,0,0.019230769,empty,mBC-0716-2
"A5,G10",14378,14828,11084,3744,7321,0,3312,3315,2293,1022,2.243639922,1565,1286,777,495,0,495,0,199,0,0.042424242,empty,mBC-0716-2
"A5,G11",13056,13764,10036,3728,6672,23,3006,3030,2102,928,2.265086207,1478,740,461,285,0,285,0,131,0,0.038596491,empty,mBC-0716-2
"A5,G12",12817,13075,9743,3332,6473,4,2975,2980,2121,859,2.469150175,1411,7484,2273,1400,0,1400,0,379,0,0.093571429,empty,mBC-0716-2
"A5,H1",917192,1041442,633536,407906,508071,5,308953,309390,217198,92192,2.3559311,176550,21345,13290,7478,3,7475,1,1398,0,0.000936455,mm10,mBC-0716-2
"A5,H2",2174334,2440353,1508692,931661,1154641,3,691245,692257,483730,208527,2.319747563,401764,126766,83308,46633,24,46609,2,3895,0,0.001501856,mm10,mBC-0716-2
"A5,H3",23067,23870,17525,6345,11652,15,5450,5473,3843,1630,2.357668712,2576,1738,1012,595,0,595,0,244,0,0,empty,mBC-0716-2
"A5,H4",734594,773161,544640,228521,377030,13,191308,191588,143931,47657,3.020143945,98210,2522,1410,825,0,825,0,264,0,0.001212121,empty,mBC-0716-2
"A5,H5",19335,20132,14948,5184,9771,2,4526,4542,3185,1357,2.347089167,2122,1257,721,443,0,443,0,197,0,0.020316027,empty,mBC-0716-2
"A5,H6",15945,16458,12116,4342,8036,0,3713,3719,2611,1108,2.356498195,1826,1468,873,551,0,551,0,218,0,0.072595281,empty,mBC-0716-2
"A5,H7",1425758,1454992,1073575,381417,700905,3,326739,327330,257973,69357,3.719494788,159895,167216,105895,59538,22,59516,3,4580,0,0.002587539,mm10,mBC-0716-2
"A5,H8",14948,15393,11398,3995,7490,0,3428,3433,2468,965,2.557512953,1654,1457,827,503,1,502,1,227,0,0.027888446,empty,mBC-0716-2
"A5,H9",23028,23384,16212,7172,10959,6,5269,5288,3823,1465,2.609556314,2685,11631,4120,2572,2,2570,1,613,0,0.218677043,empty,mBC-0716-2
"A5,H10",571759,580377,429127,151250,285592,0,132369,132596,104673,27923,3.748630162,65394,7035,4393,2590,2,2588,1,785,0,0.005023184,mm10,mBC-0716-2
"A5,H11",17891,18733,13600,5133,9228,0,4336,4344,2998,1346,2.227340267,2182,249,166,116,0,116,0,76,0,0.068965517,empty,mBC-0716-2
"A5,H12",6889,7211,5120,2091,3574,0,1751,1758,1231,527,2.335863378,853,607,345,218,0,218,0,89,0,0.02293578,empty,mBC-0716-2
"A6,A1",14541,15022,10959,4063,7204,3,3336,3350,2369,981,2.414882773,1540,988,575,362,0,362,0,174,0,0.052486188,empty,mBC-0716-2
"A6,A2",18830,18893,14310,4583,8927,1,3931,3946,2755,1191,2.3131822,1774,1089,664,432,0,432,0,188,0,0.092592593,empty,mBC-0716-2
"A6,A3",16433,16844,12267,4577,8161,0,3814,3824,2719,1105,2.460633484,1859,1095,621,403,0,403,0,176,0,0.086848635,empty,mBC-0716-2
"A6,A4",22186,22530,16893,5637,10581,31,4609,4651,3347,1304,2.566717791,2190,629,397,262,0,262,0,155,0,0.053435115,empty,mBC-0716-2
"A6,A5",736532,831910,522804,309106,405240,0,232158,232471,186155,46316,4.019237413,129867,86617,57551,31904,20,31884,4,3214,0,0.000815456,mm10,mBC-0716-2
"A6,A6",13165,13475,9776,3699,6445,10,3086,3098,2171,927,2.341963323,1491,34363,10013,5916,14,5902,6,1302,0,0.044900034,empty,mBC-0716-2
"A6,A7",16186,16463,12440,4023,7900,0,3617,3628,2523,1105,2.283257919,1691,1086,655,405,0,405,0,163,0,0.024691358,empty,mBC-0716-2
"A6,A8",583584,675601,393266,282335,328595,0,205373,205650,167220,38430,4.351288056,119978,90346,54901,30860,19,30841,4,3324,0,0.001199702,mm10,mBC-0716-2
"A6,A9",21767,22142,16592,5550,10465,0,4695,4708,3308,1400,2.362857143,2190,7986,2828,1696,2,1694,1,509,0,0.090318772,empty,mBC-0716-2
"A6,A10",15698,15975,11805,4170,7867,8,3627,3649,2471,1178,2.09762309,1795,458,272,185,0,185,0,97,0,0.059459459,empty,mBC-0716-2
"A6,A11",17934,17927,13621,4306,8679,0,3921,3932,2782,1150,2.419130435,1788,3825,1513,928,1,927,1,309,0,0.065803668,empty,mBC-0716-2
"A6,A12",21235,21748,16307,5441,10094,34,4441,4500,3223,1277,2.523884103,2079,2966,1602,949,2,947,1,313,0,0.110876452,empty,mBC-0716-2
"A6,B1",695458,731035,499411,231624,354076,1,190512,190824,155579,35245,4.414214782,100676,6102,3506,1986,1,1985,1,634,0,0.007052897,mm10,mBC-0716-2
"A6,B2",20072,20704,15399,5305,9860,7,4365,4385,3013,1372,2.19606414,2041,470,286,176,0,176,0,86,0,0.119318182,empty,mBC-0716-2
"A6,B3",19961,20614,15331,5283,10039,0,4640,4646,3251,1395,2.33046595,2227,966,586,359,0,359,0,171,0,0.016713092,empty,mBC-0716-2
"A6,B4",923466,1038203,648370,389833,498073,1,292609,292983,185926,107057,1.73670101,167161,30497,19122,10893,3,10890,1,1654,0,0.002571166,mm10,mBC-0716-2
"A6,B5",14940,11830,7864,3966,6756,0,3509,3522,2727,795,3.430188679,1910,798,476,291,0,291,0,141,0,0.034364261,empty,mBC-0716-2
"A6,B6",776229,873875,528248,345627,419528,1,250284,250658,211585,39073,5.415120416,143144,59919,39057,21760,10,21750,1,2616,0,0.008781609,mm10,mBC-0716-2
"A6,B7",17100,17685,13132,4553,8380,0,3781,3793,2599,1194,2.176716918,1790,905,521,341,0,341,0,155,0,0.052785924,empty,mBC-0716-2
"A6,B8",13206,14051,10083,3968,6788,12,3110,3130,2184,946,2.308668076,1566,1110,678,432,0,432,0,223,0,0.0625,empty,mBC-0716-2
"A6,B9",15367,15945,11648,4297,7439,10,3335,3358,2301,1057,2.176915799,1676,757,459,288,0,288,0,139,0,0.017361111,empty,mBC-0716-2
"A6,B10",16252,16253,12092,4161,8055,2,3669,3681,2521,1160,2.173275862,1763,458,253,163,1,162,1,81,0,0.055555556,empty,mBC-0716-2
"A6,B11",18245,18934,13760,5174,9097,22,4228,4265,3050,1215,2.510288066,2089,254,131,93,0,93,0,62,0,0,empty,mBC-0716-2
"A6,B12",18688,19491,14199,5292,9257,9,4247,4263,2965,1298,2.284283513,2090,1310,783,456,0,456,0,172,0,0.127192982,empty,mBC-0716-2
"A6,C1",2664819,2764490,1981593,782897,1263656,24,668728,669847,451708,218139,2.070734715,339499,18045,7650,4277,3,4274,1,1055,0,0.024099204,mm10,mBC-0716-2
"A6,C2",18282,18739,13862,4877,8966,1,4135,4141,2800,1341,2.087994034,1958,1530,859,484,0,484,0,196,0,0.064049587,empty,mBC-0716-2
"A6,C3",21913,22674,16644,6030,10936,0,5160,5177,3711,1466,2.531377899,2511,640,387,230,0,230,0,98,0,0.091304348,empty,mBC-0716-2
"A6,C4",17420,17649,13366,4283,8432,8,3665,3679,2609,1070,2.438317757,1743,1036,661,411,1,410,1,168,0,0.048780488,empty,mBC-0716-2
"A6,C5",16436,16816,12253,4563,8358,2,3923,3934,2806,1128,2.487588652,1951,3675,1375,859,0,859,0,313,0,0.036088475,empty,mBC-0716-2
"A6,C6",816263,890248,583815,306433,440515,1,242436,242829,183902,58927,3.120844435,133488,44955,29049,16149,6,16143,1,2131,0,0.002973425,mm10,mBC-0716-2
"A6,C7",16315,16564,12233,4331,8070,2,3734,3743,2620,1123,2.333036509,1851,402,225,141,0,141,0,83,0,0.056737589,empty,mBC-0716-2
"A6,C8",14771,15447,11081,4366,7501,0,3576,3579,2491,1088,2.289522059,1706,1370,748,494,0,494,0,223,0,0.022267206,empty,mBC-0716-2
"A6,C9",763171,855300,538518,316782,411530,2,233947,234311,195293,39018,5.005202727,131288,61569,39498,22219,14,22205,1,2566,0,0.002747129,mm10,mBC-0716-2
"A6,C10",852605,901097,638794,262303,427012,2,210409,210743,174655,36088,4.839697406,107232,66821,35163,19876,12,19864,4,2534,0,0.017368103,mm10,mBC-0716-2
"A6,C11",12144,12622,9260,3362,5927,0,2779,2784,1947,837,2.326164875,1325,777,503,301,0,301,0,138,0,0.083056478,empty,mBC-0716-2
"A6,C12",995565,1068387,732807,335580,499670,11,260544,261006,216643,44363,4.88341636,137046,32514,21053,11912,3,11909,1,1805,0,0.004702326,mm10,mBC-0716-2
"A6,D1",11295,11684,8540,3144,5735,0,2653,2664,1908,756,2.523809524,1325,3890,1168,759,1,758,1,258,0,0.027704485,empty,mBC-0716-2
"A6,D2",20964,21225,16240,4985,10323,7,4536,4551,3240,1311,2.471395881,2071,3862,1840,1122,0,1122,0,410,0,0.064171123,empty,mBC-0716-2
"A6,D3",518709,545412,374993,170419,268472,3,141396,141628,105836,35792,2.956973625,74474,11579,7259,4104,7,4097,1,935,0,0.004881621,mm10,mBC-0716-2
"A6,D4",13977,14376,10557,3819,6981,10,3208,3221,2238,983,2.276703967,1564,1331,812,521,0,521,0,271,0,0.021113244,empty,mBC-0716-2
"A6,D5",670364,711548,494926,216622,344966,0,172753,173056,145795,27261,5.348116357,90103,32836,21249,11734,11,11723,1,1752,0,0.001194234,mm10,mBC-0716-2
"A6,D6",12058,12454,9084,3370,6122,0,2814,2821,1956,865,2.261271676,1357,1259,757,438,0,438,0,205,0,0.066210046,empty,mBC-0716-2
"A6,D7",33232,37239,24321,12918,17586,0,9644,9667,7017,2650,2.647924528,5183,1584,880,529,0,529,0,232,0,0.011342155,empty,mBC-0716-2
"A6,D8",17825,18792,13359,5433,9152,4,4504,4512,3132,1380,2.269565217,2232,3330,1174,740,0,740,0,288,0,0.059459459,empty,mBC-0716-2
"A6,D9",5054,5115,3732,1383,2605,7,1254,1261,897,364,2.464285714,617,1447,793,533,0,533,0,266,0,0.041275797,empty,mBC-0716-2
"A6,D10",13113,13456,9842,3614,6444,0,3010,3020,2113,907,2.329658214,1458,634,382,238,0,238,0,117,0,0.037815126,empty,mBC-0716-2
"A6,D11",13312,13552,10033,3519,6535,0,2986,2989,2170,819,2.64957265,1413,1369,833,495,1,494,1,232,0,0.056680162,empty,mBC-0716-2
"A6,D12",28077,29385,21375,8010,13866,4,6515,6540,4682,1858,2.519913886,3166,2631,1626,943,1,942,1,300,0,0.07537155,empty,mBC-0716-2
"A6,E1",21717,22114,16781,5333,10513,0,4500,4511,3167,1344,2.35639881,2038,1614,937,605,0,605,0,264,0,0.052892562,empty,mBC-0716-2
"A6,E2",16550,16963,12448,4515,8209,21,3726,3762,2584,1178,2.193548387,1777,2218,1042,573,0,573,0,230,0,0.055846422,empty,mBC-0716-2
"A6,E3",460863,484449,344634,139815,237114,1,117954,118147,90145,28002,3.21923434,59983,13032,6688,3795,6,3789,3,958,0,0.033518079,mm10,mBC-0716-2
"A6,E4",15901,16725,12076,4649,7782,9,3614,3627,2529,1098,2.303278689,1749,2941,1218,696,0,696,0,277,0,0.063218391,empty,mBC-0716-2
"A6,E5",1127151,1219179,817390,401789,576048,14,312035,312578,264508,48070,5.502558768,165573,70559,45322,25501,6,25495,1,2714,0,0.001608158,mm10,mBC-0716-2
"A6,E6",844236,928339,591562,336777,441326,23,252679,253107,187908,65199,2.882068743,141139,97566,59237,32947,10,32937,3,3344,0,0.001426967,mm10,mBC-0716-2
"A6,E7",13694,14263,10569,3694,6761,2,3075,3085,2091,994,2.10362173,1477,1132,650,421,0,421,0,207,0,0.014251781,empty,mBC-0716-2
"A6,E8",18068,18240,13695,4545,8595,24,3749,3781,2722,1059,2.570349386,1731,1423,802,527,0,527,0,203,0,0.045540797,empty,mBC-0716-2
"A6,E9",9095,9653,6684,2969,4522,1,2229,2232,1534,698,2.197707736,1154,885,511,317,0,317,0,149,0,0.022082019,empty,mBC-0716-2
"A6,E10",13093,13902,10013,3889,6675,17,3074,3100,2178,922,2.362255965,1533,1196,666,394,2,392,1,186,0,0.051020408,empty,mBC-0716-2
"A6,E11",8937,9154,6831,2323,4537,3,2067,2074,1446,628,2.302547771,948,1030,648,383,0,383,0,179,0,0.028720627,empty,mBC-0716-2
"A6,E12",765911,825389,551977,273412,399879,5,216897,217246,165021,52225,3.159808521,115866,30904,19427,10859,5,10854,1,1655,0,0.002671826,mm10,mBC-0716-2
"A6,F1",18319,18612,14046,4566,9092,25,4076,4110,2861,1249,2.290632506,1948,1463,953,610,0,610,0,259,0,0.050819672,empty,mBC-0716-2
"A6,F2",767597,815689,578359,237330,388851,13,185712,186075,155862,30213,5.158772714,94810,188375,125028,70092,45,70047,3,4567,0,0.00114209,mm10,mBC-0716-2
"A6,F3",568235,606058,416250,189808,297469,0,157461,157656,124798,32858,3.798100919,83017,12047,6897,3970,4,3966,2,975,0,0.008572869,mm10,mBC-0716-2
"A6,F4",15622,15951,11746,4205,7737,7,3509,3536,2475,1061,2.332704995,1685,480,289,201,0,201,0,102,0,0.009950249,empty,mBC-0716-2
"A6,F5",24778,25804,18755,7049,12283,14,5672,5700,4070,1630,2.496932515,2791,3415,1648,967,0,967,0,369,0,0.02688728,empty,mBC-0716-2
"A6,F6",23025,23660,17362,6298,11258,0,5204,5217,3644,1573,2.316592498,2560,2102,1252,683,0,683,0,278,0,0.054172767,empty,mBC-0716-2
"A6,F7",20609,20955,15762,5193,10110,25,4469,4498,3154,1344,2.34672619,2130,902,563,335,0,335,0,147,0,0.07761194,empty,mBC-0716-2
"A6,F8",22578,23121,17039,6082,11128,6,5121,5135,3628,1507,2.407431984,2448,334,216,146,0,146,0,99,0,0.006849315,empty,mBC-0716-2
"A6,F9",14790,14913,11272,3641,7182,0,3262,3268,2264,1004,2.25498008,1507,1255,775,438,0,438,0,185,0,0.043378995,empty,mBC-0716-2
"A6,F10",1350288,1480390,948464,531926,695145,0,409974,410633,290544,120089,2.419405608,224670,27529,17211,9613,8,9605,2,1520,0,0.003956273,mm10,mBC-0716-2
"A6,F11",1740057,1867263,1266343,600920,876489,7,468779,469549,383448,86101,4.453467439,248284,140726,89144,50113,19,50094,4,4198,0,0.002036172,mm10,mBC-0716-2
"A6,F12",14671,14886,11323,3563,7072,1,3239,3245,2272,973,2.335046249,1436,155,88,65,0,65,0,38,0,0.092307692,empty,mBC-0716-2
"A6,G1",10616,11332,8201,3131,5355,33,2329,2381,1691,690,2.450724638,1195,1471,906,540,0,540,0,218,0,0.055555556,empty,mBC-0716-2
"A6,G2",22111,22597,16911,5686,10743,4,4858,4876,3364,1512,2.224867725,2245,602,401,256,0,256,0,156,0,0.00390625,empty,mBC-0716-2
"A6,G3",20241,20643,15300,5343,10115,1,4735,4738,3185,1553,2.050869285,2222,1652,972,591,1,590,1,272,0,0.018644068,empty,mBC-0716-2
"A6,G4",28850,29212,22179,7033,13914,3,6049,6063,4300,1763,2.43902439,2876,187,119,89,0,89,0,66,0,0.011235955,empty,mBC-0716-2
"A6,G5",13773,14434,10498,3936,6814,0,3116,3123,2240,883,2.536806342,1492,1087,646,418,0,418,0,226,0,0.009569378,empty,mBC-0716-2
"A6,G6",24517,25180,18865,6315,12192,0,5484,5497,3920,1577,2.485732403,2612,234,137,92,0,92,0,59,0,0.02173913,empty,mBC-0716-2
"A6,G7",20459,21192,15766,5426,10162,0,4548,4556,3197,1359,2.352465048,2134,1698,970,637,0,637,0,261,0,0.043956044,empty,mBC-0716-2
"A6,G8",14826,15559,11328,4231,7399,29,3428,3460,2443,1017,2.402163225,1618,1977,1046,632,0,632,0,297,0,0.050632911,empty,mBC-0716-2
"A6,G9",10690,10874,8115,2759,5215,0,2340,2348,1604,744,2.155913978,1071,5812,1910,1174,1,1173,1,419,0,0.023870418,empty,mBC-0716-2
"A6,G10",13702,13893,10524,3369,6850,3,3111,3128,2189,939,2.331203408,1487,1527,959,579,0,579,0,250,0,0.001727116,empty,mBC-0716-2
"A6,G11",12097,12612,9208,3404,6083,0,2771,2776,1985,791,2.509481669,1366,651,400,250,0,250,0,121,0,0.036,empty,mBC-0716-2
"A6,G12",11239,11935,8360,3575,5830,0,2798,2802,1944,858,2.265734266,1431,1088,609,366,0,366,0,161,0,0.035519126,empty,mBC-0716-2
"A6,H1",21117,21871,16090,5781,10501,16,4826,4855,3474,1381,2.515568429,2325,844,524,347,0,347,0,160,0,0.060518732,empty,mBC-0716-2
"A6,H2",26967,27400,20433,6967,13153,0,5928,5937,4328,1609,2.689869484,2819,2052,1198,713,1,712,1,306,0,0.019662921,empty,mBC-0716-2
"A6,H3",1530821,1634124,1109737,524387,772630,1,415640,416333,329423,86910,3.79039236,219553,101263,58664,33384,15,33369,2,3502,0,0.008780605,mm10,mBC-0716-2
"A6,H4",737327,790141,540143,249998,378628,9,195728,196044,155364,40680,3.819174041,103095,3948,2352,1290,1,1289,1,375,0,0.003878976,mm10,mBC-0716-2
"A6,H5",17754,18247,13269,4978,8633,0,4015,4026,2817,1209,2.330024814,1947,1563,921,557,0,557,0,230,0,0.052064632,empty,mBC-0716-2
"A6,H6",615837,656627,444641,211986,319222,1,173328,173628,126424,47204,2.678247606,91711,16530,10508,6007,2,6005,1,1170,0,0.004662781,mm10,mBC-0716-2
"A6,H7",856154,942714,601431,341283,455609,1,258436,258813,209828,48985,4.283515362,143643,86674,54659,30776,17,30759,3,3102,0,0.001137878,mm10,mBC-0716-2
"A6,H8",13308,13774,10034,3740,6703,4,3170,3186,2254,932,2.418454936,1566,1438,849,525,0,525,0,234,0,0.04,empty,mBC-0716-2
"A6,H9",845357,874556,623929,250627,417598,4,200053,200410,175184,25226,6.944580988,101527,91135,56919,32112,18,32094,1,3292,0,0.002897738,mm10,mBC-0716-2
"A6,H10",1224156,1347355,834133,513222,645065,23,386035,386610,297724,88886,3.349503859,218953,61673,37196,20781,16,20765,3,2704,0,0.00187816,mm10,mBC-0716-2
"A6,H11",17067,17664,12886,4778,8365,12,3899,3922,2677,1245,2.150200803,1906,415,189,124,0,124,0,60,0,0,empty,mBC-0716-2
"A6,H12",5884,6114,4392,1722,3049,0,1484,1495,1036,459,2.25708061,735,629,380,236,0,236,0,104,0,0.050847458,empty,mBC-0716-2
"A7,A1",25280,26344,19513,6831,12932,1,5768,5777,4224,1553,2.719896974,2774,1435,808,479,0,479,0,214,0,0.043841336,empty,mBC-0716-2
"A7,A2",929847,945891,691830,254061,453819,10,220136,220579,151585,68994,2.197075108,110114,8936,5074,2898,1,2897,1,841,0,0.010700725,mm10,mBC-0716-2
"A7,A3",19254,20018,14665,5353,9688,0,4542,4553,3270,1283,2.548713952,2218,1104,669,404,0,404,0,193,0,0.051980198,empty,mBC-0716-2
"A7,A4",23686,24193,18202,5991,11660,2,5103,5114,3615,1499,2.411607738,2389,602,357,223,0,223,0,122,0,0.035874439,empty,mBC-0716-2
"A7,A5",20294,21430,15296,6134,10505,9,4933,4948,3461,1487,2.327505044,2444,2449,1165,740,1,739,1,310,0,0.00541272,empty,mBC-0716-2
"A7,A6",19373,20424,14697,5727,10082,7,4980,5002,3728,1274,2.926216641,2506,1614,976,564,0,564,0,254,0,0.017730496,empty,mBC-0716-2
"A7,A7",17954,18497,13639,4858,9037,6,4159,4176,2927,1249,2.34347478,1936,1129,670,409,0,409,0,181,0,0.029339853,empty,mBC-0716-2
"A7,A8",672603,741767,486697,255070,363354,1,196972,197307,162517,34790,4.671371084,106241,169439,108229,60675,22,60653,3,4449,0,0.001813595,mm10,mBC-0716-2
"A7,A9",20481,20632,15839,4793,10050,0,4447,4453,3146,1307,2.407039021,2062,1194,717,449,0,449,0,226,0,0.028953229,empty,mBC-0716-2
"A7,A10",18797,19457,14369,5088,9424,14,4287,4315,3009,1306,2.303981623,2030,421,247,166,0,166,0,103,0,0.078313253,empty,mBC-0716-2
"A7,A11",1414622,1513493,1030595,482898,732595,5,392717,393305,306035,87270,3.506760628,207251,53218,34896,19994,10,19984,1,2435,0,0.000900721,mm10,mBC-0716-2
"A7,A12",573102,600428,428870,171558,293704,0,145563,145838,113472,32366,3.505901254,73655,18038,10234,5853,1,5852,1,1240,0,0.011961722,mm10,mBC-0716-2
"A7,B1",1026927,1143239,720671,422568,548368,2,313164,313677,262838,50839,5.170007278,174857,99960,63403,35687,12,35675,3,3460,0,0.000953048,mm10,mBC-0716-2
"A7,B2",20893,21378,15870,5508,10391,4,4697,4706,3341,1365,2.447619048,2224,468,270,171,0,171,0,90,0,0.052631579,empty,mBC-0716-2
"A7,B3",21898,22814,16669,6145,11188,1,5049,5057,3556,1501,2.369087275,2486,1145,702,429,0,429,0,202,0,0.025641026,empty,mBC-0716-2
"A7,B4",18067,18604,13961,4643,9071,0,4063,4067,2843,1224,2.322712418,1920,1153,666,434,1,433,1,179,0,0.013856813,empty,mBC-0716-2
"A7,B5",808481,480950,278691,202259,316045,5,193319,194435,144264,50171,2.875445975,118507,54808,34273,19111,7,19104,1,2378,0,0.002774288,mm10,mBC-0716-2
"A7,B6",14639,15462,10971,4491,7632,6,3616,3635,2590,1045,2.4784689,1885,1133,728,465,0,465,0,197,0,0.049462366,empty,mBC-0716-2
"A7,B7",17310,17766,13275,4491,8834,0,3989,4003,2913,1090,2.672477064,1869,1429,754,415,1,414,1,174,0,0.026570048,empty,mBC-0716-2
"A7,B8",757313,843226,530700,312526,412095,13,239927,240317,201069,39248,5.123038117,133256,45179,29285,16500,9,16491,2,2282,0,0.002061731,mm10,mBC-0716-2
"A7,B9",16177,16726,12381,4345,7949,5,3532,3542,2479,1063,2.332079022,1635,840,518,350,0,350,0,166,0,0.062857143,empty,mBC-0716-2
"A7,B10",687515,691806,478790,213016,349539,2,184486,185036,145909,39127,3.729112889,96383,3991,2499,1371,0,1371,0,383,0,0.005105762,mm10,mBC-0716-2
"A7,B11",18720,19247,14333,4914,9239,1,4237,4240,2966,1274,2.328100471,2014,305,182,139,0,139,0,96,0,0,empty,mBC-0716-2
"A7,B12",20216,20819,15545,5274,10291,0,4702,4713,3288,1425,2.307368421,2216,1432,905,517,0,517,0,202,0,0.034816248,empty,mBC-0716-2
"A7,C1",29866,30203,23096,7107,14495,0,6279,6293,4556,1737,2.622913069,2900,1358,727,430,0,430,0,185,0,0.090697674,empty,mBC-0716-2
"A7,C2",21622,22598,16424,6174,10715,0,4896,4904,3330,1574,2.115628971,2427,1504,896,551,0,551,0,206,0,0.076225045,empty,mBC-0716-2
"A7,C3",22366,22495,17056,5439,11011,0,5113,5120,3608,1512,2.386243386,2349,1066,482,317,0,317,0,135,0,0.028391167,empty,mBC-0716-2
"A7,C4",27839,29184,21518,7666,14219,1,6554,6573,4610,1963,2.348446256,3184,5229,1997,1122,1,1121,1,376,0,0.035682426,empty,mBC-0716-2
"A7,C5",19307,20099,14661,5438,9745,100,4451,4557,3186,1371,2.323851204,2242,1499,929,562,0,562,0,257,0,0.048042705,empty,mBC-0716-2
"A7,C6",970915,1058195,689643,368552,524336,14,288071,288571,240502,48069,5.003266138,156381,183869,121573,68464,22,68442,2,4664,0,0.000847433,mm10,mBC-0716-2
"A7,C7",44749,48089,33974,14115,23152,0,11262,11291,9008,2283,3.945685502,5705,830,501,342,0,342,0,139,0,0.029239766,empty,mBC-0716-2
"A7,C8",17303,18057,12963,5094,8847,5,4094,4108,2865,1243,2.304907482,2037,1764,1021,624,1,623,1,251,0,0.014446228,empty,mBC-0716-2
"A7,C9",15026,15945,11432,4513,7705,20,3591,3616,2504,1112,2.251798561,1800,926,512,322,1,321,1,155,0,0.046728972,empty,mBC-0716-2
"A7,C10",15029,15732,11456,4276,7765,14,3507,3533,2470,1063,2.323612418,1741,1086,670,408,0,408,0,170,0,0.044117647,empty,mBC-0716-2
"A7,C11",13097,13608,9829,3779,6637,1,3200,3205,2242,963,2.328141225,1552,942,617,359,0,359,0,153,0,0.013927577,empty,mBC-0716-2
"A7,C12",22876,23353,17496,5857,11233,40,5027,5082,3518,1564,2.249360614,2364,1166,622,400,0,400,0,163,0,0.0275,empty,mBC-0716-2
"A7,D1",14443,15153,10732,4421,7364,6,3537,3552,2488,1064,2.338345865,1741,650,385,221,1,220,1,111,0,0.027272727,empty,mBC-0716-2
"A7,D2",1114960,1231726,775557,456169,594215,7,357545,358047,275808,82239,3.353737278,198108,71600,44282,24410,8,24402,2,2859,0,0.002622736,mm10,mBC-0716-2
"A7,D3",16128,16795,12130,4665,8213,13,3913,3935,2723,1212,2.24669967,1950,1107,610,403,1,402,1,201,0,0.012437811,empty,mBC-0716-2
"A7,D4",18058,18687,13859,4828,9058,18,4149,4179,2972,1207,2.462303231,2017,2113,1053,649,1,648,1,315,0,0.023148148,empty,mBC-0716-2
"A7,D5",583088,621304,430582,190722,308124,4,159512,159754,114132,45622,2.501687782,84551,10551,5721,3208,0,3208,0,814,0,0.011533666,mm10,mBC-0716-2
"A7,D6",15264,16074,11567,4507,7665,16,3688,3712,2615,1097,2.383773929,1833,1786,949,548,2,546,2,217,0,0.04029304,empty,mBC-0716-2
"A7,D7",15469,16232,11578,4654,7892,6,3754,3765,2564,1201,2.134887594,1891,1481,879,492,0,492,0,214,0,0.010162602,empty,mBC-0716-2
"A7,D8",18799,20012,14180,5832,9540,1,4581,4588,3313,1275,2.598431373,2289,1226,661,386,1,385,1,175,0,0.038961039,empty,mBC-0716-2
"A7,D9",7822,8207,5825,2382,4084,0,1988,1989,1430,559,2.558139535,954,3694,1593,964,1,963,1,380,0,0.035306334,empty,mBC-0716-2
"A7,D10",15847,16587,11780,4807,8084,0,3860,3868,2682,1186,2.261382799,1991,712,393,218,0,218,0,119,0,0.027522936,empty,mBC-0716-2
"A7,D11",14868,15736,11239,4497,7864,4,3817,3822,2708,1114,2.430879713,1922,1652,980,601,0,601,0,276,0,0.016638935,empty,mBC-0716-2
"A7,D12",23193,23527,17645,5882,11328,20,5180,5219,3560,1659,2.145871007,2492,14770,5100,3018,3,3015,2,810,0,0.062354892,empty,mBC-0716-2
"A7,E1",25349,25969,19447,6522,12428,0,5572,5583,3930,1653,2.377495463,2647,1544,884,577,0,577,0,249,0,0.024263432,empty,mBC-0716-2
"A7,E2",914757,1004522,654703,349819,487923,2,270886,271341,225183,46158,4.878525933,147404,80033,46778,26371,14,26357,4,2993,0,0.006829305,mm10,mBC-0716-2
"A7,E3",854781,988484,562962,425522,481401,15,312942,313373,249978,63395,3.943181639,184707,71950,43741,24574,8,24566,1,2760,0,0.005047627,mm10,mBC-0716-2
"A7,E4",2255512,2580123,1531805,1048318,1211802,32,765552,766634,563730,202904,2.778308954,444076,144637,84523,48356,17,48339,1,4250,0,0.003971948,mm10,mBC-0716-2
"A7,E5",23347,24329,17733,6596,11717,0,5247,5266,3631,1635,2.220795107,2557,6697,2342,1385,3,1382,1,446,0,0.030390738,empty,mBC-0716-2
"A7,E6",16575,16999,12644,4355,8218,0,3758,3768,2638,1130,2.334513274,1764,1952,1093,675,0,675,0,307,0,0.05037037,empty,mBC-0716-2
"A7,E7",15910,16320,12109,4211,7960,1,3656,3664,2599,1065,2.440375587,1708,1211,723,460,0,460,0,200,0,0.045652174,empty,mBC-0716-2
"A7,E8",20036,20294,15367,4927,10071,5,4479,4498,3170,1328,2.387048193,2080,1989,1101,665,0,665,0,247,0,0.045112782,empty,mBC-0716-2
"A7,E9",11242,11533,8438,3095,5697,0,2600,2607,1807,800,2.25875,1259,3427,1274,733,2,731,1,231,0,0.038303694,empty,mBC-0716-2
"A7,E10",14788,15324,11126,4198,7482,46,3458,3516,2440,1076,2.267657993,1720,7782,2435,1476,2,1474,2,512,0,0.021709634,empty,mBC-0716-2
"A7,E11",798590,869212,580429,288783,425283,6,226741,227093,190022,37071,5.125893556,121073,92220,57244,31669,20,31649,2,3278,0,0.002116971,mm10,mBC-0716-2
"A7,E12",18003,18820,13747,5073,9386,0,4443,4447,3155,1292,2.441950464,2187,1084,638,350,1,349,1,157,0,0.025787966,empty,mBC-0716-2
"A7,F1",1618878,1714867,1222237,492630,817274,1,418564,419267,343951,75316,4.566772001,212277,34138,22085,12116,5,12111,2,1834,0,0.003385352,mm10,mBC-0716-2
"A7,F2",26249,27326,19812,7514,13385,8,6213,6228,4430,1798,2.463848721,3102,5339,2414,1518,3,1515,1,549,0,0.02310231,empty,mBC-0716-2
"A7,F3",1017797,1069570,761367,308203,510753,0,244324,244768,208021,36747,5.660897488,123785,139501,88254,49077,26,49051,3,4112,0,0.00193676,mm10,mBC-0716-2
"A7,F4",20069,20464,15166,5298,10128,40,4487,4542,3172,1370,2.315328467,2255,572,332,203,0,203,0,111,0,0.034482759,empty,mBC-0716-2
"A7,F5",28071,29455,21094,8361,14210,3,6611,6634,4619,2015,2.292307692,3354,4887,1982,1221,1,1220,1,451,0,0.035245902,empty,mBC-0716-2
"A7,F6",28273,29029,21368,7661,13952,0,6532,6553,4634,1919,2.414799375,3208,12640,4667,2929,3,2926,1,841,0,0.046479836,empty,mBC-0716-2
"A7,F7",22456,23246,17305,5941,11356,8,5060,5092,3572,1520,2.35,2431,1008,616,368,0,368,0,190,0,0,empty,mBC-0716-2
"A7,F8",26213,27011,20080,6931,13316,0,6161,6176,4335,1841,2.354698533,2925,362,225,160,0,160,0,111,0,0.025,empty,mBC-0716-2
"A7,F9",18643,19322,13856,5466,9255,0,4290,4300,3025,1275,2.37254902,2135,14870,4623,2819,3,2816,2,752,0,0.039417614,empty,mBC-0716-2
"A7,F10",22184,22317,17083,5234,10890,0,4740,4761,3408,1353,2.518847007,2196,1080,663,423,0,423,0,199,0,0.047281324,empty,mBC-0716-2
"A7,F11",13056,13554,10084,3470,6628,17,2965,2988,2092,896,2.334821429,1440,1166,693,442,1,441,1,200,0,0.0430839,empty,mBC-0716-2
"A7,F12",17009,17792,12566,5226,8376,21,3966,4003,2810,1193,2.355406538,2070,2385,716,449,1,448,1,167,0,0.035714286,empty,mBC-0716-2
"A7,G1",445289,471128,343188,127940,233826,0,106392,106602,80759,25843,3.124985489,52886,88140,47625,26913,23,26890,4,3125,0,0.025399777,mm10,mBC-0716-2
"A7,G2",1211495,1390411,804421,585990,666508,0,425104,425657,358757,66900,5.362585949,247538,39569,25817,14697,5,14692,1,1924,0,0.000748707,mm10,mBC-0716-2
"A7,G3",1037458,1155750,735174,420576,558104,3,331045,331463,226962,104501,2.171864384,182573,41092,22970,12852,2,12850,1,2031,0,0.007782101,mm10,mBC-0716-2
"A7,G4",31070,32046,23918,8128,15562,10,6832,6852,4856,1996,2.432865731,3212,198,138,103,1,102,1,79,0,0,empty,mBC-0716-2
"A7,G5",15186,15507,11560,3947,7638,1,3438,3457,2426,1031,2.353055286,1645,1405,818,486,0,486,0,231,0,0.034979424,empty,mBC-0716-2
"A7,G6",26370,26746,20336,6410,13169,5,5795,5814,4091,1723,2.374347069,2698,272,163,122,0,122,0,79,0,0.008196721,empty,mBC-0716-2
"A7,G7",750514,798216,563746,234470,390816,2,197621,197924,144309,53615,2.691578849,101271,29568,19168,10891,2,10889,1,1798,0,0.001836716,mm10,mBC-0716-2
"A7,G8",16654,17108,12682,4426,8455,0,3975,3979,2846,1133,2.511915269,1891,1465,848,547,0,547,0,260,0,0.047531993,empty,mBC-0716-2
"A7,G9",716965,792549,513724,278825,389961,4,220423,220719,164697,56022,2.939862911,120771,34251,21429,11944,4,11940,2,1864,0,0.003433836,mm10,mBC-0716-2
"A7,G10",15143,15605,11623,3982,7630,2,3408,3425,2398,1027,2.334956183,1600,1574,986,567,1,566,1,277,0,0.026501767,empty,mBC-0716-2
"A7,G11",13839,13922,10785,3137,6893,0,3079,3088,2184,904,2.415929204,1434,768,489,305,0,305,0,138,0,0.068852459,empty,mBC-0716-2
"A7,G12",13941,14138,10552,3586,6954,15,3211,3234,2333,901,2.589345172,1534,2223,1066,632,0,632,0,230,0,0.058544304,empty,mBC-0716-2
"A7,H1",678708,740172,496202,243970,363160,0,193027,193372,130943,62429,2.097470727,106777,7107,4581,2553,2,2551,1,630,0,0.009408075,mm10,mBC-0716-2
"A7,H2",26944,27750,20313,7437,13396,0,6185,6203,4402,1801,2.444197668,2939,2038,1308,803,1,802,1,332,0,0.06234414,empty,mBC-0716-2
"A7,H3",938016,1011630,684210,327420,484682,3,254720,255062,214132,40930,5.231663816,135100,67504,43893,24533,11,24522,3,2727,0,0.001671968,mm10,mBC-0716-2
"A7,H4",17356,18125,13232,4893,8791,1,4155,4163,2944,1219,2.41509434,1994,271,157,109,1,108,1,76,0,0.009259259,empty,mBC-0716-2
"A7,H5",20015,20712,15090,5622,10116,0,4733,4741,3382,1359,2.488594555,2344,1519,904,559,0,559,0,219,0,0.030411449,empty,mBC-0716-2
"A7,H6",17520,17994,13218,4776,8785,0,4098,4108,2940,1168,2.517123288,1987,1528,947,537,1,536,1,208,0,0.080223881,empty,mBC-0716-2
"A7,H7",19437,19730,14594,5136,9775,4,4472,4484,3129,1355,2.309225092,2095,6823,2280,1398,1,1397,1,465,0,0.017179671,empty,mBC-0716-2
"A7,H8",16445,17293,12332,4961,8403,38,3909,3951,2790,1161,2.403100775,2034,1761,1105,651,0,651,0,279,0,0.059907834,empty,mBC-0716-2
"A7,H9",19799,20386,15106,5280,9919,6,4530,4545,3284,1261,2.604282316,2189,2066,1184,762,0,762,0,311,0,0.081364829,empty,mBC-0716-2
"A7,H10",17716,18405,13362,5043,9029,2,4182,4194,2922,1272,2.297169811,2071,1268,746,498,0,498,0,251,0,0.020080321,empty,mBC-0716-2
"A7,H11",19737,20492,14813,5679,9780,5,4574,4586,3185,1401,2.27337616,2216,333,213,128,0,128,0,88,0,0.015625,empty,mBC-0716-2
"A7,H12",596453,644182,443579,200603,315638,1,157606,157898,130165,27733,4.693505932,83180,51984,34682,19163,10,19153,2,2359,0,0.001409701,mm10,mBC-0716-2
"A8,A1",753706,868072,503000,365072,434149,7,271969,272310,199917,72393,2.761551531,160449,40633,26429,14757,4,14753,1,2144,0,0.001491222,mm10,mBC-0716-2
"A8,A2",19238,19266,14488,4778,9412,9,4095,4110,2802,1308,2.142201835,1968,1134,670,433,0,433,0,214,0,0.048498845,empty,mBC-0716-2
"A8,A3",16995,17483,13043,4440,8611,0,3878,3888,2696,1192,2.261744966,1850,5119,1720,993,2,991,1,328,0,0.037336024,empty,mBC-0716-2
"A8,A4",22736,23224,17397,5827,11373,12,5025,5045,3592,1453,2.472126635,2379,729,437,272,0,272,0,137,0,0.011029412,empty,mBC-0716-2
"A8,A5",1048878,1123552,769427,354125,542321,4,281778,282229,239746,42483,5.643339689,147181,87199,53264,29576,19,29557,3,3167,0,0.001454816,mm10,mBC-0716-2
"A8,A6",15529,16175,11835,4340,8199,0,3930,3937,2799,1138,2.459578207,1892,2519,1464,904,1,903,1,349,0,0.045404208,empty,mBC-0716-2
"A8,A7",16676,17152,12586,4566,8538,0,3935,3943,2727,1216,2.242598684,1906,4816,1667,1014,0,1014,0,345,0,0.043392505,empty,mBC-0716-2
"A8,A8",1067553,1175401,738346,437055,566120,1,332429,332913,278156,54757,5.07982541,183407,190282,96058,53247,25,53222,3,4447,0,0.008116944,mm10,mBC-0716-2
"A8,A9",892292,966991,636483,330508,476628,1,261554,261887,216818,45069,4.810801216,141387,47407,32075,17947,7,17940,1,2216,0,0.001170569,mm10,mBC-0716-2
"A8,A10",16669,17030,12565,4465,8395,0,3851,3857,2747,1110,2.474774775,1841,1918,754,476,0,476,0,177,0,0.086134454,empty,mBC-0716-2
"A8,A11",18324,18827,14097,4730,9296,0,4218,4228,2944,1284,2.292834891,1987,2110,985,608,0,608,0,261,0,0.047697368,empty,mBC-0716-2
"A8,A12",21924,22698,16833,5865,10884,7,4907,4922,3456,1466,2.357435198,2313,10358,3541,2062,4,2058,2,544,0,0.032555879,empty,mBC-0716-2
"A8,B1",20482,20830,15726,5104,10139,0,4452,4461,3082,1379,2.234952864,2039,1377,848,513,0,513,0,233,0,0.029239766,empty,mBC-0716-2
"A8,B2",21029,21638,15810,5828,10584,3,4805,4831,3383,1448,2.336325967,2336,918,358,223,0,223,0,102,0,0.067264574,empty,mBC-0716-2
"A8,B3",19951,20823,15241,5582,10173,28,4672,4712,3306,1406,2.351351351,2341,1384,764,504,0,504,0,225,0,0.03968254,empty,mBC-0716-2
"A8,B4",17889,18341,13572,4769,9088,1,4178,4185,2960,1225,2.416326531,2012,1453,718,416,0,416,0,192,0,0.052884615,empty,mBC-0716-2
"A8,B5",12316,8761,5982,2779,5179,0,2640,2656,1953,703,2.778093883,1417,1062,579,342,0,342,0,170,0,0.070175439,empty,mBC-0716-2
"A8,B6",12775,13433,9654,3779,6675,0,3107,3120,2178,942,2.312101911,1505,2335,1303,818,0,818,0,342,0,0.013447433,empty,mBC-0716-2
"A8,B7",17685,17930,13459,4471,8816,12,3866,3885,2725,1160,2.349137931,1752,1092,625,366,0,366,0,190,0,0.024590164,empty,mBC-0716-2
"A8,B8",586800,632393,428539,203854,317016,0,170167,170420,127689,42731,2.988205284,90524,24432,14236,8105,2,8103,1,1526,0,0.008885598,mm10,mBC-0716-2
"A8,B9",16160,16635,12300,4335,8134,17,3723,3749,2603,1146,2.271378709,1836,837,548,361,1,360,1,173,0,0,empty,mBC-0716-2
"A8,B10",805400,810104,552967,257137,408399,3,220190,220975,170834,50141,3.407072057,116897,8036,3086,1741,3,1738,2,519,0,0.012082854,mm10,mBC-0716-2
"A8,B11",931655,1010611,665028,345583,484828,1,267848,268260,222325,45935,4.839991292,144831,3555,2265,1315,0,1315,0,390,0,0.008365019,mm10,mBC-0716-2
"A8,B12",19017,19572,14401,5171,9836,9,4534,4547,3260,1287,2.533022533,2213,1423,857,512,0,512,0,207,0,0.021484375,empty,mBC-0716-2
"A8,C1",24229,24638,18827,5811,11658,1,5038,5053,3471,1582,2.194058154,2384,827,503,329,0,329,0,144,0,0.024316109,empty,mBC-0716-2
"A8,C2",18514,18912,14004,4908,9353,1,4257,4266,2991,1275,2.345882353,2057,1419,810,512,0,512,0,217,0,0.05078125,empty,mBC-0716-2
"A8,C3",20662,21343,15835,5508,10434,0,4835,4843,3327,1516,2.194591029,2279,635,363,219,0,219,0,115,0,0.059360731,empty,mBC-0716-2
"A8,C4",756103,783268,564224,219044,386946,5,184446,184736,158083,26653,5.931152216,92147,82950,52803,29323,14,29309,2,3100,0,0.001467126,mm10,mBC-0716-2
"A8,C5",17246,17838,13067,4771,8710,12,4040,4057,2796,1261,2.217287867,1932,1577,987,601,0,601,0,274,0,0.008319468,empty,mBC-0716-2
"A8,C6",17564,18019,13232,4787,9007,21,4071,4101,2854,1247,2.288692863,1965,2978,1764,1028,0,1028,0,388,0,0.034046693,empty,mBC-0716-2
"A8,C7",17368,18511,12977,5534,9116,0,4346,4352,3044,1308,2.327217125,2210,629,344,219,0,219,0,113,0,0.01369863,empty,mBC-0716-2
"A8,C8",15706,16239,11858,4381,8059,0,3716,3718,2622,1096,2.392335766,1818,1650,959,582,0,582,0,254,0,0.008591065,empty,mBC-0716-2
"A8,C9",13272,13801,10006,3795,6792,13,3176,3198,2207,991,2.227043391,1554,1003,600,352,1,351,1,176,0,0.017094017,empty,mBC-0716-2
"A8,C10",14168,14599,10819,3780,7284,0,3263,3273,2288,985,2.32284264,1570,1080,684,425,0,425,0,215,0,0.016470588,empty,mBC-0716-2
"A8,C11",12647,13111,9570,3541,6400,24,2937,2966,2014,952,2.115546218,1405,1088,638,419,0,419,0,190,0,0.035799523,empty,mBC-0716-2
"A8,C12",534186,541674,399059,142615,268435,0,125797,126001,100039,25962,3.853285571,62338,7842,4556,2556,1,2555,1,672,0,0.014872798,mm10,mBC-0716-2
"A8,D1",11802,12158,9027,3131,6051,0,2826,2830,2037,793,2.568726356,1381,679,400,242,1,241,1,120,0,0.008298755,empty,mBC-0716-2
"A8,D2",3324141,3538690,2429691,1108999,1625897,6,880676,882036,738861,143175,5.160544788,456921,276826,169634,92781,40,92741,4,5651,0,0.002296719,mm10,mBC-0716-2
"A8,D3",14749,15268,11128,4140,7486,0,3532,3543,2482,1061,2.339302545,1711,1639,991,617,0,617,0,250,0,0.061588331,empty,mBC-0716-2
"A8,D4",20743,21568,15283,6285,10553,11,5141,5159,3805,1354,2.810192024,2553,6549,2225,1381,2,1379,1,503,0,0.036983321,empty,mBC-0716-2
"A8,D5",14302,14758,10860,3898,7364,0,3454,3459,2483,976,2.544057377,1702,4458,1486,924,1,923,1,311,0,0.084507042,empty,mBC-0716-2
"A8,D6",13266,13775,9933,3842,6806,4,3262,3272,2222,1050,2.116190476,1584,6467,2536,1493,2,1491,2,503,0,0.045606975,empty,mBC-0716-2
"A8,D7",13392,13700,10158,3542,6810,0,3124,3125,2160,965,2.238341969,1520,1997,977,600,1,599,1,247,0,0.035058431,empty,mBC-0716-2
"A8,D8",16741,17287,12637,4650,8418,4,3854,3867,2766,1101,2.51226158,1881,1084,701,391,0,391,0,180,0,0.010230179,empty,mBC-0716-2
"A8,D9",208702,222260,142154,80106,113048,0,63775,63835,51859,11976,4.330243821,35447,85207,53486,29893,14,29879,2,3139,0,0.00917032,mm10,mBC-0716-2
"A8,D10",14731,15283,11108,4175,7634,0,3578,3582,2551,1031,2.474296799,1758,1142,528,358,1,357,1,144,0,0.075630252,empty,mBC-0716-2
"A8,D11",14933,15240,11428,3812,7401,1,3313,3324,2322,1002,2.317365269,1525,1783,1092,664,1,663,1,272,0,0.010558069,empty,mBC-0716-2
"A8,D12",21576,21776,16359,5417,10605,1,4760,4767,3375,1392,2.424568966,2215,2251,1328,794,0,794,0,318,0,0.0302267,empty,mBC-0716-2
"A8,E1",22915,23622,17507,6115,11548,0,5212,5218,3682,1536,2.397135417,2471,1723,958,607,0,607,0,290,0,0.047775947,empty,mBC-0716-2
"A8,E2",17041,17392,13032,4360,8558,16,3822,3842,2693,1149,2.343777198,1821,3671,1667,1012,0,1012,0,346,0,0.056324111,empty,mBC-0716-2
"A8,E3",13132,13322,9966,3356,6686,8,3013,3035,2050,985,2.081218274,1424,1769,1023,598,0,598,0,269,0,0.013377926,empty,mBC-0716-2
"A8,E4",16475,16396,12674,3722,8101,1,3594,3602,2509,1093,2.295516926,1591,1269,777,473,0,473,0,225,0,0.031712474,empty,mBC-0716-2
"A8,E5",25955,27045,19968,7077,13166,0,5939,5956,4210,1746,2.411225659,2913,1839,1090,656,0,656,0,308,0,0.013719512,empty,mBC-0716-2
"A8,E6",14604,15121,11026,4095,7379,4,3455,3465,2482,983,2.524923703,1665,4356,2586,1500,0,1500,0,507,0,0.027333333,empty,mBC-0716-2
"A8,E7",14516,14926,10975,3951,7405,0,3424,3428,2317,1111,2.085508551,1720,1446,862,518,0,518,0,244,0,0.007722008,empty,mBC-0716-2
"A8,E8",18633,19016,14309,4707,9341,1,4158,4159,2952,1207,2.445733223,1921,2018,1113,682,0,682,0,275,0,0.041055718,empty,mBC-0716-2
"A8,E9",9217,9512,6986,2526,4715,0,2221,2225,1510,715,2.111888112,1046,1061,628,347,0,347,0,146,0,0.083573487,empty,mBC-0716-2
"A8,E10",988240,1124919,674283,450636,547113,39,336286,336798,260610,76188,3.42061742,193376,80114,51005,28471,18,28453,2,3021,0,0.001476119,mm10,mBC-0716-2
"A8,E11",9581,10009,7455,2554,4942,1,2282,2286,1541,745,2.068456376,1051,1050,605,364,0,364,0,192,0,0.046703297,empty,mBC-0716-2
"A8,E12",753079,807730,545239,262491,400141,0,218604,218914,163290,55624,2.935603337,116886,1913,811,479,0,479,0,200,0,0.035490605,empty,mBC-0716-2
"A8,F1",1574948,1708841,1152100,556741,821084,8,440830,441575,355428,86147,4.125831428,236142,118330,74359,40444,28,40416,2,3730,0,0.001830958,mm10,mBC-0716-2
"A8,F2",24336,25301,18390,6911,12342,58,5758,5837,4169,1668,2.49940048,2881,3935,2177,1374,0,1374,0,516,0,0.0356623,empty,mBC-0716-2
"A8,F3",17327,18231,13067,5164,8954,36,4260,4307,2990,1317,2.270311314,2156,1668,1009,673,0,673,0,305,0,0.078751857,empty,mBC-0716-2
"A8,F4",16342,16541,12265,4276,8300,0,3774,3780,2627,1153,2.278404163,1813,1652,705,444,0,444,0,168,0,0.047297297,empty,mBC-0716-2
"A8,F5",993092,1063329,720828,342501,513427,0,273309,273710,230263,43447,5.299859599,143690,53726,34959,19381,11,19370,3,2483,0,0.001961797,mm10,mBC-0716-2
"A8,F6",1664388,1794992,1196725,598267,865554,4,480845,481582,375554,106028,3.542026634,258566,126817,79960,44542,21,44521,2,3838,0,0.002156286,mm10,mBC-0716-2
"A8,F7",21793,22368,16484,5884,11011,0,5049,5052,3536,1516,2.332453826,2458,1006,590,387,0,387,0,202,0,0.018087855,empty,mBC-0716-2
"A8,F8",1794279,1901449,1315181,586268,909892,0,482971,483700,397372,86328,4.603048837,250440,13102,8204,4645,3,4642,1,964,0,0.006462732,mm10,mBC-0716-2
"A8,F9",15442,15637,11955,3682,7651,0,3397,3402,2392,1010,2.368316832,1526,1878,1115,636,0,636,0,247,0,0.020440252,empty,mBC-0716-2
"A8,F10",41102,43285,32254,11031,20740,1,9140,9165,6813,2352,2.896683673,4330,2052,1268,798,0,798,0,282,0,0.025062657,empty,mBC-0716-2
"A8,F11",555650,551506,422489,129017,275457,0,121379,121609,101071,20538,4.921170513,56979,6678,4301,2522,1,2521,1,750,0,0.001586672,mm10,mBC-0716-2
"A8,F12",15309,15910,11630,4280,7663,0,3556,3563,2509,1054,2.380455408,1727,219,116,92,0,92,0,63,0,0,empty,mBC-0716-2
"A8,G1",11175,11517,8647,2870,5753,4,2504,2522,1796,726,2.473829201,1230,1765,1131,707,0,707,0,265,0,0.007072136,empty,mBC-0716-2
"A8,G2",647230,676596,468221,208375,339004,12,178329,178574,141668,36906,3.838617027,93559,3571,2324,1271,1,1270,1,465,0,0.005511811,mm10,mBC-0716-2
"A8,G3",705850,753057,498956,254101,371065,0,201236,201521,131079,70442,1.860807473,112313,23457,14864,8517,3,8514,1,1625,0,0.007282124,mm10,mBC-0716-2
"A8,G4",30142,30775,22995,7780,15130,11,6698,6724,4821,1903,2.533368366,3245,202,132,93,0,93,0,68,0,0.010752688,empty,mBC-0716-2
"A8,G5",724338,792717,518368,274349,388572,0,205248,205580,180475,25105,7.188807011,111853,154295,100390,56057,24,56033,2,4310,0,0.002444988,mm10,mBC-0716-2
"A8,G6",25984,26727,20078,6649,12873,13,5686,5708,4008,1700,2.357647059,2677,383,212,140,1,139,1,84,0,0.014388489,empty,mBC-0716-2
"A8,G7",3534451,3807942,2543407,1264535,1754190,5,1007084,1008563,839491,169072,4.965286978,532979,241916,151268,84302,36,84266,5,5598,0,0.003227874,mm10,mBC-0716-2
"A8,G8",15513,16286,11633,4653,7973,0,3780,3795,2625,1170,2.243589744,1876,4445,1739,1078,0,1078,0,412,0,0.03432282,empty,mBC-0716-2
"A8,G9",11330,11306,8634,2672,5753,10,2653,2669,1905,764,2.493455497,1260,1373,802,523,0,523,0,258,0,0.022944551,empty,mBC-0716-2
"A8,G10",14402,14951,10983,3968,7343,3,3230,3244,2344,900,2.604444444,1518,1394,851,558,0,558,0,294,0,0.003584229,empty,mBC-0716-2
"A8,G11",12764,13037,9664,3373,6388,29,2856,2891,1980,911,2.173435785,1409,875,505,294,0,294,0,135,0,0.003401361,empty,mBC-0716-2
"A8,G12",12232,12632,9444,3188,6283,0,2907,2916,2083,833,2.50060024,1332,1262,754,456,1,455,1,201,0,0.114285714,empty,mBC-0716-2
"A8,H1",504198,519432,384603,134829,259692,29,119186,119406,88510,30896,2.864772139,58620,18727,8509,4849,1,4848,1,1093,0,0.062293729,mm10,mBC-0716-2
"A8,H2",1311877,1442189,923635,518554,687216,10,393279,393817,313757,80060,3.919023233,217297,77122,51221,28328,8,28320,1,3032,0,0.000776836,mm10,mBC-0716-2
"A8,H3",21764,22426,16450,5976,10927,0,5041,5049,3507,1542,2.274319066,2434,8058,2630,1616,0,1616,0,532,0,0.030940594,empty,mBC-0716-2
"A8,H4",14640,15211,10894,4317,7490,3,3511,3524,2453,1071,2.29038282,1752,269,176,120,0,120,0,84,0,0.075,empty,mBC-0716-2
"A8,H5",18583,19316,14099,5217,9410,61,4300,4368,3126,1242,2.516908213,2063,1618,977,581,0,581,0,247,0,0.012048193,empty,mBC-0716-2
"A8,H6",16078,16238,11713,4525,7837,0,3684,3694,2582,1112,2.321942446,1809,56215,16516,9940,4,9936,2,1913,0,0.050120773,empty,mBC-0716-2
"A8,H7",17512,17851,13401,4450,8966,33,4045,4093,2909,1184,2.456925676,1906,2019,1034,654,1,653,1,273,0,0.016845329,empty,mBC-0716-2
"A8,H8",14237,14561,10645,3916,7288,2,3380,3393,2433,960,2.534375,1703,2107,1208,774,2,772,1,338,0,0.062176166,empty,mBC-0716-2
"A8,H9",17599,18208,13288,4920,9048,1,4191,4211,2959,1252,2.36341853,2037,4355,1747,1099,0,1099,0,405,0,0.069153776,empty,mBC-0716-2
"A8,H10",15129,15859,11404,4455,7887,1,3691,3692,2586,1106,2.338155515,1877,1549,867,571,0,571,0,286,0,0.024518389,empty,mBC-0716-2
"A8,H11",17287,18097,12965,5132,8976,0,4273,4284,3023,1261,2.397303727,2140,300,146,110,0,110,0,84,0,0,empty,mBC-0716-2
"A8,H12",6321,6647,4816,1831,3376,0,1640,1642,1198,444,2.698198198,811,514,320,195,0,195,0,85,0,0.076923077,empty,mBC-0716-2
"A9,A1",14215,14815,10585,4230,7335,0,3480,3487,2436,1051,2.317792578,1729,1355,828,487,0,487,0,199,0,0.055441478,empty,mBC-0716-2
"A9,A2",18944,19168,14454,4714,9345,0,4099,4111,2861,1250,2.2888,1892,1288,830,465,0,465,0,204,0,0.04516129,empty,mBC-0716-2
"A9,A3",17029,17888,13081,4807,8685,0,4025,4030,2811,1219,2.305988515,1904,1088,619,378,0,378,0,180,0,0.013227513,empty,mBC-0716-2
"A9,A4",1898108,1987735,1409476,578259,921923,14,472332,473201,362374,110827,3.269726691,240961,28050,17418,9860,9,9851,2,1685,0,0.003349914,mm10,mBC-0716-2
"A9,A5",18213,18760,13894,4866,9234,0,4285,4291,3004,1287,2.334110334,2016,1663,965,555,0,555,0,253,0,0.055855856,empty,mBC-0716-2
"A9,A6",1223778,1359343,854639,504704,654053,1,381183,381770,280042,101728,2.752850739,215836,56657,36788,21059,9,21050,1,2549,0,0.000760095,mm10,mBC-0716-2
"A9,A7",16847,17433,12771,4662,8528,0,3922,3931,2716,1215,2.235390947,1908,1258,731,469,0,469,0,203,0,0.038379531,empty,mBC-0716-2
"A9,A8",487816,540338,352985,187353,268368,2,147051,147266,116704,30562,3.818598259,79916,77143,47015,26667,8,26659,1,2931,0,0.002775798,mm10,mBC-0716-2
"A9,A9",21316,21507,16318,5189,10339,0,4660,4677,3344,1333,2.508627157,2118,7221,2176,1316,1,1315,1,411,0,0.063117871,empty,mBC-0716-2
"A9,A10",16269,16857,12145,4712,8124,8,3835,3851,2673,1178,2.26910017,1913,508,313,209,0,209,0,117,0,0.04784689,empty,mBC-0716-2
"A9,A11",18678,18978,14295,4683,9212,24,4079,4106,2860,1246,2.295345104,1920,1221,676,420,3,417,1,207,0,0.055155875,empty,mBC-0716-2
"A9,A12",22275,22858,17057,5801,11004,0,4943,4958,3468,1490,2.327516779,2300,3016,1661,976,0,976,0,351,0,0.086065574,empty,mBC-0716-2
"A9,B1",21112,21485,16158,5327,10311,0,4660,4670,3399,1271,2.674272227,2147,1300,789,496,1,495,1,209,0,0.018181818,empty,mBC-0716-2
"A9,B2",1163826,1250188,833708,416480,596465,14,328283,328769,250482,78287,3.199535044,175844,12562,7493,4349,3,4346,2,864,0,0.002300966,mm10,mBC-0716-2
"A9,B3",1059675,1180120,761264,418856,564947,3,317135,317589,238150,79439,2.997897758,174483,51991,34445,19208,6,19202,2,2458,0,0.000885324,mm10,mBC-0716-2
"A9,B4",17714,18388,13642,4746,8917,0,4069,4078,2939,1139,2.580333626,1925,1390,789,458,0,458,0,221,0,0.026200873,empty,mBC-0716-2
"A9,B5",10166,5742,4057,1685,3691,0,1784,1798,1252,546,2.293040293,977,1317,571,359,0,359,0,158,0,0.027855153,empty,mBC-0716-2
"A9,B6",13276,13676,10189,3487,6741,3,3166,3175,2257,918,2.458605664,1494,1292,776,469,1,468,1,213,0,0.021367521,empty,mBC-0716-2
"A9,B7",17787,17989,13554,4435,8764,0,3886,3901,2775,1126,2.464476021,1825,1213,664,394,0,394,0,195,0,0.055837563,empty,mBC-0716-2
"A9,B8",15119,15404,11443,3961,7488,14,3444,3461,2471,990,2.495959596,1612,1253,782,468,0,468,0,254,0,0.010683761,empty,mBC-0716-2
"A9,B9",16572,16727,12583,4144,8097,1,3675,3689,2613,1076,2.428438662,1719,702,441,297,0,297,0,150,0,0.043771044,empty,mBC-0716-2
"A9,B10",17215,17162,12918,4244,8581,1,3997,4009,2780,1229,2.262001627,1838,593,349,188,1,187,1,98,0,0.085561497,empty,mBC-0716-2
"A9,B11",829757,873316,587364,285952,421272,5,233215,233599,173986,59613,2.918591582,125548,1162,638,376,1,375,1,173,0,0.026666667,empty,mBC-0716-2
"A9,B12",19550,20113,14967,5146,9828,0,4447,4459,3128,1331,2.350112697,2090,1056,616,405,0,405,0,192,0,0.017283951,empty,mBC-0716-2
"A9,C1",880909,866782,695173,171609,409812,1,158723,159123,117600,41523,2.832165306,70472,9763,6253,3577,1,3576,1,798,0,0.002516779,mm10,mBC-0716-2
"A9,C2",19538,19886,14570,5316,9670,0,4504,4512,3148,1364,2.307917889,2192,1512,925,550,0,550,0,210,0,0.043636364,empty,mBC-0716-2
"A9,C3",21073,21653,16014,5639,10418,7,4721,4744,3258,1486,2.192462988,2284,567,321,211,0,211,0,113,0,0.042654028,empty,mBC-0716-2
"A9,C4",1731248,1814849,1268003,546846,863082,12,444106,444860,373758,71102,5.256645383,229788,56984,36448,20274,8,20266,2,2416,0,0.003108655,mm10,mBC-0716-2
"A9,C5",1142226,1278740,785160,493580,609141,1,359944,360445,290756,69689,4.172193603,204828,106393,67961,38229,21,38208,2,3639,0,0.002146147,mm10,mBC-0716-2
"A9,C6",19786,20683,14873,5810,10296,92,4813,4914,3518,1396,2.520057307,2432,1342,782,496,0,496,0,210,0,0.010080645,empty,mBC-0716-2
"A9,C7",17925,18748,13689,5059,9007,17,4166,4190,2860,1330,2.15037594,2044,489,319,211,0,211,0,99,0,0.127962085,empty,mBC-0716-2
"A9,C8",16012,16482,12128,4354,7919,26,3642,3672,2533,1139,2.223880597,1709,1633,960,582,0,582,0,225,0,0.079037801,empty,mBC-0716-2
"A9,C9",13787,14274,10445,3829,6947,2,3202,3207,2180,1027,2.122687439,1545,919,562,356,0,356,0,155,0,0.106741573,empty,mBC-0716-2
"A9,C10",14921,15528,11201,4327,7569,4,3591,3605,2461,1144,2.151223776,1773,8608,2748,1663,1,1662,1,511,0,0.082430806,empty,mBC-0716-2
"A9,C11",12375,12646,9305,3341,6188,4,2831,2845,1957,888,2.203828829,1351,939,581,373,0,373,0,172,0,0.010723861,empty,mBC-0716-2
"A9,C12",21604,22098,16366,5732,10555,0,4838,4854,3454,1400,2.467142857,2296,1191,696,439,0,439,0,181,0,0.018223235,empty,mBC-0716-2
"A9,D1",12004,12517,9032,3485,6059,0,2909,2914,2047,867,2.361014994,1419,699,413,246,0,246,0,134,0,0.004065041,empty,mBC-0716-2
"A9,D2",22803,23464,17510,5954,11438,0,5194,5206,3589,1617,2.219542362,2406,6020,2546,1542,1,1541,1,554,0,0.027903958,empty,mBC-0716-2
"A9,D3",14742,15399,10969,4430,7439,6,3473,3488,2419,1069,2.262862488,1764,1320,801,499,0,499,0,221,0,0.028056112,empty,mBC-0716-2
"A9,D4",17061,17773,12875,4898,8586,2,3965,3978,2820,1158,2.435233161,1921,1404,884,598,0,598,0,284,0,0.043478261,empty,mBC-0716-2
"A9,D5",14299,14601,10817,3784,7139,0,3246,3261,2336,925,2.525405405,1536,1139,620,373,2,371,2,161,0,0.078167116,empty,mBC-0716-2
"A9,D6",12955,13371,9753,3618,6588,0,3021,3022,2125,897,2.369007804,1483,1355,741,469,0,469,0,206,0,0.046908316,empty,mBC-0716-2
"A9,D7",13896,14378,10406,3972,6850,11,3290,3313,2222,1091,2.036663611,1627,17631,5399,3165,4,3161,3,856,0,0.041126226,empty,mBC-0716-2
"A9,D8",16844,17416,12759,4657,8462,1,3943,3957,2741,1216,2.254111842,1926,1020,614,395,1,394,1,177,0,0.02284264,empty,mBC-0716-2
"A9,D9",698069,749369,476815,272554,372758,3,214733,215002,164182,50820,3.230657222,121138,228236,148029,82607,38,82569,6,5448,0,0.000920442,mm10,mBC-0716-2
"A9,D10",840003,930937,596856,334081,449589,3,253022,253386,201020,52366,3.838750334,139836,43311,26690,15022,5,15017,1,2199,0,0.000998868,mm10,mBC-0716-2
"A9,D11",13890,14380,10571,3809,7120,0,3315,3318,2325,993,2.341389728,1605,1582,983,590,0,590,0,256,0,0.077966102,empty,mBC-0716-2
"A9,D12",21489,21927,16473,5454,10615,0,4838,4847,3359,1488,2.257392473,2282,2447,1523,879,0,879,0,297,0,0.048919226,empty,mBC-0716-2
"A9,E1",23823,24534,18116,6418,11803,29,5312,5351,3729,1622,2.299013564,2569,1543,902,574,0,574,0,274,0,0.034843206,empty,mBC-0716-2
"A9,E2",462809,473489,338236,135253,235055,6,117046,117307,85790,31517,2.722023035,59856,10326,5147,3037,2,3035,1,840,0,0.039209226,mm10,mBC-0716-2
"A9,E3",791689,829939,591130,238809,397430,14,195778,196123,151159,44964,3.361778312,99337,86618,55389,31350,13,31337,2,3223,0,0.000606312,mm10,mBC-0716-2
"A9,E4",15998,16784,12222,4562,8040,2,3700,3713,2613,1100,2.375454545,1752,1388,776,484,1,483,1,199,0,0.039337474,empty,mBC-0716-2
"A9,E5",23268,24084,17961,6123,11557,0,5092,5115,3624,1491,2.430583501,2409,1339,804,511,0,511,0,252,0,0.01369863,empty,mBC-0716-2
"A9,E6",14259,14754,10806,3948,7231,11,3195,3211,2260,951,2.376445846,1612,1539,944,601,0,601,0,276,0,0.041597338,empty,mBC-0716-2
"A9,E7",16090,16389,12047,4342,7914,14,3690,3708,2603,1105,2.355656109,1803,1345,813,495,0,495,0,217,0,0.042424242,empty,mBC-0716-2
"A9,E8",4144979,4267104,3053352,1213752,1946085,2,1064320,1066139,714940,351199,2.035711947,539228,51567,26018,14792,6,14786,1,2725,0,0.021236305,mm10,mBC-0716-2
"A9,E9",9451,9493,7060,2433,4592,0,2141,2145,1484,661,2.245083207,1013,1148,711,415,1,414,1,181,0,0.04589372,empty,mBC-0716-2
"A9,E10",14131,14423,10741,3682,6935,0,3092,3094,2170,924,2.348484848,1429,1313,775,497,1,496,1,209,0,0.056451613,empty,mBC-0716-2
"A9,E11",9507,9854,7296,2558,4888,0,2295,2295,1630,665,2.45112782,1100,1106,660,427,0,427,0,196,0,0.042154567,empty,mBC-0716-2
"A9,E12",16697,17064,12399,4665,8603,0,4118,4128,2920,1208,2.417218543,2034,1078,639,379,0,379,0,156,0,0.023746702,empty,mBC-0716-2
"A9,F1",19642,19934,15121,4813,9822,5,4454,4469,3177,1292,2.458978328,2071,3609,1407,864,0,864,0,323,0,0.08912037,empty,mBC-0716-2
"A9,F2",24021,24728,18044,6684,12162,0,5658,5671,3928,1743,2.253585772,2771,2889,1706,1060,0,1060,0,417,0,0.033018868,empty,mBC-0716-2
"A9,F3",553184,577449,407486,169963,288452,1,146102,146359,100097,46262,2.163698068,76203,9752,5152,2982,0,2982,0,841,0,0.009725017,mm10,mBC-0716-2
"A9,F4",16038,16377,11935,4442,8116,19,3628,3656,2527,1129,2.23826395,1832,630,343,202,0,202,0,92,0,0.064356436,empty,mBC-0716-2
"A9,F5",26456,27715,20218,7497,13217,0,6112,6128,4363,1765,2.471954674,2917,2295,1363,850,0,850,0,342,0,0.037647059,empty,mBC-0716-2
"A9,F6",24017,24861,18073,6788,11985,0,5618,5626,3967,1659,2.391199518,2757,2149,1214,732,1,731,1,302,0,0.045143639,empty,mBC-0716-2
"A9,F7",1208354,1316076,863390,452686,632913,3,350842,351345,294976,56369,5.232947187,189688,43346,26907,15068,10,15058,3,2065,0,0.003054855,mm10,mBC-0716-2
"A9,F8",23771,24977,18177,6800,11988,15,5546,5578,3810,1768,2.154977376,2705,355,234,162,0,162,0,100,0,0,empty,mBC-0716-2
"A9,F9",1039394,1144135,723520,420615,550012,14,319986,320433,276447,43986,6.2848861,176697,130317,86434,48822,22,48800,2,3874,0,0.001639344,mm10,mBC-0716-2
"A9,F10",1817945,1961811,1339883,621928,928696,5,497633,498468,414140,84328,4.911061569,261047,126901,83817,47230,19,47211,2,3953,0,0.002435873,mm10,mBC-0716-2
"A9,F11",11615,11370,8981,2389,5618,0,2365,2368,1620,748,2.165775401,986,1055,614,392,1,391,1,191,0,0.010230179,empty,mBC-0716-2
"A9,F12",15192,15537,11496,4041,7528,34,3436,3482,2456,1026,2.393762183,1679,181,114,70,0,70,0,46,0,0,empty,mBC-0716-2
"A9,G1",11120,11506,8543,2963,5808,0,2624,2626,1824,802,2.274314214,1266,1640,1022,553,0,553,0,207,0,0.063291139,empty,mBC-0716-2
"A9,G2",23349,23488,17763,5725,11348,0,5140,5156,3606,1550,2.326451613,2416,684,442,279,0,279,0,168,0,0.003584229,empty,mBC-0716-2
"A9,G3",20995,21752,15863,5889,10582,0,4938,4950,3512,1438,2.442280946,2443,2136,1259,752,0,752,0,319,0,0.021276596,empty,mBC-0716-2
"A9,G4",1205019,1294316,866864,427452,613072,1,332121,332658,270482,62176,4.350263767,177945,603,357,244,0,244,0,115,0,0,empty,mBC-0716-2
"A9,G5",933204,1005782,689740,316042,477094,6,240809,241200,192613,48587,3.96429086,126869,100815,59219,33910,20,33890,5,3366,0,0.002301564,mm10,mBC-0716-2
"A9,G6",25986,26476,20209,6267,12839,0,5623,5635,4005,1630,2.457055215,2545,257,161,103,0,103,0,61,0,0,empty,mBC-0716-2
"A9,G7",1001687,1091996,716810,375186,525653,1,294271,294699,226271,68428,3.306701935,159321,83270,55667,30900,9,30891,3,3240,0,0.0010359,mm10,mBC-0716-2
"A9,G8",15192,15322,11466,3856,7630,0,3533,3543,2445,1098,2.226775956,1642,1608,970,582,0,582,0,256,0,0.046391753,empty,mBC-0716-2
"A9,G9",1069220,1166141,790830,375311,566314,22,294192,294723,242442,52281,4.637286968,156317,163698,103478,58662,23,58639,1,4475,0,0.002796773,mm10,mBC-0716-2
"A9,G10",14434,14567,11084,3483,7229,1,3212,3217,2235,982,2.275967413,1512,1279,759,512,0,512,0,246,0,0.0390625,empty,mBC-0716-2
"A9,G11",13301,13505,10209,3296,6574,13,2913,2934,2096,838,2.501193317,1365,740,435,287,0,287,0,138,0,0.003484321,empty,mBC-0716-2
"A9,G12",12435,12848,9457,3391,6300,45,2881,2931,2028,903,2.245847176,1402,1072,684,422,0,422,0,177,0,0.026066351,empty,mBC-0716-2
"A9,H1",961717,1107669,642769,464900,536296,2,342929,343391,272233,71158,3.825753956,200612,26444,16542,9196,3,9193,1,1596,0,0.023169803,mm10,mBC-0716-2
"A9,H2",26904,27539,20494,7045,13310,1,6085,6099,4261,1838,2.31828074,2916,2053,1263,797,0,797,0,329,0,0.058971142,empty,mBC-0716-2
"A9,H3",21020,21567,15924,5643,10513,10,4872,4893,3466,1427,2.428871759,2389,1507,893,550,0,550,0,264,0,0.065454545,empty,mBC-0716-2
"A9,H4",14750,15232,11052,4180,7489,0,3500,3501,2402,1099,2.185623294,1766,257,164,122,0,122,0,87,0,0,empty,mBC-0716-2
"A9,H5",19105,19852,14583,5269,9540,0,4389,4398,2994,1404,2.132478632,2147,1316,751,488,1,487,1,201,0,0.063655031,empty,mBC-0716-2
"A9,H6",14957,15367,11320,4047,7652,0,3608,3617,2560,1057,2.421948912,1698,2548,1199,739,0,739,0,268,0,0.028416779,empty,mBC-0716-2
"A9,H7",18062,18772,13386,5386,9232,4,4417,4432,3126,1306,2.393568147,2245,19445,5418,3335,6,3329,4,869,0,0.108741364,empty,mBC-0716-2
"A9,H8",1315881,1415405,935989,479416,676772,1,377425,378132,289548,88584,3.268626389,206066,98910,64026,36787,25,36762,7,3927,0,0.002611392,mm10,mBC-0716-2
"A9,H9",272082,292666,192809,99857,143524,0,77709,77818,61702,16116,3.828617523,42271,15210,8940,5037,1,5036,1,1046,0,0.011119936,mm10,mBC-0716-2
"A9,H10",15940,16428,11932,4496,7977,13,3728,3746,2640,1106,2.386980108,1774,1265,828,560,0,560,0,272,0,0.019642857,empty,mBC-0716-2
"A9,H11",17369,17650,13243,4407,8647,1,3903,3917,2740,1177,2.327952421,1831,175,102,78,0,78,0,55,0,0,empty,mBC-0716-2
"A9,H12",6466,6614,4871,1743,3229,47,1482,1531,1092,439,2.487471526,712,593,376,232,0,232,0,105,0,0.00862069,empty,mBC-0716-2
"A10,A1",13602,14250,10263,3987,7088,32,3330,3362,2351,1011,2.325420376,1679,1248,727,440,0,440,0,225,0,0.020454545,empty,mBC-0716-2
"A10,A2",18177,18594,13900,4694,8857,0,3938,3943,2733,1210,2.258677686,1846,1178,696,445,0,445,0,207,0,0.08988764,empty,mBC-0716-2
"A10,A3",16960,17747,12794,4953,8447,0,3963,3972,2727,1245,2.190361446,1937,1057,567,331,0,331,0,167,0,0.027190332,empty,mBC-0716-2
"A10,A4",1162680,1219417,854925,364492,574472,0,292642,293158,230570,62588,3.683933022,149698,25572,15582,8662,4,8658,1,1454,0,0.001848002,mm10,mBC-0716-2
"A10,A5",17136,17627,13033,4594,8770,0,4041,4048,2824,1224,2.307189542,1928,1872,1138,660,0,660,0,265,0,0.066666667,empty,mBC-0716-2
"A10,A6",15759,16657,11814,4843,8253,0,3923,3934,2908,1026,2.834307992,1955,1736,1035,611,0,611,0,280,0,0.024549918,empty,mBC-0716-2
"A10,A7",16992,17422,12576,4846,8526,0,4020,4031,2768,1263,2.191607284,2009,18329,5280,3240,3,3237,2,842,0,0.084337349,empty,mBC-0716-2
"A10,A8",10645,11057,8038,3019,5458,0,2580,2586,1811,775,2.336774194,1268,1545,828,518,1,517,1,246,0,0.046421663,empty,mBC-0716-2
"A10,A9",2397135,2576718,1688151,888567,1201846,4,714594,715749,518426,197323,2.627296362,382733,65196,34680,19421,12,19409,3,2952,0,0.009067958,mm10,mBC-0716-2
"A10,A10",15393,16122,11699,4423,7886,23,3686,3721,2575,1146,2.246945899,1846,501,313,212,0,212,0,129,0,0.061320755,empty,mBC-0716-2
"A10,A11",817515,927299,549058,378241,452988,2,279512,279866,205400,74466,2.758305804,163484,61159,38834,22077,8,22069,2,2513,0,0.000996873,mm10,mBC-0716-2
"A10,A12",296001,306366,226531,79835,151510,0,69048,69175,54203,14972,3.62029121,33607,19628,11832,6631,3,6628,1,1240,0,0.011617381,mm10,mBC-0716-2
"A10,B1",1468683,1552359,1090980,461379,744393,1,379218,379913,314555,65358,4.812800269,194653,74991,49413,27996,17,27979,2,3145,0,0.001930019,mm10,mBC-0716-2
"A10,B2",21132,21617,16171,5446,10452,18,4716,4744,3265,1479,2.207572684,2239,608,286,193,0,193,0,94,0,0.103626943,empty,mBC-0716-2
"A10,B3",18732,19478,14309,5169,9540,0,4393,4407,3027,1380,2.193478261,2135,2454,1084,647,0,647,0,259,0,0.072642968,empty,mBC-0716-2
"A10,B4",16572,17201,12812,4389,8452,0,3907,3914,2784,1130,2.463716814,1819,1143,660,434,0,434,0,187,0,0.050691244,empty,mBC-0716-2
"A10,B5",9028,5223,3674,1549,3276,18,1549,1577,1084,493,2.198782961,835,767,424,273,0,273,0,138,0,0.021978022,empty,mBC-0716-2
"A10,B6",12309,12675,9388,3287,6289,9,2938,2952,2043,909,2.247524752,1393,1325,764,475,0,475,0,213,0,0.037894737,empty,mBC-0716-2
"A10,B7",16917,17322,12861,4461,8525,0,3789,3797,2690,1107,2.429990967,1867,2023,946,554,0,554,0,223,0,0.045126354,empty,mBC-0716-2
"A10,B8",691751,738602,510938,227664,361711,4,181863,182194,157246,24948,6.302950136,95494,58974,37253,20979,12,20967,2,2593,0,0.001812372,mm10,mBC-0716-2
"A10,B9",64423,72929,45819,27110,34799,0,20033,20054,13314,6740,1.97537092,11098,1226,717,449,0,449,0,182,0,0.109131403,empty,mBC-0716-2
"A10,B10",16139,16329,11945,4384,8167,9,3782,3808,2631,1177,2.235344095,1792,648,355,221,0,221,0,98,0,0.031674208,empty,mBC-0716-2
"A10,B11",15873,16501,12235,4266,7958,0,3643,3651,2504,1147,2.183086312,1687,408,267,167,0,167,0,97,0,0,empty,mBC-0716-2
"A10,B12",696073,752149,515023,237126,371033,1,187934,188250,159318,28932,5.506636251,98702,76308,47566,26473,5,26468,1,2808,0,0.002342451,mm10,mBC-0716-2
"A10,C1",24323,24442,18660,5782,11748,0,5057,5072,3612,1460,2.473972603,2329,2301,917,552,1,551,1,200,0,0.121597096,empty,mBC-0716-2
"A10,C2",17866,18458,13343,5115,9137,1,4336,4346,3001,1345,2.231226766,2161,1581,972,583,0,583,0,236,0,0.042881647,empty,mBC-0716-2
"A10,C3",23058,23466,17450,6016,11473,37,5187,5251,3721,1530,2.432026144,2463,644,380,230,0,230,0,108,0,0.134782609,empty,mBC-0716-2
"A10,C4",17600,17929,13503,4426,8852,16,3902,3925,2731,1194,2.287269682,1857,5633,1870,1107,0,1107,0,367,0,0.066847335,empty,mBC-0716-2
"A10,C5",16587,16852,12579,4273,8155,0,3730,3740,2626,1114,2.357271095,1732,1242,717,484,1,483,1,228,0,0.057971014,empty,mBC-0716-2
"A10,C6",785591,850761,556974,293787,428064,0,237687,238037,192107,45930,4.182603963,129925,78082,48173,26796,16,26780,3,2850,0,0.00257655,mm10,mBC-0716-2
"A10,C7",16748,17225,12547,4678,8402,20,3911,3936,2737,1199,2.282735613,1954,531,316,196,0,196,0,90,0,0.045918367,empty,mBC-0716-2
"A10,C8",15265,15831,11647,4184,7715,1,3644,3656,2510,1146,2.190226876,1751,1513,875,551,1,550,1,245,0,0.043636364,empty,mBC-0716-2
"A10,C9",12535,12959,9495,3464,6230,0,2813,2817,1996,821,2.431181486,1308,931,556,369,0,369,0,188,0,0.01897019,empty,mBC-0716-2
"A10,C10",13867,14141,10684,3457,6899,0,3114,3118,2149,969,2.217750258,1432,1031,603,362,0,362,0,181,0,0.066298343,empty,mBC-0716-2
"A10,C11",11969,12157,9116,3041,6081,19,2835,2859,1996,863,2.312862109,1319,1690,840,532,1,531,1,199,0,0.15819209,empty,mBC-0716-2
"A10,C12",20828,21517,15634,5883,10503,0,4903,4910,3435,1475,2.328813559,2448,6872,2147,1271,6,1265,2,383,0,0.0743083,empty,mBC-0716-2
"A10,D1",511011,546165,363439,182726,274079,12,149932,150158,111468,38690,2.881054536,82097,18540,5229,3065,4,3061,1,781,0,0.044756615,mm10,mBC-0716-2
"A10,D2",1945569,2063360,1437127,626233,975281,10,509977,510838,421113,89725,4.693374199,263661,224594,129742,71850,23,71827,5,5094,0,0.007128239,mm10,mBC-0716-2
"A10,D3",13725,14254,10278,3976,7007,5,3288,3304,2255,1049,2.149666349,1630,1368,794,462,0,462,0,209,0,0.017316017,empty,mBC-0716-2
"A10,D4",14268,14779,10781,3998,7340,0,3422,3428,2392,1036,2.308880309,1660,1666,1028,633,0,633,0,275,0,0.047393365,empty,mBC-0716-2
"A10,D5",655611,688030,476334,211696,338207,18,177587,177912,118475,59437,1.99328701,93552,11472,5807,3366,0,3366,0,931,0,0.019013666,mm10,mBC-0716-2
"A10,D6",12367,12868,9207,3661,6240,7,2980,2992,2082,910,2.287912088,1507,2468,1124,685,1,684,1,271,0,0.06871345,empty,mBC-0716-2
"A10,D7",13104,13772,9926,3846,6553,2,3070,3078,2116,962,2.1995842,1524,1701,970,584,0,584,0,216,0,0.063356164,empty,mBC-0716-2
"A10,D8",16443,17000,12299,4701,8147,0,3822,3831,2692,1139,2.363476734,1851,8716,2844,1707,1,1706,1,454,0,0.084994138,empty,mBC-0716-2
"A10,D9",3876,4016,2849,1167,2055,0,952,952,677,275,2.461818182,491,1677,968,639,1,638,1,305,0,0.004702194,empty,mBC-0716-2
"A10,D10",13951,14931,10491,4440,7335,0,3526,3538,2375,1163,2.042132416,1809,981,588,341,1,340,1,129,0,0.020588235,empty,mBC-0716-2
"A10,D11",13903,14382,10468,3914,6978,0,3173,3180,2213,967,2.2885212,1581,1922,1163,720,0,720,0,278,0,0.033333333,empty,mBC-0716-2
"A10,D12",21199,22001,16236,5765,10527,1,4807,4814,3378,1436,2.352367688,2286,2680,1505,907,0,907,0,298,0,0.023153252,empty,mBC-0716-2
"A10,E1",22099,22334,16744,5590,11012,4,4977,4991,3595,1396,2.5752149,2379,4554,1832,1149,1,1148,1,408,0,0.087108014,empty,mBC-0716-2
"A10,E2",16298,16521,12342,4179,8000,4,3603,3615,2538,1077,2.356545961,1662,1561,909,578,0,578,0,228,0,0.065743945,empty,mBC-0716-2
"A10,E3",12515,12774,9712,3062,6349,0,2876,2886,2043,843,2.423487544,1315,1783,1141,672,0,672,0,280,0,0.055059524,empty,mBC-0716-2
"A10,E4",15604,16103,11990,4113,7810,20,3532,3559,2527,1032,2.448643411,1628,1453,838,527,1,526,1,199,0,0.020912548,empty,mBC-0716-2
"A10,E5",5467545,5813588,3986319,1827269,2581348,34,1525335,1527854,1170537,357317,3.275906268,787269,149898,79899,45130,22,45108,4,4686,0,0.010441607,mm10,mBC-0716-2
"A10,E6",13961,14205,10699,3506,6899,0,3111,3116,2186,930,2.350537634,1461,1701,1000,647,0,647,0,271,0,0.058732612,empty,mBC-0716-2
"A10,E7",13784,13906,10525,3381,6714,0,3023,3029,2106,923,2.281690141,1384,1271,750,462,0,462,0,202,0,0.041125541,empty,mBC-0716-2
"A10,E8",17554,17724,13350,4374,8754,0,3841,3855,2654,1201,2.209825146,1797,2136,1216,697,0,697,0,267,0,0.035868006,empty,mBC-0716-2
"A10,E9",8405,8608,6254,2354,4230,40,1971,2014,1376,638,2.156739812,982,1082,601,348,0,348,0,161,0,0.005747126,empty,mBC-0716-2
"A10,E10",13410,13580,10039,3541,6764,0,3163,3167,2247,920,2.442391304,1546,9832,3351,1963,2,1961,1,606,0,0.038245793,empty,mBC-0716-2
"A10,E11",8853,8880,6701,2179,4556,9,2095,2113,1425,688,2.07122093,987,1245,729,457,1,456,1,203,0,0.043859649,empty,mBC-0716-2
"A10,E12",14894,15162,11128,4034,7360,0,3398,3407,2334,1073,2.175209692,1627,1109,636,378,0,378,0,165,0,0.018518519,empty,mBC-0716-2
"A10,F1",19253,20138,14776,5362,9516,35,4298,4339,3071,1268,2.42192429,2069,2017,1054,637,0,637,0,279,0,0.064364207,empty,mBC-0716-2
"A10,F2",949232,1015827,705448,310379,487255,0,240292,240730,200521,40209,4.986968092,124989,269059,176885,97467,49,97418,2,5518,0,0.001591082,mm10,mBC-0716-2
"A10,F3",16292,17013,12412,4601,8199,17,3864,3887,2697,1190,2.266386555,1877,2089,1250,738,1,737,1,320,0,0.040705563,empty,mBC-0716-2
"A10,F4",15205,15530,11373,4157,7626,13,3440,3463,2402,1061,2.263901979,1694,1347,515,332,0,332,0,155,0,0.027108434,empty,mBC-0716-2
"A10,F5",843658,908942,618690,290252,439073,2,226872,227218,190126,37092,5.12579532,119845,153069,96479,53527,21,53506,2,4091,0,0.001607296,mm10,mBC-0716-2
"A10,F6",23047,23673,17186,6487,11456,0,5322,5340,3748,1592,2.354271357,2667,12541,4383,2675,4,2671,2,654,0,0.195806814,empty,mBC-0716-2
"A10,F7",20705,20984,15783,5201,10206,5,4641,4663,3191,1472,2.167798913,2108,961,577,351,0,351,0,166,0,0.048433048,empty,mBC-0716-2
"A10,F8",22817,23812,17504,6308,11446,0,5237,5243,3634,1609,2.258545681,2497,377,229,152,0,152,0,102,0,0.032894737,empty,mBC-0716-2
"A10,F9",14859,15279,11286,3993,7542,3,3446,3460,2432,1028,2.365758755,1683,1838,1080,632,1,631,1,238,0,0.047543582,empty,mBC-0716-2
"A10,F10",21834,22101,16919,5182,10805,0,4711,4719,3317,1402,2.365905849,2105,1487,970,577,0,577,0,201,0,0.081455806,empty,mBC-0716-2
"A10,F11",11822,12253,9094,3159,5967,31,2632,2674,1806,868,2.080645161,1275,1258,707,478,0,478,0,227,0,0.050209205,empty,mBC-0716-2
"A10,F12",14701,15153,10991,4162,7402,0,3460,3468,2393,1075,2.226046512,1691,378,177,123,0,123,0,70,0,0.008130081,empty,mBC-0716-2
"A10,G1",10796,11314,8444,2870,5555,1,2509,2512,1709,803,2.128268991,1173,1831,1075,637,0,637,0,225,0,0.018838305,empty,mBC-0716-2
"A10,G2",21718,21946,16775,5171,10722,0,4726,4737,3350,1387,2.415284787,2119,805,498,321,0,321,0,173,0,0.037383178,empty,mBC-0716-2
"A10,G3",22600,23168,17210,5958,11292,0,5158,5165,3585,1580,2.268987342,2493,3210,1683,999,0,999,0,395,0,0.013013013,empty,mBC-0716-2
"A10,G4",28929,29527,22205,7322,14335,0,6244,6259,4426,1833,2.41462084,2975,184,110,81,0,81,0,61,0,0.012345679,empty,mBC-0716-2
"A10,G5",14147,14477,10715,3762,6971,0,3177,3184,2254,930,2.423655914,1501,1502,803,514,0,514,0,249,0,0.042801556,empty,mBC-0716-2
"A10,G6",24302,24641,18772,5869,11813,0,5161,5173,3665,1508,2.430371353,2353,248,161,118,0,118,0,75,0,0,empty,mBC-0716-2
"A10,G7",20828,21703,16125,5578,10610,13,4753,4786,3293,1493,2.205626256,2358,1832,1060,635,0,635,0,295,0,0.05511811,empty,mBC-0716-2
"A10,G8",808418,940248,541569,398679,458494,3,291231,291610,229707,61903,3.710757152,171696,72130,46201,25657,10,25647,3,2872,0,0.0012867,mm10,mBC-0716-2
"A10,G9",828847,985462,539030,446432,479386,7,317870,318252,234672,83580,2.807753051,192427,123611,75594,42051,20,42031,2,3834,0,0.002569532,mm10,mBC-0716-2
"A10,G10",13887,14358,10786,3572,6967,0,3276,3288,2367,921,2.570032573,1516,1749,1101,633,0,633,0,291,0,0.04107425,empty,mBC-0716-2
"A10,G11",906442,1031093,586556,444537,504095,28,334213,334688,263677,71011,3.713185281,196886,5202,3496,1873,1,1872,1,557,0,0.001602564,mm10,mBC-0716-2
"A10,G12",11746,12094,9012,3082,5957,0,2728,2731,1899,832,2.282451923,1322,1030,637,370,0,370,0,162,0,0.021621622,empty,mBC-0716-2
"A10,H1",20514,21153,15653,5500,10262,23,4690,4722,3283,1439,2.281445448,2204,1150,684,423,0,423,0,190,0,0.056737589,empty,mBC-0716-2
"A10,H2",24560,25196,18878,6318,12279,0,5627,5637,3960,1677,2.361359571,2635,4969,2011,1251,2,1249,2,461,0,0.026421137,empty,mBC-0716-2
"A10,H3",20360,20735,15328,5407,9988,0,4674,4681,3345,1336,2.503742515,2232,58956,16163,9570,6,9564,3,1777,0,0.109682141,empty,mBC-0716-2
"A10,H4",13426,13955,10090,3865,6880,1,3238,3249,2237,1012,2.210474308,1594,274,188,132,0,132,0,90,0,0.007575758,empty,mBC-0716-2
"A10,H5",17891,17863,13692,4171,8796,0,3986,3997,2779,1218,2.281609195,1827,1597,904,535,0,535,0,230,0,0.03364486,empty,mBC-0716-2
"A10,H6",13748,14207,10374,3833,6968,1,3214,3227,2217,1010,2.195049505,1562,1744,1099,649,0,649,0,262,0,0.023112481,empty,mBC-0716-2
"A10,H7",16619,17282,12583,4699,8601,4,4036,4050,2790,1260,2.214285714,1985,1623,962,524,1,523,1,217,0,0.053537285,empty,mBC-0716-2
"A10,H8",17217,18382,12888,5494,8840,0,4250,4264,3107,1157,2.685393258,2227,1662,977,625,0,625,0,285,0,0.0368,empty,mBC-0716-2
"A10,H9",15123,15591,11444,4147,7558,0,3429,3430,2432,998,2.436873747,1645,8775,2866,1712,0,1712,0,556,0,0.03271028,empty,mBC-0716-2
"A10,H10",13823,14247,10486,3761,7019,11,3211,3229,2230,999,2.232232232,1553,1617,950,583,0,583,0,286,0,0.012006861,empty,mBC-0716-2
"A10,H11",16673,17394,12665,4729,8560,20,4015,4043,2827,1216,2.324835526,2015,322,147,107,0,107,0,70,0,0.056074766,empty,mBC-0716-2
"A10,H12",5908,6142,4422,1720,2987,0,1396,1396,980,416,2.355769231,688,928,372,240,0,240,0,106,0,0.054166667,empty,mBC-0716-2
"A11,A1",13569,13855,10296,3559,7135,1,3284,3296,2313,983,2.353001017,1636,4478,1830,1099,0,1099,0,348,0,0.060964513,empty,mBC-0716-2
"A11,A2",19648,20068,15144,4924,9552,0,4272,4283,3035,1248,2.431891026,1960,1031,617,394,0,394,0,178,0,0.02284264,empty,mBC-0716-2
"A11,A3",17297,17621,13353,4268,8627,0,3965,3976,2754,1222,2.253682488,1809,894,522,314,0,314,0,126,0,0.060509554,empty,mBC-0716-2
"A11,A4",23288,23805,18083,5722,11464,0,5019,5026,3473,1553,2.236316806,2355,2005,813,491,0,491,0,207,0,0.028513238,empty,mBC-0716-2
"A11,A5",752997,808142,551813,256329,395290,1,206846,207167,162883,44284,3.678145606,108773,63714,39767,22347,8,22339,2,2635,0,0.002596356,mm10,mBC-0716-2
"A11,A6",813232,894223,556671,337552,435075,0,265767,266187,189800,76387,2.484715986,149487,7941,4542,2601,2,2599,1,761,0,0.011542901,mm10,mBC-0716-2
"A11,A7",17075,17762,12905,4857,8642,0,4069,4077,2765,1312,2.107469512,1995,1088,668,379,0,379,0,162,0,0.052770449,empty,mBC-0716-2
"A11,A8",11853,12365,8695,3670,5938,5,2886,2895,2027,868,2.335253456,1428,17299,5663,3470,6,3464,3,784,0,0.189953811,empty,mBC-0716-2
"A11,A9",20603,20226,15910,4316,9898,0,4341,4346,3072,1274,2.411302983,1892,8153,2800,1695,1,1694,1,535,0,0.036599764,empty,mBC-0716-2
"A11,A10",16656,16889,12534,4355,8308,22,3774,3802,2678,1124,2.382562278,1799,473,279,189,0,189,0,100,0,0.037037037,empty,mBC-0716-2
"A11,A11",19018,19191,14376,4815,9561,0,4390,4401,3095,1306,2.369831547,2050,1239,687,438,1,437,1,187,0,0.029748284,empty,mBC-0716-2
"A11,A12",22194,22531,17062,5469,10821,63,4814,4902,3448,1454,2.371389271,2281,2501,1468,870,0,870,0,270,0,0.086206897,empty,mBC-0716-2
"A11,B1",1020470,1194772,661639,533133,579211,0,393030,393499,294778,98721,2.985970564,233736,13828,8001,4459,1,4458,1,1026,0,0.009869897,mm10,mBC-0716-2
"A11,B2",721612,730666,534538,196128,356751,0,171282,171622,133935,37687,3.553877995,84007,1973,1192,668,0,668,0,224,0,0.001497006,empty,mBC-0716-2
"A11,B3",20668,21513,15691,5822,10506,0,4874,4883,3350,1533,2.185257665,2362,1290,763,469,0,469,0,186,0,0.046908316,empty,mBC-0716-2
"A11,B4",17557,18361,13430,4931,9034,6,4163,4180,2910,1270,2.291338583,2053,1021,631,372,0,372,0,147,0,0.094086022,empty,mBC-0716-2
"A11,B5",10769,6880,4646,2234,4245,1,2146,2169,1526,643,2.373250389,1189,1787,837,484,0,484,0,167,0,0.123966942,empty,mBC-0716-2
"A11,B6",13259,13852,9915,3937,6907,0,3287,3293,2278,1015,2.244334975,1615,5906,2030,1180,0,1180,0,377,0,0.037288136,empty,mBC-0716-2
"A11,B7",17766,18367,13710,4657,9030,6,4059,4071,2885,1186,2.432546374,1966,2270,1030,605,0,605,0,220,0,0.054545455,empty,mBC-0716-2
"A11,B8",593419,660649,396058,264591,327421,9,208333,208578,163162,45416,3.592610534,118857,6524,4177,2307,1,2306,1,711,0,0.010407632,mm10,mBC-0716-2
"A11,B9",16309,16383,12505,3878,7938,0,3536,3541,2526,1015,2.488669951,1601,626,384,250,0,250,0,125,0,0.02,empty,mBC-0716-2
"A11,B10",17708,17819,13161,4658,8791,8,4042,4064,2845,1219,2.33388023,1924,748,408,241,0,241,0,101,0,0.045643154,empty,mBC-0716-2
"A11,B11",16738,17216,12836,4380,8284,0,3794,3804,2677,1127,2.375332742,1802,205,121,89,0,89,0,60,0,0.011235955,empty,mBC-0716-2
"A11,B12",19221,19971,14700,5271,9991,0,4512,4517,3122,1395,2.237992832,2240,1278,803,456,0,456,0,185,0,0.043859649,empty,mBC-0716-2
"A11,C1",24477,24801,18832,5969,11840,0,5090,5104,3600,1504,2.393617021,2417,742,454,255,0,255,0,128,0,0.031372549,empty,mBC-0716-2
"A11,C2",19305,19890,14679,5211,9628,1,4407,4417,3099,1318,2.351289833,2065,1431,859,504,0,504,0,179,0,0.067460317,empty,mBC-0716-2
"A11,C3",1587733,1730866,1153442,577424,825939,23,453942,454630,334705,119925,2.790952679,248334,42194,24693,13926,6,13920,2,2051,0,0.001149425,mm10,mBC-0716-2
"A11,C4",1226356,1349520,811610,537910,646011,29,403120,403699,332537,71162,4.672957477,228115,82715,50665,28363,20,28343,3,3145,0,0.003457644,mm10,mBC-0716-2
"A11,C5",18449,19180,13679,5501,9398,2,4570,4583,3221,1362,2.364904552,2315,7544,2450,1490,4,1486,1,487,0,0.026244953,empty,mBC-0716-2
"A11,C6",17490,18038,13213,4825,9071,40,4190,4238,2996,1242,2.412238325,2043,1443,910,553,1,552,1,214,0,0.025362319,empty,mBC-0716-2
"A11,C7",17245,17932,13034,4898,8749,0,4078,4087,2913,1174,2.481260647,1999,531,293,200,1,199,1,96,0,0.020100503,empty,mBC-0716-2
"A11,C8",16758,17363,12668,4695,8399,79,3869,3955,2766,1189,2.326324643,1914,3108,1311,767,0,767,0,292,0,0.048239896,empty,mBC-0716-2
"A11,C9",13801,14101,10352,3749,6922,5,3232,3245,2302,943,2.441145281,1567,979,581,362,0,362,0,141,0,0.052486188,empty,mBC-0716-2
"A11,C10",654500,739728,447861,291867,363474,2,221305,221582,176600,44982,3.92601485,126037,66053,43890,24887,8,24879,2,2790,0,0.000683307,mm10,mBC-0716-2
"A11,C11",12864,13168,9632,3536,6573,0,3136,3147,2195,952,2.305672269,1533,2412,993,622,0,622,0,222,0,0.080385852,empty,mBC-0716-2
"A11,C12",21154,21816,15951,5865,10532,0,4760,4778,3359,1419,2.367159972,2372,1241,699,435,0,435,0,164,0,0.073563218,empty,mBC-0716-2
"A11,D1",651428,706307,452474,253833,351662,1,204192,204421,160047,44374,3.606774237,113281,4313,2443,1394,2,1392,1,411,0,0.001436782,mm10,mBC-0716-2
"A11,D2",22695,23217,17680,5537,11275,2,4858,4889,3491,1398,2.49713877,2222,2326,1391,821,1,820,1,343,0,0.043902439,empty,mBC-0716-2
"A11,D3",914905,1065344,590915,474429,521261,2,351058,351476,259825,91651,2.834939062,210005,19358,12294,7019,3,7016,1,1332,0,0.005843786,mm10,mBC-0716-2
"A11,D4",15679,16177,11929,4248,8081,0,3752,3757,2586,1171,2.208368915,1849,1310,749,446,0,446,0,205,0,0.073991031,empty,mBC-0716-2
"A11,D5",18574,19263,14209,5054,9284,5,4176,4203,3045,1158,2.629533679,1985,1523,857,494,0,494,0,176,0,0.058704453,empty,mBC-0716-2
"A11,D6",13324,13989,9980,4009,6802,1,3245,3268,2183,1085,2.011981567,1608,4619,1720,1047,1,1046,1,336,0,0.043021033,empty,mBC-0716-2
"A11,D7",13269,13608,10118,3490,6673,1,3104,3112,2180,932,2.339055794,1533,1232,775,476,0,476,0,192,0,0.025210084,empty,mBC-0716-2
"A11,D8",16690,17254,12824,4430,8345,0,3871,3888,2720,1168,2.328767123,1852,1267,672,388,0,388,0,158,0,0.054123711,empty,mBC-0716-2
"A11,D9",346741,370469,237986,132483,184250,0,103708,103868,83731,20137,4.158067239,57567,57483,36455,20398,8,20390,2,2614,0,0.004217754,mm10,mBC-0716-2
"A11,D10",14162,14522,10655,3867,7212,0,3373,3384,2391,993,2.407854985,1642,788,462,255,0,255,0,113,0,0.074509804,empty,mBC-0716-2
"A11,D11",13897,14671,10420,4251,7089,0,3365,3372,2374,998,2.378757515,1617,1507,923,582,1,581,1,236,0,0.082616179,empty,mBC-0716-2
"A11,D12",22074,22267,16961,5306,10731,16,4755,4782,3331,1451,2.295658167,2194,2087,1258,753,0,753,0,264,0,0.047808765,empty,mBC-0716-2
"A11,E1",939857,1002960,690144,312816,481656,4,244606,245027,208070,36957,5.630056552,128001,106188,67772,38121,23,38098,2,3642,0,0.001286157,mm10,mBC-0716-2
"A11,E2",17751,18084,12983,5101,8810,39,4144,4198,2930,1268,2.310725552,2105,26754,8490,5102,3,5099,1,1145,0,0.132182781,empty,mBC-0716-2
"A11,E3",557618,596562,421279,175283,292545,1,141082,141356,119793,21563,5.555488568,72118,114944,76109,42232,19,42213,6,3785,0,0.001066022,mm10,mBC-0716-2
"A11,E4",16662,17568,12622,4946,8298,6,3815,3832,2709,1123,2.412288513,1887,1434,914,502,0,502,0,195,0,0.035856574,empty,mBC-0716-2
"A11,E5",23468,23920,18309,5611,11522,4,5003,5015,3572,1443,2.475398475,2231,1309,806,467,0,467,0,210,0,0.049250535,empty,mBC-0716-2
"A11,E6",14039,14249,10750,3499,7088,24,3124,3153,2267,886,2.558690745,1510,1373,761,475,0,475,0,220,0,0.014736842,empty,mBC-0716-2
"A11,E7",15047,15702,11396,4306,7548,1,3519,3530,2430,1100,2.209090909,1749,1095,655,386,0,386,0,182,0,0.028497409,empty,mBC-0716-2
"A11,E8",886856,918135,671647,246488,441542,2,208655,209010,161626,47384,3.41098261,102698,62517,40816,22891,7,22884,2,2637,0,0.001005069,mm10,mBC-0716-2
"A11,E9",9171,9555,6902,2653,4596,0,2142,2149,1478,671,2.202682563,1048,1036,619,344,0,344,0,147,0,0.029069767,empty,mBC-0716-2
"A11,E10",13880,14261,10702,3559,6952,0,3131,3138,2196,942,2.331210191,1476,1470,839,502,0,502,0,201,0,0.049800797,empty,mBC-0716-2
"A11,E11",495664,524465,365047,159418,262941,7,135517,135743,102791,32952,3.11941612,70545,28880,18125,10335,7,10328,1,1679,0,0.003776143,mm10,mBC-0716-2
"A11,E12",16273,16857,12137,4720,8464,0,4037,4044,2855,1189,2.40117746,1999,1064,629,393,0,393,0,161,0,0.03562341,empty,mBC-0716-2
"A11,F1",19449,19986,14876,5110,9772,4,4432,4445,3055,1390,2.197841727,2129,1393,899,537,0,537,0,213,0,0.009310987,empty,mBC-0716-2
"A11,F2",33365,35006,25342,9664,17109,3,7980,8002,5614,2388,2.350921273,3953,4168,2414,1438,1,1437,1,470,0,0.020876827,empty,mBC-0716-2
"A11,F3",693697,759734,495899,263835,373319,2,201616,201948,115001,86947,1.322656331,117620,9847,6039,3261,1,3260,1,924,0,0.009815951,mm10,mBC-0716-2
"A11,F4",17086,17045,12504,4541,8385,8,3828,3855,2695,1160,2.323275862,1864,3701,1257,811,1,810,1,304,0,0.074074074,empty,mBC-0716-2
"A11,F5",25738,26453,19531,6922,12838,2,5911,5920,4168,1752,2.378995434,2782,1771,1033,636,0,636,0,289,0,0.029874214,empty,mBC-0716-2
"A11,F6",881485,915340,656679,258661,436585,4,205544,205960,165438,40522,4.082671142,103682,160785,103399,57212,19,57193,2,4412,0,0.001153987,mm10,mBC-0716-2
"A11,F7",21755,22364,16761,5603,10877,0,4900,4921,3453,1468,2.352179837,2283,621,378,251,1,250,1,129,0,0.036,empty,mBC-0716-2
"A11,F8",30532,31657,23412,8245,15459,18,7034,7057,5026,2031,2.474643033,3420,424,221,155,0,155,0,107,0,0.032258065,empty,mBC-0716-2
"A11,F9",15658,16393,11912,4481,8022,1,3700,3707,2516,1191,2.112510495,1867,1581,905,572,0,572,0,198,0,0.047202797,empty,mBC-0716-2
"A11,F10",23374,23862,17750,6112,11623,0,5218,5229,3626,1603,2.262008734,2457,9482,2758,1680,1,1679,1,466,0,0.039309113,empty,mBC-0716-2
"A11,F11",12474,12730,9556,3174,6266,30,2758,2794,1932,862,2.241299304,1330,1073,654,400,0,400,0,176,0,0.035,empty,mBC-0716-2
"A11,F12",817215,945784,546758,399026,457924,3,290875,291240,235390,55850,4.214682184,170491,3330,2181,1252,2,1250,1,324,0,0,mm10,mBC-0716-2
"A11,G1",11252,11673,8585,3088,5631,0,2532,2542,1743,799,2.181476846,1243,1270,807,460,0,460,0,183,0,0.002173913,empty,mBC-0716-2
"A11,G2",22809,23379,17351,6028,11395,0,5225,5242,3706,1536,2.412760417,2492,1737,765,477,1,476,1,194,0,0.027310924,empty,mBC-0716-2
"A11,G3",21249,21997,16284,5713,10762,0,5044,5052,3592,1460,2.460273973,2383,2319,1328,786,0,786,0,306,0,0.069974555,empty,mBC-0716-2
"A11,G4",43925,46133,33797,12336,21926,19,10180,10231,7370,2861,2.57602237,4910,185,119,88,0,88,0,63,0,0,empty,mBC-0716-2
"A11,G5",14612,15285,11092,4193,7445,0,3453,3460,2386,1074,2.22160149,1752,1323,816,488,0,488,0,220,0,0.038934426,empty,mBC-0716-2
"A11,G6",866767,894123,674666,219457,429770,5,190575,190955,145224,45731,3.175613916,91109,3699,2365,1362,1,1361,1,355,0,0.001469508,mm10,mBC-0716-2
"A11,G7",22040,22654,17047,5607,10963,9,4935,4948,3555,1393,2.552045944,2357,1639,968,612,1,611,1,254,0,0.027823241,empty,mBC-0716-2
"A11,G8",1240244,1407782,819407,588375,667735,5,432557,433123,323931,109192,2.966618434,250425,45369,29079,16281,8,16273,1,2198,0,0.001720642,mm10,mBC-0716-2
"A11,G9",11181,11654,8363,3291,5707,7,2659,2672,1909,763,2.501965924,1329,1129,666,417,0,417,0,213,0,0.019184652,empty,mBC-0716-2
"A11,G10",15019,15268,11397,3871,7424,14,3384,3403,2389,1014,2.356015779,1576,2608,1162,715,1,714,1,295,0,0.074229692,empty,mBC-0716-2
"A11,G11",13123,13232,10029,3203,6458,0,2901,2904,2002,902,2.219512195,1303,641,334,193,0,193,0,98,0,0.010362694,empty,mBC-0716-2
"A11,G12",12217,12555,9353,3202,6235,47,2823,2877,2050,827,2.478839178,1369,1498,796,469,0,469,0,198,0,0.02771855,empty,mBC-0716-2
"A11,H1",28070,29293,21335,7958,14118,16,6490,6526,4805,1721,2.791981406,3169,1151,631,379,0,379,0,167,0,0.050131926,empty,mBC-0716-2
"A11,H2",1291282,1402380,929205,473175,663484,0,363548,364117,301489,62628,4.813965,195461,125386,80801,45633,19,45614,3,3916,0,0.000876924,mm10,mBC-0716-2
"A11,H3",21939,22471,16613,5858,11039,12,5137,5156,3646,1510,2.414569536,2567,1529,849,530,0,530,0,234,0,0.022641509,empty,mBC-0716-2
"A11,H4",14225,14804,10640,4164,7212,0,3368,3369,2413,956,2.524058577,1596,234,149,100,0,100,0,74,0,0.04,empty,mBC-0716-2
"A11,H5",960485,1055206,689790,365416,504607,1,276710,277163,214421,62742,3.417503427,153495,50319,32890,18048,7,18041,2,2321,0,0.001773738,mm10,mBC-0716-2
"A11,H6",807861,905913,548262,357651,443577,0,274985,275354,195175,80179,2.434240886,157366,20545,13074,7466,5,7461,1,1377,0,0.003082697,mm10,mBC-0716-2
"A11,H7",1133007,1189910,841488,348422,575585,1,271728,272179,227310,44869,5.066081259,145553,106057,66737,37059,17,37042,2,3594,0,0.001403812,mm10,mBC-0716-2
"A11,H8",14208,15035,10849,4186,7418,1,3501,3512,2460,1052,2.338403042,1780,1546,897,551,1,550,1,244,0,0.041818182,empty,mBC-0716-2
"A11,H9",740693,781610,522160,259450,383548,8,212646,212965,169753,43212,3.928376377,114119,8375,4542,2536,2,2534,2,783,0,0.010260458,mm10,mBC-0716-2
"A11,H10",15098,15606,11508,4098,7674,0,3545,3550,2484,1066,2.330206379,1730,1431,849,527,0,527,0,234,0,0.056925996,empty,mBC-0716-2
"A11,H11",18194,18744,13814,4930,9141,13,4257,4277,3019,1258,2.399841017,2050,141,64,52,0,52,0,47,0,0.019230769,empty,mBC-0716-2
"A11,H12",6676,7015,4999,2016,3426,24,1609,1639,1151,488,2.358606557,857,675,378,240,0,240,0,95,0,0.145833333,empty,mBC-0716-2
"A12,A1",15441,16114,11602,4512,8092,0,3812,3821,2651,1170,2.265811966,1884,2378,995,573,0,573,0,228,0,0.020942408,empty,mBC-0716-2
"A12,A2",19805,20262,15155,5107,9836,0,4309,4320,3084,1236,2.495145631,1988,1404,883,514,0,514,0,213,0,0.070038911,empty,mBC-0716-2
"A12,A3",17599,18506,13383,5123,8862,0,4034,4043,2849,1194,2.386097152,2014,904,578,344,0,344,0,146,0,0.014534884,empty,mBC-0716-2
"A12,A4",22896,23450,17993,5457,11297,15,4940,4960,3533,1427,2.475823406,2269,740,391,259,0,259,0,131,0,0.111969112,empty,mBC-0716-2
"A12,A5",18189,18890,13712,5178,9363,0,4323,4331,3075,1256,2.448248408,2123,1506,941,592,0,592,0,249,0,0.052364865,empty,mBC-0716-2
"A12,A6",549770,591061,406935,184126,288266,13,145942,146183,123821,22362,5.537116537,75631,143407,92838,52317,22,52295,3,4132,0,0.00133856,mm10,mBC-0716-2
"A12,A7",17073,17599,13116,4483,8688,3,3937,3944,2762,1182,2.336717428,1859,1211,723,437,0,437,0,199,0,0.070938215,empty,mBC-0716-2
"A12,A8",11284,11739,8659,3080,5804,8,2639,2649,1873,776,2.413659794,1253,1666,947,589,0,589,0,242,0,0.018675722,empty,mBC-0716-2
"A12,A9",19943,20357,15420,4937,9875,0,4309,4316,3064,1252,2.447284345,1961,3293,1385,843,2,841,1,315,0,0.014268728,empty,mBC-0716-2
"A12,A10",16335,16596,12447,4149,8114,13,3678,3695,2632,1063,2.476011289,1690,572,300,198,0,198,0,100,0,0.01010101,empty,mBC-0716-2
"A12,A11",713405,778449,509795,268654,380597,1,208319,208635,154934,53701,2.885123182,114280,103238,59697,33576,14,33562,2,3320,0,0.009087659,mm10,mBC-0716-2
"A12,A12",22232,22421,17226,5195,10799,17,4769,4797,3403,1394,2.441176471,2150,6927,2841,1689,1,1688,1,481,0,0.059241706,empty,mBC-0716-2
"A12,B1",20855,21706,15844,5862,10487,0,4810,4822,3414,1408,2.424715909,2280,7081,2302,1423,2,1421,2,457,0,0.083040113,empty,mBC-0716-2
"A12,B2",22840,22977,16860,6117,10940,1,4983,4994,3537,1457,2.42759094,2367,15146,4764,2988,6,2982,1,793,0,0.137491616,empty,mBC-0716-2
"A12,B3",19946,20497,15204,5293,9876,1,4525,4531,3172,1359,2.334069169,2124,1393,855,507,0,507,0,205,0,0.061143984,empty,mBC-0716-2
"A12,B4",17702,18473,13572,4901,8884,20,4022,4047,2888,1159,2.491803279,1953,1151,690,421,0,421,0,169,0,0.038004751,empty,mBC-0716-2
"A12,B5",571377,299350,219013,80337,195383,1,86674,87371,65649,21722,3.022235522,46735,15341,9656,5382,1,5381,1,1090,0,0.001486713,mm10,mBC-0716-2
"A12,B6",13687,14183,10330,3853,7139,18,3366,3393,2356,1037,2.271938284,1672,1273,760,467,1,466,1,205,0,0.027896996,empty,mBC-0716-2
"A12,B7",1317423,1431568,941709,489859,677409,23,374625,375249,300839,74410,4.042991533,201951,58878,38897,21392,5,21387,1,2473,0,0.004535465,mm10,mBC-0716-2
"A12,B8",14223,14758,10874,3884,7371,1,3332,3347,2394,953,2.512067156,1642,1349,800,506,0,506,0,238,0,0.033596838,empty,mBC-0716-2
"A12,B9",16033,16463,12246,4217,8048,0,3665,3668,2507,1161,2.159345392,1771,796,481,280,0,280,0,145,0,0.064285714,empty,mBC-0716-2
"A12,B10",18211,18486,13438,5048,9225,12,4207,4233,3014,1219,2.472518458,2068,886,469,290,0,290,0,127,0,0.037931034,empty,mBC-0716-2
"A12,B11",18798,19575,14313,5262,9482,12,4432,4448,3114,1334,2.334332834,2154,299,208,144,0,144,0,88,0,0.006944444,empty,mBC-0716-2
"A12,B12",19428,20142,14795,5347,9959,0,4511,4523,3177,1346,2.360326895,2151,1498,917,526,0,526,0,203,0,0.053231939,empty,mBC-0716-2
"A12,C1",24437,24538,18993,5545,11714,2,5039,5066,3627,1439,2.520500347,2236,1359,663,435,1,434,1,178,0,0.066820276,empty,mBC-0716-2
"A12,C2",19495,20293,14684,5609,9929,0,4652,4668,3240,1428,2.268907563,2273,1726,1024,612,0,612,0,207,0,0.075163399,empty,mBC-0716-2
"A12,C3",1171604,1269649,832430,437219,598823,2,327872,328389,285808,42581,6.712101642,177902,46975,30139,16651,14,16637,1,2294,0,0.001682996,mm10,mBC-0716-2
"A12,C4",18075,18514,13695,4819,9091,6,4144,4162,2904,1258,2.308426073,1988,4837,1533,939,2,937,1,309,0,0.028815368,empty,mBC-0716-2
"A12,C5",17797,18872,13461,5411,9055,9,4294,4310,3105,1205,2.576763485,2112,1336,786,495,0,495,0,201,0,0.036363636,empty,mBC-0716-2
"A12,C6",19282,19627,14472,5155,9998,0,4630,4639,3347,1292,2.590557276,2189,1596,935,584,0,584,0,242,0,0.070205479,empty,mBC-0716-2
"A12,C7",17454,18010,13269,4741,8653,43,3953,4014,2754,1260,2.185714286,1876,413,254,174,0,174,0,100,0,0.022988506,empty,mBC-0716-2
"A12,C8",1041490,1138047,734154,403893,547710,6,308253,308689,225931,82758,2.730020058,170018,105619,69161,38639,11,38628,3,3596,0,0.000414207,mm10,mBC-0716-2
"A12,C9",14259,14814,10710,4104,7126,12,3382,3407,2446,961,2.545265349,1645,1041,652,397,0,397,0,159,0,0.060453401,empty,mBC-0716-2
"A12,C10",15062,15553,11405,4148,7530,9,3391,3405,2348,1057,2.221381268,1617,1154,649,411,0,411,0,181,0,0.04379562,empty,mBC-0716-2
"A12,C11",12607,13192,9512,3680,6413,10,2938,2958,2017,941,2.1434644,1441,972,572,325,0,325,0,157,0,0.033846154,empty,mBC-0716-2
"A12,C12",702070,750006,519277,230729,364292,1,189074,189431,141031,48400,2.913863636,99268,21759,12934,7187,6,7181,1,1321,0,0.012254561,mm10,mBC-0716-2
"A12,D1",12326,12716,9220,3496,6460,0,3083,3084,2153,931,2.312567132,1516,1286,516,328,1,327,1,147,0,0.012232416,empty,mBC-0716-2
"A12,D2",22833,23247,17614,5633,11243,13,4958,4981,3538,1443,2.451836452,2318,3376,1765,1081,0,1081,0,399,0,0.037927845,empty,mBC-0716-2
"A12,D3",14615,15415,11020,4395,7649,2,3633,3644,2596,1048,2.477099237,1819,1261,753,471,0,471,0,214,0,0.002123142,empty,mBC-0716-2
"A12,D4",16261,16782,12460,4322,8388,10,3959,3975,2774,1201,2.309741882,1943,1363,823,536,1,535,1,247,0,0.029906542,empty,mBC-0716-2
"A12,D5",14641,14871,10941,3930,7312,0,3363,3368,2387,981,2.433231397,1606,5737,2455,1470,1,1469,1,416,0,0.204220558,empty,mBC-0716-2
"A12,D6",13200,13932,9929,4003,6817,0,3276,3282,2296,986,2.328600406,1592,9446,3107,1809,0,1809,0,527,0,0.067993367,empty,mBC-0716-2
"A12,D7",864470,1007121,557281,449840,489857,22,323272,323729,252869,70860,3.568571832,194649,121733,80119,43807,16,43791,2,3650,0,0.001347309,mm10,mBC-0716-2
"A12,D8",17119,17826,12699,5127,8544,0,4032,4043,2851,1192,2.391778523,2031,5102,1810,1120,0,1120,0,383,0,0.072321429,empty,mBC-0716-2
"A12,D9",5611,6020,4106,1914,3045,9,1514,1523,1117,406,2.751231527,811,10031,3453,2117,1,2116,1,667,0,0.040170132,empty,mBC-0716-2
"A12,D10",888144,925670,664272,261398,441736,2,211243,211623,178654,32969,5.418848009,105596,75870,46980,26586,12,26574,1,3009,0,0.001843908,mm10,mBC-0716-2
"A12,D11",14375,14876,10835,4041,7260,0,3449,3459,2470,989,2.497472194,1671,2766,1432,853,0,853,0,334,0,0.109026964,empty,mBC-0716-2
"A12,D12",1044702,1123609,766413,357196,534768,11,280748,281185,220110,61075,3.603929595,148273,108806,72378,39952,25,39927,3,3574,0,0.001102011,mm10,mBC-0716-2
"A12,E1",869292,889394,640642,248752,433291,1,218070,218440,175685,42755,4.109110046,109527,9111,4801,2678,0,2678,0,793,0,0.021284541,mm10,mBC-0716-2
"A12,E2",16773,17265,12705,4560,8467,0,3842,3854,2727,1127,2.419698314,1879,1757,1027,591,0,591,0,234,0,0.045685279,empty,mBC-0716-2
"A12,E3",16616,17212,12746,4466,8454,0,3792,3802,2792,1010,2.764356436,1865,2352,1453,865,0,865,0,340,0,0.032369942,empty,mBC-0716-2
"A12,E4",16247,16807,12378,4429,8075,0,3654,3671,2575,1096,2.349452555,1743,1757,972,577,0,577,0,214,0,0.034662045,empty,mBC-0716-2
"A12,E5",1910988,2052555,1417124,635431,967881,8,504128,505035,390537,114498,3.410863072,263547,150915,98023,54607,29,54578,4,4358,0,0.000824508,mm10,mBC-0716-2
"A12,E6",15010,15158,11460,3698,7335,4,3278,3289,2326,963,2.41536864,1500,1764,1017,638,0,638,0,269,0,0.026645768,empty,mBC-0716-2
"A12,E7",15587,15996,12076,3920,7823,1,3479,3490,2480,1010,2.455445545,1565,1212,764,486,0,486,0,201,0,0.063786008,empty,mBC-0716-2
"A12,E8",18943,19330,14566,4764,9313,6,4156,4178,2899,1279,2.266614543,1935,2008,1189,727,0,727,0,256,0,0.067400275,empty,mBC-0716-2
"A12,E9",498456,497002,368227,128775,245640,2,115137,115340,93845,21495,4.365899046,56248,9532,6088,3380,2,3378,2,864,0,0.008880995,mm10,mBC-0716-2
"A12,E10",14265,14780,11014,3766,7187,13,3275,3292,2333,959,2.43274244,1560,1423,836,535,0,535,0,216,0,0.039252336,empty,mBC-0716-2
"A12,E11",10159,10545,7792,2753,5258,0,2519,2523,1738,785,2.214012739,1223,1141,685,436,1,435,1,174,0,0.052873563,empty,mBC-0716-2
"A12,E12",16266,16848,12193,4655,8389,70,3900,3981,2768,1213,2.281945589,2029,4521,1648,989,1,988,1,327,0,0.058704453,empty,mBC-0716-2
"A12,F1",19897,20293,15072,5221,9794,8,4422,4440,3061,1379,2.219724438,2148,3617,1429,883,1,882,1,349,0,0.02154195,empty,mBC-0716-2
"A12,F2",25854,26593,18848,7745,12590,0,5983,6002,4192,1810,2.316022099,2950,46863,14308,8664,7,8657,3,1746,0,0.059835971,empty,mBC-0716-2
"A12,F3",17361,17745,13099,4646,8904,0,4219,4234,2926,1308,2.237003058,2078,9164,3087,1832,2,1830,2,586,0,0.052459016,empty,mBC-0716-2
"A12,F4",17007,17178,12820,4358,8527,0,3929,3935,2825,1110,2.545045045,1848,496,299,187,0,187,0,94,0,0.032085561,empty,mBC-0716-2
"A12,F5",25666,26198,19700,6498,12846,3,5849,5865,4185,1680,2.491071429,2698,1847,1082,697,0,697,0,306,0,0.040172166,empty,mBC-0716-2
"A12,F6",714756,763979,532806,231173,373608,0,189265,189548,133625,55923,2.389446203,98705,53735,33349,18799,8,18791,2,2405,0,0.004150923,mm10,mBC-0716-2
"A12,F7",21846,22711,16580,6131,11056,2,5094,5113,3530,1583,2.229943146,2473,847,517,296,0,296,0,157,0,0.006756757,empty,mBC-0716-2
"A12,F8",25465,25825,18831,6994,12268,12,5724,5747,4134,1613,2.562926224,2740,1102,470,300,0,300,0,152,0,0.09,empty,mBC-0716-2
"A12,F9",15481,15699,11861,3838,7803,15,3509,3535,2525,1010,2.5,1678,1528,899,545,0,545,0,206,0,0.022018349,empty,mBC-0716-2
"A12,F10",984119,1055692,715641,340051,506591,2,267052,267483,229517,37966,6.045330032,140423,82712,53181,29617,22,29595,2,3055,0,0.001486738,mm10,mBC-0716-2
"A12,F11",12213,12849,9451,3398,6322,41,2808,2853,2024,829,2.441495778,1346,1052,638,382,0,382,0,195,0,0.04973822,empty,mBC-0716-2
"A12,F12",691356,723986,519133,204853,351152,1,174156,174472,136611,37861,3.608224822,88563,705,442,255,0,255,0,106,0,0,empty,mBC-0716-2
"A12,G1",10719,11134,8435,2699,5418,0,2429,2430,1663,767,2.168187744,1084,1711,1090,643,1,642,1,232,0,0.004672897,empty,mBC-0716-2
"A12,G2",22918,23255,17393,5862,11366,10,5130,5148,3704,1444,2.565096953,2429,1280,568,380,0,380,0,182,0,0.052631579,empty,mBC-0716-2
"A12,G3",21754,22659,16417,6242,11061,0,5242,5255,3603,1652,2.180992736,2556,2209,1383,851,0,851,0,318,0,0.043478261,empty,mBC-0716-2
"A12,G4",31120,31270,23885,7385,15285,35,6566,6615,4751,1864,2.548819742,3046,190,110,72,0,72,0,49,0,0.013888889,empty,mBC-0716-2
"A12,G5",14388,15009,10964,4045,7286,0,3380,3382,2375,1007,2.358490566,1626,1343,849,562,1,561,1,254,0,0.019607843,empty,mBC-0716-2
"A12,G6",26430,26951,20362,6589,12935,0,5753,5762,4084,1678,2.433849821,2710,236,161,109,1,108,1,67,0,0,empty,mBC-0716-2
"A12,G7",21149,21647,16333,5314,10575,6,4762,4775,3319,1456,2.279532967,2214,2173,1304,772,0,772,0,281,0,0.064766839,empty,mBC-0716-2
"A12,G8",16257,16548,12122,4426,8195,23,3905,3935,2742,1193,2.298407376,1905,15377,5070,2948,2,2946,1,858,0,0.049898167,empty,mBC-0716-2
"A12,G9",11830,11993,8995,2998,5792,9,2619,2639,1862,777,2.396396396,1219,9079,2990,1789,3,1786,1,569,0,0.062150056,empty,mBC-0716-2
"A12,G10",14889,15343,11345,3998,7496,0,3384,3394,2303,1091,2.110907424,1627,1562,979,616,0,616,0,286,0,0.029220779,empty,mBC-0716-2
"A12,G11",13283,13470,10238,3232,6584,0,2915,2920,2053,867,2.367935409,1288,805,528,311,0,311,0,121,0,0.01607717,empty,mBC-0716-2
"A12,G12",12262,12893,9310,3583,6399,20,2864,2889,2011,878,2.290432802,1462,5211,1821,1095,1,1094,1,343,0,0.021937843,empty,mBC-0716-2
"A12,H1",1007217,1101142,717654,383488,526497,0,292075,292498,247154,45344,5.450643966,159154,57238,38419,21490,4,21486,1,2463,0,0.000884297,mm10,mBC-0716-2
"A12,H2",1294731,1509574,835807,673767,720077,9,479561,480170,381044,99126,3.844036882,284655,129900,85387,47438,18,47420,2,3962,0,0.002741459,mm10,mBC-0716-2
"A12,H3",721306,768419,507136,261283,377037,3,212627,212952,172569,40383,4.273308075,114887,7026,4477,2564,3,2561,1,791,0,0.012885592,mm10,mBC-0716-2
"A12,H4",15070,15809,11399,4410,7831,11,3672,3691,2571,1120,2.295535714,1839,337,188,128,0,128,0,82,0,0,empty,mBC-0716-2
"A12,H5",19517,20389,14661,5728,9801,10,4624,4641,3304,1337,2.471204188,2282,1561,848,507,0,507,0,220,0,0.063116371,empty,mBC-0716-2
"A12,H6",15391,15961,11552,4409,7782,0,3621,3624,2569,1055,2.43507109,1776,1693,1024,596,0,596,0,239,0,0.043624161,empty,mBC-0716-2
"A12,H7",18072,18540,13688,4852,9145,1,4169,4177,2983,1194,2.498324958,2028,2562,1236,748,2,746,1,273,0,0.036193029,empty,mBC-0716-2
"A12,H8",18564,18957,14182,4775,9526,18,4339,4369,3155,1214,2.598846787,2069,1698,1029,625,1,624,1,259,0,0.048076923,empty,mBC-0716-2
"A12,H9",17914,18700,13498,5202,9203,0,4311,4323,3103,1220,2.543442623,2165,1387,863,540,0,540,0,237,0,0.038888889,empty,mBC-0716-2
"A12,H10",644341,707093,457924,249169,345147,10,190496,190759,163368,27391,5.964294841,104882,65099,42960,24218,12,24206,2,2830,0,0.005825002,mm10,mBC-0716-2
"A12,H11",17673,18458,13494,4964,9111,2,4241,4259,2985,1274,2.343014129,2067,214,131,98,0,98,0,69,0,0.020408163,empty,mBC-0716-2
"A12,H12",6505,6752,4912,1840,3319,0,1597,1602,1154,448,2.575892857,785,572,313,197,0,197,0,107,0,0.005076142,empty,mBC-0716-2
"B1,A1",12738,12968,9661,3307,6480,1,2948,2957,2056,901,2.28190899,1375,1283,763,455,0,455,0,198,0,0.059340659,empty,mBC-0716-2
"B1,A2",18427,18249,13715,4534,8683,0,3958,3961,2778,1183,2.348267117,1826,29687,8614,5054,5,5049,2,1062,0,0.173103585,empty,mBC-0716-2
"B1,A3",15248,15869,11481,4388,7601,24,3527,3562,2493,1069,2.332086062,1738,1833,814,499,0,499,0,190,0,0.044088176,empty,mBC-0716-2
"B1,A4",20345,21044,15614,5430,10026,3,4320,4333,3091,1242,2.488727858,2024,785,390,245,0,245,0,120,0,0.044897959,empty,mBC-0716-2
"B1,A5",15862,16748,12035,4713,8120,1,3803,3815,2639,1176,2.244047619,1889,1626,920,566,0,566,0,232,0,0.010600707,empty,mBC-0716-2
"B1,A6",11951,12909,8990,3919,6168,1,2940,2945,2007,938,2.139658849,1453,2433,1125,669,0,669,0,258,0,0.052316891,empty,mBC-0716-2
"B1,A7",777992,868119,533867,334252,423435,1,253874,254263,200594,53669,3.737613893,143741,65462,42319,23217,9,23208,1,2632,0,0.001637366,mm10,mBC-0716-2
"B1,A8",9894,10064,7532,2532,4923,0,2267,2271,1600,671,2.384500745,1053,1326,793,478,1,477,1,216,0,0.01048218,empty,mBC-0716-2
"B1,A9",19428,20251,14960,5291,9659,2,4400,4403,3181,1222,2.603109656,2059,1263,751,486,1,485,1,208,0,0.04742268,empty,mBC-0716-2
"B1,A10",14232,14496,10922,3574,7042,7,3134,3143,2195,948,2.315400844,1481,458,263,172,0,172,0,95,0,0.040697674,empty,mBC-0716-2
"B1,A11",16460,16800,12551,4249,8186,14,3637,3657,2577,1080,2.386111111,1672,1160,706,408,1,407,1,189,0,0.041769042,empty,mBC-0716-2
"B1,A12",19581,20196,15040,5156,9605,0,4289,4302,3078,1224,2.514705882,2009,2601,1445,858,0,858,0,288,0,0.085081585,empty,mBC-0716-2
"B1,B1",745952,811633,550468,261165,394469,2,206662,206986,171841,35145,4.889486413,108883,88632,57353,31833,11,31822,1,3126,0,0.00163409,mm10,mBC-0716-2
"B1,B2",18925,18919,14570,4349,9162,0,4053,4065,2815,1250,2.252,1869,556,290,171,0,171,0,80,0,0.011695906,empty,mBC-0716-2
"B1,B3",798371,890943,559782,331161,432164,2,249184,249518,207994,41524,5.009006839,139812,71858,47149,26534,7,26527,2,2849,0,0.001206318,mm10,mBC-0716-2
"B1,B4",15374,15736,11744,3992,7552,37,3376,3422,2338,1084,2.156826568,1588,871,514,330,0,330,0,159,0,0.072727273,empty,mBC-0716-2
"B1,B5",532918,328723,195150,133573,209108,1,128510,129169,101750,27419,3.710930377,77198,4769,3116,1700,1,1699,1,485,0,0.006474397,mm10,mBC-0716-2
"B1,B6",11052,11507,8463,3044,5651,0,2698,2701,1904,797,2.388958595,1286,1253,744,447,1,446,1,189,0,0.022421525,empty,mBC-0716-2
"B1,B7",591664,586955,456240,130715,287471,28,116296,116622,86778,29844,2.907720145,55037,18254,11125,6136,2,6134,1,1248,0,0.004727747,mm10,mBC-0716-2
"B1,B8",12390,12666,9387,3279,6240,14,2775,2798,2005,793,2.528373266,1337,1098,675,412,0,412,0,208,0,0.026699029,empty,mBC-0716-2
"B1,B9",14218,14911,10743,4168,7046,0,3205,3215,2279,936,2.43482906,1609,705,374,218,0,218,0,106,0,0.027522936,empty,mBC-0716-2
"B1,B10",14971,15272,11200,4072,7738,0,3649,3667,2514,1153,2.180398959,1777,516,264,168,0,168,0,100,0,0.107142857,empty,mBC-0716-2
"B1,B11",17097,17971,13046,4925,8714,6,4064,4077,2818,1259,2.238284353,1997,289,168,96,0,96,0,67,0,0.020833333,empty,mBC-0716-2
"B1,B12",17623,18164,13490,4674,8782,5,4044,4050,2809,1241,2.26349718,1875,1363,868,523,0,523,0,198,0,0.049713193,empty,mBC-0716-2
"B1,C1",21618,21931,16807,5124,10391,14,4464,4484,3138,1346,2.331352155,2089,743,467,260,0,260,0,115,0,0.107692308,empty,mBC-0716-2
"B1,C2",16865,17580,12764,4816,8412,0,3887,3891,2745,1146,2.395287958,1891,3732,1600,931,0,931,0,306,0,0.10311493,empty,mBC-0716-2
"B1,C3",19246,19901,14353,5548,9338,11,4360,4380,3030,1350,2.244444444,2163,4683,1663,1000,0,1000,0,297,0,0.165,empty,mBC-0716-2
"B1,C4",15776,15974,11924,4050,7779,0,3414,3425,2398,1027,2.334956183,1629,3054,1200,727,0,727,0,252,0,0.022008253,empty,mBC-0716-2
"B1,C5",15380,16131,11589,4542,7652,0,3526,3538,2466,1072,2.300373134,1764,1186,682,410,1,409,1,191,0,0.036674817,empty,mBC-0716-2
"B1,C6",15281,15552,11635,3917,7822,27,3568,3608,2520,1088,2.316176471,1679,1698,940,518,0,518,0,195,0,0.102316602,empty,mBC-0716-2
"B1,C7",37521,39784,28890,10894,19341,66,9016,9102,6439,2663,2.417949681,4565,546,349,227,0,227,0,92,0,0,empty,mBC-0716-2
"B1,C8",13583,13824,10298,3526,6933,16,3194,3214,2197,1017,2.16027532,1555,1606,967,527,0,527,0,201,0,0.036053131,empty,mBC-0716-2
"B1,C9",12164,12620,9153,3467,6146,0,2892,2903,2005,898,2.232739421,1446,1742,800,520,0,520,0,184,0,0.05,empty,mBC-0716-2
"B1,C10",12687,12920,9620,3300,6338,0,2914,2920,2070,850,2.435294118,1385,1108,637,351,0,351,0,161,0,0.045584046,empty,mBC-0716-2
"B1,C11",11322,11655,8576,3079,5709,0,2643,2646,1862,784,2.375,1242,902,550,323,0,323,0,138,0,0.030959752,empty,mBC-0716-2
"B1,C12",18765,19375,14293,5082,9257,45,4150,4198,2878,1320,2.18030303,2022,1275,757,460,0,460,0,163,0,0.05,empty,mBC-0716-2
"B1,D1",10880,11042,8143,2899,5431,10,2517,2536,1801,735,2.450340136,1199,2857,1060,577,2,575,1,210,0,0.020869565,empty,mBC-0716-2
"B1,D2",20324,20823,15777,5046,10125,32,4384,4425,3088,1337,2.309648467,2063,2751,1702,1039,2,1037,2,367,0,0.070395371,empty,mBC-0716-2
"B1,D3",12571,13261,9448,3813,6501,32,3114,3153,2185,968,2.257231405,1539,1022,578,344,0,344,0,188,0,0.014534884,empty,mBC-0716-2
"B1,D4",725570,818772,485294,333478,402241,2,249972,250267,156785,93482,1.677167797,149187,6225,3745,2144,1,2143,1,605,0,0.008866076,mm10,mBC-0716-2
"B1,D5",12975,13285,9679,3606,6416,8,2988,2999,2053,946,2.170190275,1447,7078,2112,1224,0,1224,0,367,0,0.083333333,empty,mBC-0716-2
"B1,D6",11229,11545,8425,3120,5678,0,2647,2655,1816,839,2.164481526,1273,1442,849,522,0,522,0,220,0,0.030651341,empty,mBC-0716-2
"B1,D7",11666,11965,8866,3099,5904,0,2772,2778,1948,830,2.346987952,1359,1399,827,502,1,501,1,205,0,0.037924152,empty,mBC-0716-2
"B1,D8",599563,645209,443460,201749,316297,3,158523,158795,136520,22275,6.128843996,83469,56803,36215,20053,12,20041,2,2481,0,0.000898159,mm10,mBC-0716-2
"B1,D9",105818,109439,72845,36594,55357,6,29714,29761,23110,6651,3.474665464,16261,105349,67722,36832,20,36812,2,3570,0,0.001276758,empty,mBC-0716-2
"B1,D10",12905,13307,9906,3401,6498,0,2990,2994,2056,938,2.191897655,1382,858,481,259,0,259,0,111,0,0.023166023,empty,mBC-0716-2
"B1,D11",12038,12450,9149,3301,6106,0,2788,2794,1883,911,2.066959385,1355,1549,930,580,0,580,0,229,0,0.051724138,empty,mBC-0716-2
"B1,D12",19008,19697,14434,5263,9481,29,4362,4400,2993,1407,2.127221038,2148,2242,1322,772,1,771,1,239,0,0.040207523,empty,mBC-0716-2
"B1,E1",20296,20689,15470,5219,9989,4,4422,4442,3091,1351,2.287934863,2101,1599,920,533,0,533,0,229,0,0.07879925,empty,mBC-0716-2
"B1,E2",15114,15238,11566,3672,7310,12,3209,3227,2231,996,2.239959839,1470,3363,1304,797,1,796,1,298,0,0.043969849,empty,mBC-0716-2
"B1,E3",647062,734663,456037,278626,358481,1,206514,206796,167374,39422,4.24570037,116513,157001,104022,57500,24,57476,3,4233,0,0.000904725,mm10,mBC-0716-2
"B1,E4",14379,14938,10924,4014,7189,0,3296,3303,2322,981,2.366972477,1610,1362,821,476,0,476,0,197,0,0.050420168,empty,mBC-0716-2
"B1,E5",20186,20868,15650,5218,10077,12,4374,4396,3077,1319,2.3328279,2064,2506,1228,762,0,762,0,284,0,0.031496063,empty,mBC-0716-2
"B1,E6",12268,12473,9286,3187,6069,5,2715,2726,1887,839,2.249106079,1274,1480,910,570,0,570,0,253,0,0.026315789,empty,mBC-0716-2
"B1,E7",12688,13146,9672,3474,6224,2,2910,2922,2026,896,2.261160714,1367,1259,720,436,0,436,0,177,0,0.107798165,empty,mBC-0716-2
"B1,E8",16319,16768,12267,4501,8138,1,3646,3655,2573,1082,2.378003697,1753,7406,2570,1550,1,1549,1,471,0,0.03227889,empty,mBC-0716-2
"B1,E9",662457,701241,475283,225958,338745,1,178695,179014,151978,27036,5.621319722,94066,117179,75967,41952,14,41938,1,3591,0,0.000834565,mm10,mBC-0716-2
"B1,E10",12600,13167,9471,3696,6335,3,2927,2933,2035,898,2.266146993,1434,1329,736,460,0,460,0,185,0,0.065217391,empty,mBC-0716-2
"B1,E11",8553,8732,6544,2188,4226,14,1922,1937,1337,600,2.228333333,886,1912,810,513,1,512,1,224,0,0.03125,empty,mBC-0716-2
"B1,E12",13889,14308,10670,3638,7138,0,3279,3281,2311,970,2.382474227,1544,994,522,288,0,288,0,123,0,0.059027778,empty,mBC-0716-2
"B1,F1",17332,17834,13274,4560,8745,0,3977,3985,2839,1146,2.477312391,1946,1417,805,504,0,504,0,236,0,0.021825397,empty,mBC-0716-2
"B1,F2",20785,21447,15730,5717,10291,0,4770,4772,3388,1384,2.447976879,2260,6899,2572,1584,1,1583,1,516,0,0.090966519,empty,mBC-0716-2
"B1,F3",14921,15387,11118,4269,7461,3,3509,3520,2414,1106,2.182640145,1718,16491,4939,3023,2,3021,2,795,0,0.035749752,empty,mBC-0716-2
"B1,F4",14234,14633,10855,3778,7237,0,3285,3291,2306,985,2.341116751,1543,464,246,149,0,149,0,77,0,0.006711409,empty,mBC-0716-2
"B1,F5",22673,23647,17019,6628,11282,0,5264,5274,3682,1592,2.31281407,2617,1796,1062,638,0,638,0,302,0,0.026645768,empty,mBC-0716-2
"B1,F6",22056,22936,16649,6287,10937,23,5098,5134,3575,1559,2.293136626,2579,2267,1212,756,1,755,1,284,0,0.051655629,empty,mBC-0716-2
"B1,F7",19391,19918,14978,4940,9588,8,4340,4353,3087,1266,2.438388626,2036,903,563,313,0,313,0,126,0,0.060702875,empty,mBC-0716-2
"B1,F8",763649,790063,576198,213865,382943,23,182304,182659,148287,34372,4.314180147,89804,3991,2383,1326,0,1326,0,395,0,0.000754148,mm10,mBC-0716-2
"B1,F9",859935,957197,596620,360577,466364,1,276531,276932,217005,59927,3.621155739,155045,81564,50165,28608,9,28599,2,3051,0,0.001818245,mm10,mBC-0716-2
"B1,F10",19705,19878,15339,4539,9681,0,4297,4307,3008,1299,2.315627406,1969,1131,630,399,1,398,1,176,0,0.007537688,empty,mBC-0716-2
"B1,F11",10344,10526,7780,2746,5098,0,2237,2243,1527,716,2.132681564,1063,986,579,389,0,389,0,171,0,0.005141388,empty,mBC-0716-2
"B1,F12",795985,914748,542342,372406,439646,1,269372,269778,221642,48136,4.604495596,157327,4592,2679,1492,0,1492,0,398,0,0.001340483,mm10,mBC-0716-2
"B1,G1",11018,11132,8767,2365,5601,2,2113,2125,1396,729,1.914951989,995,1728,1033,626,0,626,0,236,0,0.030351438,empty,mBC-0716-2
"B1,G2",20078,20394,15184,5210,9899,0,4477,4491,3129,1362,2.297356828,2157,2951,1007,657,1,656,1,258,0,0.027439024,empty,mBC-0716-2
"B1,G3",1870873,2055256,1303466,751790,969836,15,573222,574069,466132,107937,4.318556195,318068,177975,115840,63701,20,63681,4,4546,0,0.001036416,mm10,mBC-0716-2
"B1,G4",26539,27261,20475,6786,12986,34,5682,5723,4087,1636,2.498166259,2708,149,94,70,0,70,0,54,0,0.028571429,empty,mBC-0716-2
"B1,G5",1264572,1386069,907199,478870,665574,2,372163,372778,285757,87021,3.283770584,204472,76653,42964,24070,9,24061,1,3059,0,0.030297993,mm10,mBC-0716-2
"B1,G6",22307,22799,17158,5641,10934,1,4801,4821,3385,1436,2.35724234,2225,231,134,92,0,92,0,56,0,0,empty,mBC-0716-2
"B1,G7",19254,19549,14684,4865,9487,0,4249,4262,2988,1274,2.345368917,2027,1923,980,643,0,643,0,277,0,0.057542768,empty,mBC-0716-2
"B1,G8",13485,13940,10371,3569,6888,6,3137,3152,2219,933,2.378349411,1499,1516,892,544,0,544,0,229,0,0.075367647,empty,mBC-0716-2
"B1,G9",10155,10596,7742,2854,5178,24,2383,2416,1724,692,2.49132948,1199,1272,767,492,0,492,0,228,0,0.052845528,empty,mBC-0716-2
"B1,G10",687346,713480,513866,199614,348966,0,171110,171414,136618,34796,3.926255891,85975,12893,7982,4566,1,4565,1,1029,0,0.00788609,mm10,mBC-0716-2
"B1,G11",11459,11895,8770,3125,5804,12,2521,2544,1825,719,2.538247566,1267,697,442,225,0,225,0,101,0,0.004444444,empty,mBC-0716-2
"B1,G12",10210,10717,7802,2915,5334,0,2500,2505,1742,763,2.283093054,1212,1062,661,359,0,359,0,166,0,0.022284123,empty,mBC-0716-2
"B1,H1",18862,19353,14316,5037,9340,0,4245,4250,3018,1232,2.449675325,1987,1300,680,411,1,410,1,170,0,0.070731707,empty,mBC-0716-2
"B1,H2",22785,23301,17644,5657,11152,4,4889,4911,3408,1503,2.26746507,2211,1870,1213,718,1,717,1,293,0,0.052998605,empty,mBC-0716-2
"B1,H3",974713,1043219,687243,355976,498378,0,276515,276937,229204,47733,4.801793309,148844,87637,57239,31408,11,31397,2,3044,0,0.001114756,mm10,mBC-0716-2
"B1,H4",12546,13088,9426,3662,6440,7,3012,3024,2057,967,2.127197518,1501,250,149,101,0,101,0,69,0,0.01980198,empty,mBC-0716-2
"B1,H5",16793,17141,12618,4523,8208,53,3759,3825,2659,1166,2.280445969,1840,1416,876,507,0,507,0,209,0,0.049309665,empty,mBC-0716-2
"B1,H6",12515,12857,9497,3360,6275,0,2846,2849,2027,822,2.46593674,1357,1869,1052,596,0,596,0,230,0,0.075503356,empty,mBC-0716-2
"B1,H7",15493,15856,11800,4056,7795,0,3543,3559,2458,1101,2.232515895,1703,1805,1080,646,0,646,0,238,0,0.037151703,empty,mBC-0716-2
"B1,H8",20040,21102,14646,6456,10323,0,5039,5044,3866,1178,3.281833616,2562,1417,759,493,0,493,0,238,0,0.032454361,empty,mBC-0716-2
"B1,H9",14846,14874,11030,3844,7152,0,3251,3257,2275,982,2.316700611,1557,15622,4577,2724,1,2723,1,771,0,0.035255233,empty,mBC-0716-2
"B1,H10",1138603,1261390,790018,471372,610746,14,357540,358041,296615,61426,4.828818416,200717,137824,87409,48925,21,48904,1,4142,0,0.001247342,mm10,mBC-0716-2
"B1,H11",15650,16184,12063,4121,7861,0,3632,3641,2519,1122,2.245098039,1727,240,141,105,0,105,0,75,0,0.038095238,empty,mBC-0716-2
"B1,H12",5459,5645,4161,1484,2830,1,1334,1335,998,337,2.961424332,651,705,418,245,0,245,0,123,0,0.028571429,empty,mBC-0716-2
"B2,A1",12646,13304,9373,3931,6509,0,3095,3099,2225,874,2.54576659,1522,833,525,332,0,332,0,145,0,0.030120482,empty,mBC-0716-2
"B2,A2",16658,17126,12727,4399,8327,0,3692,3701,2574,1127,2.283939663,1782,1254,614,362,0,362,0,151,0,0.03038674,empty,mBC-0716-2
"B2,A3",15393,15944,11573,4371,7655,0,3608,3618,2539,1079,2.353104727,1755,13453,3727,2299,5,2294,2,618,0,0.040540541,empty,mBC-0716-2
"B2,A4",19777,20176,15134,5042,9595,4,4296,4306,2987,1319,2.26459439,1988,588,316,197,0,197,0,100,0,0.005076142,empty,mBC-0716-2
"B2,A5",638312,652026,484778,167248,320416,1,149956,150269,117203,33066,3.544517027,72478,17662,11234,6176,2,6174,1,1253,0,0.003887269,mm10,mBC-0716-2
"B2,A6",11175,11660,8506,3154,5708,1,2627,2635,1857,778,2.38688946,1274,1074,653,369,0,369,0,189,0,0.043360434,empty,mBC-0716-2
"B2,A7",145319,146900,90106,56794,72011,2,44347,44427,27306,17121,1.594883476,25479,6963,2654,1527,4,1523,2,440,0,0.021011162,empty,mBC-0716-2
"B2,A8",9360,9677,7125,2552,4736,0,2193,2194,1514,680,2.226470588,1002,1018,568,372,0,372,0,171,0,0.037634409,empty,mBC-0716-2
"B2,A9",16583,16586,12772,3814,8141,7,3577,3594,2443,1151,2.122502172,1620,1292,733,441,1,440,1,164,0,0.038636364,empty,mBC-0716-2
"B2,A10",1401773,1523094,986255,536839,731333,1,417150,417748,330046,87702,3.763266516,228108,33001,20227,11182,5,11177,1,1671,0,0.001252572,mm10,mBC-0716-2
"B2,A11",1394172,1492371,1000607,491764,715223,4,389540,390159,294686,95473,3.086589926,210478,68865,41419,22806,8,22798,1,2930,0,0.003421353,mm10,mBC-0716-2
"B2,A12",18305,18716,14203,4513,9002,0,4029,4038,2868,1170,2.451282051,1882,2342,1312,772,0,772,0,248,0,0.060880829,empty,mBC-0716-2
"B2,B1",17846,18500,13644,4856,8988,7,4074,4090,2843,1247,2.279871692,2011,1811,812,492,1,491,1,157,0,0.16293279,empty,mBC-0716-2
"B2,B2",1067381,1188231,735570,452661,567994,5,337327,337813,267507,70306,3.804895741,189555,24626,15206,8421,4,8417,1,1434,0,0.003445408,mm10,mBC-0716-2
"B2,B3",16829,17334,12826,4508,8474,0,3868,3874,2722,1152,2.362847222,1894,1260,632,383,0,383,0,144,0,0.065274151,empty,mBC-0716-2
"B2,B4",14905,15494,11450,4044,7593,0,3482,3492,2370,1122,2.112299465,1717,2356,913,568,0,568,0,205,0,0.063380282,empty,mBC-0716-2
"B2,B5",7885,4681,3340,1341,3026,0,1426,1443,986,457,2.157549234,770,662,366,210,0,210,0,89,0,0.104761905,empty,mBC-0716-2
"B2,B6",11167,11706,8469,3237,5676,3,2652,2661,1831,830,2.206024096,1324,826,487,299,0,299,0,130,0,0.036789298,empty,mBC-0716-2
"B2,B7",851678,908506,623862,284644,437150,3,224730,225105,193894,31211,6.212361027,117033,80965,52571,29146,13,29133,2,2936,0,0.001132736,mm10,mBC-0716-2
"B2,B8",13839,14126,10648,3478,6947,2,3162,3169,2237,932,2.400214592,1507,1355,879,515,0,515,0,195,0,0.009708738,empty,mBC-0716-2
"B2,B9",13734,13905,10548,3357,6599,18,2939,2966,2055,911,2.255762898,1378,676,394,220,0,220,0,107,0,0.104545455,empty,mBC-0716-2
"B2,B10",14583,14592,10564,4028,7329,0,3378,3385,2392,993,2.408862034,1656,2938,996,599,2,597,1,200,0,0.082077052,empty,mBC-0716-2
"B2,B11",17219,17427,12379,5048,8185,2,3866,3879,2855,1024,2.788085938,1910,5534,1713,1050,0,1050,0,320,0,0.040952381,empty,mBC-0716-2
"B2,B12",16575,17491,12606,4885,8451,5,3930,3941,2768,1173,2.359761296,1953,1759,855,510,0,510,0,185,0,0.103921569,empty,mBC-0716-2
"B2,C1",21010,21457,16211,5246,10223,5,4475,4488,3116,1372,2.271137026,2090,515,267,185,0,185,0,86,0,0,empty,mBC-0716-2
"B2,C2",16228,16779,12192,4587,8056,23,3778,3808,2624,1184,2.216216216,1879,1413,803,487,0,487,0,155,0,0.071868583,empty,mBC-0716-2
"B2,C3",20384,21163,15359,5804,10201,27,4836,4875,3439,1436,2.394846797,2372,542,298,167,2,165,2,81,0,0,empty,mBC-0716-2
"B2,C4",15940,16309,12065,4244,7757,41,3408,3460,2414,1046,2.307839388,1623,5696,1966,1158,2,1156,2,341,0,0.031141869,empty,mBC-0716-2
"B2,C5",14778,15401,11218,4183,7588,7,3573,3589,2510,1079,2.326227989,1745,887,520,318,0,318,0,146,0,0.050314465,empty,mBC-0716-2
"B2,C6",14623,14869,11133,3736,7530,0,3526,3540,2479,1061,2.336475024,1664,14357,3864,2274,2,2272,1,621,0,0.044454225,empty,mBC-0716-2
"B2,C7",15132,15742,11476,4266,7579,31,3548,3594,2463,1131,2.177718833,1746,273,138,96,0,96,0,59,0,0.010416667,empty,mBC-0716-2
"B2,C8",13629,13757,10377,3380,6788,0,3093,3099,2140,959,2.231491137,1441,1652,775,487,1,486,1,179,0,0.03909465,empty,mBC-0716-2
"B2,C9",12032,12557,9188,3369,6023,0,2778,2789,1981,808,2.451732673,1323,747,441,276,0,276,0,114,0,0.057971014,empty,mBC-0716-2
"B2,C10",12539,12891,9600,3291,6204,0,2733,2742,1912,830,2.303614458,1280,1774,749,389,0,389,0,161,0,0.035989717,empty,mBC-0716-2
"B2,C11",11097,11682,8429,3253,5655,2,2731,2738,1835,903,2.032115172,1371,826,492,284,0,284,0,122,0,0.017605634,empty,mBC-0716-2
"B2,C12",1784722,2050928,1191720,859208,968614,12,620935,621846,451781,170065,2.656519566,366991,69710,41021,22815,19,22796,4,2710,0,0.002456571,mm10,mBC-0716-2
"B2,D1",10323,10637,7765,2872,5252,1,2560,2566,1737,829,2.095295537,1216,446,279,176,0,176,0,80,0,0.011363636,empty,mBC-0716-2
"B2,D2",19457,19670,15094,4576,9566,0,4160,4168,2948,1220,2.416393443,1913,2330,1360,799,0,799,0,294,0,0.056320401,empty,mBC-0716-2
"B2,D3",12121,12545,9223,3322,6235,0,2899,2908,1994,914,2.181619256,1393,992,576,344,0,344,0,160,0,0.049418605,empty,mBC-0716-2
"B2,D4",12927,13428,9824,3604,6520,0,3018,3026,2116,910,2.325274725,1473,1138,684,399,0,399,0,193,0,0.01754386,empty,mBC-0716-2
"B2,D5",12295,12708,9210,3498,6067,0,2870,2880,2030,850,2.388235294,1390,979,623,354,0,354,0,139,0,0.04519774,empty,mBC-0716-2
"B2,D6",11078,11603,8363,3240,5696,0,2698,2702,1896,806,2.35235732,1330,1270,743,422,0,422,0,156,0,0.075829384,empty,mBC-0716-2
"B2,D7",11461,11786,8836,2950,5726,2,2685,2693,1891,802,2.357855362,1273,1242,717,460,0,460,0,166,0,0.054347826,empty,mBC-0716-2
"B2,D8",18701,19990,14256,5734,9450,0,4433,4446,3196,1250,2.5568,2223,1066,676,404,0,404,0,142,0,0.059405941,empty,mBC-0716-2
"B2,D9",4858,4870,3535,1335,2517,1,1247,1249,878,371,2.366576819,603,7357,2279,1327,2,1325,2,451,0,0.046037736,empty,mBC-0716-2
"B2,D10",12340,12673,9397,3276,6046,0,2796,2802,1920,882,2.176870748,1328,5429,1774,1036,1,1035,1,308,0,0.032850242,empty,mBC-0716-2
"B2,D11",12218,12501,9040,3461,6058,42,2779,2824,1941,883,2.198187995,1420,2750,1215,747,0,747,0,243,0,0.127175368,empty,mBC-0716-2
"B2,D12",18313,18636,14146,4490,8932,0,4013,4020,2758,1262,2.185419968,1820,2556,1365,760,1,759,1,227,0,0.051383399,empty,mBC-0716-2
"B2,E1",20400,20995,15403,5592,10000,18,4488,4513,3154,1359,2.320824135,2196,5209,1954,1183,2,1181,1,396,0,0.067739204,empty,mBC-0716-2
"B2,E2",14613,14637,11084,3553,7040,1,3057,3073,2145,928,2.311422414,1433,2033,930,588,0,588,0,198,0,0.054421769,empty,mBC-0716-2
"B2,E3",11439,11974,8706,3268,5730,0,2601,2610,1772,838,2.114558473,1255,1462,860,528,0,528,0,183,0,0.068181818,empty,mBC-0716-2
"B2,E4",14011,14266,10725,3541,6928,0,3109,3117,2214,903,2.451827243,1466,2740,1084,671,1,670,1,238,0,0.017910448,empty,mBC-0716-2
"B2,E5",19349,19809,14794,5015,9537,0,4233,4240,3041,1199,2.536280234,2008,12448,3705,2152,2,2150,2,608,0,0.022325581,empty,mBC-0716-2
"B2,E6",758545,831644,517692,313952,398686,5,236212,236522,189247,47275,4.003109466,132249,93961,51859,28785,21,28764,3,3123,0,0.002746489,mm10,mBC-0716-2
"B2,E7",12524,13132,9432,3700,6278,13,2908,2928,2009,919,2.186071817,1441,989,577,341,0,341,0,154,0,0.041055718,empty,mBC-0716-2
"B2,E8",15806,16283,12133,4150,7901,0,3461,3474,2459,1015,2.422660099,1655,5022,1676,1027,2,1025,1,328,0,0.030243902,empty,mBC-0716-2
"B2,E9",7735,7784,5948,1836,3835,0,1726,1728,1192,536,2.223880597,788,868,483,284,0,284,0,124,0,0.024647887,empty,mBC-0716-2
"B2,E10",11910,12475,9054,3421,6149,0,2909,2917,1984,933,2.126473741,1435,1220,644,398,0,398,0,166,0,0.020100503,empty,mBC-0716-2
"B2,E11",7963,8511,6001,2510,4230,0,2040,2045,1427,618,2.309061489,1061,944,607,362,1,361,1,142,0,0.033240997,empty,mBC-0716-2
"B2,E12",642192,743767,437112,306655,364390,0,223660,223948,157543,66405,2.372456893,131882,57321,35469,19882,11,19871,2,2550,0,0.001761361,mm10,mBC-0716-2
"B2,F1",16128,16838,12485,4353,8188,0,3718,3724,2605,1119,2.327971403,1754,1306,837,482,0,482,0,195,0,0.031120332,empty,mBC-0716-2
"B2,F2",751942,831606,540885,290721,404422,5,223857,224195,187746,36449,5.150923208,122425,148482,93914,52154,24,52130,1,4106,0,0.001937464,mm10,mBC-0716-2
"B2,F3",14821,15430,10945,4485,7546,8,3574,3587,2493,1094,2.278793419,1776,9400,3560,2197,0,2197,0,567,0,0.248065544,empty,mBC-0716-2
"B2,F4",13952,14110,10591,3519,7024,0,3161,3166,2225,941,2.364505845,1501,373,201,124,0,124,0,65,0,0,empty,mBC-0716-2
"B2,F5",542180,548360,416481,131879,268098,1,114631,114855,72301,42554,1.699041218,56577,8216,4484,2410,1,2409,1,692,0,0.02532171,mm10,mBC-0716-2
"B2,F6",20677,21325,15668,5657,10234,0,4702,4713,3289,1424,2.309691011,2273,2098,1283,738,0,738,0,245,0,0.039295393,empty,mBC-0716-2
"B2,F7",755429,808506,540689,267817,396274,20,216786,217170,164538,52632,3.12619699,116337,7490,4822,2713,2,2711,1,626,0,0.007377352,mm10,mBC-0716-2
"B2,F8",20745,21187,15569,5618,10430,21,4810,4844,3366,1478,2.277401894,2371,362,211,120,0,120,0,63,0,0.008333333,empty,mBC-0716-2
"B2,F9",13091,13224,9979,3245,6436,0,2884,2893,1980,913,2.168674699,1367,1366,787,473,0,473,0,169,0,0.122621564,empty,mBC-0716-2
"B2,F10",19081,19346,14758,4588,9336,0,4115,4122,2855,1267,2.25335438,1914,10889,3085,1778,0,1778,0,514,0,0.010123735,empty,mBC-0716-2
"B2,F11",9978,10133,7561,2572,4964,5,2222,2233,1530,703,2.176386913,1031,869,514,304,0,304,0,135,0,0.059210526,empty,mBC-0716-2
"B2,F12",639361,664340,472272,192068,320622,11,159166,159488,127233,32255,3.944597737,80938,1288,749,430,0,430,0,140,0,0.004651163,empty,mBC-0716-2
"B2,G1",9369,9785,7181,2604,4743,7,2192,2200,1513,687,2.202328967,1066,1251,752,464,0,464,0,177,0,0.034482759,empty,mBC-0716-2
"B2,G2",19127,19572,14658,4914,9463,1,4246,4261,3015,1246,2.419743178,1986,575,378,230,0,230,0,107,0,0.004347826,empty,mBC-0716-2
"B2,G3",19147,19594,14444,5150,9612,15,4464,4481,3113,1368,2.275584795,2118,4314,1794,1062,1,1061,1,372,0,0.053722903,empty,mBC-0716-2
"B2,G4",25902,26521,19724,6797,12833,0,5656,5664,4035,1629,2.476979742,2717,137,92,57,0,57,0,40,0,0.01754386,empty,mBC-0716-2
"B2,G5",12061,12443,9173,3270,6096,38,2831,2871,1966,905,2.172375691,1385,1038,584,362,0,362,0,157,0,0.052486188,empty,mBC-0716-2
"B2,G6",539642,530164,401732,128432,259916,1,117826,118050,90907,27143,3.349187636,55461,642,382,217,0,217,0,89,0,0.004608295,empty,mBC-0716-2
"B2,G7",20480,21079,15772,5307,10040,12,4530,4550,3179,1371,2.318745441,2118,19045,5693,3354,2,3352,2,847,0,0.061455847,empty,mBC-0716-2
"B2,G8",13560,14108,10098,4010,6770,0,3174,3183,2178,1005,2.167164179,1592,1312,784,503,0,503,0,202,0,0.047713718,empty,mBC-0716-2
"B2,G9",9450,9551,7199,2352,4650,5,2148,2155,1564,591,2.646362098,954,952,591,374,0,374,0,160,0,0.07486631,empty,mBC-0716-2
"B2,G10",12266,12661,9204,3457,6156,0,2833,2841,1996,845,2.362130178,1422,1473,855,550,0,550,0,206,0,0.134545455,empty,mBC-0716-2
"B2,G11",13692,14527,10490,4037,6961,0,3247,3250,2410,840,2.869047619,1601,745,445,268,1,267,1,101,0,0.029962547,empty,mBC-0716-2
"B2,G12",10331,10579,7863,2716,5165,0,2387,2390,1616,774,2.087855297,1157,934,554,306,0,306,0,123,0,0.022875817,empty,mBC-0716-2
"B2,H1",19518,19910,14862,5048,9674,0,4527,4530,3126,1404,2.226495726,2145,7067,2384,1418,2,1416,2,418,0,0.050141243,empty,mBC-0716-2
"B2,H2",24182,24858,18558,6300,11967,6,5436,5460,3898,1562,2.495518566,2619,1830,1143,667,1,666,1,262,0,0.03003003,empty,mBC-0716-2
"B2,H3",19686,20329,14834,5495,9745,23,4398,4424,3138,1286,2.440124417,2148,11781,3857,2244,3,2241,2,604,0,0.029897367,empty,mBC-0716-2
"B2,H4",496645,508007,381441,126566,248885,0,112268,112468,83749,28719,2.916153069,54303,1633,945,526,0,526,0,185,0,0,empty,mBC-0716-2
"B2,H5",15917,16221,12134,4087,7844,0,3601,3610,2584,1026,2.518518519,1662,1346,740,433,0,433,0,172,0,0.030023095,empty,mBC-0716-2
"B2,H6",12809,13263,9530,3733,6514,27,3028,3065,2172,893,2.43225084,1505,1427,867,527,0,527,0,195,0,0.058823529,empty,mBC-0716-2
"B2,H7",552931,571798,424260,147538,283166,0,128871,129108,101860,27248,3.738256019,63184,38333,23741,13268,6,13262,2,1950,0,0.007314131,mm10,mBC-0716-2
"B2,H8",12393,12758,9353,3405,6305,0,3016,3023,2102,921,2.282301846,1483,1314,788,492,0,492,0,193,0,0.077235772,empty,mBC-0716-2
"B2,H9",533036,555275,403964,151311,272844,1,124236,124444,105769,18675,5.663668005,62277,60678,39891,22221,4,22217,3,2664,0,0.000900212,mm10,mBC-0716-2
"B2,H10",13068,13621,9936,3685,6542,32,3089,3130,2148,982,2.187372709,1538,1402,862,516,0,516,0,223,0,0.093023256,empty,mBC-0716-2
"B2,H11",15405,16186,11536,4650,7862,9,3735,3756,2618,1138,2.300527241,1907,146,66,50,0,50,0,36,0,0,empty,mBC-0716-2
"B2,H12",5486,5526,4079,1447,2759,0,1314,1315,955,360,2.652777778,620,397,209,135,0,135,0,59,0,0.125925926,empty,mBC-0716-2
"B3,A1",14845,15245,11216,4029,7534,0,3488,3498,2437,1061,2.296889727,1692,1251,710,401,0,401,0,195,0,0.034912718,empty,mBC-0716-2
"B3,A2",18833,18983,14277,4706,9258,1,4030,4042,2814,1228,2.291530945,1920,1503,837,530,0,530,0,213,0,0.035849057,empty,mBC-0716-2
"B3,A3",16813,17130,12827,4303,8349,0,3897,3900,2712,1188,2.282828283,1848,2724,1215,712,1,711,1,237,0,0.032348805,empty,mBC-0716-2
"B3,A4",21823,22093,16704,5389,10594,0,4656,4667,3311,1356,2.441740413,2169,777,454,272,0,272,0,121,0,0.047794118,empty,mBC-0716-2
"B3,A5",17981,18793,13612,5181,9269,0,4334,4343,3005,1338,2.245889387,2126,1980,1025,620,0,620,0,257,0,0.070967742,empty,mBC-0716-2
"B3,A6",1641128,1772062,1189420,582642,851355,7,460405,461212,373366,87846,4.250233363,245820,197464,127247,70327,22,70305,2,5158,0,0.00293009,mm10,mBC-0716-2
"B3,A7",16441,17475,12545,4930,8473,42,3890,3941,2697,1244,2.168006431,1917,1171,669,380,1,379,1,155,0,0.018469657,empty,mBC-0716-2
"B3,A8",10537,11065,7943,3122,5432,0,2505,2508,1819,689,2.640058055,1260,1586,998,590,0,590,0,230,0,0.066101695,empty,mBC-0716-2
"B3,A9",19238,19778,14770,5008,9382,0,4270,4286,2956,1330,2.222556391,1996,1351,863,536,0,536,0,225,0,0.052238806,empty,mBC-0716-2
"B3,A10",1014971,1113965,742213,371752,545047,30,303078,303552,223369,80183,2.785740119,163844,7592,4698,2521,0,2521,0,661,0,0.000793336,mm10,mBC-0716-2
"B3,A11",982289,1088694,669972,418722,527647,0,322603,323042,239288,83754,2.857033694,181660,25323,16483,9188,8,9180,1,1595,0,0.002614379,mm10,mBC-0716-2
"B3,A12",21304,21792,16192,5600,10546,18,4676,4704,3307,1397,2.367215462,2268,2664,1535,901,0,901,0,311,0,0.077691454,empty,mBC-0716-2
"B3,B1",19999,20544,15382,5162,9837,0,4407,4417,3040,1377,2.207697894,2098,2010,904,597,0,597,0,251,0,0.028475712,empty,mBC-0716-2
"B3,B2",924418,966806,693161,273645,465720,1,225795,226201,192220,33981,5.656690504,113146,27793,17935,10170,4,10166,1,1581,0,0.004524887,mm10,mBC-0716-2
"B3,B3",19392,19943,14761,5182,9915,25,4580,4611,3303,1308,2.525229358,2235,1236,691,457,0,457,0,201,0,0.067833698,empty,mBC-0716-2
"B3,B4",16823,17373,12659,4714,8453,15,3920,3949,2784,1165,2.389699571,1879,1317,706,443,0,443,0,193,0,0.009029345,empty,mBC-0716-2
"B3,B5",18507,16157,10186,5971,8995,2,5083,5100,3979,1121,3.549509367,2893,1098,596,340,0,340,0,144,0,0.070588235,empty,mBC-0716-2
"B3,B6",13150,13576,9840,3736,6813,1,3243,3246,2245,1001,2.242757243,1582,1282,733,458,0,458,0,210,0,0.056768559,empty,mBC-0716-2
"B3,B7",17349,18222,13359,4863,8787,28,4014,4057,2916,1141,2.555652936,1940,1385,756,427,0,427,0,191,0,0.021077283,empty,mBC-0716-2
"B3,B8",14332,14448,10932,3516,7245,0,3339,3345,2398,947,2.532206969,1536,1093,618,410,0,410,0,197,0,0.012195122,empty,mBC-0716-2
"B3,B9",15723,16763,11987,4776,7910,0,3680,3687,2546,1141,2.231375986,1824,898,538,324,0,324,0,135,0,0.080246914,empty,mBC-0716-2
"B3,B10",17342,17407,12771,4636,8645,1,3961,3982,2669,1313,2.032749429,1934,641,357,227,0,227,0,92,0,0.061674009,empty,mBC-0716-2
"B3,B11",20653,21579,15506,6073,10663,16,5090,5115,3693,1422,2.597046414,2617,196,116,86,0,86,0,65,0,0.011627907,empty,mBC-0716-2
"B3,B12",18566,18997,14092,4905,9225,15,4242,4266,2971,1295,2.294208494,2017,1412,847,505,0,505,0,215,0,0.021782178,empty,mBC-0716-2
"B3,C1",23331,23712,18022,5690,11224,32,4761,4813,3377,1436,2.351671309,2219,774,489,309,2,307,1,135,0,0.055374593,empty,mBC-0716-2
"B3,C2",18942,19416,14209,5207,9344,0,4288,4302,2959,1343,2.203276247,2060,1610,981,592,0,592,0,193,0,0.081081081,empty,mBC-0716-2
"B3,C3",21093,21951,15940,6011,10590,16,4921,4942,3423,1519,2.253456221,2390,2953,981,610,1,609,1,198,0,0.027914614,empty,mBC-0716-2
"B3,C4",17530,17981,13240,4741,8729,0,4019,4033,2808,1225,2.292244898,1940,1820,968,587,0,587,0,188,0,0.124361158,empty,mBC-0716-2
"B3,C5",882024,930223,661761,268462,446883,31,216472,216872,175060,41812,4.186836315,110679,53352,33627,19048,9,19039,3,2396,0,0.007195756,mm10,mBC-0716-2
"B3,C6",17023,17061,12602,4459,8705,0,3938,3947,2746,1201,2.286427977,1902,3413,1475,866,0,866,0,297,0,0.03926097,empty,mBC-0716-2
"B3,C7",16687,17273,12535,4738,8304,2,3895,3899,2731,1168,2.338184932,1900,506,323,196,0,196,0,100,0,0.010204082,empty,mBC-0716-2
"B3,C8",15453,15562,11640,3922,7950,17,3716,3740,2598,1142,2.274956217,1791,7413,2403,1398,2,1396,1,410,0,0.131805158,empty,mBC-0716-2
"B3,C9",1056305,1203251,709000,494251,575693,8,356846,357359,294858,62501,4.717652518,206656,82346,50006,27652,19,27633,2,3011,0,0.001809431,mm10,mBC-0716-2
"B3,C10",13959,14346,10684,3662,7087,0,3181,3187,2236,951,2.351209253,1533,1132,665,367,0,367,0,182,0,0.059945504,empty,mBC-0716-2
"B3,C11",11749,12100,8984,3116,6001,0,2808,2818,1945,873,2.227949599,1332,1032,626,399,0,399,0,154,0,0.070175439,empty,mBC-0716-2
"B3,C12",724352,763449,533345,230104,370758,24,191506,191912,146609,45303,3.236187449,99168,13943,9166,5179,2,5177,1,1080,0,0.006953834,mm10,mBC-0716-2
"B3,D1",1422435,1560905,968803,592102,762393,1,462185,462909,373452,89457,4.174653744,260102,57311,34894,19247,6,19241,2,2523,0,0.003274258,mm10,mBC-0716-2
"B3,D2",21783,21931,16556,5375,10848,0,4838,4851,3342,1509,2.21471173,2300,4154,2002,1209,0,1209,0,404,0,0.052109181,empty,mBC-0716-2
"B3,D3",14137,14579,10562,4017,7098,0,3323,3331,2281,1050,2.172380952,1565,1236,724,456,0,456,0,217,0,0.035087719,empty,mBC-0716-2
"B3,D4",978227,1035687,714953,320734,496774,12,259113,259585,219823,39762,5.528469393,133884,96628,62000,34332,16,34316,1,3371,0,0.00125306,mm10,mBC-0716-2
"B3,D5",14874,15093,11183,3910,7249,19,3259,3286,2349,937,2.506937033,1552,23080,7187,4188,2,4186,1,964,0,0.114906832,empty,mBC-0716-2
"B3,D6",627260,634761,481342,153419,317590,0,135901,136219,104100,32119,3.241072263,66020,54610,25816,14689,10,14679,5,2722,0,0.026772941,mm10,mBC-0716-2
"B3,D7",13443,14261,10128,4133,6894,8,3276,3297,2233,1064,2.098684211,1604,1696,891,497,1,496,1,204,0,0.010080645,empty,mBC-0716-2
"B3,D8",15751,16471,11735,4736,8039,11,3753,3772,2657,1115,2.382959641,1991,1196,778,433,0,433,0,161,0,0.03926097,empty,mBC-0716-2
"B3,D9",5387,5468,4014,1454,2819,0,1329,1335,941,394,2.388324873,621,1696,1023,634,1,633,1,275,0,0.05371248,empty,mBC-0716-2
"B3,D10",14350,14594,10847,3747,7185,54,3349,3406,2409,997,2.416248746,1594,6658,2103,1264,1,1263,1,336,0,0.148060174,empty,mBC-0716-2
"B3,D11",13811,13811,10417,3394,6856,0,3094,3101,2184,917,2.381679389,1426,3614,1526,920,0,920,0,345,0,0.045652174,empty,mBC-0716-2
"B3,D12",20945,21445,15786,5659,10314,0,4804,4822,3370,1452,2.320936639,2299,2985,1543,902,1,901,1,330,0,0.039955605,empty,mBC-0716-2
"B3,E1",22390,22719,17133,5586,11124,0,4971,4979,3485,1494,2.332663989,2318,1906,1078,609,0,609,0,270,0,0.077175698,empty,mBC-0716-2
"B3,E2",16793,16929,12665,4264,8387,21,3767,3796,2734,1062,2.574387947,1813,1597,907,534,0,534,0,213,0,0.093632959,empty,mBC-0716-2
"B3,E3",12700,12874,9543,3331,6372,8,2868,2881,1984,897,2.211817168,1362,1813,1131,655,0,655,0,262,0,0.059541985,empty,mBC-0716-2
"B3,E4",15908,16421,11896,4525,8026,0,3762,3779,2667,1112,2.398381295,1857,1382,817,489,0,489,0,197,0,0.042944785,empty,mBC-0716-2
"B3,E5",645188,662799,496140,166659,325738,0,149790,150120,109904,40216,2.73284265,72831,28658,12828,7252,3,7249,1,1458,0,0.007449303,mm10,mBC-0716-2
"B3,E6",729085,744664,540294,204370,357279,2,174336,174694,128292,46402,2.764794621,87367,15618,9773,5561,4,5557,1,1137,0,0.003239158,mm10,mBC-0716-2
"B3,E7",15959,16693,12066,4627,8207,0,3838,3849,2754,1095,2.515068493,1890,1407,858,474,0,474,0,190,0,0.033755274,empty,mBC-0716-2
"B3,E8",17579,17736,13536,4200,8747,1,3878,3884,2775,1109,2.502254283,1791,1812,1075,633,0,633,0,243,0,0.048973144,empty,mBC-0716-2
"B3,E9",9079,9499,6795,2704,4641,0,2213,2215,1513,702,2.155270655,1119,1177,703,409,0,409,0,139,0,0.097799511,empty,mBC-0716-2
"B3,E10",13350,13867,10173,3694,6810,0,3147,3154,2195,959,2.288842544,1538,1464,888,514,0,514,0,213,0,0.029182879,empty,mBC-0716-2
"B3,E11",9297,9447,6955,2492,4763,6,2212,2221,1571,650,2.416923077,1066,959,565,369,1,368,1,168,0,0.010869565,empty,mBC-0716-2
"B3,E12",15689,16081,11808,4273,8038,1,3806,3816,2635,1181,2.231160034,1905,22291,6700,3932,4,3928,1,995,0,0.028258656,empty,mBC-0716-2
"B3,F1",18964,19585,14442,5143,9524,8,4411,4429,3111,1318,2.360394537,2139,1747,996,607,0,607,0,222,0,0.029654036,empty,mBC-0716-2
"B3,F2",23713,24493,17805,6688,11917,0,5607,5622,3987,1635,2.43853211,2742,2901,1699,1061,2,1059,1,401,0,0.058545798,empty,mBC-0716-2
"B3,F3",628140,670890,451492,219398,332154,2,175983,176290,114765,61525,1.865339293,98586,18971,12326,7035,5,7030,1,1367,0,0.005547653,mm10,mBC-0716-2
"B3,F4",16622,16892,12665,4227,8406,0,3810,3827,2660,1167,2.279348757,1765,6147,1843,1117,2,1115,2,310,0,0.032286996,empty,mBC-0716-2
"B3,F5",838141,878428,621516,256912,425406,0,215764,216160,165440,50720,3.261829653,110841,12193,7486,4223,1,4222,1,1001,0,0.003789673,mm10,mBC-0716-2
"B3,F6",24070,24945,18359,6586,11957,1,5497,5509,3849,1660,2.318674699,2620,2081,1231,739,0,739,0,281,0,0.027063599,empty,mBC-0716-2
"B3,F7",31371,33739,22882,10857,16298,0,8527,8535,6087,2448,2.486519608,4382,1140,670,394,0,394,0,160,0,0.058375635,empty,mBC-0716-2
"B3,F8",23388,24075,17654,6421,11702,0,5513,5529,3837,1692,2.267730496,2646,750,369,234,0,234,0,112,0,0.055555556,empty,mBC-0716-2
"B3,F9",138331,125488,120204,5284,64580,50,6517,6603,4652,1951,2.384418247,2079,3607,2030,1168,0,1168,0,430,0,0.006849315,empty,mBC-0716-2
"B3,F10",20807,21290,16199,5091,10376,1,4508,4520,3206,1314,2.439878234,2068,1308,749,450,0,450,0,200,0,0.042222222,empty,mBC-0716-2
"B3,F11",690210,741899,505277,236622,361609,14,186886,187235,160061,27174,5.890225951,97857,118215,78708,43610,18,43592,1,3631,0,0.00096348,mm10,mBC-0716-2
"B3,F12",14541,14940,10964,3976,7172,0,3386,3389,2332,1057,2.206244087,1646,184,106,60,0,60,0,44,0,0,empty,mBC-0716-2
"B3,G1",10680,10896,8138,2758,5395,0,2417,2424,1665,759,2.193675889,1140,1933,1239,728,0,728,0,222,0,0.020604396,empty,mBC-0716-2
"B3,G2",21736,21631,16482,5149,10699,18,4766,4792,3398,1394,2.43758967,2169,789,462,303,0,303,0,144,0,0.0330033,empty,mBC-0716-2
"B3,G3",1029802,1136893,712870,424023,542753,1,317848,318342,267489,50853,5.260043655,176973,140922,91014,49769,25,49744,3,4159,0,0.003578321,mm10,mBC-0716-2
"B3,G4",29789,30589,22884,7705,14675,0,6451,6472,4637,1835,2.526975477,3081,185,106,76,0,76,0,59,0,0,empty,mBC-0716-2
"B3,G5",13366,13532,10036,3496,6744,40,3055,3098,2195,903,2.430786268,1489,1205,730,505,0,505,0,238,0,0.003960396,empty,mBC-0716-2
"B3,G6",986308,1063565,719714,343851,509394,2,265390,265791,230796,34995,6.595113588,140695,10221,6316,3408,1,3407,1,719,0,0.003815674,mm10,mBC-0716-2
"B3,G7",1094474,1179236,769174,410062,569862,21,333522,334031,237292,96739,2.452909375,180924,31200,18439,10396,3,10393,1,1731,0,0.005869335,mm10,mBC-0716-2
"B3,G8",14965,15870,11322,4548,7686,5,3635,3652,2601,1051,2.474785918,1813,2562,1253,771,0,771,0,296,0,0.081712062,empty,mBC-0716-2
"B3,G9",11004,11194,8240,2954,5424,0,2478,2487,1775,712,2.492977528,1179,1198,739,474,0,474,0,233,0,0.016877637,empty,mBC-0716-2
"B3,G10",13896,14504,10653,3851,7052,5,3173,3182,2241,941,2.381509033,1548,1528,932,578,0,578,0,253,0,0.057093426,empty,mBC-0716-2
"B3,G11",12634,12784,9740,3044,6291,4,2806,2815,1992,823,2.420413123,1255,1028,584,314,1,313,1,139,0,0.019169329,empty,mBC-0716-2
"B3,G12",11766,12169,8925,3244,5993,0,2774,2780,1960,820,2.390243902,1349,1031,621,373,0,373,0,161,0,0.075067024,empty,mBC-0716-2
"B3,H1",21462,21821,16398,5423,10849,31,4958,5003,3518,1485,2.369023569,2399,964,584,353,0,353,0,156,0,0.039660057,empty,mBC-0716-2
"B3,H2",1131857,1235209,811069,424140,592137,46,328877,329448,251202,78246,3.210413312,177990,80675,53006,29350,14,29336,1,3133,0,0.002045269,mm10,mBC-0716-2
"B3,H3",21132,21326,15851,5475,10456,0,4862,4869,3458,1411,2.450744153,2282,1658,913,547,1,546,1,248,0,0.036630037,empty,mBC-0716-2
"B3,H4",1267078,1347810,900384,447426,648924,17,356775,357350,277092,80258,3.452515637,192284,5295,3179,1770,0,1770,0,476,0,0.01299435,mm10,mBC-0716-2
"B3,H5",24702,25950,18490,7460,12695,26,6215,6257,4566,1691,2.70017741,3197,3400,1400,835,1,834,1,297,0,0.020383693,empty,mBC-0716-2
"B3,H6",813886,874855,573505,301350,426229,0,237690,238055,175826,62229,2.825467226,129273,81679,53069,29723,13,29710,1,3120,0,0.001144396,mm10,mBC-0716-2
"B3,H7",16955,17745,12895,4850,8625,0,3908,3923,2684,1239,2.166263115,1927,2695,1263,738,0,738,0,284,0,0.032520325,empty,mBC-0716-2
"B3,H8",14204,14668,10730,3938,7009,28,3218,3255,2232,1023,2.181818182,1564,1703,1054,629,0,629,0,271,0,0.022257552,empty,mBC-0716-2
"B3,H9",17111,17417,12776,4641,8656,0,4008,4012,2892,1120,2.582142857,1942,1497,889,562,0,562,0,258,0,0.058718861,empty,mBC-0716-2
"B3,H10",1218381,1312181,880795,431386,631403,2,338213,338704,275298,63406,4.341828849,180567,124255,82572,45955,32,45923,2,3958,0,0.000479063,mm10,mBC-0716-2
"B3,H11",211072,237297,160815,76482,115445,0,60224,60338,50868,9470,5.371488912,31871,1821,1141,627,0,627,0,201,0,0.001594896,empty,mBC-0716-2
"B3,H12",6434,6730,4820,1910,3308,1,1548,1553,1075,478,2.248953975,811,645,387,252,0,252,0,98,0,0.103174603,empty,mBC-0716-2
"B4,A1",15555,16028,11879,4149,7827,1,3609,3623,2508,1115,2.249327354,1753,1039,609,369,0,369,0,155,0,0.01897019,empty,mBC-0716-2
"B4,A2",20139,20327,15535,4792,9762,0,4263,4267,3009,1258,2.391891892,1913,1581,856,526,0,526,0,209,0,0.009505703,empty,mBC-0716-2
"B4,A3",754354,865702,502137,363565,421174,2,270378,270724,200325,70399,2.845565988,158440,16289,10316,5701,7,5694,1,1170,0,0.002283105,mm10,mBC-0716-2
"B4,A4",1739658,1847655,1303608,544047,860793,1,435669,436468,338551,97917,3.457530357,224695,60122,34482,19312,10,19302,1,2489,0,0.013988188,mm10,mBC-0716-2
"B4,A5",17709,18444,13554,4890,8999,13,4058,4083,2812,1271,2.212431157,1975,1346,783,446,1,445,1,217,0,0.013483146,empty,mBC-0716-2
"B4,A6",17818,18652,13496,5156,9050,3,4249,4257,3020,1237,2.441390461,2089,1451,799,460,0,460,0,182,0,0.056521739,empty,mBC-0716-2
"B4,A7",16553,17272,12626,4646,8212,11,3783,3801,2664,1137,2.343007916,1754,1244,753,427,0,427,0,172,0,0.056206089,empty,mBC-0716-2
"B4,A8",10871,11344,8324,3020,5537,0,2571,2574,1815,759,2.391304348,1221,1683,873,525,0,525,0,210,0,0.064761905,empty,mBC-0716-2
"B4,A9",19187,19929,14670,5259,9251,56,4046,4108,2922,1186,2.463743676,1968,1464,900,530,0,530,0,198,0,0.077358491,empty,mBC-0716-2
"B4,A10",1020394,1096409,711182,385227,518214,1,293449,293894,234165,59729,3.920457399,160568,21927,12620,7155,4,7151,1,1225,0,0.005593623,mm10,mBC-0716-2
"B4,A11",19585,20062,15055,5007,9668,0,4288,4296,2974,1322,2.249621785,2009,1301,811,463,0,463,0,175,0,0.097192225,empty,mBC-0716-2
"B4,A12",21629,22444,16552,5892,10476,1,4710,4716,3350,1366,2.452415813,2240,2548,1525,884,0,884,0,264,0,0.083710407,empty,mBC-0716-2
"B4,B1",19393,20070,14848,5222,9609,0,4417,4428,3085,1343,2.297096054,2073,1339,779,457,1,456,1,186,0,0.032894737,empty,mBC-0716-2
"B4,B2",20653,20893,15667,5226,10065,25,4531,4565,3210,1355,2.36900369,2162,395,211,115,0,115,0,65,0,0.034782609,empty,mBC-0716-2
"B4,B3",18435,18830,14091,4739,9092,0,4122,4130,2894,1236,2.341423948,1892,1201,667,410,0,410,0,169,0,0.051219512,empty,mBC-0716-2
"B4,B4",17054,17544,12973,4571,8336,8,3724,3750,2696,1054,2.557874763,1789,1029,546,359,0,359,0,160,0,0.036211699,empty,mBC-0716-2
"B4,B5",9338,5630,3966,1664,3531,0,1716,1729,1176,553,2.126582278,897,2270,836,509,0,509,0,199,0,0.011787819,empty,mBC-0716-2
"B4,B6",13651,14377,10181,4196,7061,23,3369,3400,2374,1026,2.313840156,1762,1266,750,425,0,425,0,174,0,0.058823529,empty,mBC-0716-2
"B4,B7",16549,16362,12626,3736,7892,1,3542,3556,2498,1058,2.361058601,1637,16039,4662,2712,2,2710,2,711,0,0.065313653,empty,mBC-0716-2
"B4,B8",13372,13531,10301,3230,6566,5,2965,2972,2058,914,2.251641138,1332,1281,805,492,0,492,0,211,0,0.016260163,empty,mBC-0716-2
"B4,B9",1031104,1114788,743425,371363,523906,0,283586,284101,246116,37985,6.479294458,150755,81589,54459,30206,16,30190,3,2973,0,0.002020537,mm10,mBC-0716-2
"B4,B10",16829,17318,12503,4815,8467,0,3940,3959,2737,1222,2.239770867,1943,633,368,226,0,226,0,110,0,0.07079646,empty,mBC-0716-2
"B4,B11",17468,17961,13256,4705,8634,0,3961,3971,2770,1201,2.306411324,1928,231,124,86,0,86,0,61,0,0.011627907,empty,mBC-0716-2
"B4,B12",887973,1030005,607616,422389,497907,8,304472,304873,218841,86032,2.543716292,180003,54151,34540,19108,10,19098,1,2315,0,0.001099592,mm10,mBC-0716-2
"B4,C1",22359,22817,17207,5610,10708,15,4625,4654,3341,1313,2.544554455,2172,696,456,278,0,278,0,126,0,0.025179856,empty,mBC-0716-2
"B4,C2",20018,20422,15012,5410,9662,17,4352,4387,3078,1309,2.351413293,2111,4470,1799,1047,0,1047,0,289,0,0.087870105,empty,mBC-0716-2
"B4,C3",20573,21151,15512,5639,9926,10,4535,4553,3137,1416,2.21539548,2195,4441,1369,820,1,819,1,261,0,0.081807082,empty,mBC-0716-2
"B4,C4",18912,19011,14439,4572,9222,0,4016,4032,2911,1121,2.596788582,1855,6948,2410,1414,2,1412,1,427,0,0.067988669,empty,mBC-0716-2
"B4,C5",19172,20027,14375,5652,9787,0,4810,4813,3422,1391,2.460100647,2389,928,541,356,0,356,0,196,0,0.036516854,empty,mBC-0716-2
"B4,C6",17415,17885,13154,4731,8791,1,4035,4044,2873,1171,2.453458582,1949,6350,2372,1413,0,1413,0,402,0,0.170559094,empty,mBC-0716-2
"B4,C7",793335,838764,570000,268764,404886,3,220406,220742,171767,48975,3.507238387,117574,6024,3957,2273,1,2272,1,530,0,0.003961268,mm10,mBC-0716-2
"B4,C8",15693,16078,11837,4241,7690,2,3523,3537,2450,1087,2.253909844,1668,1228,778,474,0,474,0,198,0,0.048523207,empty,mBC-0716-2
"B4,C9",13610,13807,10250,3557,6548,22,2981,3011,2111,900,2.345555556,1437,2588,1043,638,1,637,1,228,0,0.069073783,empty,mBC-0716-2
"B4,C10",14280,14789,11057,3732,7101,0,3211,3214,2220,994,2.233400402,1512,901,466,290,0,290,0,136,0,0.034482759,empty,mBC-0716-2
"B4,C11",11925,12260,8992,3268,5857,22,2635,2659,1807,852,2.120892019,1278,1085,698,399,0,399,0,149,0,0.077694236,empty,mBC-0716-2
"B4,C12",20258,20692,15224,5468,9895,0,4585,4600,3257,1343,2.425167535,2214,2498,961,530,2,528,1,200,0,0.009469697,empty,mBC-0716-2
"B4,D1",12853,13260,9767,3493,6554,1,3068,3071,2122,949,2.236037935,1488,624,337,243,0,243,0,108,0,0.032921811,empty,mBC-0716-2
"B4,D2",21334,22067,16435,5632,10498,15,4658,4675,3339,1336,2.499251497,2193,2461,1477,868,1,867,1,299,0,0.056516724,empty,mBC-0716-2
"B4,D3",13988,14781,10534,4247,7164,0,3381,3386,2392,994,2.406438632,1724,1076,626,390,0,390,0,176,0,0.056410256,empty,mBC-0716-2
"B4,D4",15149,15768,11616,4152,7511,19,3331,3357,2399,958,2.504175365,1603,1197,763,496,0,496,0,234,0,0.038306452,empty,mBC-0716-2
"B4,D5",14891,15625,11308,4317,7568,0,3523,3530,2416,1114,2.168761221,1764,1089,649,378,0,378,0,160,0,0.034391534,empty,mBC-0716-2
"B4,D6",855882,976319,586612,389707,470302,8,290144,290550,213979,76571,2.794517507,167899,67277,42371,23651,8,23643,2,2763,0,0.001607241,mm10,mBC-0716-2
"B4,D7",540692,576931,398122,178809,283852,16,147998,148243,108843,39400,2.76251269,78622,12587,7303,4188,2,4186,1,912,0,0.006688963,mm10,mBC-0716-2
"B4,D8",16271,16822,12362,4460,8011,0,3818,3825,2654,1171,2.266438941,1868,1025,588,373,1,372,1,182,0,0.02688172,empty,mBC-0716-2
"B4,D9",6764,7048,4987,2061,3419,0,1629,1633,1167,466,2.504291845,821,27780,7856,4610,5,4605,3,1110,0,0.055157438,empty,mBC-0716-2
"B4,D10",15017,15586,11333,4253,7486,0,3613,3619,2505,1114,2.248653501,1750,971,553,326,0,326,0,117,0,0.180981595,empty,mBC-0716-2
"B4,D11",900710,1038761,597885,440876,497091,15,317418,317866,261089,56777,4.598499392,185191,135025,79048,43672,19,43653,1,3925,0,0.006643301,mm10,mBC-0716-2
"B4,D12",20841,21168,15639,5529,10099,0,4578,4599,3187,1412,2.257082153,2203,17709,5465,3204,3,3201,2,719,0,0.091533896,empty,mBC-0716-2
"B4,E1",23552,23794,17612,6182,11210,4,5119,5142,3580,1562,2.291933419,2408,70990,20005,11915,16,11899,4,2195,0,0.031347172,empty,mBC-0716-2
"B4,E2",17290,17677,13253,4424,8405,45,3665,3722,2661,1061,2.50801131,1702,10569,3463,2043,2,2041,1,571,0,0.036256737,empty,mBC-0716-2
"B4,E3",913943,1060545,614568,445977,508508,4,322283,322680,231018,91662,2.520324671,190735,97690,60178,33913,7,33906,2,3228,0,0.002713384,mm10,mBC-0716-2
"B4,E4",15595,16187,12012,4175,7702,0,3458,3470,2468,1002,2.463073852,1643,1414,767,463,0,463,0,186,0,0.058315335,empty,mBC-0716-2
"B4,E5",20657,20949,15885,5064,10142,0,4445,4458,3127,1331,2.349361382,2043,8866,2796,1701,7,1694,2,496,0,0.034828808,empty,mBC-0716-2
"B4,E6",16374,16826,12472,4354,7879,69,3514,3585,2514,1071,2.347338936,1710,1491,816,506,0,506,0,223,0,0.033596838,empty,mBC-0716-2
"B4,E7",578435,598993,436061,162932,289805,23,134036,134358,102137,32221,3.169889203,67875,4364,2056,1339,0,1339,0,547,0,0.03360717,mm10,mBC-0716-2
"B4,E8",18021,18495,13674,4821,9014,0,4054,4066,2868,1198,2.393989983,1930,1529,896,525,0,525,0,202,0,0.026666667,empty,mBC-0716-2
"B4,E9",10983,11502,8291,3211,5358,51,2457,2509,1779,730,2.436986301,1217,2151,1044,600,0,600,0,226,0,0.123333333,empty,mBC-0716-2
"B4,E10",12933,13247,10044,3203,6535,10,2990,3005,2098,907,2.313120176,1343,1288,744,473,1,472,1,189,0,0.063559322,empty,mBC-0716-2
"B4,E11",9624,9945,7323,2622,4901,10,2276,2291,1585,706,2.245042493,1070,1295,786,431,0,431,0,161,0,0.027842227,empty,mBC-0716-2
"B4,E12",16462,17004,12579,4425,8244,26,3768,3807,2653,1154,2.298960139,1793,1067,636,366,0,366,0,134,0,0.128415301,empty,mBC-0716-2
"B4,F1",18142,18670,13739,4931,9063,0,4089,4104,2860,1244,2.29903537,2046,1335,845,501,0,501,0,193,0,0.05988024,empty,mBC-0716-2
"B4,F2",23432,24049,17872,6177,11557,0,5309,5321,3767,1554,2.424066924,2534,7340,3086,1899,2,1897,1,599,0,0.05904059,empty,mBC-0716-2
"B4,F3",16970,17562,12616,4946,8695,1,4192,4207,2982,1225,2.434285714,2113,2159,1077,676,0,676,0,280,0,0.036982249,empty,mBC-0716-2
"B4,F4",17575,17755,13310,4445,8578,1,3834,3839,2728,1111,2.455445545,1848,541,326,189,0,189,0,89,0,0,empty,mBC-0716-2
"B4,F5",2170232,2425855,1536738,889117,1131581,7,670962,671926,507419,164507,3.084482727,375338,196043,118576,66110,26,66084,4,4910,0,0.002269838,mm10,mBC-0716-2
"B4,F6",24879,25798,18817,6981,12236,7,5684,5701,4047,1654,2.446795647,2768,1968,1147,672,0,672,0,255,0,0.069940476,empty,mBC-0716-2
"B4,F7",20857,21411,15770,5641,10332,2,4694,4705,3281,1424,2.304073034,2258,2357,922,516,0,516,0,193,0,0.071705426,empty,mBC-0716-2
"B4,F8",22203,22954,17019,5935,11070,8,5016,5048,3545,1503,2.358616101,2401,280,168,124,0,124,0,89,0,0.056451613,empty,mBC-0716-2
"B4,F9",15135,15519,11511,4008,7494,0,3423,3427,2332,1095,2.129680365,1641,3216,1501,883,0,883,0,290,0,0.105322763,empty,mBC-0716-2
"B4,F10",20170,20441,15756,4685,9944,1,4354,4362,3152,1210,2.604958678,1971,2048,998,581,0,581,0,203,0,0.051635112,empty,mBC-0716-2
"B4,F11",11580,11679,8838,2841,5670,13,2498,2514,1725,789,2.186311787,1180,1049,626,359,0,359,0,161,0,0.04735376,empty,mBC-0716-2
"B4,F12",14755,15702,11153,4549,7345,1,3445,3451,2400,1051,2.283539486,1717,376,149,105,0,105,0,60,0,0,empty,mBC-0716-2
"B4,G1",9689,9965,7441,2524,4879,2,2183,2195,1506,689,2.185776488,1040,11931,3798,2258,3,2255,1,599,0,0.014634146,empty,mBC-0716-2
"B4,G2",21636,22162,16703,5459,10736,1,4801,4819,3401,1418,2.398448519,2225,749,428,284,0,284,0,152,0,0.01056338,empty,mBC-0716-2
"B4,G3",24584,25406,18300,7106,12254,0,5767,5778,4076,1702,2.394829612,2836,1755,1010,635,0,635,0,263,0,0.022047244,empty,mBC-0716-2
"B4,G4",28721,29357,22123,7234,13924,1,6224,6239,4408,1831,2.407427635,2900,170,113,69,0,69,0,53,0,0.028985507,empty,mBC-0716-2
"B4,G5",14406,14833,10880,3953,7084,0,3214,3215,2270,945,2.402116402,1573,2671,1040,643,0,643,0,283,0,0.01088647,empty,mBC-0716-2
"B4,G6",25668,26205,19581,6624,12378,5,5506,5528,3907,1621,2.410240592,2605,1039,400,229,0,229,0,104,0,0.07860262,empty,mBC-0716-2
"B4,G7",19767,20319,15264,5055,9899,32,4317,4371,3067,1304,2.351993865,2086,1799,1082,639,0,639,0,249,0,0.0657277,empty,mBC-0716-2
"B4,G8",15196,15941,11477,4464,7692,1,3604,3613,2566,1047,2.450811843,1770,1644,1016,631,0,631,0,231,0,0.025356577,empty,mBC-0716-2
"B4,G9",14421,15584,10830,4754,7435,0,3609,3628,2609,1019,2.560353288,1866,1769,975,581,0,581,0,215,0,0.029259897,empty,mBC-0716-2
"B4,G10",13865,14154,10718,3436,6897,0,3049,3057,2152,905,2.377900552,1440,1305,755,450,1,449,1,210,0,0.042316258,empty,mBC-0716-2
"B4,G11",13067,13637,10031,3606,6500,0,2950,2958,2066,892,2.316143498,1453,755,497,281,0,281,0,119,0,0.046263345,empty,mBC-0716-2
"B4,G12",11986,12551,9032,3519,6092,3,2892,2903,2050,853,2.403282532,1443,1127,650,385,0,385,0,192,0,0.031168831,empty,mBC-0716-2
"B4,H1",21059,22087,15584,6503,10466,0,4912,4923,3454,1469,2.35125936,2417,855,486,304,0,304,0,146,0,0.098684211,empty,mBC-0716-2
"B4,H2",25890,26472,19692,6780,12650,8,5790,5816,4157,1659,2.505726341,2768,1712,1095,684,1,683,1,277,0,0.03806735,empty,mBC-0716-2
"B4,H3",21570,22533,16431,6102,10677,33,4804,4851,3336,1515,2.201980198,2363,1522,881,499,0,499,0,192,0,0.034068136,empty,mBC-0716-2
"B4,H4",16100,16438,12263,4175,7736,41,3475,3521,2438,1083,2.251154201,1646,1521,426,256,0,256,0,108,0,0.0234375,empty,mBC-0716-2
"B4,H5",27648,28729,21141,7588,13640,0,6450,6466,4663,1803,2.586245147,3164,3422,1351,784,0,784,0,280,0,0.098214286,empty,mBC-0716-2
"B4,H6",16286,16862,12365,4497,7997,3,3711,3726,2598,1128,2.303191489,1800,1594,952,576,0,576,0,214,0,0.006944444,empty,mBC-0716-2
"B4,H7",17457,17999,13275,4724,8710,0,4042,4060,2791,1269,2.199369582,1958,1562,916,474,1,473,1,186,0,0.044397463,empty,mBC-0716-2
"B4,H8",695327,785113,484196,300917,378497,1,220055,220441,174260,46181,3.773413309,126414,107267,69222,38998,7,38991,1,3590,0,0.00151317,mm10,mBC-0716-2
"B4,H9",18179,18774,13848,4926,9093,2,4264,4272,3132,1140,2.747368421,2027,1277,731,430,0,430,0,221,0,0.041860465,empty,mBC-0716-2
"B4,H10",15978,16520,12014,4506,8036,0,3773,3780,2666,1114,2.393177738,1868,1329,830,511,0,511,0,238,0,0.021526419,empty,mBC-0716-2
"B4,H11",1070700,1163342,744336,419006,552375,3,319294,319763,275321,44442,6.195063228,175214,1175,801,484,2,482,1,149,0,0,empty,mBC-0716-2
"B4,H12",6916,7114,5341,1773,3503,0,1661,1667,1177,490,2.402040816,769,632,320,207,1,206,1,90,0,0.082524272,empty,mBC-0716-2
"B5,A1",14971,15281,11241,4040,7515,5,3434,3444,2382,1062,2.242937853,1644,3332,1254,764,1,763,1,266,0,0.134993447,empty,mBC-0716-2
"B5,A2",19797,19967,15195,4772,9718,0,4309,4318,3004,1314,2.286149163,1974,1309,655,419,0,419,0,199,0,0.047732697,empty,mBC-0716-2
"B5,A3",18470,18869,13579,5290,8959,0,4169,4176,3024,1152,2.625,2014,8839,3067,1862,0,1862,0,498,0,0.17132116,empty,mBC-0716-2
"B5,A4",22704,23025,17529,5496,10974,1,4938,4947,3571,1376,2.595203488,2247,673,402,273,0,273,0,128,0,0.021978022,empty,mBC-0716-2
"B5,A5",18903,19489,14322,5167,9623,1,4479,4484,3108,1376,2.25872093,2182,1575,944,573,0,573,0,281,0,0.041884817,empty,mBC-0716-2
"B5,A6",587634,648968,402928,246040,319642,1,190365,190610,143191,47419,3.019696746,107805,13373,8299,4761,3,4758,1,1067,0,0.002311896,mm10,mBC-0716-2
"B5,A7",16850,17485,12745,4740,8360,0,3876,3877,2703,1174,2.302385009,1861,10672,3466,2073,5,2068,2,631,0,0.054158607,empty,mBC-0716-2
"B5,A8",11491,11691,8672,3019,5743,0,2687,2689,1925,764,2.519633508,1264,1643,952,570,0,570,0,233,0,0.029824561,empty,mBC-0716-2
"B5,A9",22879,23250,17403,5847,11200,0,5078,5091,3618,1473,2.456211813,2385,1480,891,500,1,499,1,230,0,0.03006012,empty,mBC-0716-2
"B5,A10",17403,17444,12923,4521,8266,1,3765,3770,2686,1084,2.477859779,1811,1317,510,332,0,332,0,145,0,0.108433735,empty,mBC-0716-2
"B5,A11",1762055,1913252,1233975,679277,911419,2,535806,536672,413709,122963,3.36449989,291350,46191,27405,15425,7,15418,2,2373,0,0.002918666,mm10,mBC-0716-2
"B5,A12",21979,22404,16592,5812,10832,5,4848,4861,3378,1483,2.277815239,2359,2429,1449,873,0,873,0,284,0,0.088201604,empty,mBC-0716-2
"B5,B1",20407,21301,15656,5645,10329,0,4744,4751,3238,1513,2.140118969,2289,1172,676,399,0,399,0,183,0,0.032581454,empty,mBC-0716-2
"B5,B2",21897,22553,16669,5884,10658,0,4815,4820,3362,1458,2.305898491,2273,1323,507,297,1,296,1,134,0,0.108108108,empty,mBC-0716-2
"B5,B3",1095305,1180010,797454,382556,561500,3,300140,300613,232893,67720,3.439057885,158900,62432,38758,21731,10,21721,1,2674,0,0.000966806,mm10,mBC-0716-2
"B5,B4",18183,18808,13740,5068,8980,1,4119,4122,2859,1263,2.263657957,1988,10322,3384,2018,2,2016,2,595,0,0.071428571,empty,mBC-0716-2
"B5,B5",561361,299300,219554,79746,193760,5,82649,83395,67490,15905,4.243319711,44260,62039,36802,20425,7,20418,1,2525,0,0.003379371,mm10,mBC-0716-2
"B5,B6",669003,737382,468231,269151,359939,5,204603,204852,141038,63814,2.210141975,116097,31960,20773,11959,3,11956,2,1707,0,0.002091,mm10,mBC-0716-2
"B5,B7",17644,18107,13431,4676,8702,16,3874,3895,2754,1141,2.413672217,1869,6281,2010,1214,1,1213,1,386,0,0.012366035,empty,mBC-0716-2
"B5,B8",14782,15435,11358,4077,7536,7,3517,3530,2479,1051,2.358705994,1727,1262,743,437,0,437,0,219,0,0.032036613,empty,mBC-0716-2
"B5,B9",15816,15952,12280,3672,7708,0,3371,3376,2391,985,2.427411168,1562,696,425,260,0,260,0,148,0,0.007692308,empty,mBC-0716-2
"B5,B10",17421,17738,12889,4849,8721,13,3998,4021,2750,1271,2.163650669,1959,541,316,204,0,204,0,100,0,0.019607843,empty,mBC-0716-2
"B5,B11",21873,22995,16370,6625,11100,0,5311,5326,3888,1438,2.703755216,2706,270,161,95,0,95,0,62,0,0,empty,mBC-0716-2
"B5,B12",19612,20389,14963,5426,9787,6,4513,4530,3202,1328,2.411144578,2130,1475,895,530,0,530,0,215,0,0.037735849,empty,mBC-0716-2
"B5,C1",915919,929243,709977,219266,441605,2,193621,194054,141043,53011,2.660636472,90593,11437,6049,3426,2,3424,1,857,0,0.007593458,mm10,mBC-0716-2
"B5,C2",20193,20436,15220,5216,9779,0,4563,4568,3139,1429,2.196641008,2136,11565,3906,2303,2,2301,2,593,0,0.062146893,empty,mBC-0716-2
"B5,C3",21442,22102,16041,6061,10615,0,4890,4898,3375,1523,2.216021011,2396,615,392,232,1,231,1,100,0,0.082251082,empty,mBC-0716-2
"B5,C4",18149,18114,13811,4303,8978,28,3823,3869,2748,1121,2.451382694,1792,1086,617,375,1,374,1,150,0,0.082887701,empty,mBC-0716-2
"B5,C5",17557,18363,13377,4986,8988,4,4178,4192,3023,1169,2.585970915,2083,1414,842,504,0,504,0,240,0,0.045634921,empty,mBC-0716-2
"B5,C6",2252499,2477559,1532841,944718,1207775,7,756641,757734,558646,199088,2.806025476,426566,32721,19219,11075,7,11068,1,1931,0,0.004607879,mm10,mBC-0716-2
"B5,C7",17926,18945,13394,5551,9099,0,4390,4398,3023,1375,2.198545455,2189,333,217,155,0,155,0,85,0,0,empty,mBC-0716-2
"B5,C8",15876,16025,11972,4053,7894,0,3583,3600,2514,1086,2.314917127,1675,1425,848,527,0,527,0,212,0,0.028462998,empty,mBC-0716-2
"B5,C9",13734,14208,10440,3768,6952,28,3252,3287,2308,979,2.357507661,1581,913,527,345,0,345,0,154,0,0.017391304,empty,mBC-0716-2
"B5,C10",14795,15056,11153,3903,7389,0,3379,3386,2366,1020,2.319607843,1580,5303,1985,1168,5,1163,2,382,0,0.123817713,empty,mBC-0716-2
"B5,C11",12471,12940,9404,3536,6318,0,2995,2998,2044,954,2.142557652,1466,843,561,347,0,347,0,158,0,0.014409222,empty,mBC-0716-2
"B5,C12",20644,21276,15667,5609,10428,0,4807,4818,3403,1415,2.404946996,2339,1070,583,353,0,353,0,155,0,0.062322946,empty,mBC-0716-2
"B5,D1",12135,12263,9103,3160,6120,6,2855,2865,1984,881,2.251986379,1332,603,336,211,0,211,0,106,0,0.071090047,empty,mBC-0716-2
"B5,D2",22373,22675,17406,5269,11009,0,4872,4881,3382,1499,2.256170781,2217,2672,1631,984,0,984,0,373,0,0.031504065,empty,mBC-0716-2
"B5,D3",14652,15284,11152,4132,7381,0,3507,3511,2441,1070,2.281308411,1706,1244,735,445,0,445,0,216,0,0.051685393,empty,mBC-0716-2
"B5,D4",15672,16167,12000,4167,7967,0,3638,3640,2542,1098,2.315118397,1709,1592,913,549,0,549,0,273,0,0.029143898,empty,mBC-0716-2
"B5,D5",14680,15259,11005,4254,7234,27,3264,3307,2281,1026,2.223196881,1603,1038,641,368,0,368,0,160,0,0.024456522,empty,mBC-0716-2
"B5,D6",13350,13881,10105,3776,6724,1,3171,3179,2224,955,2.328795812,1558,1265,775,482,0,482,0,215,0,0.062240664,empty,mBC-0716-2
"B5,D7",13704,13981,10292,3689,6767,12,3181,3197,2219,978,2.268916155,1529,1221,741,437,2,435,1,196,0,0.04137931,empty,mBC-0716-2
"B5,D8",17348,18057,13130,4927,8712,28,4117,4151,2885,1266,2.278830964,2003,1016,604,352,0,352,0,170,0,0.039772727,empty,mBC-0716-2
"B5,D9",228449,242316,164263,78053,122120,12,62490,62591,51317,11274,4.551800603,33440,82140,52388,29152,11,29141,2,3178,0,0.001715796,mm10,mBC-0716-2
"B5,D10",14563,14779,11099,3680,7139,23,3279,3307,2269,1038,2.185934489,1596,642,404,246,0,246,0,123,0,0.032520325,empty,mBC-0716-2
"B5,D11",810406,888122,570006,318116,434803,1,254481,254911,202316,52595,3.846677441,139671,14797,7685,4242,3,4239,2,1022,0,0.012974758,mm10,mBC-0716-2
"B5,D12",21970,22534,16559,5975,10808,0,4892,4902,3469,1433,2.420795534,2324,2040,1097,665,1,664,1,269,0,0.028614458,empty,mBC-0716-2
"B5,E1",2125331,2362486,1441655,920831,1125820,1,704133,705078,558936,146142,3.824608942,400346,76194,47836,26648,13,26635,2,3238,0,0.009123334,mm10,mBC-0716-2
"B5,E2",17067,17033,12994,4039,8443,23,3863,3901,2756,1145,2.4069869,1739,3696,1568,984,1,983,1,303,0,0.141403866,empty,mBC-0716-2
"B5,E3",13189,13360,10144,3216,6553,0,2920,2922,2043,879,2.324232082,1305,1888,996,649,0,649,0,259,0,0.041602465,empty,mBC-0716-2
"B5,E4",16614,17192,12648,4544,8219,12,3692,3714,2586,1128,2.292553191,1783,1386,787,457,0,457,0,201,0,0.074398249,empty,mBC-0716-2
"B5,E5",21972,22771,17086,5685,11010,12,4937,4955,3488,1467,2.377641445,2289,1509,866,597,0,597,0,286,0,0.018425461,empty,mBC-0716-2
"B5,E6",14482,14866,10899,3967,7358,38,3345,3390,2361,1029,2.294460641,1670,1555,889,586,1,585,1,281,0,0.056410256,empty,mBC-0716-2
"B5,E7",14771,15242,11245,3997,7359,0,3361,3366,2360,1006,2.345924453,1602,1395,798,511,1,510,1,209,0,0.056862745,empty,mBC-0716-2
"B5,E8",18044,17963,13831,4132,8836,0,3824,3843,2632,1211,2.173410405,1736,1666,988,618,0,618,0,254,0,0.042071197,empty,mBC-0716-2
"B5,E9",9668,10024,7310,2714,4947,13,2304,2324,1655,669,2.473841555,1113,935,572,339,0,339,0,149,0,0.050147493,empty,mBC-0716-2
"B5,E10",1931815,2122650,1353840,768810,1001473,0,590913,591853,483071,108782,4.440725488,324293,187021,120731,68385,33,68352,2,4757,0,0.000790028,mm10,mBC-0716-2
"B5,E11",9581,9802,7330,2472,4896,0,2232,2235,1552,683,2.272327965,1075,1213,748,389,0,389,0,175,0,0.035989717,empty,mBC-0716-2
"B5,E12",16471,17156,12417,4739,8277,28,3833,3866,2719,1147,2.370531822,1872,1071,641,348,0,348,0,170,0,0.020114943,empty,mBC-0716-2
"B5,F1",960963,1089098,668214,420884,524981,4,315256,315637,257081,58556,4.390344286,178395,83964,55594,30653,12,30641,1,3067,0,0.002904605,mm10,mBC-0716-2
"B5,F2",24006,24673,18029,6644,11742,8,5477,5496,3762,1734,2.169550173,2593,2685,1571,1016,0,1016,0,408,0,0.051181102,empty,mBC-0716-2
"B5,F3",17019,17393,12772,4621,8571,4,4036,4046,2834,1212,2.338283828,1951,1852,1179,740,0,740,0,308,0,0.062162162,empty,mBC-0716-2
"B5,F4",16642,16633,12739,3894,8233,3,3719,3737,2635,1102,2.391107078,1722,818,378,230,0,230,0,102,0,0,empty,mBC-0716-2
"B5,F5",26491,27160,19867,7293,13273,0,6102,6111,4305,1806,2.38372093,2907,1737,1036,673,0,673,0,340,0,0.037147103,empty,mBC-0716-2
"B5,F6",34984,35841,26672,9169,17286,0,7925,7959,5893,2066,2.852371733,3759,3119,1843,1116,0,1116,0,369,0,0.045698925,empty,mBC-0716-2
"B5,F7",1148696,1224235,852631,371604,585646,1,298357,298827,253579,45248,5.604203501,153906,51836,32870,18530,6,18524,1,2373,0,0.001241632,mm10,mBC-0716-2
"B5,F8",474733,482090,354572,127518,239680,3,112964,113131,89232,23899,3.733712708,55113,946,594,376,0,376,0,179,0,0.013297872,empty,mBC-0716-2
"B5,F9",16255,16696,12485,4211,8009,26,3647,3690,2511,1179,2.129770992,1739,1440,816,506,0,506,0,223,0,0.065217391,empty,mBC-0716-2
"B5,F10",23253,23787,17874,5913,11384,31,4976,5015,3529,1486,2.374831763,2322,1479,859,511,1,510,1,204,0,0.017647059,empty,mBC-0716-2
"B5,F11",778686,825694,583964,241730,399015,0,195050,195346,163601,31745,5.153598992,99392,86391,55963,31539,10,31529,1,3076,0,0.001014939,mm10,mBC-0716-2
"B5,F12",15324,16080,11469,4611,7719,26,3567,3599,2524,1075,2.347906977,1814,208,131,83,0,83,0,48,0,0,empty,mBC-0716-2
"B5,G1",11084,11013,8541,2472,5363,29,2283,2321,1628,693,2.349206349,1020,1606,1030,637,0,637,0,224,0,0.025117739,empty,mBC-0716-2
"B5,G2",22665,23453,17155,6298,11229,16,5123,5147,3644,1503,2.424484365,2490,975,536,346,0,346,0,177,0,0.011560694,empty,mBC-0716-2
"B5,G3",718511,736252,532949,203303,358324,24,173512,173818,138787,35031,3.961833804,87052,23071,15064,8750,4,8746,1,1501,0,0.006402927,mm10,mBC-0716-2
"B5,G4",927846,947620,698097,249523,457941,0,217898,218309,173095,45214,3.828349626,106996,361,187,130,0,130,0,83,0,0,empty,mBC-0716-2
"B5,G5",960348,1092603,657770,434833,523349,21,318887,319368,243812,75556,3.226904548,181357,157722,92564,51898,18,51880,1,4478,0,0.018138011,mm10,mBC-0716-2
"B5,G6",26522,27232,20353,6879,13003,0,5768,5779,4112,1667,2.466706659,2758,276,158,119,0,119,0,73,0,0,empty,mBC-0716-2
"B5,G7",21698,22205,16762,5443,10812,1,4816,4835,3374,1461,2.309377139,2233,3374,1332,772,0,772,0,313,0,0.055699482,empty,mBC-0716-2
"B5,G8",737199,809214,523621,285593,397464,3,228642,228967,175939,53028,3.317850947,125623,22935,10224,5878,3,5875,1,1307,0,0.040340426,mm10,mBC-0716-2
"B5,G9",11403,11757,8592,3165,5749,0,2742,2750,1982,768,2.580729167,1338,1193,723,469,0,469,0,239,0,0.025586354,empty,mBC-0716-2
"B5,G10",15024,15465,11397,4068,7414,66,3265,3335,2406,929,2.589881593,1591,2046,1209,716,0,716,0,289,0,0.026536313,empty,mBC-0716-2
"B5,G11",13181,13662,10026,3636,6648,0,3065,3070,2128,942,2.259023355,1494,673,426,277,0,277,0,131,0,0.054151625,empty,mBC-0716-2
"B5,G12",848150,944388,592792,351596,465220,1,268662,268992,224228,44764,5.009114467,149399,120396,75374,42150,21,42129,2,3714,0,0.006859883,mm10,mBC-0716-2
"B5,H1",22164,22365,16996,5369,10737,0,4739,4754,3357,1397,2.403006442,2156,972,575,346,0,346,0,181,0,0.040462428,empty,mBC-0716-2
"B5,H2",1282681,1403864,917673,486191,666901,0,373431,373973,305065,68908,4.42713473,202929,89029,57639,32461,20,32441,3,3227,0,0.001078882,mm10,mBC-0716-2
"B5,H3",22617,23464,17172,6292,11188,7,5175,5188,3661,1527,2.39751146,2430,1747,1066,655,0,655,0,264,0,0.018320611,empty,mBC-0716-2
"B5,H4",1437672,1523437,1042699,480738,727814,2,382879,383484,308976,74508,4.146883556,201326,7470,4815,2814,4,2810,2,668,0,0.000355872,mm10,mBC-0716-2
"B5,H5",19333,20525,14497,6028,9607,66,4393,4467,3160,1307,2.417750574,2239,1307,784,507,1,506,1,216,0,0.017786561,empty,mBC-0716-2
"B5,H6",14772,15323,10939,4384,7635,7,3539,3550,2416,1134,2.130511464,1823,1476,927,540,1,539,1,255,0,0.044526902,empty,mBC-0716-2
"B5,H7",17740,18614,13346,5268,9121,0,4268,4284,2999,1285,2.33385214,2116,1721,997,619,0,619,0,258,0,0.08723748,empty,mBC-0716-2
"B5,H8",14289,14752,10820,3932,7208,11,3396,3411,2426,985,2.462944162,1667,1583,976,629,0,629,0,272,0,0.036565978,empty,mBC-0716-2
"B5,H9",1719070,1854732,1226791,627941,884767,0,485062,485810,379481,106329,3.568932276,264649,165270,104355,58533,25,58508,1,4647,0,0.001965543,mm10,mBC-0716-2
"B5,H10",15677,15971,11817,4154,7749,11,3529,3550,2531,1019,2.483807655,1668,1371,814,537,0,537,0,272,0,0.039106145,empty,mBC-0716-2
"B5,H11",17549,17827,13295,4532,8779,0,4131,4142,2871,1271,2.258851298,1927,216,129,84,0,84,0,61,0,0,empty,mBC-0716-2
"B5,H12",6921,7054,5119,1935,3474,0,1624,1624,1130,494,2.287449393,786,520,283,178,0,178,0,94,0,0.028089888,empty,mBC-0716-2
"B6,A1",771369,874141,520805,353336,430891,0,266220,266628,196726,69902,2.814311465,153030,32132,21346,12009,6,12003,2,1770,0,0.001083063,mm10,mBC-0716-2
"B6,A2",1083364,1225881,699689,526192,589574,0,389783,390274,297317,92957,3.198435836,230725,5120,3333,1744,2,1742,1,565,0,0.025258324,mm10,mBC-0716-2
"B6,A3",16758,17079,12491,4588,8318,1,3863,3869,2739,1130,2.423893805,1842,712,446,293,0,293,0,149,0,0.040955631,empty,mBC-0716-2
"B6,A4",21773,22323,16724,5599,10698,13,4707,4738,3361,1377,2.440813362,2191,595,358,206,1,205,1,95,0,0.068292683,empty,mBC-0716-2
"B6,A5",17842,18603,13607,4996,9133,0,4182,4195,2910,1285,2.26459144,2016,1876,857,569,1,568,1,239,0,0.093309859,empty,mBC-0716-2
"B6,A6",16860,17366,12772,4594,8684,0,4195,4204,3139,1065,2.94741784,1985,1115,651,420,0,420,0,197,0,0.121428571,empty,mBC-0716-2
"B6,A7",1429677,1509313,1063687,445626,724407,5,368986,369629,301582,68047,4.431966141,188962,54702,33937,18968,11,18957,1,2468,0,0.011605212,mm10,mBC-0716-2
"B6,A8",10868,11418,8157,3261,5622,1,2673,2678,1874,804,2.330845771,1343,1196,667,430,0,430,0,199,0,0.062790698,empty,mBC-0716-2
"B6,A9",927180,999531,680212,319319,478718,0,250987,251373,192783,58590,3.290373784,133223,62652,39920,21925,8,21917,1,2593,0,0.001551307,mm10,mBC-0716-2
"B6,A10",15936,16738,12277,4461,8095,0,3810,3814,2656,1158,2.293609672,1880,375,217,144,0,144,0,83,0,0,empty,mBC-0716-2
"B6,A11",1641476,1733746,1205604,528142,823938,2,425616,426309,350576,75733,4.629104882,219221,98790,61207,33997,11,33986,1,3448,0,0.001618313,mm10,mBC-0716-2
"B6,A12",21260,21623,16380,5243,10385,7,4641,4656,3339,1317,2.535307517,2104,1846,1041,617,0,617,0,222,0,0.04376013,empty,mBC-0716-2
"B6,B1",19829,20486,15292,5194,9792,0,4507,4521,3163,1358,2.32916053,2078,1050,610,372,0,372,0,151,0,0.094086022,empty,mBC-0716-2
"B6,B2",20623,21247,15860,5387,10351,0,4693,4704,3269,1435,2.27804878,2267,395,234,144,0,144,0,68,0,0.020833333,empty,mBC-0716-2
"B6,B3",19085,19540,14562,4978,9534,1,4297,4305,3013,1292,2.332043344,2038,826,512,321,0,321,0,154,0,0,empty,mBC-0716-2
"B6,B4",17360,17983,13386,4597,8676,42,3976,4025,2787,1238,2.251211632,1942,1023,480,316,0,316,0,138,0,0.050632911,empty,mBC-0716-2
"B6,B5",9420,5574,3941,1633,3573,16,1709,1737,1207,530,2.277358491,920,505,320,187,0,187,0,102,0,0.032085561,empty,mBC-0716-2
"B6,B6",12793,13361,9679,3682,6541,27,3011,3039,2174,865,2.513294798,1520,920,580,358,0,358,0,163,0,0.094972067,empty,mBC-0716-2
"B6,B7",19995,21092,15191,5901,10055,18,4660,4692,3253,1439,2.260597637,2330,847,522,311,0,311,0,119,0,0.038585209,empty,mBC-0716-2
"B6,B8",742223,822050,525180,296870,401374,22,227574,227925,193969,33956,5.712363058,124977,81609,51078,28677,12,28665,1,3095,0,0.001848945,mm10,mBC-0716-2
"B6,B9",15604,15933,11973,3960,7683,113,3344,3462,2413,1049,2.300285987,1658,553,354,228,0,228,0,114,0,0.087719298,empty,mBC-0716-2
"B6,B10",16741,16643,12388,4255,8415,0,3880,3887,2666,1221,2.183456183,1881,466,237,148,0,148,0,70,0,0,empty,mBC-0716-2
"B6,B11",18239,18914,14032,4882,9126,0,4093,4111,2888,1223,2.361406378,1976,288,183,118,0,118,0,63,0,0,empty,mBC-0716-2
"B6,B12",18794,19097,14344,4753,9532,0,4314,4322,3008,1314,2.289193303,2065,979,555,343,1,342,1,155,0,0.020467836,empty,mBC-0716-2
"B6,C1",23250,23171,18197,4974,11092,3,4690,4703,3273,1430,2.288811189,2049,579,332,192,0,192,0,106,0,0.046875,empty,mBC-0716-2
"B6,C2",1436557,1530907,1040617,490290,737748,21,392037,392657,325302,67355,4.829663722,207613,118171,77306,42632,21,42611,1,3972,0,0.001572364,mm10,mBC-0716-2
"B6,C3",22686,23584,17162,6422,11396,6,5366,5389,3783,1606,2.355541719,2601,398,236,164,0,164,0,85,0,0.006097561,empty,mBC-0716-2
"B6,C4",17681,17687,13492,4195,8662,50,3758,3812,2624,1188,2.208754209,1714,810,514,332,0,332,0,146,0,0.054216867,empty,mBC-0716-2
"B6,C5",17335,17988,13211,4777,8632,0,4050,4055,2822,1233,2.288726683,1907,783,459,284,0,284,0,154,0,0.035211268,empty,mBC-0716-2
"B6,C6",1144016,1326856,741089,585767,663412,1,445960,446540,318526,128014,2.488212227,267225,8074,5004,2830,1,2829,1,757,0,0.006362672,mm10,mBC-0716-2
"B6,C7",16297,17241,12400,4841,8293,2,3950,3960,2811,1149,2.446475196,1934,257,170,115,0,115,0,69,0,0,empty,mBC-0716-2
"B6,C8",15620,16160,11891,4269,8051,16,3650,3684,2479,1205,2.057261411,1805,1447,792,473,0,473,0,180,0,0.054968288,empty,mBC-0716-2
"B6,C9",13488,13733,10131,3602,6754,8,3160,3172,2234,938,2.381663113,1494,725,454,276,1,275,1,132,0,0.061818182,empty,mBC-0716-2
"B6,C10",625640,672683,461027,211656,331332,13,170686,170982,133306,37676,3.538220618,89691,25567,15028,8448,2,8446,1,1476,0,0.004262373,mm10,mBC-0716-2
"B6,C11",744878,872999,498603,374396,429833,0,273865,274168,169933,104235,1.630287332,167514,4480,2795,1563,0,1563,0,459,0,0.007037748,mm10,mBC-0716-2
"B6,C12",20756,21531,15508,6023,10439,16,4938,4961,3407,1554,2.192406692,2470,973,534,292,0,292,0,126,0,0.023972603,empty,mBC-0716-2
"B6,D1",670803,723898,487336,236562,358067,1,190320,190598,142783,47815,2.986154972,101939,8903,5691,3095,1,3094,1,709,0,0.004848093,mm10,mBC-0716-2
"B6,D2",21610,21743,16498,5245,10730,0,4728,4747,3377,1370,2.464963504,2163,2085,1270,766,0,766,0,287,0,0.062663185,empty,mBC-0716-2
"B6,D3",13836,14388,10504,3884,7103,1,3296,3306,2283,1023,2.231671554,1662,877,557,342,0,342,0,178,0,0.005847953,empty,mBC-0716-2
"B6,D4",15787,16416,12087,4329,8113,0,3776,3782,2648,1134,2.335097002,1791,963,582,391,1,390,1,205,0,0.023076923,empty,mBC-0716-2
"B6,D5",879741,992324,592823,399501,483533,2,297564,297912,234148,63764,3.672103381,171048,71084,39465,21734,9,21725,2,2689,0,0.00575374,mm10,mBC-0716-2
"B6,D6",13096,13488,9805,3683,6589,11,3070,3086,2097,989,2.120323559,1497,1009,522,336,0,336,0,163,0,0.038690476,empty,mBC-0716-2
"B6,D7",22652,24257,16841,7416,11698,0,6054,6067,4281,1786,2.396976484,3112,1329,751,422,0,422,0,184,0,0.011848341,empty,mBC-0716-2
"B6,D8",748618,815578,537062,278516,401272,43,222906,223276,140809,82467,1.707458741,124074,4869,2913,1594,0,1594,0,479,0,0.000627353,mm10,mBC-0716-2
"B6,D9",245741,263215,172217,90998,132741,29,72962,73098,60402,12696,4.757561437,39891,52562,34154,18958,11,18947,2,2358,0,0.001108355,mm10,mBC-0716-2
"B6,D10",13639,14037,10384,3653,6791,25,3141,3171,2171,1000,2.171,1502,581,349,219,0,219,0,90,0,0.063926941,empty,mBC-0716-2
"B6,D11",13745,13914,10389,3525,6976,11,3166,3185,2232,953,2.34207765,1547,1038,644,419,0,419,0,202,0,0.054892601,empty,mBC-0716-2
"B6,D12",25903,27307,19711,7596,13034,0,6163,6178,4415,1763,2.504254112,3035,1843,1068,628,1,627,1,235,0,0.031897927,empty,mBC-0716-2
"B6,E1",22858,22950,17664,5286,11160,0,4871,4880,3410,1470,2.319727891,2189,3047,1355,816,0,816,0,301,0,0.041666667,empty,mBC-0716-2
"B6,E2",17007,17368,13212,4156,8379,0,3687,3692,2504,1188,2.107744108,1704,1246,668,417,0,417,0,173,0,0.016786571,empty,mBC-0716-2
"B6,E3",596765,639559,446555,193004,312997,8,156947,157216,134631,22585,5.961080363,80276,82824,54505,31037,14,31023,2,3072,0,0.002062986,mm10,mBC-0716-2
"B6,E4",16426,17118,12559,4559,8229,0,3783,3792,2621,1171,2.238257899,1877,1173,616,372,0,372,0,171,0,0.053763441,empty,mBC-0716-2
"B6,E5",1406061,1493790,1036181,457609,699631,0,360450,361104,310103,51001,6.080331758,184346,89507,58118,32213,21,32192,2,3217,0,0.002795726,mm10,mBC-0716-2
"B6,E6",14194,14284,10790,3494,6888,1,2968,2978,2132,846,2.520094563,1356,1176,731,442,0,442,0,222,0,0.011312217,empty,mBC-0716-2
"B6,E7",14225,14893,10877,4016,7230,3,3337,3347,2296,1051,2.184586108,1681,2395,922,591,1,590,1,226,0,0.038983051,empty,mBC-0716-2
"B6,E8",18387,18773,14151,4622,9121,1,4023,4035,2816,1219,2.310090238,1905,1300,772,470,0,470,0,206,0,0.068085106,empty,mBC-0716-2
"B6,E9",9290,9640,6980,2660,4675,0,2185,2188,1557,631,2.467511886,1055,761,456,287,0,287,0,128,0,0.059233449,empty,mBC-0716-2
"B6,E10",13641,14028,10454,3574,6869,1,3136,3141,2103,1038,2.026011561,1468,1094,718,427,0,427,0,175,0,0.011709602,empty,mBC-0716-2
"B6,E11",9306,9528,7131,2397,4739,0,2141,2149,1547,602,2.569767442,1016,782,467,282,2,280,2,139,0,0.035714286,empty,mBC-0716-2
"B6,E12",15571,16146,11836,4310,8046,0,3743,3747,2553,1194,2.138190955,1814,1533,672,376,1,375,1,160,0,0.08,empty,mBC-0716-2
"B6,F1",18789,19393,14420,4973,9407,0,4261,4266,2992,1274,2.348508634,2043,1327,750,468,0,468,0,205,0,0.006410256,empty,mBC-0716-2
"B6,F2",925727,1011949,666267,345682,487970,2,266937,267344,216291,51053,4.236597262,143799,106678,69644,39278,16,39262,1,3492,0,0.007055168,mm10,mBC-0716-2
"B6,F3",16732,17279,12574,4705,8422,11,3989,4009,2820,1189,2.371740959,1925,2272,936,563,0,563,0,254,0,0.037300178,empty,mBC-0716-2
"B6,F4",16625,16631,12516,4115,8309,12,3709,3729,2612,1117,2.338406446,1766,365,193,114,0,114,0,66,0,0.061403509,empty,mBC-0716-2
"B6,F5",25325,26032,19269,6763,12518,36,5742,5792,4091,1701,2.40505585,2762,3267,1245,785,0,785,0,324,0,0.043312102,empty,mBC-0716-2
"B6,F6",834339,889711,619922,269789,430857,1,216075,216458,189053,27405,6.898485678,112133,95559,63003,34982,18,34964,2,3446,0,0.001515845,mm10,mBC-0716-2
"B6,F7",21151,22022,16274,5748,10757,0,4870,4891,3400,1491,2.280348759,2276,751,409,225,0,225,0,114,0,0.088888889,empty,mBC-0716-2
"B6,F8",24393,25492,18483,7009,12288,1,5735,5754,4087,1667,2.451709658,2846,342,218,138,0,138,0,95,0,0,empty,mBC-0716-2
"B6,F9",15160,15233,11410,3823,7487,1,3394,3399,2297,1102,2.084392015,1631,1018,594,387,0,387,0,174,0,0.03875969,empty,mBC-0716-2
"B6,F10",21746,21974,16767,5207,10492,20,4470,4501,3122,1379,2.263959391,2017,962,614,398,0,398,0,177,0,0.002512563,empty,mBC-0716-2
"B6,F11",12082,12481,8947,3534,6055,0,2799,2810,1894,916,2.06768559,1467,5127,1674,998,0,998,0,333,0,0.065130261,empty,mBC-0716-2
"B6,F12",14791,15184,11209,3975,7257,0,3403,3409,2455,954,2.573375262,1599,112,69,52,0,52,0,38,0,0,empty,mBC-0716-2
"B6,G1",10785,11258,8240,3018,5575,0,2477,2486,1732,754,2.297082228,1234,1440,941,563,0,563,0,215,0,0.030195382,empty,mBC-0716-2
"B6,G2",21681,22396,16400,5996,10802,0,4961,4975,3463,1512,2.290343915,2415,566,338,220,0,220,0,138,0,0.009090909,empty,mBC-0716-2
"B6,G3",20604,21276,15586,5690,10295,127,4548,4682,3290,1392,2.363505747,2282,1464,898,541,0,541,0,223,0,0.066543438,empty,mBC-0716-2
"B6,G4",28204,28332,21881,6451,13920,0,5948,5973,4168,1805,2.309141274,2774,137,83,62,0,62,0,49,0,0,empty,mBC-0716-2
"B6,G5",14143,14538,10788,3750,7026,0,3274,3283,2301,982,2.343177189,1574,2444,1004,619,0,619,0,273,0,0.040387722,empty,mBC-0716-2
"B6,G6",25168,25644,19457,6187,12465,0,5568,5581,3927,1654,2.374244256,2543,199,133,95,0,95,0,65,0,0,empty,mBC-0716-2
"B6,G7",1012804,1093433,755805,337628,527566,0,271509,271938,189148,82790,2.284672062,142832,40325,25684,14387,5,14382,2,2049,0,0.000625782,mm10,mBC-0716-2
"B6,G8",902794,1066310,603808,462502,517588,10,329404,329842,233403,96439,2.420213814,200082,52571,34147,19055,8,19047,3,2339,0,0.003202604,mm10,mBC-0716-2
"B6,G9",10942,11245,8418,2827,5538,14,2512,2534,1766,768,2.299479167,1218,1898,964,614,0,614,0,255,0,0.104234528,empty,mBC-0716-2
"B6,G10",931679,1040240,660937,379303,502956,2,287637,288009,208690,79319,2.631021571,160581,94227,64029,35293,18,35275,3,3323,0,0.000340184,mm10,mBC-0716-2
"B6,G11",12837,13136,9950,3186,6286,36,2806,2848,2030,818,2.481662592,1271,847,389,248,1,247,1,112,0,0.024291498,empty,mBC-0716-2
"B6,G12",11693,12140,8861,3279,5939,4,2747,2753,1899,854,2.223653396,1311,1106,630,355,1,354,1,133,0,0.081920904,empty,mBC-0716-2
"B6,H1",22116,22646,16568,6078,10891,1,5053,5075,3565,1510,2.360927152,2400,1804,791,479,1,478,1,192,0,0.025104603,empty,mBC-0716-2
"B6,H2",24622,25118,18681,6437,12080,0,5382,5397,3802,1595,2.38369906,2533,1526,911,580,0,580,0,266,0,0.037931034,empty,mBC-0716-2
"B6,H3",840009,895470,611315,284155,433856,16,230271,230669,161519,69150,2.335777296,124639,10854,5021,2928,0,2928,0,765,0,0.019808743,mm10,mBC-0716-2
"B6,H4",514323,526164,388139,138025,260152,2,121541,121774,96531,25243,3.824070039,59985,2105,1032,616,0,616,0,201,0,0.025974026,empty,mBC-0716-2
"B6,H5",18235,18590,13641,4949,9014,22,4150,4186,2931,1255,2.335458167,2063,3396,1328,768,0,768,0,278,0,0.03515625,empty,mBC-0716-2
"B6,H6",715013,791655,491742,299913,387426,16,227291,227647,176140,51507,3.419729357,128734,99748,65669,36453,18,36435,3,3374,0,0.000576369,mm10,mBC-0716-2
"B6,H7",1055323,1212427,682960,529467,589763,24,385454,386023,310054,75969,4.081322645,229517,46273,30339,17000,6,16994,2,2262,0,0.001353419,mm10,mBC-0716-2
"B6,H8",14035,14410,10508,3902,7017,4,3238,3253,2298,955,2.406282723,1557,1409,852,469,0,469,0,227,0,0.053304904,empty,mBC-0716-2
"B6,H9",15849,16611,11891,4720,8168,0,3761,3773,2639,1134,2.327160494,1877,2222,1116,639,0,639,0,260,0,0.078247261,empty,mBC-0716-2
"B6,H10",14809,15087,11190,3897,7410,24,3410,3444,2431,1013,2.399802567,1646,1392,769,499,0,499,0,226,0,0.028056112,empty,mBC-0716-2
"B6,H11",828621,887614,580822,306792,435185,0,252497,252823,199022,53801,3.699224921,136491,369,220,134,0,134,0,76,0,0.007462687,empty,mBC-0716-2
"B6,H12",6294,6334,4747,1587,3180,8,1481,1491,1051,440,2.388636364,703,671,440,218,1,217,1,88,0,0.096774194,empty,mBC-0716-2
"B7,A1",1030730,1173077,687840,485237,561818,11,359154,359620,254325,105295,2.415356855,211876,12668,6726,3884,6,3878,3,947,0,0.008767406,mm10,mBC-0716-2
"B7,A2",22700,23098,17406,5692,10598,2,4657,4667,3254,1413,2.302901628,2173,1218,729,454,0,454,0,190,0,0.037444934,empty,mBC-0716-2
"B7,A3",19044,19766,14433,5333,9366,0,4450,4459,3132,1327,2.360211002,2133,2035,918,557,1,556,1,198,0,0.079136691,empty,mBC-0716-2
"B7,A4",24017,24508,18400,6108,11597,1,5012,5023,3589,1434,2.5027894,2369,708,454,251,0,251,0,133,0,0.059760956,empty,mBC-0716-2
"B7,A5",2135839,2346015,1523777,822238,1088928,2,630844,631751,441540,190211,2.321316853,345617,124536,76486,42746,20,42726,3,4016,0,0.004657586,mm10,mBC-0716-2
"B7,A6",14812,15425,11159,4266,7493,0,3572,3585,2551,1034,2.467117988,1803,1463,870,572,1,571,1,236,0,0.099824869,empty,mBC-0716-2
"B7,A7",1964496,2159083,1408781,750302,991123,22,566843,567836,425353,142483,2.985289473,309973,62809,40486,23037,10,23027,2,2783,0,0.003474182,mm10,mBC-0716-2
"B7,A8",492855,550638,353606,197032,263298,0,144397,144642,121999,22643,5.387934461,79702,104922,66805,37227,19,37208,2,3427,0,0.00086003,mm10,mBC-0716-2
"B7,A9",22008,22658,16883,5775,10464,0,4643,4658,3304,1354,2.440177253,2152,2148,1094,622,0,622,0,273,0,0.046623794,empty,mBC-0716-2
"B7,A10",833886,859731,630985,228746,400744,2,183849,184221,154049,30172,5.105694021,90749,13901,8572,4759,0,4759,0,955,0,0.002731666,mm10,mBC-0716-2
"B7,A11",21476,21763,16232,5531,10258,0,4596,4609,3190,1419,2.248062016,2131,4846,1913,1177,1,1176,1,397,0,0.067176871,empty,mBC-0716-2
"B7,A12",24551,24553,18410,6143,11265,0,5034,5049,3442,1607,2.141879278,2379,31288,10166,6083,3,6080,3,1375,0,0.049342105,empty,mBC-0716-2
"B7,B1",21443,22266,16522,5744,10563,0,4827,4839,3431,1408,2.436789773,2307,1943,831,524,0,524,0,210,0,0.078244275,empty,mBC-0716-2
"B7,B2",22279,23162,16917,6245,10720,3,4886,4905,3448,1457,2.36650652,2405,3436,1186,699,2,697,1,229,0,0.084648494,empty,mBC-0716-2
"B7,B3",22666,23595,17112,6483,11192,29,5206,5245,3648,1597,2.284283031,2576,1081,659,397,0,397,0,162,0,0.065491184,empty,mBC-0716-2
"B7,B4",18353,19086,13994,5092,8907,0,4104,4113,2930,1183,2.476754015,1991,937,506,296,0,296,0,150,0,0.033783784,empty,mBC-0716-2
"B7,B5",572535,327462,214637,112825,206399,2,111053,111786,83414,28372,2.940011279,63846,11036,6020,3490,2,3488,2,846,0,0.002866972,mm10,mBC-0716-2
"B7,B6",14424,14830,10873,3957,7019,0,3270,3275,2309,966,2.390269151,1538,1184,754,455,0,455,0,197,0,0.010989011,empty,mBC-0716-2
"B7,B7",18754,19070,14380,4690,8936,30,3994,4037,2828,1209,2.339123242,1826,947,558,368,0,368,0,147,0,0.051630435,empty,mBC-0716-2
"B7,B8",14711,15518,11112,4406,7371,2,3406,3412,2368,1044,2.268199234,1702,3292,1343,788,1,787,1,313,0,0.007623888,empty,mBC-0716-2
"B7,B9",16945,17565,13036,4529,8105,0,3648,3657,2558,1099,2.327570519,1739,1153,678,423,0,423,0,180,0,0.016548463,empty,mBC-0716-2
"B7,B10",19374,19945,14239,5706,9530,0,4529,4545,3163,1382,2.288712012,2309,730,424,234,0,234,0,105,0,0.012820513,empty,mBC-0716-2
"B7,B11",278104,318205,182981,135224,146533,19,94607,94753,70826,23927,2.960086931,55388,2022,1324,742,1,741,1,240,0,0.001349528,empty,mBC-0716-2
"B7,B12",857273,958159,601028,357131,455121,5,262643,263039,214126,48913,4.377691002,147612,63002,41145,22474,7,22467,3,2751,0,0.001424311,mm10,mBC-0716-2
"B7,C1",30926,31316,24015,7301,14196,0,6139,6147,4378,1769,2.474844545,2748,3381,1190,732,0,732,0,264,0,0.046448087,empty,mBC-0716-2
"B7,C2",633266,641805,490343,151462,306068,1,132147,132407,104105,28302,3.678361953,62974,10842,6267,3542,3,3539,2,829,0,0.060469059,mm10,mBC-0716-2
"B7,C3",22864,23537,17160,6377,10989,44,5151,5211,3610,1601,2.254840725,2537,524,286,191,0,191,0,105,0,0.02617801,empty,mBC-0716-2
"B7,C4",25771,26798,19585,7213,12572,3,5757,5773,4100,1673,2.450687388,2861,1300,770,456,0,456,0,187,0,0.032894737,empty,mBC-0716-2
"B7,C5",18404,18604,13584,5020,8887,1,4140,4153,2933,1220,2.404098361,2041,12337,3889,2284,9,2275,3,642,0,0.033406593,empty,mBC-0716-2
"B7,C6",18685,19200,14005,5195,9446,0,4416,4427,3119,1308,2.384556575,2161,2926,1294,787,0,787,0,309,0,0.048284625,empty,mBC-0716-2
"B7,C7",18733,19297,14239,5058,9123,0,4203,4209,2904,1305,2.225287356,2024,526,297,186,0,186,0,83,0,0.021505376,empty,mBC-0716-2
"B7,C8",17894,18546,13483,5063,8710,31,3999,4044,2844,1200,2.37,1985,1584,855,544,0,544,0,223,0,0.025735294,empty,mBC-0716-2
"B7,C9",14997,15692,11348,4344,7346,0,3475,3481,2435,1046,2.32791587,1670,1316,789,471,0,471,0,177,0,0.042462845,empty,mBC-0716-2
"B7,C10",15827,16353,12070,4283,7692,42,3493,3543,2491,1052,2.367870722,1671,1708,1088,611,0,611,0,222,0,0.037643208,empty,mBC-0716-2
"B7,C11",12929,13310,9768,3542,6303,1,3012,3018,2125,893,2.379619261,1443,2470,1105,639,0,639,0,231,0,0.045383412,empty,mBC-0716-2
"B7,C12",22691,23061,17245,5816,10751,26,4801,4833,3349,1484,2.256738544,2264,1381,777,452,0,452,0,154,0,0.039823009,empty,mBC-0716-2
"B7,D1",13507,13980,10225,3755,6698,0,3121,3121,2213,908,2.43722467,1543,677,407,235,0,235,0,108,0,0.05106383,empty,mBC-0716-2
"B7,D2",24001,24586,18465,6121,11643,1,5233,5251,3698,1553,2.381197682,2448,2861,1504,924,0,924,0,362,0,0.050865801,empty,mBC-0716-2
"B7,D3",16409,17001,12157,4844,8129,1,3862,3883,2714,1169,2.321642429,1937,7830,2605,1519,0,1519,0,471,0,0.061882818,empty,mBC-0716-2
"B7,D4",16383,16714,12510,4204,8047,0,3761,3769,2658,1111,2.392439244,1747,1232,722,487,1,486,1,234,0,0.00617284,empty,mBC-0716-2
"B7,D5",16241,16947,12294,4653,7914,0,3713,3728,2592,1136,2.281690141,1800,1076,591,366,0,366,0,159,0,0.084699454,empty,mBC-0716-2
"B7,D6",14818,15457,11140,4317,7362,0,3499,3505,2402,1103,2.177697189,1759,1246,633,403,0,403,0,200,0,0.089330025,empty,mBC-0716-2
"B7,D7",15087,15550,11375,4175,7398,8,3471,3485,2491,994,2.506036217,1680,1330,816,480,0,480,0,196,0,0.0125,empty,mBC-0716-2
"B7,D8",18503,19680,13987,5693,9195,3,4393,4407,3005,1402,2.143366619,2250,4366,1525,942,0,942,0,311,0,0.014861996,empty,mBC-0716-2
"B7,D9",7602,8043,5627,2416,3890,0,1892,1892,1370,522,2.624521073,987,10817,3557,2015,0,2015,0,599,0,0.033746898,empty,mBC-0716-2
"B7,D10",15414,16152,11735,4417,7512,16,3420,3447,2374,1073,2.21248835,1715,989,567,351,0,351,0,115,0,0.128205128,empty,mBC-0716-2
"B7,D11",14984,15347,11357,3990,7401,13,3341,3362,2354,1008,2.33531746,1608,1947,1159,714,0,714,0,278,0,0.023809524,empty,mBC-0716-2
"B7,D12",23278,23868,17682,6186,11298,23,5181,5222,3652,1570,2.32611465,2522,15805,5571,3390,3,3387,1,891,0,0.049601417,empty,mBC-0716-2
"B7,E1",25715,26078,19473,6605,12139,2,5442,5460,3891,1569,2.479923518,2554,7282,2427,1498,0,1498,0,488,0,0.087449933,empty,mBC-0716-2
"B7,E2",18849,19108,14353,4755,9187,0,4079,4090,2883,1207,2.388566694,1937,1229,717,452,1,451,1,184,0,0.044345898,empty,mBC-0716-2
"B7,E3",876204,955464,630737,324727,447762,3,250490,250891,190219,60672,3.1352024,134824,35324,22451,12653,7,12646,1,1928,0,0.001423375,mm10,mBC-0716-2
"B7,E4",18034,18322,13837,4485,8610,0,3887,3899,2724,1175,2.318297872,1809,1253,702,430,0,430,0,185,0,0.03255814,empty,mBC-0716-2
"B7,E5",2091520,2319676,1491037,828639,1067970,6,616945,617967,492149,125818,3.911594525,339733,188731,120250,67322,26,67296,1,4771,0,0.001381954,mm10,mBC-0716-2
"B7,E6",16376,16600,12137,4463,7791,0,3539,3555,2480,1075,2.306976744,1747,2879,1460,830,0,830,0,318,0,0.086746988,empty,mBC-0716-2
"B7,E7",15428,15643,11905,3738,7445,5,3295,3311,2277,1034,2.20212766,1518,1283,758,471,0,471,0,207,0,0.025477707,empty,mBC-0716-2
"B7,E8",20131,20424,15636,4788,9630,45,4189,4243,2985,1258,2.37281399,1895,1719,1053,580,1,579,1,219,0,0.020725389,empty,mBC-0716-2
"B7,E9",64057,73655,44664,28991,34820,0,21048,21074,16306,4768,3.41988255,11813,6640,4238,2402,1,2401,1,522,0,0.011661808,empty,mBC-0716-2
"B7,E10",14687,15101,11354,3747,7193,0,3332,3334,2317,1017,2.27826942,1483,2118,1182,691,0,691,0,233,0,0.037626628,empty,mBC-0716-2
"B7,E11",10966,11362,8250,3112,5446,0,2538,2541,1745,796,2.192211055,1222,1664,986,619,0,619,0,223,0,0.037156704,empty,mBC-0716-2
"B7,E12",17401,18364,13129,5235,8712,0,4117,4134,2875,1259,2.28355838,2033,1402,735,466,0,466,0,181,0,0.053648069,empty,mBC-0716-2
"B7,F1",699773,717785,511370,206415,342526,3,173246,173587,135270,38317,3.530286818,88468,6851,4350,2499,3,2496,1,729,0,0.009615385,mm10,mBC-0716-2
"B7,F2",26229,27427,19976,7451,12652,4,5953,5967,4252,1715,2.479300292,2868,8742,3257,1973,1,1972,1,600,0,0.013691684,empty,mBC-0716-2
"B7,F3",937520,1091585,633479,458106,516169,7,324951,325368,248006,77362,3.205785786,191729,63199,38965,22392,22,22370,2,2664,0,0.004023245,mm10,mBC-0716-2
"B7,F4",19086,19429,14513,4916,9277,66,4139,4214,2945,1269,2.32072498,2012,470,288,190,0,190,0,88,0,0.010526316,empty,mBC-0716-2
"B7,F5",28671,29314,21587,7727,13564,154,6156,6323,4395,1928,2.279564315,2965,10530,3470,2142,2,2140,2,658,0,0.069626168,empty,mBC-0716-2
"B7,F6",27775,28455,20719,7736,13246,1,6285,6306,4470,1836,2.434640523,3047,7312,2586,1569,1,1568,1,509,0,0.040178571,empty,mBC-0716-2
"B7,F7",1078950,1128753,812669,316084,523986,39,248769,249314,207951,41363,5.027464159,124334,55867,36540,20624,14,20610,1,2472,0,0.000776322,mm10,mBC-0716-2
"B7,F8",25222,26627,19302,7325,12440,32,5774,5814,4136,1678,2.464839094,2866,342,202,141,0,141,0,90,0,0,empty,mBC-0716-2
"B7,F9",792189,854460,586528,267932,405129,1,205511,205844,173707,32137,5.405202726,107725,156147,97995,55200,21,55179,3,4214,0,0.00083365,mm10,mBC-0716-2
"B7,F10",22783,23231,17599,5632,10966,24,4806,4853,3462,1391,2.488856937,2241,1415,849,519,0,519,0,209,0,0.01734104,empty,mBC-0716-2
"B7,F11",13141,13400,10075,3325,6473,4,2882,2896,2002,894,2.239373602,1381,1390,805,500,0,500,0,216,0,0.016,empty,mBC-0716-2
"B7,F12",15710,16140,11879,4261,7618,0,3585,3592,2536,1056,2.401515152,1729,160,99,70,0,70,0,49,0,0,empty,mBC-0716-2
"B7,G1",741605,767610,547190,220420,363232,3,181955,182330,141566,40764,3.472819154,91485,26225,16582,9297,6,9291,3,1637,0,0.00408998,mm10,mBC-0716-2
"B7,G2",1256814,1413968,850892,563076,657583,18,409219,409799,302634,107165,2.824000373,231989,19113,12562,7090,2,7088,1,1277,0,0.000282167,mm10,mBC-0716-2
"B7,G3",23215,23617,17708,5909,11223,5,5072,5085,3532,1553,2.274307791,2411,10952,3543,2110,4,2106,3,623,0,0.019468186,empty,mBC-0716-2
"B7,G4",32466,33280,24726,8554,15609,25,6835,6883,4864,2019,2.409113422,3340,266,142,100,0,100,0,62,0,0,empty,mBC-0716-2
"B7,G5",15843,16586,12066,4520,7725,5,3577,3583,2543,1040,2.445192308,1759,1559,805,509,0,509,0,243,0,0.072691552,empty,mBC-0716-2
"B7,G6",27458,28100,20986,7114,12993,0,5685,5697,4032,1665,2.421621622,2674,202,133,90,0,90,0,66,0,0,empty,mBC-0716-2
"B7,G7",22927,23688,17846,5842,11312,1,5076,5097,3572,1525,2.342295082,2389,1638,1032,578,0,578,0,276,0,0.048442907,empty,mBC-0716-2
"B7,G8",16949,17591,12925,4666,8388,10,3893,3906,2743,1163,2.35855546,1902,1694,1073,666,0,666,0,272,0,0.015015015,empty,mBC-0716-2
"B7,G9",12058,12878,9374,3504,6083,0,2822,2824,1950,874,2.231121281,1335,1650,922,572,0,572,0,239,0,0.019230769,empty,mBC-0716-2
"B7,G10",15214,15467,11823,3644,7265,1,3232,3239,2273,966,2.35300207,1433,1987,1130,701,0,701,0,278,0,0.034236805,empty,mBC-0716-2
"B7,G11",1165673,1271833,817219,454614,590302,1,336378,336911,281047,55864,5.030914363,184751,49870,33144,18355,11,18344,1,2174,0,0.000654165,mm10,mBC-0716-2
"B7,G12",13557,13878,10287,3591,6560,0,3009,3012,2129,883,2.411098528,1438,1539,862,509,1,508,1,184,0,0.019685039,empty,mBC-0716-2
"B7,H1",23666,24226,18090,6136,11501,19,5186,5219,3743,1476,2.535907859,2495,882,518,328,1,327,1,158,0,0.01529052,empty,mBC-0716-2
"B7,H2",29373,29994,21751,8243,13584,15,6377,6418,4541,1877,2.419286095,3122,34123,10783,6550,6,6544,1,1354,0,0.158618582,empty,mBC-0716-2
"B7,H3",24245,24982,18225,6757,11813,0,5534,5554,3855,1699,2.268981754,2759,14272,4539,2635,2,2633,1,723,0,0.029244208,empty,mBC-0716-2
"B7,H4",16471,16963,12518,4445,8130,0,3800,3808,2667,1141,2.337423313,1874,442,204,128,0,128,0,90,0,0,empty,mBC-0716-2
"B7,H5",20370,20851,15558,5293,9532,5,4287,4300,3033,1267,2.393843725,2020,1282,790,461,0,461,0,213,0,0.015184382,empty,mBC-0716-2
"B7,H6",17027,17926,12858,5068,8423,0,4066,4074,2889,1185,2.437974684,2056,1421,886,498,0,498,0,227,0,0.046184739,empty,mBC-0716-2
"B7,H7",19524,20026,14674,5352,9568,2,4515,4537,3228,1309,2.466004584,2197,1412,887,556,0,556,0,211,0,0.041366906,empty,mBC-0716-2
"B7,H8",1513986,1631931,1086119,545812,752540,2,412521,413200,337730,75470,4.475023188,221168,129677,84323,47312,14,47298,4,4143,0,0.00116284,mm10,mBC-0716-2
"B7,H9",18683,18707,14258,4449,8872,5,3846,3866,2767,1099,2.517743403,1782,1875,1103,696,0,696,0,283,0,0.037356322,empty,mBC-0716-2
"B7,H10",866217,898710,645108,253602,418527,21,202946,203364,173364,30000,5.7788,101727,99947,64091,35433,22,35411,2,3391,0,0.001073113,mm10,mBC-0716-2
"B7,H11",18967,19289,14354,4935,9150,11,4236,4260,2961,1299,2.279445727,2064,283,133,93,0,93,0,70,0,0.010752688,empty,mBC-0716-2
"B7,H12",7112,7465,5272,2193,3517,0,1647,1656,1167,489,2.386503067,846,819,467,280,0,280,0,110,0,0.046428571,empty,mBC-0716-2
"B8,A1",17091,17653,12984,4669,8752,1,4097,4103,2843,1260,2.256349206,1958,966,527,332,0,332,0,151,0,0.018072289,empty,mBC-0716-2
"B8,A2",22188,22486,16888,5598,10734,1,4694,4712,3367,1345,2.503345725,2198,1209,724,422,0,422,0,193,0,0.052132701,empty,mBC-0716-2
"B8,A3",910747,975974,672538,303436,470583,9,240970,241332,196923,44409,4.434303857,124913,77713,50821,28082,11,28071,2,2901,0,0.001318086,mm10,mBC-0716-2
"B8,A4",24062,24528,18566,5962,11837,0,5253,5263,3823,1440,2.654861111,2466,811,442,279,1,278,1,120,0,0.010791367,empty,mBC-0716-2
"B8,A5",19903,20148,15263,4885,9914,0,4467,4478,3105,1373,2.261471231,1997,3227,1468,896,0,896,0,340,0,0.082589286,empty,mBC-0716-2
"B8,A6",14686,15443,11298,4145,7565,5,3508,3517,2492,1025,2.431219512,1685,1696,1055,559,0,559,0,232,0,0.055456172,empty,mBC-0716-2
"B8,A7",18465,18714,14204,4510,9063,1,4156,4172,2901,1271,2.28245476,1915,1310,773,459,0,459,0,182,0,0.047930283,empty,mBC-0716-2
"B8,A8",12306,12822,9349,3473,6253,0,2875,2886,1994,892,2.235426009,1391,1324,776,497,0,497,0,199,0,0.038229376,empty,mBC-0716-2
"B8,A9",1257300,1405852,849053,556799,666616,1,410888,411468,331389,80079,4.138275952,232325,95352,62961,34725,8,34717,1,3297,0,0.00106576,mm10,mBC-0716-2
"B8,A10",18466,18904,14143,4761,9160,5,4178,4200,2953,1247,2.3680834,1948,528,286,196,0,196,0,98,0,0.030612245,empty,mBC-0716-2
"B8,A11",1219359,1301124,873646,427478,613744,1,333703,334268,283017,51251,5.522175177,175516,77169,48861,27455,10,27445,1,2917,0,0.001931135,mm10,mBC-0716-2
"B8,A12",23171,23768,17735,6033,11292,0,4946,4966,3473,1493,2.326188881,2290,4768,2047,1163,0,1163,0,362,0,0.072226999,empty,mBC-0716-2
"B8,B1",21758,22354,16776,5578,10614,0,4739,4741,3391,1350,2.511851852,2170,1162,691,406,0,406,0,173,0,0.056650246,empty,mBC-0716-2
"B8,B2",22421,23245,17115,6130,11063,0,4933,4947,3477,1470,2.365306122,2351,748,354,210,0,210,0,85,0,0.028571429,empty,mBC-0716-2
"B8,B3",21551,22216,16450,5766,10834,15,4936,4956,3508,1448,2.422651934,2351,1341,831,519,1,518,1,180,0,0.075289575,empty,mBC-0716-2
"B8,B4",23520,25579,17508,8071,12476,18,6347,6375,3429,2946,1.16395112,3363,4886,1737,1048,1,1047,1,316,0,0.087870105,empty,mBC-0716-2
"B8,B5",11002,6866,4840,2026,4408,0,2146,2161,1547,614,2.519543974,1171,762,446,268,0,268,0,123,0,0.01119403,empty,mBC-0716-2
"B8,B6",14352,15157,10845,4312,7387,0,3510,3517,2471,1046,2.362332696,1725,1079,682,429,0,429,0,175,0,0.060606061,empty,mBC-0716-2
"B8,B7",1433180,1637044,950394,686650,782687,8,502889,503558,391830,111728,3.506999141,293142,62605,40446,21838,17,21821,3,2606,0,0.001099858,mm10,mBC-0716-2
"B8,B8",14793,15420,11310,4110,7512,0,3442,3446,2474,972,2.54526749,1670,1077,694,433,0,433,0,209,0,0.027713626,empty,mBC-0716-2
"B8,B9",16589,16998,12845,4153,8223,0,3695,3704,2622,1082,2.423290203,1673,666,375,231,0,231,0,119,0,0.021645022,empty,mBC-0716-2
"B8,B10",18957,19434,14251,5183,9714,3,4488,4500,3151,1349,2.335804299,2211,770,415,235,0,235,0,102,0,0.029787234,empty,mBC-0716-2
"B8,B11",18598,19324,14249,5075,9282,0,4256,4266,2927,1339,2.185959671,2071,418,193,126,0,126,0,76,0,0.055555556,empty,mBC-0716-2
"B8,B12",20349,20770,15579,5191,10195,0,4559,4565,3210,1355,2.36900369,2143,1461,801,474,0,474,0,167,0,0.130801688,empty,mBC-0716-2
"B8,C1",24938,25062,19330,5732,12066,5,5248,5262,3746,1516,2.470976253,2390,2286,816,480,0,480,0,182,0,0.039583333,empty,mBC-0716-2
"B8,C2",20697,21290,15734,5556,10414,0,4854,4859,3379,1480,2.283108108,2309,1237,740,430,1,429,1,164,0,0.06993007,empty,mBC-0716-2
"B8,C3",22641,23030,17254,5776,11068,1,5000,5026,3468,1558,2.22593068,2394,551,302,200,0,200,0,90,0,0.08,empty,mBC-0716-2
"B8,C4",20655,21021,15787,5234,10112,1,4500,4512,3160,1352,2.337278107,2118,1198,747,427,0,427,0,166,0,0.06088993,empty,mBC-0716-2
"B8,C5",20670,21978,15431,6547,10763,9,5218,5239,3767,1472,2.559103261,2698,1299,808,454,0,454,0,195,0,0.019823789,empty,mBC-0716-2
"B8,C6",19051,19590,14317,5273,9871,0,4541,4554,3202,1352,2.368343195,2210,1483,895,588,0,588,0,200,0,0.042517007,empty,mBC-0716-2
"B8,C7",1107374,1186664,797570,389094,565059,2,302463,302948,262251,40697,6.4439885,161038,9801,6373,3491,0,3491,0,782,0,0.002005156,mm10,mBC-0716-2
"B8,C8",904067,994448,632177,362271,488543,1,287608,288027,206318,81709,2.525033962,160226,25450,14096,8007,6,8001,1,1499,0,0.024121985,mm10,mBC-0716-2
"B8,C9",14984,15367,11357,4010,7381,16,3327,3349,2342,1007,2.32571996,1603,1009,650,360,0,360,0,145,0,0.030555556,empty,mBC-0716-2
"B8,C10",15575,16119,11911,4208,7872,0,3603,3607,2529,1078,2.346011132,1759,1050,597,363,0,363,0,153,0,0.052341598,empty,mBC-0716-2
"B8,C11",13076,13735,9813,3922,6760,26,3232,3264,2297,967,2.375387797,1628,945,532,359,0,359,0,162,0,0.097493036,empty,mBC-0716-2
"B8,C12",22992,23735,17390,6345,11247,9,5075,5094,3595,1499,2.39826551,2451,3068,1229,706,0,706,0,214,0,0.110481586,empty,mBC-0716-2
"B8,D1",14272,14784,10945,3839,7279,127,3350,3485,2398,1087,2.206071757,1646,1228,481,324,0,324,0,125,0,0.021604938,empty,mBC-0716-2
"B8,D2",23655,23474,18333,5141,11770,0,5134,5143,3576,1567,2.282067645,2333,2329,1377,834,0,834,0,332,0,0.034772182,empty,mBC-0716-2
"B8,D3",15350,15759,11488,4271,7875,0,3805,3811,2685,1126,2.384547069,1845,1468,764,477,0,477,0,207,0,0.088050314,empty,mBC-0716-2
"B8,D4",16632,17256,12726,4530,8417,9,3887,3900,2745,1155,2.376623377,1851,1312,791,490,1,489,1,218,0,0.040899796,empty,mBC-0716-2
"B8,D5",15818,16486,11987,4499,8031,0,3761,3768,2619,1149,2.279373368,1837,1129,702,402,1,401,1,165,0,0.034912718,empty,mBC-0716-2
"B8,D6",823299,940943,569911,371032,456343,1,270502,270895,205967,64928,3.172236939,156679,88596,57224,31770,9,31761,1,3116,0,0.000692673,mm10,mBC-0716-2
"B8,D7",15176,15920,11465,4455,7585,11,3508,3536,2385,1151,2.072111208,1805,1424,843,547,0,547,0,195,0,0.071297989,empty,mBC-0716-2
"B8,D8",18716,19528,13754,5774,9469,1,4596,4611,3176,1435,2.213240418,2377,6695,2099,1287,4,1283,2,410,0,0.039750585,empty,mBC-0716-2
"B8,D9",72733,82688,46474,36214,41097,0,26052,26085,20839,5246,3.972359893,15707,26777,17257,9328,1,9327,1,1368,0,0.00268039,empty,mBC-0716-2
"B8,D10",16642,17389,12595,4794,8374,15,3983,4004,2880,1124,2.56227758,1939,824,475,263,0,263,0,110,0,0.007604563,empty,mBC-0716-2
"B8,D11",1908563,2049760,1391297,658463,966375,2,511600,512357,442697,69660,6.355110537,270095,207515,137554,76048,39,76009,4,5020,0,0.00078938,mm10,mBC-0716-2
"B8,D12",23017,23992,17239,6753,11638,0,5506,5522,3870,1652,2.342615012,2778,2309,1434,843,0,843,0,277,0,0.056939502,empty,mBC-0716-2
"B8,E1",24620,24770,18683,6087,12084,1,5342,5350,3759,1591,2.362664991,2455,5681,1986,1179,0,1179,0,413,0,0.052586938,empty,mBC-0716-2
"B8,E2",18709,19364,14170,5194,9346,0,4284,4290,2985,1305,2.287356322,2031,41041,10500,6246,9,6237,3,1294,0,0.051787718,empty,mBC-0716-2
"B8,E3",13791,13992,10579,3413,6801,5,3103,3115,2234,881,2.535754824,1420,1532,944,552,0,552,0,240,0,0.028985507,empty,mBC-0716-2
"B8,E4",17372,18314,13150,5164,8718,27,4079,4110,2956,1154,2.56152513,2019,1170,682,418,0,418,0,163,0,0.040669856,empty,mBC-0716-2
"B8,E5",24520,24713,18849,5864,12188,1,5507,5518,3903,1615,2.416718266,2545,1419,862,540,0,540,0,229,0,0.025925926,empty,mBC-0716-2
"B8,E6",16057,16673,12323,4350,8022,2,3612,3621,2550,1071,2.380952381,1743,1595,1038,613,2,611,1,243,0,0.055646481,empty,mBC-0716-2
"B8,E7",16352,16645,12243,4402,8019,0,3687,3702,2579,1123,2.296527159,1774,4101,1428,874,3,871,1,306,0,0.076923077,empty,mBC-0716-2
"B8,E8",19964,20335,15327,5008,10028,8,4559,4578,3179,1399,2.272337384,2128,1680,868,537,0,537,0,211,0,0.081936685,empty,mBC-0716-2
"B8,E9",10675,11164,8024,3140,5279,0,2428,2434,1706,728,2.343406593,1189,982,600,340,0,340,0,137,0,0.058823529,empty,mBC-0716-2
"B8,E10",14621,14940,11253,3687,7398,2,3354,3365,2327,1038,2.241811175,1570,1158,703,395,0,395,0,179,0,0.053164557,empty,mBC-0716-2
"B8,E11",10835,11228,8201,3027,5616,15,2598,2619,1793,826,2.170702179,1283,984,545,316,1,315,1,139,0,0.034920635,empty,mBC-0716-2
"B8,E12",17925,18822,13610,5212,9252,52,4255,4315,3001,1314,2.283866058,2131,1127,664,385,0,385,0,156,0,0.072727273,empty,mBC-0716-2
"B8,F1",1119367,1239344,776908,462436,597941,2,361987,362500,264733,97767,2.707795064,202486,11987,7602,4160,0,4160,0,877,0,0.010576923,mm10,mBC-0716-2
"B8,F2",25464,26284,19208,7076,12812,0,6099,6109,4298,1811,2.373274434,2908,2906,1638,1014,1,1013,1,396,0,0.046396841,empty,mBC-0716-2
"B8,F3",772303,839939,539998,299941,414404,1,241101,241444,187939,53505,3.512550229,133473,9557,5403,3051,2,3049,1,890,0,0.0236143,mm10,mBC-0716-2
"B8,F4",735135,783136,542792,240344,389447,1,196776,197106,163432,33674,4.853358674,102846,20443,13404,7435,3,7432,2,1276,0,0.002018299,mm10,mBC-0716-2
"B8,F5",29542,30550,22440,8110,14685,8,6808,6826,4835,1991,2.428427926,3314,2365,1187,739,0,739,0,304,0,0.063599459,empty,mBC-0716-2
"B8,F6",27316,28264,20820,7444,13659,0,6216,6233,4403,1830,2.406010929,3091,2124,1172,687,0,687,0,252,0,0.059679767,empty,mBC-0716-2
"B8,F7",23438,24369,18216,6153,11788,0,5302,5320,3766,1554,2.423423423,2505,737,481,297,0,297,0,125,0,0.043771044,empty,mBC-0716-2
"B8,F8",25373,25888,19624,6264,12599,15,5556,5590,3897,1693,2.301831069,2554,274,153,112,0,112,0,79,0,0.008928571,empty,mBC-0716-2
"B8,F9",16701,17296,12682,4614,8408,20,3769,3797,2651,1146,2.313263525,1835,1221,737,439,0,439,0,180,0,0.022779043,empty,mBC-0716-2
"B8,F10",25400,25882,19631,6251,12616,6,5482,5495,3930,1565,2.511182109,2490,3145,1201,697,0,697,0,281,0,0.020086083,empty,mBC-0716-2
"B8,F11",929820,1017991,663124,354867,494267,6,274047,274489,233586,40903,5.710730264,149131,73069,48214,26809,8,26801,1,2938,0,0.001268609,mm10,mBC-0716-2
"B8,F12",860497,975290,603355,371935,468688,1,274994,275327,203375,71952,2.826537136,157630,4319,2587,1419,0,1419,0,373,0,0.006342495,mm10,mBC-0716-2
"B8,G1",11506,12155,8943,3212,5961,10,2748,2760,1889,871,2.168771527,1318,1835,1103,674,0,674,0,223,0,0.065281899,empty,mBC-0716-2
"B8,G2",23884,24544,18416,6128,11980,0,5346,5358,3751,1607,2.334163037,2508,618,322,228,0,228,0,145,0,0.013157895,empty,mBC-0716-2
"B8,G3",22552,23098,17391,5707,11127,0,4975,4982,3594,1388,2.589337176,2293,2034,1309,767,0,767,0,269,0,0.033898305,empty,mBC-0716-2
"B8,G4",32022,33439,24563,8876,16120,20,7303,7335,5216,2119,2.461538462,3637,154,90,59,0,59,0,55,0,0.016949153,empty,mBC-0716-2
"B8,G5",15589,16211,11741,4470,7884,0,3661,3673,2545,1128,2.256205674,1847,1232,759,467,0,467,0,210,0,0.023554604,empty,mBC-0716-2
"B8,G6",27121,28209,20710,7499,13349,0,6097,6108,4322,1786,2.419932811,2903,159,92,67,1,66,1,46,0,0,empty,mBC-0716-2
"B8,G7",22776,23362,17528,5834,11309,3,5163,5175,3797,1378,2.755442671,2437,1642,967,585,0,585,0,287,0,0.035897436,empty,mBC-0716-2
"B8,G8",16425,17359,12361,4998,8563,5,4093,4110,2908,1202,2.419301165,2077,1625,944,558,0,558,0,227,0,0.050179211,empty,mBC-0716-2
"B8,G9",650290,670583,505409,165174,327353,15,145651,145991,111204,34787,3.196711415,69869,34376,19042,10832,9,10823,2,1792,0,0.00619052,mm10,mBC-0716-2
"B8,G10",15625,16256,12034,4222,7899,12,3580,3599,2597,1002,2.591816367,1704,1467,861,546,0,546,0,221,0,0.031135531,empty,mBC-0716-2
"B8,G11",13614,14102,10646,3456,7033,0,3151,3157,2176,981,2.21814475,1526,683,432,222,0,222,0,87,0,0.004504505,empty,mBC-0716-2
"B8,G12",13949,14336,10242,4094,6922,23,3283,3309,2295,1014,2.263313609,1638,21144,5721,3486,6,3480,3,655,0,0.272701149,empty,mBC-0716-2
"B8,H1",23514,24574,17707,6867,11857,0,5481,5493,3894,1599,2.435272045,2707,1051,627,394,0,394,0,175,0,0.068527919,empty,mBC-0716-2
"B8,H2",1199878,1252463,912473,339990,589272,0,273858,274383,230145,44238,5.202427777,135828,146586,96958,53656,25,53631,1,4142,0,0.000466148,mm10,mBC-0716-2
"B8,H3",1024449,1170210,682953,487257,562851,1,354952,355437,292783,62654,4.673013694,205952,70182,44595,24591,15,24576,2,2704,0,0.002319336,mm10,mBC-0716-2
"B8,H4",16623,17325,12620,4705,8435,34,3908,3950,2832,1118,2.533094812,1927,266,181,134,0,134,0,78,0,0,empty,mBC-0716-2
"B8,H5",20385,21103,15463,5640,10247,2,4857,4863,3389,1474,2.299185889,2308,1377,824,502,0,502,0,208,0,0.003984064,empty,mBC-0716-2
"B8,H6",192033,201071,149681,51390,98778,0,44337,44422,28014,16408,1.707337884,22291,2548,1448,871,2,869,1,325,0,0.046029919,empty,mBC-0716-2
"B8,H7",1115798,1347163,697530,649633,657297,2,455328,455845,336427,119418,2.817221859,284586,66488,41190,22950,12,22938,1,2647,0,0.002746534,mm10,mBC-0716-2
"B8,H8",15930,16461,11857,4604,7972,0,3750,3755,2639,1116,2.364695341,1819,1392,835,535,0,535,0,245,0,0.03364486,empty,mBC-0716-2
"B8,H9",2009635,2148503,1455424,693079,1012139,31,543075,544003,441972,102031,4.331742314,289611,128882,73970,41659,15,41644,4,3997,0,0.00148881,mm10,mBC-0716-2
"B8,H10",17666,18444,13236,5208,8921,15,4141,4166,2942,1224,2.403594771,2062,1534,967,613,0,613,0,255,0,0.024469821,empty,mBC-0716-2
"B8,H11",19069,20022,14579,5443,9670,0,4574,4581,3175,1406,2.258179232,2269,219,133,97,0,97,0,72,0,0,empty,mBC-0716-2
"B8,H12",7190,7307,5567,1740,3715,0,1666,1677,1135,542,2.094095941,807,712,376,237,0,237,0,98,0,0.105485232,empty,mBC-0716-2
"B9,A1",15520,16214,11688,4526,8102,0,3721,3733,2582,1151,2.243266725,1850,890,516,303,0,303,0,127,0,0.00990099,empty,mBC-0716-2
"B9,A2",779670,830021,573765,256256,403782,1,204976,205232,162599,42633,3.813923487,107390,43206,27726,15823,5,15818,1,2275,0,0.00284486,mm10,mBC-0716-2
"B9,A3",17843,18468,13487,4981,9095,0,4307,4314,3078,1236,2.490291262,2079,817,553,327,0,327,0,142,0,0.042813456,empty,mBC-0716-2
"B9,A4",1742834,1844287,1294969,549318,873695,3,453281,454020,374688,79332,4.723037362,231713,26704,16844,9418,5,9413,2,1584,0,0.004355678,mm10,mBC-0716-2
"B9,A5",19070,19827,14459,5368,9902,0,4714,4726,3306,1420,2.328169014,2358,1135,676,405,1,404,1,173,0,0.032178218,empty,mBC-0716-2
"B9,A6",14058,14893,10689,4204,7281,0,3513,3521,2442,1079,2.263206673,1739,1156,662,383,0,383,0,176,0,0.028720627,empty,mBC-0716-2
"B9,A7",17757,18277,13758,4519,8984,3,4047,4058,2810,1248,2.251602564,1867,810,461,287,0,287,0,139,0,0.052264808,empty,mBC-0716-2
"B9,A8",12026,12406,9130,3276,6055,42,2730,2779,1933,846,2.284869976,1318,1121,691,390,0,390,0,180,0,0.058974359,empty,mBC-0716-2
"B9,A9",20717,20778,15913,4865,9921,0,4369,4374,3109,1265,2.45770751,1940,984,522,326,0,326,0,161,0,0.039877301,empty,mBC-0716-2
"B9,A10",1705364,1892210,1195507,696703,906822,1,529476,530250,433187,97063,4.462946746,295083,43292,27309,14996,10,14986,2,2018,0,0.000133458,mm10,mBC-0716-2
"B9,A11",707404,728135,527911,200224,356045,1,173564,173892,124443,49449,2.516592853,87254,20344,7969,4535,2,4533,2,1121,0,0.011030223,mm10,mBC-0716-2
"B9,A12",23069,23378,17877,5501,11242,1,5014,5026,3569,1457,2.449553878,2266,2014,1274,731,0,731,0,221,0,0.056087551,empty,mBC-0716-2
"B9,B1",21608,22390,16654,5736,10831,14,4899,4918,3475,1443,2.408177408,2360,939,573,318,0,318,0,151,0,0.053459119,empty,mBC-0716-2
"B9,B2",22405,23433,17070,6363,11308,1,5204,5213,3619,1594,2.270388959,2595,458,203,109,0,109,0,56,0,0.009174312,empty,mBC-0716-2
"B9,B3",20428,21224,15461,5763,10355,0,4725,4736,3276,1460,2.243835616,2301,946,529,308,0,308,0,123,0,0.025974026,empty,mBC-0716-2
"B9,B4",18046,18411,13754,4657,9019,0,4084,4095,2832,1263,2.242280285,1952,846,437,255,0,255,0,120,0,0.043137255,empty,mBC-0716-2
"B9,B5",13804,9628,6716,2912,5653,0,2741,2760,1924,836,2.301435407,1519,644,385,235,0,235,0,96,0,0.012765957,empty,mBC-0716-2
"B9,B6",13854,14640,10439,4201,7227,0,3502,3509,2436,1073,2.27027027,1752,874,546,326,0,326,0,143,0,0.049079755,empty,mBC-0716-2
"B9,B7",18886,19482,14457,5025,9309,1,4155,4162,2932,1230,2.383739837,1967,1037,565,343,0,343,0,129,0,0.005830904,empty,mBC-0716-2
"B9,B8",14556,14676,11139,3537,7380,0,3310,3321,2299,1022,2.249510763,1554,1111,664,415,0,415,0,171,0,0.019277108,empty,mBC-0716-2
"B9,B9",16288,16783,12502,4281,8143,0,3655,3656,2574,1082,2.378927911,1721,586,355,177,0,177,0,90,0,0.04519774,empty,mBC-0716-2
"B9,B10",1396834,1409253,1034466,374787,685613,7,320688,321599,222497,99102,2.245131279,159581,24769,15401,8557,4,8553,1,1446,0,0.000116918,mm10,mBC-0716-2
"B9,B11",17599,18308,13155,5153,8879,0,4096,4098,2872,1226,2.342577488,2040,233,171,115,0,115,0,63,0,0,empty,mBC-0716-2
"B9,B12",2018116,2162305,1482554,679751,1038481,4,562440,563232,418670,144562,2.896127613,298588,31934,18614,10188,5,10183,2,1914,0,0.004517333,mm10,mBC-0716-2
"B9,C1",1528180,1666030,1093059,572971,775408,11,432427,433096,343376,89720,3.82719572,235157,44525,29296,16418,6,16412,1,2104,0,0.000792103,mm10,mBC-0716-2
"B9,C2",20577,21147,15602,5545,10119,0,4595,4608,3177,1431,2.220125786,2218,5672,1934,1080,0,1080,0,339,0,0.041666667,empty,mBC-0716-2
"B9,C3",25547,26564,19046,7518,12926,0,6144,6160,4445,1715,2.591836735,3071,460,229,139,0,139,0,76,0,0.035971223,empty,mBC-0716-2
"B9,C4",19209,19527,14775,4752,9564,0,4160,4172,2933,1239,2.367231638,1966,759,457,263,0,263,0,125,0,0.019011407,empty,mBC-0716-2
"B9,C5",18636,18952,14275,4677,9262,0,4109,4124,2872,1252,2.293929712,1931,904,496,311,0,311,0,143,0,0.054662379,empty,mBC-0716-2
"B9,C6",19885,20614,15033,5581,10277,0,4738,4741,3343,1398,2.391273247,2304,901,571,347,0,347,0,152,0,0.04610951,empty,mBC-0716-2
"B9,C7",17720,18257,13522,4735,8779,9,4034,4050,2772,1278,2.169014085,1858,305,162,111,0,111,0,61,0,0.027027027,empty,mBC-0716-2
"B9,C8",16714,17443,12652,4791,8426,0,3882,3887,2655,1232,2.155032468,1880,1097,620,385,0,385,0,161,0,0.033766234,empty,mBC-0716-2
"B9,C9",14360,15141,10828,4313,7288,2,3458,3464,2454,1010,2.42970297,1710,711,378,246,0,246,0,116,0,0.040650407,empty,mBC-0716-2
"B9,C10",15074,15501,11582,3919,7735,2,3496,3509,2454,1055,2.326066351,1693,905,557,324,0,324,0,135,0,0.046296296,empty,mBC-0716-2
"B9,C11",12692,13608,9623,3985,6608,0,3098,3109,2128,981,2.169215087,1548,2541,985,572,1,571,1,209,0,0.033274956,empty,mBC-0716-2
"B9,C12",21730,22321,16498,5823,10825,25,4996,5031,3518,1513,2.325181758,2459,802,440,286,0,286,0,125,0,0.052447552,empty,mBC-0716-2
"B9,D1",839351,908133,593742,314391,450799,55,254019,254432,193300,61132,3.162010077,138790,15447,8730,4835,3,4832,1,1077,0,0.007864238,mm10,mBC-0716-2
"B9,D2",23193,23937,17956,5981,11597,1,5044,5057,3579,1478,2.421515562,2393,1654,999,632,0,632,0,247,0,0.05221519,empty,mBC-0716-2
"B9,D3",542986,558317,407514,150803,276805,1,130391,130611,102414,28197,3.63208852,64946,11277,7404,4193,2,4191,1,883,0,0.003817705,mm10,mBC-0716-2
"B9,D4",1576780,1716060,1131100,584960,829184,30,465893,466582,374345,92237,4.058512311,251486,96021,56808,31566,22,31544,4,3665,0,0.003931017,mm10,mBC-0716-2
"B9,D5",15131,15542,11436,4106,7574,0,3469,3479,2401,1078,2.227272727,1631,2067,823,472,0,472,0,175,0,0.023305085,empty,mBC-0716-2
"B9,D6",15291,15184,10997,4187,7324,0,3540,3546,2495,1051,2.373929591,1687,11697,4002,2439,2,2437,1,572,0,0.191218712,empty,mBC-0716-2
"B9,D7",14187,14730,10740,3990,7057,1,3253,3263,2340,923,2.535211268,1577,1110,672,414,1,413,1,149,0,0.11622276,empty,mBC-0716-2
"B9,D8",17475,18382,13306,5076,8901,5,4269,4279,2999,1280,2.34296875,2100,607,373,207,0,207,0,100,0,0.014492754,empty,mBC-0716-2
"B9,D9",538794,564115,385592,178523,281410,0,144149,144369,119443,24926,4.791904036,76837,172031,107835,60185,36,60149,2,4633,0,0.004222847,mm10,mBC-0716-2
"B9,D10",760413,783733,573778,209955,382035,13,182095,182429,143672,38757,3.706994865,89750,24648,10867,6406,10,6396,4,1367,0,0.01782364,mm10,mBC-0716-2
"B9,D11",14465,15172,10978,4194,7376,10,3458,3475,2504,971,2.578784758,1703,1317,838,501,1,500,1,185,0,0.042,empty,mBC-0716-2
"B9,D12",22484,23578,17138,6440,11377,3,5285,5300,3709,1591,2.331238215,2575,1860,1121,635,0,635,0,216,0,0.088188976,empty,mBC-0716-2
"B9,E1",24027,24523,18267,6256,11981,0,5373,5394,3813,1581,2.411764706,2595,1186,666,421,0,421,0,175,0,0.047505938,empty,mBC-0716-2
"B9,E2",17961,18226,13790,4436,8888,3,3982,3993,2771,1222,2.267594108,1848,1065,673,388,0,388,0,154,0,0.06185567,empty,mBC-0716-2
"B9,E3",13431,14046,10341,3705,6894,0,3137,3145,2183,962,2.269230769,1487,1146,735,462,0,462,0,197,0,0.032467532,empty,mBC-0716-2
"B9,E4",17382,17909,13339,4570,8672,0,3900,3910,2735,1175,2.327659574,1844,2894,1023,609,1,608,1,210,0,0.008223684,empty,mBC-0716-2
"B9,E5",22909,23388,17641,5747,11417,1,5046,5057,3525,1532,2.300913838,2359,1041,637,396,0,396,0,195,0,0.055555556,empty,mBC-0716-2
"B9,E6",15693,15927,11844,4083,7706,8,3385,3409,2411,998,2.415831663,1576,7089,2400,1463,1,1462,1,473,0,0.155266758,empty,mBC-0716-2
"B9,E7",15728,16286,11799,4487,7793,3,3546,3566,2469,1097,2.250683683,1753,6076,2269,1388,1,1387,1,354,0,0.25739005,empty,mBC-0716-2
"B9,E8",18901,19111,14567,4544,9462,0,4138,4146,2925,1221,2.395577396,1886,1383,867,479,0,479,0,189,0,0.096033403,empty,mBC-0716-2
"B9,E9",9718,10048,7350,2698,4936,0,2304,2307,1619,688,2.353197674,1129,804,509,312,0,312,0,124,0,0.044871795,empty,mBC-0716-2
"B9,E10",14277,14865,10923,3942,7404,11,3472,3494,2475,1019,2.428851816,1693,1072,585,336,0,336,0,145,0,0.071428571,empty,mBC-0716-2
"B9,E11",10055,10411,7667,2744,5095,0,2301,2308,1619,689,2.349782293,1145,699,401,234,0,234,0,120,0,0.085470085,empty,mBC-0716-2
"B9,E12",18231,18777,13629,5148,9337,0,4432,4442,3064,1378,2.223512337,2228,956,555,308,0,308,0,117,0,0.032467532,empty,mBC-0716-2
"B9,F1",20603,21149,15864,5285,10203,0,4575,4584,3247,1337,2.428571429,2129,7342,2748,1680,4,1676,2,468,0,0.112171838,empty,mBC-0716-2
"B9,F2",1595062,1739784,1134724,605060,840440,1,481945,482579,378638,103941,3.642816598,265222,77217,50234,28283,6,28277,1,3125,0,0.001909679,mm10,mBC-0716-2
"B9,F3",17577,18385,13310,5075,9044,0,4232,4246,2947,1299,2.268668206,2063,1143,701,458,0,458,0,191,0,0.045851528,empty,mBC-0716-2
"B9,F4",17672,17684,13436,4248,8690,0,3853,3860,2684,1176,2.282312925,1737,467,248,148,0,148,0,64,0,0.040540541,empty,mBC-0716-2
"B9,F5",27307,28323,20891,7432,13834,18,6312,6351,4496,1855,2.423719677,3074,6752,2331,1373,0,1373,0,448,0,0.035688274,empty,mBC-0716-2
"B9,F6",25783,26540,19438,7102,12940,1,6123,6128,4357,1771,2.460191982,3024,1851,969,590,0,590,0,220,0,0.054237288,empty,mBC-0716-2
"B9,F7",22281,22838,16948,5890,11099,0,4987,5007,3496,1511,2.313699537,2408,642,396,227,0,227,0,105,0,0.013215859,empty,mBC-0716-2
"B9,F8",26135,26718,20069,6649,12945,60,5766,5835,4146,1689,2.454706927,2656,330,200,126,0,126,0,75,0,0,empty,mBC-0716-2
"B9,F9",16424,16833,12603,4230,8200,4,3710,3725,2585,1140,2.26754386,1714,1290,764,438,0,438,0,173,0,0.02283105,empty,mBC-0716-2
"B9,F10",1208288,1299456,880304,419152,617279,22,331048,331567,272858,58709,4.647634945,174468,55090,33439,18306,8,18298,1,2369,0,0.001694174,mm10,mBC-0716-2
"B9,F11",12633,12847,9628,3219,6328,0,2864,2870,2003,867,2.310265283,1338,899,523,310,0,310,0,138,0,0.009677419,empty,mBC-0716-2
"B9,F12",15707,16299,11988,4311,7870,9,3636,3661,2540,1121,2.265834077,1762,229,99,65,0,65,0,39,0,0.046153846,empty,mBC-0716-2
"B9,G1",10991,11446,8405,3041,5655,0,2535,2542,1794,748,2.398395722,1219,1226,758,456,0,456,0,181,0,0.078947368,empty,mBC-0716-2
"B9,G2",885493,918735,680640,238095,442045,10,202315,202701,167082,35619,4.690811084,98237,26054,17357,9648,4,9644,1,1470,0,0.001347988,mm10,mBC-0716-2
"B9,G3",22329,23178,16796,6382,11242,7,5267,5282,3650,1632,2.236519608,2558,1760,1049,626,0,626,0,252,0,0.059105431,empty,mBC-0716-2
"B9,G4",1023227,1103639,712722,390917,537269,0,313059,313501,246592,66909,3.685483268,171187,151,98,67,0,67,0,45,0,0.014925373,empty,mBC-0716-2
"B9,G5",14651,15594,11111,4483,7632,0,3554,3556,2475,1081,2.289546716,1800,1065,685,402,0,402,0,176,0,0.034825871,empty,mBC-0716-2
"B9,G6",27120,27453,21092,6361,13318,60,5805,5878,4109,1769,2.322781232,2680,135,84,52,0,52,0,39,0,0,empty,mBC-0716-2
"B9,G7",22232,23014,17222,5792,11241,18,5034,5061,3607,1454,2.480742779,2405,1378,752,476,0,476,0,213,0,0.058823529,empty,mBC-0716-2
"B9,G8",16113,16609,12416,4193,8200,0,3795,3801,2670,1131,2.360742706,1827,1537,756,462,0,462,0,197,0,0.075757576,empty,mBC-0716-2
"B9,G9",11792,12398,8949,3449,6188,1,2868,2875,1996,879,2.27076223,1439,3371,1207,714,2,712,2,270,0,0.058988764,empty,mBC-0716-2
"B9,G10",14841,15202,11416,3786,7349,0,3324,3335,2325,1010,2.301980198,1542,1042,667,427,0,427,0,173,0,0.039812646,empty,mBC-0716-2
"B9,G11",1056120,1082761,788363,294398,528641,9,256375,256896,197853,59043,3.350998425,128432,15586,8742,4963,5,4958,1,1138,0,0.005042356,mm10,mBC-0716-2
"B9,G12",12356,12931,9382,3549,6336,10,2952,2970,2062,908,2.27092511,1419,823,472,267,0,267,0,115,0,0.097378277,empty,mBC-0716-2
"B9,H1",1445794,1483216,1085648,397568,709567,1,341657,342260,257980,84280,3.060987186,171691,15384,8375,4666,0,4666,0,1081,0,0.00235748,mm10,mBC-0716-2
"B9,H2",26588,27037,20317,6720,13133,0,5891,5905,4197,1708,2.457259953,2799,1743,1017,632,1,631,1,263,0,0.041204437,empty,mBC-0716-2
"B9,H3",22478,23553,16876,6677,11497,4,5460,5476,3860,1616,2.388613861,2743,1252,775,456,1,455,1,198,0,0.03956044,empty,mBC-0716-2
"B9,H4",16477,16565,12281,4284,8109,59,3639,3713,2604,1109,2.348061317,1808,992,306,200,0,200,0,98,0,0.035,empty,mBC-0716-2
"B9,H5",19846,20630,14992,5638,9907,1,4701,4712,3278,1434,2.285913529,2310,1204,772,458,0,458,0,176,0,0.050218341,empty,mBC-0716-2
"B9,H6",15391,16051,11535,4516,7901,0,3716,3718,2583,1135,2.275770925,1842,1277,778,451,2,449,1,186,0,0.037861915,empty,mBC-0716-2
"B9,H7",18683,19042,14225,4817,9378,28,4363,4400,3039,1361,2.232916973,2058,1104,616,390,0,390,0,169,0,0.084615385,empty,mBC-0716-2
"B9,H8",15539,16304,11539,4765,8081,7,3840,3853,2712,1141,2.376862401,1991,14855,4754,2860,5,2855,3,727,0,0.147810858,empty,mBC-0716-2
"B9,H9",17672,17749,13246,4503,8909,0,4039,4052,2889,1163,2.484092863,1974,7026,2120,1305,1,1304,1,411,0,0.058282209,empty,mBC-0716-2
"B9,H10",17127,17565,12813,4752,8663,12,4045,4064,2850,1214,2.347611203,1953,1093,665,418,0,418,0,203,0,0.0215311,empty,mBC-0716-2
"B9,H11",18236,18880,13882,4998,9295,0,4377,4390,2943,1447,2.033863165,2122,157,89,66,0,66,0,42,0,0.015151515,empty,mBC-0716-2
"B9,H12",6749,6750,5178,1572,3430,0,1537,1542,1111,431,2.577726218,719,423,265,175,0,175,0,70,0,0,empty,mBC-0716-2
"B10,A1",14379,14551,10964,3587,7437,3,3439,3449,2340,1109,2.110009017,1594,1276,768,467,0,467,0,185,0,0.034261242,empty,mBC-0716-2
"B10,A2",782390,828858,575592,253266,402841,4,211136,211517,146733,64784,2.264957397,109587,20676,13523,7843,2,7841,1,1315,0,0.003060834,mm10,mBC-0716-2
"B10,A3",17144,17840,12951,4889,8602,2,4028,4039,2880,1159,2.484900777,1947,1182,660,422,1,421,1,175,0,0.03087886,empty,mBC-0716-2
"B10,A4",1120273,1187970,846910,341060,558927,7,273062,273613,203625,69988,2.90942733,137704,27740,18704,10622,5,10617,1,1596,0,0.001036074,mm10,mBC-0716-2
"B10,A5",18637,19400,14203,5197,9445,17,4377,4404,3005,1399,2.147962831,2145,4486,1864,1091,0,1091,0,370,0,0.077910174,empty,mBC-0716-2
"B10,A6",16625,17599,12584,5015,8641,0,4012,4021,2921,1100,2.655454545,2012,2003,1197,727,1,726,1,270,0,0.046831956,empty,mBC-0716-2
"B10,A7",21235,22814,15622,7192,11078,21,5755,5798,4078,1720,2.370930233,3014,4390,1574,974,0,974,0,358,0,0.054414784,empty,mBC-0716-2
"B10,A8",11736,12262,9050,3212,6097,6,2834,2847,1989,858,2.318181818,1367,1606,952,566,1,565,1,258,0,0.033628319,empty,mBC-0716-2
"B10,A9",20351,20498,15583,4915,9800,0,4189,4196,2985,1211,2.464905037,1923,1647,1003,581,0,581,0,248,0,0.063683305,empty,mBC-0716-2
"B10,A10",958255,1111836,634797,477039,536168,1,340467,340898,251096,89802,2.796106991,200924,14383,9163,5052,2,5050,1,1014,0,0.001584158,mm10,mBC-0716-2
"B10,A11",19040,19431,14537,4894,9668,4,4422,4435,3107,1328,2.339608434,2118,1867,1018,614,2,612,1,243,0,0.022875817,empty,mBC-0716-2
"B10,A12",22554,23110,17362,5748,11044,8,4913,4928,3481,1447,2.405666897,2322,2407,1499,859,0,859,0,276,0,0.061699651,empty,mBC-0716-2
"B10,B1",907056,981271,639482,341789,477283,0,274810,275290,212192,63098,3.362895813,149003,19206,12398,6095,2,6093,1,1263,0,0.005744297,mm10,mBC-0716-2
"B10,B2",908874,964635,621284,343351,473167,1,271018,271415,197420,73995,2.668018109,152112,2922,1594,844,0,844,0,269,0,0.017772512,empty,mBC-0716-2
"B10,B3",20234,21162,15335,5827,10347,0,4816,4827,3352,1475,2.272542373,2415,1189,682,411,0,411,0,201,0,0.063260341,empty,mBC-0716-2
"B10,B4",858920,930947,637157,293790,451336,0,235619,235989,177282,58707,3.019776177,124367,44452,28411,16104,8,16096,1,2112,0,0.001677435,mm10,mBC-0716-2
"B10,B5",15898,12554,8512,4042,7099,5,3503,3527,2690,837,3.21385902,1900,884,522,322,0,322,0,124,0,0.034161491,empty,mBC-0716-2
"B10,B6",13263,13954,9934,4020,6769,0,3181,3191,2174,1017,2.137659784,1625,1304,731,445,0,445,0,207,0,0.056179775,empty,mBC-0716-2
"B10,B7",17330,17658,13308,4350,8732,0,3923,3934,2770,1164,2.379725086,1835,1185,697,390,0,390,0,160,0,0.115384615,empty,mBC-0716-2
"B10,B8",657009,697841,494437,203404,340495,8,161859,162162,137542,24620,5.586596263,82242,120492,78256,43430,27,43403,3,3846,0,0.000944635,mm10,mBC-0716-2
"B10,B9",938090,1020163,682115,338048,488695,38,260966,261402,219806,41596,5.284306183,140099,70101,44418,24780,12,24768,2,2813,0,0.000242248,mm10,mBC-0716-2
"B10,B10",17500,17846,12799,5047,8878,0,4255,4262,2946,1316,2.238601824,2147,840,460,255,1,254,1,108,0,0.070866142,empty,mBC-0716-2
"B10,B11",16908,17482,12928,4554,8350,4,3809,3821,2692,1129,2.384410983,1821,293,174,113,0,113,0,63,0,0,empty,mBC-0716-2
"B10,B12",19646,20339,15171,5168,9973,8,4524,4539,3236,1303,2.483499616,2174,1384,790,484,1,483,1,183,0,0.049689441,empty,mBC-0716-2
"B10,C1",23830,23723,18265,5458,11412,0,4864,4878,3404,1474,2.30936228,2173,812,489,309,0,309,0,139,0,0.012944984,empty,mBC-0716-2
"B10,C2",19663,20261,15077,5184,9644,19,4455,4478,3079,1399,2.200857756,2127,1678,1020,645,0,645,0,230,0,0.052713178,empty,mBC-0716-2
"B10,C3",971183,1080001,708541,371460,517789,34,281647,282109,207182,74927,2.765118048,155005,28747,18846,10513,6,10507,1,1621,0,0.001903493,mm10,mBC-0716-2
"B10,C4",18596,18849,14268,4581,9249,0,4059,4069,2833,1236,2.292071197,1920,1691,904,509,1,508,1,198,0,0.023622047,empty,mBC-0716-2
"B10,C5",16960,17718,12903,4815,8609,0,3977,3990,2802,1188,2.358585859,1973,1507,807,514,0,514,0,228,0,0.048638132,empty,mBC-0716-2
"B10,C6",17485,18271,13268,5003,9162,7,4308,4319,3039,1280,2.37421875,2139,1904,1074,622,1,621,1,245,0,0.035426731,empty,mBC-0716-2
"B10,C7",17151,17906,12891,5015,8701,14,4094,4114,2865,1249,2.293835068,2006,450,231,146,1,145,1,91,0,0.034482759,empty,mBC-0716-2
"B10,C8",15776,16324,11862,4462,7906,0,3683,3694,2432,1262,1.927099842,1798,1698,994,606,0,606,0,223,0,0.061056106,empty,mBC-0716-2
"B10,C9",825162,893891,600802,293089,432814,6,225469,225854,191116,34738,5.501640854,120437,80878,52607,29666,19,29647,1,2961,0,0.000573414,mm10,mBC-0716-2
"B10,C10",14782,15398,11344,4054,7594,0,3463,3467,2411,1056,2.283143939,1710,1333,779,478,0,478,0,190,0,0.054393305,empty,mBC-0716-2
"B10,C11",12601,12896,9285,3611,6352,0,3021,3026,2089,937,2.22945571,1494,7706,2600,1582,2,1580,1,490,0,0.161392405,empty,mBC-0716-2
"B10,C12",20218,20705,15312,5393,10192,0,4659,4670,3295,1375,2.396363636,2208,1381,815,497,0,497,0,192,0,0.078470825,empty,mBC-0716-2
"B10,D1",12397,12870,9266,3604,6400,6,3037,3045,2115,930,2.274193548,1476,1699,659,409,0,409,0,158,0,0.122249389,empty,mBC-0716-2
"B10,D2",885375,925223,645528,279695,449124,1,235678,236117,180447,55670,3.24136878,121185,42342,22231,12757,8,12749,1,2225,0,0.011530316,mm10,mBC-0716-2
"B10,D3",13746,14481,10260,4221,7068,0,3308,3319,2303,1016,2.266732283,1659,1602,956,597,0,597,0,264,0,0.060301508,empty,mBC-0716-2
"B10,D4",15435,15562,11792,3770,7702,0,3443,3456,2497,959,2.60375391,1608,1487,926,549,0,549,0,255,0,0.009107468,empty,mBC-0716-2
"B10,D5",14975,15539,11362,4177,7482,101,3395,3506,2542,964,2.636929461,1716,1293,751,422,1,421,1,160,0,0.03087886,empty,mBC-0716-2
"B10,D6",13273,13919,9974,3945,6844,2,3267,3272,2280,992,2.298387097,1612,1500,900,534,0,534,0,216,0,0.058052434,empty,mBC-0716-2
"B10,D7",13891,14468,10614,3854,6980,26,3196,3232,2352,880,2.672727273,1582,1514,900,528,0,528,0,210,0,0.017045455,empty,mBC-0716-2
"B10,D8",16843,17951,12704,5247,8771,1,4230,4235,3025,1210,2.5,2213,1114,654,412,0,412,0,191,0,0.02184466,empty,mBC-0716-2
"B10,D9",6926,7256,5201,2055,3744,0,1826,1834,1351,483,2.797101449,960,3321,1938,1151,0,1151,0,379,0,0.019982624,empty,mBC-0716-2
"B10,D10",14357,15233,10855,4378,7314,25,3482,3513,2441,1072,2.277052239,1741,968,528,314,0,314,0,122,0,0.063694268,empty,mBC-0716-2
"B10,D11",14437,15004,10909,4095,7251,20,3320,3348,2369,979,2.419816139,1668,1717,982,586,0,586,0,258,0,0.030716724,empty,mBC-0716-2
"B10,D12",21615,22285,16401,5884,10665,0,4889,4904,3328,1576,2.111675127,2330,4317,2173,1254,1,1253,1,356,0,0.10933759,empty,mBC-0716-2
"B10,E1",22995,23209,17547,5662,11358,0,5114,5125,3658,1467,2.493524199,2453,1637,953,577,0,577,0,263,0,0.022530329,empty,mBC-0716-2
"B10,E2",381150,380935,297944,82991,191726,0,76865,77040,57582,19458,2.959296947,35714,25262,15652,9084,4,9080,2,1560,0,0.003634361,mm10,mBC-0716-2
"B10,E3",12968,13272,9878,3394,6465,0,2938,2950,2057,893,2.303471445,1358,1713,1071,647,0,647,0,249,0,0.052550232,empty,mBC-0716-2
"B10,E4",16833,17122,12635,4487,8208,1,3779,3783,2684,1099,2.4422202,1831,5666,1918,1149,2,1147,2,353,0,0.024411508,empty,mBC-0716-2
"B10,E5",23292,23650,18033,5617,11453,1,5069,5081,3606,1475,2.444745763,2326,1609,952,601,0,601,0,281,0,0.041597338,empty,mBC-0716-2
"B10,E6",14826,15055,11186,3869,7191,50,3178,3236,2292,944,2.427966102,1486,12954,4661,2872,1,2871,1,690,0,0.21595263,empty,mBC-0716-2
"B10,E7",14731,15064,11176,3888,7370,0,3350,3360,2364,996,2.373493976,1614,2635,1258,695,0,695,0,270,0,0.041726619,empty,mBC-0716-2
"B10,E8",18852,19556,14462,5094,9481,6,4281,4295,2966,1329,2.231753198,2056,2142,1340,778,0,778,0,269,0,0.035989717,empty,mBC-0716-2
"B10,E9",9478,9620,7139,2481,4739,2,2225,2231,1590,641,2.48049922,1069,1207,681,385,0,385,0,148,0,0.046753247,empty,mBC-0716-2
"B10,E10",14078,14820,10793,4027,7250,0,3387,3390,2376,1014,2.343195266,1673,1384,823,493,0,493,0,199,0,0.024340771,empty,mBC-0716-2
"B10,E11",740307,811965,522576,289389,401285,5,226179,226538,176588,49950,3.535295295,124600,109066,70821,39827,9,39818,2,3646,0,0.001305942,mm10,mBC-0716-2
"B10,E12",15509,15937,11732,4205,7884,3,3569,3582,2488,1094,2.274223035,1759,1206,749,422,0,422,0,176,0,0.078199052,empty,mBC-0716-2
"B10,F1",19672,20855,14986,5869,9879,23,4415,4449,3163,1286,2.459564541,2219,3326,1444,860,0,860,0,338,0,0.034883721,empty,mBC-0716-2
"B10,F2",2391539,2609670,1705023,904647,1234555,9,710036,711065,568605,142460,3.9913309,387582,292210,192804,108244,42,108202,3,6089,0,0.001247666,mm10,mBC-0716-2
"B10,F3",17037,17853,12731,5122,8709,5,4198,4212,2859,1353,2.11308204,2172,2073,1316,839,1,838,1,323,0,0.039379475,empty,mBC-0716-2
"B10,F4",16486,16510,12384,4126,8257,13,3718,3743,2625,1118,2.347942755,1814,958,433,267,0,267,0,127,0,0,empty,mBC-0716-2
"B10,F5",25436,26323,19407,6916,12712,0,5852,5879,4158,1721,2.416037188,2832,3020,1472,904,1,903,1,356,0,0.048726467,empty,mBC-0716-2
"B10,F6",24295,25076,18311,6765,12133,2,5622,5634,3982,1652,2.410411622,2747,2572,1349,840,0,840,0,280,0,0.033333333,empty,mBC-0716-2
"B10,F7",21511,22681,16465,6216,11040,26,5061,5094,3575,1519,2.353522054,2496,1387,679,405,0,405,0,183,0,0.017283951,empty,mBC-0716-2
"B10,F8",24811,25687,18697,6990,12641,21,5813,5847,4088,1759,2.324047754,2838,375,216,139,0,139,0,85,0,0.007194245,empty,mBC-0716-2
"B10,F9",735270,785375,529010,256365,388267,1,213699,213991,171799,42192,4.071838263,113542,20969,10868,6336,6,6330,1,1292,0,0.008372828,mm10,mBC-0716-2
"B10,F10",1146670,1257850,819669,438181,603514,17,345580,346170,269637,76533,3.523146878,187063,81147,52616,29435,14,29421,5,2964,0,0.001801434,mm10,mBC-0716-2
"B10,F11",779766,844365,559130,285235,411832,1,225825,226138,181461,44677,4.061620073,121111,69457,45203,25460,7,25453,1,2814,0,0.002042981,mm10,mBC-0716-2
"B10,F12",14902,15824,11150,4674,7474,3,3629,3640,2457,1183,2.076923077,1773,204,113,81,0,81,0,55,0,0,empty,mBC-0716-2
"B10,G1",505299,535986,378382,157604,265157,1,135332,135578,102183,33395,3.059829316,68817,11591,7284,3924,1,3923,1,962,0,0.00586286,mm10,mBC-0716-2
"B10,G2",1062078,1120677,790710,329967,534691,1,261253,261714,221494,40220,5.507061164,132950,32790,21147,11807,10,11797,3,1744,0,0.001017208,mm10,mBC-0716-2
"B10,G3",911730,1001371,647595,353776,484048,20,272501,272960,226016,46944,4.814587594,149195,90580,59249,33613,15,33598,5,3407,0,0.001637002,mm10,mBC-0716-2
"B10,G4",30623,31525,23686,7839,15144,22,6678,6715,4716,1999,2.35917959,3158,170,107,79,0,79,0,54,0,0,empty,mBC-0716-2
"B10,G5",14944,15326,11526,3800,7365,1,3373,3383,2348,1035,2.268599034,1544,12039,3489,2174,4,2170,3,617,0,0.057142857,empty,mBC-0716-2
"B10,G6",25872,26312,19638,6674,12605,0,5565,5588,4089,1499,2.727818546,2637,228,132,84,0,84,0,56,0,0,empty,mBC-0716-2
"B10,G7",21584,22249,16726,5523,10863,0,4887,4893,3481,1412,2.46529745,2292,2155,1282,782,0,782,0,279,0,0.063938619,empty,mBC-0716-2
"B10,G8",15982,16650,12086,4564,8022,0,3837,3844,2682,1162,2.308089501,1837,1635,987,578,0,578,0,240,0,0.031141869,empty,mBC-0716-2
"B10,G9",1099582,1137180,837953,299227,553377,35,262444,262959,200085,62874,3.182317015,128689,58538,35882,20556,7,20549,1,2834,0,0.005499051,mm10,mBC-0716-2
"B10,G10",14312,14809,11030,3779,7279,6,3291,3304,2334,970,2.406185567,1598,1336,808,511,0,511,0,236,0,0.045009785,empty,mBC-0716-2
"B10,G11",13524,13707,10107,3600,6623,0,3106,3110,2194,916,2.395196507,1433,9704,3025,1822,1,1821,1,497,0,0.021965953,empty,mBC-0716-2
"B10,G12",12195,12665,9252,3413,6331,15,2990,3007,2072,935,2.216042781,1470,1189,668,409,1,408,1,179,0,0.058823529,empty,mBC-0716-2
"B10,H1",21845,22623,16468,6155,11028,1,5186,5195,3677,1518,2.42226614,2533,988,596,370,0,370,0,167,0,0.051351351,empty,mBC-0716-2
"B10,H2",25519,26159,19409,6750,12638,3,5746,5757,4088,1669,2.449370881,2720,2365,1519,898,0,898,0,327,0,0.050111359,empty,mBC-0716-2
"B10,H3",21641,22258,16295,5963,10735,8,5043,5060,3579,1481,2.416610398,2410,1819,1095,631,1,630,1,272,0,0.019047619,empty,mBC-0716-2
"B10,H4",14780,14820,11165,3655,7287,10,3362,3387,2382,1005,2.370149254,1596,715,348,245,0,245,0,102,0,0.048979592,empty,mBC-0716-2
"B10,H5",19282,20249,14505,5744,9568,15,4420,4439,3092,1347,2.295471418,2231,5593,2160,1342,1,1341,1,380,0,0.118568233,empty,mBC-0716-2
"B10,H6",14404,14956,11084,3872,7482,14,3565,3580,2507,1073,2.336439888,1751,1454,825,515,0,515,0,220,0,0.05631068,empty,mBC-0716-2
"B10,H7",17711,18349,13391,4958,9033,0,4225,4233,2968,1265,2.346245059,2084,1382,838,504,0,504,0,208,0,0.041666667,empty,mBC-0716-2
"B10,H8",15660,16367,11808,4559,8080,55,3850,3917,2752,1165,2.36223176,1949,1714,1102,663,1,662,1,282,0,0.021148036,empty,mBC-0716-2
"B10,H9",16340,16861,12469,4392,8318,0,3775,3787,2720,1067,2.549203374,1852,1616,948,607,0,607,0,253,0,0.021416804,empty,mBC-0716-2
"B10,H10",15543,16193,11677,4516,7871,29,3623,3665,2599,1066,2.438086304,1831,4494,1832,1147,1,1146,1,409,0,0.080279232,empty,mBC-0716-2
"B10,H11",17274,17895,13007,4888,8694,0,3962,3966,2744,1222,2.245499182,1917,205,103,81,0,81,0,60,0,0.049382716,empty,mBC-0716-2
"B10,H12",6348,6530,4738,1792,3185,6,1449,1460,992,468,2.11965812,713,696,437,265,0,265,0,104,0,0.064150943,empty,mBC-0716-2
"B11,A1",14980,16028,11246,4782,7876,0,3755,3760,2643,1117,2.366159355,1924,1071,673,400,0,400,0,160,0,0.0775,empty,mBC-0716-2
"B11,A2",19700,19865,15236,4629,9682,15,4212,4236,2941,1295,2.271042471,1967,1069,594,350,0,350,0,152,0,0.051428571,empty,mBC-0716-2
"B11,A3",454380,495144,324400,170744,240709,25,133637,133864,106890,26974,3.962704827,72522,24282,15080,8517,6,8511,1,1255,0,0.00892962,mm10,mBC-0716-2
"B11,A4",1014702,1054392,772009,282383,497776,27,232602,233049,180857,52192,3.465224555,114097,32776,21463,11830,8,11822,2,1732,0,0.001353409,mm10,mBC-0716-2
"B11,A5",18665,19366,14165,5201,9579,5,4370,4388,3015,1373,2.19592134,2157,1547,809,476,0,476,0,203,0,0.037815126,empty,mBC-0716-2
"B11,A6",14251,14339,10605,3734,7071,1,3270,3276,2337,939,2.488817891,1558,1893,876,538,1,537,1,212,0,0.156424581,empty,mBC-0716-2
"B11,A7",16951,17755,12874,4881,8508,13,3979,3999,2764,1235,2.23805668,1913,1150,675,425,0,425,0,182,0,0.018823529,empty,mBC-0716-2
"B11,A8",11100,11389,8409,2980,5530,10,2447,2462,1750,712,2.457865169,1175,1294,731,436,1,435,1,185,0,0.036781609,empty,mBC-0716-2
"B11,A9",19947,20293,15348,4945,9835,2,4341,4349,3089,1260,2.451587302,2025,1116,673,407,0,407,0,176,0,0.00982801,empty,mBC-0716-2
"B11,A10",909649,985329,640360,344969,475009,2,264452,264844,224456,40388,5.557492324,143798,30987,18268,10536,4,10532,2,1640,0,0.002563616,mm10,mBC-0716-2
"B11,A11",19188,19410,14758,4652,9603,8,4200,4216,2957,1259,2.348689436,1976,1215,709,432,0,432,0,169,0,0.064814815,empty,mBC-0716-2
"B11,A12",21977,23036,16835,6201,10928,8,4934,4953,3470,1483,2.339851652,2348,5833,2387,1356,3,1353,1,399,0,0.059127864,empty,mBC-0716-2
"B11,B1",20857,21582,15847,5735,10401,17,4835,4858,3475,1383,2.512653651,2312,1317,745,421,0,421,0,152,0,0.057007126,empty,mBC-0716-2
"B11,B2",22203,22754,17068,5686,11021,5,4997,5020,3499,1521,2.300460224,2372,770,353,213,0,213,0,84,0,0.042253521,empty,mBC-0716-2
"B11,B3",1291221,1443554,906438,537116,684353,1,395126,395716,266624,129092,2.065379729,225816,37315,24201,13480,10,13470,1,1884,0,0.001484781,mm10,mBC-0716-2
"B11,B4",17504,18319,13417,4902,8898,0,4066,4082,2911,1171,2.485909479,1958,1003,637,382,0,382,0,129,0,0.07591623,empty,mBC-0716-2
"B11,B5",9480,5543,3852,1691,3499,4,1635,1650,1185,465,2.548387097,900,731,394,224,0,224,0,115,0,0.0625,empty,mBC-0716-2
"B11,B6",932260,1032767,633346,399421,498790,27,309041,309462,251544,57918,4.34310577,174050,18079,10562,6124,3,6121,2,1228,0,0.002123836,mm10,mBC-0716-2
"B11,B7",17871,18502,13718,4784,9051,21,4096,4127,2861,1266,2.259873618,1988,1105,655,378,1,377,1,140,0,0.106100796,empty,mBC-0716-2
"B11,B8",14111,14531,10809,3722,7082,0,3281,3293,2306,987,2.336372847,1555,984,622,392,0,392,0,192,0,0.022959184,empty,mBC-0716-2
"B11,B9",16714,17198,12802,4396,8226,1,3746,3759,2671,1088,2.454963235,1758,685,427,257,0,257,0,119,0,0.042801556,empty,mBC-0716-2
"B11,B10",17994,18223,13590,4633,9028,35,4070,4128,2785,1343,2.073715562,1958,694,351,230,0,230,0,90,0,0.030434783,empty,mBC-0716-2
"B11,B11",3320964,3544923,2373603,1171320,1610521,2,930296,931646,745814,185832,4.013377674,493526,11909,7025,3968,1,3967,1,943,0,0.003781195,mm10,mBC-0716-2
"B11,B12",19436,19957,14630,5327,9956,0,4576,4585,3230,1355,2.383763838,2247,3216,1237,735,1,734,1,272,0,0.050408719,empty,mBC-0716-2
"B11,C1",23719,24509,18132,6377,11618,0,5136,5147,3668,1479,2.480054091,2433,621,391,216,0,216,0,102,0,0.013888889,empty,mBC-0716-2
"B11,C2",19363,19986,14653,5333,9669,0,4506,4525,3174,1351,2.349370836,2223,1325,758,456,0,456,0,181,0,0.052631579,empty,mBC-0716-2
"B11,C3",23555,24592,17598,6994,11957,16,5753,5779,4180,1599,2.614133834,2874,2975,899,565,0,565,0,201,0,0.069026549,empty,mBC-0716-2
"B11,C4",18522,18822,14265,4557,9140,0,4073,4077,2898,1179,2.458015267,1877,884,506,309,1,308,1,132,0,0.025974026,empty,mBC-0716-2
"B11,C5",17215,17741,12864,4877,8944,0,4230,4236,2970,1266,2.345971564,2102,1114,596,377,0,377,0,167,0,0.00795756,empty,mBC-0716-2
"B11,C6",17634,18038,13142,4896,9082,3,4141,4153,2987,1166,2.561749571,2040,1382,779,490,0,490,0,192,0,0.03877551,empty,mBC-0716-2
"B11,C7",17786,18489,13331,5158,8812,0,4092,4104,2864,1240,2.309677419,2033,731,247,169,0,169,0,89,0,0,empty,mBC-0716-2
"B11,C8",16146,16788,12188,4600,8286,21,3762,3793,2620,1173,2.233589088,1903,1290,762,468,0,468,0,176,0,0.072649573,empty,mBC-0716-2
"B11,C9",13595,14391,10044,4347,6801,38,3210,3259,2239,1020,2.195098039,1622,767,472,275,0,275,0,121,0,0.043636364,empty,mBC-0716-2
"B11,C10",14556,14922,11197,3725,7278,1,3322,3331,2312,1019,2.26889107,1532,1014,610,351,0,351,0,141,0,0.074074074,empty,mBC-0716-2
"B11,C11",808066,889960,576617,313343,432276,64,241511,241927,203847,38080,5.353125,132935,62136,41457,23307,10,23297,1,2597,0,0.000772632,mm10,mBC-0716-2
"B11,C12",990593,1049355,731128,318227,495840,1,251154,251642,209601,42041,4.985633072,130363,39870,25928,14358,11,14347,1,2011,0,0.001881927,mm10,mBC-0716-2
"B11,D1",12988,13567,9752,3815,6563,55,3095,3156,2235,921,2.426710098,1542,560,296,185,0,185,0,85,0,0.081081081,empty,mBC-0716-2
"B11,D2",22451,22964,17394,5570,11194,16,4876,4910,3470,1440,2.409722222,2240,2283,1396,882,0,882,0,335,0,0.029478458,empty,mBC-0716-2
"B11,D3",14474,15041,10904,4137,7444,4,3481,3488,2430,1058,2.296786389,1690,1781,980,575,0,575,0,199,0,0.029565217,empty,mBC-0716-2
"B11,D4",1000932,1064406,745384,319022,507927,7,248806,249257,214068,35189,6.083378328,127831,107780,71415,40457,20,40437,1,3509,0,0.00143433,mm10,mBC-0716-2
"B11,D5",851223,929595,610195,319400,450876,0,249448,249797,204862,44935,4.559074218,134219,42359,27722,15922,6,15916,1,2074,0,0.002701684,mm10,mBC-0716-2
"B11,D6",13184,13946,9966,3980,6814,0,3295,3302,2357,945,2.494179894,1645,1030,564,368,0,368,0,163,0,0.035326087,empty,mBC-0716-2
"B11,D7",14016,14606,10452,4154,7094,0,3385,3387,2295,1092,2.101648352,1708,1200,692,407,0,407,0,161,0,0.022113022,empty,mBC-0716-2
"B11,D8",16922,17284,12627,4657,8294,1,3839,3844,2664,1180,2.257627119,1875,5483,1836,1067,0,1067,0,383,0,0.035613871,empty,mBC-0716-2
"B11,D9",5855,5938,4315,1623,3057,2,1502,1505,1124,381,2.950131234,751,1459,852,552,0,552,0,235,0,0.018115942,empty,mBC-0716-2
"B11,D10",14644,14843,11085,3758,7174,4,3228,3239,2296,943,2.434782609,1580,596,341,222,0,222,0,96,0,0.103603604,empty,mBC-0716-2
"B11,D11",14082,14548,10597,3951,7124,27,3312,3345,2302,1043,2.207094919,1640,1483,867,557,0,557,0,231,0,0.044883303,empty,mBC-0716-2
"B11,D12",21643,22710,16565,6145,10991,22,5019,5045,3531,1514,2.332232497,2449,3509,1697,1046,0,1046,0,349,0,0.029636711,empty,mBC-0716-2
"B11,E1",22954,22996,17544,5452,11288,0,4951,4978,3500,1478,2.368064953,2302,1671,1006,575,0,575,0,210,0,0.073043478,empty,mBC-0716-2
"B11,E2",17202,17671,13079,4592,8692,5,3956,3966,2797,1169,2.392643285,1908,1344,758,445,0,445,0,183,0,0.074157303,empty,mBC-0716-2
"B11,E3",13354,13710,10200,3510,6645,5,2949,2966,2071,895,2.31396648,1392,1376,826,487,0,487,0,200,0,0.036960986,empty,mBC-0716-2
"B11,E4",16478,16750,12226,4524,8016,0,3663,3673,2592,1081,2.397779833,1742,9141,3167,2018,4,2014,1,477,0,0.304369414,empty,mBC-0716-2
"B11,E5",22741,23006,17532,5474,11192,0,4910,4925,3528,1397,2.525411596,2211,2542,1181,721,0,721,0,277,0,0.026352288,empty,mBC-0716-2
"B11,E6",15013,15180,11423,3757,7479,1,3463,3467,2472,995,2.484422111,1679,1259,756,446,0,446,0,206,0,0.051569507,empty,mBC-0716-2
"B11,E7",15057,15470,11380,4090,7481,12,3401,3420,2421,999,2.423423423,1611,7574,2317,1395,1,1394,1,436,0,0.035150646,empty,mBC-0716-2
"B11,E8",18793,18913,14567,4346,9228,0,4022,4034,2856,1178,2.424448217,1875,2072,1115,676,1,675,1,253,0,0.091851852,empty,mBC-0716-2
"B11,E9",9445,9881,7255,2626,4812,0,2258,2258,1569,689,2.277213353,1052,1946,909,536,0,536,0,170,0,0.069029851,empty,mBC-0716-2
"B11,E10",14006,14307,10892,3415,7011,5,3188,3199,2243,956,2.34623431,1479,1609,907,549,0,549,0,186,0,0.102003643,empty,mBC-0716-2
"B11,E11",10221,10611,7834,2777,5285,0,2404,2409,1670,739,2.259810555,1163,1081,669,398,0,398,0,161,0,0.08040201,empty,mBC-0716-2
"B11,E12",756504,887567,489592,397975,436441,0,290827,291161,216394,74767,2.894244787,176960,30794,10946,6438,3,6435,1,1583,0,0.032634033,mm10,mBC-0716-2
"B11,F1",20038,20959,15323,5636,10104,0,4576,4585,3292,1293,2.546017015,2321,3275,1194,750,0,750,0,283,0,0.06,empty,mBC-0716-2
"B11,F2",934251,1043429,655849,387580,504122,1,287648,288150,240794,47356,5.084762227,161476,180391,118776,66854,20,66834,3,4611,0,0.001182033,mm10,mBC-0716-2
"B11,F3",17054,18210,12756,5454,9068,3,4464,4469,3051,1418,2.151622003,2299,1542,951,569,0,569,0,248,0,0.042179262,empty,mBC-0716-2
"B11,F4",748968,799890,533218,266672,396772,7,217779,218096,168260,49836,3.376274179,116619,14109,9326,5454,8,5446,1,981,0,0.004957767,mm10,mBC-0716-2
"B11,F5",26279,27183,19740,7443,13062,0,6056,6068,4250,1818,2.337733773,2996,2091,1176,677,0,677,0,272,0,0.047267356,empty,mBC-0716-2
"B11,F6",690656,747239,497594,249645,366830,1,198224,198513,164997,33516,4.922932331,106729,64709,41828,24122,11,24111,2,2618,0,0.00128572,mm10,mBC-0716-2
"B11,F7",21738,22198,16455,5743,10873,0,4954,4967,3466,1501,2.309127249,2399,1184,580,354,0,354,0,153,0,0.042372881,empty,mBC-0716-2
"B11,F8",698622,748963,518304,230659,364864,10,183619,183951,149468,34483,4.334541658,96310,6104,3937,2318,2,2316,1,558,0,0.000431779,mm10,mBC-0716-2
"B11,F9",15803,16537,11966,4571,8209,12,3859,3875,2668,1207,2.210439105,1946,1562,908,513,0,513,0,194,0,0.019493177,empty,mBC-0716-2
"B11,F10",22530,23253,17248,6005,11105,16,4954,4982,3592,1390,2.584172662,2368,5902,1927,1144,3,1141,2,349,0,0.024539877,empty,mBC-0716-2
"B11,F11",610019,641449,445548,195901,317383,1,164868,165122,128100,37022,3.460104803,85975,17754,7971,4737,2,4735,1,1081,0,0.027666315,mm10,mBC-0716-2
"B11,F12",15213,15619,11643,3976,7634,0,3508,3512,2433,1079,2.254865616,1652,140,79,59,0,59,0,39,0,0.084745763,empty,mBC-0716-2
"B11,G1",10562,11000,8072,2928,5401,6,2461,2475,1625,850,1.911764706,1181,1672,1036,566,0,566,0,195,0,0.03180212,empty,mBC-0716-2
"B11,G2",22418,23043,17077,5966,11288,0,5106,5126,3592,1534,2.341590613,2403,640,341,211,1,210,1,124,0,0.019047619,empty,mBC-0716-2
"B11,G3",772469,841651,562705,278946,410217,1,218914,219277,180054,39223,4.590520868,117379,109321,73206,40650,21,40629,3,3795,0,0.001033744,mm10,mBC-0716-2
"B11,G4",37098,38697,28565,10132,18526,6,8327,8355,6009,2346,2.561381074,3948,126,95,62,0,62,0,43,0,0.016129032,empty,mBC-0716-2
"B11,G5",14829,15428,11295,4133,7443,4,3526,3541,2416,1125,2.147555556,1678,2539,1033,652,0,652,0,265,0,0.073619632,empty,mBC-0716-2
"B11,G6",25503,26250,19912,6338,12583,1,5507,5518,3923,1595,2.459561129,2545,204,120,95,0,95,0,60,0,0,empty,mBC-0716-2
"B11,G7",21832,21986,16714,5272,10676,2,4674,4693,3354,1339,2.504854369,2197,4700,1766,1071,0,1071,0,351,0,0.051353875,empty,mBC-0716-2
"B11,G8",15600,16488,11909,4579,8041,8,3762,3783,2586,1197,2.160401003,1885,1127,713,461,0,461,0,202,0,0.026030369,empty,mBC-0716-2
"B11,G9",11300,11813,8581,3232,5755,0,2641,2649,1871,778,2.404884319,1254,2373,1001,596,0,596,0,269,0,0.062080537,empty,mBC-0716-2
"B11,G10",927681,993788,677639,316149,481577,1,252931,253343,201397,51946,3.877045393,132811,56968,38155,21132,4,21128,1,2535,0,0.003076486,mm10,mBC-0716-2
"B11,G11",13266,13684,10213,3471,6631,13,2972,2999,2161,838,2.57875895,1366,615,375,211,0,211,0,106,0,0.037914692,empty,mBC-0716-2
"B11,G12",12225,12863,9203,3660,6219,0,2892,2896,2009,887,2.264937993,1401,1021,639,382,0,382,0,163,0,0.083769634,empty,mBC-0716-2
"B11,H1",24755,25885,18892,6993,12447,1,5706,5726,4062,1664,2.441105769,2800,1753,825,500,0,500,0,191,0,0.034,empty,mBC-0716-2
"B11,H2",29398,29758,22325,7433,14502,16,6767,6801,4781,2020,2.366831683,3149,1704,1015,653,0,653,0,269,0,0.029096478,empty,mBC-0716-2
"B11,H3",21965,22518,16702,5816,11057,1,5067,5074,3560,1514,2.351387054,2411,2410,989,566,0,566,0,229,0,0.060070671,empty,mBC-0716-2
"B11,H4",15190,15319,11375,3944,7604,6,3534,3545,2501,1044,2.39559387,1705,227,142,96,0,96,0,67,0,0,empty,mBC-0716-2
"B11,H5",18930,19328,14217,5111,9332,21,4253,4284,2986,1298,2.30046225,2044,1430,856,520,1,519,1,194,0,0.052023121,empty,mBC-0716-2
"B11,H6",15210,15401,11478,3923,7636,5,3551,3564,2538,1026,2.473684211,1641,1428,828,489,0,489,0,197,0,0.034764826,empty,mBC-0716-2
"B11,H7",17563,18257,13235,5022,9047,1,4264,4276,2993,1283,2.332813718,2081,1176,744,466,0,466,0,191,0,0.025751073,empty,mBC-0716-2
"B11,H8",14650,15303,10984,4319,7451,0,3497,3504,2482,1022,2.428571429,1764,1582,960,613,1,612,1,243,0,0.035947712,empty,mBC-0716-2
"B11,H9",980011,1051459,677069,374390,508597,18,295258,295693,224305,71388,3.142054687,163325,17874,11178,6285,2,6283,1,1302,0,0.003978991,mm10,mBC-0716-2
"B11,H10",15348,15668,11555,4113,7752,0,3523,3543,2557,986,2.593306288,1684,1215,724,466,0,466,0,208,0,0.025751073,empty,mBC-0716-2
"B11,H11",17713,18566,13409,5157,9059,10,4198,4220,2983,1237,2.411479386,2105,183,110,79,0,79,0,53,0,0,empty,mBC-0716-2
"B11,H12",466036,495969,348184,147785,247433,1,121275,121476,97332,24144,4.031312127,62665,49954,31759,18086,15,18071,2,2339,0,0.005921089,mm10,mBC-0716-2
"B12,A1",13939,14528,10413,4115,7258,0,3342,3352,2228,1124,1.982206406,1678,1236,657,373,0,373,0,156,0,0.032171582,empty,mBC-0716-2
"B12,A2",788838,801812,582597,219215,390202,2,189740,190042,153877,36165,4.254859671,94433,12895,8084,4581,0,4581,0,1002,0,0.007640253,mm10,mBC-0716-2
"B12,A3",16806,17314,12767,4547,8439,0,3905,3914,2723,1191,2.286314022,1890,979,617,392,0,392,0,154,0,0.053571429,empty,mBC-0716-2
"B12,A4",22577,22878,17573,5305,11020,0,4812,4823,3475,1348,2.577893175,2150,597,327,213,0,213,0,120,0,0.042253521,empty,mBC-0716-2
"B12,A5",808119,862972,590892,272080,422843,0,219534,219884,186235,33649,5.534636988,114506,114418,73991,40856,11,40845,2,3780,0,0.001640348,mm10,mBC-0716-2
"B12,A6",15678,16336,11870,4466,8199,11,3849,3877,2776,1101,2.521344233,1911,6186,2009,1260,0,1260,0,448,0,0.026190476,empty,mBC-0716-2
"B12,A7",801277,865023,587904,277119,422871,1,221265,221663,183979,37684,4.882151576,116437,83268,54500,30010,18,29992,2,3048,0,0.00180048,mm10,mBC-0716-2
"B12,A8",453365,488279,336072,152207,243799,4,123877,124072,98349,25723,3.82338763,64649,46790,30791,16807,4,16803,1,2208,0,0.000952211,mm10,mBC-0716-2
"B12,A9",19082,19148,14696,4452,9297,0,4076,4082,2894,1188,2.436026936,1796,1099,661,428,0,428,0,208,0,0.051401869,empty,mBC-0716-2
"B12,A10",15793,16211,12212,3999,7913,5,3575,3595,2503,1092,2.292124542,1638,448,297,186,0,186,0,109,0,0.02688172,empty,mBC-0716-2
"B12,A11",17988,18244,13768,4476,9024,28,3926,3966,2767,1199,2.307756464,1895,3974,1539,915,1,914,1,321,0,0.065645514,empty,mBC-0716-2
"B12,A12",21503,21985,16618,5367,10616,0,4640,4651,3232,1419,2.277660324,2217,2815,1517,882,2,880,2,311,0,0.055681818,empty,mBC-0716-2
"B12,B1",19889,20270,15294,4976,9815,9,4421,4433,3120,1313,2.376237624,2032,1347,694,425,0,425,0,169,0,0.037647059,empty,mBC-0716-2
"B12,B2",20973,21990,15881,6109,10440,0,4712,4724,3292,1432,2.298882682,2278,433,278,176,0,176,0,87,0,0.045454545,empty,mBC-0716-2
"B12,B3",2129576,2410764,1490284,920480,1143052,0,683292,684196,533579,150617,3.542621351,387975,112293,71141,39481,20,39461,2,3686,0,0.00136844,mm10,mBC-0716-2
"B12,B4",17190,18013,13105,4908,8732,0,3984,3997,2800,1197,2.339181287,1918,1052,618,358,0,358,0,159,0,0.078212291,empty,mBC-0716-2
"B12,B5",9169,5361,3792,1569,3479,0,1710,1717,1214,503,2.413518887,883,864,508,288,0,288,0,129,0,0.048611111,empty,mBC-0716-2
"B12,B6",12529,12850,9520,3330,6344,8,2958,2974,2024,950,2.130526316,1395,1997,941,570,0,570,0,229,0,0.047368421,empty,mBC-0716-2
"B12,B7",17610,18396,13462,4934,8893,0,4094,4117,2837,1280,2.21640625,1993,1343,738,451,0,451,0,186,0,0.017738359,empty,mBC-0716-2
"B12,B8",583722,612529,441184,171345,302051,5,141285,141540,119467,22073,5.412358991,70862,61290,39663,22095,9,22086,1,2648,0,0.000633886,mm10,mBC-0716-2
"B12,B9",15957,16924,12231,4693,8214,6,3763,3776,2591,1185,2.18649789,1889,959,637,353,0,353,0,149,0,0.065155807,empty,mBC-0716-2
"B12,B10",16702,16813,12433,4380,8467,0,3890,3898,2727,1171,2.328778822,1871,649,369,223,2,221,1,87,0,0.067873303,empty,mBC-0716-2
"B12,B11",18108,18676,13684,4992,9067,0,4164,4168,2892,1276,2.26645768,2033,262,151,102,0,102,0,70,0,0,empty,mBC-0716-2
"B12,B12",19350,19833,14439,5394,9675,0,4506,4511,3171,1340,2.36641791,2155,3832,1540,860,0,860,0,270,0,0.1,empty,mBC-0716-2
"B12,C1",23143,23310,18107,5203,11186,2,4626,4637,3283,1354,2.424667651,2094,718,426,272,0,272,0,130,0,0.040441176,empty,mBC-0716-2
"B12,C2",18390,19235,13934,5301,9322,0,4354,4367,3012,1355,2.222878229,2110,1628,923,550,0,550,0,192,0,0.050909091,empty,mBC-0716-2
"B12,C3",20038,21008,15028,5980,10217,3,4737,4749,3291,1458,2.257201646,2313,597,356,217,0,217,0,101,0,0,empty,mBC-0716-2
"B12,C4",17613,17771,13439,4332,8725,23,3779,3814,2693,1121,2.402319358,1784,1071,658,377,0,377,0,146,0,0.061007958,empty,mBC-0716-2
"B12,C5",17512,18148,13182,4966,8860,53,4148,4208,3009,1199,2.509591326,2045,1293,778,487,0,487,0,214,0,0.026694045,empty,mBC-0716-2
"B12,C6",771972,835504,551989,283515,422211,29,234167,234577,168738,65839,2.562888258,126354,38668,25352,14149,4,14145,2,2010,0,0.001201838,mm10,mBC-0716-2
"B12,C7",982829,1039897,734221,305676,497463,2,239645,240061,198159,41902,4.729106009,123050,29181,18348,10174,4,10170,2,1569,0,0.002064897,mm10,mBC-0716-2
"B12,C8",15457,15812,11633,4179,7708,12,3519,3537,2457,1080,2.275,1665,1564,957,532,0,532,0,217,0,0.078947368,empty,mBC-0716-2
"B12,C9",13492,14052,10239,3813,6830,0,3227,3234,2180,1054,2.068311195,1582,818,515,340,0,340,0,149,0,0.026470588,empty,mBC-0716-2
"B12,C10",1555559,1669119,1127714,541405,802723,13,434575,435256,359309,75947,4.731049284,229931,121143,76990,43477,24,43453,4,3944,0,0.001357789,mm10,mBC-0716-2
"B12,C11",12037,12766,9076,3690,6277,39,3013,3066,2071,995,2.081407035,1581,842,484,303,0,303,0,146,0,0.02640264,empty,mBC-0716-2
"B12,C12",20688,21196,15806,5390,10236,0,4557,4567,3243,1324,2.44939577,2158,1209,740,466,1,465,1,161,0,0.027956989,empty,mBC-0716-2
"B12,D1",11244,11137,8551,2586,5629,0,2521,2526,1781,745,2.390604027,1173,640,379,231,0,231,0,114,0,0.012987013,empty,mBC-0716-2
"B12,D2",972724,1096357,652147,444210,535826,0,334960,335419,216451,118968,1.819405218,195374,88181,58684,32919,22,32897,4,3429,0,0.000790346,mm10,mBC-0716-2
"B12,D3",539637,581457,380420,201037,291003,0,163447,163669,132192,31477,4.199637831,88678,28298,14307,8019,7,8012,1,1558,0,0.005741388,mm10,mBC-0716-2
"B12,D4",992579,1186571,629315,557256,577343,2,392642,393133,295468,97665,3.025321251,239483,78403,50103,27983,14,27969,2,3124,0,0.002037971,mm10,mBC-0716-2
"B12,D5",803492,882890,562044,320846,433261,1,246522,246898,210161,36737,5.720690312,136880,90888,57604,32192,13,32179,1,3126,0,0.001211971,mm10,mBC-0716-2
"B12,D6",12353,12997,9281,3716,6456,31,3072,3108,2110,998,2.114228457,1586,1124,643,399,1,398,1,180,0,0.015075377,empty,mBC-0716-2
"B12,D7",12780,13093,9729,3364,6468,0,2985,2992,2121,871,2.435132032,1405,1379,859,490,0,490,0,176,0,0.120408163,empty,mBC-0716-2
"B12,D8",16731,17064,12515,4549,8402,16,3939,3963,2761,1202,2.297004992,1999,920,530,289,0,289,0,146,0,0,empty,mBC-0716-2
"B12,D9",4808,5001,3668,1333,2570,2,1228,1236,894,342,2.614035088,630,1559,907,544,0,544,0,268,0,0.012867647,empty,mBC-0716-2
"B12,D10",14241,14791,10881,3910,7214,4,3372,3379,2299,1080,2.128703704,1583,801,480,269,0,269,0,124,0,0.003717472,empty,mBC-0716-2
"B12,D11",13851,14352,10512,3840,7036,0,3203,3208,2267,941,2.409139214,1572,1622,997,605,0,605,0,250,0,0.05785124,empty,mBC-0716-2
"B12,D12",21097,21457,16067,5390,10338,23,4680,4714,3272,1442,2.269070735,2223,2374,1494,845,1,844,1,287,0,0.015402844,empty,mBC-0716-2
"B12,E1",684802,692371,505125,187246,341592,4,164254,164536,129112,35424,3.644760614,81230,8565,5710,3208,0,3208,0,863,0,0.003428928,mm10,mBC-0716-2
"B12,E2",601392,615836,444683,171153,306343,2,150947,151210,119959,31251,3.838565166,75796,10962,6950,3875,3,3872,1,840,0,0.004390496,mm10,mBC-0716-2
"B12,E3",16571,16765,12588,4177,8401,0,3829,3836,2791,1045,2.670813397,1796,5921,2452,1487,0,1487,0,457,0,0.104909213,empty,mBC-0716-2
"B12,E4",16160,16566,12144,4422,8019,0,3608,3614,2588,1026,2.522417154,1750,7706,2580,1517,3,1514,1,446,0,0.054821664,empty,mBC-0716-2
"B12,E5",1197747,1316924,828367,488557,635807,2,383513,384037,273999,110038,2.490039804,215041,7690,4790,2702,1,2701,1,735,0,0.002591633,mm10,mBC-0716-2
"B12,E6",13550,13585,10307,3278,6824,40,3046,3094,2131,963,2.212876428,1405,1365,826,527,0,527,0,247,0,0.058823529,empty,mBC-0716-2
"B12,E7",13824,13923,10559,3364,6953,2,3123,3134,2147,987,2.175278622,1502,1091,680,431,0,431,0,192,0,0.055684455,empty,mBC-0716-2
"B12,E8",18581,18701,14169,4532,9129,9,4049,4061,2847,1214,2.345140033,1868,7712,2598,1583,0,1583,0,479,0,0.044851548,empty,mBC-0716-2
"B12,E9",9129,9086,6893,2193,4463,0,2024,2029,1424,605,2.353719008,926,2195,827,543,0,543,0,211,0,0.014732965,empty,mBC-0716-2
"B12,E10",13244,13888,9980,3908,6905,0,3250,3259,2235,1024,2.182617188,1621,1244,746,452,1,451,1,198,0,0.057649667,empty,mBC-0716-2
"B12,E11",9362,9377,7071,2306,4786,0,2256,2259,1547,712,2.172752809,1071,7351,2290,1416,0,1416,0,422,0,0.060734463,empty,mBC-0716-2
"B12,E12",755602,892238,489421,402817,442527,5,296706,297069,233359,63710,3.662831581,178496,46730,27857,15495,7,15488,1,2196,0,0.020402893,mm10,mBC-0716-2
"B12,F1",18902,19387,14397,4990,9422,3,4360,4384,3004,1380,2.176811594,2077,10402,3426,2021,3,2018,2,593,0,0.032210109,empty,mBC-0716-2
"B12,F2",22708,23950,17193,6757,11532,0,5362,5367,3752,1615,2.323219814,2664,2569,1556,914,1,913,1,396,0,0.04381161,empty,mBC-0716-2
"B12,F3",16726,17520,12694,4826,8565,9,4056,4076,2792,1284,2.174454829,2015,1674,1033,648,1,647,1,281,0,0.043276662,empty,mBC-0716-2
"B12,F4",16168,16169,12202,3967,8087,7,3595,3616,2500,1116,2.240143369,1765,440,262,164,0,164,0,88,0,0.012195122,empty,mBC-0716-2
"B12,F5",1373886,1428888,1035274,393614,685495,3,327615,328176,269293,58883,4.573357336,163953,134706,84462,46953,25,46928,4,4175,0,0.001726048,mm10,mBC-0716-2
"B12,F6",24255,24529,18289,6240,11910,0,5391,5405,3853,1552,2.482603093,2556,3577,1734,989,1,988,1,333,0,0.08097166,empty,mBC-0716-2
"B12,F7",21326,21907,16347,5560,10775,0,4868,4869,3435,1434,2.39539749,2298,798,490,299,0,299,0,149,0,0.013377926,empty,mBC-0716-2
"B12,F8",829835,916721,594191,322530,446534,1,246634,246993,196037,50956,3.847181882,134866,13569,9011,5011,1,5010,1,958,0,0.000399202,mm10,mBC-0716-2
"B12,F9",15308,15468,11786,3682,7611,0,3393,3401,2337,1064,2.196428571,1592,1427,880,504,0,504,0,181,0,0.109126984,empty,mBC-0716-2
"B12,F10",21324,21927,16441,5486,10669,0,4661,4670,3244,1426,2.274894811,2228,1293,800,477,1,476,1,199,0,0.021008403,empty,mBC-0716-2
"B12,F11",11636,11711,9005,2706,5810,14,2587,2616,1831,785,2.332484076,1220,943,548,356,0,356,0,183,0,0.036516854,empty,mBC-0716-2
"B12,F12",14940,15327,11360,3967,7376,0,3448,3454,2436,1018,2.392927308,1646,181,114,92,1,91,1,53,0,0,empty,mBC-0716-2
"B12,G1",10737,10868,8301,2567,5364,2,2325,2337,1582,755,2.095364238,1044,1595,1017,579,1,578,1,204,0,0.032871972,empty,mBC-0716-2
"B12,G2",1226744,1318088,877097,440991,631322,8,346039,346546,271751,74795,3.633277626,186433,24271,15531,8674,5,8669,1,1499,0,0.002768485,mm10,mBC-0716-2
"B12,G3",22651,22905,17148,5757,11181,14,5089,5111,3659,1452,2.519972452,2389,3444,1598,965,0,965,0,368,0,0.058031088,empty,mBC-0716-2
"B12,G4",966225,1001456,732604,268852,482862,0,224212,224626,190806,33820,5.64180958,110245,1047,658,377,0,377,0,142,0,0.00265252,empty,mBC-0716-2
"B12,G5",14024,14329,10623,3706,6973,25,3153,3187,2221,966,2.299171843,1516,1193,748,499,0,499,0,222,0,0.042084168,empty,mBC-0716-2
"B12,G6",24250,24842,18725,6117,12078,1,5276,5292,3709,1583,2.343019583,2430,316,193,134,0,134,0,74,0,0.007462687,empty,mBC-0716-2
"B12,G7",21693,22440,16710,5730,10792,2,4832,4849,3469,1380,2.513768116,2272,1982,1192,722,0,722,0,291,0,0.063711911,empty,mBC-0716-2
"B12,G8",15032,15733,11485,4248,7706,7,3565,3578,2448,1130,2.166371681,1754,1667,992,630,0,630,0,286,0,0.047619048,empty,mBC-0716-2
"B12,G9",10821,11125,8373,2752,5448,0,2533,2544,1826,718,2.543175487,1155,3081,1225,769,1,768,1,302,0,0.0234375,empty,mBC-0716-2
"B12,G10",13918,14349,10648,3701,7104,0,3238,3249,2253,996,2.262048193,1582,1240,776,493,0,493,0,231,0,0.024340771,empty,mBC-0716-2
"B12,G11",12537,12935,9623,3312,6323,1,2862,2863,2015,848,2.376179245,1364,598,343,214,0,214,0,101,0,0.028037383,empty,mBC-0716-2
"B12,G12",770568,816630,579214,237416,402112,10,193659,193985,159502,34483,4.625525621,99106,96802,63127,35568,14,35554,2,3224,0,0.000787534,mm10,mBC-0716-2
"B12,H1",21384,22037,15973,6064,10805,0,5021,5027,3543,1484,2.387466307,2441,905,554,306,1,305,1,154,0,0.062295082,empty,mBC-0716-2
"B12,H2",24831,25457,19007,6450,12458,0,5765,5777,4021,1756,2.289863326,2777,2063,1313,829,0,829,0,324,0,0.034981906,empty,mBC-0716-2
"B12,H3",798970,846076,586468,259608,413312,14,215857,216217,174065,42152,4.129460049,112775,21428,9560,5550,4,5546,2,1267,0,0.021817526,mm10,mBC-0716-2
"B12,H4",749376,782422,547262,235160,381210,87,193634,194042,160906,33136,4.855927088,99623,2893,1835,1081,1,1080,1,319,0,0,mm10,mBC-0716-2
"B12,H5",18578,19532,13944,5588,9348,43,4349,4395,3144,1251,2.513189448,2215,3636,1595,947,0,947,0,310,0,0.125659979,empty,mBC-0716-2
"B12,H6",593773,614155,426993,187162,306941,83,160595,160967,128694,32273,3.98766771,83108,15563,7171,4154,2,4152,1,1099,0,0.016618497,mm10,mBC-0716-2
"B12,H7",802809,845082,590712,254370,414885,3,206483,206857,169986,36871,4.61028993,107139,99183,66452,36985,9,36976,2,3358,0,0.001271095,mm10,mBC-0716-2
"B12,H8",13863,14539,10331,4208,7164,1,3400,3418,2400,1018,2.357563851,1705,1577,930,598,2,596,1,262,0,0.053691275,empty,mBC-0716-2
"B12,H9",15989,16030,12148,3882,7785,20,3462,3496,2459,1037,2.371263259,1616,1180,648,415,0,415,0,199,0,0.002409639,empty,mBC-0716-2
"B12,H10",14588,15238,10907,4331,7549,0,3586,3595,2554,1041,2.453410183,1828,1307,807,500,0,500,0,257,0,0.024,empty,mBC-0716-2
"B12,H11",16908,17576,12703,4873,8505,0,3967,3986,2710,1276,2.123824451,1966,201,101,73,0,73,0,51,0,0,empty,mBC-0716-2
"B12,H12",6306,6437,4757,1680,3116,0,1442,1447,1003,444,2.259009009,660,604,371,193,0,193,0,92,0,0.088082902,empty,mBC-0716-2
"C1,A1",1036673,1123222,758385,364837,554594,2,290747,291224,232161,59063,3.930734978,155437,91283,57971,32460,19,32441,2,3233,0,0.001048056,mm10,mBC-0716-2
"C1,A2",17819,18384,13495,4889,9202,0,4200,4205,2882,1323,2.178382464,2098,3936,1879,1077,1,1076,1,330,0,0.050185874,empty,mBC-0716-2
"C1,A3",15956,16669,12075,4594,8123,0,3801,3805,2650,1155,2.294372294,1823,1477,913,560,0,560,0,229,0,0.025,empty,mBC-0716-2
"C1,A4",22103,22407,16831,5576,10943,0,4864,4872,3489,1383,2.522776573,2262,1223,761,448,0,448,0,189,0,0.024553571,empty,mBC-0716-2
"C1,A5",516678,537294,385884,151410,268648,1,131744,131989,103534,28455,3.638516957,66630,16797,10727,6148,1,6147,1,1202,0,0.004067025,mm10,mBC-0716-2
"C1,A6",66256,81120,44673,36447,39839,15,26384,26425,11285,15140,0.745376486,16075,3446,1944,1159,0,1159,0,422,0,0.025884383,empty,mBC-0716-2
"C1,A7",650412,719224,452960,266264,355287,2,212225,212485,153396,59089,2.596016179,118752,16259,10313,5980,2,5978,1,1196,0,0.003345601,mm10,mBC-0716-2
"C1,A8",11001,11479,8181,3298,5733,0,2702,2704,1858,846,2.196217494,1356,1324,783,465,0,465,0,209,0,0.023655914,empty,mBC-0716-2
"C1,A9",1974245,2156844,1388160,768684,1016669,3,595665,596508,467804,128704,3.634727747,326702,102549,66053,37331,21,37310,1,3582,0,0.001581345,mm10,mBC-0716-2
"C1,A10",14999,15179,11153,4026,7505,1,3465,3472,2406,1066,2.257035647,1671,480,254,167,0,167,0,98,0,0.011976048,empty,mBC-0716-2
"C1,A11",17692,17983,13373,4610,8793,34,3937,3984,2779,1205,2.306224066,1914,1169,661,434,1,433,1,215,0,0.020785219,empty,mBC-0716-2
"C1,A12",20075,20465,15390,5075,9698,1,4235,4247,2870,1377,2.084241104,1967,2324,1479,886,0,886,0,295,0,0.039503386,empty,mBC-0716-2
"C1,B1",965734,1074436,676803,397633,517147,15,299664,300114,253042,47072,5.375637322,166859,44991,28623,15881,7,15874,1,2143,0,0.001259922,mm10,mBC-0716-2
"C1,B2",684766,721414,496193,225221,354347,0,186683,187001,136200,50801,2.681049586,98176,9524,4110,2454,3,2451,2,681,0,0.031823745,mm10,mBC-0716-2
"C1,B3",1124863,1237886,773368,464518,591819,1,347944,348478,300029,48449,6.192676835,193644,87654,57206,32504,15,32489,1,3175,0,0.001662101,mm10,mBC-0716-2
"C1,B4",17133,17762,13029,4733,8781,6,4016,4027,2836,1191,2.381192275,1914,1304,789,476,0,476,0,200,0,0.012605042,empty,mBC-0716-2
"C1,B5",9672,6081,4176,1905,3656,0,1771,1784,1279,505,2.532673267,966,2514,841,502,4,498,1,205,0,0.010040161,empty,mBC-0716-2
"C1,B6",1236449,1356798,875985,480813,657688,1,374173,374757,303037,71720,4.225278862,206656,79559,52478,30095,13,30082,1,3178,0,0.001462669,mm10,mBC-0716-2
"C1,B7",16267,16495,12375,4120,8101,0,3646,3656,2629,1027,2.559883155,1647,966,544,343,0,343,0,164,0,0.049562682,empty,mBC-0716-2
"C1,B8",12889,12906,9709,3197,6364,0,2881,2888,2093,795,2.632704403,1321,1345,816,514,0,514,0,231,0,0.052529183,empty,mBC-0716-2
"C1,B9",777784,847888,571547,276341,408320,1,215238,215576,167086,48490,3.445782636,114895,52593,24841,13792,5,13787,1,1965,0,0.00935664,mm10,mBC-0716-2
"C1,B10",15731,16014,11529,4485,8145,10,3829,3848,2682,1166,2.300171527,1849,442,226,134,0,134,0,81,0,0.029850746,empty,mBC-0716-2
"C1,B11",19837,20711,15057,5654,10022,11,4598,4619,3216,1403,2.292230934,2287,284,177,125,0,125,0,84,0,0,empty,mBC-0716-2
"C1,B12",1173716,1322593,776063,546530,633441,1,407166,407687,304018,103669,2.932583511,232556,57648,36935,20705,18,20687,3,2597,0,0.001740223,mm10,mBC-0716-2
"C1,C1",22563,22913,17473,5440,10923,0,4634,4647,3265,1382,2.36251809,2149,1222,752,441,0,441,0,173,0,0.004535147,empty,mBC-0716-2
"C1,C2",17447,17628,13228,4400,8551,7,3882,3896,2769,1127,2.456965395,1822,2159,1364,782,0,782,0,255,0,0.047314578,empty,mBC-0716-2
"C1,C3",19743,20377,14882,5495,9880,0,4621,4635,3238,1397,2.317823908,2232,1089,648,408,1,407,1,165,0,0.034398034,empty,mBC-0716-2
"C1,C4",16466,16774,12445,4329,8340,8,3690,3712,2677,1035,2.58647343,1783,2045,1307,762,0,762,0,233,0,0.019685039,empty,mBC-0716-2
"C1,C5",899632,959129,666328,292801,460704,0,226873,227241,179529,47712,3.762764085,118704,128224,83631,47214,14,47200,3,3835,0,0.001949153,mm10,mBC-0716-2
"C1,C6",16460,16616,12312,4304,8426,5,3943,3954,2845,1109,2.565374211,1920,1140,610,382,0,382,0,202,0,0.02617801,empty,mBC-0716-2
"C1,C7",16069,16545,11983,4562,8033,2,3793,3804,2583,1221,2.115479115,1908,398,256,170,0,170,0,90,0,0,empty,mBC-0716-2
"C1,C8",13840,14296,10285,4011,7190,0,3331,3342,2321,1021,2.273261508,1648,1493,870,541,0,541,0,230,0,0.038817006,empty,mBC-0716-2
"C1,C9",12644,13127,9505,3622,6456,0,3013,3024,2135,889,2.401574803,1458,873,534,331,0,331,0,149,0,0.063444109,empty,mBC-0716-2
"C1,C10",12980,13283,9987,3296,6633,0,3027,3029,2088,941,2.218916047,1406,1103,680,405,0,405,0,167,0,0.019753086,empty,mBC-0716-2
"C1,C11",651932,720573,465918,254655,355188,9,196776,197049,167114,29935,5.582562218,108645,60259,38936,21581,14,21567,2,2623,0,0.001715584,mm10,mBC-0716-2
"C1,C12",19936,20323,15024,5299,9876,1,4556,4561,3204,1357,2.361090641,2199,1091,638,369,0,369,0,165,0,0.046070461,empty,mBC-0716-2
"C1,D1",562699,618931,391926,227005,305836,2,172593,172831,140396,32435,4.328533991,96210,48862,32404,17891,10,17881,1,2280,0,0.001845534,mm10,mBC-0716-2
"C1,D2",21778,22171,16767,5404,10771,0,4807,4822,3414,1408,2.424715909,2235,12512,4329,2613,1,2612,1,749,0,0.011102603,empty,mBC-0716-2
"C1,D3",13222,13800,9857,3943,6704,14,3143,3161,2208,953,2.316894019,1575,1574,934,577,0,577,0,260,0,0.013864818,empty,mBC-0716-2
"C1,D4",14550,14655,10880,3775,7138,0,3323,3327,2306,1021,2.258570029,1572,5486,2409,1438,0,1438,0,458,0,0.109874826,empty,mBC-0716-2
"C1,D5",13342,13966,10184,3782,6814,6,3163,3177,2257,920,2.45326087,1565,1072,657,405,0,405,0,169,0,0.086419753,empty,mBC-0716-2
"C1,D6",11761,12357,8929,3428,6124,13,2889,2909,1992,917,2.172300981,1469,3023,1288,775,0,775,0,280,0,0.067096774,empty,mBC-0716-2
"C1,D7",426208,442942,320525,122417,220716,19,104344,104559,76023,28536,2.664108495,53173,13248,7685,4373,1,4372,1,1007,0,0.002516011,mm10,mBC-0716-2
"C1,D8",1885367,2080810,1314686,766124,987320,4,585288,586073,444619,141454,3.143205565,327173,68125,44003,24501,15,24486,1,3068,0,0.001102671,mm10,mBC-0716-2
"C1,D9",228627,248952,156237,92715,125934,1,72575,72660,52405,20255,2.587262404,41158,59650,38786,22355,8,22347,1,2545,0,0.000894975,mm10,mBC-0716-2
"C1,D10",13189,13742,10070,3672,6681,0,3113,3121,2179,942,2.313163482,1443,688,378,226,0,226,0,107,0,0.044247788,empty,mBC-0716-2
"C1,D11",12866,13092,9705,3387,6520,4,2937,2948,2070,878,2.357630979,1400,5051,1910,1151,2,1149,2,398,0,0.025239339,empty,mBC-0716-2
"C1,D12",20039,20099,15207,4892,9768,0,4460,4466,3054,1412,2.162889518,2039,2227,1355,788,2,786,1,282,0,0.027989822,empty,mBC-0716-2
"C1,E1",21095,21817,16196,5621,10688,1,4805,4815,3425,1390,2.464028777,2341,2228,1398,872,0,872,0,328,0,0.029816514,empty,mBC-0716-2
"C1,E2",15188,15692,11521,4171,7629,4,3542,3561,2531,1030,2.457281553,1739,2217,1404,806,0,806,0,258,0,0.040942928,empty,mBC-0716-2
"C1,E3",12046,12587,9137,3450,6321,0,2961,2969,2128,841,2.530321046,1449,5089,2079,1285,3,1282,1,426,0,0.021840874,empty,mBC-0716-2
"C1,E4",15550,16054,11978,4076,7649,2,3500,3509,2527,982,2.573319756,1649,1896,1180,715,0,715,0,250,0,0.01958042,empty,mBC-0716-2
"C1,E5",21858,22196,16994,5202,10882,18,4804,4831,3411,1420,2.402112676,2160,1616,1048,676,0,676,0,293,0,0,empty,mBC-0716-2
"C1,E6",13238,13672,9993,3679,6772,9,3138,3151,2212,939,2.355697551,1590,1565,962,578,0,578,0,270,0,0.005190311,empty,mBC-0716-2
"C1,E7",13386,13815,10218,3597,6667,9,3054,3069,2167,902,2.402439024,1479,1190,740,484,0,484,0,210,0,0.059917355,empty,mBC-0716-2
"C1,E8",17265,17669,13278,4391,8667,0,3847,3857,2679,1178,2.274193548,1833,1805,1131,684,0,684,0,258,0,0.046783626,empty,mBC-0716-2
"C1,E9",416267,440881,307384,133497,217460,3,107579,107749,92655,15094,6.138531867,55918,62693,41392,22980,19,22961,2,2747,0,0.00165498,mm10,mBC-0716-2
"C1,E10",13585,13831,10085,3746,6839,5,3192,3209,2263,946,2.39217759,1550,8306,2755,1691,3,1688,1,474,0,0.182464455,empty,mBC-0716-2
"C1,E11",8711,9106,6494,2612,4559,12,2136,2155,1475,680,2.169117647,1071,954,585,368,0,368,0,172,0,0.016304348,empty,mBC-0716-2
"C1,E12",14547,15130,10979,4151,7400,15,3515,3541,2484,1057,2.350047304,1740,3955,1333,800,0,800,0,307,0,0.0225,empty,mBC-0716-2
"C1,F1",18368,19203,13889,5314,9505,0,4507,4523,3173,1350,2.35037037,2264,2124,1369,793,0,793,0,300,0,0.003783102,empty,mBC-0716-2
"C1,F2",22469,23469,16849,6620,11676,15,5588,5618,3966,1652,2.400726392,2834,3484,2105,1315,2,1313,1,485,0,0.04112719,empty,mBC-0716-2
"C1,F3",15771,16660,11769,4891,8346,0,3965,3972,2721,1251,2.175059952,2021,2682,1695,1006,0,1006,0,361,0,0.023856859,empty,mBC-0716-2
"C1,F4",14680,14734,11001,3733,7406,0,3431,3438,2423,1015,2.387192118,1655,7987,2507,1419,2,1417,1,453,0,0.016937191,empty,mBC-0716-2
"C1,F5",23126,23872,17521,6351,11609,3,5294,5307,3659,1648,2.22026699,2553,1955,1111,645,1,644,1,299,0,0.031055901,empty,mBC-0716-2
"C1,F6",2749516,2900665,1972120,928545,1368294,0,777052,778209,515295,262914,1.95993747,413969,50818,22658,12987,6,12981,4,2475,0,0.019798167,mm10,mBC-0716-2
"C1,F7",19884,20732,15294,5438,10150,6,4711,4726,3244,1482,2.188933873,2273,823,501,302,0,302,0,139,0,0.009933775,empty,mBC-0716-2
"C1,F8",22309,22623,16934,5689,11152,13,5124,5149,3636,1513,2.403172505,2464,418,230,161,0,161,0,110,0,0.00621118,empty,mBC-0716-2
"C1,F9",14187,14270,10822,3448,7074,0,3085,3088,2195,893,2.458006719,1446,4173,1473,893,1,892,1,310,0,0.033632287,empty,mBC-0716-2
"C1,F10",1395820,1566396,930405,635991,741650,31,473998,474647,373766,100881,3.705018785,269800,76497,45824,25526,12,25514,2,2883,0,0.002273262,mm10,mBC-0716-2
"C1,F11",10667,10846,8162,2684,5415,0,2392,2402,1690,712,2.373595506,1120,907,543,344,0,344,0,178,0,0.029069767,empty,mBC-0716-2
"C1,F12",690734,756052,490359,265693,367062,0,210137,210415,156789,53626,2.923749674,115054,734,390,257,0,257,0,106,0,0.019455253,empty,mBC-0716-2
"C1,G1",10219,10487,7967,2520,5224,45,2255,2300,1617,683,2.36749634,1058,2418,1536,897,0,897,0,274,0,0.017837235,empty,mBC-0716-2
"C1,G2",20605,21049,15699,5350,10512,0,4700,4710,3294,1416,2.326271186,2320,825,519,321,0,321,0,171,0,0.034267913,empty,mBC-0716-2
"C1,G3",1792827,2062741,1201144,861597,984719,2,627279,628123,466238,161885,2.88005683,368489,138023,90660,50143,29,50114,2,4341,0,0.000937862,mm10,mBC-0716-2
"C1,G4",27636,28016,21320,6696,13638,1,6027,6042,4279,1763,2.427112876,2778,167,110,85,0,85,0,64,0,0.023529412,empty,mBC-0716-2
"C1,G5",13367,13974,10036,3938,6891,1,3226,3237,2221,1016,2.186023622,1593,1146,695,446,0,446,0,236,0,0.020179372,empty,mBC-0716-2
"C1,G6",2173336,2308206,1562503,745703,1075778,2,592932,593813,459775,134038,3.430183978,313686,7778,5078,2962,1,2961,1,686,0,0,mm10,mBC-0716-2
"C1,G7",20703,20838,15846,4992,10091,0,4429,4439,3145,1294,2.430448223,2020,18400,5975,3662,4,3658,3,942,0,0.088846364,empty,mBC-0716-2
"C1,G8",15118,15353,11210,4143,7954,0,3773,3781,2661,1120,2.375892857,1761,4981,1917,1148,1,1147,1,445,0,0.053182214,empty,mBC-0716-2
"C1,G9",11042,11241,8210,3031,5684,5,2699,2706,1921,785,2.447133758,1286,1249,686,422,0,422,0,226,0,0.023696682,empty,mBC-0716-2
"C1,G10",13135,13474,10169,3305,6664,0,3066,3074,2186,888,2.461711712,1448,4326,1617,1035,1,1034,1,366,0,0.115087041,empty,mBC-0716-2
"C1,G11",12210,12533,9354,3179,6159,19,2753,2778,1907,871,2.189437428,1293,710,434,271,0,271,0,139,0,0.003690037,empty,mBC-0716-2
"C1,G12",11051,11329,8286,3043,5642,0,2600,2602,1749,853,2.050410317,1245,870,475,306,0,306,0,143,0,0.013071895,empty,mBC-0716-2
"C1,H1",19929,20630,14981,5649,10205,13,4821,4853,3392,1461,2.321697467,2444,1675,947,557,1,556,1,234,0,0.007194245,empty,mBC-0716-2
"C1,H2",1099782,1173610,803676,369934,558436,16,291827,292309,251634,40675,6.186453596,151887,104443,69633,39278,20,39258,2,3484,0,0.000967956,mm10,mBC-0716-2
"C1,H3",20043,20512,14988,5524,10258,0,4815,4817,3487,1330,2.621804511,2360,2102,1245,745,0,745,0,292,0,0.02147651,empty,mBC-0716-2
"C1,H4",13739,14054,10215,3839,7114,0,3418,3435,2408,1027,2.344693281,1696,339,199,135,1,134,1,80,0,0.014925373,empty,mBC-0716-2
"C1,H5",1140009,1260121,794531,465590,595566,2,347178,347693,292214,55479,5.267110078,193181,120698,70052,38865,23,38842,3,3713,0,0.005921425,mm10,mBC-0716-2
"C1,H6",13308,13670,9857,3813,6745,0,3157,3164,2250,914,2.461706783,1514,1972,1021,671,0,671,0,265,0,0.047690015,empty,mBC-0716-2
"C1,H7",16484,16656,12458,4198,8253,0,3716,3720,2649,1071,2.473389356,1738,2443,1220,760,0,760,0,282,0,0.059210526,empty,mBC-0716-2
"C1,H8",690487,763866,471027,292839,374528,1,226965,227289,162343,64946,2.499661257,129726,28890,13025,7418,5,7413,2,1526,0,0.011466343,mm10,mBC-0716-2
"C1,H9",15869,16148,11901,4247,7986,11,3619,3637,2591,1046,2.477055449,1758,1292,764,480,0,480,0,238,0,0.027083333,empty,mBC-0716-2
"C1,H10",14346,14693,10673,4020,7285,0,3369,3378,2350,1028,2.285992218,1624,5189,1882,1115,1,1114,1,393,0,0.044883303,empty,mBC-0716-2
"C1,H11",660965,763342,435067,328275,378014,10,245503,245770,183949,61821,2.97550994,146092,534,353,202,0,202,0,104,0,0.014851485,empty,mBC-0716-2
"C1,H12",5824,5840,4391,1449,2925,0,1356,1356,973,383,2.540469974,602,575,342,238,0,238,0,111,0,0.008403361,empty,mBC-0716-2
"C2,A1",11624,12172,8587,3585,6121,0,2943,2949,2100,849,2.473498233,1454,1010,619,398,0,398,0,175,0,0.065326633,empty,mBC-0716-2
"C2,A2",15450,15267,11622,3645,7485,0,3259,3264,2268,996,2.277108434,1483,1370,815,512,0,512,0,210,0,0.033203125,empty,mBC-0716-2
"C2,A3",13938,14302,10591,3711,6985,0,3164,3170,2185,985,2.218274112,1521,1159,685,431,0,431,0,186,0,0.030162413,empty,mBC-0716-2
"C2,A4",19051,19103,14735,4368,9169,2,3952,3967,2852,1115,2.557847534,1755,1855,664,427,0,427,0,175,0,0.06088993,empty,mBC-0716-2
"C2,A5",14506,14711,11070,3641,7442,0,3393,3399,2367,1032,2.293604651,1587,1587,985,643,1,642,1,276,0,0.021806854,empty,mBC-0716-2
"C2,A6",10993,11222,8230,2992,5576,0,2673,2680,1911,769,2.485045514,1253,1987,1189,725,0,725,0,285,0,0.051034483,empty,mBC-0716-2
"C2,A7",13651,14066,10389,3677,6982,20,3201,3230,2275,955,2.382198953,1532,1208,729,417,0,417,0,201,0,0.043165468,empty,mBC-0716-2
"C2,A8",554801,609168,401675,207493,300195,0,164908,165182,131396,33786,3.889066477,88950,74003,46249,26144,15,26129,1,2968,0,0.003444449,mm10,mBC-0716-2
"C2,A9",1249385,1356249,883239,473010,637305,58,360862,361500,266376,95124,2.800302763,196419,104658,64926,36251,15,36236,2,3379,0,0.001655812,mm10,mBC-0716-2
"C2,A10",670987,732614,470180,262434,359651,0,207339,207636,171665,35971,4.772316588,114025,25701,16680,9330,4,9326,1,1444,0,0.001822861,mm10,mBC-0716-2
"C2,A11",639863,696275,454314,241961,341819,0,188996,189299,161938,27361,5.918570228,102900,56208,36139,20412,6,20406,3,2403,0,0.002352249,mm10,mBC-0716-2
"C2,A12",17554,17623,13392,4231,8519,1,3809,3821,2671,1150,2.322608696,1750,2866,1595,906,1,905,1,299,0,0.06519337,empty,mBC-0716-2
"C2,B1",16420,16822,12533,4289,8170,0,3679,3685,2553,1132,2.255300353,1700,1499,863,521,0,521,0,206,0,0.038387716,empty,mBC-0716-2
"C2,B2",18440,18316,13938,4378,8968,10,4017,4040,2751,1289,2.134212568,1869,7030,2298,1376,1,1375,1,441,0,0.034909091,empty,mBC-0716-2
"C2,B3",15842,16318,12073,4245,7997,28,3555,3601,2412,1189,2.028595458,1702,1085,639,401,0,401,0,198,0,0.069825436,empty,mBC-0716-2
"C2,B4",13889,14321,10475,3846,7070,0,3259,3267,2248,1019,2.206084396,1619,1278,691,432,0,432,0,176,0,0.0625,empty,mBC-0716-2
"C2,B5",7567,4371,3024,1347,2813,0,1349,1363,976,387,2.521963824,787,1084,467,298,1,297,1,148,0,0.006734007,empty,mBC-0716-2
"C2,B6",11007,11150,8194,2956,5496,0,2556,2562,1783,779,2.288831836,1259,4776,1842,1131,0,1131,0,376,0,0.101679929,empty,mBC-0716-2
"C2,B7",14895,15217,11348,3869,7339,0,3238,3243,2303,940,2.45,1525,1144,646,401,0,401,0,171,0,0.097256858,empty,mBC-0716-2
"C2,B8",13407,14119,10274,3845,6811,1,3092,3100,2261,839,2.694874851,1525,1457,850,533,0,533,0,227,0,0.022514071,empty,mBC-0716-2
"C2,B9",13446,13599,10360,3239,6509,2,2876,2889,1968,921,2.136807818,1311,9149,2652,1591,2,1589,1,482,0,0.062932662,empty,mBC-0716-2
"C2,B10",14269,14540,10530,4010,7151,0,3366,3375,2298,1077,2.133704735,1602,538,300,181,1,180,1,88,0,0,empty,mBC-0716-2
"C2,B11",14475,14917,10864,4053,7291,4,3370,3384,2408,976,2.467213115,1633,392,224,156,0,156,0,91,0,0,empty,mBC-0716-2
"C2,B12",15237,15789,11713,4076,7859,0,3579,3584,2551,1033,2.469506292,1710,3374,1306,792,2,790,2,289,0,0.018987342,empty,mBC-0716-2
"C2,C1",878347,870367,686409,183958,411795,39,168650,169107,133632,35475,3.766934461,76490,11158,6470,3630,1,3629,1,843,0,0.013226784,mm10,mBC-0716-2
"C2,C2",15324,15771,11471,4300,7627,0,3544,3548,2408,1140,2.112280702,1740,1420,877,514,0,514,0,197,0,0.062256809,empty,mBC-0716-2
"C2,C3",20054,20151,14615,5536,9759,9,4623,4639,3318,1321,2.511733535,2314,15288,4483,2640,4,2636,2,661,0,0.107359636,empty,mBC-0716-2
"C2,C4",14385,14510,10943,3567,7078,0,3155,3155,2209,946,2.335095137,1430,1239,737,435,0,435,0,173,0,0.075862069,empty,mBC-0716-2
"C2,C5",2549741,2890829,1725558,1165271,1376188,2,876264,877457,653274,224183,2.914021135,505743,171578,102639,58060,24,58036,2,4832,0,0.003308291,mm10,mBC-0716-2
"C2,C6",14670,15001,11102,3899,7478,2,3503,3511,2484,1027,2.418695229,1698,1533,882,551,2,549,2,237,0,0.052823315,empty,mBC-0716-2
"C2,C7",14022,14366,10640,3726,6972,0,3269,3280,2335,945,2.470899471,1553,3143,1060,627,1,626,1,207,0,0.063897764,empty,mBC-0716-2
"C2,C8",12866,13020,9731,3289,6389,12,2931,2947,2049,898,2.281737194,1405,10720,3490,2078,0,2078,0,650,0,0.032242541,empty,mBC-0716-2
"C2,C9",11772,12008,8751,3257,5922,0,2785,2792,1974,818,2.413202934,1377,2344,905,555,0,555,0,217,0,0.086486486,empty,mBC-0716-2
"C2,C10",11519,11912,8687,3225,5848,0,2686,2693,1872,821,2.280146163,1314,1097,698,443,0,443,0,185,0,0.047404063,empty,mBC-0716-2
"C2,C11",10292,10668,7689,2979,5246,10,2484,2498,1726,772,2.235751295,1230,787,466,322,0,322,0,150,0,0.049689441,empty,mBC-0716-2
"C2,C12",16627,17182,12562,4620,8342,8,3808,3831,2643,1188,2.224747475,1786,1230,799,482,0,482,0,177,0,0.018672199,empty,mBC-0716-2
"C2,D1",9404,9678,7043,2635,4781,0,2244,2249,1516,733,2.068212824,1093,591,304,186,0,186,0,100,0,0.010752688,empty,mBC-0716-2
"C2,D2",18334,18514,14156,4358,9114,1,3953,3964,2793,1171,2.385140905,1778,2433,1514,930,0,930,0,377,0,0.021505376,empty,mBC-0716-2
"C2,D3",11360,11950,8624,3326,5965,2,2856,2864,1938,926,2.09287257,1419,1101,666,415,0,415,0,206,0,0.019277108,empty,mBC-0716-2
"C2,D4",19490,20655,14648,6007,10316,0,5132,5144,3802,1342,2.833084948,2565,1336,839,536,0,536,0,264,0,0.055970149,empty,mBC-0716-2
"C2,D5",11733,12154,8759,3395,5950,0,2806,2812,1992,820,2.429268293,1410,1914,903,551,1,550,1,224,0,0.027272727,empty,mBC-0716-2
"C2,D6",10603,11358,8223,3135,5534,0,2625,2632,1824,808,2.257425743,1347,1396,762,473,0,473,0,204,0,0.042283298,empty,mBC-0716-2
"C2,D7",559472,596408,406307,190101,293235,0,155432,155654,125301,30353,4.128125721,81875,21530,13210,7410,5,7405,1,1377,0,0.008777853,mm10,mBC-0716-2
"C2,D8",16346,17078,12482,4596,8250,0,3891,3905,2755,1150,2.395652174,1894,972,540,325,0,325,0,167,0,0.052307692,empty,mBC-0716-2
"C2,D9",4026,4087,2916,1171,2052,3,969,976,694,282,2.460992908,477,49095,14376,8505,6,8499,2,1770,0,0.035062949,empty,mBC-0716-2
"C2,D10",12320,12500,9482,3018,6009,0,2728,2734,1929,805,2.396273292,1264,638,353,230,0,230,0,105,0,0.113043478,empty,mBC-0716-2
"C2,D11",935772,1000633,680288,320345,479946,10,254107,254578,211756,42822,4.945028257,133604,127178,84701,47409,28,47381,1,3798,0,0.001350752,mm10,mBC-0716-2
"C2,D12",17464,18373,13251,5122,8812,2,4032,4049,2796,1253,2.231444533,2040,2133,1216,759,0,759,0,289,0,0.031620553,empty,mBC-0716-2
"C2,E1",18695,19181,14459,4722,9248,15,4072,4094,2877,1217,2.36400986,1884,1743,1028,616,0,616,0,297,0,0.073051948,empty,mBC-0716-2
"C2,E2",14027,14163,10404,3759,6839,2,3132,3137,2175,962,2.260914761,1480,39072,11866,7056,10,7046,3,1360,0,0.187056486,empty,mBC-0716-2
"C2,E3",10401,10615,7874,2741,5369,4,2411,2425,1778,647,2.748068006,1152,1513,916,555,0,555,0,253,0,0.032432432,empty,mBC-0716-2
"C2,E4",13073,13547,9802,3745,6665,0,3113,3119,2182,937,2.328708645,1571,1262,736,425,0,425,0,206,0,0.049411765,empty,mBC-0716-2
"C2,E5",19307,19423,14495,4928,9483,0,4263,4273,3008,1265,2.377865613,2023,7599,2845,1690,0,1690,0,513,0,0.117751479,empty,mBC-0716-2
"C2,E6",12384,12622,9302,3320,6243,31,2818,2855,2047,808,2.533415842,1352,1830,1090,617,0,617,0,268,0,0.038897893,empty,mBC-0716-2
"C2,E7",18510,20992,13272,7720,10280,40,5786,5834,3436,2398,1.432860717,3368,1340,812,492,0,492,0,206,0,0.038617886,empty,mBC-0716-2
"C2,E8",15155,15233,11594,3639,7489,1,3278,3281,2329,952,2.446428571,1546,1924,1119,664,0,664,0,254,0,0.030120482,empty,mBC-0716-2
"C2,E9",7620,7765,5817,1948,3748,0,1631,1642,1111,531,2.092278719,741,1143,643,400,1,399,1,157,0,0.027568922,empty,mBC-0716-2
"C2,E10",11416,11961,8631,3330,5903,0,2765,2773,1969,804,2.449004975,1410,1520,898,527,0,527,0,204,0,0.024667932,empty,mBC-0716-2
"C2,E11",7569,7948,5737,2211,3844,0,1789,1789,1241,548,2.26459854,853,1233,713,458,0,458,0,203,0,0.019650655,empty,mBC-0716-2
"C2,E12",462106,497948,340090,157858,247258,49,126744,127011,104407,22604,4.618961246,66728,49959,32175,18135,14,18121,2,2194,0,0.001048507,mm10,mBC-0716-2
"C2,F1",15183,15518,11436,4082,7650,0,3513,3526,2461,1065,2.310798122,1718,4454,1731,1008,2,1006,1,381,0,0.026838966,empty,mBC-0716-2
"C2,F2",862847,983279,573323,409956,477710,0,302580,302983,250692,52291,4.794171081,176317,122062,78112,43089,13,43076,2,3868,0,0.00160182,mm10,mBC-0716-2
"C2,F3",13788,14046,10331,3715,6882,25,3220,3249,2286,963,2.373831776,1562,3002,1537,960,0,960,0,356,0,0.06875,empty,mBC-0716-2
"C2,F4",13434,13316,10136,3180,6698,2,3035,3039,2161,878,2.461275626,1399,574,332,227,0,227,0,99,0,0.017621145,empty,mBC-0716-2
"C2,F5",20629,20948,15549,5399,10272,0,4650,4664,3263,1401,2.329050678,2184,2028,1183,739,0,739,0,345,0,0.025710419,empty,mBC-0716-2
"C2,F6",20263,20906,15187,5719,10033,11,4589,4614,3269,1345,2.430483271,2256,5907,2418,1411,1,1410,1,470,0,0.086524823,empty,mBC-0716-2
"C2,F7",17297,17834,13209,4625,8751,17,3922,3951,2733,1218,2.243842365,1899,938,581,361,0,361,0,171,0,0.04432133,empty,mBC-0716-2
"C2,F8",925286,1007536,651947,355589,486477,1,276011,276427,222801,53626,4.154719726,150758,9602,5586,3095,2,3093,2,734,0,0.005496282,mm10,mBC-0716-2
"C2,F9",12885,13186,9865,3321,6422,0,2954,2963,2051,912,2.248903509,1384,19137,6091,3686,2,3684,1,882,0,0.078718784,empty,mBC-0716-2
"C2,F10",17756,17824,13689,4135,8877,0,3925,3939,2729,1210,2.255371901,1776,1332,787,470,0,470,0,209,0,0.019148936,empty,mBC-0716-2
"C2,F11",9764,10034,7470,2564,4970,0,2224,2229,1530,699,2.188841202,1071,6090,2149,1299,1,1298,1,404,0,0.035439137,empty,mBC-0716-2
"C2,F12",12570,12986,9498,3488,6284,2,2867,2881,2025,856,2.365654206,1423,1731,552,341,0,341,0,134,0,0.046920821,empty,mBC-0716-2
"C2,G1",8600,8823,6589,2234,4470,2,2030,2034,1427,607,2.350906096,969,1528,934,569,0,569,0,215,0,0.038664323,empty,mBC-0716-2
"C2,G2",18125,18458,13786,4672,8952,0,4025,4039,2907,1132,2.568021201,1913,649,411,272,0,272,0,171,0,0.011029412,empty,mBC-0716-2
"C2,G3",808055,953483,527345,426138,465725,3,309969,310332,209177,101155,2.067885918,185959,69073,44541,24747,10,24737,1,2960,0,0.003314872,mm10,mBC-0716-2
"C2,G4",23907,24471,18378,6093,11861,3,5259,5272,3646,1626,2.242312423,2493,170,103,67,0,67,0,57,0,0.029850746,empty,mBC-0716-2
"C2,G5",11352,11489,8555,2934,5753,0,2655,2666,1854,812,2.283251232,1269,1433,835,524,0,524,0,244,0,0.032442748,empty,mBC-0716-2
"C2,G6",20680,20656,15609,5047,10170,15,4453,4478,3094,1384,2.235549133,2077,274,164,121,0,121,0,95,0,0,empty,mBC-0716-2
"C2,G7",4965148,5394802,3544487,1850315,2447538,4,1471626,1473749,1176517,297232,3.958244738,792997,388488,252908,140944,70,140874,6,6808,0,0.001228048,mm10,mBC-0716-2
"C2,G8",12487,12867,9512,3355,6354,0,2997,3004,2123,881,2.409761635,1439,1653,952,609,0,609,0,268,0,0.052545156,empty,mBC-0716-2
"C2,G9",9055,9206,6872,2334,4439,6,2036,2043,1421,622,2.284565916,969,1426,845,543,0,543,0,226,0,0.057090239,empty,mBC-0716-2
"C2,G10",11580,11680,8866,2814,5812,0,2651,2651,1815,836,2.171052632,1232,1597,1003,632,0,632,0,269,0,0.042721519,empty,mBC-0716-2
"C2,G11",1804265,1938307,1296132,642175,916792,11,505334,506169,423921,82248,5.154180041,267820,120342,75243,41598,16,41582,1,3751,0,0.003487086,mm10,mBC-0716-2
"C2,G12",9895,10294,7551,2743,5093,30,2312,2347,1674,673,2.487369985,1158,1254,762,483,0,483,0,193,0,0.02484472,empty,mBC-0716-2
"C2,H1",677276,716082,487810,228272,351689,28,189342,189687,146064,43623,3.348325425,99430,12803,7203,4104,0,4104,0,978,0,0.006822612,mm10,mBC-0716-2
"C2,H2",21444,21891,16267,5624,10835,8,4968,4984,3515,1469,2.392784207,2424,3254,1743,1072,1,1071,1,359,0,0.02334267,empty,mBC-0716-2
"C2,H3",16939,17400,12744,4656,8679,1,4008,4015,2810,1205,2.331950207,1947,1683,1007,612,1,611,1,255,0,0.058919804,empty,mBC-0716-2
"C2,H4",12237,12521,9108,3413,6150,0,2830,2838,1961,877,2.236031927,1413,476,252,173,0,173,0,109,0,0.052023121,empty,mBC-0716-2
"C2,H5",15058,15642,11402,4240,7587,35,3538,3581,2516,1065,2.362441315,1779,1419,832,524,0,524,0,208,0,0.015267176,empty,mBC-0716-2
"C2,H6",11758,12186,8768,3418,5936,4,2790,2798,1970,828,2.379227053,1382,6231,2272,1384,0,1384,0,429,0,0.067196532,empty,mBC-0716-2
"C2,H7",13886,14428,10407,4021,7099,0,3270,3274,2236,1038,2.154142582,1609,1569,939,592,1,591,1,229,0,0.037225042,empty,mBC-0716-2
"C2,H8",11368,11658,8659,2999,5728,0,2634,2643,1856,787,2.358322745,1245,1645,966,589,1,588,1,278,0,0.022108844,empty,mBC-0716-2
"C2,H9",14510,14768,10971,3797,7213,37,3260,3307,2360,947,2.492080253,1546,1459,884,548,0,548,0,280,0,0.01459854,empty,mBC-0716-2
"C2,H10",11959,11931,8944,2987,5959,0,2722,2731,1859,872,2.131880734,1310,1376,887,544,2,542,1,258,0,0.057195572,empty,mBC-0716-2
"C2,H11",451643,480370,321458,158912,240548,0,131735,131925,105436,26489,3.98036921,71274,1020,448,278,0,278,0,112,0,0.007194245,empty,mBC-0716-2
"C2,H12",454896,491783,330544,161239,244421,0,127431,127636,109973,17663,6.226179018,68254,83531,54086,29705,12,29693,3,3099,0,0.00050517,mm10,mBC-0716-2
"C3,A1",12229,12575,9305,3270,6203,2,2871,2876,2002,874,2.290617849,1397,960,545,338,0,338,0,142,0,0.029585799,empty,mBC-0716-2
"C3,A2",16790,16835,12827,4008,8244,0,3698,3715,2536,1179,2.150975403,1732,1131,627,352,0,352,0,150,0,0.005681818,empty,mBC-0716-2
"C3,A3",930613,1059313,618410,440903,507951,18,321411,321889,254494,67395,3.776155501,185665,79756,50856,28543,15,28528,1,2991,0,0.000385586,mm10,mBC-0716-2
"C3,A4",20463,20897,15627,5270,9923,0,4352,4360,3143,1217,2.582580115,2030,582,308,181,0,181,0,85,0,0.011049724,empty,mBC-0716-2
"C3,A5",16001,16455,12178,4277,7998,6,3680,3689,2562,1127,2.273291925,1749,1098,734,420,0,420,0,171,0,0.030952381,empty,mBC-0716-2
"C3,A6",581207,630574,415867,214707,308421,1,171234,171468,144040,27428,5.251567741,91652,97014,58229,33200,13,33187,2,3379,0,0.010727092,mm10,mBC-0716-2
"C3,A7",15079,15386,11413,3973,7529,30,3403,3446,2391,1055,2.266350711,1680,2233,980,601,1,600,1,209,0,0.078333333,empty,mBC-0716-2
"C3,A8",10223,10326,7775,2551,5038,0,2285,2288,1571,717,2.191073919,1054,1033,590,341,0,341,0,142,0,0.020527859,empty,mBC-0716-2
"C3,A9",16960,17022,13016,4006,8248,0,3655,3663,2580,1083,2.382271468,1692,1003,587,372,0,372,0,167,0,0.064516129,empty,mBC-0716-2
"C3,A10",460765,477089,345113,131976,235778,0,112701,112911,85513,27398,3.121140229,56339,3881,2098,1191,1,1190,1,401,0,0.001680672,mm10,mBC-0716-2
"C3,A11",16333,16395,12638,3757,7938,4,3515,3523,2424,1099,2.205641492,1570,871,512,285,0,285,0,130,0,0.035087719,empty,mBC-0716-2
"C3,A12",18951,19431,14581,4850,9214,0,4051,4059,2868,1191,2.408060453,1919,2210,1336,716,0,716,0,233,0,0.076815642,empty,mBC-0716-2
"C3,B1",18116,18770,13787,4983,9078,2,4090,4099,2895,1204,2.40448505,1992,8677,2470,1455,1,1454,1,423,0,0.01650619,empty,mBC-0716-2
"C3,B2",20346,21324,15591,5733,10347,230,4579,4827,3398,1429,2.377886634,2403,364,195,113,0,113,0,57,0,0.079646018,empty,mBC-0716-2
"C3,B3",17279,17831,13174,4657,8618,0,3914,3924,2772,1152,2.40625,1866,919,492,299,0,299,0,137,0,0.030100334,empty,mBC-0716-2
"C3,B4",15519,15805,12053,3752,7725,0,3356,3367,2368,999,2.37037037,1558,926,566,335,0,335,0,138,0,0.044776119,empty,mBC-0716-2
"C3,B5",8211,4981,3416,1565,3082,6,1493,1512,1058,454,2.330396476,844,719,432,265,0,265,0,127,0,0.037735849,empty,mBC-0716-2
"C3,B6",1354782,1522521,924128,598393,735258,6,450440,451034,355492,95542,3.72079295,258014,113613,71547,40179,21,40158,1,3748,0,0.002266049,mm10,mBC-0716-2
"C3,B7",15691,15724,11845,3879,7664,2,3448,3454,2363,1091,2.165902841,1662,787,487,300,1,299,1,116,0,0.033444816,empty,mBC-0716-2
"C3,B8",898938,985793,629513,356280,474805,1,274020,274372,216026,58346,3.702498886,151222,52543,35017,19152,11,19141,1,2326,0,0.001515072,mm10,mBC-0716-2
"C3,B9",14561,15178,11095,4083,7298,13,3352,3373,2358,1015,2.323152709,1631,1097,533,323,0,323,0,130,0,0.095975232,empty,mBC-0716-2
"C3,B10",15027,15133,11029,4104,7527,1,3524,3537,2375,1162,2.043889845,1730,463,259,150,0,150,0,77,0,0.053333333,empty,mBC-0716-2
"C3,B11",16739,17131,12613,4518,8187,1,3698,3705,2547,1158,2.199481865,1771,166,93,54,0,54,0,40,0,0.037037037,empty,mBC-0716-2
"C3,B12",747382,826213,519792,306421,403005,13,233698,234063,199122,34941,5.69880656,129578,60371,39699,21992,4,21988,1,2577,0,0.00213753,mm10,mBC-0716-2
"C3,C1",21883,22344,16894,5450,10521,10,4455,4484,3138,1346,2.331352155,2109,640,391,237,0,237,0,98,0,0.122362869,empty,mBC-0716-2
"C3,C2",17141,17498,13006,4492,8388,29,3802,3843,2699,1144,2.359265734,1811,1306,786,407,0,407,0,140,0,0.068796069,empty,mBC-0716-2
"C3,C3",18818,19747,13940,5807,9339,16,4392,4418,3026,1392,2.173850575,2229,1655,616,381,0,381,0,147,0,0.065616798,empty,mBC-0716-2
"C3,C4",16650,16637,12465,4172,8019,2,3537,3555,2505,1050,2.385714286,1703,14601,4581,2698,2,2696,1,730,0,0.03264095,empty,mBC-0716-2
"C3,C5",15841,16781,11692,5089,8153,1,4016,4026,2440,1586,1.538461538,2137,1302,766,426,1,425,1,186,0,0.032941176,empty,mBC-0716-2
"C3,C6",15088,15194,11347,3847,7662,4,3506,3517,2409,1108,2.174187726,1680,1138,665,389,2,387,1,164,0,0.056847545,empty,mBC-0716-2
"C3,C7",677484,713179,495168,218011,348219,3,180016,180322,135845,44477,3.054275243,93988,8308,3843,2141,4,2137,1,611,0,0.014506317,mm10,mBC-0716-2
"C3,C8",13387,13553,10078,3475,6628,15,2975,2996,2044,952,2.147058824,1397,2731,1191,746,1,745,1,236,0,0.139597315,empty,mBC-0716-2
"C3,C9",12618,12759,9404,3355,6316,0,2938,2948,2111,837,2.522102748,1402,3343,1309,756,0,756,0,230,0,0.038359788,empty,mBC-0716-2
"C3,C10",12915,13434,9884,3550,6584,0,3066,3077,2097,980,2.139795918,1460,731,465,280,0,280,0,129,0,0.071428571,empty,mBC-0716-2
"C3,C11",11439,11717,8561,3156,5704,5,2680,2686,1858,828,2.243961353,1363,2726,1075,662,0,662,0,245,0,0.102719033,empty,mBC-0716-2
"C3,C12",18851,19503,14151,5352,9264,0,4216,4224,2897,1327,2.183119819,2081,988,604,307,0,307,0,116,0,0.081433225,empty,mBC-0716-2
"C3,D1",9890,9921,7395,2526,4945,0,2283,2289,1609,680,2.366176471,1022,512,303,197,1,196,1,94,0,0.071428571,empty,mBC-0716-2
"C3,D2",30805,30933,22919,8014,15025,18,7079,7130,4978,2152,2.313197026,3375,4262,2652,1510,0,1510,0,425,0,0.036423841,empty,mBC-0716-2
"C3,D3",12677,12865,9545,3320,6388,11,3018,3036,2063,973,2.12024666,1433,829,473,294,0,294,0,152,0,0.044217687,empty,mBC-0716-2
"C3,D4",14447,14570,11114,3456,7071,2,3190,3194,2206,988,2.232793522,1510,1018,618,367,0,367,0,172,0,0.027247956,empty,mBC-0716-2
"C3,D5",12497,12798,9531,3267,6281,0,2836,2839,1977,862,2.29350348,1376,1022,589,362,0,362,0,149,0,0.143646409,empty,mBC-0716-2
"C3,D6",11695,12174,8459,3715,5859,0,2820,2828,1915,913,2.097480832,1463,8923,3025,1809,3,1806,1,510,0,0.139534884,empty,mBC-0716-2
"C3,D7",11397,11705,8603,3102,5648,0,2645,2648,1880,768,2.447916667,1271,3019,1260,721,0,721,0,224,0,0.048543689,empty,mBC-0716-2
"C3,D8",14280,14761,10817,3944,7204,0,3413,3419,2402,1017,2.361848574,1633,890,534,322,0,322,0,142,0,0.00621118,empty,mBC-0716-2
"C3,D9",3649,3733,2609,1124,2002,9,999,1008,739,269,2.747211896,535,5593,2023,1222,1,1221,1,426,0,0.12039312,empty,mBC-0716-2
"C3,D10",12877,13335,9890,3445,6504,4,3018,3026,2134,892,2.392376682,1457,1455,648,359,0,359,0,132,0,0.033426184,empty,mBC-0716-2
"C3,D11",11872,12282,8992,3290,5998,0,2790,2798,1955,843,2.319098458,1385,1396,816,497,0,497,0,207,0,0.028169014,empty,mBC-0716-2
"C3,D12",20173,20663,15241,5422,9936,4,4624,4652,3195,1457,2.192862045,2303,19933,6433,3800,3,3797,1,931,0,0.048722676,empty,mBC-0716-2
"C3,E1",1118932,1203697,793921,409776,572036,21,316540,317060,264268,52792,5.005834217,170616,89676,52825,29260,19,29241,2,3123,0,0.004616805,mm10,mBC-0716-2
"C3,E2",14606,14863,11240,3623,7200,0,3225,3230,2282,948,2.407172996,1442,1376,777,466,0,466,0,174,0,0.053648069,empty,mBC-0716-2
"C3,E3",11736,12326,8977,3349,5977,2,2731,2738,1897,841,2.255648038,1331,1682,961,571,0,571,0,213,0,0.031523643,empty,mBC-0716-2
"C3,E4",14581,15081,11061,4020,7168,0,3251,3258,2272,986,2.304259635,1528,1176,733,429,1,428,1,175,0,0.023364486,empty,mBC-0716-2
"C3,E5",1056541,1126296,767643,358653,538028,17,282927,283381,238872,44509,5.366824687,148310,59990,39019,21702,11,21691,2,2568,0,0.001475266,mm10,mBC-0716-2
"C3,E6",14843,15431,11257,4174,7456,13,3438,3452,2483,969,2.562435501,1681,1466,836,498,0,498,0,213,0,0.062248996,empty,mBC-0716-2
"C3,E7",13076,13206,9822,3384,6432,0,2968,2985,2034,951,2.138801262,1424,1057,565,326,0,326,0,146,0,0.009202454,empty,mBC-0716-2
"C3,E8",16399,16915,12536,4379,8179,0,3652,3664,2488,1176,2.115646259,1792,1354,791,468,0,468,0,185,0,0.057692308,empty,mBC-0716-2
"C3,E9",7716,7847,5952,1895,3891,0,1762,1765,1231,534,2.305243446,817,874,529,271,0,271,0,109,0,0.029520295,empty,mBC-0716-2
"C3,E10",12680,13201,9692,3509,6364,7,2897,2911,2004,907,2.209481808,1438,1168,690,411,0,411,0,166,0,0.111922141,empty,mBC-0716-2
"C3,E11",8405,8540,6346,2194,4295,0,2021,2027,1402,625,2.2432,971,5608,1944,1177,0,1177,0,335,0,0.038232795,empty,mBC-0716-2
"C3,E12",13882,14539,10432,4107,7035,2,3326,3331,2329,1002,2.324351297,1634,1044,634,361,0,361,0,133,0,0.016620499,empty,mBC-0716-2
"C3,F1",17026,17414,13011,4403,8432,3,3758,3777,2605,1172,2.222696246,1820,1335,779,487,0,487,0,174,0,0.051334702,empty,mBC-0716-2
"C3,F2",20871,21577,15720,5857,10496,10,4855,4878,3424,1454,2.354883081,2371,4546,2044,1232,1,1231,1,432,0,0.044679123,empty,mBC-0716-2
"C3,F3",14620,14792,10929,3863,7169,14,3268,3297,2232,1065,2.095774648,1584,1840,1083,659,0,659,0,244,0,0.050075873,empty,mBC-0716-2
"C3,F4",13798,14179,10361,3818,7019,1,3263,3273,2255,1018,2.215127701,1599,631,293,190,0,190,0,77,0,0.015789474,empty,mBC-0716-2
"C3,F5",22801,23987,17375,6612,11494,9,5275,5297,3697,1600,2.310625,2651,1931,1183,702,0,702,0,248,0,0.04985755,empty,mBC-0716-2
"C3,F6",203800,226438,133600,92838,109489,0,70265,70348,35243,35105,1.003931064,40956,6957,3064,1780,3,1777,2,572,0,0.050084412,mm10,mBC-0716-2
"C3,F7",31899,34662,23631,11031,16462,15,8587,8626,6145,2481,2.476823861,4406,784,504,258,0,258,0,110,0,0.100775194,empty,mBC-0716-2
"C3,F8",20372,21079,15585,5494,10216,0,4692,4694,3313,1381,2.398986242,2181,203,140,100,0,100,0,61,0,0.02,empty,mBC-0716-2
"C3,F9",13507,13893,10315,3578,6753,27,2999,3038,2144,894,2.398210291,1450,1910,941,580,0,580,0,194,0,0.082758621,empty,mBC-0716-2
"C3,F10",19666,20063,15150,4913,9786,0,4385,4396,3089,1307,2.363427697,2033,978,583,367,0,367,0,159,0,0.040871935,empty,mBC-0716-2
"C3,F11",10470,10829,8063,2766,5221,7,2334,2343,1641,702,2.337606838,1082,1043,616,346,0,346,0,121,0,0.060693642,empty,mBC-0716-2
"C3,F12",13250,13596,10147,3449,6558,0,2963,2970,2070,900,2.3,1420,101,61,43,0,43,0,36,0,0,empty,mBC-0716-2
"C3,G1",9856,10243,7557,2686,5040,12,2269,2288,1588,700,2.268571429,1091,1544,949,534,0,534,0,189,0,0.02247191,empty,mBC-0716-2
"C3,G2",19967,20277,15378,4899,9726,0,4356,4367,3064,1303,2.351496546,1938,537,329,208,0,208,0,102,0,0.014423077,empty,mBC-0716-2
"C3,G3",18755,19775,14444,5331,9371,10,4424,4448,3111,1337,2.326851159,2149,14599,4713,2821,2,2819,1,784,0,0.009223129,empty,mBC-0716-2
"C3,G4",1081762,1146512,796493,350019,544456,39,280135,280699,224777,55922,4.019473552,145751,324,211,135,0,135,0,66,0,0.007407407,empty,mBC-0716-2
"C3,G5",12837,13460,9655,3805,6542,1,3080,3095,2165,930,2.327956989,1519,2475,971,580,0,580,0,241,0,0.025862069,empty,mBC-0716-2
"C3,G6",23094,23776,17695,6081,11440,1,5140,5153,3715,1438,2.583449235,2442,183,134,80,0,80,0,41,0,0.1,empty,mBC-0716-2
"C3,G7",19368,20079,14758,5321,9584,21,4385,4414,3187,1227,2.597392013,2111,26866,7940,4710,4,4706,2,1033,0,0.072885678,empty,mBC-0716-2
"C3,G8",13618,14003,10321,3682,6866,14,3256,3282,2316,966,2.397515528,1533,1241,682,416,0,416,0,176,0,0.014423077,empty,mBC-0716-2
"C3,G9",9601,10302,7136,3166,4981,0,2387,2392,1659,733,2.263301501,1236,1030,630,396,0,396,0,179,0,0.055555556,empty,mBC-0716-2
"C3,G10",12745,12887,9781,3106,6256,0,2821,2825,2003,822,2.436739659,1297,1260,806,463,0,463,0,199,0,0.041036717,empty,mBC-0716-2
"C3,G11",11682,11989,8964,3025,5742,0,2601,2612,1766,846,2.087470449,1252,486,312,206,0,206,0,95,0,0.029126214,empty,mBC-0716-2
"C3,G12",865170,1062642,536676,525966,526847,2,372093,372558,227909,144649,1.575600246,236852,41439,25651,14396,4,14392,1,1922,0,0.004863813,mm10,mBC-0716-2
"C3,H1",19296,19829,14593,5236,9630,1,4444,4452,3159,1293,2.443155452,2188,795,516,320,0,320,0,122,0,0.034375,empty,mBC-0716-2
"C3,H2",41796,45068,31126,13942,21157,0,10868,10888,7594,3294,2.305403764,5585,11599,4061,2326,2,2324,2,675,0,0.024096386,empty,mBC-0716-2
"C3,H3",18288,18689,13749,4940,8912,41,4091,4138,2844,1294,2.197836167,1936,1629,844,525,0,525,0,207,0,0.064761905,empty,mBC-0716-2
"C3,H4",644978,666561,487761,178800,321459,1,146055,146376,121241,25135,4.8235926,72116,3630,2250,1307,0,1307,0,347,0,0.000765111,mm10,mBC-0716-2
"C3,H5",22364,23623,16507,7116,11255,20,5482,5511,3926,1585,2.476971609,2822,1681,1002,553,1,552,1,178,0,0.016304348,empty,mBC-0716-2
"C3,H6",12400,12705,9287,3418,6104,0,2848,2850,1954,896,2.180803571,1376,1395,781,459,0,459,0,175,0,0.02832244,empty,mBC-0716-2
"C3,H7",15160,15354,11553,3801,7614,64,3325,3400,2399,1001,2.396603397,1637,1220,717,434,1,433,1,173,0,0.032332564,empty,mBC-0716-2
"C3,H8",11866,12351,9029,3322,5886,0,2735,2740,1939,801,2.420724095,1305,1380,810,494,0,494,0,206,0,0.070850202,empty,mBC-0716-2
"C3,H9",14208,14389,10730,3659,6931,0,3139,3149,2224,925,2.404324324,1485,1894,945,570,0,570,0,231,0,0.070175439,empty,mBC-0716-2
"C3,H10",13692,13994,10334,3660,6775,4,3129,3133,2209,924,2.390692641,1463,1146,724,439,0,439,0,184,0,0.034168565,empty,mBC-0716-2
"C3,H11",733848,823007,519147,303860,400109,4,226159,226503,182259,44244,4.119406021,127629,5458,2763,1552,0,1552,0,407,0,0.010953608,mm10,mBC-0716-2
"C3,H12",5370,5567,4075,1492,2656,0,1234,1235,815,420,1.94047619,613,494,275,170,0,170,0,69,0,0.123529412,empty,mBC-0716-2
"C4,A1",556903,586715,400079,186636,293270,0,156597,156877,125350,31527,3.975957116,82386,17690,10765,6158,3,6155,1,1258,0,0.008123477,mm10,mBC-0716-2
"C4,A2",16774,17580,12884,4696,8555,1,3913,3927,2781,1146,2.426701571,1940,989,626,376,0,376,0,162,0,0.031914894,empty,mBC-0716-2
"C4,A3",14912,15530,11305,4225,7626,27,3556,3589,2577,1012,2.546442688,1772,827,494,310,0,310,0,119,0,0.04516129,empty,mBC-0716-2
"C4,A4",19957,20642,15303,5339,9886,10,4410,4433,3092,1341,2.305741984,2141,493,279,183,0,183,0,89,0,0,empty,mBC-0716-2
"C4,A5",15797,16155,12201,3954,7841,1,3604,3610,2553,1057,2.415326395,1624,1325,818,502,0,502,0,216,0,0.033864542,empty,mBC-0716-2
"C4,A6",14117,14934,10557,4377,7294,46,3485,3535,2438,1097,2.222424795,1783,9048,2882,1747,4,1743,1,480,0,0.122203098,empty,mBC-0716-2
"C4,A7",17296,17497,13170,4327,8500,8,3859,3876,2830,1046,2.705544933,1787,8176,3057,1807,2,1805,2,522,0,0.120221607,empty,mBC-0716-2
"C4,A8",9547,10022,7145,2877,4925,3,2329,2339,1655,684,2.419590643,1153,2525,1146,701,2,699,1,246,0,0.097281831,empty,mBC-0716-2
"C4,A9",1394564,1450486,1054388,396098,689674,1,338908,339522,273023,66499,4.105670762,168393,33598,17653,10088,6,10082,2,1906,0,0.008232494,mm10,mBC-0716-2
"C4,A10",15157,15615,11509,4106,7510,0,3403,3407,2404,1003,2.396809571,1592,415,264,147,0,147,0,80,0,0,empty,mBC-0716-2
"C4,A11",616895,619811,458831,160980,302340,0,142042,142311,114012,28299,4.028834941,69407,5217,3323,1840,0,1840,0,558,0,0.00923913,mm10,mBC-0716-2
"C4,A12",18815,19396,14354,5042,9384,1,4210,4226,2942,1284,2.291277259,1980,2354,1435,803,0,803,0,254,0,0.107098381,empty,mBC-0716-2
"C4,B1",629198,636175,491009,145166,308451,1,129630,129892,103877,26015,3.992965597,60130,18733,10996,6383,5,6378,1,1261,0,0.001254312,mm10,mBC-0716-2
"C4,B2",18181,18534,13773,4761,8917,9,4056,4071,2823,1248,2.262019231,1945,461,263,177,0,177,0,78,0,0.005649718,empty,mBC-0716-2
"C4,B3",16560,16900,12828,4072,8386,15,3794,3814,2693,1121,2.402319358,1750,1028,642,384,0,384,0,157,0,0.049479167,empty,mBC-0716-2
"C4,B4",14934,15544,11429,4115,7597,6,3500,3515,2431,1084,2.242619926,1738,1036,574,345,0,345,0,135,0,0.020289855,empty,mBC-0716-2
"C4,B5",10860,7654,5140,2514,4571,13,2354,2386,1758,628,2.799363057,1309,753,420,255,0,255,0,110,0,0.011764706,empty,mBC-0716-2
"C4,B6",11528,12102,8751,3351,5940,0,2815,2817,1930,887,2.175873732,1414,963,551,355,1,354,1,164,0,0.039548023,empty,mBC-0716-2
"C4,B7",15042,15824,11438,4386,7644,29,3407,3440,2362,1078,2.19109462,1702,895,563,331,0,331,0,152,0,0.024169184,empty,mBC-0716-2
"C4,B8",438637,455849,329689,126160,225686,17,109110,109311,81200,28111,2.888548967,54970,9013,5097,2860,0,2860,0,745,0,0.002097902,mm10,mBC-0716-2
"C4,B9",13805,14108,10512,3596,6743,12,3071,3085,2119,966,2.193581781,1434,830,508,286,1,285,1,113,0,0.038596491,empty,mBC-0716-2
"C4,B10",15241,15529,11483,4046,7696,28,3503,3537,2403,1134,2.119047619,1721,542,349,199,0,199,0,78,0,0.070351759,empty,mBC-0716-2
"C4,B11",16755,17555,12705,4850,8398,0,3898,3912,2746,1166,2.355060034,1920,191,116,74,0,74,0,43,0,0.040540541,empty,mBC-0716-2
"C4,B12",16382,16850,12509,4341,8157,13,3707,3723,2626,1097,2.393801276,1729,1283,745,440,0,440,0,171,0,0.025,empty,mBC-0716-2
"C4,C1",1342421,1442381,959219,483162,671767,24,374993,375627,308166,67461,4.568061547,199424,33053,21250,12088,1,12087,1,1753,0,0.005212211,mm10,mBC-0716-2
"C4,C2",16548,16937,12701,4236,8104,0,3645,3650,2518,1132,2.224381625,1700,2193,1117,683,0,683,0,221,0,0.067349927,empty,mBC-0716-2
"C4,C3",18605,19215,14032,5183,9313,3,4350,4374,3039,1335,2.276404494,2095,436,250,145,0,145,0,70,0,0.089655172,empty,mBC-0716-2
"C4,C4",15798,16052,12114,3938,7753,1,3404,3419,2436,983,2.478128179,1475,1076,663,370,1,369,1,141,0,0.010840108,empty,mBC-0716-2
"C4,C5",16527,17325,12335,4990,8352,49,3918,3972,2863,1109,2.58160505,2030,1169,641,421,0,421,0,175,0,0.026128266,empty,mBC-0716-2
"C4,C6",16267,16836,12246,4590,8546,7,4129,4142,2964,1178,2.516129032,2040,1149,680,415,0,415,0,182,0,0.036144578,empty,mBC-0716-2
"C4,C7",803477,856738,598887,257851,412193,1,200725,201074,170050,31024,5.48124033,103859,37754,24115,13238,8,13230,1,1887,0,0.002569917,mm10,mBC-0716-2
"C4,C8",13450,13832,10249,3583,6770,0,3160,3173,2209,964,2.291493776,1502,1441,844,528,0,528,0,200,0,0.051136364,empty,mBC-0716-2
"C4,C9",11653,12157,8824,3333,5977,25,2829,2863,1954,909,2.149614961,1430,854,541,335,0,335,0,127,0,0.032835821,empty,mBC-0716-2
"C4,C10",12660,12887,9580,3307,6367,23,2939,2971,2005,966,2.075569358,1390,5319,1711,1038,2,1036,2,353,0,0.053088803,empty,mBC-0716-2
"C4,C11",10860,11461,8205,3256,5552,0,2629,2638,1789,849,2.107184923,1334,907,502,303,1,302,1,138,0,0.039735099,empty,mBC-0716-2
"C4,C12",1337075,1454635,986995,467640,690860,2,367046,367632,281440,86192,3.265268238,195370,84238,54817,30171,13,30158,1,3201,0,0.001061078,mm10,mBC-0716-2
"C4,D1",10320,10796,7663,3133,5400,29,2547,2589,1843,746,2.470509383,1319,484,275,153,1,152,1,69,0,0.019736842,empty,mBC-0716-2
"C4,D2",19155,19441,14766,4675,9601,6,4122,4133,2924,1209,2.418527709,1947,2186,1293,751,0,751,0,299,0,0.037283622,empty,mBC-0716-2
"C4,D3",12522,12960,9465,3495,6458,1,3007,3019,2083,936,2.22542735,1486,999,612,384,0,384,0,187,0,0.033854167,empty,mBC-0716-2
"C4,D4",12775,13080,9690,3390,6602,0,3051,3057,2132,925,2.304864865,1492,1073,623,407,0,407,0,206,0,0.061425061,empty,mBC-0716-2
"C4,D5",12909,13194,9842,3352,6408,30,2944,2981,2120,861,2.462253194,1364,791,404,252,0,252,0,113,0,0.03968254,empty,mBC-0716-2
"C4,D6",568012,591171,410704,180467,290855,8,151655,151901,117769,34132,3.450398453,79036,10413,5217,2979,0,2979,0,788,0,0.013763008,mm10,mBC-0716-2
"C4,D7",11771,12084,8933,3151,5897,14,2644,2667,1807,860,2.101162791,1330,3317,1268,789,2,787,1,250,0,0.043202033,empty,mBC-0716-2
"C4,D8",13840,14293,10599,3694,7107,0,3337,3346,2306,1040,2.217307692,1589,977,647,407,0,407,0,156,0,0.039312039,empty,mBC-0716-2
"C4,D9",4963,4983,3679,1304,2543,7,1143,1154,840,314,2.675159236,580,1466,824,532,0,532,0,225,0,0.030075188,empty,mBC-0716-2
"C4,D10",613711,696426,434965,261461,341900,4,197420,197757,149162,48595,3.069492746,111531,54930,32193,17854,8,17846,1,2418,0,0.005155217,mm10,mBC-0716-2
"C4,D11",1075735,1223499,722600,500899,583215,6,368076,368619,277453,91166,3.043382401,211490,31839,18942,10496,5,10491,1,1830,0,0.002764274,mm10,mBC-0716-2
"C4,D12",18361,18737,13832,4905,9182,6,4183,4199,2907,1292,2.25,1959,2327,1354,799,0,799,0,262,0,0.060075094,empty,mBC-0716-2
"C4,E1",20087,20601,15193,5408,9953,0,4567,4587,3287,1300,2.528461538,2162,1474,937,517,0,517,0,228,0,0.040618956,empty,mBC-0716-2
"C4,E2",14606,14788,11077,3711,7292,6,3269,3289,2307,982,2.349287169,1583,1361,792,471,0,471,0,188,0,0.04670913,empty,mBC-0716-2
"C4,E3",11231,11597,8593,3004,5706,31,2522,2561,1741,820,2.123170732,1221,1459,876,556,0,556,0,209,0,0.073741007,empty,mBC-0716-2
"C4,E4",14227,14518,10760,3758,6908,24,3185,3223,2312,911,2.537870472,1545,1202,645,393,0,393,0,164,0,0.050890585,empty,mBC-0716-2
"C4,E5",1016630,1093258,750706,342552,521183,0,275076,275489,226576,48913,4.632224562,142788,54615,35373,20004,11,19993,2,2510,0,0.00140049,mm10,mBC-0716-2
"C4,E6",13302,13765,10122,3643,6697,21,3034,3057,2117,940,2.25212766,1478,1380,868,521,1,520,1,220,0,0.015384615,empty,mBC-0716-2
"C4,E7",12354,12541,9283,3258,6208,16,2802,2821,1934,887,2.180383315,1397,1653,791,481,0,481,0,188,0,0,empty,mBC-0716-2
"C4,E8",16287,16718,12429,4289,8219,37,3689,3743,2644,1099,2.405823476,1783,3696,1427,919,2,917,1,316,0,0.080697928,empty,mBC-0716-2
"C4,E9",8613,8929,6434,2495,4274,5,1983,1995,1384,611,2.265139116,988,5730,1983,1185,0,1185,0,351,0,0.029535865,empty,mBC-0716-2
"C4,E10",11936,12371,9104,3267,5922,8,2704,2717,1904,813,2.341943419,1267,1366,816,505,0,505,0,209,0,0.04950495,empty,mBC-0716-2
"C4,E11",8535,8787,6582,2205,4352,0,1988,1994,1401,593,2.362563238,886,1210,693,416,0,416,0,163,0,0.079326923,empty,mBC-0716-2
"C4,E12",1260401,1481301,819355,661946,729195,0,497342,497918,332287,165631,2.006188455,298856,19229,11496,6275,2,6273,1,1319,0,0.005738881,mm10,mBC-0716-2
"C4,F1",16332,16762,12305,4457,8121,0,3685,3694,2610,1084,2.407749077,1764,2127,1056,632,0,632,0,249,0,0.083860759,empty,mBC-0716-2
"C4,F2",20624,21730,15626,6104,10827,0,5197,5214,3671,1543,2.379131562,2599,2463,1419,823,0,823,0,316,0,0.024301337,empty,mBC-0716-2
"C4,F3",15390,15752,11416,4336,7676,0,3695,3704,2608,1096,2.379562044,1822,15061,4403,2805,0,2805,0,700,0,0.136541889,empty,mBC-0716-2
"C4,F4",14313,14394,10776,3618,7172,0,3207,3215,2288,927,2.468176915,1463,604,350,210,0,210,0,83,0,0,empty,mBC-0716-2
"C4,F5",22191,22778,16971,5807,11086,1,5015,5021,3456,1565,2.208306709,2333,3584,1404,857,1,856,1,325,0,0.010514019,empty,mBC-0716-2
"C4,F6",21011,21728,15851,5877,10379,21,4746,4775,3428,1347,2.544914625,2327,1817,1000,602,0,602,0,232,0,0.07807309,empty,mBC-0716-2
"C4,F7",19200,19856,14642,5214,9517,27,4306,4340,3100,1240,2.5,2096,1096,603,402,0,402,0,158,0,0.109452736,empty,mBC-0716-2
"C4,F8",20357,21155,15266,5889,10211,26,4706,4738,3322,1416,2.346045198,2329,302,157,103,0,103,0,59,0,0,empty,mBC-0716-2
"C4,F9",13134,13526,9928,3598,6646,5,2997,3004,2119,885,2.394350282,1457,1601,934,554,0,554,0,190,0,0.045126354,empty,mBC-0716-2
"C4,F10",19068,19400,14430,4970,9398,14,4183,4213,3000,1213,2.473206925,1949,3098,1440,854,2,852,1,277,0,0.194835681,empty,mBC-0716-2
"C4,F11",10009,10572,7596,2976,5152,7,2285,2301,1597,704,2.268465909,1168,1224,692,431,0,431,0,184,0,0.044083527,empty,mBC-0716-2
"C4,F12",12919,13519,9860,3659,6481,0,2998,3009,2107,902,2.335920177,1483,168,104,60,0,60,0,35,0,0,empty,mBC-0716-2
"C4,G1",9597,9749,7319,2430,4783,47,2021,2074,1429,645,2.215503876,941,10021,3108,1906,3,1903,3,492,0,0.090383605,empty,mBC-0716-2
"C4,G2",704191,724947,542411,182536,351615,18,155839,156153,112751,43402,2.597829593,75219,14541,9284,5222,4,5218,1,1055,0,0.002491376,mm10,mBC-0716-2
"C4,G3",539161,559719,411142,148577,274136,1,126045,126259,88913,37346,2.380790446,63578,12652,7509,4287,0,4287,0,975,0,0.015162118,mm10,mBC-0716-2
"C4,G4",26623,26961,20287,6674,12888,1,5712,5722,4031,1691,2.38379657,2692,239,119,74,0,74,0,45,0,0,empty,mBC-0716-2
"C4,G5",13038,13316,9821,3495,6537,0,3022,3040,2139,901,2.374028857,1484,1015,605,387,0,387,0,180,0,0.033591731,empty,mBC-0716-2
"C4,G6",22224,22705,17028,5677,11013,1,4909,4925,3472,1453,2.389538885,2256,198,144,89,0,89,0,37,0,0,empty,mBC-0716-2
"C4,G7",18166,19061,14081,4980,9188,9,4079,4097,3006,1091,2.755270394,1943,1618,952,540,0,540,0,210,0,0.035185185,empty,mBC-0716-2
"C4,G8",13503,13956,10221,3735,6816,0,3190,3199,2241,958,2.339248434,1530,1256,738,465,0,465,0,217,0,0.006451613,empty,mBC-0716-2
"C4,G9",735098,775566,552621,222945,373115,1,183432,183746,146953,36793,3.994047781,92570,60748,39063,21917,10,21907,2,2772,0,0.003332268,mm10,mBC-0716-2
"C4,G10",12875,13118,9861,3257,6347,2,2865,2871,2027,844,2.401658768,1280,1531,903,576,0,576,0,234,0,0.055555556,empty,mBC-0716-2
"C4,G11",11542,11826,8938,2888,5741,12,2641,2664,1824,840,2.171428571,1226,846,492,298,0,298,0,123,0,0.124161074,empty,mBC-0716-2
"C4,G12",10174,10546,7734,2812,5255,1,2412,2421,1691,730,2.316438356,1159,1209,721,405,0,405,0,165,0,0.049382716,empty,mBC-0716-2
"C4,H1",18718,19141,14407,4734,9327,1,4201,4211,2966,1245,2.382329317,1969,829,470,280,0,280,0,134,0,0.007142857,empty,mBC-0716-2
"C4,H2",3451989,3806804,2426586,1380218,1737201,10,1034937,1036414,847071,189343,4.473738137,573709,310503,201531,111324,47,111277,4,5799,0,0.00110535,mm10,mBC-0716-2
"C4,H3",18484,19051,14160,4891,9156,0,4239,4244,2953,1291,2.287374129,1994,1270,774,487,0,487,0,214,0,0.032854209,empty,mBC-0716-2
"C4,H4",741750,779910,539974,239936,374015,1,191504,191776,156309,35467,4.407167226,98671,4608,3050,1748,1,1747,1,424,0,0.00057241,mm10,mBC-0716-2
"C4,H5",17452,17905,13130,4775,8573,26,3908,3944,2859,1085,2.635023041,1898,6065,1814,1095,0,1095,0,354,0,0.065753425,empty,mBC-0716-2
"C4,H6",555091,592293,403763,188530,290922,0,147814,148030,127712,20318,6.285658037,78035,139875,91423,51106,28,51078,2,4022,0,0.000685227,mm10,mBC-0716-2
"C4,H7",15765,15846,11957,3889,7830,1,3579,3587,2526,1061,2.380772856,1613,1215,740,485,1,484,1,184,0,0.068181818,empty,mBC-0716-2
"C4,H8",12517,13372,9332,4040,6346,0,3027,3033,2116,917,2.307524537,1519,1309,776,475,0,475,0,202,0,0.008421053,empty,mBC-0716-2
"C4,H9",18128,18882,13526,5356,9326,1,4490,4504,3419,1085,3.151152074,2224,1337,802,500,0,500,0,215,0,0.036,empty,mBC-0716-2
"C4,H10",13141,13364,9887,3477,6590,0,3010,3018,2109,909,2.320132013,1440,2163,1039,670,0,670,0,275,0,0.014925373,empty,mBC-0716-2
"C4,H11",15601,16492,11746,4746,7843,0,3741,3754,2616,1138,2.298769772,1859,143,95,66,0,66,0,48,0,0.075757576,empty,mBC-0716-2
"C4,H12",534862,595134,367258,227876,295611,10,178463,178720,141834,36886,3.84519872,100935,20444,10422,6042,6,6036,3,1267,0,0.030318091,mm10,mBC-0716-2
"C5,A1",13502,13805,10186,3619,6932,10,3221,3241,2285,956,2.390167364,1600,1152,685,438,0,438,0,184,0,0.047945205,empty,mBC-0716-2
"C5,A2",18071,18693,13674,5019,9043,33,4126,4177,2922,1255,2.328286853,2065,1139,624,359,0,359,0,143,0,0.072423398,empty,mBC-0716-2
"C5,A3",15948,16360,12189,4171,8039,6,3618,3632,2622,1010,2.596039604,1697,955,569,309,1,308,1,143,0,0.00974026,empty,mBC-0716-2
"C5,A4",21845,22097,16925,5172,10756,0,4691,4701,3368,1333,2.526631658,2152,573,332,209,0,209,0,108,0,0.019138756,empty,mBC-0716-2
"C5,A5",17713,18218,13487,4731,8922,5,4099,4112,2888,1224,2.359477124,1890,4587,1786,1077,1,1076,1,362,0,0.038104089,empty,mBC-0716-2
"C5,A6",632594,685131,465182,219949,331702,1,173929,174206,143004,31202,4.583167746,91446,72981,47555,26598,14,26584,2,3023,0,0.00210653,mm10,mBC-0716-2
"C5,A7",16465,17292,12528,4764,8377,0,3923,3932,2666,1266,2.105845182,1962,1207,725,454,0,454,0,206,0,0.039647577,empty,mBC-0716-2
"C5,A8",10954,11465,8370,3095,5643,0,2549,2555,1807,748,2.415775401,1283,1351,826,484,0,484,0,213,0,0.066115702,empty,mBC-0716-2
"C5,A9",2087817,2166151,1523493,642658,1002730,1,518676,519511,442104,77407,5.711421448,262836,220474,142073,77440,35,77405,3,5287,0,0.000904334,mm10,mBC-0716-2
"C5,A10",15786,16145,12091,4054,7758,0,3559,3565,2457,1108,2.217509025,1644,354,231,136,0,136,0,76,0,0.022058824,empty,mBC-0716-2
"C5,A11",18103,18353,13837,4516,8948,3,3924,3933,2798,1135,2.465198238,1808,931,483,319,0,319,0,153,0,0.047021944,empty,mBC-0716-2
"C5,A12",21188,21722,16253,5469,10249,11,4556,4590,3226,1364,2.365102639,2160,2386,1488,860,0,860,0,277,0,0.063953488,empty,mBC-0716-2
"C5,B1",19732,20233,15235,4998,9788,0,4469,4476,3195,1281,2.494145199,2084,972,570,370,0,370,0,170,0,0.083783784,empty,mBC-0716-2
"C5,B2",20635,21382,15799,5583,10223,0,4638,4654,3292,1362,2.417033774,2209,496,298,180,0,180,0,77,0,0.016666667,empty,mBC-0716-2
"C5,B3",19011,20049,14489,5560,9678,11,4448,4469,3130,1339,2.337565347,2165,1121,694,386,0,386,0,174,0,0.049222798,empty,mBC-0716-2
"C5,B4",1148948,1293959,796555,497404,615474,20,368019,368537,260229,108308,2.402675703,210633,51976,34342,19313,11,19302,2,2445,0,0.001295203,mm10,mBC-0716-2
"C5,B5",9574,5662,3930,1732,3531,0,1691,1702,1178,524,2.248091603,938,10019,3132,1891,1,1890,1,535,0,0.030687831,empty,mBC-0716-2
"C5,B6",12324,13196,9342,3854,6402,0,3105,3112,2163,949,2.279241307,1559,1084,664,401,0,401,0,174,0,0.044887781,empty,mBC-0716-2
"C5,B7",16861,17184,12896,4288,8392,25,3723,3758,2642,1116,2.367383513,1824,1151,666,391,0,391,0,157,0,0.097186701,empty,mBC-0716-2
"C5,B8",13593,14028,10432,3596,6868,0,3062,3065,2158,907,2.379272326,1446,1592,846,533,0,533,0,240,0,0.063789869,empty,mBC-0716-2
"C5,B9",15418,15953,11553,4400,7637,0,3501,3515,2380,1135,2.0969163,1802,658,406,244,0,244,0,115,0,0.040983607,empty,mBC-0716-2
"C5,B10",15900,16064,11712,4352,8098,0,3733,3752,2583,1169,2.209580838,1807,635,368,212,0,212,0,85,0,0.033018868,empty,mBC-0716-2
"C5,B11",16311,16862,12335,4527,8042,1,3783,3792,2624,1168,2.246575342,1792,222,138,92,0,92,0,60,0,0,empty,mBC-0716-2
"C5,B12",18942,19723,14600,5123,9505,0,4362,4371,3065,1306,2.346860643,2130,1186,701,398,0,398,0,172,0,0.002512563,empty,mBC-0716-2
"C5,C1",23292,23776,17940,5836,11198,6,4849,4869,3427,1442,2.376560333,2273,687,389,241,0,241,0,113,0,0.020746888,empty,mBC-0716-2
"C5,C2",18045,18350,13746,4604,8843,0,3997,4007,2807,1200,2.339166667,1884,1504,863,500,0,500,0,193,0,0.042,empty,mBC-0716-2
"C5,C3",20801,21592,15602,5990,10306,10,4902,4922,3379,1543,2.189889825,2416,3844,1321,771,0,771,0,273,0,0.047989624,empty,mBC-0716-2
"C5,C4",17162,17545,13251,4294,8556,1,3778,3788,2628,1160,2.265517241,1782,1111,701,429,0,429,0,154,0,0.081585082,empty,mBC-0716-2
"C5,C5",19575,20702,14817,5885,9985,18,4860,4883,3516,1367,2.572055596,2437,1132,718,455,0,455,0,194,0,0.063736264,empty,mBC-0716-2
"C5,C6",17581,17927,13179,4748,8821,1,4047,4052,2781,1271,2.188040913,1969,4799,2037,1289,0,1289,0,404,0,0.134988363,empty,mBC-0716-2
"C5,C7",16329,16731,12381,4350,8034,3,3702,3715,2602,1113,2.337825696,1763,968,408,260,0,260,0,118,0,0.069230769,empty,mBC-0716-2
"C5,C8",15162,15868,11559,4309,7657,17,3531,3548,2441,1107,2.205058717,1724,1309,732,489,0,489,0,209,0,0.09202454,empty,mBC-0716-2
"C5,C9",12718,13616,9604,4012,6593,22,3169,3204,2259,945,2.39047619,1636,894,538,357,0,357,0,150,0,0.025210084,empty,mBC-0716-2
"C5,C10",13750,14119,10539,3580,6826,0,3111,3115,2236,879,2.543799772,1439,1047,600,372,1,371,1,156,0,0.086253369,empty,mBC-0716-2
"C5,C11",731279,797097,544420,252677,386326,0,199886,200205,158273,41932,3.774515883,105867,56391,36705,20519,11,20508,2,2494,0,0.002389311,mm10,mBC-0716-2
"C5,C12",751323,814400,540723,273677,390890,1,209320,209671,176420,33251,5.305705092,113635,54754,34147,18688,12,18676,2,2395,0,0.002463054,mm10,mBC-0716-2
"C5,D1",10669,11050,8007,3043,5585,0,2643,2648,1846,802,2.301745636,1261,550,320,192,0,192,0,88,0,0.036458333,empty,mBC-0716-2
"C5,D2",21689,22037,16801,5236,10633,0,4652,4659,3260,1399,2.330235883,2097,2263,1400,862,0,862,0,308,0,0.071925754,empty,mBC-0716-2
"C5,D3",13397,13838,10049,3789,6877,0,3259,3270,2251,1019,2.209028459,1636,978,585,383,0,383,0,178,0,0.049608355,empty,mBC-0716-2
"C5,D4",634301,674533,461930,212603,330643,1,175286,175544,127653,47891,2.665490384,92575,10295,6519,3734,1,3733,1,888,0,0.005625502,mm10,mBC-0716-2
"C5,D5",585503,600065,446775,153290,292819,2,132652,132905,78113,54792,1.425627829,66144,9147,5414,3177,2,3175,2,783,0,0.009133858,mm10,mBC-0716-2
"C5,D6",1010282,1158731,674376,484355,550482,2,345595,346076,258197,87879,2.938096701,200161,108253,71892,39863,15,39848,1,3645,0,0.000803052,mm10,mBC-0716-2
"C5,D7",12509,13279,9429,3850,6433,1,3089,3096,2115,981,2.155963303,1569,1278,822,461,1,460,1,175,0,0.030434783,empty,mBC-0716-2
"C5,D8",16504,17542,12347,5195,8536,3,4094,4114,2796,1318,2.121396055,2047,979,636,413,0,413,0,151,0,0.041162228,empty,mBC-0716-2
"C5,D9",4367,4378,3274,1104,2275,0,1057,1057,741,316,2.344936709,498,1499,809,497,0,497,0,255,0,0.036217304,empty,mBC-0716-2
"C5,D10",16418,16995,12411,4584,8162,48,3838,3895,2719,1176,2.31207483,1864,2583,958,565,1,564,1,192,0,0.021276596,empty,mBC-0716-2
"C5,D11",14390,14848,10794,4054,7272,0,3408,3424,2359,1065,2.215023474,1707,1672,1052,629,0,629,0,240,0,0.049284579,empty,mBC-0716-2
"C5,D12",20162,21037,15245,5792,10081,0,4686,4694,3235,1459,2.217272104,2290,2242,1253,712,0,712,0,262,0,0.040730337,empty,mBC-0716-2
"C5,E1",22701,22982,17499,5483,10982,7,4876,4893,3500,1393,2.512562814,2250,1538,930,541,0,541,0,230,0,0.096118299,empty,mBC-0716-2
"C5,E2",15890,16404,11982,4422,8039,0,3694,3705,2697,1008,2.675595238,1821,1458,764,451,0,451,0,181,0,0.090909091,empty,mBC-0716-2
"C5,E3",12546,13002,9618,3384,6315,0,2843,2848,1950,898,2.171492205,1331,7331,2555,1504,1,1503,1,477,0,0.051896208,empty,mBC-0716-2
"C5,E4",16029,16606,12265,4341,8080,1,3828,3837,2596,1241,2.091861402,1852,4586,1673,983,3,980,1,347,0,0.024489796,empty,mBC-0716-2
"C5,E5",21169,21533,16308,5225,10475,16,4681,4705,3390,1315,2.577946768,2213,1893,924,584,0,584,0,218,0,0.037671233,empty,mBC-0716-2
"C5,E6",13048,13120,9935,3185,6475,0,2855,2862,1981,881,2.248581158,1327,2021,900,556,3,553,1,230,0,0.04159132,empty,mBC-0716-2
"C5,E7",15083,15276,11376,3900,7528,1,3495,3502,2467,1035,2.383574879,1713,1228,740,412,0,412,0,167,0,0.036407767,empty,mBC-0716-2
"C5,E8",18281,18614,13885,4729,8999,0,4017,4027,2817,1210,2.328099174,1937,1612,954,573,1,572,1,216,0,0.033216783,empty,mBC-0716-2
"C5,E9",8860,9035,6670,2365,4358,7,2009,2024,1394,630,2.212698413,977,1049,599,380,0,380,0,149,0,0.031578947,empty,mBC-0716-2
"C5,E10",13647,13886,10559,3327,6768,0,3082,3083,2138,945,2.262433862,1364,1320,851,513,0,513,0,189,0,0.015594542,empty,mBC-0716-2
"C5,E11",9011,9247,6817,2430,4589,0,2122,2125,1473,652,2.259202454,1024,1142,699,401,0,401,0,181,0,0.029925187,empty,mBC-0716-2
"C5,E12",454853,470597,330386,140211,234217,58,120393,120689,96279,24410,3.944244162,62000,6903,3716,2120,0,2120,0,616,0,0.014622642,mm10,mBC-0716-2
"C5,F1",822592,906586,599862,306724,435648,21,237051,237456,177838,59618,2.982958167,128863,60345,38594,21501,9,21492,1,2604,0,0.002605621,mm10,mBC-0716-2
"C5,F2",22312,23260,16889,6371,11456,6,5302,5321,3700,1621,2.282541641,2673,2631,1557,967,1,966,1,375,0,0.022774327,empty,mBC-0716-2
"C5,F3",15862,16363,11931,4432,8129,32,3798,3840,2634,1206,2.184079602,1911,1947,1113,687,1,686,1,298,0,0.024781341,empty,mBC-0716-2
"C5,F4",15366,15649,11719,3930,7799,0,3533,3535,2485,1050,2.366666667,1653,447,313,180,0,180,0,84,0,0.005555556,empty,mBC-0716-2
"C5,F5",25166,25647,18912,6735,12402,0,5717,5722,4073,1649,2.469981807,2735,1770,1062,658,0,658,0,305,0,0.048632219,empty,mBC-0716-2
"C5,F6",27210,27906,20470,7436,13448,0,6305,6309,4577,1732,2.6426097,3074,2656,1717,1002,0,1002,0,321,0,0.02994012,empty,mBC-0716-2
"C5,F7",1444609,1496253,1098662,397591,715552,3,345737,346324,271959,74365,3.657083305,170392,37907,24514,13759,5,13754,1,2061,0,0.005380253,mm10,mBC-0716-2
"C5,F8",497289,507364,378754,128610,251570,1,114299,114518,86534,27984,3.09226701,55669,1497,920,524,0,524,0,180,0,0.001908397,empty,mBC-0716-2
"C5,F9",15042,15083,11600,3483,7333,8,3229,3250,2226,1024,2.173828125,1450,1389,797,502,0,502,0,183,0,0.045816733,empty,mBC-0716-2
"C5,F10",22405,23027,16977,6050,11011,12,4959,4985,3550,1435,2.473867596,2435,1777,951,569,0,569,0,207,0,0.082601054,empty,mBC-0716-2
"C5,F11",1642586,1748564,1219083,529481,827483,14,426075,426747,320828,105919,3.028993854,221297,157554,98003,55227,21,55206,1,4440,0,0.000941927,mm10,mBC-0716-2
"C5,F12",14801,15243,11259,3984,7307,12,3301,3321,2350,971,2.420185376,1599,137,69,52,0,52,0,44,0,0,empty,mBC-0716-2
"C5,G1",496269,544159,360606,183553,267991,30,147191,147461,109557,37904,2.890380962,79259,33996,21398,11928,4,11924,1,1762,0,0.004193224,mm10,mBC-0716-2
"C5,G2",1933534,2205206,1294014,911192,1051643,2,673765,674557,509726,164831,3.092415868,393139,41873,27325,15162,6,15156,1,2121,0,0,mm10,mBC-0716-2
"C5,G3",20231,21120,15296,5824,10196,23,4694,4725,3224,1501,2.147901399,2313,1962,1160,685,0,685,0,259,0,0.090510949,empty,mBC-0716-2
"C5,G4",831942,850070,652868,197202,407227,0,171024,171366,121847,49519,2.460611079,80537,614,351,199,0,199,0,86,0,0.010050251,empty,mBC-0716-2
"C5,G5",13622,14163,10189,3974,6927,16,3169,3197,2249,948,2.372362869,1622,1311,791,514,0,514,0,206,0,0.046692607,empty,mBC-0716-2
"C5,G6",24810,25281,18831,6450,11948,0,5284,5307,3810,1497,2.54509018,2453,202,132,93,0,93,0,59,0,0,empty,mBC-0716-2
"C5,G7",20962,21396,16218,5178,10364,1,4529,4543,3215,1328,2.420933735,2092,1644,958,586,0,586,0,241,0,0.056313993,empty,mBC-0716-2
"C5,G8",846613,924297,615337,308960,442918,2,238446,238791,170571,68220,2.500307828,128809,64573,42732,23809,7,23802,1,2678,0,0.001470465,mm10,mBC-0716-2
"C5,G9",11046,11304,8425,2879,5538,46,2554,2609,1809,800,2.26125,1253,1119,716,449,0,449,0,198,0,0.042316258,empty,mBC-0716-2
"C5,G10",14037,14328,10649,3679,7007,16,3157,3177,2169,1008,2.151785714,1502,1415,844,470,0,470,0,226,0,0.025531915,empty,mBC-0716-2
"C5,G11",12362,12527,9502,3025,6075,19,2728,2753,1908,845,2.257988166,1291,783,479,285,0,285,0,116,0,0.042105263,empty,mBC-0716-2
"C5,G12",11415,11857,8542,3315,5929,5,2765,2773,1892,881,2.147559591,1417,905,553,347,0,347,0,139,0,0.034582133,empty,mBC-0716-2
"C5,H1",1056240,1119364,787017,332347,525979,18,260191,260688,224387,36301,6.181289772,133539,54247,34595,19069,15,19054,2,2316,0,0.002729086,mm10,mBC-0716-2
"C5,H2",842609,860787,631905,228882,414940,12,199682,200051,160153,39898,4.014060855,98245,14983,9695,5370,2,5368,1,1140,0,0.001304024,mm10,mBC-0716-2
"C5,H3",20683,21225,15536,5689,10231,0,4730,4741,3361,1380,2.435507246,2329,2424,1119,677,1,676,1,277,0,0.026627219,empty,mBC-0716-2
"C5,H4",13703,14299,10361,3938,7106,0,3311,3318,2305,1013,2.275419546,1657,228,147,88,0,88,0,66,0,0.011363636,empty,mBC-0716-2
"C5,H5",17905,18674,13380,5294,9033,0,4228,4236,3019,1217,2.480690222,2142,1403,817,478,1,477,1,198,0,0.002096436,empty,mBC-0716-2
"C5,H6",13940,14568,10594,3974,7044,0,3378,3380,2348,1032,2.275193798,1644,1535,957,573,0,573,0,210,0,0.045375218,empty,mBC-0716-2
"C5,H7",16976,17518,12718,4800,8603,0,3986,3999,2748,1251,2.196642686,2038,2720,1216,780,0,780,0,286,0,0.051282051,empty,mBC-0716-2
"C5,H8",13561,13818,10250,3568,6618,12,3052,3066,2142,924,2.318181818,1483,1625,864,549,0,549,0,242,0,0.041894353,empty,mBC-0716-2
"C5,H9",16597,17128,12628,4500,8204,0,3719,3732,2567,1165,2.203433476,1822,1285,739,433,0,433,0,212,0,0.027713626,empty,mBC-0716-2
"C5,H10",15306,15425,11044,4381,7407,19,3429,3456,2450,1006,2.435387674,1720,17666,5611,3464,1,3463,1,799,0,0.24545192,empty,mBC-0716-2
"C5,H11",690131,772496,485209,287287,378931,0,221449,221780,146256,75524,1.936549971,126125,708,473,274,0,274,0,109,0,0,empty,mBC-0716-2
"C5,H12",596744,665755,417241,248514,326892,10,190242,190514,151236,39278,3.850399715,107059,52103,34684,19639,11,19628,1,2360,0,0.001834115,mm10,mBC-0716-2
"C6,A1",14959,15343,11313,4030,7697,3,3715,3719,2636,1083,2.433979686,1784,1275,789,459,0,459,0,180,0,0.05664488,empty,mBC-0716-2
"C6,A2",19918,20112,15095,5017,9701,0,4348,4355,3107,1248,2.489583333,2060,3284,1388,882,2,880,1,272,0,0.172727273,empty,mBC-0716-2
"C6,A3",16856,17380,12609,4771,8416,6,3871,3889,2688,1201,2.238134888,1871,1012,583,357,0,357,0,157,0,0.042016807,empty,mBC-0716-2
"C6,A4",21993,22372,17071,5301,10791,0,4647,4656,3257,1399,2.328091494,2130,658,406,261,0,261,0,118,0,0.091954023,empty,mBC-0716-2
"C6,A5",18168,18784,13763,5021,9174,13,4272,4300,2996,1304,2.297546012,2070,1560,922,522,1,521,1,217,0,0.024952015,empty,mBC-0716-2
"C6,A6",20407,22198,14972,7226,11079,14,5685,5707,3952,1755,2.251851852,3107,1410,820,484,0,484,0,233,0,0.045454545,empty,mBC-0716-2
"C6,A7",843416,967452,574021,393431,473797,8,295769,296171,236637,59534,3.974821111,170810,106989,63878,35669,13,35656,1,3429,0,0.007347992,mm10,mBC-0716-2
"C6,A8",11564,11944,8717,3227,5754,0,2694,2701,1914,787,2.43202033,1277,12389,3969,2245,1,2244,1,680,0,0.051693405,empty,mBC-0716-2
"C6,A9",23302,23518,18113,5405,11211,2,4970,4985,3471,1514,2.292602378,2257,1443,898,557,1,556,1,208,0,0.059352518,empty,mBC-0716-2
"C6,A10",786228,857502,571345,286157,416836,2,223151,223508,168955,54553,3.097079904,120840,18727,11133,6111,5,6106,1,1206,0,0.00049132,mm10,mBC-0716-2
"C6,A11",355319,349834,271512,78322,176170,3,73167,73320,58388,14932,3.910259845,33966,7632,4996,2713,0,2713,0,741,0,0.00589753,mm10,mBC-0716-2
"C6,A12",21343,22177,16448,5729,10627,0,4705,4717,3285,1432,2.293994413,2283,2529,1431,832,0,832,0,263,0,0.049278846,empty,mBC-0716-2
"C6,B1",20293,21176,15337,5839,10173,10,4629,4653,3330,1323,2.517006803,2272,3590,1359,835,0,835,0,281,0,0.094610778,empty,mBC-0716-2
"C6,B2",20609,21211,15815,5396,10082,0,4563,4571,3229,1342,2.406110283,2103,492,238,157,0,157,0,79,0,0.063694268,empty,mBC-0716-2
"C6,B3",2322265,2501603,1686774,814829,1161892,1,637543,638497,532201,106296,5.006782946,336275,150747,99872,55629,15,55614,1,4450,0,0.001510411,mm10,mBC-0716-2
"C6,B4",16961,17518,13019,4499,8544,0,3888,3895,2741,1154,2.375216638,1820,4637,1655,961,2,959,1,312,0,0.054223149,empty,mBC-0716-2
"C6,B5",9034,5167,3672,1495,3382,0,1562,1579,1125,454,2.477973568,886,4848,1508,882,2,880,1,291,0,0.036363636,empty,mBC-0716-2
"C6,B6",12875,13356,9735,3621,6600,4,3053,3066,2133,933,2.286173633,1539,1214,738,453,0,453,0,189,0,0.088300221,empty,mBC-0716-2
"C6,B7",20807,21668,15936,5732,10623,1,4887,4895,3387,1508,2.24602122,2372,1271,631,377,0,377,0,157,0,0.037135279,empty,mBC-0716-2
"C6,B8",13985,14393,10752,3641,7092,0,3309,3312,2353,959,2.453597497,1626,1217,711,423,0,423,0,212,0,0.016548463,empty,mBC-0716-2
"C6,B9",15239,15724,11590,4134,7598,8,3449,3469,2403,1066,2.254221388,1664,762,405,255,1,254,1,122,0,0.043307087,empty,mBC-0716-2
"C6,B10",17329,17734,13020,4714,8754,8,4088,4112,2820,1292,2.182662539,1945,689,325,195,0,195,0,94,0,0.035897436,empty,mBC-0716-2
"C6,B11",16993,17594,13054,4540,8381,2,3862,3874,2679,1195,2.241841004,1743,243,141,96,0,96,0,63,0,0,empty,mBC-0716-2
"C6,B12",18997,19462,14537,4925,9548,0,4321,4334,2997,1337,2.241585639,2043,1545,811,462,0,462,0,177,0,0.04978355,empty,mBC-0716-2
"C6,C1",1133963,1214590,843780,370810,573969,2,287108,287582,225153,62429,3.606545035,150613,54243,35686,19612,14,19598,1,2337,0,0.000867435,mm10,mBC-0716-2
"C6,C2",18720,19210,14318,4892,9359,0,4154,4164,2883,1281,2.25058548,1954,1613,1005,565,1,564,1,175,0,0.081560284,empty,mBC-0716-2
"C6,C3",20724,21178,15592,5586,10161,0,4778,4788,3309,1479,2.237322515,2290,3304,1150,683,0,683,0,216,0,0.036603221,empty,mBC-0716-2
"C6,C4",17782,17945,13537,4408,8846,0,3829,3837,2689,1148,2.342334495,1779,957,536,348,0,348,0,143,0,0.054597701,empty,mBC-0716-2
"C6,C5",17233,17778,13058,4720,8724,0,4015,4022,2823,1199,2.354462052,1982,2332,1079,653,1,652,1,258,0,0.044478528,empty,mBC-0716-2
"C6,C6",17474,17861,13177,4684,9017,1,4175,4186,2935,1251,2.346123102,1994,2528,1126,647,0,647,0,232,0,0.024729521,empty,mBC-0716-2
"C6,C7",17115,17747,12872,4875,8764,40,4100,4149,2840,1309,2.169595111,2090,428,235,149,0,149,0,75,0,0,empty,mBC-0716-2
"C6,C8",15290,16020,11716,4304,7945,28,3607,3639,2520,1119,2.252010724,1742,1549,878,537,0,537,0,217,0,0.016759777,empty,mBC-0716-2
"C6,C9",13206,13758,9862,3896,6818,0,3174,3183,2225,958,2.322546973,1623,893,534,342,0,342,0,148,0,0.052631579,empty,mBC-0716-2
"C6,C10",14772,15210,11185,4025,7343,0,3412,3419,2350,1069,2.198316183,1657,1116,664,421,0,421,0,175,0,0.047505938,empty,mBC-0716-2
"C6,C11",12174,12677,9091,3586,6087,12,2871,2887,2030,857,2.368728121,1372,799,509,299,0,299,0,115,0,0.016722408,empty,mBC-0716-2
"C6,C12",21180,21954,15963,5991,10606,2,4954,4970,3521,1449,2.429951691,2369,1329,630,375,0,375,0,169,0,0.058666667,empty,mBC-0716-2
"C6,D1",12294,13013,9255,3758,6449,3,3128,3135,2184,951,2.296529968,1608,689,380,247,0,247,0,101,0,0.012145749,empty,mBC-0716-2
"C6,D2",21634,22102,16681,5421,10922,2,4771,4788,3346,1442,2.32038835,2250,2698,1534,939,0,939,0,349,0,0.04685836,empty,mBC-0716-2
"C6,D3",14125,14705,10663,4042,7207,0,3410,3416,2386,1030,2.316504854,1598,1300,750,451,0,451,0,200,0,0.062084257,empty,mBC-0716-2
"C6,D4",14548,15182,11165,4017,7440,2,3423,3431,2414,1017,2.373647984,1623,1427,835,501,1,500,1,234,0,0.08,empty,mBC-0716-2
"C6,D5",16530,17313,12496,4817,8441,49,3950,4002,2642,1360,1.942647059,1989,1273,799,488,0,488,0,187,0,0.010245902,empty,mBC-0716-2
"C6,D6",12795,13553,9408,4145,6645,5,3323,3333,2336,997,2.343029087,1700,1268,685,437,0,437,0,198,0,0.050343249,empty,mBC-0716-2
"C6,D7",20147,21631,14767,6864,10567,1,5521,5532,3914,1618,2.419035847,2934,7741,2446,1429,0,1429,0,439,0,0.021693492,empty,mBC-0716-2
"C6,D8",16007,16758,12099,4659,8230,5,3852,3868,2714,1154,2.351819757,1932,1125,555,335,0,335,0,152,0,0.017910448,empty,mBC-0716-2
"C6,D9",5452,5713,4031,1682,2842,2,1375,1377,1004,373,2.691689008,706,1509,873,562,2,560,1,253,0,0.042857143,empty,mBC-0716-2
"C6,D10",13471,14065,10250,3815,6932,45,3163,3213,2252,961,2.3433923,1602,740,414,253,0,253,0,105,0,0.055335968,empty,mBC-0716-2
"C6,D11",13569,14289,10292,3997,7092,15,3290,3318,2408,910,2.646153846,1677,1619,978,585,0,585,0,227,0,0.095726496,empty,mBC-0716-2
"C6,D12",27647,29302,21109,8193,13933,24,6623,6663,4790,1873,2.557394554,3310,2251,1285,798,1,797,1,285,0,0.031367629,empty,mBC-0716-2
"C6,E1",888922,919390,659844,259546,444743,14,219620,220010,156655,63355,2.472654092,112690,11043,6537,3752,0,3752,0,886,0,0.012526652,mm10,mBC-0716-2
"C6,E2",16564,16868,12638,4230,8314,17,3711,3733,2703,1030,2.624271845,1732,1435,791,484,0,484,0,190,0,0.055785124,empty,mBC-0716-2
"C6,E3",714563,786431,509969,276462,383826,3,214625,214950,181725,33225,5.469525959,116920,122276,80364,45185,22,45163,1,3844,0,0.00055355,mm10,mBC-0716-2
"C6,E4",1054607,1168864,738579,430285,559430,1,330843,331322,271566,59756,4.544581297,182644,89428,58882,33529,11,33518,3,3264,0,0.001342562,mm10,mBC-0716-2
"C6,E5",21874,22207,16847,5360,10690,0,4663,4679,3284,1395,2.354121864,2145,1510,953,586,0,586,0,240,0,0.017064846,empty,mBC-0716-2
"C6,E6",14634,14861,11058,3803,7311,0,3368,3385,2406,979,2.457609806,1624,1398,848,502,0,502,0,215,0,0.055776892,empty,mBC-0716-2
"C6,E7",831157,922212,575877,346335,446113,11,262985,263402,180465,82937,2.175928717,149194,56768,36309,19782,8,19774,1,2439,0,0.00313543,mm10,mBC-0716-2
"C6,E8",18460,18753,14266,4487,9150,1,4015,4021,2805,1216,2.306743421,1865,1751,999,611,0,611,0,262,0,0.032733224,empty,mBC-0716-2
"C6,E9",9645,10046,7269,2777,4869,0,2273,2278,1604,674,2.379821958,1124,887,518,287,0,287,0,121,0,0.038327526,empty,mBC-0716-2
"C6,E10",13645,14226,10364,3862,7005,0,3217,3227,2189,1038,2.108863198,1592,1085,695,424,0,424,0,176,0,0.037735849,empty,mBC-0716-2
"C6,E11",9333,9571,7146,2425,4853,5,2256,2272,1563,709,2.204513399,1117,1120,638,381,0,381,0,171,0,0.034120735,empty,mBC-0716-2
"C6,E12",15781,16365,11810,4555,8205,5,3915,3930,2747,1183,2.322062553,1968,1227,705,394,0,394,0,146,0,0.073604061,empty,mBC-0716-2
"C6,F1",19357,19726,14923,4803,9491,0,4185,4202,2965,1237,2.396928052,1884,1407,845,492,0,492,0,216,0,0.034552846,empty,mBC-0716-2
"C6,F2",23431,24463,17693,6770,11723,1,5437,5444,3896,1548,2.516795866,2667,2968,1732,1040,0,1040,0,392,0,0.045192308,empty,mBC-0716-2
"C6,F3",17426,18099,13024,5075,8926,0,4268,4276,3061,1215,2.519341564,2150,1793,1097,675,1,674,1,290,0,0.068249258,empty,mBC-0716-2
"C6,F4",17093,17443,13030,4413,8699,0,3984,3992,2767,1225,2.25877551,1921,544,327,215,0,215,0,99,0,0,empty,mBC-0716-2
"C6,F5",25938,26404,19298,7106,12598,3,5828,5852,4113,1739,2.365152386,2768,26751,8029,4777,3,4774,2,1213,0,0.049224969,empty,mBC-0716-2
"C6,F6",24601,25426,18429,6997,12212,44,5678,5734,4073,1661,2.452137267,2815,1989,1160,663,0,663,0,242,0,0.022624434,empty,mBC-0716-2
"C6,F7",21411,21670,16492,5178,10549,1,4716,4726,3264,1462,2.23255814,2160,805,464,301,0,301,0,135,0,0.013289037,empty,mBC-0716-2
"C6,F8",22204,22706,16928,5778,11272,0,5147,5156,3664,1492,2.455764075,2472,343,212,148,0,148,0,97,0,0.054054054,empty,mBC-0716-2
"C6,F9",15735,15973,11989,3984,7701,1,3418,3425,2415,1010,2.391089109,1636,27577,7873,4683,4,4679,2,1156,0,0.032485574,empty,mBC-0716-2
"C6,F10",21218,21723,16348,5375,10635,0,4682,4688,3266,1422,2.29676512,2179,1402,858,482,0,482,0,206,0,0.060165975,empty,mBC-0716-2
"C6,F11",11815,12177,8903,3274,5954,5,2644,2655,1844,811,2.273736128,1259,16842,5485,3252,2,3250,2,826,0,0.040307692,empty,mBC-0716-2
"C6,F12",14442,14808,10976,3832,7203,0,3219,3222,2273,949,2.395152792,1529,191,111,67,0,67,0,47,0,0,empty,mBC-0716-2
"C6,G1",11113,11197,8444,2753,5401,0,2395,2395,1690,705,2.397163121,1069,5257,2118,1318,0,1318,0,411,0,0.146433991,empty,mBC-0716-2
"C6,G2",22604,23453,17238,6215,11321,3,5143,5159,3561,1598,2.228410513,2498,1385,568,364,0,364,0,169,0,0.013736264,empty,mBC-0716-2
"C6,G3",20768,21246,15794,5452,10422,20,4780,4808,3420,1388,2.463976945,2281,1924,1128,641,0,641,0,279,0,0.03276131,empty,mBC-0716-2
"C6,G4",29856,30270,23082,7188,14642,7,6479,6505,4615,1890,2.441798942,2985,186,114,82,0,82,0,56,0,0.012195122,empty,mBC-0716-2
"C6,G5",667971,697160,511766,185394,338207,0,159148,159429,119013,40416,2.944700119,78176,45843,24073,13628,9,13619,4,2144,0,0.021440634,mm10,mBC-0716-2
"C6,G6",24949,25230,19337,5893,12178,5,5212,5233,3701,1532,2.415796345,2376,245,171,98,0,98,0,77,0,0.020408163,empty,mBC-0716-2
"C6,G7",20829,21383,16070,5313,10372,1,4614,4621,3297,1324,2.490181269,2128,1801,1092,678,0,678,0,245,0,0.054572271,empty,mBC-0716-2
"C6,G8",887644,961526,642403,319123,466106,25,259102,259556,158921,100635,1.579182193,138795,48821,31726,17971,6,17965,1,2452,0,0.004787086,mm10,mBC-0716-2
"C6,G9",2444953,2748542,1711883,1036659,1303087,5,789915,791044,632003,159041,3.973836935,441634,257473,162496,90214,39,90175,4,5565,0,0.002816745,mm10,mBC-0716-2
"C6,G10",21596,23571,15275,8296,11299,6,6167,6181,3576,2605,1.372744722,3423,6014,2185,1298,0,1298,0,440,0,0.036979969,empty,mBC-0716-2
"C6,G11",13801,14175,10003,4172,6619,5,3052,3066,2154,912,2.361842105,1489,15592,4545,2787,2,2785,2,681,0,0.105206463,empty,mBC-0716-2
"C6,G12",12134,12579,9132,3447,6204,0,2889,2905,2024,881,2.29738933,1427,1262,728,422,0,422,0,161,0,0.078199052,empty,mBC-0716-2
"C6,H1",21984,22243,16781,5462,10810,7,4869,4882,3455,1427,2.42116328,2256,1413,699,429,0,429,0,178,0,0.020979021,empty,mBC-0716-2
"C6,H2",25230,26146,19345,6801,12748,9,5853,5885,4128,1757,2.349459306,2852,1984,1149,713,0,713,0,279,0,0.026647966,empty,mBC-0716-2
"C6,H3",21469,22216,16420,5796,10973,0,5100,5123,3537,1586,2.230138714,2509,1483,802,503,0,503,0,218,0,0.02584493,empty,mBC-0716-2
"C6,H4",15006,15614,11454,4160,7577,3,3514,3527,2510,1017,2.468043265,1737,275,167,107,0,107,0,66,0,0.009345794,empty,mBC-0716-2
"C6,H5",19084,19765,14585,5180,9471,79,4315,4401,3110,1291,2.408985283,2136,11149,3458,2028,5,2023,4,581,0,0.054374691,empty,mBC-0716-2
"C6,H6",15065,16064,11422,4642,7972,0,3883,3886,2757,1129,2.441984057,2011,1614,1016,579,2,577,1,204,0,0.022530329,empty,mBC-0716-2
"C6,H7",869241,1021125,566455,454670,505109,7,334067,334487,226583,107904,2.099857281,201703,54199,33207,18689,5,18684,2,2402,0,0.003800043,mm10,mBC-0716-2
"C6,H8",14146,14595,10728,3867,7242,0,3360,3363,2350,1013,2.319842053,1653,1684,978,569,0,569,0,234,0,0.040421793,empty,mBC-0716-2
"C6,H9",16712,17449,12746,4703,8483,7,3939,3950,2826,1124,2.514234875,1947,1364,794,497,0,497,0,208,0,0.040241449,empty,mBC-0716-2
"C6,H10",14913,15260,11301,3959,7460,0,3495,3495,2375,1120,2.120535714,1645,2005,825,561,0,561,0,262,0,0.01426025,empty,mBC-0716-2
"C6,H11",17611,18433,13154,5279,8973,1,4164,4173,2897,1276,2.270376176,2079,338,169,121,0,121,0,74,0,0,empty,mBC-0716-2
"C6,H12",6475,6824,4960,1864,3338,2,1571,1577,1080,497,2.173038229,790,895,450,275,0,275,0,111,0,0.058181818,empty,mBC-0716-2
"C7,A1",19170,19919,14690,5229,9920,37,4585,4632,3342,1290,2.590697674,2242,1542,826,508,0,508,0,219,0,0.017716535,empty,mBC-0716-2
"C7,A2",856756,931438,603189,328249,446628,0,250629,251010,194603,56407,3.449979612,138618,85847,56358,31649,11,31638,2,3100,0,0.002749858,mm10,mBC-0716-2
"C7,A3",17231,17898,13217,4681,8761,5,4052,4066,2809,1257,2.23468576,1941,1259,696,418,0,418,0,198,0,0.071770335,empty,mBC-0716-2
"C7,A4",23635,24566,18202,6364,11568,53,5148,5213,3664,1549,2.36539703,2485,861,496,312,1,311,1,161,0,0.090032154,empty,mBC-0716-2
"C7,A5",737680,791204,551286,239918,390582,1,196840,197160,150279,46881,3.205541691,103096,42416,27586,15517,7,15510,1,2066,0,0.003675048,mm10,mBC-0716-2
"C7,A6",13053,13470,10127,3343,6681,0,3048,3061,2122,939,2.259850905,1476,1760,1050,688,0,688,0,290,0,0.087209302,empty,mBC-0716-2
"C7,A7",16781,17527,12829,4698,8594,0,3957,3963,2778,1185,2.344303797,1939,1420,903,541,0,541,0,210,0,0.033271719,empty,mBC-0716-2
"C7,A8",11589,12054,8948,3106,5866,0,2677,2686,1825,861,2.119628339,1293,1545,933,584,0,584,0,264,0,0.020547945,empty,mBC-0716-2
"C7,A9",21738,22422,16758,5664,10703,5,4702,4719,3408,1311,2.599542334,2242,1654,1026,594,1,593,1,248,0,0.028667791,empty,mBC-0716-2
"C7,A10",16696,16911,12674,4237,8226,28,3701,3734,2612,1122,2.32798574,1778,520,343,229,0,229,0,137,0,0.030567686,empty,mBC-0716-2
"C7,A11",967411,1085197,646952,438245,521594,16,320842,321307,269991,51316,5.261341492,183430,129663,70338,39178,21,39157,4,3875,0,0.008555303,mm10,mBC-0716-2
"C7,A12",22988,23497,17700,5797,11089,2,4915,4930,3421,1509,2.267064281,2241,16509,4965,2932,5,2927,2,775,0,0.04817219,empty,mBC-0716-2
"C7,B1",4154909,4587493,2877769,1709724,2128046,30,1356669,1358567,1071765,286802,3.736950928,751419,116032,70630,39093,14,39079,2,4377,0,0.006397298,mm10,mBC-0716-2
"C7,B2",21882,22178,16647,5531,10525,8,4705,4724,3270,1454,2.248968363,2163,902,535,272,0,272,0,105,0,0.150735294,empty,mBC-0716-2
"C7,B3",20650,21191,15676,5515,10328,12,4802,4818,3331,1487,2.240080699,2294,1823,990,612,0,612,0,246,0,0.006535948,empty,mBC-0716-2
"C7,B4",18980,19416,14133,5283,8981,0,4167,4172,3010,1162,2.590361446,1990,8678,3427,2147,2,2145,1,538,0,0.320745921,empty,mBC-0716-2
"C7,B5",16384,13167,8791,4376,7455,2,3876,3896,2792,1104,2.528985507,2145,1095,689,424,0,424,0,172,0,0.068396226,empty,mBC-0716-2
"C7,B6",13294,13761,9831,3930,6758,48,3156,3209,2219,990,2.241414141,1647,1366,871,509,0,509,0,215,0,0.055009823,empty,mBC-0716-2
"C7,B7",17615,18208,13668,4540,8831,0,3963,3972,2791,1181,2.363251482,1902,2662,1066,654,0,654,0,254,0,0.027522936,empty,mBC-0716-2
"C7,B8",14579,15063,11160,3903,7307,2,3360,3372,2375,997,2.382146439,1631,1776,1057,645,1,644,1,288,0,0.01552795,empty,mBC-0716-2
"C7,B9",16179,16422,12452,3970,7905,0,3459,3469,2431,1038,2.342003854,1602,933,502,320,0,320,0,165,0,0.053125,empty,mBC-0716-2
"C7,B10",17533,17469,13095,4374,8718,6,3975,3993,2691,1302,2.066820276,1839,663,389,259,0,259,0,111,0,0.069498069,empty,mBC-0716-2
"C7,B11",16927,17702,12917,4785,8368,27,3847,3881,2686,1195,2.247698745,1842,450,299,176,0,176,0,96,0,0.011363636,empty,mBC-0716-2
"C7,B12",19172,19667,14631,5036,9537,0,4283,4293,3000,1293,2.320185615,2022,1586,928,578,0,578,0,212,0,0.05017301,empty,mBC-0716-2
"C7,C1",26650,27436,20525,6911,12800,1,5455,5475,3913,1562,2.505121639,2595,1140,635,388,0,388,0,166,0,0.028350515,empty,mBC-0716-2
"C7,C2",19064,19488,14253,5235,9469,0,4354,4359,3010,1349,2.231282431,2150,1641,922,540,0,540,0,214,0,0.111111111,empty,mBC-0716-2
"C7,C3",1155243,1248406,848188,400218,590046,8,308565,309060,254158,54902,4.629303122,163328,42177,27327,15171,7,15164,2,2046,0,0.001582696,mm10,mBC-0716-2
"C7,C4",21364,21865,16329,5536,10669,0,4770,4778,3332,1446,2.30428769,2241,1651,973,583,0,583,0,224,0,0.030874786,empty,mBC-0716-2
"C7,C5",16940,17348,12803,4545,8379,2,3857,3865,2715,1150,2.360869565,1820,1330,774,491,0,491,0,251,0,0.020366599,empty,mBC-0716-2
"C7,C6",17649,17823,13257,4566,9017,49,4134,4201,2951,1250,2.3608,2007,3941,1587,974,1,973,1,352,0,0.064748201,empty,mBC-0716-2
"C7,C7",18191,18577,13486,5091,8968,3,4213,4224,2932,1292,2.269349845,2049,1876,620,383,1,382,1,168,0,0.015706806,empty,mBC-0716-2
"C7,C8",895544,986322,631874,354448,481386,9,274340,274731,182587,92144,1.981539764,152433,60334,37506,20401,10,20391,1,2763,0,0.004070423,mm10,mBC-0716-2
"C7,C9",1033043,1127555,742732,384823,537917,2,296366,296839,222481,74358,2.992025068,161333,50907,29760,16958,9,16949,2,2290,0,0.001888017,mm10,mBC-0716-2
"C7,C10",14891,15515,11305,4210,7526,0,3479,3483,2360,1123,2.101513802,1694,1200,726,429,0,429,0,194,0,0.006993007,empty,mBC-0716-2
"C7,C11",12083,12382,9243,3139,6106,6,2847,2856,1933,923,2.094257855,1327,1066,622,401,0,401,0,176,0,0.037406484,empty,mBC-0716-2
"C7,C12",988609,1143864,657763,486101,551734,9,357259,357787,263037,94750,2.776116095,210547,50909,31490,17651,15,17636,2,2390,0,0.002494897,mm10,mBC-0716-2
"C7,D1",12168,12491,9155,3336,6156,38,2886,2932,2036,896,2.272321429,1401,785,460,272,0,272,0,138,0,0.007352941,empty,mBC-0716-2
"C7,D2",23287,23979,17876,6103,11561,9,5098,5127,3654,1473,2.480651731,2469,2768,1697,1041,0,1041,0,408,0,0.039385207,empty,mBC-0716-2
"C7,D3",14039,14621,10573,4048,7194,15,3433,3456,2378,1078,2.20593692,1726,1190,723,466,0,466,0,248,0,0.012875536,empty,mBC-0716-2
"C7,D4",17891,18775,13296,5479,9285,0,4673,4680,3369,1311,2.56979405,2324,1549,937,601,0,601,0,284,0,0.056572379,empty,mBC-0716-2
"C7,D5",14625,14948,11207,3741,7277,0,3334,3337,2372,965,2.458031088,1563,3576,1397,873,0,873,0,312,0,0.059564719,empty,mBC-0716-2
"C7,D6",13450,13991,10080,3911,6815,45,3242,3298,2220,1078,2.059369202,1623,1463,856,585,0,585,0,263,0,0.013675214,empty,mBC-0716-2
"C7,D7",13477,13917,10286,3631,6756,3,3081,3087,2147,940,2.284042553,1442,1479,928,545,1,544,1,229,0,0.049632353,empty,mBC-0716-2
"C7,D8",1895620,2044139,1386087,658052,961700,5,512264,513117,426969,86148,4.956226494,271145,175662,114770,63383,17,63366,2,4752,0,0.001152037,mm10,mBC-0716-2
"C7,D9",5166,5323,3859,1464,2635,7,1224,1236,877,359,2.442896936,612,5708,2243,1403,0,1403,0,509,0,0.055595153,empty,mBC-0716-2
"C7,D10",14246,15025,10868,4157,7297,40,3390,3438,2369,1069,2.216089804,1637,895,537,345,0,345,0,140,0,0.04057971,empty,mBC-0716-2
"C7,D11",13915,14549,10462,4087,7107,0,3334,3342,2353,989,2.37917088,1639,1922,1106,665,0,665,0,277,0,0.048120301,empty,mBC-0716-2
"C7,D12",21465,22620,16288,6332,10772,0,4906,4915,3458,1457,2.373369938,2448,2501,1536,907,0,907,0,318,0,0.012127894,empty,mBC-0716-2
"C7,E1",23253,23503,17716,5787,11508,0,5111,5131,3657,1474,2.481004071,2452,9869,3416,1982,1,1981,1,609,0,0.048965169,empty,mBC-0716-2
"C7,E2",17148,16625,12635,3990,8172,1,3679,3691,2588,1103,2.346328196,1663,19859,6612,3972,4,3968,1,914,0,0.166582661,empty,mBC-0716-2
"C7,E3",571586,615416,423960,191456,301854,51,153056,153364,126649,26715,4.7407449,80022,78242,50276,28742,11,28731,1,3011,0,0.001566252,mm10,mBC-0716-2
"C7,E4",16349,16843,12425,4418,8126,0,3739,3745,2639,1106,2.386075949,1744,1404,818,498,1,497,1,206,0,0.060362173,empty,mBC-0716-2
"C7,E5",22513,23101,17312,5789,11209,1,4964,4976,3510,1466,2.394270123,2377,1695,1010,653,0,653,0,287,0,0.012251149,empty,mBC-0716-2
"C7,E6",14759,14965,11195,3770,7231,54,3248,3309,2299,1010,2.276237624,1592,2100,1257,793,0,793,0,318,0,0.034047919,empty,mBC-0716-2
"C7,E7",14899,15400,11366,4034,7380,47,3326,3386,2361,1025,2.303414634,1666,2187,1170,709,1,708,1,271,0,0.031073446,empty,mBC-0716-2
"C7,E8",18681,19460,14144,5316,9344,1,4178,4189,2904,1285,2.259922179,2075,1964,1236,765,1,764,1,295,0,0.061518325,empty,mBC-0716-2
"C7,E9",9152,9407,7038,2369,4612,0,2099,2101,1491,610,2.444262295,979,2640,1275,794,0,794,0,245,0,0.190176322,empty,mBC-0716-2
"C7,E10",13955,14449,10733,3716,6991,0,3157,3166,2196,970,2.263917526,1548,1324,826,490,0,490,0,223,0,0.06122449,empty,mBC-0716-2
"C7,E11",1074505,1122402,808413,313989,554716,8,262956,263445,211731,51714,4.094268477,132684,113596,74364,41614,21,41593,2,3848,0,0.000697233,mm10,mBC-0716-2
"C7,E12",15434,16374,11497,4877,7879,26,3682,3714,2595,1119,2.319034853,1784,2610,1025,598,4,594,2,253,0,0.028619529,empty,mBC-0716-2
"C7,F1",19608,20241,14964,5277,9831,3,4400,4421,3093,1328,2.329066265,2107,1841,1118,662,0,662,0,290,0,0.054380665,empty,mBC-0716-2
"C7,F2",25086,25697,19132,6565,12474,23,5686,5718,4038,1680,2.403571429,2731,2868,1782,1139,0,1139,0,450,0,0.036874451,empty,mBC-0716-2
"C7,F3",889658,962127,638221,323906,466627,1,255423,255800,210150,45650,4.603504929,137438,116586,76326,42523,17,42506,1,3738,0,0.001105726,mm10,mBC-0716-2
"C7,F4",528390,533679,397225,136454,267833,4,119604,119832,95352,24480,3.895098039,58740,6887,3670,2070,1,2069,1,564,0,0.003383277,mm10,mBC-0716-2
"C7,F5",881093,967545,619325,348220,470126,6,269365,269762,214874,54888,3.914771899,148945,66306,44327,24839,6,24833,1,2723,0,0.001328877,mm10,mBC-0716-2
"C7,F6",24253,25085,18452,6633,11881,17,5352,5380,3803,1577,2.4115409,2597,2434,1496,968,0,968,0,345,0,0.087809917,empty,mBC-0716-2
"C7,F7",22201,22360,16926,5434,10966,0,4903,4910,3424,1486,2.304172275,2249,1071,677,403,1,402,1,184,0,0.02238806,empty,mBC-0716-2
"C7,F8",25088,25659,19231,6428,12400,26,5644,5679,4066,1613,2.520768754,2643,446,275,191,0,191,0,127,0,0.015706806,empty,mBC-0716-2
"C7,F9",15967,16291,12396,3895,8002,6,3583,3609,2522,1087,2.320147194,1665,1778,1115,662,0,662,0,269,0,0.016616314,empty,mBC-0716-2
"C7,F10",22208,22333,17122,5211,10770,3,4657,4669,3294,1375,2.395636364,2088,1636,1052,635,1,634,1,242,0,0.044164038,empty,mBC-0716-2
"C7,F11",11787,12123,9076,3047,5908,17,2629,2647,1848,799,2.312891114,1253,1061,623,380,0,380,0,204,0,0.047368421,empty,mBC-0716-2
"C7,F12",14944,15356,11312,4044,7389,1,3319,3330,2310,1020,2.264705882,1560,189,115,65,0,65,0,45,0,0,empty,mBC-0716-2
"C7,G1",10867,11173,8265,2908,5483,12,2412,2426,1718,708,2.426553672,1122,2138,1242,727,0,727,0,265,0,0.030261348,empty,mBC-0716-2
"C7,G2",25062,25576,19258,6318,12366,50,5428,5494,3973,1521,2.612097304,2564,712,464,320,0,320,0,204,0,0.00625,empty,mBC-0716-2
"C7,G3",1004143,1127946,689452,438494,540629,0,324544,324961,244248,80713,3.02612962,185395,93982,59188,33140,17,33123,2,3328,0,0.002143526,mm10,mBC-0716-2
"C7,G4",29883,30508,23020,7488,14786,29,6322,6365,4434,1931,2.296219575,2976,187,118,87,0,87,0,74,0,0.022988506,empty,mBC-0716-2
"C7,G5",846635,911320,623413,287907,437506,21,224841,225226,189092,36134,5.233076881,118459,119357,77578,43259,18,43241,2,3592,0,0.001040679,mm10,mBC-0716-2
"C7,G6",26338,26929,20410,6519,12948,14,5655,5684,4025,1659,2.426160338,2677,231,157,103,0,103,0,85,0,0.019417476,empty,mBC-0716-2
"C7,G7",1443193,1601371,983395,617976,757526,22,462903,463497,385069,78428,4.909840873,259247,113723,70534,39564,16,39548,3,3730,0,0.002806716,mm10,mBC-0716-2
"C7,G8",15540,16077,11880,4197,7731,4,3574,3588,2444,1144,2.136363636,1740,1991,1244,727,0,727,0,311,0,0.008253095,empty,mBC-0716-2
"C7,G9",11338,11525,8589,2936,5700,0,2584,2595,1826,769,2.374512354,1244,1452,878,539,0,539,0,279,0,0.011131725,empty,mBC-0716-2
"C7,G10",14301,14713,11080,3633,7074,0,3111,3122,2193,929,2.360602799,1440,2433,1357,800,0,800,0,345,0,0.03,empty,mBC-0716-2
"C7,G11",13582,13889,10412,3477,6641,24,2925,2958,2032,926,2.194384449,1344,779,468,281,1,280,1,137,0,0.010714286,empty,mBC-0716-2
"C7,G12",12445,12885,9489,3396,6315,0,2992,2998,2133,865,2.465895954,1454,8803,2969,1785,2,1783,1,514,0,0.103757712,empty,mBC-0716-2
"C7,H1",22186,23015,16908,6107,11076,0,5110,5120,3620,1500,2.413333333,2477,1057,609,384,0,384,0,185,0,0.052083333,empty,mBC-0716-2
"C7,H2",25985,26995,19562,7433,13053,0,6028,6042,4283,1759,2.434906197,2970,2596,1633,990,1,989,1,412,0,0.031344793,empty,mBC-0716-2
"C7,H3",22387,23099,16807,6292,11101,9,5218,5230,3687,1543,2.389500972,2511,3339,1470,925,0,925,0,349,0,0.058378378,empty,mBC-0716-2
"C7,H4",14736,15172,11028,4144,7314,0,3396,3403,2402,1001,2.3996004,1639,272,157,115,0,115,0,82,0,0,empty,mBC-0716-2
"C7,H5",19384,19646,14768,4878,9568,6,4417,4432,3122,1310,2.383206107,2069,1617,974,625,0,625,0,259,0,0.0144,empty,mBC-0716-2
"C7,H6",602490,646818,434325,212493,318275,1,166379,166665,137144,29521,4.645642085,88591,108275,69674,38850,15,38835,2,3629,0,0.002317497,mm10,mBC-0716-2
"C7,H7",675702,703951,503149,200802,347088,15,168435,168754,136048,32706,4.159726044,84828,101641,67276,37869,14,37855,1,3355,0,0.000713248,mm10,mBC-0716-2
"C7,H8",14299,14266,10743,3523,7101,0,3258,3261,2326,935,2.487700535,1546,1617,961,637,0,637,0,276,0,0.047095761,empty,mBC-0716-2
"C7,H9",16631,16963,12589,4374,8217,0,3749,3760,2642,1118,2.363148479,1784,1728,999,626,0,626,0,288,0,0.062300319,empty,mBC-0716-2
"C7,H10",780605,945547,489137,456410,458469,1,315057,315409,251052,64357,3.900927638,196065,72900,44316,25181,11,25170,1,2775,0,0.00246325,mm10,mBC-0716-2
"C7,H11",18971,19833,14024,5809,9545,8,4597,4626,3016,1610,1.873291925,2377,272,134,103,0,103,0,72,0,0.029126214,empty,mBC-0716-2
"C7,H12",6344,6549,4771,1778,3279,0,1492,1493,1037,456,2.274122807,741,746,465,289,2,287,1,131,0,0.020905923,empty,mBC-0716-2
"C8,A1",15045,15440,11366,4074,7717,0,3607,3613,2571,1042,2.467370441,1706,9938,2701,1585,3,1582,1,500,0,0.008217446,empty,mBC-0716-2
"C8,A2",977033,1010711,719450,291261,481495,7,237371,237835,200514,37321,5.372685619,119344,92613,59053,32570,10,32560,1,3339,0,0.003931204,mm10,mBC-0716-2
"C8,A3",17828,18867,13563,5304,9181,9,4268,4284,3074,1210,2.540495868,2138,799,448,289,0,289,0,157,0,0.017301038,empty,mBC-0716-2
"C8,A4",22874,23588,17391,6197,11369,1,5075,5088,3670,1418,2.588152327,2450,715,438,292,0,292,0,158,0,0.017123288,empty,mBC-0716-2
"C8,A5",772145,813081,567943,245138,396802,0,197749,198066,169656,28410,5.971700106,102001,100624,60352,33347,22,33325,3,3235,0,0.001950488,mm10,mBC-0716-2
"C8,A6",20996,22335,15497,6838,11202,3,5637,5654,4052,1602,2.529338327,2977,1695,953,604,0,604,0,259,0,0.043046358,empty,mBC-0716-2
"C8,A7",527162,569745,380547,189198,284414,1,156400,156642,122202,34440,3.54825784,83901,16708,10257,5779,3,5776,2,1088,0,0.003635734,mm10,mBC-0716-2
"C8,A8",290539,302390,214303,88087,152334,3,75772,75906,59360,16546,3.587574036,38435,24717,16080,9002,2,9000,1,1491,0,0.003,mm10,mBC-0716-2
"C8,A9",19979,20415,15239,5176,9797,1,4339,4363,3096,1267,2.443567482,2042,1528,909,572,0,572,0,255,0,0.033216783,empty,mBC-0716-2
"C8,A10",719072,810102,495939,314163,397057,16,236164,236489,172688,63801,2.70666604,135537,8757,5688,3127,1,3126,1,672,0,0.000319898,mm10,mBC-0716-2
"C8,A11",881591,966039,620218,345821,470507,0,275766,276144,201718,74426,2.710316287,150130,22752,14772,8206,0,8206,0,1407,0,0.005605654,mm10,mBC-0716-2
"C8,A12",843684,888926,628050,260876,424418,5,208778,209132,171711,37421,4.588626707,106022,165845,108847,59684,21,59663,1,4277,0,0.001759885,mm10,mBC-0716-2
"C8,B1",20334,20835,15742,5093,10183,3,4569,4581,3226,1355,2.380811808,2165,1156,654,413,0,413,0,180,0,0.046004843,empty,mBC-0716-2
"C8,B2",21050,21647,15872,5775,10478,10,4706,4728,3310,1418,2.334273625,2290,1572,527,336,0,336,0,136,0,0.089285714,empty,mBC-0716-2
"C8,B3",21291,21432,15494,5938,10041,7,4732,4743,3347,1396,2.39756447,2288,11445,4267,2645,3,2642,1,605,0,0.264572294,empty,mBC-0716-2
"C8,B4",18933,18911,14056,4855,8935,1,4083,4091,2925,1166,2.508576329,1910,7637,2674,1615,1,1614,1,426,0,0.247211896,empty,mBC-0716-2
"C8,B5",13916,10248,6793,3455,5943,4,3113,3133,2164,969,2.233230134,1743,936,590,354,0,354,0,143,0,0.062146893,empty,mBC-0716-2
"C8,B6",13280,13826,10083,3743,6880,6,3224,3233,2264,969,2.336429309,1592,1346,847,542,0,542,0,222,0,0.031365314,empty,mBC-0716-2
"C8,B7",446000,521743,315858,205885,253736,21,155615,155851,115459,40392,2.858462072,88459,23291,13926,7707,4,7703,1,1247,0,0.005971699,mm10,mBC-0716-2
"C8,B8",14458,15213,10923,4290,7376,0,3356,3363,2451,912,2.6875,1691,1163,703,456,0,456,0,224,0,0.030701754,empty,mBC-0716-2
"C8,B9",16279,16919,12499,4420,8146,10,3722,3741,2642,1099,2.40400364,1828,801,471,320,1,319,1,137,0,0.02507837,empty,mBC-0716-2
"C8,B10",938395,922929,658183,264746,466667,2,230866,231943,171206,60737,2.818808963,119543,7352,4267,2395,1,2394,1,593,0,0.006683375,mm10,mBC-0716-2
"C8,B11",17784,18439,13576,4863,8974,5,4100,4124,2924,1200,2.436666667,1949,371,232,139,0,139,0,79,0,0,empty,mBC-0716-2
"C8,B12",19435,19885,14641,5244,9815,45,4545,4608,3176,1432,2.217877095,2189,5149,1808,1068,1,1067,1,358,0,0.033739456,empty,mBC-0716-2
"C8,C1",23665,24293,18294,5999,11555,57,4985,5053,3636,1417,2.565984474,2361,864,435,292,0,292,0,140,0,0.092465753,empty,mBC-0716-2
"C8,C2",18970,19636,14373,5263,9549,0,4452,4458,3096,1362,2.273127753,2143,1672,819,496,0,496,0,206,0,0.034274194,empty,mBC-0716-2
"C8,C3",21008,21545,15980,5565,10451,0,4951,4959,3473,1486,2.337146703,2366,808,476,289,0,289,0,132,0,0.024221453,empty,mBC-0716-2
"C8,C4",18929,18901,14386,4515,9170,6,4012,4028,2832,1196,2.367892977,1897,12066,3914,2311,5,2306,2,597,0,0.084128361,empty,mBC-0716-2
"C8,C5",17338,18134,13141,4993,8802,0,4145,4153,2837,1316,2.155775076,2044,1074,588,395,0,395,0,223,0,0.012658228,empty,mBC-0716-2
"C8,C6",17241,17704,12973,4731,8947,1,4207,4220,2942,1278,2.302034429,2050,1598,957,580,1,579,1,231,0,0.032815199,empty,mBC-0716-2
"C8,C7",17037,17507,12831,4676,8360,10,3852,3871,2687,1184,2.269425676,1845,2368,684,416,0,416,0,178,0,0,empty,mBC-0716-2
"C8,C8",16127,16352,12118,4234,7967,5,3667,3679,2528,1151,2.196350999,1713,5169,1897,1181,0,1181,0,379,0,0.050804403,empty,mBC-0716-2
"C8,C9",14048,14411,10376,4035,7118,0,3378,3386,2418,968,2.497933884,1606,899,574,342,0,342,0,176,0,0.038011696,empty,mBC-0716-2
"C8,C10",933888,985063,684626,300437,472040,4,240058,240443,202343,38100,5.310839895,123764,97636,62370,34761,10,34751,2,3375,0,0.001035941,mm10,mBC-0716-2
"C8,C11",12283,12842,9202,3640,6334,11,3018,3030,2068,962,2.14968815,1440,932,568,360,0,360,0,157,0,0.066666667,empty,mBC-0716-2
"C8,C12",20990,21691,15963,5728,10682,0,4950,4970,3476,1494,2.326639893,2411,1303,719,452,0,452,0,189,0,0.042035398,empty,mBC-0716-2
"C8,D1",724643,764418,522387,242031,377901,7,203314,203679,157868,45811,3.446071904,106978,14163,7562,4267,0,4267,0,947,0,0.001640497,mm10,mBC-0716-2
"C8,D2",22160,22717,16987,5730,11144,0,4918,4932,3476,1456,2.387362637,2287,2998,1645,1012,0,1012,0,401,0,0.036561265,empty,mBC-0716-2
"C8,D3",14681,15509,10978,4531,7608,32,3663,3712,2580,1132,2.279151943,1910,1690,950,556,1,555,1,239,0,0.021621622,empty,mBC-0716-2
"C8,D4",14949,15550,11401,4149,7634,0,3554,3559,2467,1092,2.259157509,1716,1420,825,528,0,528,0,237,0,0.087121212,empty,mBC-0716-2
"C8,D5",14280,14877,10892,3985,7294,0,3308,3317,2339,978,2.391615542,1610,1036,568,373,0,373,0,174,0,0.008042895,empty,mBC-0716-2
"C8,D6",13170,13846,9789,4057,6741,10,3243,3258,2320,938,2.473347548,1625,1491,901,515,0,515,0,233,0,0.054368932,empty,mBC-0716-2
"C8,D7",628915,689049,453598,235451,339997,4,184429,184720,146061,38659,3.778188779,100658,87274,52582,29243,10,29233,1,3282,0,0.005165395,mm10,mBC-0716-2
"C8,D8",16216,16663,12347,4316,8189,0,3819,3825,2720,1105,2.461538462,1842,983,646,365,0,365,0,154,0,0.065753425,empty,mBC-0716-2
"C8,D9",246066,266486,167475,99011,134171,0,76858,76950,64150,12800,5.01171875,43311,95413,61170,33859,13,33846,1,3323,0,0.001447734,mm10,mBC-0716-2
"C8,D10",13804,14115,10515,3600,6899,2,3197,3203,2207,996,2.215863454,1503,1035,612,376,0,376,0,141,0,0.04787234,empty,mBC-0716-2
"C8,D11",806173,886420,567301,319119,432102,0,247845,248218,213038,35180,6.055656623,135757,125091,81417,44932,13,44919,1,3722,0,0.00106859,mm10,mBC-0716-2
"C8,D12",21645,22122,16409,5713,10626,25,4752,4792,3312,1480,2.237837838,2289,2477,1519,877,0,877,0,317,0,0.063854048,empty,mBC-0716-2
"C8,E1",23498,24154,18013,6141,11608,9,5172,5193,3664,1529,2.396337475,2485,1771,1093,694,0,694,0,288,0,0.057636888,empty,mBC-0716-2
"C8,E2",17396,17742,13323,4419,8664,0,3873,3885,2776,1109,2.503155996,1799,2107,1073,696,1,695,1,277,0,0.043165468,empty,mBC-0716-2
"C8,E3",13234,13673,10192,3481,6675,0,3006,3007,2092,915,2.286338798,1440,1716,1056,625,0,625,0,278,0,0.0624,empty,mBC-0716-2
"C8,E4",1025334,1150861,720512,430349,550861,6,322631,323112,235511,87601,2.688451045,182063,50366,31376,17781,7,17774,3,2179,0,0.003375717,mm10,mBC-0716-2
"C8,E5",23580,23963,18104,5859,11715,0,5276,5286,3745,1541,2.430240104,2469,2830,1349,827,0,827,0,322,0,0.081015719,empty,mBC-0716-2
"C8,E6",14773,14838,11216,3622,7425,1,3374,3384,2378,1006,2.363817097,1621,2985,1261,723,1,722,1,309,0,0.063711911,empty,mBC-0716-2
"C8,E7",941340,1003561,681685,321876,479233,3,252779,253229,191335,61894,3.09133357,132902,68771,44766,25275,13,25262,1,2835,0,0.000910458,mm10,mBC-0716-2
"C8,E8",19106,19286,14654,4632,9243,7,4082,4095,2871,1224,2.345588235,1898,4040,1684,1023,1,1022,1,376,0,0.060665362,empty,mBC-0716-2
"C8,E9",9572,9760,7167,2593,4828,0,2194,2196,1585,611,2.59410802,1070,943,529,348,0,348,0,154,0,0.094827586,empty,mBC-0716-2
"C8,E10",598526,644209,436509,207700,317624,0,170868,171150,127873,43277,2.954756568,91506,16705,9180,5303,2,5301,1,1095,0,0.006979815,mm10,mBC-0716-2
"C8,E11",9908,10312,7553,2759,5096,3,2353,2361,1623,738,2.199186992,1150,6760,2304,1396,3,1393,3,423,0,0.057430007,empty,mBC-0716-2
"C8,E12",16357,16934,12345,4589,8447,1,4065,4078,2834,1244,2.278135048,1939,1845,802,477,1,476,1,196,0,0.023109244,empty,mBC-0716-2
"C8,F1",19485,20191,14743,5448,9719,0,4287,4294,2970,1324,2.243202417,2094,1619,992,591,0,591,0,224,0,0.076142132,empty,mBC-0716-2
"C8,F2",24439,25252,18366,6886,12338,0,5795,5802,4090,1712,2.389018692,2838,2839,1745,1073,1,1072,1,435,0,0.037313433,empty,mBC-0716-2
"C8,F3",17847,18507,13293,5214,9111,0,4341,4347,2997,1350,2.22,2175,12710,4130,2524,5,2519,1,745,0,0.014291385,empty,mBC-0716-2
"C8,F4",16807,17321,12558,4763,8558,24,3930,3959,2792,1167,2.392459297,1983,481,288,182,0,182,0,101,0,0.032967033,empty,mBC-0716-2
"C8,F5",27258,28620,20625,7995,13885,0,6579,6590,4659,1931,2.412739513,3320,2020,1244,774,0,774,0,370,0,0.034883721,empty,mBC-0716-2
"C8,F6",25070,25698,19085,6613,12267,0,5564,5579,3888,1691,2.299231224,2632,4431,1919,1091,1,1090,1,387,0,0.043119266,empty,mBC-0716-2
"C8,F7",21507,22018,16360,5658,10813,0,4884,4891,3400,1491,2.280348759,2337,1166,662,419,2,417,1,183,0,0.059952038,empty,mBC-0716-2
"C8,F8",814365,879487,591764,287723,428418,24,227116,227471,173895,53576,3.245763028,120890,8727,5665,3134,2,3132,2,726,0,0.000957854,mm10,mBC-0716-2
"C8,F9",16017,16493,12213,4280,7979,10,3580,3597,2541,1056,2.40625,1630,1686,1002,567,0,567,0,219,0,0.028218695,empty,mBC-0716-2
"C8,F10",1394766,1538456,952623,585833,725954,2,438037,438723,365631,73092,5.002339517,243667,96086,59338,32465,17,32448,1,3384,0,0.002835306,mm10,mBC-0716-2
"C8,F11",1311744,1321894,966860,355034,638427,3,314259,314832,252400,62432,4.042798565,155184,12018,7176,4026,2,4024,1,1069,0,0.003976143,mm10,mBC-0716-2
"C8,F12",15097,15501,11457,4044,7639,0,3542,3543,2514,1029,2.443148688,1746,213,118,82,0,82,0,53,0,0,empty,mBC-0716-2
"C8,G1",757605,829790,555178,274612,402283,0,209452,209785,180210,29575,6.093322063,112780,5400,2749,1677,2,1675,2,673,0,0.034626866,mm10,mBC-0716-2
"C8,G2",22385,22816,17250,5566,11193,0,5081,5090,3627,1463,2.479152427,2329,713,459,293,0,293,0,162,0,0,empty,mBC-0716-2
"C8,G3",21598,22589,16331,6258,10989,3,5186,5192,3589,1603,2.238927012,2514,4287,1842,1059,0,1059,0,402,0,0.04815864,empty,mBC-0716-2
"C8,G4",30725,31007,23777,7230,15071,29,6503,6546,4610,1936,2.381198347,2981,163,97,81,0,81,0,67,0,0,empty,mBC-0716-2
"C8,G5",14506,14832,10955,3877,7405,0,3453,3461,2447,1014,2.41321499,1672,1265,806,510,1,509,1,237,0,0.049115914,empty,mBC-0716-2
"C8,G6",26080,26695,20056,6639,12796,39,5550,5596,3931,1665,2.360960961,2656,285,163,102,0,102,0,59,0,0,empty,mBC-0716-2
"C8,G7",21696,22172,16532,5640,10823,1,4921,4932,3559,1373,2.592134013,2314,2094,1124,716,0,716,0,284,0,0.040502793,empty,mBC-0716-2
"C8,G8",1038854,1132634,743072,389562,538988,14,295310,295759,252687,43072,5.866618685,159785,155682,100591,54695,24,54671,2,4263,0,0.000804814,mm10,mBC-0716-2
"C8,G9",860177,954650,601875,352775,461958,7,273582,273982,193268,80714,2.394479272,153370,27577,17867,9838,7,9831,2,1676,0,0.000406876,mm10,mBC-0716-2
"C8,G10",14517,14954,11004,3950,7307,0,3328,3340,2352,988,2.380566802,1590,1400,869,560,0,560,0,247,0,0.003571429,empty,mBC-0716-2
"C8,G11",840117,895235,618838,276397,431286,14,211639,212040,181888,30152,6.032369329,111639,4563,1985,1161,2,1159,1,492,0,0.003451251,mm10,mBC-0716-2
"C8,G12",680955,746418,489796,256622,373394,25,207521,207856,159522,48334,3.30040965,113621,28245,18270,10344,1,10343,1,1630,0,0.006091076,mm10,mBC-0716-2
"C8,H1",21934,22755,16531,6224,11089,0,5046,5058,3594,1464,2.454918033,2506,914,517,322,0,322,0,158,0,0.01863354,empty,mBC-0716-2
"C8,H2",1408068,1654078,902979,751099,790920,3,539560,540216,351609,188607,1.864241518,325868,43050,27963,15617,5,15612,2,2122,0,0.007302075,mm10,mBC-0716-2
"C8,H3",21949,22277,16614,5663,10927,0,5071,5077,3653,1424,2.565308989,2411,6580,2242,1351,3,1348,1,475,0,0.041543027,empty,mBC-0716-2
"C8,H4",15521,16468,11555,4913,7905,56,3734,3793,2663,1130,2.356637168,1926,285,185,115,0,115,0,68,0,0.008695652,empty,mBC-0716-2
"C8,H5",19148,19932,14511,5421,9509,0,4412,4425,3165,1260,2.511904762,2194,1564,939,574,0,574,0,242,0,0.019163763,empty,mBC-0716-2
"C8,H6",15045,15391,11265,4126,7650,0,3440,3447,2414,1033,2.336882865,1696,1473,880,529,3,526,1,228,0,0.013307985,empty,mBC-0716-2
"C8,H7",17729,18422,13326,5096,9047,1,4223,4234,2951,1283,2.300077942,2076,1773,1066,634,1,633,1,274,0,0.023696682,empty,mBC-0716-2
"C8,H8",14648,15009,10940,4069,7437,0,3498,3503,2485,1018,2.441060904,1705,2171,1187,724,0,724,0,341,0,0.053867403,empty,mBC-0716-2
"C8,H9",955788,1027314,670348,356966,496100,0,276078,276491,236410,40081,5.89830593,150724,78739,44893,24877,7,24870,1,2940,0,0.002613591,mm10,mBC-0716-2
"C8,H10",731026,792987,518526,274461,384072,25,209052,209415,180042,29373,6.12950669,113881,80608,52981,29283,12,29271,3,3026,0,0.001503194,mm10,mBC-0716-2
"C8,H11",18136,18877,13624,5253,9120,0,4217,4225,2930,1295,2.262548263,2020,344,163,116,0,116,0,78,0,0,empty,mBC-0716-2
"C8,H12",6235,6509,4678,1831,3288,0,1553,1558,1117,441,2.532879819,768,737,442,248,0,248,0,113,0,0.044354839,empty,mBC-0716-2
"C9,A1",15329,15229,11189,4040,7274,0,3446,3453,2375,1078,2.203153989,1627,14414,4987,3012,4,3008,2,723,0,0.180518617,empty,mBC-0716-2
"C9,A2",19342,19590,14916,4674,9347,2,3950,3961,2772,1189,2.3313709,1801,1180,708,440,0,440,0,159,0,0.1,empty,mBC-0716-2
"C9,A3",16881,17602,12846,4756,8505,1,3915,3924,2702,1222,2.211129296,1912,1113,541,331,1,330,1,148,0,0.021212121,empty,mBC-0716-2
"C9,A4",22501,23115,17316,5799,10983,6,4893,4915,3500,1415,2.473498233,2317,641,364,237,0,237,0,110,0,0.097046414,empty,mBC-0716-2
"C9,A5",985955,1055103,715840,339263,507778,3,268014,268422,225698,42724,5.282698249,141059,122476,79409,44023,13,44010,2,3834,0,0.001386049,mm10,mBC-0716-2
"C9,A6",16449,17734,12488,5246,8638,7,4186,4204,2954,1250,2.3632,2090,1388,755,491,0,491,0,204,0,0.126272912,empty,mBC-0716-2
"C9,A7",16997,17237,13001,4236,8391,0,3735,3743,2626,1117,2.350940018,1765,2055,895,505,0,505,0,204,0,0.043564356,empty,mBC-0716-2
"C9,A8",11262,11364,8711,2653,5539,2,2539,2549,1835,714,2.570028011,1152,2445,1225,730,1,729,1,252,0,0.064471879,empty,mBC-0716-2
"C9,A9",19383,19588,14880,4708,9414,33,4078,4116,2877,1239,2.322033898,1880,1238,739,419,1,418,1,187,0,0.043062201,empty,mBC-0716-2
"C9,A10",16251,16564,12418,4146,8099,0,3667,3676,2581,1095,2.357077626,1699,678,296,181,0,181,0,97,0,0,empty,mBC-0716-2
"C9,A11",792404,882652,546666,335986,433105,24,259796,260171,185010,75161,2.461515946,147521,36070,20042,11192,8,11184,1,1803,0,0.00491774,mm10,mBC-0716-2
"C9,A12",21975,22313,16888,5425,10434,0,4603,4607,3284,1323,2.482237339,2133,2897,1611,909,2,907,1,301,0,0.058434399,empty,mBC-0716-2
"C9,B1",20167,20626,15502,5124,9952,0,4466,4479,3112,1367,2.276517922,2085,1149,668,405,0,405,0,155,0,0.066666667,empty,mBC-0716-2
"C9,B2",20775,21365,16008,5357,10253,0,4675,4682,3245,1437,2.258176757,2182,748,440,279,0,279,0,121,0,0.05734767,empty,mBC-0716-2
"C9,B3",19260,19900,14592,5308,9576,0,4373,4379,3049,1330,2.292481203,2144,987,602,374,0,374,0,166,0,0.018716578,empty,mBC-0716-2
"C9,B4",17201,17777,13167,4610,8542,10,3825,3850,2760,1090,2.532110092,1780,2022,853,532,1,531,1,188,0,0.04519774,empty,mBC-0716-2
"C9,B5",639317,283123,167039,116084,192109,23,107204,108297,77928,30369,2.566037736,67710,26681,17848,9748,3,9745,1,1529,0,0.000820934,mm10,mBC-0716-2
"C9,B6",12491,12890,9504,3386,6275,37,2881,2928,1990,938,2.121535181,1413,1396,803,483,0,483,0,196,0,0.047619048,empty,mBC-0716-2
"C9,B7",16842,17393,13039,4354,8561,0,3800,3803,2660,1143,2.327209099,1818,1116,661,389,1,388,1,160,0,0.015463918,empty,mBC-0716-2
"C9,B8",821741,915452,578455,336997,446139,26,258668,259175,193582,65593,2.951260043,143644,54934,35325,19691,6,19685,1,2544,0,0.002692405,mm10,mBC-0716-2
"C9,B9",16183,16711,12420,4291,7984,15,3598,3626,2575,1051,2.450047574,1727,600,358,211,0,211,0,115,0,0.028436019,empty,mBC-0716-2
"C9,B10",17325,17336,12922,4414,8553,0,3928,3942,2706,1236,2.189320388,1838,505,266,172,0,172,0,81,0,0.005813953,empty,mBC-0716-2
"C9,B11",15838,16446,12143,4303,7932,23,3559,3587,2540,1047,2.425978988,1690,288,147,96,0,96,0,60,0,0.010416667,empty,mBC-0716-2
"C9,B12",18913,19538,14377,5161,9609,0,4402,4417,3097,1320,2.346212121,2180,1280,797,482,0,482,0,174,0,0.014522822,empty,mBC-0716-2
"C9,C1",23673,23713,18358,5355,11359,7,4824,4842,3350,1492,2.245308311,2197,678,401,227,0,227,0,113,0,0.052863436,empty,mBC-0716-2
"C9,C2",18920,19173,14391,4782,9224,0,4159,4173,2907,1266,2.296208531,1933,2933,1344,787,0,787,0,254,0,0.081321474,empty,mBC-0716-2
"C9,C3",20671,21099,15636,5463,10150,24,4603,4645,3269,1376,2.375726744,2195,618,354,209,0,209,0,88,0,0,empty,mBC-0716-2
"C9,C4",17760,17759,13637,4122,8546,0,3648,3654,2574,1080,2.383333333,1648,1455,882,521,1,520,1,177,0,0.036538462,empty,mBC-0716-2
"C9,C5",16774,17594,12777,4817,8482,24,3991,4019,2834,1185,2.391561181,1917,968,604,370,0,370,0,193,0,0.037837838,empty,mBC-0716-2
"C9,C6",17101,17426,12836,4590,8668,1,3926,3941,2712,1229,2.206672091,1901,1277,731,456,0,456,0,181,0,0.043859649,empty,mBC-0716-2
"C9,C7",16830,17399,12758,4641,8395,0,3834,3847,2628,1219,2.155865463,1804,427,247,148,1,147,1,77,0,0,empty,mBC-0716-2
"C9,C8",15601,16023,11870,4153,7785,0,3607,3613,2480,1133,2.188879082,1698,1579,895,521,0,521,0,211,0,0.042226488,empty,mBC-0716-2
"C9,C9",896370,1022868,604224,418644,496230,0,309260,309663,238470,71193,3.34962707,180821,35506,22923,12796,7,12789,1,1740,0,0.001798421,mm10,mBC-0716-2
"C9,C10",14603,14888,11237,3651,7152,0,3275,3278,2232,1046,2.133843212,1524,5641,1818,1085,0,1085,0,358,0,0.02764977,empty,mBC-0716-2
"C9,C11",12284,12630,9285,3345,6160,0,2861,2866,1993,873,2.282932417,1341,972,566,314,1,313,1,144,0,0.099041534,empty,mBC-0716-2
"C9,C12",812961,880134,590479,289655,424832,9,228487,228894,180039,48855,3.685170402,123304,78076,37661,21359,18,21341,3,2716,0,0.035705918,mm10,mBC-0716-2
"C9,D1",11494,11957,8645,3312,5784,24,2702,2729,1886,843,2.237247924,1333,652,401,224,0,224,0,87,0,0.017857143,empty,mBC-0716-2
"C9,D2",21850,22066,16873,5193,10845,0,4681,4698,3321,1377,2.411764706,2210,2110,1219,707,1,706,1,295,0,0.029745042,empty,mBC-0716-2
"C9,D3",14296,14918,10681,4237,7169,0,3351,3367,2313,1054,2.194497154,1634,6125,2122,1281,0,1281,0,391,0,0.046057767,empty,mBC-0716-2
"C9,D4",16965,17675,12812,4863,8623,31,4005,4042,2892,1150,2.514782609,2006,1358,811,495,0,495,0,214,0,0.066666667,empty,mBC-0716-2
"C9,D5",13865,14416,10410,4006,7006,0,3259,3264,2288,976,2.344262295,1607,1066,628,367,0,367,0,146,0,0.027247956,empty,mBC-0716-2
"C9,D6",12923,13402,9884,3518,6483,9,3040,3057,2113,944,2.238347458,1476,1138,703,408,0,408,0,186,0,0.024509804,empty,mBC-0716-2
"C9,D7",13348,13785,10098,3687,6528,30,2970,3009,2084,925,2.252972973,1400,1611,969,513,3,510,1,193,0,0.050980392,empty,mBC-0716-2
"C9,D8",16217,16740,12231,4509,8124,0,3757,3774,2611,1163,2.24505589,1863,6474,2127,1285,0,1285,0,382,0,0.041245136,empty,mBC-0716-2
"C9,D9",4865,4991,3543,1448,2523,0,1191,1199,846,353,2.396600567,608,1768,983,622,1,621,1,269,0,0.043478261,empty,mBC-0716-2
"C9,D10",14348,15096,10846,4250,7343,0,3461,3464,2351,1113,2.112309075,1725,706,411,264,1,263,1,107,0,0.08365019,empty,mBC-0716-2
"C9,D11",13646,14287,10330,3957,6824,28,3136,3170,2184,986,2.215010142,1553,1504,919,542,0,542,0,231,0,0.033210332,empty,mBC-0716-2
"C9,D12",878948,943736,640254,303482,455396,1,240141,240528,190614,49914,3.818848419,127044,132435,86474,47902,25,47877,2,3945,0,0.001670948,mm10,mBC-0716-2
"C9,E1",22613,23171,17232,5939,11218,0,4956,4983,3398,1585,2.14384858,2410,6155,2049,1252,1,1251,1,411,0,0.052757794,empty,mBC-0716-2
"C9,E2",16759,17368,12671,4697,8344,19,3750,3780,2602,1178,2.208828523,1832,1581,857,553,0,553,0,229,0,0.032549729,empty,mBC-0716-2
"C9,E3",12775,13054,9751,3303,6467,11,2915,2934,2024,910,2.224175824,1392,1480,891,521,0,521,0,202,0,0.030710173,empty,mBC-0716-2
"C9,E4",16939,17070,12619,4451,8061,24,3621,3649,2591,1058,2.448960302,1717,1858,983,593,0,593,0,259,0,0.067453626,empty,mBC-0716-2
"C9,E5",527613,526664,417114,109550,258151,0,97769,98041,58458,39583,1.476846121,46587,10573,4851,2741,2,2739,1,778,0,0.005841548,mm10,mBC-0716-2
"C9,E6",13720,13950,10523,3427,6794,0,2950,2968,2047,921,2.222584148,1399,1527,936,544,0,544,0,233,0,0.042279412,empty,mBC-0716-2
"C9,E7",13823,13950,10245,3705,6872,0,3119,3121,2222,899,2.47163515,1489,1289,760,447,0,447,0,189,0,0.064876957,empty,mBC-0716-2
"C9,E8",588037,604215,441739,162476,298616,1,144106,144358,100902,43456,2.321934831,71084,37389,18702,10600,8,10592,4,1876,0,0.017749245,mm10,mBC-0716-2
"C9,E9",9079,9289,6733,2556,4504,0,2050,2053,1399,654,2.139143731,1016,1072,652,378,0,378,0,144,0,0.100529101,empty,mBC-0716-2
"C9,E10",705505,736178,543881,192297,359518,21,166276,166688,134112,32576,4.116895874,81578,28160,17616,9953,8,9945,1,1594,0,0.002011061,mm10,mBC-0716-2
"C9,E11",9373,9368,7071,2297,4671,21,2067,2092,1427,665,2.145864662,1003,1088,612,341,0,341,0,149,0,0.090909091,empty,mBC-0716-2
"C9,E12",977817,1143373,626784,516589,558252,15,375961,376450,231987,144463,1.605857555,228983,19499,12214,6564,5,6559,1,1275,0,0.002286934,mm10,mBC-0716-2
"C9,F1",19115,19458,14719,4739,9450,1,4217,4224,2925,1299,2.251732102,1986,1539,908,526,0,526,0,221,0,0.072243346,empty,mBC-0716-2
"C9,F2",23804,24953,18040,6913,12211,12,5726,5747,3927,1820,2.157692308,2855,9755,3637,2284,1,2283,1,694,0,0.013140604,empty,mBC-0716-2
"C9,F3",16749,17420,12546,4874,8392,0,4059,4066,2735,1331,2.05484598,1964,4741,1781,1045,0,1045,0,373,0,0.110047847,empty,mBC-0716-2
"C9,F4",16630,17051,12387,4664,8297,12,3782,3808,2642,1166,2.265866209,1848,597,374,201,0,201,0,94,0,0.039800995,empty,mBC-0716-2
"C9,F5",764910,832800,566816,265984,405576,11,209977,210329,156331,53998,2.895125745,112279,72367,43735,24027,10,24017,2,2878,0,0.002290045,mm10,mBC-0716-2
"C9,F6",23829,24562,17940,6622,11813,0,5329,5355,3720,1635,2.275229358,2597,4605,2028,1246,2,1244,1,384,0,0.030546624,empty,mBC-0716-2
"C9,F7",22079,22612,16954,5658,10926,47,4826,4879,3415,1464,2.332650273,2292,5470,1864,1080,0,1080,0,382,0,0.008333333,empty,mBC-0716-2
"C9,F8",22819,23080,17379,5701,11197,3,5011,5024,3576,1448,2.46961326,2332,316,191,118,0,118,0,70,0,0,empty,mBC-0716-2
"C9,F9",15746,16050,12066,3984,7726,0,3492,3503,2446,1057,2.3140965,1610,1612,942,593,0,593,0,211,0,0.038785835,empty,mBC-0716-2
"C9,F10",22166,22786,17195,5591,10899,0,4798,4806,3321,1485,2.236363636,2235,2577,1080,646,1,645,1,245,0,0.072868217,empty,mBC-0716-2
"C9,F11",947689,1059286,649142,410144,513995,0,308815,309259,247033,62226,3.969932183,175186,57389,35804,20068,9,20059,1,2433,0,0.00493544,mm10,mBC-0716-2
"C9,F12",14526,14945,11011,3934,7142,0,3267,3277,2271,1006,2.257455268,1575,129,87,56,0,56,0,40,0,0.017857143,empty,mBC-0716-2
"C9,G1",11332,11562,8690,2872,5483,88,2318,2414,1658,756,2.193121693,1163,1599,1018,571,1,570,1,191,0,0.007017544,empty,mBC-0716-2
"C9,G2",960183,996724,702981,293743,480639,2,246601,247023,204133,42890,4.759454418,125194,9064,5745,3192,1,3191,1,735,0,0.00219367,mm10,mBC-0716-2
"C9,G3",21404,22229,16175,6054,10807,0,5046,5061,3518,1543,2.279974076,2460,4202,1720,993,2,991,1,397,0,0.030272452,empty,mBC-0716-2
"C9,G4",1198821,1264347,872644,391703,600343,3,314055,314584,263179,51405,5.119715981,162384,755,462,263,0,263,0,99,0,0,empty,mBC-0716-2
"C9,G5",13436,13768,10193,3575,6725,0,2997,3005,2064,941,2.193411265,1452,1059,648,388,0,388,0,185,0,0.041237113,empty,mBC-0716-2
"C9,G6",25473,25996,19693,6303,12502,0,5526,5544,3855,1689,2.282415631,2553,215,128,78,0,78,0,56,0,0,empty,mBC-0716-2
"C9,G7",1227348,1350353,879975,470378,643467,2,361862,362349,273375,88974,3.072526806,196269,106247,66342,36555,18,36537,2,3552,0,0.002408517,mm10,mBC-0716-2
"C9,G8",584861,643766,415702,228064,313730,9,180013,180267,134477,45790,2.936820266,99628,27806,18280,10247,4,10243,1,1563,0,0.002245436,mm10,mBC-0716-2
"C9,G9",11064,11261,8356,2905,5477,5,2543,2550,1792,758,2.364116095,1215,1289,726,456,0,456,0,189,0,0.067982456,empty,mBC-0716-2
"C9,G10",14870,15356,11457,3899,7346,118,3216,3341,2295,1046,2.194072658,1568,1225,750,456,0,456,0,191,0,0.030701754,empty,mBC-0716-2
"C9,G11",12848,13155,9776,3379,6294,38,2817,2861,1986,875,2.269714286,1368,662,387,234,0,234,0,108,0,0.038461538,empty,mBC-0716-2
"C9,G12",11839,12107,9094,3013,5991,6,2724,2734,1880,854,2.201405152,1294,1307,795,454,0,454,0,174,0,0.083700441,empty,mBC-0716-2
"C9,H1",21468,22095,16335,5760,10675,34,4790,4837,3389,1448,2.340469613,2334,1028,653,393,0,393,0,154,0,0.10178117,empty,mBC-0716-2
"C9,H2",27687,28585,20934,7651,13792,0,6278,6298,4525,1773,2.552171461,3096,3767,1798,1057,0,1057,0,381,0,0.083254494,empty,mBC-0716-2
"C9,H3",20532,21231,15488,5743,10202,87,4634,4726,3348,1378,2.429608128,2294,1332,804,484,0,484,0,229,0,0.012396694,empty,mBC-0716-2
"C9,H4",16470,16901,12544,4357,8072,3,3634,3646,2535,1111,2.281728173,1726,155,96,66,0,66,0,46,0,0.03030303,empty,mBC-0716-2
"C9,H5",18586,18793,14184,4609,9121,35,4107,4159,2918,1241,2.351329573,1948,1336,822,518,0,518,0,195,0,0.032818533,empty,mBC-0716-2
"C9,H6",478609,479972,374280,105692,237890,0,97411,97619,74821,22798,3.281910694,45549,13143,8218,4437,0,4437,0,1042,0,0.038314176,mm10,mBC-0716-2
"C9,H7",17517,17806,13249,4557,8731,1,4007,4019,2727,1292,2.110681115,1955,1324,754,467,0,467,0,212,0,0.012847966,empty,mBC-0716-2
"C9,H8",14207,14911,10694,4217,7262,6,3468,3479,2412,1067,2.26054358,1705,1515,861,542,0,542,0,207,0,0.036900369,empty,mBC-0716-2
"C9,H9",729646,795745,509733,286012,389039,9,216514,216900,184151,32749,5.623102996,120214,114194,67490,38172,19,38153,4,3739,0,0.012345032,mm10,mBC-0716-2
"C9,H10",15363,15628,11540,4088,7761,7,3581,3595,2480,1115,2.224215247,1736,1335,816,506,1,505,1,209,0,0.005940594,empty,mBC-0716-2
"C9,H11",617763,657496,451749,205747,325685,0,171488,171780,132840,38940,3.411402157,90465,528,304,175,0,175,0,78,0,0,empty,mBC-0716-2
"C9,H12",6217,6670,4734,1936,3274,0,1555,1559,1078,481,2.241164241,799,518,314,191,0,191,0,90,0,0.036649215,empty,mBC-0716-2
"C10,A1",17005,17713,12617,5096,8815,0,4307,4321,3075,1246,2.467897271,2146,15205,5000,2996,0,2996,0,728,0,0.130841121,empty,mBC-0716-2
"C10,A2",21941,22231,16624,5607,10784,14,4829,4852,3430,1422,2.41209564,2285,7464,2433,1510,1,1509,1,442,0,0.05036448,empty,mBC-0716-2
"C10,A3",1706143,1796564,1261694,534870,848113,13,432117,432894,358273,74621,4.801235577,221679,102694,66671,37375,15,37360,4,3775,0.066666667,0.002007495,mm10,mBC-0716-2
"C10,A4",23659,24271,18431,5840,11574,1,5049,5061,3565,1496,2.38302139,2287,605,344,212,0,212,0,118,0,0.028301887,empty,mBC-0716-2
"C10,A5",19836,20701,15138,5563,10227,1,4810,4825,3432,1393,2.463747308,2387,1628,958,563,0,563,0,225,0,0.063943162,empty,mBC-0716-2
"C10,A6",699038,747265,517978,229287,359536,36,178271,178630,152592,26038,5.860357938,92499,128126,82986,46280,20,46260,2,3859,0,0.000691742,mm10,mBC-0716-2
"C10,A7",1064461,1221245,711416,509829,589408,41,374514,375012,250602,124410,2.014323607,221722,24443,15545,8796,4,8792,1,1491,0,0.001364877,mm10,mBC-0716-2
"C10,A8",11716,12306,8887,3419,5947,8,2814,2829,1990,839,2.371871275,1353,1291,737,417,0,417,0,178,0,0.011990408,empty,mBC-0716-2
"C10,A9",1209521,1314577,864587,449990,622385,13,345806,346343,290910,55433,5.247956993,185749,94401,60396,33593,18,33575,2,3276,0,0.002889054,mm10,mBC-0716-2
"C10,A10",17965,18611,13479,5132,8981,13,4213,4236,2985,1251,2.386091127,2017,1142,466,297,0,297,0,128,0,0.067340067,empty,mBC-0716-2
"C10,A11",20200,20744,15284,5460,10146,0,4585,4600,3210,1390,2.309352518,2187,1930,966,549,0,549,0,208,0,0.06557377,empty,mBC-0716-2
"C10,A12",23220,23674,17834,5840,11310,0,4986,4992,3555,1437,2.473903967,2307,9956,3372,2053,2,2051,1,560,0,0.091662604,empty,mBC-0716-2
"C10,B1",21180,22031,16354,5677,10710,0,4740,4765,3450,1315,2.623574144,2256,1180,706,441,0,441,0,178,0,0.036281179,empty,mBC-0716-2
"C10,B2",22660,23295,17150,6145,11251,1,5148,5162,3604,1558,2.31322208,2481,498,241,159,0,159,0,79,0,0.113207547,empty,mBC-0716-2
"C10,B3",21392,22095,16328,5767,10750,4,4891,4901,3542,1359,2.606328182,2379,1182,688,435,0,435,0,161,0,0.089655172,empty,mBC-0716-2
"C10,B4",18257,19272,13957,5315,9338,20,4335,4359,3085,1274,2.421507064,2173,3350,1143,729,1,728,1,267,0,0.026098901,empty,mBC-0716-2
"C10,B5",10255,6001,4145,1856,3788,7,1833,1854,1270,584,2.174657534,1032,775,445,268,0,268,0,121,0,0.029850746,empty,mBC-0716-2
"C10,B6",14353,14684,10833,3851,7265,1,3415,3425,2367,1058,2.237240076,1652,1028,630,412,0,412,0,193,0,0.016990291,empty,mBC-0716-2
"C10,B7",18699,19337,14352,4985,9276,0,4173,4180,2905,1275,2.278431373,1954,1044,634,351,0,351,0,147,0,0.028490028,empty,mBC-0716-2
"C10,B8",14993,15329,11482,3847,7514,0,3382,3397,2409,988,2.438259109,1607,1012,651,397,0,397,0,210,0,0.073047859,empty,mBC-0716-2
"C10,B9",19999,20735,15086,5649,10078,3,4784,4795,3300,1495,2.20735786,2363,718,426,270,0,270,0,130,0,0.018518519,empty,mBC-0716-2
"C10,B10",18606,18431,13951,4480,9154,0,4176,4184,2865,1319,2.172100076,1909,564,298,186,0,186,0,88,0,0.021505376,empty,mBC-0716-2
"C10,B11",21305,22479,16118,6361,10695,9,4967,4987,3584,1403,2.554526016,2429,329,180,111,0,111,0,59,0,0,empty,mBC-0716-2
"C10,B12",19723,20107,15154,4953,9853,0,4486,4490,3171,1319,2.404094011,2094,1301,726,423,0,423,0,152,0,0.026004728,empty,mBC-0716-2
"C10,C1",24770,24986,19269,5717,11863,0,4988,4992,3564,1428,2.495798319,2223,525,303,199,0,199,0,108,0,0.010050251,empty,mBC-0716-2
"C10,C2",20578,20754,15545,5209,10082,9,4557,4570,3214,1356,2.37020649,2155,1673,981,568,0,568,0,192,0,0.040492958,empty,mBC-0716-2
"C10,C3",30033,31386,22394,8992,15334,4,7423,7439,5474,1965,2.785750636,3763,494,229,149,0,149,0,77,0,0.046979866,empty,mBC-0716-2
"C10,C4",20048,20459,15181,5278,10072,0,4422,4433,3177,1256,2.529458599,2180,1303,693,435,0,435,0,165,0,0.055172414,empty,mBC-0716-2
"C10,C5",18924,19879,14139,5740,9770,0,4788,4808,3389,1419,2.388301621,2396,1257,735,451,0,451,0,197,0,0.013303769,empty,mBC-0716-2
"C10,C6",18661,19378,14095,5283,9725,8,4613,4623,3235,1388,2.330691643,2233,1334,745,438,0,438,0,194,0,0.01369863,empty,mBC-0716-2
"C10,C7",18007,18688,13669,5019,9054,24,4200,4230,2898,1332,2.175675676,2079,334,178,101,0,101,0,67,0,0.03960396,empty,mBC-0716-2
"C10,C8",17024,17704,12913,4791,8531,1,4004,4011,2763,1248,2.213942308,1930,1493,911,560,0,560,0,193,0,0.003571429,empty,mBC-0716-2
"C10,C9",14307,14958,10878,4080,7154,15,3295,3314,2251,1063,2.117591722,1615,866,513,336,1,335,1,141,0,0.032835821,empty,mBC-0716-2
"C10,C10",15908,16502,12256,4246,7961,42,3637,3691,2577,1114,2.313285458,1758,1105,642,396,0,396,0,159,0,0.01010101,empty,mBC-0716-2
"C10,C11",13108,13728,9971,3757,6677,0,3132,3134,2153,981,2.194699286,1520,840,479,292,0,292,0,149,0,0.010273973,empty,mBC-0716-2
"C10,C12",22066,22592,16776,5816,10885,10,4912,4935,3503,1432,2.44622905,2348,1284,597,332,1,331,1,137,0,0.051359517,empty,mBC-0716-2
"C10,D1",935057,1053076,635136,417940,509360,10,307603,308061,226690,81371,2.785881948,178740,32564,18798,10702,6,10696,2,1695,0,0.009816754,mm10,mBC-0716-2
"C10,D2",23281,23668,18132,5536,11501,9,4977,5005,3455,1550,2.229032258,2297,2371,1406,844,0,844,0,350,0,0.048578199,empty,mBC-0716-2
"C10,D3",788335,912528,527446,385082,447809,0,282699,283114,212519,70595,3.010397337,167234,35519,23178,12737,5,12732,1,1909,0,0.001492303,mm10,mBC-0716-2
"C10,D4",16172,16613,12419,4194,8121,0,3748,3755,2650,1105,2.398190045,1762,1334,776,475,1,474,1,213,0,0.035864979,empty,mBC-0716-2
"C10,D5",15287,16076,11651,4425,7785,4,3540,3555,2444,1111,2.199819982,1769,1049,619,335,0,335,0,156,0,0.03880597,empty,mBC-0716-2
"C10,D6",15811,16246,11193,5053,7645,0,3818,3828,2700,1128,2.393617021,1893,75633,21883,13050,20,13030,4,2233,0,0.114351497,empty,mBC-0716-2
"C10,D7",14121,14628,10698,3930,7059,22,3285,3314,2350,964,2.437759336,1592,1370,844,515,0,515,0,187,0,0.060194175,empty,mBC-0716-2
"C10,D8",18095,19070,13568,5502,9065,20,4210,4242,2978,1264,2.356012658,2155,723,396,245,0,245,0,135,0,0.032653061,empty,mBC-0716-2
"C10,D9",307284,345590,201933,143657,173182,10,109130,109263,82425,26838,3.071205008,64083,32222,20747,11472,7,11465,1,1779,0,0.003924989,mm10,mBC-0716-2
"C10,D10",14966,15508,11475,4033,7535,0,3440,3452,2401,1051,2.284490961,1675,741,445,252,0,252,0,109,0,0.031746032,empty,mBC-0716-2
"C10,D11",14992,15757,11436,4321,7716,24,3612,3641,2552,1089,2.343434343,1811,1663,1061,615,0,615,0,244,0,0.034146341,empty,mBC-0716-2
"C10,D12",22105,22692,16878,5814,10912,4,4946,4966,3451,1515,2.277887789,2346,2297,1419,797,0,797,0,277,0,0.045169385,empty,mBC-0716-2
"C10,E1",24474,25097,18347,6750,12027,0,5371,5380,3836,1544,2.484455959,2605,15526,5603,3391,4,3387,1,887,0,0.107469737,empty,mBC-0716-2
"C10,E2",18207,18901,13843,5058,9291,0,4305,4307,3060,1247,2.453889334,2070,1492,799,475,0,475,0,204,0,0.037894737,empty,mBC-0716-2
"C10,E3",13514,13992,10204,3788,6924,1,3137,3145,2222,923,2.407367281,1556,1930,1073,630,0,630,0,239,0,0.034920635,empty,mBC-0716-2
"C10,E4",16484,17089,12657,4432,8441,0,3850,3862,2750,1112,2.473021583,1858,1122,644,396,0,396,0,170,0,0.045454545,empty,mBC-0716-2
"C10,E5",25264,25780,19329,6451,12748,29,5642,5682,4078,1604,2.542394015,2730,1390,844,519,0,519,0,220,0,0.038535645,empty,mBC-0716-2
"C10,E6",16393,16847,12463,4384,8125,12,3728,3749,2654,1095,2.423744292,1803,1395,829,503,0,503,0,230,0,0.055666004,empty,mBC-0716-2
"C10,E7",16003,16596,12055,4541,8008,1,3693,3705,2626,1079,2.43373494,1869,1382,764,464,0,464,0,199,0,0.045258621,empty,mBC-0716-2
"C10,E8",19717,20340,15197,5143,9893,3,4388,4404,3115,1289,2.416602017,2085,5383,1970,1170,0,1170,0,351,0,0.065811966,empty,mBC-0716-2
"C10,E9",10458,10756,8031,2725,5253,4,2336,2346,1694,652,2.598159509,1108,933,569,361,0,361,0,122,0,0.019390582,empty,mBC-0716-2
"C10,E10",14798,15266,11201,4065,7417,4,3448,3457,2424,1033,2.346563408,1651,1249,773,456,0,456,0,190,0,0.043859649,empty,mBC-0716-2
"C10,E11",10639,10944,8049,2895,5362,24,2444,2477,1704,773,2.204398448,1193,8100,2583,1540,2,1538,2,452,0,0.035760728,empty,mBC-0716-2
"C10,E12",17533,18100,13193,4907,8996,1,4316,4326,3022,1304,2.317484663,2130,1350,776,459,0,459,0,186,0,0.052287582,empty,mBC-0716-2
"C10,F1",761296,792645,579963,212682,382792,0,177400,177791,156877,20914,7.501051927,87220,110615,70910,40812,17,40795,1,3205,0,0.00235323,mm10,mBC-0716-2
"C10,F2",3347320,3625287,2411288,1213999,1679541,9,966350,967780,747527,220253,3.393946961,523445,198053,122743,68648,29,68619,2,5425,0,0.002375435,mm10,mBC-0716-2
"C10,F3",1063968,1147470,749165,398305,551151,2,316606,317092,252695,64397,3.9240182,170962,19159,12238,6850,4,6846,1,1377,0,0.00628104,mm10,mBC-0716-2
"C10,F4",18066,18331,13475,4856,9082,1,4105,4117,2860,1257,2.275258552,1972,508,296,178,0,178,0,82,0,0.028089888,empty,mBC-0716-2
"C10,F5",823633,883948,595649,288299,428027,2,233059,233448,188974,44474,4.249089356,124282,12434,7023,4010,1,4009,1,997,0,0.015465203,mm10,mBC-0716-2
"C10,F6",25933,26330,19782,6548,12821,1,5844,5850,4094,1756,2.33143508,2717,12087,3845,2268,2,2266,1,655,0,0.051191527,empty,mBC-0716-2
"C10,F7",22129,23046,17067,5979,11294,0,5108,5116,3605,1511,2.385837194,2425,918,535,328,0,328,0,141,0,0.118902439,empty,mBC-0716-2
"C10,F8",24527,25709,18737,6972,12736,20,5961,5993,4327,1666,2.597238896,2922,586,287,188,0,188,0,99,0,0.021276596,empty,mBC-0716-2
"C10,F9",16206,16852,12388,4464,8173,4,3752,3761,2606,1155,2.256277056,1819,1307,730,448,0,448,0,187,0,0.049107143,empty,mBC-0716-2
"C10,F10",1101250,1222666,763962,458704,586220,1,350639,351115,275500,75615,3.643456986,195376,60575,40736,22197,8,22189,1,2769,0,0.002253369,mm10,mBC-0716-2
"C10,F11",12813,13383,9908,3475,6615,0,3023,3033,2113,920,2.29673913,1483,2108,958,552,0,552,0,200,0,0.081521739,empty,mBC-0716-2
"C10,F12",15808,16365,11971,4394,7764,0,3652,3662,2566,1096,2.341240876,1714,191,125,85,0,85,0,50,0,0.094117647,empty,mBC-0716-2
"C10,G1",11304,11676,8647,3029,5603,0,2484,2490,1754,736,2.383152174,1162,2501,1329,813,1,812,1,271,0,0.013546798,empty,mBC-0716-2
"C10,G2",23847,24300,18443,5857,11880,25,5304,5339,3703,1636,2.263447433,2514,769,473,306,0,306,0,153,0,0.071895425,empty,mBC-0716-2
"C10,G3",24290,25457,18473,6984,12267,11,5680,5710,4136,1574,2.627700127,2812,1986,1172,686,2,684,1,270,0,0.043859649,empty,mBC-0716-2
"C10,G4",31877,32631,24587,8044,15605,0,6931,6945,4962,1983,2.502269289,3268,145,80,57,0,57,0,43,0,0,empty,mBC-0716-2
"C10,G5",15281,15815,11414,4401,7663,0,3535,3540,2534,1006,2.51888668,1703,9207,2871,1730,1,1729,1,568,0,0.018507808,empty,mBC-0716-2
"C10,G6",26730,27096,20696,6400,12833,7,5620,5637,4006,1631,2.456161864,2528,217,133,89,0,89,0,66,0,0.02247191,empty,mBC-0716-2
"C10,G7",22201,22868,17155,5713,11069,0,5005,5014,3510,1504,2.333776596,2352,1611,885,551,0,551,0,234,0,0.049001815,empty,mBC-0716-2
"C10,G8",16381,16793,12168,4625,8343,0,3939,3949,2659,1290,2.06124031,1955,1617,944,566,2,564,1,233,0,0.037234043,empty,mBC-0716-2
"C10,G9",12257,12757,9252,3505,6273,41,2935,2985,2070,915,2.262295082,1473,1055,627,395,0,395,0,194,0,0.060759494,empty,mBC-0716-2
"C10,G10",14979,15914,11410,4504,7611,1,3542,3549,2484,1065,2.332394366,1747,1324,790,493,0,493,0,215,0,0.042596349,empty,mBC-0716-2
"C10,G11",13938,14292,10753,3539,6900,28,3123,3154,2223,931,2.387755102,1468,649,379,244,0,244,0,115,0,0.004098361,empty,mBC-0716-2
"C10,G12",12929,13398,9826,3572,6640,0,3062,3065,2195,870,2.522988506,1453,998,632,381,0,381,0,166,0,0.081364829,empty,mBC-0716-2
"C10,H1",23105,23859,17626,6233,11531,1,5354,5369,3872,1497,2.586506346,2570,841,544,343,0,343,0,150,0,0.102040816,empty,mBC-0716-2
"C10,H2",29570,30747,22375,8372,14960,0,6951,6964,5071,1893,2.678816693,3395,6475,2451,1450,0,1450,0,469,0,0.013103448,empty,mBC-0716-2
"C10,H3",23814,24812,18063,6749,12017,0,5649,5663,3983,1680,2.370833333,2787,3161,1272,809,1,808,1,319,0,0.060643564,empty,mBC-0716-2
"C10,H4",712079,752462,524344,228118,363054,27,183408,183768,151305,32463,4.660844654,94972,3404,2159,1224,1,1223,1,337,0,0.001635323,mm10,mBC-0716-2
"C10,H5",20734,21419,15574,5845,10304,5,4835,4844,3434,1410,2.435460993,2415,1591,970,562,0,562,0,214,0,0.044483986,empty,mBC-0716-2
"C10,H6",16634,17128,12536,4592,8390,0,3896,3900,2815,1085,2.594470046,1931,1384,770,438,1,437,1,200,0,0.043478261,empty,mBC-0716-2
"C10,H7",18747,19441,14145,5296,9631,0,4440,4454,3135,1319,2.376800607,2169,2546,1217,739,0,739,0,262,0,0.110960758,empty,mBC-0716-2
"C10,H8",17742,18422,13230,5192,8896,0,4324,4336,3093,1243,2.488334674,2165,1648,963,550,0,550,0,236,0,0.038181818,empty,mBC-0716-2
"C10,H9",763767,800531,557697,242834,388106,6,194024,194390,166498,27892,5.969381902,99754,90508,59644,33491,14,33477,1,3155,0,0.001792275,mm10,mBC-0716-2
"C10,H10",834530,913833,586421,327412,439718,17,254125,254532,186532,68000,2.743117647,139699,18374,11500,6575,3,6572,1,1251,0,0.003804017,mm10,mBC-0716-2
"C10,H11",18634,19241,14140,5101,9306,0,4369,4371,2977,1394,2.135581062,2127,236,134,87,0,87,0,58,0,0,empty,mBC-0716-2
"C10,H12",7081,7476,5203,2273,3692,0,1787,1795,1273,522,2.438697318,937,801,455,266,0,266,0,91,0,0.011278195,empty,mBC-0716-2
"C11,A1",14890,15464,11164,4300,7754,1,3647,3653,2568,1085,2.366820276,1830,1123,714,405,0,405,0,195,0,0.044444444,empty,mBC-0716-2
"C11,A2",19858,19842,15356,4486,9806,15,4261,4279,2975,1304,2.281441718,1896,1093,642,396,0,396,0,178,0,0.053030303,empty,mBC-0716-2
"C11,A3",17498,18159,13331,4828,8978,4,4179,4188,2918,1270,2.297637795,2008,1154,675,418,0,418,0,169,0,0.045454545,empty,mBC-0716-2
"C11,A4",2395602,2527987,1755280,772707,1163790,21,607931,608981,510064,98917,5.15648473,313174,86702,56153,31084,11,31073,1,3262,0,0.001222927,mm10,mBC-0716-2
"C11,A5",18771,19189,14376,4813,9551,0,4417,4430,3101,1329,2.333333333,2116,1477,849,522,0,522,0,215,0,0.049808429,empty,mBC-0716-2
"C11,A6",13350,13920,9972,3948,6930,0,3290,3298,2330,968,2.407024793,1661,1297,789,489,0,489,0,236,0,0.042944785,empty,mBC-0716-2
"C11,A7",16757,17379,12709,4670,8661,0,3906,3921,2714,1207,2.248550124,1947,1174,711,433,0,433,0,188,0,0.030023095,empty,mBC-0716-2
"C11,A8",11811,12407,9041,3366,6080,10,2798,2811,1961,850,2.307058824,1350,2921,1195,703,1,702,1,272,0,0.066951567,empty,mBC-0716-2
"C11,A9",20529,20815,15825,4990,10041,0,4523,4527,3223,1304,2.471625767,2094,1856,894,559,0,559,0,255,0,0.037567084,empty,mBC-0716-2
"C11,A10",16820,17605,12781,4824,8627,3,3941,3953,2828,1125,2.513777778,1960,2053,737,447,0,447,0,177,0,0.029082774,empty,mBC-0716-2
"C11,A11",800042,817848,587383,230465,397225,0,195210,195538,140369,55169,2.544345556,99716,11251,7038,4080,3,4077,1,908,0,0.005150846,mm10,mBC-0716-2
"C11,A12",22733,23387,17284,6103,11144,0,5010,5021,3572,1449,2.465148378,2418,2331,1292,777,0,777,0,256,0,0.068211068,empty,mBC-0716-2
"C11,B1",21387,21578,16332,5246,10520,0,4650,4662,3254,1408,2.311079545,2142,993,617,363,0,363,0,166,0,0.019283747,empty,mBC-0716-2
"C11,B2",1749920,1876356,1309622,566734,895069,19,458984,459737,391521,68216,5.739430632,237113,30483,19601,11089,3,11086,2,1637,0,0.001713873,mm10,mBC-0716-2
"C11,B3",999915,1056014,741387,314627,508256,55,256864,257326,217546,39780,5.468728004,131329,39249,25308,14376,8,14368,3,1930,0,0.002296771,mm10,mBC-0716-2
"C11,B4",709147,775603,518900,256703,380998,25,201725,202028,144278,57750,2.498320346,109314,35936,21799,12487,10,12477,1,1771,0,0.005369881,mm10,mBC-0716-2
"C11,B5",9771,5509,3689,1820,3602,0,1742,1756,1212,544,2.227941176,1032,19185,5687,3362,4,3358,2,818,0,0.115544967,empty,mBC-0716-2
"C11,B6",702014,779905,494055,285850,382709,3,217496,217846,183491,34355,5.341027507,121523,81207,53651,29964,18,29946,3,3115,0,0.002638082,mm10,mBC-0716-2
"C11,B7",18275,18760,14279,4481,9111,0,4076,4084,2891,1193,2.423302598,1885,807,426,257,0,257,0,118,0,0.042801556,empty,mBC-0716-2
"C11,B8",14583,15228,11053,4175,7480,0,3466,3478,2379,1099,2.164695177,1753,1568,962,591,0,591,0,255,0,0.049069374,empty,mBC-0716-2
"C11,B9",837945,910079,611072,299007,438350,50,232073,232465,194683,37782,5.152797629,123658,52943,33040,18150,7,18143,2,2390,0,0.000826765,mm10,mBC-0716-2
"C11,B10",17637,17642,13201,4441,8758,16,3937,3961,2684,1277,2.101801096,1852,628,352,209,0,209,0,90,0,0.038277512,empty,mBC-0716-2
"C11,B11",20256,21415,15091,6324,10393,22,4971,5016,3475,1541,2.255029202,2558,264,166,114,0,114,0,74,0,0,empty,mBC-0716-2
"C11,B12",19748,20516,15060,5456,10130,0,4725,4740,3279,1461,2.244353183,2287,1420,896,527,0,527,0,211,0,0.009487666,empty,mBC-0716-2
"C11,C1",24338,24687,18870,5817,11761,0,5087,5091,3594,1497,2.400801603,2269,486,309,221,0,221,0,127,0,0.009049774,empty,mBC-0716-2
"C11,C2",19367,19995,14676,5319,9721,0,4459,4468,3101,1367,2.268471105,2141,2486,1161,718,0,718,0,249,0,0.045961003,empty,mBC-0716-2
"C11,C3",26080,27347,19187,8160,13314,32,6497,6534,4756,1778,2.674915636,3338,512,283,190,0,190,0,104,0,0.036842105,empty,mBC-0716-2
"C11,C4",18665,19041,14204,4837,9222,1,4121,4138,2976,1162,2.561101549,1926,1994,1013,574,2,572,1,186,0,0.090909091,empty,mBC-0716-2
"C11,C5",3293531,3609467,2278288,1331179,1680837,8,1021441,1022961,831775,191186,4.350606216,567555,155043,100026,56411,19,56392,2,4641,0,0.00076252,mm10,mBC-0716-2
"C11,C6",18958,19085,14166,4919,9770,0,4562,4573,3284,1289,2.547711404,2204,2929,1390,819,2,817,1,285,0,0.055079559,empty,mBC-0716-2
"C11,C7",1099290,1250071,751822,498249,603419,11,372205,372620,258221,114399,2.257196304,215847,11862,6544,3768,1,3767,1,839,0,0.003451022,mm10,mBC-0716-2
"C11,C8",1917200,2097687,1364620,733067,1007049,3,578057,578893,439431,139462,3.150901321,316015,127120,80454,45032,16,45016,4,4018,0,0.00442065,mm10,mBC-0716-2
"C11,C9",13805,14181,10280,3901,7022,16,3336,3361,2410,951,2.534174553,1686,916,556,340,0,340,0,144,0,0.032352941,empty,mBC-0716-2
"C11,C10",14841,15186,11315,3871,7512,1,3457,3465,2460,1005,2.447761194,1644,1043,641,391,0,391,0,157,0,0.030690537,empty,mBC-0716-2
"C11,C11",13211,13637,10209,3428,6555,9,3055,3082,2084,998,2.088176353,1393,836,503,332,0,332,0,156,0,0.060240964,empty,mBC-0716-2
"C11,C12",21980,22699,16728,5971,11001,0,5108,5116,3641,1475,2.468474576,2487,1023,583,347,0,347,0,155,0,0.07204611,empty,mBC-0716-2
"C11,D1",12017,12321,8925,3396,6112,11,2856,2869,2011,858,2.343822844,1386,643,343,208,0,208,0,92,0,0.048076923,empty,mBC-0716-2
"C11,D2",22979,23326,17689,5637,11513,0,5020,5029,3497,1532,2.282637076,2318,2855,1796,1045,2,1043,1,374,0,0.069990412,empty,mBC-0716-2
"C11,D3",14622,15495,10741,4754,7639,0,3680,3686,2527,1159,2.180327869,1882,1157,688,435,0,435,0,197,0,0.036781609,empty,mBC-0716-2
"C11,D4",920075,1005881,666910,338971,488339,0,265413,265833,207721,58112,3.57449408,142369,61640,37419,21204,6,21198,2,2642,0,0.003255024,mm10,mBC-0716-2
"C11,D5",16941,17634,12686,4948,8798,0,4083,4088,2889,1199,2.409507923,2079,2425,990,579,0,579,0,241,0,0.039723661,empty,mBC-0716-2
"C11,D6",13598,14158,10105,4053,6962,1,3440,3446,2423,1023,2.368523949,1700,1050,557,342,0,342,0,185,0,0.084795322,empty,mBC-0716-2
"C11,D7",13433,13904,10131,3773,6688,0,3029,3036,2111,925,2.282162162,1471,2479,987,606,0,606,0,228,0,0.00990099,empty,mBC-0716-2
"C11,D8",17396,18158,13214,4944,8887,9,4194,4219,2946,1273,2.314218382,2065,878,549,329,0,329,0,144,0,0.082066869,empty,mBC-0716-2
"C11,D9",213441,221868,154197,67671,112572,0,56211,56305,44172,12133,3.640649468,29445,67465,44060,24868,10,24858,1,2926,0,0.00160914,mm10,mBC-0716-2
"C11,D10",17263,17806,13068,4738,8853,0,4209,4217,2984,1233,2.420113544,2015,721,421,265,0,265,0,114,0,0.064150943,empty,mBC-0716-2
"C11,D11",14016,14279,10704,3575,7069,1,3259,3264,2272,992,2.290322581,1475,1387,823,498,0,498,0,235,0,0.042168675,empty,mBC-0716-2
"C11,D12",22098,22714,16803,5911,11096,15,5140,5158,3476,1682,2.066587396,2456,12170,4052,2422,3,2419,1,655,0,0.033484911,empty,mBC-0716-2
"C11,E1",23325,23570,17848,5722,11513,0,5191,5199,3674,1525,2.409180328,2435,1451,890,566,0,566,0,246,0,0.058303887,empty,mBC-0716-2
"C11,E2",17329,17653,13297,4356,8704,0,3974,3988,2804,1184,2.368243243,1834,1543,903,544,0,544,0,205,0,0.051470588,empty,mBC-0716-2
"C11,E3",252183,293463,157198,136265,144591,34,99007,99166,47560,51606,0.921598264,60664,10614,4448,2506,4,2502,1,743,0,0.09392486,empty,mBC-0716-2
"C11,E4",16700,17327,12665,4662,8424,1,3885,3905,2780,1125,2.471111111,1919,2244,1106,669,0,669,0,237,0,0.062780269,empty,mBC-0716-2
"C11,E5",23079,23533,17847,5686,11435,0,5140,5151,3595,1556,2.310411311,2329,1578,965,627,0,627,0,248,0,0.057416268,empty,mBC-0716-2
"C11,E6",14429,14862,11110,3752,7247,3,3225,3244,2284,960,2.379166667,1518,1720,948,574,0,574,0,262,0,0.045296167,empty,mBC-0716-2
"C11,E7",14823,14829,11206,3623,7268,0,3239,3247,2215,1032,2.146317829,1511,998,581,384,0,384,0,170,0,0.096354167,empty,mBC-0716-2
"C11,E8",18468,19056,14155,4901,9375,0,4242,4254,3005,1249,2.40592474,2105,1685,958,604,0,604,0,222,0,0.067880795,empty,mBC-0716-2
"C11,E9",9381,9697,7058,2639,4748,0,2219,2228,1558,670,2.325373134,1098,937,577,358,0,358,0,137,0,0.019553073,empty,mBC-0716-2
"C11,E10",15045,15700,11251,4449,7527,0,3541,3552,2473,1079,2.291936979,1758,19678,5556,3289,2,3287,1,830,0,0.033769395,empty,mBC-0716-2
"C11,E11",10077,10370,7575,2795,5238,2,2486,2493,1739,754,2.306366048,1192,2046,874,570,0,570,0,205,0,0.052631579,empty,mBC-0716-2
"C11,E12",17050,17472,12801,4671,8603,0,4034,4045,2802,1243,2.254223652,1941,2081,771,495,0,495,0,206,0,0.022222222,empty,mBC-0716-2
"C11,F1",20097,20584,15221,5363,9995,7,4585,4602,3192,1410,2.263829787,2213,1617,754,495,0,495,0,229,0,0.03030303,empty,mBC-0716-2
"C11,F2",1718961,1912004,1213821,698183,920752,37,542090,542843,418742,124101,3.37420327,303836,151594,88167,49652,20,49632,2,4425,0,0.003223727,mm10,mBC-0716-2
"C11,F3",17320,17964,13131,4833,8866,0,4179,4185,2916,1269,2.29787234,2032,8207,2902,1763,3,1760,1,542,0,0.066477273,empty,mBC-0716-2
"C11,F4",16915,17207,12794,4413,8676,7,3976,3991,2809,1182,2.376480541,1971,515,215,137,0,137,0,76,0,0.051094891,empty,mBC-0716-2
"C11,F5",26566,27748,20240,7508,13528,20,6218,6250,4502,1748,2.575514874,3054,2479,1299,811,0,811,0,349,0,0.027127004,empty,mBC-0716-2
"C11,F6",25526,26088,19128,6960,12713,0,5889,5904,4133,1771,2.333709768,2871,1972,1165,715,0,715,0,295,0,0.032167832,empty,mBC-0716-2
"C11,F7",21755,22484,16720,5764,11092,0,5068,5089,3549,1540,2.304545455,2451,787,470,299,0,299,0,153,0,0.003344482,empty,mBC-0716-2
"C11,F8",1022845,1079215,760022,319193,518736,13,255520,255996,209326,46670,4.485236769,130376,5574,3087,1732,0,1732,0,475,0,0.000577367,mm10,mBC-0716-2
"C11,F9",16075,16393,12239,4154,7874,17,3591,3623,2560,1063,2.408278457,1764,1349,871,530,0,530,0,203,0,0.047169811,empty,mBC-0716-2
"C11,F10",1792222,1884934,1315452,569482,897268,1,473852,474606,347809,126797,2.743038084,244505,64462,43305,23983,7,23976,1,2924,0,0.00154321,mm10,mBC-0716-2
"C11,F11",12730,13097,9335,3762,6358,21,2949,2972,2066,906,2.280353201,1499,12027,4091,2528,1,2527,1,553,0,0.265532252,empty,mBC-0716-2
"C11,F12",15057,15686,11237,4449,7634,0,3553,3553,2496,1057,2.361400189,1856,223,141,100,0,100,0,59,0,0,empty,mBC-0716-2
"C11,G1",10698,10959,8333,2626,5509,5,2426,2434,1696,738,2.298102981,1104,1854,1069,687,0,687,0,236,0,0.03930131,empty,mBC-0716-2
"C11,G2",928617,962838,698962,263876,467571,2,231080,231452,179514,51938,3.456313297,114902,9780,4313,2528,0,2528,0,706,0,0.023338608,mm10,mBC-0716-2
"C11,G3",1354006,1531933,888020,643913,729154,13,475816,476377,347251,129126,2.689241516,275292,55523,34270,18945,6,18939,1,2518,0,0.006705739,mm10,mBC-0716-2
"C11,G4",2195112,2325553,1568765,756788,1091353,28,600195,601125,502984,98141,5.125115905,322734,692,350,204,0,204,0,121,0,0.009803922,empty,mBC-0716-2
"C11,G5",14935,15287,11421,3866,7557,8,3436,3454,2469,985,2.506598985,1625,1251,758,477,0,477,0,212,0,0.031446541,empty,mBC-0716-2
"C11,G6",26418,27040,20019,7021,13134,1,5884,5911,4201,1710,2.456725146,2811,216,145,109,0,109,0,73,0,0,empty,mBC-0716-2
"C11,G7",22250,22954,16986,5968,11145,8,5139,5156,3577,1579,2.265357821,2453,1849,1127,671,0,671,0,257,0,0.031296572,empty,mBC-0716-2
"C11,G8",16095,16698,12360,4338,8126,13,3831,3848,2686,1162,2.311531842,1817,1987,1041,667,1,666,1,265,0,0.094594595,empty,mBC-0716-2
"C11,G9",11600,11961,8810,3151,5945,1,2743,2748,1902,846,2.24822695,1344,1397,907,555,0,555,0,205,0,0.034234234,empty,mBC-0716-2
"C11,G10",14763,14826,11310,3516,7343,0,3241,3250,2319,931,2.490870032,1465,1296,775,496,0,496,0,241,0,0.050403226,empty,mBC-0716-2
"C11,G11",13229,13489,10227,3262,6618,0,2941,2946,2087,859,2.429569267,1384,698,400,261,0,261,0,129,0,0.053639847,empty,mBC-0716-2
"C11,G12",12101,12663,9197,3466,6286,0,2928,2936,2004,932,2.150214592,1396,1153,691,441,1,440,1,169,0,0.052272727,empty,mBC-0716-2
"C11,H1",1722564,1878883,1245046,633837,897987,1,495106,495919,412842,83077,4.969389843,266912,106681,67297,37486,16,37470,4,3673,0,0.001948225,mm10,mBC-0716-2
"C11,H2",25772,27145,19608,7537,13228,3,5978,6001,4251,1750,2.429142857,2934,1684,1117,709,2,707,1,316,0,0.042432815,empty,mBC-0716-2
"C11,H3",21564,22583,16146,6437,11071,1,5158,5171,3671,1500,2.447333333,2625,1701,995,608,0,608,0,235,0,0.057565789,empty,mBC-0716-2
"C11,H4",863753,980354,583297,397057,476042,34,296100,296524,200203,96321,2.078497939,173169,2498,1374,741,0,741,0,231,0,0.002699055,empty,mBC-0716-2
"C11,H5",19211,20132,14562,5570,9698,0,4556,4561,3191,1370,2.32919708,2193,1348,786,466,0,466,0,206,0,0.053648069,empty,mBC-0716-2
"C11,H6",14716,15272,11037,4235,7562,4,3525,3536,2481,1055,2.351658768,1712,2301,1154,703,0,703,0,266,0,0.046941679,empty,mBC-0716-2
"C11,H7",17933,18382,13359,5023,9046,16,4168,4193,2976,1217,2.445357436,1997,2317,1170,754,1,753,1,266,0,0.142098274,empty,mBC-0716-2
"C11,H8",14335,14510,10834,3676,7170,3,3246,3253,2322,931,2.494092374,1477,1552,943,581,0,581,0,240,0,0.063683305,empty,mBC-0716-2
"C11,H9",16658,17215,12690,4525,8502,0,3786,3791,2685,1106,2.427667269,1834,5593,1743,1061,1,1060,1,388,0,0.009433962,empty,mBC-0716-2
"C11,H10",227768,209855,202620,7235,105586,27,8889,8986,6754,2232,3.025985663,2779,23481,12783,7149,6,7143,1,1445,0,0.0149797,empty,mBC-0716-2
"C11,H11",1210790,1332249,875467,456782,652213,2,360287,360798,293845,66953,4.388824997,197786,2635,1617,919,0,919,0,269,0,0.009793254,empty,mBC-0716-2
"C11,H12",6516,6595,4898,1697,3432,3,1649,1655,1152,503,2.290258449,830,444,249,138,0,138,0,68,0,0.028985507,empty,mBC-0716-2
"C12,A1",15826,16010,11885,4125,8028,0,3704,3710,2563,1147,2.234524847,1777,1610,707,462,0,462,0,200,0,0.058441558,empty,mBC-0716-2
"C12,A2",20515,20994,15579,5415,10124,0,4458,4465,3078,1387,2.219178082,2162,841,498,286,0,286,0,137,0,0.073426573,empty,mBC-0716-2
"C12,A3",612046,636389,446306,190083,314369,6,160984,161330,129176,32154,4.017416185,83113,10703,4516,2587,1,2586,1,790,0,0.018561485,mm10,mBC-0716-2
"C12,A4",951625,985811,735774,250037,467039,1,207725,208194,176104,32090,5.487815519,100231,29452,19653,10909,9,10900,1,1671,0,0.001834862,mm10,mBC-0716-2
"C12,A5",18706,19428,14164,5264,9692,0,4611,4620,3220,1400,2.3,2257,1242,749,438,0,438,0,204,0,0.054794521,empty,mBC-0716-2
"C12,A6",22138,23306,16388,6918,11658,0,5845,5864,4198,1666,2.519807923,2986,9540,2976,1832,1,1831,1,568,0,0.04642272,empty,mBC-0716-2
"C12,A7",17459,18276,13190,5086,8886,0,4159,4167,2886,1281,2.2529274,2034,3305,1324,752,0,752,0,245,0,0.035904255,empty,mBC-0716-2
"C12,A8",12376,13030,9398,3632,6307,0,2878,2883,2026,857,2.364060677,1412,2614,1222,744,0,744,0,283,0,0.028225806,empty,mBC-0716-2
"C12,A9",20417,20622,15573,5049,10003,0,4371,4384,3120,1264,2.46835443,2074,1013,572,357,0,357,0,168,0,0.030812325,empty,mBC-0716-2
"C12,A10",16978,17094,12864,4230,8460,0,3864,3870,2701,1169,2.310521814,1816,265,169,116,0,116,0,73,0,0.017241379,empty,mBC-0716-2
"C12,A11",20182,20063,15203,4860,9844,24,4387,4422,3113,1309,2.378151261,2046,3695,1289,787,1,786,1,297,0,0.055979644,empty,mBC-0716-2
"C12,A12",22634,23165,17570,5595,11141,12,4945,4967,3482,1485,2.344781145,2332,1886,1166,679,1,678,1,230,0,0.088495575,empty,mBC-0716-2
"C12,B1",674198,703025,492910,210115,345213,4,179199,179487,139270,40217,3.462963423,92047,8570,4453,2548,3,2545,1,664,0,0.029862475,mm10,mBC-0716-2
"C12,B2",22828,23366,17268,6098,11249,0,5085,5094,3539,1555,2.275884244,2431,508,303,181,0,181,0,83,0,0.077348066,empty,mBC-0716-2
"C12,B3",22823,23702,17360,6342,11507,0,5337,5344,3844,1500,2.562666667,2584,879,519,336,0,336,0,153,0,0.089285714,empty,mBC-0716-2
"C12,B4",18051,18659,13664,4995,9099,6,4075,4099,2852,1247,2.287089014,1993,1317,675,426,0,426,0,168,0,0.061032864,empty,mBC-0716-2
"C12,B5",10668,6722,4749,1973,4153,6,2010,2031,1393,638,2.18338558,1083,639,419,241,0,241,0,118,0,0.033195021,empty,mBC-0716-2
"C12,B6",13945,14345,10437,3908,7082,0,3334,3337,2343,994,2.357142857,1635,14415,3978,2373,5,2368,2,605,0,0.146537162,empty,mBC-0716-2
"C12,B7",17937,18337,13867,4470,8888,8,3922,3950,2798,1152,2.428819444,1862,872,512,308,0,308,0,129,0,0.068181818,empty,mBC-0716-2
"C12,B8",14564,14894,11128,3766,7310,0,3309,3315,2343,972,2.410493827,1574,983,576,363,1,362,1,185,0,0.019337017,empty,mBC-0716-2
"C12,B9",839072,928527,600602,327925,447652,4,251348,251700,207869,43831,4.742511008,137477,36477,23462,13146,5,13141,1,1886,0,0.001598052,mm10,mBC-0716-2
"C12,B10",18704,18872,13864,5008,9323,17,4318,4353,3011,1342,2.24366617,2082,531,337,204,0,204,0,86,0,0.024509804,empty,mBC-0716-2
"C12,B11",17632,18338,13495,4843,8678,0,3971,3982,2754,1228,2.24267101,1904,200,116,89,0,89,0,51,0,0.123595506,empty,mBC-0716-2
"C12,B12",19570,20174,14755,5419,10037,0,4666,4670,3357,1313,2.556740289,2285,917,532,315,0,315,0,159,0,0.044444444,empty,mBC-0716-2
"C12,C1",24876,25124,19068,6056,12069,1,5279,5297,3692,1605,2.300311526,2479,1020,369,246,0,246,0,125,0,0.036585366,empty,mBC-0716-2
"C12,C2",20241,20750,15343,5407,10044,1,4560,4575,3183,1392,2.286637931,2177,2501,1102,660,1,659,1,233,0,0.04400607,empty,mBC-0716-2
"C12,C3",21764,23014,16474,6540,11048,12,5262,5288,3562,1726,2.06373117,2706,2414,857,512,0,512,0,183,0,0.03125,empty,mBC-0716-2
"C12,C4",19124,19352,14623,4729,9455,2,4170,4178,2882,1296,2.223765432,1930,1037,624,355,1,354,1,154,0,0.031073446,empty,mBC-0716-2
"C12,C5",18845,19684,14001,5683,9627,0,4574,4583,3198,1385,2.309025271,2258,4165,1450,873,1,872,1,314,0,0.033256881,empty,mBC-0716-2
"C12,C6",18511,18914,13869,5045,9248,25,4240,4275,2999,1276,2.35031348,2006,3072,1329,791,3,788,2,253,0,0.092639594,empty,mBC-0716-2
"C12,C7",18106,18803,13877,4926,9105,17,4126,4156,2842,1314,2.162861492,2027,1792,568,372,0,372,0,154,0,0.002688172,empty,mBC-0716-2
"C12,C8",16608,17262,12628,4634,8399,3,3839,3853,2627,1226,2.14274062,1882,1184,630,366,0,366,0,173,0,0.043715847,empty,mBC-0716-2
"C12,C9",13745,13798,10368,3430,6894,0,3214,3217,2320,897,2.586399108,1524,926,492,306,0,306,0,133,0,0.058823529,empty,mBC-0716-2
"C12,C10",15298,16066,11508,4558,7738,14,3571,3587,2489,1098,2.266848816,1767,824,504,310,1,309,1,142,0,0.029126214,empty,mBC-0716-2
"C12,C11",12685,13100,9578,3522,6389,1,2992,3001,2047,954,2.145702306,1452,853,493,306,0,306,0,141,0,0.045751634,empty,mBC-0716-2
"C12,C12",21541,22188,16402,5786,10649,3,4944,4952,3533,1419,2.489781536,2290,1470,638,366,0,366,0,151,0,0.06010929,empty,mBC-0716-2
"C12,D1",12693,13285,9598,3687,6467,24,2975,3006,2121,885,2.396610169,1462,576,326,194,0,194,0,82,0,0.072164948,empty,mBC-0716-2
"C12,D2",23024,23503,17484,6019,11476,0,5072,5087,3596,1491,2.411804158,2416,3961,1703,1077,0,1077,0,366,0,0.030640669,empty,mBC-0716-2
"C12,D3",889713,952676,658270,294406,461229,31,236444,236856,185434,51422,3.606121893,123858,33136,20089,10975,3,10972,1,1808,0,0.006015312,mm10,mBC-0716-2
"C12,D4",19301,19342,13833,5509,9242,18,4427,4461,3219,1242,2.59178744,2186,18940,5706,3559,2,3557,1,874,0,0.178521226,empty,mBC-0716-2
"C12,D5",15329,15777,11806,3971,7593,0,3404,3415,2398,1017,2.357915438,1612,863,444,285,0,285,0,135,0,0.063157895,empty,mBC-0716-2
"C12,D6",13906,14403,10489,3914,7077,1,3302,3319,2245,1074,2.090316574,1642,1002,610,395,0,395,0,177,0,0.058227848,empty,mBC-0716-2
"C12,D7",14340,14823,10939,3884,7211,3,3383,3397,2324,1073,2.165890028,1634,1185,717,393,0,393,0,156,0,0.005089059,empty,mBC-0716-2
"C12,D8",17648,18622,13244,5378,8920,13,4243,4266,2970,1296,2.291666667,2154,2840,1027,633,0,633,0,229,0,0.056872038,empty,mBC-0716-2
"C12,D9",5868,6238,4386,1852,3143,0,1550,1552,1104,448,2.464285714,788,1419,826,488,0,488,0,232,0,0.016393443,empty,mBC-0716-2
"C12,D10",14801,15009,11188,3821,7250,11,3271,3287,2286,1001,2.283716284,1529,808,426,230,0,230,0,112,0,0.091304348,empty,mBC-0716-2
"C12,D11",1672028,1873978,1167528,706450,896116,3,527990,528810,425384,103426,4.112930984,295763,257366,165414,91316,40,91276,2,5669,0,0.000810728,mm10,mBC-0716-2
"C12,D12",22558,22896,17110,5786,11023,13,4964,4991,3405,1586,2.146910467,2328,2201,1164,687,0,687,0,238,0,0.081513828,empty,mBC-0716-2
"C12,E1",1014418,1056140,748496,307644,507118,2,260690,261129,202781,58348,3.475371906,133206,14765,8677,4998,3,4995,1,1121,0,0.017617618,mm10,mBC-0716-2
"C12,E2",829687,863230,599571,263659,421418,1,224402,224754,172092,52662,3.267859177,115872,17893,10312,5811,2,5809,1,1276,0,0.008607333,mm10,mBC-0716-2
"C12,E3",16995,17594,12843,4751,8553,30,3821,3861,2786,1075,2.591627907,1857,4046,1744,1025,0,1025,0,356,0,0.050731707,empty,mBC-0716-2
"C12,E4",16835,17523,12910,4613,8511,5,3892,3906,2774,1132,2.450530035,1934,1023,652,393,0,393,0,171,0,0.03307888,empty,mBC-0716-2
"C12,E5",23431,24054,17979,6075,11503,0,5145,5158,3670,1488,2.466397849,2436,1025,659,449,0,449,0,209,0,0.011135857,empty,mBC-0716-2
"C12,E6",15229,15828,11565,4263,7644,0,3513,3518,2475,1043,2.372962608,1704,1317,789,508,0,508,0,242,0,0.011811024,empty,mBC-0716-2
"C12,E7",937829,1011208,674866,336342,484896,3,263357,263747,203794,59953,3.399229396,141769,55176,34358,19393,10,19383,2,2444,0,0.003043904,mm10,mBC-0716-2
"C12,E8",932085,1013030,678989,334041,490161,1,263163,263569,215674,47895,4.503058774,139958,92386,59964,33296,14,33282,1,3136,0,0.002193378,mm10,mBC-0716-2
"C12,E9",10078,10181,7701,2480,4981,0,2290,2292,1641,651,2.520737327,1063,917,541,317,0,317,0,122,0,0.041009464,empty,mBC-0716-2
"C12,E10",1812912,1989046,1278185,710861,943929,0,552816,553680,454710,98970,4.594422552,302087,106105,69572,39361,18,39343,1,3914,0,0.003177185,mm10,mBC-0716-2
"C12,E11",10246,10636,7886,2750,5187,0,2401,2404,1658,746,2.222520107,1131,1061,706,416,0,416,0,155,0,0.038461538,empty,mBC-0716-2
"C12,E12",17158,17815,12902,4913,8997,16,4344,4363,3026,1337,2.263275991,2167,962,593,347,0,347,0,137,0,0.060518732,empty,mBC-0716-2
"C12,F1",19528,20168,14783,5385,9685,0,4417,4425,3056,1369,2.23228634,2119,1418,736,445,0,445,0,193,0,0.042696629,empty,mBC-0716-2
"C12,F2",24424,25018,18658,6360,12212,0,5638,5642,3966,1676,2.366348449,2642,2225,1301,825,0,825,0,342,0,0.053333333,empty,mBC-0716-2
"C12,F3",1700617,1895178,1180601,714577,908351,1,543315,544030,412570,131460,3.138369086,310136,81052,54700,30699,18,30681,2,3140,0,0.001825234,mm10,mBC-0716-2
"C12,F4",885293,934273,638885,295388,456497,1,235883,236258,203422,32836,6.195090754,124053,34193,22366,12302,2,12300,1,1810,0,0.001219512,mm10,mBC-0716-2
"C12,F5",1070599,1229215,708133,521082,593044,1,383049,383556,248160,135396,1.832845874,231228,20611,9067,5127,3,5124,1,1171,0,0.029859485,mm10,mBC-0716-2
"C12,F6",25671,26420,19575,6845,12662,0,5802,5810,4115,1695,2.427728614,2643,1742,1053,636,1,635,1,246,0,0.040944882,empty,mBC-0716-2
"C12,F7",22092,23050,16788,6262,11211,4,5193,5214,3570,1644,2.171532847,2461,751,477,281,2,279,1,125,0,0.007168459,empty,mBC-0716-2
"C12,F8",1985047,2263459,1340305,923154,1080520,4,685492,686346,557606,128740,4.331256797,395040,10115,6366,3560,1,3559,1,792,0,0.002247822,mm10,mBC-0716-2
"C12,F9",16299,16471,12279,4192,8059,9,3698,3715,2628,1087,2.417663293,1724,1273,698,407,1,406,1,156,0,0.009852217,empty,mBC-0716-2
"C12,F10",23149,23369,17736,5633,11236,20,4944,4978,3533,1445,2.444982699,2308,3574,1466,877,1,876,1,293,0,0.063926941,empty,mBC-0716-2
"C12,F11",12428,12658,9398,3260,6325,0,2846,2859,2054,805,2.551552795,1374,1081,568,350,0,350,0,154,0,0.088571429,empty,mBC-0716-2
"C12,F12",15575,16002,11698,4304,7744,15,3585,3607,2492,1115,2.234977578,1796,165,89,55,0,55,0,33,0,0,empty,mBC-0716-2
"C12,G1",10600,10693,8277,2416,5284,0,2338,2341,1626,715,2.274125874,1058,1262,765,445,0,445,0,174,0,0.015730337,empty,mBC-0716-2
"C12,G2",653239,673067,500382,172685,329206,0,150133,150422,113196,37226,3.040777951,73321,6535,4069,2255,1,2254,1,589,0,0.002661934,mm10,mBC-0716-2
"C12,G3",23611,24554,17872,6682,11838,4,5542,5553,3794,1759,2.156907334,2696,1460,919,539,0,539,0,215,0,0.033395176,empty,mBC-0716-2
"C12,G4",30941,31654,23632,8022,15270,1,6796,6806,4897,1909,2.565217391,3209,134,83,55,0,55,0,42,0,0.018181818,empty,mBC-0716-2
"C12,G5",15001,15684,11498,4186,7500,0,3502,3512,2472,1040,2.376923077,1644,988,552,377,0,377,0,186,0,0.037135279,empty,mBC-0716-2
"C12,G6",26519,27241,20374,6867,13077,0,5745,5757,4058,1699,2.388463802,2692,183,128,94,0,94,0,56,0,0.106382979,empty,mBC-0716-2
"C12,G7",1109915,1229971,786834,443137,592334,1,343914,344463,282791,61672,4.585403425,188061,83590,54775,30562,6,30556,1,3063,0,0.001178165,mm10,mBC-0716-2
"C12,G8",16528,17173,12459,4714,8324,0,3905,3918,2687,1231,2.182778229,1910,1335,797,495,0,495,0,212,0,0.026262626,empty,mBC-0716-2
"C12,G9",12365,12687,9413,3274,6094,23,2807,2830,2033,797,2.550815558,1344,1116,665,395,0,395,0,185,0,0.043037975,empty,mBC-0716-2
"C12,G10",744231,812411,529957,282454,399710,0,228361,228707,172456,56251,3.065829941,124259,8363,5323,2936,2,2934,2,745,0,0.001363327,mm10,mBC-0716-2
"C12,G11",13758,13771,10482,3289,6660,4,2985,2994,2096,898,2.334075724,1359,2026,803,509,0,509,0,212,0,0.023575639,empty,mBC-0716-2
"C12,G12",12424,12769,9397,3372,6229,0,2918,2923,2053,870,2.359770115,1392,1099,654,381,0,381,0,160,0,0.018372703,empty,mBC-0716-2
"C12,H1",22463,23635,17044,6591,11340,1,5188,5198,3691,1507,2.449236894,2600,925,517,290,0,290,0,140,0,0.003448276,empty,mBC-0716-2
"C12,H2",1008395,1106649,728305,378344,536274,0,303567,304001,203303,100698,2.018937814,164068,23088,15206,8530,7,8523,1,1415,0,0.007039775,mm10,mBC-0716-2
"C12,H3",26238,27601,19792,7809,13158,1,6257,6289,4495,1794,2.505574136,3100,2326,1036,598,1,597,1,243,0,0.048576214,empty,mBC-0716-2
"C12,H4",16302,16992,11995,4997,8195,3,3852,3861,2684,1177,2.280373832,1920,766,266,166,1,165,1,83,0,0.109090909,empty,mBC-0716-2
"C12,H5",19680,20481,14839,5642,9857,39,4599,4644,3283,1361,2.412196914,2290,1136,674,398,0,398,0,176,0,0.027638191,empty,mBC-0716-2
"C12,H6",16012,16154,12256,3898,7942,0,3603,3611,2549,1062,2.400188324,1620,1509,972,610,0,610,0,218,0,0.008196721,empty,mBC-0716-2
"C12,H7",18239,18428,13783,4645,9205,0,4226,4239,2916,1323,2.204081633,1961,1171,772,475,0,475,0,195,0,0.04,empty,mBC-0716-2
"C12,H8",805157,965997,507770,458227,470928,19,321440,321881,256285,65596,3.90702177,198962,64994,42892,23779,9,23770,1,2771,0,0.000631048,mm10,mBC-0716-2
"C12,H9",19932,20238,15073,5165,10106,5,4651,4669,3421,1248,2.741185897,2248,1192,702,415,0,415,0,204,0,0.057831325,empty,mBC-0716-2
"C12,H10",16490,16936,12356,4580,8254,0,3842,3850,2723,1127,2.416149068,1869,2498,1028,639,1,638,1,249,0,0.051724138,empty,mBC-0716-2
"C12,H11",18493,19228,13882,5346,9241,0,4330,4336,3007,1329,2.262603461,2112,190,111,74,0,74,0,48,0,0,empty,mBC-0716-2
"C12,H12",6688,6804,5028,1776,3490,0,1727,1729,1214,515,2.357281553,824,488,304,189,0,189,0,86,0,0.010582011,empty,mBC-0716-2
"D1,A1",15713,16340,11904,4436,8046,2,3781,3794,2703,1091,2.477543538,1805,1980,1192,758,1,757,1,261,0,0.022457067,empty,mBC-0716-2
"D1,A2",1022764,1042435,766780,275655,485548,3,231260,231752,193907,37845,5.123715154,112267,38254,21833,12186,12,12174,4,1777,0,0.004271398,mm10,mBC-0716-2
"D1,A3",1073184,1176590,758083,418507,557057,1,311903,312364,265316,47048,5.63926203,170237,115535,67517,37366,18,37348,2,3621,0,0.005703117,mm10,mBC-0716-2
"D1,A4",22848,23296,17522,5774,11255,0,5005,5017,3642,1375,2.648727273,2338,2275,1115,662,0,662,0,246,0,0.03021148,empty,mBC-0716-2
"D1,A5",18184,19095,13768,5327,9474,1,4401,4408,3130,1278,2.44913928,2185,1801,1061,674,0,674,0,314,0,0.035608309,empty,mBC-0716-2
"D1,A6",14220,14922,10716,4206,7280,0,3410,3421,2395,1026,2.334307992,1687,1732,1024,618,1,617,1,263,0,0.050243112,empty,mBC-0716-2
"D1,A7",772594,868692,546345,322347,424296,2,247696,248037,176719,71318,2.477901792,139488,33529,21333,11969,3,11966,1,1814,0,0.002339963,mm10,mBC-0716-2
"D1,A8",501806,560712,362456,198256,276437,1,152621,152836,112049,40787,2.747174345,84860,72032,47690,26219,8,26211,2,2752,0,0.002327267,mm10,mBC-0716-2
"D1,A9",21483,21948,16395,5553,10649,30,4812,4856,3570,1286,2.776049767,2288,1578,866,530,0,530,0,233,0,0.041509434,empty,mBC-0716-2
"D1,A10",17272,17618,13146,4472,8648,6,3990,4002,2822,1180,2.391525424,1885,699,314,214,1,213,1,126,0,0.051643192,empty,mBC-0716-2
"D1,A11",19771,20564,14951,5613,10205,1,4713,4726,3289,1437,2.288796103,2357,1466,828,504,1,503,1,233,0,0.085487078,empty,mBC-0716-2
"D1,A12",21855,22003,16674,5329,10575,1,4619,4632,3308,1324,2.498489426,2147,2784,1758,977,0,977,0,324,0,0.054247697,empty,mBC-0716-2
"D1,B1",20564,20791,15590,5201,10036,34,4457,4515,3151,1364,2.310117302,2092,2167,1255,728,1,727,1,252,0,0.01650619,empty,mBC-0716-2
"D1,B2",22351,22729,16683,6046,11055,17,5065,5090,3570,1520,2.348684211,2411,2746,1107,657,0,657,0,209,0,0.127853881,empty,mBC-0716-2
"D1,B3",19557,20226,14920,5306,9851,0,4491,4504,3182,1322,2.406959153,2109,1941,1120,668,0,668,0,243,0,0.038922156,empty,mBC-0716-2
"D1,B4",18318,18981,13967,5014,9112,0,4290,4310,3078,1232,2.498376623,2070,9847,3191,1926,1,1925,1,560,0,0.047272727,empty,mBC-0716-2
"D1,B5",11604,7774,5267,2507,4700,4,2354,2380,1695,685,2.474452555,1287,3613,1300,714,1,713,1,262,0,0.032258065,empty,mBC-0716-2
"D1,B6",874557,965942,610205,355737,464534,4,268367,268743,207373,61370,3.379061431,150620,75942,50263,28255,16,28239,1,3007,0,0.001204009,mm10,mBC-0716-2
"D1,B7",17034,17597,13069,4528,8691,0,3990,4003,2727,1276,2.137147335,1911,3969,1378,850,1,849,1,308,0,0.06360424,empty,mBC-0716-2
"D1,B8",13784,14228,10543,3685,6912,0,3146,3151,2259,892,2.532511211,1468,1307,775,507,1,506,1,261,0,0.029644269,empty,mBC-0716-2
"D1,B9",15914,16496,12118,4378,7960,21,3605,3640,2515,1125,2.235555556,1770,906,531,337,0,337,0,154,0,0.038575668,empty,mBC-0716-2
"D1,B10",18358,18070,13116,4954,8961,0,4150,4164,2884,1280,2.253125,2052,8471,2621,1565,1,1564,1,459,0,0.099104859,empty,mBC-0716-2
"D1,B11",21444,22234,16201,6033,10447,15,4882,4910,3430,1480,2.317567568,2373,610,288,178,0,178,0,88,0,0.005617978,empty,mBC-0716-2
"D1,B12",20210,21013,15254,5759,10168,19,4767,4802,3307,1495,2.212040134,2306,6774,2615,1604,1,1603,1,448,0,0.161572052,empty,mBC-0716-2
"D1,C1",23023,23329,17990,5339,11154,7,4705,4725,3331,1394,2.389526542,2114,1254,724,446,1,445,1,207,0,0.035955056,empty,mBC-0716-2
"D1,C2",19773,20579,14886,5693,9890,22,4573,4608,3215,1393,2.307968413,2231,2253,1462,841,1,840,1,276,0,0.048809524,empty,mBC-0716-2
"D1,C3",1744700,1924163,1220150,704013,917205,26,544126,544892,456267,88625,5.148287729,301721,46816,28754,15993,10,15983,3,2262,0,0.003003191,mm10,mBC-0716-2
"D1,C4",18755,18582,14165,4417,9238,1,4103,4129,2929,1200,2.440833333,1910,1663,982,619,0,619,0,222,0,0.030694669,empty,mBC-0716-2
"D1,C5",18061,18877,13695,5182,9126,20,4273,4307,2959,1348,2.195103858,2150,1530,899,542,0,542,0,244,0,0.012915129,empty,mBC-0716-2
"D1,C6",17839,18460,13442,5018,9178,1,4313,4319,3102,1217,2.548890715,2092,1603,918,593,1,592,1,247,0,0.018581081,empty,mBC-0716-2
"D1,C7",18541,19141,13948,5193,9481,0,4487,4497,3227,1270,2.540944882,2244,561,341,215,0,215,0,109,0,0.079069767,empty,mBC-0716-2
"D1,C8",16142,16516,12203,4313,8126,0,3744,3757,2613,1144,2.284090909,1798,7403,2715,1552,1,1551,1,511,0,0.037395229,empty,mBC-0716-2
"D1,C9",14751,15146,10770,4376,7269,3,3514,3536,2489,1047,2.377268386,1788,20328,6289,3799,4,3795,3,893,0,0.087483531,empty,mBC-0716-2
"D1,C10",14722,15114,11356,3758,7442,8,3401,3414,2308,1106,2.086799277,1607,1699,848,520,0,520,0,225,0,0.053846154,empty,mBC-0716-2
"D1,C11",12477,13262,9393,3869,6522,3,3123,3130,2210,920,2.402173913,1594,1170,715,448,2,446,1,199,0,0.038116592,empty,mBC-0716-2
"D1,C12",880696,960414,627945,332469,458811,1,253680,254071,210956,43115,4.892867911,138568,44911,27175,15058,5,15053,1,2059,0,0.005978875,mm10,mBC-0716-2
"D1,D1",17152,18010,13027,4983,8852,0,4163,4172,3143,1029,3.054421769,2001,1226,748,464,0,464,0,168,0,0.006465517,empty,mBC-0716-2
"D1,D2",1408553,1543446,951936,591510,726088,7,445956,446565,356862,89703,3.978261597,246948,143754,94740,52222,22,52200,1,4178,0,0.002049808,mm10,mBC-0716-2
"D1,D3",14966,15509,11273,4236,7754,0,3693,3697,2564,1133,2.263018535,1852,1840,1101,635,0,635,0,258,0,0.048818898,empty,mBC-0716-2
"D1,D4",17796,18537,13309,5228,9091,0,4364,4372,3196,1176,2.717687075,2118,1742,1021,661,0,661,0,273,0,0.016641452,empty,mBC-0716-2
"D1,D5",14761,15394,11141,4253,7438,3,3431,3438,2498,940,2.657446809,1691,1463,856,519,0,519,0,202,0,0.053949904,empty,mBC-0716-2
"D1,D6",13921,14460,10524,3936,6884,37,3256,3299,2265,1034,2.190522244,1572,1672,855,537,0,537,0,263,0,0.074487896,empty,mBC-0716-2
"D1,D7",13634,14145,10241,3904,7002,3,3292,3304,2298,1006,2.284294235,1627,1626,984,617,0,617,0,241,0,0.084278768,empty,mBC-0716-2
"D1,D8",17064,17930,12963,4967,8585,0,3984,3994,2827,1167,2.422450728,1934,1135,724,452,0,452,0,204,0,0.033185841,empty,mBC-0716-2
"D1,D9",255959,257491,188162,69329,129501,0,61277,61370,49290,12080,4.080298013,30547,30061,18050,10220,7,10213,1,1812,0,0.006364437,mm10,mBC-0716-2
"D1,D10",13929,14533,10572,3961,7130,16,3324,3348,2300,1048,2.194656489,1658,1205,622,370,0,370,0,139,0,0.051351351,empty,mBC-0716-2
"D1,D11",14422,14730,11156,3574,7254,0,3351,3359,2395,964,2.484439834,1559,1737,1034,655,1,654,1,296,0,0.029051988,empty,mBC-0716-2
"D1,D12",1302854,1350516,962475,388041,648300,72,324791,325391,250064,75327,3.319712719,166150,88163,52914,29720,11,29709,2,3442,0,0.00407284,mm10,mBC-0716-2
"D1,E1",3311224,3645498,2281174,1364324,1680656,1,1024587,1026019,821358,204661,4.013260953,574584,208545,120175,65631,31,65600,6,5245,0,0.002972561,mm10,mBC-0716-2
"D1,E2",17291,18031,13348,4683,8673,0,3882,3896,2794,1102,2.5353902,1853,2268,1287,758,1,757,1,257,0,0.054161162,empty,mBC-0716-2
"D1,E3",12698,13250,9817,3433,6467,7,2922,2938,2090,848,2.464622642,1383,2761,1627,981,0,981,0,342,0,0.028542304,empty,mBC-0716-2
"D1,E4",16680,17253,12526,4727,8318,6,3864,3870,2769,1101,2.514986376,1926,7418,3002,1784,3,1781,2,490,0,0.190342504,empty,mBC-0716-2
"D1,E5",22633,23371,17467,5904,11159,23,4878,4913,3426,1487,2.30396772,2240,2083,1197,757,0,757,0,324,0,0.030383091,empty,mBC-0716-2
"D1,E6",15451,15811,11570,4241,7764,13,3544,3566,2519,1047,2.405921681,1798,1755,1071,655,0,655,0,281,0,0.039694656,empty,mBC-0716-2
"D1,E7",14797,15132,11304,3828,7378,18,3259,3283,2268,1015,2.234482759,1518,1936,974,640,0,640,0,253,0,0.0625,empty,mBC-0716-2
"D1,E8",18675,19142,14344,4798,9351,0,4204,4213,2944,1269,2.319936958,1971,3993,1715,1013,1,1012,1,327,0,0.038537549,empty,mBC-0716-2
"D1,E9",10117,10212,7707,2505,4949,0,2225,2229,1585,644,2.461180124,1028,1215,692,398,0,398,0,162,0,0.050251256,empty,mBC-0716-2
"D1,E10",13984,14108,10521,3587,7009,0,3186,3186,2208,978,2.257668712,1502,4350,1642,1015,2,1013,2,350,0,0.048371175,empty,mBC-0716-2
"D1,E11",9943,10403,7545,2858,5046,1,2421,2426,1659,767,2.162972621,1170,1292,719,435,1,434,1,203,0,0.057603687,empty,mBC-0716-2
"D1,E12",581549,625790,427417,198373,308109,34,158144,158414,117597,40817,2.881078962,83689,36907,24116,13238,7,13231,2,1921,0,0.002040662,mm10,mBC-0716-2
"D1,F1",19676,20654,14838,5816,9909,1,4608,4627,3247,1380,2.352898551,2320,14902,4764,2853,1,2852,1,769,0,0.055399719,empty,mBC-0716-2
"D1,F2",25482,26628,18835,7793,13000,0,6244,6261,4442,1819,2.4420011,3181,3625,2190,1302,0,1302,0,467,0,0.012288786,empty,mBC-0716-2
"D1,F3",17860,18686,13374,5312,9146,0,4471,4482,3062,1420,2.156338028,2255,2303,1444,916,0,916,0,357,0,0.017467249,empty,mBC-0716-2
"D1,F4",17265,17653,12940,4713,8802,0,4065,4078,2929,1149,2.549173194,1971,4309,1572,961,1,960,1,363,0,0.051041667,empty,mBC-0716-2
"D1,F5",26302,26937,19899,7038,13206,20,6142,6175,4344,1831,2.372474058,3019,2770,1564,985,0,985,0,395,0,0.025380711,empty,mBC-0716-2
"D1,F6",25331,26204,19053,7151,12693,4,5882,5895,4080,1815,2.247933884,2848,2588,1430,857,0,857,0,335,0,0.035005834,empty,mBC-0716-2
"D1,F7",1193104,1307315,846810,460505,626549,0,357430,357956,283700,74256,3.820566688,195609,46529,30591,17224,12,17212,3,2227,0,0.001684871,mm10,mBC-0716-2
"D1,F8",25475,26624,19428,7196,13011,96,5931,6050,4315,1735,2.4870317,2995,410,238,170,0,170,0,117,0,0.005882353,empty,mBC-0716-2
"D1,F9",918334,1011818,647727,364091,489941,1,282148,282578,189105,93473,2.023097579,158285,64800,42273,23451,7,23444,1,2687,0,0.002004777,mm10,mBC-0716-2
"D1,F10",1168004,1268450,837527,430923,601149,0,333239,333726,257511,76215,3.378744342,179888,80214,51707,28311,14,28297,2,2971,0,0.00314521,mm10,mBC-0716-2
"D1,F11",12102,12362,9115,3247,6156,0,2825,2827,2000,827,2.418379686,1366,1237,709,465,0,465,0,225,0,0.002150538,empty,mBC-0716-2
"D1,F12",15038,15609,11395,4214,7529,0,3485,3493,2482,1011,2.454995054,1700,219,128,88,0,88,0,59,0,0.022727273,empty,mBC-0716-2
"D1,G1",10517,10800,8157,2643,5327,7,2378,2387,1682,705,2.385815603,1057,2255,1416,824,0,824,0,282,0,0.009708738,empty,mBC-0716-2
"D1,G2",22471,23069,17079,5990,11357,15,5081,5111,3705,1406,2.635135135,2389,1376,706,434,0,434,0,232,0,0.025345622,empty,mBC-0716-2
"D1,G3",925690,1050022,644351,405671,503079,22,293050,293530,242458,51072,4.747376253,167631,157441,94656,51922,22,51900,4,4308,0,0.009344894,mm10,mBC-0716-2
"D1,G4",838561,870080,618110,251970,421192,2,213497,213946,173103,40843,4.238253801,109014,310,173,120,0,120,0,69,0,0,empty,mBC-0716-2
"D1,G5",711072,780347,510539,269808,377172,2,205692,206020,174852,31168,5.6099846,112156,73140,45769,25430,9,25421,1,2904,0,0.002281578,mm10,mBC-0716-2
"D1,G6",26008,26437,19838,6599,12725,0,5614,5628,3905,1723,2.266395821,2609,293,189,136,0,136,0,83,0,0.022058824,empty,mBC-0716-2
"D1,G7",1204746,1329229,850488,478741,634828,20,368984,369590,302977,66613,4.548316395,201856,90697,52462,29579,15,29564,3,3101,0,0.006291436,mm10,mBC-0716-2
"D1,G8",16024,16795,12136,4659,8225,0,3918,3928,2734,1194,2.289782245,1922,1914,1175,683,1,682,1,292,0,0.039589443,empty,mBC-0716-2
"D1,G9",11807,11984,8948,3036,5857,0,2721,2731,1931,800,2.41375,1258,1481,886,557,0,557,0,245,0,0.007181329,empty,mBC-0716-2
"D1,G10",14511,14622,11108,3514,7272,13,3329,3347,2344,1003,2.336989033,1600,1610,967,571,0,571,0,268,0,0.07530648,empty,mBC-0716-2
"D1,G11",580214,605498,438183,167315,296601,2,140086,140358,109443,30915,3.540126152,69972,37502,24627,13775,6,13769,1,1922,0,0.000581015,mm10,mBC-0716-2
"D1,G12",11861,12630,9012,3618,6212,0,2937,2945,2049,896,2.286830357,1472,1268,756,438,0,438,0,170,0,0.057077626,empty,mBC-0716-2
"D1,H1",22807,23330,17450,5880,11179,0,5141,5160,3660,1500,2.44,2386,2712,1216,734,0,734,0,284,0,0.042234332,empty,mBC-0716-2
"D1,H2",2584430,2870376,1795855,1074521,1323902,1,792939,794135,601076,193059,3.113431645,446751,281071,178399,98772,36,98736,2,5578,0,0.001448307,mm10,mBC-0716-2
"D1,H3",22106,22796,16667,6129,11176,1,5275,5285,3786,1499,2.525683789,2643,2186,1310,768,0,768,0,304,0,0.029947917,empty,mBC-0716-2
"D1,H4",15931,16018,12196,3822,7840,61,3547,3616,2577,1039,2.48026949,1653,267,180,139,0,139,0,96,0,0,empty,mBC-0716-2
"D1,H5",19709,20470,14895,5575,9912,4,4615,4630,3289,1341,2.452647278,2269,4894,1953,1199,1,1198,1,417,0,0.07345576,empty,mBC-0716-2
"D1,H6",16222,16678,12206,4472,8319,0,3892,3901,2718,1183,2.297548605,1935,2520,1362,812,0,812,0,334,0,0.025862069,empty,mBC-0716-2
"D1,H7",604784,642293,434364,207929,318149,0,167689,167921,130771,37150,3.520080754,90636,3180,1760,1024,0,1024,0,436,0,0.084960938,mm10,mBC-0716-2
"D1,H8",15183,15807,11559,4248,7758,0,3629,3641,2588,1053,2.457739791,1736,2365,1341,785,0,785,0,323,0,0.03566879,empty,mBC-0716-2
"D1,H9",19846,20510,14929,5581,9917,1,4651,4663,3325,1338,2.485052317,2236,1656,930,604,1,603,1,287,0,0.116086235,empty,mBC-0716-2
"D1,H10",16983,17768,12613,5155,8729,5,4173,4180,2966,1214,2.443163097,2084,1851,1156,664,0,664,0,321,0,0.045180723,empty,mBC-0716-2
"D1,H11",18173,19108,13793,5315,9247,0,4385,4387,3056,1331,2.296018032,2143,252,144,103,0,103,0,77,0,0.009708738,empty,mBC-0716-2
"D1,H12",6701,7146,5076,2070,3517,20,1668,1693,1171,522,2.243295019,837,636,371,241,0,241,0,120,0,0.087136929,empty,mBC-0716-2
"D2,A1",767017,914414,485906,428508,449734,3,306630,307022,234104,72918,3.210510436,188053,53410,33270,17949,7,17942,3,2411,0,0.002340876,mm10,mBC-0716-2
"D2,A2",18751,19008,14212,4796,8984,0,3972,3991,2824,1167,2.419880034,1884,9767,3446,2082,2,2080,1,551,0,0.155288462,empty,mBC-0716-2
"D2,A3",16089,16433,12273,4160,7963,11,3633,3661,2614,1047,2.496657116,1699,961,548,336,0,336,0,165,0,0,empty,mBC-0716-2
"D2,A4",1020919,1093545,750010,343535,516760,1,270921,271382,226716,44666,5.075807102,140705,33463,20517,11305,5,11300,1,1788,0,0.006902655,mm10,mBC-0716-2
"D2,A5",900936,1025773,616447,409326,494425,0,299552,299959,238501,61458,3.880715285,172030,101055,63044,35137,12,35125,1,3381,0,0.002733096,mm10,mBC-0716-2
"D2,A6",12525,13171,9334,3837,6349,3,3055,3062,2093,969,2.15995872,1535,3498,1593,961,0,961,0,364,0,0.064516129,empty,mBC-0716-2
"D2,A7",15783,16447,12098,4349,7941,2,3689,3699,2527,1172,2.156143345,1788,1104,584,366,0,366,0,193,0,0.032786885,empty,mBC-0716-2
"D2,A8",10941,11261,8302,2959,5559,0,2567,2572,1773,799,2.21902378,1251,3692,1533,938,2,936,1,338,0,0.088675214,empty,mBC-0716-2
"D2,A9",19036,19357,14538,4819,9321,0,4175,4188,2896,1292,2.241486068,2013,1293,758,478,0,478,0,233,0,0.058577406,empty,mBC-0716-2
"D2,A10",15654,16029,11901,4128,7705,26,3503,3539,2482,1057,2.348155156,1708,525,293,189,0,189,0,121,0,0.010582011,empty,mBC-0716-2
"D2,A11",17787,18095,13667,4428,8768,3,3906,3916,2740,1176,2.329931973,1761,1346,781,476,0,476,0,204,0,0.058823529,empty,mBC-0716-2
"D2,A12",20754,21313,15859,5454,10049,0,4505,4510,3248,1262,2.573692552,2098,2493,1563,913,0,913,0,288,0,0.098576123,empty,mBC-0716-2
"D2,B1",19172,19660,14683,4977,9411,7,4292,4314,3039,1275,2.383529412,2056,1357,735,469,0,469,0,221,0,0.006396588,empty,mBC-0716-2
"D2,B2",19516,19884,14947,4937,9598,0,4211,4212,2932,1280,2.290625,1963,429,265,181,0,181,0,107,0,0.011049724,empty,mBC-0716-2
"D2,B3",20354,21337,15534,5803,10222,1,4777,4784,3392,1392,2.436781609,2292,1181,666,439,0,439,0,195,0,0.070615034,empty,mBC-0716-2
"D2,B4",2363977,2617486,1704713,912773,1226934,4,695365,696445,541859,154586,3.505226864,383283,202682,132779,74161,41,74120,2,5076,0,0.000836481,mm10,mBC-0716-2
"D2,B5",13877,10352,7425,2927,5912,0,2772,2787,2114,673,3.14115899,1446,923,569,360,1,359,1,162,0,0.04178273,empty,mBC-0716-2
"D2,B6",12212,12798,9229,3569,6305,9,3023,3039,2109,930,2.267741935,1529,1216,695,461,0,461,0,222,0,0.052060738,empty,mBC-0716-2
"D2,B7",16365,16624,12572,4052,8049,0,3606,3615,2512,1103,2.277425204,1682,895,504,318,0,318,0,165,0,0.040880503,empty,mBC-0716-2
"D2,B8",16432,17410,12463,4947,8258,21,3881,3914,2832,1082,2.617375231,1970,9598,3169,1884,1,1883,1,554,0,0.134360064,empty,mBC-0716-2
"D2,B9",14953,15405,11339,4066,7280,19,3232,3259,2310,949,2.434141201,1555,904,580,342,0,342,0,154,0,0.070175439,empty,mBC-0716-2
"D2,B10",429251,429646,312766,116880,218324,26,99486,99889,77044,22845,3.372466623,50603,14473,8856,4995,4,4991,1,968,0,0.007814065,mm10,mBC-0716-2
"D2,B11",16176,16499,12181,4318,7855,18,3581,3615,2550,1065,2.394366197,1719,612,203,139,1,138,1,83,0,0.02173913,empty,mBC-0716-2
"D2,B12",622387,662387,460238,202149,325433,1,167409,167706,130932,36774,3.560450318,87360,23237,12806,7092,6,7086,2,1373,0,0.006209427,mm10,mBC-0716-2
"D2,C1",22557,22487,17590,4897,10778,0,4539,4554,3222,1332,2.418918919,2071,772,481,278,0,278,0,139,0,0.021582734,empty,mBC-0716-2
"D2,C2",17599,17931,13317,4614,8644,16,3928,3954,2754,1200,2.295,1865,1703,983,565,0,565,0,187,0,0.024778761,empty,mBC-0716-2
"D2,C3",21421,22078,16538,5540,10728,0,4872,4893,3467,1426,2.431276297,2314,1935,744,423,0,423,0,163,0,0.059101655,empty,mBC-0716-2
"D2,C4",17521,17885,13263,4622,8772,0,3904,3919,2760,1159,2.381363244,1890,5835,2043,1252,1,1251,1,370,0,0.045563549,empty,mBC-0716-2
"D2,C5",950886,1008511,667142,341369,485019,0,274036,274404,220726,53678,4.112038452,148472,8743,5571,3144,1,3143,1,894,0,0.014317531,mm10,mBC-0716-2
"D2,C6",16172,16684,12206,4478,8313,0,3819,3832,2703,1129,2.394154119,1850,1700,990,604,0,604,0,240,0,0.067880795,empty,mBC-0716-2
"D2,C7",15793,16503,12037,4466,7939,9,3696,3716,2530,1186,2.133220911,1785,465,297,189,0,189,0,92,0,0.015873016,empty,mBC-0716-2
"D2,C8",687225,747998,497327,250671,366900,3,197403,197663,144860,52803,2.743404731,106595,60614,36530,20175,11,20164,1,2402,0,0.001537393,mm10,mBC-0716-2
"D2,C9",708771,725847,538150,187697,350710,2,158524,158807,129028,29779,4.33285201,77176,52397,33852,18917,14,18903,1,2317,0,0.00095223,mm10,mBC-0716-2
"D2,C10",13796,14116,10557,3559,6787,2,2990,2999,2026,973,2.082219938,1390,1176,696,405,0,405,0,176,0,0.017283951,empty,mBC-0716-2
"D2,C11",2752503,3052078,1960313,1091765,1432947,1,851286,852529,631176,221353,2.851445429,473712,138655,85843,47838,35,47803,4,4121,0,0.004225676,mm10,mBC-0716-2
"D2,C12",19081,19445,14467,4978,9544,0,4410,4418,3119,1299,2.401077752,2062,1459,817,469,0,469,0,187,0,0.08315565,empty,mBC-0716-2
"D2,D1",11268,11392,8388,3004,5482,10,2580,2591,1814,777,2.334620335,1214,594,367,234,1,233,1,116,0,0.021459227,empty,mBC-0716-2
"D2,D2",21416,21695,16449,5246,10389,0,4529,4541,3175,1366,2.324304539,2124,2540,1541,940,1,939,1,380,0,0.008519702,empty,mBC-0716-2
"D2,D3",13420,13975,10034,3941,6835,0,3210,3224,2256,968,2.330578512,1648,3178,1272,735,0,735,0,288,0,0.039455782,empty,mBC-0716-2
"D2,D4",14215,14232,10795,3437,7005,0,3155,3159,2214,945,2.342857143,1427,1496,960,591,0,591,0,269,0,0.013536379,empty,mBC-0716-2
"D2,D5",13532,13868,10201,3667,6624,11,3084,3097,2207,890,2.479775281,1462,832,475,337,0,337,0,166,0,0.080118694,empty,mBC-0716-2
"D2,D6",12184,12850,9084,3766,6339,0,3018,3027,2091,936,2.233974359,1578,1335,749,479,0,479,0,204,0,0.037578288,empty,mBC-0716-2
"D2,D7",12763,13119,9593,3526,6371,0,2984,2990,2129,861,2.472706156,1464,24416,7011,4149,4,4145,2,1032,0,0.030156815,empty,mBC-0716-2
"D2,D8",20902,21806,15942,5864,10462,0,4832,4835,3548,1287,2.756798757,2265,1087,668,401,2,399,2,186,0,0.037593985,empty,mBC-0716-2
"D2,D9",4990,5235,3615,1620,2578,0,1230,1233,858,375,2.288,650,5844,2107,1256,1,1255,1,457,0,0.034262948,empty,mBC-0716-2
"D2,D10",12705,13632,9689,3943,6510,0,3053,3057,2031,1026,1.979532164,1555,977,488,298,1,297,1,147,0,0.03030303,empty,mBC-0716-2
"D2,D11",12922,13521,9855,3666,6449,19,2965,2988,2077,911,2.279912184,1428,1760,1036,660,0,660,0,274,0,0.027272727,empty,mBC-0716-2
"D2,D12",20096,20549,15230,5319,9815,0,4525,4538,3151,1387,2.271809661,2139,2535,1609,958,0,958,0,326,0,0.048016701,empty,mBC-0716-2
"D2,E1",21437,21987,16353,5634,10474,0,4785,4795,3357,1438,2.33449235,2287,1826,1013,608,0,608,0,265,0,0.074013158,empty,mBC-0716-2
"D2,E2",15638,15994,11867,4127,7721,0,3436,3443,2419,1024,2.362304688,1669,1545,962,545,1,544,1,204,0,0.079044118,empty,mBC-0716-2
"D2,E3",12400,12954,9492,3462,6190,0,2728,2740,1899,841,2.258026159,1337,1588,934,551,1,550,1,261,0,0.010909091,empty,mBC-0716-2
"D2,E4",15575,15526,11846,3680,7420,12,3251,3265,2298,967,2.376421923,1475,1515,844,533,0,533,0,213,0,0.067542214,empty,mBC-0716-2
"D2,E5",21163,21554,16486,5068,10508,4,4567,4584,3129,1455,2.150515464,2095,1675,929,581,0,581,0,265,0,0.056798623,empty,mBC-0716-2
"D2,E6",13446,13553,10209,3344,6622,7,2991,3003,2117,886,2.389390519,1453,1569,914,578,1,577,1,260,0,0.029462738,empty,mBC-0716-2
"D2,E7",13356,13880,10153,3727,6676,6,3066,3075,2128,947,2.247096093,1490,5966,1992,1143,1,1142,1,360,0,0.034150613,empty,mBC-0716-2
"D2,E8",669724,704787,509609,195178,341461,13,161998,162343,120027,42316,2.836444844,81509,72413,45772,26042,11,26031,2,3004,0,0.016518766,mm10,mBC-0716-2
"D2,E9",8709,8820,6723,2097,4249,3,1909,1919,1310,609,2.151067323,882,1121,706,400,1,399,1,160,0,0.107769424,empty,mBC-0716-2
"D2,E10",13168,13637,9962,3675,6692,9,3141,3159,2218,941,2.35706695,1558,1366,812,482,0,482,0,200,0,0.006224066,empty,mBC-0716-2
"D2,E11",9032,9437,6889,2548,4648,1,2146,2147,1510,637,2.370486656,1056,886,557,355,0,355,0,184,0,0.050704225,empty,mBC-0716-2
"D2,E12",15892,16760,12005,4755,8184,14,3832,3862,2661,1201,2.215653622,1915,1232,725,428,0,428,0,175,0,0.039719626,empty,mBC-0716-2
"D2,F1",938343,1027821,665497,362324,492231,38,280298,280769,223700,57069,3.919816363,153338,76479,46420,26404,13,26391,4,2840,0,0.008980334,mm10,mBC-0716-2
"D2,F2",862066,913401,643967,269434,436499,0,215336,215726,185527,30199,6.143481572,109707,192211,126095,70706,27,70679,1,4683,0,0.002405241,mm10,mBC-0716-2
"D2,F3",22237,24041,16384,7657,11454,96,5642,5754,4293,1461,2.938398357,3011,4176,2261,1365,1,1364,1,406,0,0.020527859,empty,mBC-0716-2
"D2,F4",15782,15707,12049,3658,7724,5,3375,3391,2373,1018,2.331041257,1531,852,459,322,0,322,0,180,0,0.01242236,empty,mBC-0716-2
"D2,F5",24477,25267,18643,6624,11927,81,5357,5456,3833,1623,2.361675909,2666,2018,1229,742,0,742,0,329,0,0.020215633,empty,mBC-0716-2
"D2,F6",23359,23863,17771,6092,11439,8,5208,5228,3662,1566,2.33844189,2453,2317,1338,793,1,792,1,303,0,0.045454545,empty,mBC-0716-2
"D2,F7",20340,21073,15522,5551,9977,4,4569,4581,3216,1365,2.356043956,2170,3399,1243,778,0,778,0,264,0,0.01285347,empty,mBC-0716-2
"D2,F8",22631,23323,17167,6156,11332,0,5223,5234,3698,1536,2.407552083,2530,1152,441,293,0,293,0,161,0,0.034129693,empty,mBC-0716-2
"D2,F9",15074,15904,11442,4462,7510,32,3397,3443,2434,1009,2.412289395,1697,7643,2480,1522,1,1521,1,457,0,0.078895464,empty,mBC-0716-2
"D2,F10",20762,20979,16007,4972,10078,0,4344,4358,3158,1200,2.631666667,1930,1313,771,483,0,483,0,188,0,0.051759834,empty,mBC-0716-2
"D2,F11",11420,11630,8750,2880,5647,1,2470,2481,1742,739,2.357239513,1167,5665,1909,1184,1,1183,1,367,0,0.048182587,empty,mBC-0716-2
"D2,F12",14852,15634,11095,4539,7521,1,3674,3689,2654,1035,2.564251208,1859,198,124,82,1,81,1,56,0,0.074074074,empty,mBC-0716-2
"D2,G1",10466,10772,8187,2585,5113,30,2223,2257,1555,702,2.215099715,1004,1594,929,564,0,564,0,222,0,0.078014184,empty,mBC-0716-2
"D2,G2",21192,21589,16262,5327,10408,24,4679,4712,3333,1379,2.416968818,2176,704,472,300,0,300,0,139,0,0.013333333,empty,mBC-0716-2
"D2,G3",1607908,1701727,1187762,513965,801867,5,412762,413482,342705,70777,4.84203908,213625,163068,99652,55303,26,55277,2,4485,0,0.006096568,mm10,mBC-0716-2
"D2,G4",30121,30038,22346,7692,13854,0,6168,6196,4428,1768,2.504524887,2934,669,262,166,0,166,0,96,0,0.072289157,empty,mBC-0716-2
"D2,G5",13553,14026,10353,3673,6732,33,3066,3103,2165,938,2.308102345,1497,1386,773,513,0,513,0,244,0,0.040935673,empty,mBC-0716-2
"D2,G6",24238,25166,18690,6476,12039,1,5307,5317,3726,1591,2.341923319,2593,232,144,108,0,108,0,75,0,0,empty,mBC-0716-2
"D2,G7",21328,21820,16533,5287,10597,6,4727,4756,3364,1392,2.416666667,2209,2493,1336,868,0,868,0,322,0,0.072580645,empty,mBC-0716-2
"D2,G8",2093341,2357665,1461293,896372,1124565,17,691033,691985,517735,174250,2.971219512,393546,73882,45672,25443,9,25434,1,3259,0,0.00416765,mm10,mBC-0716-2
"D2,G9",930107,1041033,649024,392009,498559,8,293206,293613,208499,85114,2.449644007,167528,87446,52795,29398,11,29387,4,3141,0,0.00554667,mm10,mBC-0716-2
"D2,G10",13813,14339,10616,3723,6900,0,3149,3155,2209,946,2.335095137,1521,1520,983,622,0,622,0,256,0,0.028938907,empty,mBC-0716-2
"D2,G11",14469,15428,11087,4341,7241,0,3233,3243,2339,904,2.587389381,1522,877,517,315,1,314,1,148,0,0.00955414,empty,mBC-0716-2
"D2,G12",10992,11597,8363,3234,5680,0,2630,2633,1860,773,2.406209573,1269,1253,751,462,0,462,0,165,0,0.060606061,empty,mBC-0716-2
"D2,H1",20871,21509,15853,5656,10313,12,4680,4706,3273,1433,2.284019539,2294,1062,604,401,1,400,1,175,0,0.0325,empty,mBC-0716-2
"D2,H2",24350,24999,18758,6241,11959,2,5348,5362,3818,1544,2.472797927,2480,2208,1258,778,0,778,0,352,0,0.0218509,empty,mBC-0716-2
"D2,H3",1036059,1208371,682159,526212,579706,11,376851,377292,269964,107328,2.515317531,226399,58629,37330,20577,6,20571,2,2549,0,0.000826406,mm10,mBC-0716-2
"D2,H4",13695,13901,10373,3528,6686,4,3043,3052,2107,945,2.22962963,1424,260,170,115,0,115,0,86,0,0.008695652,empty,mBC-0716-2
"D2,H5",17657,18462,13324,5138,8635,0,4076,4081,2872,1209,2.375516956,1982,1320,826,488,0,488,0,221,0,0.032786885,empty,mBC-0716-2
"D2,H6",461523,464542,341982,122560,229080,18,108826,109018,80282,28736,2.79377784,53701,10767,5963,3224,2,3222,1,884,0,0.013345748,mm10,mBC-0716-2
"D2,H7",16793,17404,12702,4702,8534,1,3945,3957,2766,1191,2.322418136,2030,4741,1811,1113,1,1112,1,403,0,0.055755396,empty,mBC-0716-2
"D2,H8",697703,737381,514358,223023,353908,0,176449,176742,149486,27256,5.484517171,91080,94607,60059,33657,16,33641,2,3236,0,0.00068369,mm10,mBC-0716-2
"D2,H9",15609,16028,11652,4376,7707,29,3501,3535,2516,1019,2.469087341,1734,1594,984,618,0,618,0,256,0,0.030744337,empty,mBC-0716-2
"D2,H10",740250,787800,536804,250996,376552,147,196124,196600,171203,25397,6.74107178,103201,73512,47335,26160,10,26150,1,2938,0,0.002829828,mm10,mBC-0716-2
"D2,H11",16296,16690,12205,4485,8071,0,3727,3729,2576,1153,2.234171726,1843,219,139,97,0,97,0,73,0,0.041237113,empty,mBC-0716-2
"D2,H12",6060,6294,4545,1749,3082,0,1467,1471,1070,401,2.668329177,743,665,372,206,0,206,0,103,0,0.09223301,empty,mBC-0716-2
"D3,A1",818173,876967,591991,284976,426566,10,223040,223413,184161,39252,4.691760929,118483,83380,52583,29186,10,29176,1,3089,0,0.001576638,mm10,mBC-0716-2
"D3,A2",21163,21407,16146,5261,10228,5,4460,4475,3211,1264,2.540348101,2093,1193,695,441,0,441,0,183,0,0.036281179,empty,mBC-0716-2
"D3,A3",17665,18320,13354,4966,8886,4,4059,4073,2896,1177,2.460492778,1991,1000,597,337,0,337,0,152,0,0.068249258,empty,mBC-0716-2
"D3,A4",679068,713850,499475,214375,347961,8,179879,180170,139543,40627,3.434735521,92605,9969,4884,2754,2,2752,1,709,0,0.014534884,mm10,mBC-0716-2
"D3,A5",18984,19878,14461,5417,9737,0,4471,4487,3179,1308,2.430428135,2141,1449,839,506,1,505,1,215,0,0.023762376,empty,mBC-0716-2
"D3,A6",14780,15497,11199,4298,7590,5,3591,3610,2579,1031,2.501454898,1787,3350,1398,855,0,855,0,327,0,0.094736842,empty,mBC-0716-2
"D3,A7",17664,18509,13372,5137,8907,1,4205,4215,2950,1265,2.33201581,2076,1328,770,478,0,478,0,181,0,0.060669456,empty,mBC-0716-2
"D3,A8",11634,12011,8774,3237,5924,3,2746,2751,1943,808,2.40470297,1328,1404,760,468,0,468,0,204,0,0.047008547,empty,mBC-0716-2
"D3,A9",19849,20418,15137,5281,9642,14,4257,4272,3098,1174,2.638841567,2036,5129,1862,1114,0,1114,0,395,0,0.071813285,empty,mBC-0716-2
"D3,A10",18821,19510,14267,5243,9427,1,4468,4482,3148,1334,2.35982009,2163,569,337,220,0,220,0,112,0,0,empty,mBC-0716-2
"D3,A11",19430,19657,14843,4814,9634,7,4368,4378,3071,1307,2.3496557,2041,1595,786,488,0,488,0,208,0,0.086065574,empty,mBC-0716-2
"D3,A12",22292,22832,17114,5718,10842,1,4793,4811,3379,1432,2.359636872,2268,2529,1446,829,2,827,2,279,0,0.087061669,empty,mBC-0716-2
"D3,B1",1115948,1182223,829887,352336,557721,2,282072,282579,240842,41737,5.770467451,143887,75694,47186,26466,8,26458,2,3010,0,0.002381132,mm10,mBC-0716-2
"D3,B2",20421,21031,15320,5711,10189,0,4655,4672,3216,1456,2.208791209,2331,715,399,252,0,252,0,95,0,0.027777778,empty,mBC-0716-2
"D3,B3",594211,596467,449418,147049,292090,28,131550,131812,100981,30831,3.275307321,63899,6431,4072,2309,2,2307,1,716,0,0.007368877,mm10,mBC-0716-2
"D3,B4",17599,17951,13648,4303,8646,0,3865,3870,2755,1115,2.470852018,1763,6020,1974,1196,0,1196,0,373,0,0.066053512,empty,mBC-0716-2
"D3,B5",14442,10527,7129,3398,6100,4,3011,3029,2296,733,3.132332879,1666,924,437,274,0,274,0,128,0,0.04379562,empty,mBC-0716-2
"D3,B6",14410,14882,10836,4046,7177,4,3422,3432,2435,997,2.442326981,1681,1168,640,384,0,384,0,191,0,0.033854167,empty,mBC-0716-2
"D3,B7",903017,972470,669041,303429,467578,8,239084,239512,190691,48821,3.905921632,125215,81979,53507,29504,8,29496,2,2964,0,0.001118796,mm10,mBC-0716-2
"D3,B8",14378,15176,10976,4200,7262,6,3342,3367,2387,980,2.435714286,1660,4760,1704,1050,0,1050,0,382,0,0.05047619,empty,mBC-0716-2
"D3,B9",16012,16506,12324,4182,7830,7,3542,3564,2453,1111,2.207920792,1670,756,430,278,0,278,0,139,0,0.035971223,empty,mBC-0716-2
"D3,B10",1348920,1386917,957205,429712,681101,0,353687,354594,288281,66313,4.347277306,184635,41155,25766,14496,4,14492,1,2197,0,0.001863097,mm10,mBC-0716-2
"D3,B11",18975,19843,14456,5387,9483,31,4414,4456,3210,1246,2.576243981,2208,253,150,94,0,94,0,68,0,0.010638298,empty,mBC-0716-2
"D3,B12",27685,28944,21365,7579,13934,3,6462,6470,4668,1802,2.59045505,3130,1895,1153,667,1,666,1,237,0,0.033033033,empty,mBC-0716-2
"D3,C1",25976,25046,19056,5990,11343,1,4945,4948,3471,1477,2.350033852,2168,11392,3596,2218,3,2215,1,617,0,0.083069977,empty,mBC-0716-2
"D3,C2",19999,20585,15029,5556,9822,0,4532,4537,3172,1365,2.323809524,2133,8789,3051,1781,6,1775,2,514,0,0.134084507,empty,mBC-0716-2
"D3,C3",20943,21755,15947,5808,10309,0,4719,4733,3365,1368,2.459795322,2254,765,383,244,0,244,0,110,0,0.049180328,empty,mBC-0716-2
"D3,C4",19146,19550,14579,4971,9502,11,4295,4313,3070,1243,2.469831054,2038,2259,1072,669,1,668,1,230,0,0.119760479,empty,mBC-0716-2
"D3,C5",18547,19041,13901,5140,9170,7,4248,4261,3025,1236,2.447411003,2093,1358,694,429,0,429,0,215,0,0.009324009,empty,mBC-0716-2
"D3,C6",847131,926722,605600,321122,458356,2,250540,250945,203826,47119,4.32577092,137114,117462,76600,42734,16,42718,1,3760,0,0.000819327,mm10,mBC-0716-2
"D3,C7",17597,18321,13342,4979,8772,6,4040,4055,2900,1155,2.510822511,1974,468,288,197,0,197,0,93,0,0.060913706,empty,mBC-0716-2
"D3,C8",16243,16396,12446,3950,7923,0,3570,3575,2471,1104,2.238224638,1624,1551,904,552,0,552,0,228,0,0.03442029,empty,mBC-0716-2
"D3,C9",14007,14420,10778,3642,7014,1,3340,3347,2337,1010,2.313861386,1561,1315,621,392,0,392,0,182,0,0.020408163,empty,mBC-0716-2
"D3,C10",15156,15688,11694,3994,7430,8,3327,3342,2333,1009,2.312190287,1504,1243,740,461,0,461,0,173,0,0.110629067,empty,mBC-0716-2
"D3,C11",12726,13100,9648,3452,6422,6,3038,3051,2098,953,2.201469045,1468,1059,615,402,0,402,0,189,0,0.069651741,empty,mBC-0716-2
"D3,C12",20848,21798,15728,6070,10293,48,4781,4840,3369,1471,2.290278722,2378,1239,765,419,0,419,0,162,0,0.062052506,empty,mBC-0716-2
"D3,D1",13167,13591,9937,3654,6691,0,3192,3197,2258,939,2.404685836,1589,649,346,198,0,198,0,108,0,0.015151515,empty,mBC-0716-2
"D3,D2",21982,22712,16906,5806,11075,0,4885,4898,3446,1452,2.373278237,2341,3379,1804,1084,1,1083,1,359,0,0.050784857,empty,mBC-0716-2
"D3,D3",653414,694927,476639,218288,340633,4,177242,177512,141754,35758,3.964259746,93652,26149,16774,9653,5,9648,1,1629,0,0.002694859,mm10,mBC-0716-2
"D3,D4",16574,17339,12396,4943,8207,1,3926,3942,2760,1182,2.335025381,2003,23645,6606,4005,4,4001,2,1021,0,0.038490377,empty,mBC-0716-2
"D3,D5",801121,826102,591857,234245,399970,27,199936,200335,159702,40633,3.930352177,100541,24592,15672,8808,3,8805,2,1529,0,0.002952868,mm10,mBC-0716-2
"D3,D6",13876,14571,10490,4081,7062,24,3268,3308,2311,997,2.317953862,1675,7006,2311,1411,2,1409,1,439,0,0.127040454,empty,mBC-0716-2
"D3,D7",959044,1032942,688101,344841,491684,15,266743,267198,225829,41369,5.458894341,143365,87261,57268,31710,15,31695,1,3078,0,0.002082347,mm10,mBC-0716-2
"D3,D8",17187,17725,13165,4560,8605,3,3892,3905,2697,1208,2.232615894,1918,1045,603,376,0,376,0,165,0,0.042553191,empty,mBC-0716-2
"D3,D9",6742,7008,4927,2081,3574,0,1727,1731,1261,470,2.682978723,906,1844,1088,654,0,654,0,273,0,0.019877676,empty,mBC-0716-2
"D3,D10",736085,806106,533960,272146,389203,0,208140,208472,165393,43079,3.839295248,112181,66075,43895,24762,7,24755,3,2814,0,0.001090689,mm10,mBC-0716-2
"D3,D11",14519,15051,10896,4155,7299,4,3437,3450,2445,1005,2.432835821,1671,11920,3708,2293,2,2291,1,605,0,0.150589262,empty,mBC-0716-2
"D3,D12",1161887,1346503,780403,566100,641090,1,403403,403906,319540,84366,3.787544746,236570,207738,135813,74239,37,74202,3,4826,0,0.001428533,mm10,mBC-0716-2
"D3,E1",23400,23961,17894,6067,11532,13,5158,5189,3696,1493,2.475552579,2464,1396,880,544,1,543,1,240,0,0.05893186,empty,mBC-0716-2
"D3,E2",779993,858120,551607,306513,417431,1,238977,239281,186505,52776,3.533897984,131604,96981,56824,32129,12,32117,2,3234,0,0.011551515,mm10,mBC-0716-2
"D3,E3",585571,626873,431563,195310,304975,27,156397,156662,122976,33686,3.650656059,80867,84610,54796,30550,13,30537,3,3129,0,0.002947244,mm10,mBC-0716-2
"D3,E4",16744,17666,12645,5021,8373,0,3997,4006,2805,1201,2.335553705,2000,6254,2161,1301,1,1300,1,410,0,0.044615385,empty,mBC-0716-2
"D3,E5",22101,22449,17035,5414,10886,0,4813,4830,3450,1380,2.5,2196,1415,853,559,0,559,0,261,0,0.01431127,empty,mBC-0716-2
"D3,E6",19748,20572,14826,5746,9955,23,4650,4681,3329,1352,2.462278107,2360,1934,1021,659,0,659,0,287,0,0.040971168,empty,mBC-0716-2
"D3,E7",14766,14869,11106,3763,7164,0,3256,3261,2241,1020,2.197058824,1482,1291,796,468,0,468,0,196,0,0.021367521,empty,mBC-0716-2
"D3,E8",18899,19358,14405,4953,9370,0,4207,4217,2911,1306,2.228943338,2012,1811,1012,624,1,623,1,226,0,0.057784912,empty,mBC-0716-2
"D3,E9",9958,10093,7567,2526,4984,0,2307,2308,1654,654,2.529051988,1101,977,565,362,0,362,0,132,0,0.069060773,empty,mBC-0716-2
"D3,E10",13911,14394,10579,3815,6945,34,3127,3175,2203,972,2.266460905,1496,1421,869,529,1,528,1,228,0,0.022727273,empty,mBC-0716-2
"D3,E11",9928,10002,7564,2438,4940,0,2181,2185,1519,666,2.280780781,986,1079,587,359,0,359,0,166,0,0.016713092,empty,mBC-0716-2
"D3,E12",16992,17891,12855,5036,8738,0,4114,4135,2971,1164,2.552405498,2047,1164,674,379,0,379,0,134,0,0.044854881,empty,mBC-0716-2
"D3,F1",1053968,1122615,783926,338689,530465,4,273101,273548,207353,66195,3.132457134,140466,65177,36162,20361,10,20351,2,2746,0,0.004520662,mm10,mBC-0716-2
"D3,F2",24123,25015,18318,6697,12105,1,5626,5638,3981,1657,2.402534701,2732,2657,1545,957,1,956,1,411,0,0.066945607,empty,mBC-0716-2
"D3,F3",17950,18781,13536,5245,9007,0,4298,4300,2909,1391,2.091301222,2124,3529,1637,949,0,949,0,391,0,0.023182297,empty,mBC-0716-2
"D3,F4",18200,18469,13711,4758,9099,9,4185,4212,2961,1251,2.366906475,1994,893,418,237,0,237,0,107,0,0.063291139,empty,mBC-0716-2
"D3,F5",26186,27251,19930,7321,12992,9,6015,6034,4267,1767,2.414827391,2877,2000,1210,755,0,755,0,320,0,0.013245033,empty,mBC-0716-2
"D3,F6",26098,26507,19941,6566,12558,0,5764,5773,4131,1642,2.515834348,2701,2167,1217,723,1,722,1,278,0,0.04432133,empty,mBC-0716-2
"D3,F7",30479,32210,22590,9620,15537,7,7919,7942,5725,2217,2.582318448,3934,1015,604,364,0,364,0,160,0,0.038461538,empty,mBC-0716-2
"D3,F8",24432,24701,18317,6384,11819,0,5435,5462,3881,1581,2.454775459,2557,2110,841,502,0,502,0,217,0,0.11752988,empty,mBC-0716-2
"D3,F9",15877,16118,11843,4275,7882,0,3603,3616,2485,1131,2.197170645,1743,26175,7389,4552,6,4546,3,1074,0,0.021117466,empty,mBC-0716-2
"D3,F10",21440,21804,16454,5350,10552,0,4624,4639,3253,1386,2.347041847,2178,1461,933,526,2,524,1,187,0,0.06870229,empty,mBC-0716-2
"D3,F11",12475,13060,9499,3561,6313,1,2865,2870,2041,829,2.462002413,1425,1113,627,397,0,397,0,189,0,0.027707809,empty,mBC-0716-2
"D3,F12",871056,998873,593341,405532,477865,10,296128,296522,238320,58202,4.094704649,171270,5908,3571,2094,1,2093,1,506,0,0.001433349,mm10,mBC-0716-2
"D3,G1",10461,10624,8115,2509,5271,0,2324,2329,1634,695,2.351079137,1053,1783,1033,619,0,619,0,233,0,0.048465267,empty,mBC-0716-2
"D3,G2",22345,22982,17141,5841,11300,3,5105,5123,3592,1531,2.346178968,2410,622,349,225,0,225,0,131,0,0.026666667,empty,mBC-0716-2
"D3,G3",21341,22068,16128,5940,10630,0,4813,4824,3365,1459,2.306374229,2375,1988,1178,714,0,714,0,292,0,0.053221289,empty,mBC-0716-2
"D3,G4",1997002,2150441,1463650,686791,1009411,82,545970,546876,399000,147876,2.698206606,290081,1059,649,374,0,374,0,134,0,0.005347594,empty,mBC-0716-2
"D3,G5",14527,15286,11131,4155,7261,14,3339,3361,2374,987,2.40526849,1616,1270,732,466,0,466,0,228,0,0.036480687,empty,mBC-0716-2
"D3,G6",25120,25780,19446,6334,12342,1,5424,5437,3880,1557,2.491971741,2504,227,147,97,0,97,0,71,0,0,empty,mBC-0716-2
"D3,G7",21395,21961,16525,5436,10707,0,4700,4711,3367,1344,2.505208333,2216,1971,1145,701,0,701,0,297,0,0.041369472,empty,mBC-0716-2
"D3,G8",15882,16543,12058,4485,8106,0,3837,3848,2645,1203,2.198669992,1884,1439,847,515,1,514,1,243,0,0.035019455,empty,mBC-0716-2
"D3,G9",756030,878030,511070,366960,425927,30,265741,266158,196700,69458,2.831927208,156229,90471,58827,32579,12,32567,2,3340,0,0.000798354,mm10,mBC-0716-2
"D3,G10",18774,19797,13822,5975,9681,3,4930,4942,2971,1971,1.507356672,2537,7383,2697,1631,1,1630,1,526,0,0.085889571,empty,mBC-0716-2
"D3,G11",12806,13534,9844,3690,6600,0,3011,3017,2072,945,2.192592593,1500,827,485,292,0,292,0,129,0,0.065068493,empty,mBC-0716-2
"D3,G12",700393,705538,516511,189027,348629,1,169979,170247,138100,32147,4.295890752,83213,8558,5559,3156,1,3155,1,837,0,0.015530903,mm10,mBC-0716-2
"D3,H1",22212,22867,16976,5891,11158,11,5088,5118,3647,1471,2.479265806,2493,868,472,290,0,290,0,146,0,0.031034483,empty,mBC-0716-2
"D3,H2",41021,43688,30224,13464,20645,0,10494,10515,7416,3099,2.39303001,5355,3668,2175,1271,0,1271,0,394,0,0.017309205,empty,mBC-0716-2
"D3,H3",694994,737352,516778,220574,359260,2,183138,183446,130060,53386,2.436219234,97569,10422,6278,3579,1,3578,1,849,0,0.00922303,mm10,mBC-0716-2
"D3,H4",16269,17439,12322,5117,8571,1,4090,4105,2940,1165,2.52360515,2103,246,160,112,0,112,0,81,0,0.008928571,empty,mBC-0716-2
"D3,H5",561508,598351,416559,181792,293729,21,149358,149641,109181,40460,2.698492338,78381,27323,14359,8195,3,8192,1,1519,0,0.005004883,mm10,mBC-0716-2
"D3,H6",16821,17201,12773,4428,8569,0,3985,3995,2880,1115,2.582959641,1903,9494,3318,1950,0,1950,0,578,0,0.058461538,empty,mBC-0716-2
"D3,H7",17861,18512,13497,5015,9098,0,4240,4249,2978,1271,2.343036979,2085,1553,934,590,1,589,1,246,0,0.05942275,empty,mBC-0716-2
"D3,H8",15310,16168,11453,4715,7721,0,3673,3688,2558,1130,2.263716814,1876,1767,1060,640,0,640,0,275,0,0.028125,empty,mBC-0716-2
"D3,H9",17633,18110,13366,4744,8852,0,4028,4043,2886,1157,2.494382022,1900,1526,855,521,0,521,0,232,0,0.021113244,empty,mBC-0716-2
"D3,H10",17802,18510,13339,5171,8987,1,4215,4226,2946,1280,2.3015625,2050,1545,909,551,0,551,0,266,0,0.032667877,empty,mBC-0716-2
"D3,H11",998029,1125338,693147,432191,540264,11,319112,319618,267562,52056,5.139887813,181370,6184,3944,2251,0,2251,0,529,0,0.00444247,mm10,mBC-0716-2
"D3,H12",6875,7131,5248,1883,3424,0,1631,1636,1131,505,2.23960396,748,734,438,282,1,281,1,120,0,0.053380783,empty,mBC-0716-2
"D4,A1",714198,772487,505498,266989,383463,1,218577,218909,155355,63554,2.444456683,120904,27537,10730,6239,3,6236,2,1393,0,0.033354715,mm10,mBC-0716-2
"D4,A2",19585,19590,15130,4460,9365,0,4073,4091,2855,1236,2.30987055,1797,1502,906,508,0,508,0,203,0,0.031496063,empty,mBC-0716-2
"D4,A3",16458,17044,12409,4635,8263,0,3853,3872,2799,1073,2.608574091,1893,5660,1869,1144,0,1144,0,377,0,0.067307692,empty,mBC-0716-2
"D4,A4",20527,21185,15618,5567,10270,0,4575,4584,3245,1339,2.423450336,2200,4774,1539,923,0,923,0,336,0,0.008667389,empty,mBC-0716-2
"D4,A5",17693,18449,13481,4968,9044,6,4128,4141,2880,1261,2.283901665,2032,1959,1124,703,0,703,0,291,0,0.045519203,empty,mBC-0716-2
"D4,A6",15773,16639,11863,4776,8147,1,3910,3916,2800,1116,2.508960573,1932,1658,1006,609,0,609,0,271,0,0.077175698,empty,mBC-0716-2
"D4,A7",608543,661122,442573,218549,326664,0,174274,174593,148703,25890,5.743646195,93366,72846,46952,25460,10,25450,1,2856,0,0.001335953,mm10,mBC-0716-2
"D4,A8",10481,11048,8009,3039,5396,1,2515,2516,1781,735,2.423129252,1202,1673,849,505,1,504,1,270,0,0.025793651,empty,mBC-0716-2
"D4,A9",941266,1009466,692427,317039,478253,0,241980,242355,203900,38455,5.302301391,125834,207182,136377,74267,27,74240,5,4776,0,0.001791487,mm10,mBC-0716-2
"D4,A10",16654,17436,12679,4757,8542,5,3939,3959,2850,1109,2.569882777,2007,1267,504,329,0,329,0,150,0,0.012158055,empty,mBC-0716-2
"D4,A11",18642,19205,14050,5155,9374,0,4290,4299,2929,1370,2.137956204,2059,1661,980,584,0,584,0,229,0,0.042808219,empty,mBC-0716-2
"D4,A12",20285,20714,15458,5256,9915,1,4486,4496,3148,1348,2.335311573,2119,2484,1518,870,0,870,0,287,0,0.057471264,empty,mBC-0716-2
"D4,B1",18740,19437,14309,5128,9132,6,4059,4071,2911,1160,2.509482759,1919,1416,900,496,0,496,0,198,0,0.056451613,empty,mBC-0716-2
"D4,B2",18516,18920,14235,4685,9189,8,4162,4179,2970,1209,2.456575682,1950,522,299,196,0,196,0,89,0,0.025510204,empty,mBC-0716-2
"D4,B3",19235,20248,14579,5669,9743,5,4516,4535,3200,1335,2.397003745,2243,2097,933,574,0,574,0,233,0,0.118466899,empty,mBC-0716-2
"D4,B4",15871,16446,12124,4322,8145,0,3770,3786,2744,1042,2.633397313,1861,1078,591,333,0,333,0,161,0,0.024024024,empty,mBC-0716-2
"D4,B5",571303,297261,204697,92564,194888,9,96060,96873,75577,21296,3.548882419,53844,16494,10467,5638,3,5635,1,1142,0,0.006743567,mm10,mBC-0716-2
"D4,B6",13011,13796,9783,4013,6741,0,3232,3237,2232,1005,2.220895522,1613,1130,665,446,0,446,0,209,0,0.004484305,empty,mBC-0716-2
"D4,B7",15270,15637,11707,3930,7710,19,3458,3481,2477,1004,2.467131474,1645,1164,718,456,0,456,0,200,0,0.048245614,empty,mBC-0716-2
"D4,B8",860767,929001,624481,304520,446290,1,240234,240648,195075,45573,4.28049503,127903,68633,43106,24013,16,23997,4,2710,0,0.001500188,mm10,mBC-0716-2
"D4,B9",14384,15028,10932,4096,7169,4,3209,3217,2243,974,2.302874743,1590,806,454,319,0,319,0,142,0,0.047021944,empty,mBC-0716-2
"D4,B10",16404,16689,12202,4487,8267,22,3742,3776,2577,1199,2.149291076,1827,830,372,243,0,243,0,98,0,0.04526749,empty,mBC-0716-2
"D4,B11",1411914,1507720,1030842,476878,714995,8,378786,379328,291293,88035,3.308831715,201466,14247,8813,4814,6,4808,1,1018,0,0.00187188,mm10,mBC-0716-2
"D4,B12",17645,18142,13485,4657,8812,0,3987,3993,2769,1224,2.262254902,1879,2001,1038,603,0,603,0,247,0,0.049751244,empty,mBC-0716-2
"D4,C1",2502201,2823208,1685828,1137380,1311278,10,841016,842164,646054,196110,3.29434501,480366,61640,40212,22406,5,22401,2,2658,0,0.000669613,mm10,mBC-0716-2
"D4,C2",18832,19280,14259,5021,9276,0,4276,4293,2982,1311,2.274599542,2084,1797,1117,659,1,658,1,243,0,0.045592705,empty,mBC-0716-2
"D4,C3",19404,20492,14722,5770,9798,14,4519,4547,3119,1428,2.184173669,2228,842,455,256,0,256,0,140,0,0.078125,empty,mBC-0716-2
"D4,C4",18638,18474,14071,4403,8917,0,4005,4014,2834,1180,2.401694915,1821,8776,3451,2051,2,2049,1,504,0,0.241581259,empty,mBC-0716-2
"D4,C5",18323,19096,13895,5201,9424,50,4429,4485,3215,1270,2.531496063,2227,1364,792,485,1,484,1,229,0,0.04338843,empty,mBC-0716-2
"D4,C6",16761,16698,12810,3888,8390,0,3724,3730,2616,1114,2.348294434,1710,1678,1058,647,0,647,0,280,0,0.024729521,empty,mBC-0716-2
"D4,C7",16588,17208,12483,4725,8231,0,3802,3812,2630,1182,2.225042301,1844,1066,452,286,0,286,0,126,0,0,empty,mBC-0716-2
"D4,C8",15200,15552,11465,4087,7590,1,3544,3555,2482,1073,2.313140727,1721,13045,4204,2483,4,2479,2,629,0,0.108108108,empty,mBC-0716-2
"D4,C9",13016,13528,9786,3742,6652,4,3162,3173,2222,951,2.336487907,1576,953,534,337,0,337,0,170,0,0.020771513,empty,mBC-0716-2
"D4,C10",663109,725395,465457,259938,356752,0,207883,208159,163806,44353,3.693233829,113762,24271,13567,7885,2,7883,1,1499,0,0.026259038,mm10,mBC-0716-2
"D4,C11",11517,12303,8582,3721,5907,1,2804,2811,2018,793,2.544766709,1415,954,549,360,0,360,0,165,0,0.005555556,empty,mBC-0716-2
"D4,C12",490142,492123,382007,110116,241568,0,100140,100350,79547,20803,3.823823487,46663,10168,5147,2922,3,2919,1,745,0,0.013018157,mm10,mBC-0716-2
"D4,D1",433443,442855,317382,125473,221826,0,109266,109453,86454,22999,3.759033001,55579,5371,3422,1889,0,1889,0,550,0,0.016410799,mm10,mBC-0716-2
"D4,D2",1011588,1067928,748682,319246,508484,1,254233,254722,213506,41216,5.180172748,130506,185548,114348,63899,24,63875,2,4622,0,0.001518591,mm10,mBC-0716-2
"D4,D3",1834596,2014847,1318948,695899,969840,0,543165,543973,436011,107962,4.038559864,298669,211012,134861,73961,33,73928,5,5108,0,0.001163294,mm10,mBC-0716-2
"D4,D4",14608,15141,11156,3985,7485,0,3432,3435,2417,1018,2.374263261,1661,1609,980,640,1,639,1,306,0,0.001564945,empty,mBC-0716-2
"D4,D5",13928,14469,10641,3828,7109,32,3312,3363,2378,985,2.414213198,1641,1283,817,501,0,501,0,210,0,0.047904192,empty,mBC-0716-2
"D4,D6",12840,13668,9720,3948,6573,28,3048,3084,2129,955,2.229319372,1522,1650,959,593,0,593,0,230,0,0.050590219,empty,mBC-0716-2
"D4,D7",715673,793868,502037,291831,385058,2,220083,220386,171268,49118,3.486868358,122807,115609,76470,42013,17,41996,3,3648,0,0.001047719,mm10,mBC-0716-2
"D4,D8",15649,16519,11738,4781,7864,1,3668,3678,2571,1107,2.322493225,1808,1093,570,335,0,335,0,165,0,0.014925373,empty,mBC-0716-2
"D4,D9",6087,6504,4559,1945,3278,0,1576,1584,1132,452,2.504424779,799,1808,1078,655,1,654,1,300,0,0.027522936,empty,mBC-0716-2
"D4,D10",13319,13711,10153,3558,6573,0,3050,3057,2123,934,2.273019272,1438,785,505,294,0,294,0,141,0,0.054421769,empty,mBC-0716-2
"D4,D11",13610,14079,10232,3847,6985,0,3301,3315,2329,986,2.362068966,1619,2214,1272,772,0,772,0,300,0,0.056994819,empty,mBC-0716-2
"D4,D12",869428,981283,607510,373773,475155,30,282539,282953,189887,93066,2.04034771,162940,64249,41328,23071,15,23056,1,2609,0,0.003556558,mm10,mBC-0716-2
"D4,E1",21684,22100,16625,5475,10690,0,4783,4803,3384,1419,2.384778013,2283,1634,1033,639,0,639,0,268,0,0.021909233,empty,mBC-0716-2
"D4,E2",819745,906262,569286,336976,440084,4,256436,256821,185174,71647,2.5845325,145286,60185,36278,20084,10,20074,3,2596,0,0.00288931,mm10,mBC-0716-2
"D4,E3",12274,12470,9223,3247,6149,10,2778,2790,1970,820,2.402439024,1346,16491,4699,2832,3,2829,1,733,0,0.098267939,empty,mBC-0716-2
"D4,E4",15635,16354,11948,4406,7875,0,3650,3660,2577,1083,2.379501385,1778,1430,861,544,0,544,0,217,0,0.055147059,empty,mBC-0716-2
"D4,E5",1984872,2124597,1477182,647415,999227,3,536706,537627,430518,107109,4.019438142,277801,190321,120240,66286,32,66254,5,4877,0,0.002203641,mm10,mBC-0716-2
"D4,E6",18857,19795,14189,5606,9578,4,4636,4648,3257,1391,2.341480949,2280,1720,1037,648,1,647,1,294,0,0.024729521,empty,mBC-0716-2
"D4,E7",13642,13980,10248,3732,6693,0,3087,3096,2158,938,2.300639659,1468,1514,926,574,0,574,0,248,0,0.038327526,empty,mBC-0716-2
"D4,E8",959693,1008283,711356,296927,482369,3,242923,243320,205284,38036,5.397097487,123415,98190,64975,36242,17,36225,2,3382,0,0.001380262,mm10,mBC-0716-2
"D4,E9",9977,10518,7527,2991,5087,26,2362,2393,1702,691,2.463096961,1180,1075,610,384,0,384,0,172,0,0.091145833,empty,mBC-0716-2
"D4,E10",12704,13138,9604,3534,6498,15,2988,3005,2106,899,2.342602892,1462,1385,825,488,1,487,1,238,0,0.020533881,empty,mBC-0716-2
"D4,E11",9370,9750,7145,2605,4772,0,2254,2259,1532,727,2.107290234,1076,1279,729,482,0,482,0,227,0,0.045643154,empty,mBC-0716-2
"D4,E12",15521,16020,11576,4444,7974,18,3793,3816,2682,1134,2.365079365,1853,1054,638,386,0,386,0,163,0,0.062176166,empty,mBC-0716-2
"D4,F1",17906,18750,13681,5069,9001,1,4120,4133,2959,1174,2.52044293,2040,1474,921,534,0,534,0,254,0,0.026217228,empty,mBC-0716-2
"D4,F2",22521,23332,17106,6226,11430,0,5420,5425,3830,1595,2.401253918,2659,2755,1611,1008,0,1008,0,453,0,0.035714286,empty,mBC-0716-2
"D4,F3",663040,733874,469933,263941,361695,8,206137,206457,151367,55090,2.747631149,116460,17850,9577,5467,2,5465,1,1288,0,0.029643184,mm10,mBC-0716-2
"D4,F4",17595,17107,12803,4304,8606,4,3949,3969,2767,1202,2.301996672,1890,3289,1135,724,2,722,1,294,0,0.051246537,empty,mBC-0716-2
"D4,F5",1083285,1248199,720776,527423,598548,0,380839,381368,275369,105999,2.597845263,225863,45400,29266,16292,11,16281,1,2170,0,0.001289847,mm10,mBC-0716-2
"D4,F6",23907,24576,17917,6659,11779,0,5465,5477,3876,1601,2.420986883,2584,11703,4045,2395,0,2395,0,598,0,0.192484342,empty,mBC-0716-2
"D4,F7",19710,20283,15029,5254,9936,0,4575,4580,3212,1368,2.347953216,2164,890,531,355,0,355,0,176,0,0.005633803,empty,mBC-0716-2
"D4,F8",22337,22968,16910,6058,11090,0,5104,5118,3605,1513,2.38268341,2454,446,299,210,0,210,0,127,0,0.061904762,empty,mBC-0716-2
"D4,F9",14116,14543,10942,3601,7046,0,3205,3209,2214,995,2.225125628,1461,1668,926,571,1,570,1,233,0,0.052631579,empty,mBC-0716-2
"D4,F10",19530,20071,15007,5064,9667,16,4193,4217,2955,1262,2.341521395,1975,1976,1029,603,1,602,1,245,0,0.048172757,empty,mBC-0716-2
"D4,F11",11487,11838,8763,3075,5792,0,2547,2549,1825,724,2.520718232,1222,1160,755,470,0,470,0,236,0,0.034042553,empty,mBC-0716-2
"D4,F12",13883,14232,10541,3691,6863,27,3163,3205,2276,929,2.449946179,1517,272,182,116,0,116,0,60,0,0.017241379,empty,mBC-0716-2
"D4,G1",1252120,1404012,888921,515091,679357,3,393941,394600,309685,84915,3.646999941,218854,211745,135495,75272,30,75242,7,5156,0,0.001435369,mm10,mBC-0716-2
"D4,G2",20879,21623,15854,5769,10547,64,4639,4719,3278,1441,2.27480916,2352,1701,694,440,0,440,0,214,0,0,empty,mBC-0716-2
"D4,G3",22360,23808,16686,7122,11637,1,5718,5726,4029,1697,2.374189747,2940,2230,1331,840,0,840,0,354,0,0.04047619,empty,mBC-0716-2
"D4,G4",871291,945384,622596,322788,461322,37,261896,262337,202421,59916,3.378413112,141705,381,224,142,0,142,0,83,0,0.028169014,empty,mBC-0716-2
"D4,G5",13726,13934,10314,3620,6862,18,3090,3114,2232,882,2.530612245,1502,3850,1539,897,1,896,1,360,0,0.034598214,empty,mBC-0716-2
"D4,G6",23633,23956,18167,5789,11566,0,5140,5157,3661,1496,2.447192513,2409,267,151,102,0,102,0,77,0,0,empty,mBC-0716-2
"D4,G7",19449,20394,15165,5229,9727,0,4334,4345,3122,1223,2.552739166,2051,3324,1564,982,0,982,0,355,0,0.020366599,empty,mBC-0716-2
"D4,G8",1208789,1316341,880262,436079,633231,1,338746,339315,283422,55893,5.070795985,182229,188383,124776,67753,39,67714,2,4794,0,0.001063296,mm10,mBC-0716-2
"D4,G9",12682,13297,9660,3637,6380,12,2920,2941,2109,832,2.534855769,1420,1601,968,612,1,611,1,273,0,0.034369885,empty,mBC-0716-2
"D4,G10",13262,14047,10025,4022,6841,0,3154,3166,2164,1002,2.159680639,1614,1900,1198,714,0,714,0,330,0,0.039215686,empty,mBC-0716-2
"D4,G11",11992,12301,9061,3240,6103,0,2776,2783,1954,829,2.357056695,1356,1783,703,444,0,444,0,185,0,0.042792793,empty,mBC-0716-2
"D4,G12",11347,11834,8618,3216,5785,23,2631,2661,1873,788,2.376903553,1284,1017,567,362,0,362,0,164,0,0.074585635,empty,mBC-0716-2
"D4,H1",26626,28971,19807,9164,14142,1,7221,7232,5405,1827,2.958401752,3813,3497,1285,764,0,764,0,256,0,0.123036649,empty,mBC-0716-2
"D4,H2",23874,24935,18221,6714,12160,0,5618,5633,3966,1667,2.379124175,2710,2600,1644,1014,0,1014,0,426,0,0.031558185,empty,mBC-0716-2
"D4,H3",21357,22161,16389,5772,10624,0,4891,4898,3532,1366,2.585651537,2325,1502,932,578,0,578,0,274,0,0.015570934,empty,mBC-0716-2
"D4,H4",15224,15814,11454,4360,7725,0,3549,3556,2504,1052,2.380228137,1751,261,162,119,0,119,0,91,0,0,empty,mBC-0716-2
"D4,H5",17765,18866,13348,5518,8993,88,4187,4283,3087,1196,2.581103679,2183,1997,1069,625,0,625,0,248,0,0.0368,empty,mBC-0716-2
"D4,H6",15216,15606,11480,4126,7712,8,3486,3510,2489,1021,2.437806072,1706,4076,1842,1066,0,1066,0,354,0,0.021575985,empty,mBC-0716-2
"D4,H7",16969,17588,12854,4734,8601,40,3895,3947,2852,1095,2.60456621,1980,1470,903,586,0,586,0,261,0,0.027303754,empty,mBC-0716-2
"D4,H8",14485,15157,11077,4080,7327,41,3441,3486,2511,975,2.575384615,1711,1699,989,631,0,631,0,292,0,0.036450079,empty,mBC-0716-2
"D4,H9",16633,17081,12452,4629,8291,0,3804,3813,2742,1071,2.56022409,1866,1441,845,559,0,559,0,261,0,0.055456172,empty,mBC-0716-2
"D4,H10",16704,17421,12431,4990,8435,0,3967,3977,2772,1205,2.300414938,1999,4990,1976,1245,2,1243,2,482,0,0.042638777,empty,mBC-0716-2
"D4,H11",16480,17160,12403,4757,8396,0,3955,3957,2784,1173,2.373401535,1947,948,401,246,1,245,1,116,0,0.040816327,empty,mBC-0716-2
"D4,H12",6678,7153,5047,2106,3447,54,1570,1629,1175,454,2.588105727,840,579,337,208,0,208,0,108,0,0.072115385,empty,mBC-0716-2
"D5,A1",14094,14637,10546,4091,7224,27,3399,3430,2420,1010,2.396039604,1703,1033,583,381,1,380,1,189,0,0.005263158,empty,mBC-0716-2
"D5,A2",19251,19477,14792,4685,9407,12,4050,4068,2878,1190,2.418487395,1905,1339,836,497,0,497,0,221,0,0.036217304,empty,mBC-0716-2
"D5,A3",17013,17510,12880,4630,8468,3,3914,3930,2786,1144,2.435314685,1875,909,571,343,0,343,0,148,0,0.067055394,empty,mBC-0716-2
"D5,A4",326262,334680,237208,97472,167125,1,85574,85715,63703,22012,2.894012357,43758,2481,1500,763,0,763,0,261,0,0.015727392,empty,mBC-0716-2
"D5,A5",18411,18997,14045,4952,9307,0,4365,4370,2960,1410,2.09929078,2043,1792,1102,660,0,660,0,263,0,0.025757576,empty,mBC-0716-2
"D5,A6",17324,18020,13104,4916,8898,12,4262,4284,3058,1226,2.494290375,2077,1334,786,494,1,493,1,231,0,0.010141988,empty,mBC-0716-2
"D5,A7",16744,17278,12853,4425,8454,15,3880,3901,2732,1169,2.337040205,1882,1314,774,457,0,457,0,203,0,0.041575492,empty,mBC-0716-2
"D5,A8",11599,12086,8618,3468,5744,8,2681,2693,1849,844,2.190758294,1336,12695,3834,2245,3,2242,2,684,0,0.029438002,empty,mBC-0716-2
"D5,A9",20588,21229,15696,5533,10063,23,4422,4451,3165,1286,2.461119751,2093,3706,1461,877,0,877,0,320,0,0.028506271,empty,mBC-0716-2
"D5,A10",16255,16405,12267,4138,8130,7,3714,3727,2607,1120,2.327678571,1777,1923,702,442,0,442,0,168,0,0,empty,mBC-0716-2
"D5,A11",699571,761054,501013,260041,375285,1,204402,204700,173231,31469,5.504814262,110363,52761,30545,16990,8,16982,1,2398,0,0.003179837,mm10,mBC-0716-2
"D5,A12",21732,22161,16640,5521,10554,45,4591,4645,3291,1354,2.430576071,2171,2268,1374,803,0,803,0,277,0,0.078455791,empty,mBC-0716-2
"D5,B1",19556,20045,14974,5071,9589,14,4312,4332,3074,1258,2.443561208,1982,1023,646,373,0,373,0,179,0,0.058981233,empty,mBC-0716-2
"D5,B2",20469,20971,15508,5463,10351,3,4579,4599,3153,1446,2.180497925,2239,575,371,234,0,234,0,108,0,0.047008547,empty,mBC-0716-2
"D5,B3",20313,20831,15559,5272,10145,8,4577,4589,3257,1332,2.445195195,2172,1127,647,429,0,429,0,173,0,0.086247086,empty,mBC-0716-2
"D5,B4",17780,18480,13484,4996,9013,0,4195,4203,2930,1273,2.301649647,2060,1205,708,435,0,435,0,182,0,0.071264368,empty,mBC-0716-2
"D5,B5",10429,6705,4555,2150,4160,0,2107,2119,1512,607,2.490939044,1176,745,404,237,0,237,0,136,0,0.037974684,empty,mBC-0716-2
"D5,B6",12950,13377,9663,3714,6557,0,3099,3104,2208,896,2.464285714,1539,1335,805,497,0,497,0,206,0,0.030181087,empty,mBC-0716-2
"D5,B7",18216,18763,14074,4689,9282,0,4168,4178,2991,1187,2.51979781,1959,1077,692,412,0,412,0,173,0,0.053398058,empty,mBC-0716-2
"D5,B8",1029211,1090654,751196,339458,537310,0,287766,288227,219460,68767,3.191356319,149950,39822,24583,13950,9,13941,4,2247,0,0.006312316,mm10,mBC-0716-2
"D5,B9",15419,15900,11916,3984,7667,0,3393,3395,2365,1030,2.296116505,1633,1552,644,391,0,391,0,178,0,0.056265985,empty,mBC-0716-2
"D5,B10",17244,17354,12900,4454,8631,0,3901,3911,2665,1246,2.138844302,1875,481,241,133,0,133,0,75,0,0.022556391,empty,mBC-0716-2
"D5,B11",19678,21084,14683,6401,10280,2,5086,5096,3677,1419,2.591261452,2644,372,231,143,0,143,0,83,0,0,empty,mBC-0716-2
"D5,B12",877472,976791,615382,361409,479915,5,276143,276569,234630,41939,5.594553995,153489,163643,81945,45517,27,45490,4,4154,0,0.016838866,mm10,mBC-0716-2
"D5,C1",23848,23589,18390,5199,11390,1,4856,4875,3496,1379,2.535170413,2084,858,480,303,0,303,0,150,0,0.02640264,empty,mBC-0716-2
"D5,C2",19402,20240,14583,5657,9595,0,4345,4355,3079,1276,2.413009404,2139,3836,1661,955,0,955,0,302,0,0.086910995,empty,mBC-0716-2
"D5,C3",20867,21639,15798,5841,10288,14,4691,4718,3258,1460,2.231506849,2290,560,365,221,1,220,1,100,0,0.036363636,empty,mBC-0716-2
"D5,C4",17832,18078,13443,4635,8786,5,3865,3883,2746,1137,2.415127529,1843,1368,748,419,1,418,1,166,0,0.066985646,empty,mBC-0716-2
"D5,C5",17158,17691,12884,4807,8623,24,4009,4048,2784,1264,2.202531646,2041,6575,2427,1493,2,1491,1,445,0,0.126760563,empty,mBC-0716-2
"D5,C6",16605,17059,12418,4641,8511,14,3987,4009,2807,1202,2.335274542,1963,1517,937,590,0,590,0,246,0,0.094915254,empty,mBC-0716-2
"D5,C7",16422,17137,12474,4663,8165,2,3761,3771,2613,1158,2.256476684,1849,393,227,145,0,145,0,81,0,0,empty,mBC-0716-2
"D5,C8",15179,15685,11526,4159,7646,0,3516,3522,2373,1149,2.065274151,1664,2302,1242,715,0,715,0,258,0,0.078321678,empty,mBC-0716-2
"D5,C9",13502,13872,10089,3783,6709,16,3104,3123,2160,963,2.242990654,1548,1592,926,608,1,607,1,309,0,0.044481054,empty,mBC-0716-2
"D5,C10",14105,14247,10767,3480,6936,3,3199,3214,2211,1003,2.204386839,1370,968,593,369,0,369,0,171,0,0.027100271,empty,mBC-0716-2
"D5,C11",12265,12837,9436,3401,6244,4,2849,2855,2016,839,2.402860548,1361,945,432,262,0,262,0,161,0,0.049618321,empty,mBC-0716-2
"D5,C12",20959,21893,15474,6419,10503,0,4921,4942,3489,1453,2.401238816,2540,2988,1283,755,0,755,0,229,0,0.160264901,empty,mBC-0716-2
"D5,D1",11332,11703,8672,3031,6002,0,2861,2868,1995,873,2.285223368,1399,547,276,201,0,201,0,105,0,0.039800995,empty,mBC-0716-2
"D5,D2",21713,21847,16828,5019,10862,0,4732,4743,3333,1410,2.363829787,2144,5164,2083,1258,0,1258,0,439,0,0.03736089,empty,mBC-0716-2
"D5,D3",14052,14546,10667,3879,7069,0,3330,3337,2298,1039,2.21174206,1583,2918,1221,750,0,750,0,303,0,0.092,empty,mBC-0716-2
"D5,D4",15162,15742,11585,4157,7697,3,3612,3619,2550,1069,2.385406922,1753,1523,873,565,0,565,0,279,0,0.046017699,empty,mBC-0716-2
"D5,D5",13896,14351,10526,3825,7059,14,3254,3283,2278,1005,2.266666667,1576,1146,653,434,0,434,0,184,0,0.039170507,empty,mBC-0716-2
"D5,D6",12879,13744,9477,4267,6501,21,3179,3201,2155,1046,2.060229446,1593,1268,814,488,0,488,0,206,0,0.05942623,empty,mBC-0716-2
"D5,D7",12915,13380,9792,3588,6514,8,3083,3096,2198,898,2.44766147,1497,1353,793,491,1,490,1,220,0,0.028571429,empty,mBC-0716-2
"D5,D8",15575,16291,11680,4611,8041,0,3758,3771,2554,1217,2.098603122,1914,1041,597,350,0,350,0,162,0,0.085714286,empty,mBC-0716-2
"D5,D9",335748,362492,231512,130980,181761,0,101135,101274,77332,23942,3.229972433,57167,72056,47682,26691,9,26682,1,2813,0,0.001836444,mm10,mBC-0716-2
"D5,D10",14223,14900,10693,4207,7274,1,3426,3441,2419,1022,2.366927593,1661,703,362,223,0,223,0,103,0,0.040358744,empty,mBC-0716-2
"D5,D11",15641,16507,11755,4752,7907,26,3709,3746,2653,1093,2.42726441,1840,1715,1066,655,0,655,0,265,0,0.045801527,empty,mBC-0716-2
"D5,D12",20774,21365,15930,5435,10436,0,4718,4725,3241,1484,2.183962264,2229,2343,1383,807,0,807,0,296,0,0.021065675,empty,mBC-0716-2
"D5,E1",22659,22837,17453,5384,10925,0,4754,4772,3384,1388,2.438040346,2121,1427,816,517,0,517,0,237,0,0.056092843,empty,mBC-0716-2
"D5,E2",16276,16547,12295,4252,8081,0,3679,3692,2511,1181,2.126164268,1742,6231,2512,1540,1,1539,1,458,0,0.07797271,empty,mBC-0716-2
"D5,E3",13005,13237,9930,3307,6608,0,2927,2938,1993,945,2.108994709,1415,1778,1066,619,0,619,0,287,0,0.02907916,empty,mBC-0716-2
"D5,E4",15875,16379,12144,4235,7897,6,3608,3624,2510,1114,2.253141831,1671,1263,730,391,1,390,1,178,0,0.023076923,empty,mBC-0716-2
"D5,E5",21639,22337,16596,5741,10860,1,4891,4904,3405,1499,2.271514343,2378,1494,922,573,0,573,0,252,0,0.066317627,empty,mBC-0716-2
"D5,E6",13780,14384,10519,3865,6887,15,3132,3159,2270,889,2.553430821,1559,1350,768,503,0,503,0,238,0,0.053677932,empty,mBC-0716-2
"D5,E7",14416,14580,10993,3587,7058,23,3108,3140,2180,960,2.270833333,1449,13314,4227,2574,2,2572,2,693,0,0.017884914,empty,mBC-0716-2
"D5,E8",1023090,1064707,763177,301530,511790,3,245752,246206,216469,29737,7.279449844,123422,120199,79175,43335,29,43306,2,3631,0,0.000877477,mm10,mBC-0716-2
"D5,E9",9223,9580,6947,2633,4698,0,2232,2234,1515,719,2.107093185,1095,2450,1065,625,1,624,1,227,0,0.16025641,empty,mBC-0716-2
"D5,E10",14070,14626,10667,3959,7016,0,3257,3262,2238,1024,2.185546875,1528,9718,3176,1896,2,1894,1,497,0,0.086589229,empty,mBC-0716-2
"D5,E11",9208,9519,7002,2517,4797,0,2226,2232,1542,690,2.234782609,1083,1075,600,388,0,388,0,176,0,0.041237113,empty,mBC-0716-2
"D5,E12",16939,16880,12206,4674,8138,0,3845,3853,2745,1108,2.477436823,1826,36374,10613,6349,4,6345,1,1382,0,0.109692671,empty,mBC-0716-2
"D5,F1",18748,18897,14402,4495,9215,3,4079,4084,2850,1234,2.309562399,1856,1548,889,548,1,547,1,252,0,0.032906764,empty,mBC-0716-2
"D5,F2",23231,24156,17506,6650,11737,0,5516,5537,3876,1661,2.333534016,2688,2495,1473,926,0,926,0,386,0,0.024838013,empty,mBC-0716-2
"D5,F3",1000467,1066539,735119,331420,513978,0,260050,260447,215139,45308,4.748366734,135116,201475,132275,72614,27,72587,6,4822,0,0.000978137,mm10,mBC-0716-2
"D5,F4",15672,15592,11925,3667,7824,0,3455,3461,2448,1013,2.416584403,1529,531,309,190,0,190,0,93,0,0.010526316,empty,mBC-0716-2
"D5,F5",2084536,2338099,1431903,906196,1108808,6,679445,680495,520211,160284,3.245557885,386249,220029,137452,75894,28,75866,4,5161,0,0.000975404,mm10,mBC-0716-2
"D5,F6",43564,47085,33382,13703,22868,1,11104,11142,8618,2524,3.414421553,5706,10084,4796,2776,1,2775,1,692,0,0.016576577,empty,mBC-0716-2
"D5,F7",21451,22056,16370,5686,10753,1,4851,4856,3328,1528,2.178010471,2291,966,586,376,0,376,0,154,0,0.074468085,empty,mBC-0716-2
"D5,F8",22675,23343,17134,6209,11423,1,5141,5149,3575,1574,2.271283355,2450,792,329,218,0,218,0,122,0,0.02293578,empty,mBC-0716-2
"D5,F9",762467,812218,546668,265550,401501,0,214515,214814,139794,75020,1.863423087,118281,9981,6052,3272,1,3271,1,846,0,0.011922959,mm10,mBC-0716-2
"D5,F10",22272,22029,17320,4709,10864,0,4621,4629,3265,1364,2.393695015,2014,1091,677,417,0,417,0,193,0,0.047961631,empty,mBC-0716-2
"D5,F11",11697,11942,8884,3058,5764,9,2502,2515,1740,775,2.24516129,1206,2728,1043,630,1,629,1,253,0,0.046104928,empty,mBC-0716-2
"D5,F12",698309,747400,512039,235361,365966,3,195022,195341,156767,38574,4.064058692,102736,636,399,224,0,224,0,102,0,0,empty,mBC-0716-2
"D5,G1",11069,11596,8413,3183,5637,1,2566,2579,1816,763,2.380078637,1266,1874,1106,615,0,615,0,232,0,0.053658537,empty,mBC-0716-2
"D5,G2",22647,23188,17008,6180,11028,0,4907,4923,3455,1468,2.353542234,2402,4618,1563,929,1,928,1,333,0,0.007543103,empty,mBC-0716-2
"D5,G3",785288,816111,585491,230620,398935,3,199039,199382,152448,46934,3.24813568,100080,22698,10502,5940,1,5939,1,1319,0,0.036201381,mm10,mBC-0716-2
"D5,G4",29641,29815,22571,7244,14315,0,6282,6299,4539,1760,2.578977273,2903,369,180,115,0,115,0,85,0,0.043478261,empty,mBC-0716-2
"D5,G5",13682,13978,10372,3606,6756,4,3036,3049,2106,943,2.233297985,1442,3073,1168,725,0,725,0,296,0,0.026206897,empty,mBC-0716-2
"D5,G6",25200,25428,19514,5914,12288,0,5334,5357,3784,1573,2.405594406,2367,265,154,104,0,104,0,65,0,0.096153846,empty,mBC-0716-2
"D5,G7",21436,21884,16406,5478,10673,15,4809,4839,3360,1479,2.271805274,2269,4727,1869,1126,0,1126,0,424,0,0.072824156,empty,mBC-0716-2
"D5,G8",959700,1064651,677856,386795,513916,15,298126,298563,228678,69885,3.272204336,165245,84965,53920,30613,17,30596,2,3124,0,0.00114394,mm10,mBC-0716-2
"D5,G9",11034,11354,8318,3036,5546,30,2546,2578,1803,775,2.326451613,1249,1269,800,498,0,498,0,224,0,0.02811245,empty,mBC-0716-2
"D5,G10",1049318,1132320,764993,367327,544600,1,283867,284328,239926,44402,5.403495338,150270,176436,115170,64713,18,64695,2,4487,0,0.000711029,mm10,mBC-0716-2
"D5,G11",543760,571519,406186,165333,285842,0,142121,142335,113540,28795,3.943045668,72576,1188,645,396,0,396,0,164,0,0.093434343,empty,mBC-0716-2
"D5,G12",11799,12637,9047,3590,6168,6,2924,2934,2008,926,2.168466523,1433,1180,686,405,1,404,1,165,0,0.047029703,empty,mBC-0716-2
"D5,H1",21317,22065,16067,5998,10767,0,4940,4952,3494,1458,2.396433471,2346,2609,1003,618,0,618,0,242,0,0.037216828,empty,mBC-0716-2
"D5,H2",1266988,1388167,893068,495099,665436,21,378168,378708,305096,73612,4.144650329,209510,119319,70684,39751,14,39737,3,3712,0,0.002768201,mm10,mBC-0716-2
"D5,H3",21406,22213,15966,6247,10548,0,4922,4927,3410,1517,2.247857614,2425,13582,3815,2319,7,2312,2,664,0,0.070934256,empty,mBC-0716-2
"D5,H4",830774,946322,552908,393414,461626,0,289004,289325,216698,72627,2.983711292,170284,3273,2000,1124,0,1124,0,338,0,0.00088968,mm10,mBC-0716-2
"D5,H5",18455,18829,13960,4869,9128,4,4283,4293,2921,1372,2.129008746,2068,9085,2956,1769,3,1766,2,537,0,0.025481314,empty,mBC-0716-2
"D5,H6",765630,818757,551663,267094,400857,31,211184,211551,174253,37298,4.671912703,112384,135762,82027,45663,16,45647,1,3878,0,0.017744868,mm10,mBC-0716-2
"D5,H7",17181,17448,13118,4330,8604,8,3895,3913,2748,1165,2.358798283,1818,1508,893,571,0,571,0,243,0,0.042031524,empty,mBC-0716-2
"D5,H8",14320,14318,10737,3581,6954,5,3209,3218,2245,973,2.30729702,1476,16327,5399,3186,2,3184,1,879,0,0.046482412,empty,mBC-0716-2
"D5,H9",17111,17408,13062,4346,8432,0,3883,3883,2710,1173,2.310315431,1786,1381,846,531,0,531,0,248,0,0.02259887,empty,mBC-0716-2
"D5,H10",14334,14361,10627,3734,7063,1,3163,3171,2231,940,2.373404255,1527,1432,871,558,0,558,0,279,0,0.017921147,empty,mBC-0716-2
"D5,H11",16605,17315,12656,4659,8611,2,3981,3993,2768,1225,2.259591837,1968,297,190,120,0,120,0,74,0,0.041666667,empty,mBC-0716-2
"D5,H12",6340,6371,4770,1601,3134,5,1480,1491,1029,462,2.227272727,665,627,347,214,0,214,0,105,0,0.074766355,empty,mBC-0716-2
"D6,A1",578091,594360,439700,154660,296603,15,136991,137256,101711,35545,2.861471374,67761,9936,6143,3434,2,3432,1,861,0,0.004662005,mm10,mBC-0716-2
"D6,A2",19828,19583,15224,4359,9570,0,4069,4077,2895,1182,2.449238579,1869,1488,949,577,0,577,0,242,0,0.051993068,empty,mBC-0716-2
"D6,A3",16878,17794,12726,5068,8728,9,4136,4160,2928,1232,2.376623377,2109,1039,686,417,1,416,1,171,0,0.038461538,empty,mBC-0716-2
"D6,A4",21955,22218,16997,5221,10661,0,4647,4666,3285,1381,2.378711079,2134,621,355,223,0,223,0,124,0,0.022421525,empty,mBC-0716-2
"D6,A5",18472,18797,14052,4745,9299,7,4277,4295,3039,1256,2.419585987,2012,1629,935,565,0,565,0,248,0,0.046017699,empty,mBC-0716-2
"D6,A6",13806,14281,10336,3945,6996,34,3301,3338,2337,1001,2.334665335,1650,1439,830,521,0,521,0,246,0,0.080614203,empty,mBC-0716-2
"D6,A7",16622,17334,12744,4590,8501,0,3982,3985,2833,1152,2.459201389,1901,1775,880,563,1,562,1,242,0,0.051601423,empty,mBC-0716-2
"D6,A8",10878,11020,8365,2655,5507,0,2492,2496,1777,719,2.471488178,1148,4969,1839,1105,1,1104,1,357,0,0.089673913,empty,mBC-0716-2
"D6,A9",21344,21858,16379,5479,10478,0,4577,4592,3160,1432,2.206703911,2098,1689,998,622,0,622,0,272,0,0.053054662,empty,mBC-0716-2
"D6,A10",16305,16738,12512,4226,8193,16,3713,3740,2620,1120,2.339285714,1748,465,273,167,1,166,1,99,0,0.012048193,empty,mBC-0716-2
"D6,A11",18668,19188,14322,4866,9393,29,4175,4214,2935,1279,2.294761532,2006,1356,770,492,0,492,0,205,0,0.083333333,empty,mBC-0716-2
"D6,A12",21312,21740,16283,5457,10536,3,4682,4694,3335,1359,2.454010302,2226,2547,1518,893,0,893,0,317,0,0.050391937,empty,mBC-0716-2
"D6,B1",19716,20238,15172,5066,9710,0,4382,4393,3082,1311,2.350877193,2047,1566,798,470,1,469,1,213,0,0.025586354,empty,mBC-0716-2
"D6,B2",20564,21150,15555,5595,10126,3,4529,4540,3184,1356,2.348082596,2180,582,333,224,0,224,0,103,0,0.022321429,empty,mBC-0716-2
"D6,B3",20851,21870,15873,5997,10589,23,4851,4884,3472,1412,2.458923513,2410,1368,846,503,0,503,0,222,0,0.009940358,empty,mBC-0716-2
"D6,B4",17034,17739,13086,4653,8470,0,3895,3899,2738,1161,2.3583118,1889,1498,770,464,0,464,0,196,0,0.05387931,empty,mBC-0716-2
"D6,B5",9461,5646,3849,1797,3529,28,1665,1713,1211,502,2.412350598,973,933,585,361,0,361,0,137,0,0.055401662,empty,mBC-0716-2
"D6,B6",662691,757122,471759,285363,372240,30,216110,216477,132003,84474,1.562646495,124402,30555,19834,11153,6,11147,2,1629,0,0.002063335,mm10,mBC-0716-2
"D6,B7",959240,1005390,726557,278833,484544,11,229155,229564,191926,37638,5.099261385,114410,52775,34943,19277,7,19270,1,2231,0,0.004255319,mm10,mBC-0716-2
"D6,B8",13628,14264,10458,3806,6999,1,3192,3200,2243,957,2.343782654,1537,1105,694,458,0,458,0,203,0,0.015283843,empty,mBC-0716-2
"D6,B9",15173,15937,11510,4427,7692,1,3437,3440,2394,1046,2.288718929,1660,1733,772,494,2,492,1,179,0,0.071138211,empty,mBC-0716-2
"D6,B10",17096,17122,12578,4544,8557,0,3944,3960,2764,1196,2.311036789,1892,484,258,167,0,167,0,88,0,0.005988024,empty,mBC-0716-2
"D6,B11",16733,17327,12837,4490,8427,2,3886,3896,2665,1231,2.16490658,1885,375,221,145,0,145,0,92,0,0.096551724,empty,mBC-0716-2
"D6,B12",925627,993585,676620,316965,482251,1,253719,254120,215025,39095,5.500063947,133414,91322,55948,30995,12,30983,2,2996,0,0.000935997,mm10,mBC-0716-2
"D6,C1",22845,23059,17816,5243,11067,0,4687,4712,3347,1365,2.452014652,2099,881,515,301,0,301,0,135,0,0.053156146,empty,mBC-0716-2
"D6,C2",19435,19852,14744,5108,9483,0,4283,4286,3030,1256,2.412420382,2040,1524,867,532,0,532,0,213,0,0.04887218,empty,mBC-0716-2
"D6,C3",20506,21097,15412,5685,10231,11,4690,4708,3303,1405,2.35088968,2329,703,408,229,0,229,0,101,0,0.096069869,empty,mBC-0716-2
"D6,C4",18160,18479,13898,4581,8859,4,3875,3884,2689,1195,2.250209205,1850,1340,675,413,1,412,1,175,0,0.077669903,empty,mBC-0716-2
"D6,C5",16919,17775,12789,4986,8547,0,4028,4035,2782,1253,2.220271349,1993,1263,746,480,0,480,0,217,0,0.045833333,empty,mBC-0716-2
"D6,C6",17138,17538,12799,4739,8834,3,4111,4124,2866,1258,2.278219396,2000,1388,735,466,1,465,1,226,0,0.049462366,empty,mBC-0716-2
"D6,C7",17347,17814,13126,4688,8613,0,4016,4021,2800,1221,2.293202293,1983,1430,548,325,0,325,0,134,0,0.036923077,empty,mBC-0716-2
"D6,C8",15683,16318,11884,4434,7824,26,3524,3555,2411,1144,2.107517483,1718,1542,897,490,1,489,1,203,0,0.053169734,empty,mBC-0716-2
"D6,C9",13239,13627,10086,3541,6667,1,3108,3117,2198,919,2.391730141,1498,874,488,307,0,307,0,155,0,0.074918567,empty,mBC-0716-2
"D6,C10",974015,1103544,663642,439902,532534,15,322088,322545,272117,50428,5.396148965,183285,145710,90885,50794,16,50778,2,4193,0,0.000945291,mm10,mBC-0716-2
"D6,C11",12209,12993,9306,3687,6259,35,2883,2925,2040,885,2.305084746,1483,979,615,366,0,366,0,156,0,0.030054645,empty,mBC-0716-2
"D6,C12",744499,801135,551141,249994,385671,3,192829,193184,161582,31602,5.113030821,100723,93758,59260,32728,11,32717,2,3238,0,0.002292386,mm10,mBC-0716-2
"D6,D1",12137,12557,9049,3508,6215,0,2925,2935,2036,899,2.264738598,1410,6059,1940,1124,1,1123,1,337,0,0.026714159,empty,mBC-0716-2
"D6,D2",21500,21632,16416,5216,10616,16,4619,4650,3341,1309,2.552330023,2148,2436,1524,942,0,942,0,369,0,0.044585987,empty,mBC-0716-2
"D6,D3",14029,15035,10619,4416,7372,6,3515,3524,2438,1086,2.244935543,1762,1137,656,416,0,416,0,195,0,0.045673077,empty,mBC-0716-2
"D6,D4",15635,16211,11999,4212,7828,164,3447,3619,2526,1093,2.311070448,1760,1778,1078,689,1,688,1,274,0,0.020348837,empty,mBC-0716-2
"D6,D5",790022,851996,577836,274160,415843,0,216270,216666,180619,36047,5.010652759,114534,124511,72347,40587,18,40569,3,3852,0,0.003648106,mm10,mBC-0716-2
"D6,D6",12880,13662,9570,4092,6659,10,3148,3181,2142,1039,2.06159769,1598,3988,1786,1072,4,1068,1,366,0,0.086142322,empty,mBC-0716-2
"D6,D7",28817,32518,20882,11636,15637,8,8788,8817,6313,2504,2.521166134,4843,2270,1287,752,1,751,1,274,0,0.019973369,empty,mBC-0716-2
"D6,D8",15720,16756,11880,4876,8215,0,3948,3959,2699,1260,2.142063492,1981,1047,615,403,0,403,0,162,0,0.037220844,empty,mBC-0716-2
"D6,D9",5458,5576,4040,1536,2810,9,1283,1292,964,328,2.93902439,619,1681,972,628,0,628,0,276,0,0.038216561,empty,mBC-0716-2
"D6,D10",13689,14078,10446,3632,6904,0,3185,3194,2287,907,2.521499449,1544,878,541,305,0,305,0,124,0,0.029508197,empty,mBC-0716-2
"D6,D11",13739,14333,10318,4015,6975,9,3189,3213,2278,935,2.436363636,1582,1502,940,597,0,597,0,251,0,0.023450586,empty,mBC-0716-2
"D6,D12",25763,26547,19753,6794,12764,46,5893,5954,4270,1684,2.535629454,2829,2561,1595,948,0,948,0,309,0,0.065400844,empty,mBC-0716-2
"D6,E1",949634,1011444,688219,323225,491936,1,263700,264091,183486,80605,2.276360027,142282,16401,8943,5069,1,5068,1,1073,0,0.011641673,mm10,mBC-0716-2
"D6,E2",16739,16960,12855,4105,8355,0,3807,3815,2667,1148,2.323170732,1750,5853,1988,1201,0,1201,0,412,0,0.059950042,empty,mBC-0716-2
"D6,E3",1003314,1128036,670626,457410,541548,4,338959,339449,270327,69122,3.910867741,194467,113790,66911,38019,15,38004,4,3584,0,0.003236501,mm10,mBC-0716-2
"D6,E4",16326,16391,12482,3909,8030,7,3551,3573,2517,1056,2.383522727,1619,1234,758,450,0,450,0,190,0,0.017777778,empty,mBC-0716-2
"D6,E5",1102730,1237689,770872,466817,595761,10,351458,351992,259449,92543,2.803550782,197637,104337,68689,38019,19,38000,3,3444,0,0.000947368,mm10,mBC-0716-2
"D6,E6",14134,14400,10597,3803,7063,0,3175,3183,2284,899,2.540600667,1520,1626,964,577,2,575,1,257,0,0.036521739,empty,mBC-0716-2
"D6,E7",14507,14700,10874,3826,7137,0,3295,3303,2304,999,2.306306306,1579,1143,655,403,1,402,1,175,0,0.044776119,empty,mBC-0716-2
"D6,E8",18513,18433,14223,4210,9101,0,4007,4014,2855,1159,2.463330457,1836,11651,3914,2427,1,2426,1,657,0,0.071723001,empty,mBC-0716-2
"D6,E9",9779,10155,7499,2656,4939,4,2203,2213,1546,667,2.317841079,1061,1531,778,483,1,482,1,177,0,0.072614108,empty,mBC-0716-2
"D6,E10",13678,14471,10389,4082,6940,7,3161,3177,2210,967,2.285418821,1562,1201,709,436,1,435,1,192,0,0.018390805,empty,mBC-0716-2
"D6,E11",9593,9799,7336,2463,4891,0,2162,2165,1509,656,2.300304878,967,1155,647,390,0,390,0,182,0,0.046153846,empty,mBC-0716-2
"D6,E12",15986,16263,12168,4095,8089,0,3797,3808,2639,1169,2.25748503,1772,1229,692,430,0,430,0,190,0,0.006976744,empty,mBC-0716-2
"D6,F1",19330,20058,14690,5368,9594,25,4278,4316,3013,1303,2.312356101,2101,1711,1011,609,0,609,0,252,0,0.087027915,empty,mBC-0716-2
"D6,F2",24247,24744,17964,6780,12019,6,5532,5546,3866,1680,2.301190476,2680,27837,8250,4990,9,4981,2,1230,0,0.058422004,empty,mBC-0716-2
"D6,F3",879970,988350,614555,373795,479374,1,272609,273011,233637,39374,5.933788795,153893,138596,91162,50902,25,50877,3,4037,0,0.001474144,mm10,mBC-0716-2
"D6,F4",16834,16898,12663,4235,8445,0,3775,3780,2645,1135,2.330396476,1790,3022,1030,630,1,629,1,217,0,0.085850556,empty,mBC-0716-2
"D6,F5",25057,25927,18883,7044,12643,0,5828,5846,4154,1692,2.455082742,2897,2451,1271,801,0,801,0,343,0,0.02372035,empty,mBC-0716-2
"D6,F6",24494,24958,18337,6621,12141,8,5586,5602,3924,1678,2.338498212,2714,18964,5833,3456,1,3455,1,895,0,0.059334298,empty,mBC-0716-2
"D6,F7",1104520,1260686,739425,521261,616686,28,394406,394929,269953,124976,2.160038727,232737,10596,6484,3629,1,3628,1,829,0,0.007166483,mm10,mBC-0716-2
"D6,F8",1022603,1192955,670747,522208,579492,10,378012,378480,300452,78028,3.850566463,224535,7457,4610,2610,0,2610,0,604,0,0.002298851,mm10,mBC-0716-2
"D6,F9",767642,821471,567346,254125,401975,18,200816,201159,174546,26613,6.558674332,104890,119843,76226,42259,20,42239,4,3777,0,0.008759677,mm10,mBC-0716-2
"D6,F10",21147,21293,16339,4954,10407,12,4531,4549,3243,1306,2.483154671,2048,1211,689,437,1,436,1,174,0,0.009174312,empty,mBC-0716-2
"D6,F11",11685,12033,8903,3130,5828,0,2593,2601,1754,847,2.070838253,1227,924,560,377,1,376,1,187,0,0.021276596,empty,mBC-0716-2
"D6,F12",15060,15552,11453,4099,7348,15,3296,3316,2326,990,2.349494949,1566,287,129,81,0,81,0,48,0,0,empty,mBC-0716-2
"D6,G1",534097,583719,395240,188479,288431,1,150752,150985,126587,24398,5.188417083,79575,87358,56147,31288,9,31279,2,3128,0,0.00092714,mm10,mBC-0716-2
"D6,G2",1169288,1250992,853776,397216,597920,0,318018,318528,275519,43009,6.406077798,165686,28301,18055,10119,6,10113,1,1549,0,0.001483239,mm10,mBC-0716-2
"D6,G3",20679,20910,15582,5328,10038,1,4556,4580,3317,1263,2.626286619,2071,2163,1324,796,0,796,0,303,0,0.045226131,empty,mBC-0716-2
"D6,G4",28711,28663,22145,6518,14027,19,6215,6241,4480,1761,2.544009086,2865,185,115,78,0,78,0,63,0,0,empty,mBC-0716-2
"D6,G5",14300,14663,10900,3763,7057,12,3230,3250,2232,1018,2.192534381,1538,1191,672,436,0,436,0,243,0,0.027522936,empty,mBC-0716-2
"D6,G6",24727,25209,18849,6360,12281,0,5569,5579,3967,1612,2.460918114,2616,193,132,90,0,90,0,70,0,0.011111111,empty,mBC-0716-2
"D6,G7",20555,20811,15847,4964,10120,0,4400,4411,3081,1330,2.316541353,2040,2017,1180,741,0,741,0,310,0,0.064777328,empty,mBC-0716-2
"D6,G8",15065,15348,11394,3954,7488,0,3557,3563,2458,1105,2.224434389,1705,1753,1091,651,0,651,0,275,0,0.016897081,empty,mBC-0716-2
"D6,G9",11102,11572,8439,3133,5691,9,2634,2650,1869,781,2.393085787,1294,1349,806,532,0,532,0,264,0,0.013157895,empty,mBC-0716-2
"D6,G10",14450,14797,10697,4100,7276,0,3326,3332,2343,989,2.369059656,1679,11525,3832,2405,3,2402,1,624,0,0.129475437,empty,mBC-0716-2
"D6,G11",12760,13096,9829,3267,6452,0,2870,2874,2001,873,2.29209622,1306,926,481,287,1,286,1,141,0,0,empty,mBC-0716-2
"D6,G12",11826,12110,8923,3187,6062,0,2841,2844,2001,843,2.37366548,1431,1162,659,408,1,407,1,178,0,0.041769042,empty,mBC-0716-2
"D6,H1",22146,22815,16703,6112,11045,0,5126,5141,3624,1517,2.388925511,2495,902,532,354,1,353,1,177,0,0.025495751,empty,mBC-0716-2
"D6,H2",24728,25194,19133,6061,12176,0,5421,5432,3849,1583,2.431459255,2500,2042,1167,743,0,743,0,327,0,0.020188425,empty,mBC-0716-2
"D6,H3",21223,22035,16013,6022,10573,9,4929,4949,3503,1446,2.422544952,2390,1612,973,573,0,573,0,261,0,0.022687609,empty,mBC-0716-2
"D6,H4",15735,15783,11253,4530,7578,0,3624,3634,2544,1090,2.333944954,1818,1427,548,342,0,342,0,129,0,0.239766082,empty,mBC-0716-2
"D6,H5",18700,19413,14252,5161,9298,3,4259,4276,2996,1280,2.340625,2062,1584,917,584,0,584,0,234,0,0.018835616,empty,mBC-0716-2
"D6,H6",14989,15339,11481,3858,7540,33,3446,3483,2494,989,2.52173913,1638,1805,1073,655,0,655,0,248,0,0.054961832,empty,mBC-0716-2
"D6,H7",955739,1039817,667687,372130,506271,23,288246,288683,245472,43211,5.680775728,158006,112258,72241,39931,18,39913,4,3624,0,0.005061008,mm10,mBC-0716-2
"D6,H8",765614,803368,564617,238751,386232,1,192018,192350,164098,28252,5.808367549,98547,118566,76373,42812,18,42794,4,3788,0,0.000887975,mm10,mBC-0716-2
"D6,H9",16397,16528,12243,4285,8203,12,3716,3732,2679,1053,2.544159544,1850,2783,1202,768,0,768,0,311,0,0.061197917,empty,mBC-0716-2
"D6,H10",15616,15880,11884,3996,7616,2,3471,3484,2466,1018,2.422396857,1627,2591,1249,747,1,746,1,320,0,0.012064343,empty,mBC-0716-2
"D6,H11",17764,18771,13389,5382,9022,33,4297,4344,3012,1332,2.261261261,2121,385,148,113,1,112,1,85,0,0,empty,mBC-0716-2
"D6,H12",6379,6392,4682,1710,3180,1,1507,1512,1059,453,2.337748344,750,4926,1508,865,4,861,1,302,0,0.066202091,empty,mBC-0716-2
"D7,A1",22726,23239,17340,5899,11536,1,5247,5263,3848,1415,2.719434629,2492,5763,1834,1135,0,1135,0,354,0,0.079295154,empty,mBC-0716-2
"D7,A2",21576,21910,16788,5122,10550,0,4623,4633,3256,1377,2.364560639,2085,972,508,329,1,328,1,136,0,0.057926829,empty,mBC-0716-2
"D7,A3",18583,19345,14065,5280,9251,0,4206,4212,2972,1240,2.396774194,2043,1603,675,407,0,407,0,162,0,0.078624079,empty,mBC-0716-2
"D7,A4",1206543,1296289,870377,425912,609376,1,328572,329119,279291,49828,5.605101549,174169,21644,13711,7573,1,7572,1,1344,0,0.001320655,mm10,mBC-0716-2
"D7,A5",19640,20759,15105,5654,10030,11,4601,4623,3285,1338,2.455156951,2248,1039,599,384,0,384,0,188,0,0.075520833,empty,mBC-0716-2
"D7,A6",501685,527521,369433,158088,259640,11,134104,134339,104180,30159,3.454358566,69311,16126,10318,5753,4,5749,1,1244,0,0.008871108,mm10,mBC-0716-2
"D7,A7",17656,18208,13288,4920,8876,0,4082,4097,2906,1191,2.439966415,1995,2162,979,620,0,620,0,214,0,0.090322581,empty,mBC-0716-2
"D7,A8",489714,511386,374987,136399,251867,0,120020,120241,88280,31961,2.762116329,59007,7493,4783,2754,1,2753,1,747,0,0.010170723,mm10,mBC-0716-2
"D7,A9",20354,20596,15604,4992,9898,0,4434,4443,3176,1267,2.506708761,2052,2320,995,627,1,626,1,230,0,0.108626198,empty,mBC-0716-2
"D7,A10",17941,18756,13632,5124,8954,0,4080,4086,2786,1300,2.143076923,2005,423,249,166,0,166,0,90,0,0.006024096,empty,mBC-0716-2
"D7,A11",20658,21500,15940,5560,10297,0,4632,4645,3209,1436,2.234679666,2263,884,494,322,0,322,0,165,0,0.02484472,empty,mBC-0716-2
"D7,A12",23178,23744,17775,5969,11207,2,4984,4992,3469,1523,2.2777413,2399,1990,1180,706,0,706,0,226,0,0.062322946,empty,mBC-0716-2
"D7,B1",21697,22683,16817,5866,10887,8,4946,4967,3476,1491,2.331321261,2392,938,527,332,0,332,0,158,0,0.012048193,empty,mBC-0716-2
"D7,B2",21629,22353,16486,5867,10726,0,4802,4814,3432,1382,2.483357453,2312,2266,747,441,1,440,1,146,0,0.070454545,empty,mBC-0716-2
"D7,B3",22972,24114,17301,6813,11706,25,5541,5585,3991,1594,2.503764115,2773,1420,836,478,1,477,1,182,0,0.067085954,empty,mBC-0716-2
"D7,B4",18391,19157,13967,5190,9164,6,4152,4164,2971,1193,2.490360436,2021,1364,684,430,0,430,0,171,0,0.058139535,empty,mBC-0716-2
"D7,B5",636934,358302,238070,120232,229805,3,117085,117897,93913,23984,3.915652101,67228,32038,20763,11468,3,11465,1,1787,0,0.001221108,mm10,mBC-0716-2
"D7,B6",822125,909844,580872,328972,439314,7,246244,246600,209737,36863,5.689634593,136939,78550,49832,27872,15,27857,1,2953,0,0.002476936,mm10,mBC-0716-2
"D7,B7",17931,18186,13652,4534,8879,3,3923,3942,2802,1140,2.457894737,1859,847,465,267,0,267,0,129,0,0.074906367,empty,mBC-0716-2
"D7,B8",15274,15581,11532,4049,7576,32,3364,3406,2396,1010,2.372277228,1671,933,561,356,0,356,0,179,0,0.087078652,empty,mBC-0716-2
"D7,B9",16294,16896,12356,4540,8115,2,3736,3755,2645,1110,2.382882883,1775,510,345,210,0,210,0,109,0,0.095238095,empty,mBC-0716-2
"D7,B10",19474,19711,14286,5425,9765,0,4565,4582,3082,1500,2.054666667,2258,5509,1547,876,0,876,0,271,0,0.025114155,empty,mBC-0716-2
"D7,B11",17843,18387,13849,4538,8882,1,4074,4085,2855,1230,2.321138211,1879,187,111,69,0,69,0,50,0,0,empty,mBC-0716-2
"D7,B12",20094,21022,15207,5815,10118,0,4679,4692,3334,1358,2.455081001,2259,1096,632,397,0,397,0,147,0,0.035264484,empty,mBC-0716-2
"D7,C1",25665,26210,19941,6269,12390,0,5330,5349,3792,1557,2.435452794,2463,694,407,242,0,242,0,115,0,0.090909091,empty,mBC-0716-2
"D7,C2",1156828,1268648,812603,456045,601664,10,347954,348478,266903,81575,3.27187251,192229,35141,22702,12864,5,12859,2,1880,0,0.00225523,mm10,mBC-0716-2
"D7,C3",22063,22825,16584,6241,10899,5,5019,5046,3510,1536,2.28515625,2498,439,239,136,0,136,0,75,0,0.132352941,empty,mBC-0716-2
"D7,C4",26414,27721,20394,7327,13351,9,6144,6159,4383,1776,2.467905405,2947,1133,690,427,0,427,0,154,0,0.014051522,empty,mBC-0716-2
"D7,C5",18450,18711,13869,4842,9070,30,4180,4218,2956,1262,2.342313788,1965,1101,728,411,0,411,0,179,0,0.02919708,empty,mBC-0716-2
"D7,C6",20011,20636,15025,5611,10284,5,4784,4797,3407,1390,2.451079137,2406,1113,654,400,0,400,0,169,0,0.0375,empty,mBC-0716-2
"D7,C7",18321,19105,13856,5249,9244,10,4377,4398,3097,1301,2.380476556,2215,383,240,132,0,132,0,63,0,0,empty,mBC-0716-2
"D7,C8",17085,17689,13091,4598,8545,44,3841,3891,2708,1183,2.28909552,1872,1174,691,427,0,427,0,175,0,0.021077283,empty,mBC-0716-2
"D7,C9",1749585,1954675,1237893,716782,926199,9,531147,531937,438291,93646,4.680296008,296725,110458,69733,38967,17,38950,2,3653,0,0.001335045,mm10,mBC-0716-2
"D7,C10",15056,15588,11417,4171,7581,15,3500,3526,2397,1129,2.123117803,1722,854,495,314,0,314,0,137,0,0.073248408,empty,mBC-0716-2
"D7,C11",13066,13854,9818,4036,6581,0,3134,3136,2197,939,2.33972311,1584,696,390,246,0,246,0,117,0,0.020325203,empty,mBC-0716-2
"D7,C12",21398,22018,16187,5831,10639,3,4828,4843,3356,1487,2.256893073,2293,2343,853,510,0,510,0,185,0,0.035294118,empty,mBC-0716-2
"D7,D1",13538,14122,10206,3916,6849,25,3158,3191,2260,931,2.427497315,1588,1181,448,270,0,270,0,113,0,0.092592593,empty,mBC-0716-2
"D7,D2",23371,23964,18007,5957,11664,0,5256,5262,3776,1486,2.541049798,2473,1878,1140,682,0,682,0,268,0,0.065982405,empty,mBC-0716-2
"D7,D3",15774,16210,11826,4384,7963,35,3714,3753,2606,1147,2.272013949,1850,5943,1860,1147,5,1142,2,382,0,0.022767075,empty,mBC-0716-2
"D7,D4",16611,16952,12669,4283,8509,3,3895,3904,2779,1125,2.470222222,1861,4258,1519,919,1,918,1,325,0,0.041394336,empty,mBC-0716-2
"D7,D5",1003090,1093894,720813,373081,526036,2,289713,290158,225781,64377,3.507168709,156838,50724,32471,17820,12,17808,1,2300,0,0.001123091,mm10,mBC-0716-2
"D7,D6",14077,14697,10584,4113,7169,16,3411,3430,2376,1054,2.25426945,1694,839,471,290,0,290,0,130,0,0.065517241,empty,mBC-0716-2
"D7,D7",14159,14516,10684,3832,7051,0,3289,3297,2270,1027,2.210321324,1571,1064,627,359,0,359,0,151,0,0.022284123,empty,mBC-0716-2
"D7,D8",17506,18128,13156,4972,8753,0,4151,4162,2912,1250,2.3296,1987,856,527,317,0,317,0,137,0,0.006309148,empty,mBC-0716-2
"D7,D9",6455,6631,4740,1891,3355,0,1573,1576,1144,432,2.648148148,809,3104,1269,793,0,793,0,300,0,0.030264817,empty,mBC-0716-2
"D7,D10",802764,869363,585902,283461,419323,0,218544,218874,187314,31560,5.935171103,116569,50077,30629,17174,12,17162,2,2193,0,0.000466146,mm10,mBC-0716-2
"D7,D11",1071916,1257131,697552,559579,606451,45,402402,402929,265104,137825,1.923482677,244512,46046,27431,15375,6,15369,2,2181,0,0.007222331,mm10,mBC-0716-2
"D7,D12",22093,22784,16960,5824,10825,5,4940,4955,3498,1457,2.40082361,2336,1834,1135,666,0,666,0,235,0,0.097597598,empty,mBC-0716-2
"D7,E1",24194,24559,18497,6062,11826,0,5297,5302,3763,1539,2.445094217,2482,1363,853,508,0,508,0,212,0,0.031496063,empty,mBC-0716-2
"D7,E2",885730,956306,618353,337953,464232,0,265943,266297,221380,44917,4.92864617,145250,44392,27438,15445,10,15435,3,2122,0,0.014188533,mm10,mBC-0716-2
"D7,E3",13332,13677,10230,3447,6710,0,3011,3019,2104,915,2.299453552,1371,1674,883,515,0,515,0,213,0,0.038834951,empty,mBC-0716-2
"D7,E4",17035,17490,12985,4505,8439,5,3755,3771,2577,1194,2.158291457,1781,6662,2102,1248,2,1246,1,388,0,0.028089888,empty,mBC-0716-2
"D7,E5",22831,23766,17493,6273,11538,0,5157,5173,3599,1574,2.286531131,2518,1177,738,475,0,475,0,196,0,0.050526316,empty,mBC-0716-2
"D7,E6",16035,16322,12088,4234,7855,0,3555,3564,2591,973,2.662898253,1668,1445,778,489,0,489,0,221,0,0.073619632,empty,mBC-0716-2
"D7,E7",653062,701244,467791,233453,342230,19,187124,187452,144686,42766,3.383201609,100131,33897,15286,8821,7,8814,1,1718,0,0.049693669,mm10,mBC-0716-2
"D7,E8",1644741,1800781,1173607,627174,862780,15,488768,489445,387870,101575,3.818557716,266231,114996,71866,40633,15,40618,1,3954,0,0.001920331,mm10,mBC-0716-2
"D7,E9",10607,10803,7881,2922,5336,11,2410,2429,1753,676,2.593195266,1175,755,447,284,1,283,1,118,0,0.024734982,empty,mBC-0716-2
"D7,E10",13833,14356,10577,3779,7169,0,3348,3354,2284,1070,2.134579439,1628,989,565,355,0,355,0,155,0,0.008450704,empty,mBC-0716-2
"D7,E11",10407,10877,8022,2855,5265,0,2428,2434,1740,694,2.507204611,1177,995,540,325,0,325,0,143,0,0.095384615,empty,mBC-0716-2
"D7,E12",16823,17049,12649,4400,8556,0,4017,4034,2778,1256,2.211783439,1953,1051,640,379,1,378,1,132,0,0.111111111,empty,mBC-0716-2
"D7,F1",20119,20933,15305,5628,10151,0,4733,4738,3300,1438,2.294853964,2304,1357,802,476,0,476,0,190,0,0.069327731,empty,mBC-0716-2
"D7,F2",24996,26053,18933,7120,12635,0,5967,5976,4187,1789,2.340413639,2914,4020,1844,1128,0,1128,0,421,0,0.019503546,empty,mBC-0716-2
"D7,F3",2294975,2587845,1563057,1024788,1211729,9,734896,735844,613584,122260,5.018681498,425524,6440,3310,1837,2,1835,1,729,0,0.03106267,mm10,mBC-0716-2
"D7,F4",1020614,1070574,739083,331491,518332,57,266401,266891,231508,35383,6.54291609,138566,34466,21529,11986,7,11979,1,1723,0,0.001586109,mm10,mBC-0716-2
"D7,F5",27768,28960,21104,7856,13898,0,6420,6442,4612,1830,2.520218579,3127,1309,810,485,0,485,0,232,0,0.039175258,empty,mBC-0716-2
"D7,F6",26386,27291,20277,7014,13004,17,5950,5983,4329,1654,2.617291415,2797,1410,815,497,1,496,1,188,0,0.036290323,empty,mBC-0716-2
"D7,F7",23191,23916,17664,6252,11486,0,5172,5175,3668,1507,2.433974784,2491,796,429,278,0,278,0,129,0,0,empty,mBC-0716-2
"D7,F8",24318,25068,18511,6557,12319,0,5682,5698,4052,1646,2.461725395,2702,307,197,125,0,125,0,76,0,0,empty,mBC-0716-2
"D7,F9",874396,902264,652786,249478,436244,7,213363,213749,157430,56319,2.795326622,107229,24850,14804,8643,7,8636,4,1572,0,0.00717925,mm10,mBC-0716-2
"D7,F10",21945,22251,16977,5274,11020,3,4854,4864,3446,1418,2.430183357,2218,1333,689,415,0,415,0,164,0,0.065060241,empty,mBC-0716-2
"D7,F11",12518,12610,9701,2909,6310,2,2827,2839,1992,847,2.351829988,1311,913,539,340,0,340,0,148,0,0.038235294,empty,mBC-0716-2
"D7,F12",15758,16360,12041,4319,7764,0,3527,3534,2457,1077,2.281337047,1643,147,69,47,0,47,0,29,0,0,empty,mBC-0716-2
"D7,G1",10904,11520,8428,3092,5577,0,2494,2499,1720,779,2.207958922,1169,1306,875,509,0,509,0,166,0,0.013752456,empty,mBC-0716-2
"D7,G2",24303,24709,18229,6480,11815,1,5426,5432,3823,1609,2.376009944,2614,1759,639,388,0,388,0,162,0,0.087628866,empty,mBC-0716-2
"D7,G3",22448,23058,16962,6096,11193,22,5171,5206,3636,1570,2.315923567,2525,1779,1003,627,0,627,0,212,0,0.035087719,empty,mBC-0716-2
"D7,G4",32105,32251,24312,7939,15447,17,6765,6808,4715,2093,2.252747253,3251,129,85,60,0,60,0,47,0,0,empty,mBC-0716-2
"D7,G5",15245,15897,11499,4398,7734,6,3626,3635,2563,1072,2.390858209,1809,1235,646,408,0,408,0,192,0,0.039215686,empty,mBC-0716-2
"D7,G6",27484,27902,21015,6887,13081,57,5637,5706,4045,1661,2.435279952,2588,1229,422,246,0,246,0,102,0,0.008130081,empty,mBC-0716-2
"D7,G7",760313,793195,577384,215811,387067,0,188212,188566,144289,44277,3.258779953,93237,11711,7218,4170,0,4170,0,947,0,0.020383693,mm10,mBC-0716-2
"D7,G8",16739,17401,12680,4721,8429,37,4030,4081,2881,1200,2.400833333,2061,1226,755,478,0,478,0,205,0,0.056485356,empty,mBC-0716-2
"D7,G9",12104,12672,9128,3544,5988,0,2827,2838,1991,847,2.350649351,1364,890,551,333,0,333,0,172,0,0.036036036,empty,mBC-0716-2
"D7,G10",14947,15494,11355,4139,7636,0,3501,3514,2492,1022,2.438356164,1701,2232,1059,644,0,644,0,255,0,0.062111801,empty,mBC-0716-2
"D7,G11",13656,13773,10528,3245,6600,0,2912,2912,2092,820,2.551219512,1329,474,312,197,0,197,0,83,0,0,empty,mBC-0716-2
"D7,G12",12903,13314,9803,3511,6532,0,3086,3089,2147,942,2.279193206,1509,3674,1546,903,0,903,0,250,0,0.289036545,empty,mBC-0716-2
"D7,H1",23763,24648,18001,6647,11979,20,5466,5499,3989,1510,2.641721854,2716,790,459,249,2,247,1,104,0,0.024291498,empty,mBC-0716-2
"D7,H2",27920,28956,21218,7738,13895,0,6477,6485,4570,1915,2.386422977,3148,1749,1085,637,0,637,0,257,0,0.025117739,empty,mBC-0716-2
"D7,H3",23207,23662,17782,5880,11510,0,5276,5284,3771,1513,2.492399207,2461,967,538,338,0,338,0,167,0,0.044378698,empty,mBC-0716-2
"D7,H4",15900,16615,12066,4549,8042,0,3813,3821,2682,1139,2.354697103,1866,235,156,101,0,101,0,68,0,0,empty,mBC-0716-2
"D7,H5",20137,21123,15183,5940,10063,0,4837,4843,3430,1413,2.427459306,2404,1148,706,410,0,410,0,168,0,0.082926829,empty,mBC-0716-2
"D7,H6",16896,17507,12738,4769,8433,7,3906,3924,2798,1126,2.484902309,1927,3924,1557,902,2,900,1,287,0,0.064444444,empty,mBC-0716-2
"D7,H7",1029200,1128604,717463,411141,544052,5,316348,316768,259667,57101,4.547503546,175513,47330,30920,17561,7,17554,2,2258,0,0.001709012,mm10,mBC-0716-2
"D7,H8",1094009,1089029,842824,246205,523238,0,221152,221627,180850,40777,4.435098217,102908,39556,23919,13550,7,13543,1,2258,0,0.006793177,mm10,mBC-0716-2
"D7,H9",19144,19754,14123,5631,9672,0,4533,4549,3162,1387,2.279740447,2270,968,598,355,0,355,0,183,0,0.011267606,empty,mBC-0716-2
"D7,H10",16843,17527,12698,4829,8496,0,4059,4068,2877,1191,2.415617128,1975,4982,1850,1094,1,1093,1,342,0,0.049405306,empty,mBC-0716-2
"D7,H11",1614077,1775368,1171367,604001,846320,1,464614,465298,378533,86765,4.362738431,252808,5359,3357,1859,0,1859,0,476,0,0.003765465,mm10,mBC-0716-2
"D7,H12",791360,875695,564746,310949,424233,1,239290,239680,170006,69674,2.440020668,132568,60013,37405,21117,5,21112,2,2453,0,0.001420993,mm10,mBC-0716-2
"D8,A1",16693,17248,12711,4537,8651,0,4059,4074,2849,1225,2.325714286,1946,1229,718,418,0,418,0,182,0,0.031100478,empty,mBC-0716-2
"D8,A2",22511,22937,17221,5716,10939,2,4772,4793,3323,1470,2.260544218,2258,1167,730,464,0,464,0,198,0,0.064655172,empty,mBC-0716-2
"D8,A3",19315,20072,14581,5491,9735,19,4512,4535,3219,1316,2.446048632,2198,1212,676,405,0,405,0,170,0,0.056790123,empty,mBC-0716-2
"D8,A4",1103802,1137026,852306,284720,530764,12,229834,230294,205892,24402,8.437505123,110268,49390,31592,17891,6,17885,1,2253,0,0.000615041,mm10,mBC-0716-2
"D8,A5",19530,20261,14846,5415,9976,1,4537,4548,3178,1370,2.319708029,2212,2214,1059,670,1,669,1,290,0,0.034379671,empty,mBC-0716-2
"D8,A6",19600,20952,14660,6292,10296,4,5094,5104,3667,1437,2.55184412,2624,3111,1291,776,0,776,0,310,0,0.056701031,empty,mBC-0716-2
"D8,A7",1554760,1748337,1107645,640692,842238,11,486596,487298,394495,92803,4.250886286,271606,118950,76143,43250,22,43228,2,3640,0,0.001966318,mm10,mBC-0716-2
"D8,A8",12565,12943,9526,3417,6313,2,2948,2963,2098,865,2.425433526,1399,1937,970,632,0,632,0,249,0,0.060126582,empty,mBC-0716-2
"D8,A9",20918,21336,16128,5208,10280,0,4535,4540,3188,1352,2.357988166,2110,1404,793,474,0,474,0,202,0,0.069620253,empty,mBC-0716-2
"D8,A10",18250,18714,13729,4985,9072,0,4130,4137,2952,1185,2.491139241,1999,500,306,188,0,188,0,107,0,0.079787234,empty,mBC-0716-2
"D8,A11",21445,21995,16414,5581,10615,0,4768,4780,3303,1477,2.236289777,2214,1253,701,410,0,410,0,181,0,0.068292683,empty,mBC-0716-2
"D8,A12",23708,24337,18235,6102,11412,4,4993,5013,3537,1476,2.396341463,2258,2699,1621,1001,0,1001,0,311,0,0.07992008,empty,mBC-0716-2
"D8,B1",1167843,1299802,831914,467888,620972,2,355269,355744,242682,113062,2.14645062,198504,44680,27775,15789,11,15778,1,2289,0,0.007542147,mm10,mBC-0716-2
"D8,B2",21909,22138,16939,5199,10827,0,4823,4836,3375,1461,2.310061602,2266,1373,585,360,0,360,0,143,0,0.080555556,empty,mBC-0716-2
"D8,B3",21705,22534,16683,5851,10798,11,4928,4944,3499,1445,2.421453287,2343,1435,904,558,0,558,0,219,0,0.064516129,empty,mBC-0716-2
"D8,B4",931733,1021287,671612,349675,493131,7,267182,267586,223123,44463,5.018172413,145478,77322,50854,28305,10,28295,1,2812,0,0.000671497,mm10,mBC-0716-2
"D8,B5",636001,396178,242972,153206,252736,3,146591,147380,118249,29131,4.059215269,86368,52586,32948,18284,9,18275,2,2381,0,0.002024624,mm10,mBC-0716-2
"D8,B6",14893,15432,11217,4215,7574,1,3565,3579,2568,1011,2.540059347,1759,2167,1056,658,0,658,0,240,0,0.063829787,empty,mBC-0716-2
"D8,B7",18381,19101,14174,4927,9341,0,4294,4310,3069,1241,2.473005641,2089,1103,672,421,0,421,0,158,0,0.106888361,empty,mBC-0716-2
"D8,B8",833476,939526,591846,347680,453548,16,256794,257193,210653,46540,4.52627847,143065,123677,81393,45077,26,45051,3,3859,0,0.001065459,mm10,mBC-0716-2
"D8,B9",16770,17331,12850,4481,8348,7,3780,3802,2644,1158,2.283246978,1787,896,559,359,0,359,0,138,0,0.08913649,empty,mBC-0716-2
"D8,B10",19059,19469,14268,5201,9709,1,4403,4423,3063,1360,2.252205882,2090,685,382,230,0,230,0,101,0,0.039130435,empty,mBC-0716-2
"D8,B11",23837,24770,17848,6922,12183,4,5737,5757,4185,1572,2.66221374,2923,280,150,98,0,98,0,61,0,0.040816327,empty,mBC-0716-2
"D8,B12",20734,21102,16029,5073,10370,2,4680,4686,3290,1396,2.356733524,2164,1427,844,489,1,488,1,192,0,0.040983607,empty,mBC-0716-2
"D8,C1",24859,24971,19060,5911,12089,0,5158,5165,3708,1457,2.544955388,2374,736,467,274,0,274,0,124,0,0.032846715,empty,mBC-0716-2
"D8,C2",21334,21876,16169,5707,10498,0,4843,4852,3405,1447,2.353144437,2344,1680,1039,594,1,593,1,211,0,0.064080944,empty,mBC-0716-2
"D8,C3",24578,25517,18796,6721,12233,0,5669,5676,4059,1617,2.510204082,2707,764,446,276,1,275,1,110,0,0.018181818,empty,mBC-0716-2
"D8,C4",20697,20540,15707,4833,10030,0,4444,4459,3205,1254,2.555821372,1994,3546,1439,854,0,854,0,271,0,0.128805621,empty,mBC-0716-2
"D8,C5",18736,19384,14525,4859,9392,4,4294,4303,3050,1253,2.434158021,1985,1368,852,551,0,551,0,222,0,0.070780399,empty,mBC-0716-2
"D8,C6",860084,909429,644437,264992,451723,1,223480,223824,147704,76120,1.940409879,120927,7233,4539,2624,1,2623,1,634,0,0.003431186,mm10,mBC-0716-2
"D8,C7",18172,18568,13899,4669,8900,6,4063,4072,2890,1182,2.44500846,1867,351,213,132,0,132,0,76,0,0.007575758,empty,mBC-0716-2
"D8,C8",17997,18593,13674,4919,8948,0,4055,4064,2715,1349,2.012601927,1936,14065,4296,2535,2,2533,2,695,0,0.045795499,empty,mBC-0716-2
"D8,C9",15215,16140,11582,4558,7806,15,3739,3763,2642,1121,2.356824264,1894,17375,5105,2981,0,2981,0,726,0,0.022811137,empty,mBC-0716-2
"D8,C10",15828,16175,12084,4091,7952,0,3565,3573,2510,1063,2.361241769,1683,1046,609,374,0,374,0,168,0,0.026737968,empty,mBC-0716-2
"D8,C11",13269,13819,10098,3721,6752,0,3116,3129,2155,974,2.212525667,1568,6434,1949,1161,0,1161,0,370,0,0.036175711,empty,mBC-0716-2
"D8,C12",22809,23569,17201,6368,11354,0,5176,5189,3649,1540,2.369480519,2564,1103,700,418,0,418,0,156,0,0.045454545,empty,mBC-0716-2
"D8,D1",13911,14542,10284,4258,6984,0,3270,3287,2308,979,2.357507661,1636,6280,1954,1127,2,1125,2,341,0,0.021333333,empty,mBC-0716-2
"D8,D2",23808,24150,18309,5841,11662,7,5098,5119,3654,1465,2.494197952,2375,2836,1634,985,0,985,0,381,0,0.028426396,empty,mBC-0716-2
"D8,D3",15788,16247,11858,4389,8101,8,3830,3846,2690,1156,2.326989619,1878,1455,810,527,0,527,0,217,0,0.055028463,empty,mBC-0716-2
"D8,D4",16542,17455,12596,4859,8458,6,3915,3927,2717,1210,2.245454545,1955,1468,903,571,0,571,0,246,0,0.015761821,empty,mBC-0716-2
"D8,D5",16058,16693,12150,4543,8152,0,3776,3789,2603,1186,2.194772344,1839,1333,783,471,0,471,0,189,0,0.044585987,empty,mBC-0716-2
"D8,D6",14708,15160,10993,4167,7447,1,3526,3536,2472,1064,2.323308271,1732,7094,2300,1390,0,1390,0,462,0,0.032374101,empty,mBC-0716-2
"D8,D7",15186,15705,11619,4086,7666,0,3554,3563,2501,1062,2.354990584,1720,1346,788,457,0,457,0,181,0,0.059080963,empty,mBC-0716-2
"D8,D8",18948,19652,14449,5203,9502,1,4429,4439,3115,1324,2.352719033,2156,1036,588,335,0,335,0,149,0,0.035820896,empty,mBC-0716-2
"D8,D9",6812,7045,5036,2009,3555,0,1673,1682,1188,494,2.4048583,842,1858,1038,695,0,695,0,299,0,0.064748201,empty,mBC-0716-2
"D8,D10",15967,16355,12159,4196,7935,27,3621,3653,2548,1105,2.305882353,1703,970,573,325,0,325,0,123,0,0.055384615,empty,mBC-0716-2
"D8,D11",15484,16123,11721,4402,7893,62,3578,3652,2586,1066,2.425891182,1825,2117,1244,708,0,708,0,286,0,0.031073446,empty,mBC-0716-2
"D8,D12",23049,23643,17485,6158,11247,0,5055,5071,3537,1534,2.305736636,2388,2480,1522,884,0,884,0,307,0,0.066742081,empty,mBC-0716-2
"D8,E1",24378,25172,18655,6517,12225,8,5468,5487,3867,1620,2.387037037,2661,1669,983,609,0,609,0,264,0,0.05090312,empty,mBC-0716-2
"D8,E2",19059,19517,14425,5092,9593,0,4385,4395,3061,1334,2.294602699,2152,1430,814,476,1,475,1,197,0,0.075789474,empty,mBC-0716-2
"D8,E3",13993,14348,10780,3568,6961,0,3036,3052,2129,923,2.306608884,1377,1581,898,533,0,533,0,236,0,0.030018762,empty,mBC-0716-2
"D8,E4",17972,18627,13646,4981,8670,4,4065,4075,2813,1262,2.229001585,1916,1479,872,527,1,526,1,192,0,0.058935361,empty,mBC-0716-2
"D8,E5",24428,24727,18778,5949,12028,0,5390,5401,3866,1535,2.518566775,2437,1433,883,523,0,523,0,221,0,0.066921606,empty,mBC-0716-2
"D8,E6",16143,16559,12402,4157,8078,1,3576,3585,2577,1008,2.556547619,1740,1816,1087,671,0,671,0,278,0,0.044709389,empty,mBC-0716-2
"D8,E7",16194,16605,12245,4360,8108,0,3755,3766,2593,1173,2.210571185,1821,1148,724,446,1,445,1,189,0,0.065168539,empty,mBC-0716-2
"D8,E8",21286,21653,15958,5695,10195,5,4570,4585,3222,1363,2.363903155,2162,42498,12466,7430,4,7426,2,1425,0,0.100861837,empty,mBC-0716-2
"D8,E9",10583,11145,8210,2935,5400,2,2495,2502,1785,717,2.489539749,1172,1030,650,391,0,391,0,161,0,0.058823529,empty,mBC-0716-2
"D8,E10",14863,15504,11258,4246,7478,4,3516,3529,2464,1065,2.313615023,1685,2636,1252,694,1,693,1,261,0,0.051948052,empty,mBC-0716-2
"D8,E11",10854,11218,8219,2999,5598,1,2606,2610,1811,799,2.266583229,1232,1195,710,430,0,430,0,181,0,0.025581395,empty,mBC-0716-2
"D8,E12",17632,18188,13424,4764,8984,0,4216,4233,2962,1271,2.330448466,2045,1316,704,413,0,413,0,167,0,0.092009685,empty,mBC-0716-2
"D8,F1",20524,20927,15857,5070,10221,0,4572,4575,3191,1384,2.305635838,2157,1582,955,546,0,546,0,234,0,0.029304029,empty,mBC-0716-2
"D8,F2",906216,955460,686360,269100,458484,3,217853,218240,181557,36683,4.949349835,109748,102225,62341,35566,24,35542,4,3435,0,0.001406786,mm10,mBC-0716-2
"D8,F3",18801,19768,14014,5754,9670,0,4615,4623,3269,1354,2.414327917,2380,1959,1146,714,0,714,0,285,0,0.032212885,empty,mBC-0716-2
"D8,F4",19285,19885,14678,5207,9603,68,4282,4364,3113,1251,2.488409273,2087,500,259,183,0,183,0,94,0,0.027322404,empty,mBC-0716-2
"D8,F5",1236538,1376923,858159,518764,654439,1,391035,391659,307723,83936,3.666162314,218972,69699,45059,25582,14,25568,1,2859,0,0.002112015,mm10,mBC-0716-2
"D8,F6",27401,28078,20792,7286,13489,0,6165,6176,4343,1833,2.36933988,2974,2215,1292,753,1,752,1,293,0,0.079787234,empty,mBC-0716-2
"D8,F7",1143829,1222726,843221,379505,585527,1,303552,304057,251565,52492,4.792444563,158219,42126,27808,15520,12,15508,1,2084,0,0.001096208,mm10,mBC-0716-2
"D8,F8",26087,27272,19796,7476,13011,0,5934,5951,4204,1747,2.40641099,2912,370,231,155,0,155,0,89,0,0.064516129,empty,mBC-0716-2
"D8,F9",2390039,2429530,1839545,589985,1125934,7,505112,506161,391269,114892,3.405537374,244284,203899,125706,70659,31,70628,2,5280,0,0.005621,mm10,mBC-0716-2
"D8,F10",3631917,3890410,2639969,1250441,1762388,3,987192,988650,818839,169811,4.822060997,519771,151443,97929,54173,21,54152,3,4420,0,0.001052593,mm10,mBC-0716-2
"D8,F11",857592,940574,622796,317778,457215,5,248581,248978,197216,51762,3.810053707,134254,86461,50144,28362,11,28351,2,3141,0,0.00165779,mm10,mBC-0716-2
"D8,F12",16222,16620,12386,4234,8070,0,3680,3696,2592,1104,2.347826087,1697,151,82,50,0,50,0,37,0,0,empty,mBC-0716-2
"D8,G1",11256,11862,8721,3141,5705,0,2564,2576,1797,779,2.306803594,1210,3335,1455,908,1,907,1,286,0,0.068357222,empty,mBC-0716-2
"D8,G2",1337826,1467009,951119,515890,696717,2,399303,399916,313456,86460,3.625445293,217494,30977,19690,11193,5,11188,2,1634,0,0.002145156,mm10,mBC-0716-2
"D8,G3",25365,26561,19277,7284,12812,6,5965,5983,4244,1739,2.440483036,2946,1911,1187,749,0,749,0,304,0,0.029372497,empty,mBC-0716-2
"D8,G4",32613,32976,24658,8318,15963,2,7052,7065,5117,1948,2.626796715,3399,199,132,99,0,99,0,75,0,0.04040404,empty,mBC-0716-2
"D8,G5",15426,15846,11843,4003,7675,0,3454,3463,2423,1040,2.329807692,1628,1359,829,519,0,519,0,238,0,0.011560694,empty,mBC-0716-2
"D8,G6",26952,27682,20838,6844,13328,12,5965,5987,4194,1793,2.339096486,2750,169,112,74,0,74,0,58,0,0.013513514,empty,mBC-0716-2
"D8,G7",23023,23848,17906,5942,11328,1,5014,5027,3507,1520,2.307236842,2267,2120,1256,738,0,738,0,283,0,0.094850949,empty,mBC-0716-2
"D8,G8",16769,17197,12608,4589,8333,0,3858,3863,2691,1172,2.296075085,1820,1710,1064,644,0,644,0,247,0,0.038819876,empty,mBC-0716-2
"D8,G9",11996,12330,9254,3076,6063,0,2731,2735,1937,798,2.427318296,1260,1433,823,458,0,458,0,231,0,0.015283843,empty,mBC-0716-2
"D8,G10",16393,16854,12414,4440,8104,1,3710,3725,2631,1094,2.404936015,1738,1530,915,562,0,562,0,268,0,0.024911032,empty,mBC-0716-2
"D8,G11",14490,14766,11206,3560,7212,7,3252,3264,2332,932,2.502145923,1534,832,506,306,1,305,1,127,0,0.059016393,empty,mBC-0716-2
"D8,G12",14493,15092,11019,4073,7318,119,3301,3428,2431,997,2.438314945,1700,1379,808,469,1,468,1,179,0,0.074786325,empty,mBC-0716-2
"D8,H1",23694,24537,17790,6747,11824,21,5443,5475,3836,1639,2.340451495,2664,4970,1585,999,1,998,1,344,0,0.088176353,empty,mBC-0716-2
"D8,H2",27544,28725,20889,7836,13577,5,6215,6235,4423,1812,2.440949227,3021,2944,1569,976,1,975,1,335,0,0.02974359,empty,mBC-0716-2
"D8,H3",24370,24905,18258,6647,12012,0,5572,5587,3904,1683,2.319667261,2693,17359,4899,2976,2,2974,1,789,0,0.043712172,empty,mBC-0716-2
"D8,H4",1820804,1932619,1330165,602454,906843,13,480502,481250,386812,94438,4.095935958,252422,5116,3075,1820,0,1820,0,493,0,0.004395604,mm10,mBC-0716-2
"D8,H5",20825,21370,15887,5483,10291,28,4746,4786,3383,1403,2.411261582,2272,1583,957,577,0,577,0,234,0,0.01559792,empty,mBC-0716-2
"D8,H6",17043,17567,12780,4787,8367,48,3852,3913,2713,1200,2.260833333,1879,1623,1051,597,0,597,0,221,0,0.023450586,empty,mBC-0716-2
"D8,H7",19798,20837,15072,5765,10103,0,4640,4646,3276,1370,2.391240876,2325,1889,1060,632,0,632,0,263,0,0.045886076,empty,mBC-0716-2
"D8,H8",549036,583606,410707,172899,285367,38,137937,138209,106448,31761,3.351531753,71726,64547,41575,23300,9,23291,2,2925,0,0.001545661,mm10,mBC-0716-2
"D8,H9",19217,19619,14535,5084,9558,0,4385,4397,3135,1262,2.484152139,2127,1572,893,558,0,558,0,236,0,0.086021505,empty,mBC-0716-2
"D8,H10",1191703,1399007,773551,625456,660254,4,434574,435214,293679,141535,2.074956724,265603,60287,39017,21958,12,21946,1,2569,0,0.001777089,mm10,mBC-0716-2
"D8,H11",19480,20085,14860,5225,9876,15,4570,4599,3280,1319,2.486732373,2220,253,128,90,0,90,0,63,0,0,empty,mBC-0716-2
"D8,H12",7345,7668,5652,2016,3754,0,1713,1717,1238,479,2.584551148,848,654,354,208,0,208,0,115,0,0.048076923,empty,mBC-0716-2
"D9,A1",17924,18891,13504,5387,9318,0,4399,4404,3076,1328,2.31626506,2223,1254,724,453,0,453,0,221,0,0.026490066,empty,mBC-0716-2
"D9,A2",23073,23446,17599,5847,11312,36,4960,5009,3528,1481,2.382174207,2352,1219,714,451,0,451,0,187,0,0.093126386,empty,mBC-0716-2
"D9,A3",19421,19940,14901,5039,9571,0,4410,4415,3139,1276,2.460031348,2047,1057,618,357,0,357,0,186,0,0.033613445,empty,mBC-0716-2
"D9,A4",23763,24437,18251,6186,11795,6,5246,5265,3689,1576,2.340736041,2519,1633,619,402,0,402,0,187,0,0.042288557,empty,mBC-0716-2
"D9,A5",21296,22333,16131,6202,10742,1,4944,4958,3436,1522,2.257555848,2425,1624,1005,660,0,660,0,310,0,0.016666667,empty,mBC-0716-2
"D9,A6",29205,31058,21444,9614,15805,8,8215,8237,6186,2051,3.016089712,4322,1782,971,638,0,638,0,301,0,0.062695925,empty,mBC-0716-2
"D9,A7",18401,19160,13896,5264,9385,0,4440,4448,3030,1418,2.136812412,2157,3558,1457,857,2,855,2,340,0,0.043274854,empty,mBC-0716-2
"D9,A8",12645,12957,9675,3282,6439,7,2964,2981,2092,889,2.353205849,1371,2018,1018,666,0,666,0,302,0,0.100600601,empty,mBC-0716-2
"D9,A9",898523,932976,663014,269962,445596,0,225245,225627,176527,49100,3.595254582,114109,23296,12859,7281,5,7276,1,1605,0,0.004947774,mm10,mBC-0716-2
"D9,A10",18551,19052,14165,4887,9340,3,4298,4307,2983,1324,2.253021148,2054,625,296,187,0,187,0,114,0,0.005347594,empty,mBC-0716-2
"D9,A11",21570,21820,16360,5460,10636,5,4823,4848,3402,1446,2.352697095,2282,1309,718,470,0,470,0,215,0,0.038297872,empty,mBC-0716-2
"D9,A12",24013,24216,18515,5701,11576,0,5148,5162,3625,1537,2.358490566,2347,4231,2065,1188,0,1188,0,400,0,0.085858586,empty,mBC-0716-2
"D9,B1",21855,22814,16361,6453,10945,13,5123,5147,3681,1466,2.510914052,2630,4528,1736,1074,1,1073,1,371,0,0.127679404,empty,mBC-0716-2
"D9,B2",21841,22965,16668,6297,10973,11,5049,5061,3642,1419,2.566596195,2446,482,273,168,1,167,1,83,0,0.035928144,empty,mBC-0716-2
"D9,B3",508970,511932,387949,123983,251827,0,109969,110183,87897,22286,3.944045589,52842,6683,4304,2434,4,2430,1,718,0,0.009876543,mm10,mBC-0716-2
"D9,B4",18615,19132,14386,4746,9287,0,4168,4179,2980,1199,2.485404504,1933,1846,774,462,0,462,0,183,0,0.036796537,empty,mBC-0716-2
"D9,B5",14186,10309,6705,3604,6030,5,3135,3151,2274,877,2.592930445,1810,884,515,318,0,318,0,137,0,0.072327044,empty,mBC-0716-2
"D9,B6",14965,15709,11272,4437,7744,0,3688,3691,2615,1076,2.430297398,1857,1180,721,437,0,437,0,207,0,0.018306636,empty,mBC-0716-2
"D9,B7",1187570,1281864,868531,413333,608308,4,322622,323202,253741,69461,3.652999525,170995,64699,41321,23106,6,23100,1,2445,0,0.001255411,mm10,mBC-0716-2
"D9,B8",1444849,1582102,1010746,571356,762774,12,445218,445862,350292,95570,3.665292456,246636,96732,60352,33462,16,33446,3,3669,0,0.000478383,mm10,mBC-0716-2
"D9,B9",883522,970180,639441,330739,464112,0,253826,254230,205501,48729,4.217221778,137403,47177,31199,17643,9,17634,1,2255,0,0.001417716,mm10,mBC-0716-2
"D9,B10",1250051,1316710,813991,502719,640489,20,381976,383285,288292,94993,3.034876254,216741,31807,19768,10925,2,10923,2,1701,0,0.002746498,mm10,mBC-0716-2
"D9,B11",1123947,1275440,758386,517054,602090,27,373785,374368,303550,70818,4.286339631,215589,3269,1974,1128,0,1128,0,351,0,0,mm10,mBC-0716-2
"D9,B12",21024,21873,15844,6029,10596,0,4876,4886,3515,1371,2.563822028,2372,8752,2987,1802,1,1801,1,520,0,0.101054969,empty,mBC-0716-2
"D9,C1",24391,24765,18781,5984,11848,1,5088,5098,3586,1512,2.371693122,2350,770,452,290,0,290,0,145,0,0.065517241,empty,mBC-0716-2
"D9,C2",22153,22765,16703,6062,10705,0,4938,4946,3435,1511,2.273328921,2373,3225,1382,812,1,811,1,285,0,0.043156597,empty,mBC-0716-2
"D9,C3",23955,25127,18136,6991,11973,21,5588,5624,3961,1663,2.381840048,2740,499,268,171,1,170,1,90,0,0.035294118,empty,mBC-0716-2
"D9,C4",20846,21081,15965,5116,10256,8,4458,4469,3110,1359,2.288447388,2035,1115,633,401,0,401,0,165,0,0.034912718,empty,mBC-0716-2
"D9,C5",21893,22670,16215,6455,10731,8,5078,5098,3594,1504,2.38962766,2484,24476,7400,4520,2,4518,2,1009,0,0.076582559,empty,mBC-0716-2
"D9,C6",2132617,2383770,1461179,922591,1154007,14,702028,702983,567701,135282,4.196426723,399353,182637,107850,60481,31,60450,5,4694,0,0.007593052,mm10,mBC-0716-2
"D9,C7",19166,19919,14529,5390,9521,0,4464,4479,3135,1344,2.332589286,2146,440,275,182,0,182,0,96,0,0,empty,mBC-0716-2
"D9,C8",17906,18497,13565,4932,9022,1,4265,4274,2923,1351,2.163582531,2034,1781,1148,663,0,663,0,261,0,0.033182504,empty,mBC-0716-2
"D9,C9",15637,15522,11491,4031,7602,0,3603,3612,2520,1092,2.307692308,1752,9519,3073,1981,3,1978,3,539,0,0.170879676,empty,mBC-0716-2
"D9,C10",799322,846021,584667,261354,408959,1,212411,212784,156483,56301,2.779400011,112241,19986,11867,6900,4,6896,2,1314,0,0.010730858,mm10,mBC-0716-2
"D9,C11",917619,1043811,637015,406796,504139,1,298374,298779,238086,60693,3.922791755,171455,99640,60462,33720,11,33709,3,3314,0,0.003233558,mm10,mBC-0716-2
"D9,C12",22480,23219,16883,6336,11164,1,5249,5265,3714,1551,2.394584139,2585,1096,604,390,0,390,0,179,0,0.020512821,empty,mBC-0716-2
"D9,D1",845222,984909,559680,425229,478905,1,306283,306719,223510,83209,2.686127703,182994,36671,23100,13014,9,13005,2,1945,0,0.000538255,mm10,mBC-0716-2
"D9,D2",1175050,1253802,854354,399448,594657,11,312159,312655,262789,49866,5.269903341,162983,161265,107280,60079,24,60055,4,4362,0,0.000632753,mm10,mBC-0716-2
"D9,D3",1775329,1912172,1297607,614565,903036,13,480409,481234,399557,81677,4.891915717,254439,125338,73344,41289,19,41270,2,3852,0,0.001550763,mm10,mBC-0716-2
"D9,D4",17133,17645,13105,4540,8433,35,3844,3885,2766,1119,2.471849866,1836,1780,1060,672,0,672,0,313,0,0.069940476,empty,mBC-0716-2
"D9,D5",16449,17082,12439,4643,8297,0,3854,3857,2753,1104,2.49365942,1866,3440,1297,811,1,810,1,330,0,0.062962963,empty,mBC-0716-2
"D9,D6",14792,15824,11095,4729,7795,2,3731,3737,2644,1093,2.419030192,1918,1253,709,473,0,473,0,205,0,0.040169133,empty,mBC-0716-2
"D9,D7",15455,16342,11663,4679,7829,26,3641,3671,2654,1017,2.609636185,1807,1715,1001,585,0,585,0,251,0,0.032478632,empty,mBC-0716-2
"D9,D8",20461,20615,14597,6018,9596,0,4572,4582,3235,1347,2.401633259,2290,11281,4019,2518,1,2517,1,649,0,0.150973381,empty,mBC-0716-2
"D9,D9",752129,819814,532198,287616,402146,3,222202,222532,179040,43492,4.116619148,122111,209146,125683,70192,39,70153,5,4971,0,0.003021966,mm10,mBC-0716-2
"D9,D10",16096,16796,12290,4506,8057,0,3805,3815,2647,1168,2.266267123,1825,1188,629,380,0,380,0,140,0,0.034210526,empty,mBC-0716-2
"D9,D11",15903,16211,11870,4341,7941,12,3676,3701,2599,1102,2.358439201,1783,1864,1166,673,0,673,0,301,0,0.019316493,empty,mBC-0716-2
"D9,D12",22703,23337,17242,6095,11250,12,5232,5255,3709,1546,2.399094437,2570,2917,1583,982,1,981,1,334,0,0.051987768,empty,mBC-0716-2
"D9,E1",1016678,1081001,757484,323517,516294,5,260639,261077,201947,59130,3.41530526,134139,39426,25800,14442,5,14437,2,1969,0,0.005333518,mm10,mBC-0716-2
"D9,E2",19374,19862,14806,5056,9640,3,4336,4359,3067,1292,2.373839009,2046,1400,761,470,0,470,0,197,0,0.061702128,empty,mBC-0716-2
"D9,E3",14352,14890,10979,3911,7215,0,3311,3324,2318,1006,2.30417495,1576,4825,1904,1172,3,1169,2,449,0,0.036783576,empty,mBC-0716-2
"D9,E4",17732,18204,13433,4771,8899,26,4087,4124,2898,1226,2.363784666,1980,1236,700,465,0,465,0,235,0,0.025806452,empty,mBC-0716-2
"D9,E5",23189,23564,17811,5753,11519,0,5190,5197,3755,1442,2.604022191,2387,2382,1338,861,0,861,0,340,0,0.118466899,empty,mBC-0716-2
"D9,E6",585311,599349,426993,172356,291774,19,146392,146643,113848,32795,3.471504803,74267,27259,10354,6006,4,6002,3,1466,0,0.020159947,mm10,mBC-0716-2
"D9,E7",853151,897260,606663,290597,431533,6,233213,233648,186822,46826,3.989706573,124308,6965,4516,2509,0,2509,0,723,0,0.008768434,mm10,mBC-0716-2
"D9,E8",20196,20563,15532,5031,10084,0,4499,4515,3210,1305,2.459770115,2148,1731,999,629,1,628,1,262,0,0.058917197,empty,mBC-0716-2
"D9,E9",11593,11967,8691,3276,5763,7,2664,2679,1912,767,2.492829205,1307,4849,1581,933,2,931,2,328,0,0.038668099,empty,mBC-0716-2
"D9,E10",14961,15781,11322,4459,7667,25,3570,3608,2462,1146,2.148342059,1812,1523,950,562,0,562,0,221,0,0.049822064,empty,mBC-0716-2
"D9,E11",11196,11705,8597,3108,5692,17,2607,2630,1833,797,2.299874529,1262,1089,657,407,0,407,0,196,0,0.022113022,empty,mBC-0716-2
"D9,E12",19798,20660,14854,5806,10089,2,4739,4757,3352,1405,2.385765125,2352,946,537,339,2,337,2,152,0,0.050445104,empty,mBC-0716-2
"D9,F1",20927,21305,15575,5730,10505,0,4847,4863,3301,1562,2.113316261,2423,3974,1688,1002,2,1000,2,359,0,0.037,empty,mBC-0716-2
"D9,F2",604088,637500,450169,187331,313559,2,156891,157161,123043,34118,3.606395451,80906,25028,13098,7584,5,7579,3,1610,0,0.010819369,mm10,mBC-0716-2
"D9,F3",1027949,1230055,662499,567556,596794,4,402451,402911,280739,122172,2.297899682,249923,10402,6642,3764,2,3762,1,907,0,0.008506114,mm10,mBC-0716-2
"D9,F4",20297,20082,14989,5093,9783,22,4276,4311,3068,1243,2.468222043,2026,695,395,227,0,227,0,112,0,0.066079295,empty,mBC-0716-2
"D9,F5",1166137,1338382,777462,560920,634928,30,400678,401265,320527,80738,3.969964577,234785,147428,92593,51597,24,51573,3,4078,0,0.00089194,mm10,mBC-0716-2
"D9,F6",28286,29529,21753,7776,13829,0,6339,6350,4483,1867,2.401178361,2984,2440,1497,869,1,868,1,327,0,0.044930876,empty,mBC-0716-2
"D9,F7",2227848,2327920,1701743,626177,1093328,4,530568,531540,404145,127395,3.172377252,264686,46525,28454,16116,6,16110,2,2415,0,0.002917443,mm10,mBC-0716-2
"D9,F8",986421,1016238,750155,266083,480913,1,216454,216880,192932,23948,8.056288625,105139,12130,7900,4403,1,4402,1,887,0,0.002044525,mm10,mBC-0716-2
"D9,F9",17637,17865,13500,4365,8646,44,3803,3857,2702,1155,2.339393939,1754,1479,836,494,0,494,0,242,0,0.012145749,empty,mBC-0716-2
"D9,F10",22950,23647,17536,6111,11484,29,5155,5194,3618,1576,2.295685279,2441,1260,735,458,0,458,0,209,0,0.015283843,empty,mBC-0716-2
"D9,F11",13583,13762,10260,3502,6768,12,3049,3063,2188,875,2.500571429,1443,1268,750,470,0,470,0,223,0,0.010638298,empty,mBC-0716-2
"D9,F12",16429,16943,12562,4381,8143,0,3732,3737,2696,1041,2.589817483,1772,262,169,106,0,106,0,73,0,0.009433962,empty,mBC-0716-2
"D9,G1",10919,11267,8391,2876,5520,3,2481,2490,1723,767,2.246414602,1161,1529,971,620,0,620,0,271,0,0.019354839,empty,mBC-0716-2
"D9,G2",23979,24779,18452,6327,12009,0,5475,5501,3869,1632,2.370710784,2626,821,528,336,0,336,0,196,0,0.029761905,empty,mBC-0716-2
"D9,G3",1831960,1954401,1365402,588999,912776,9,466974,467915,381803,86112,4.433795522,240528,151551,96632,54398,16,54382,1,4470,0,0.001710125,mm10,mBC-0716-2
"D9,G4",1416828,1579282,959172,620110,747484,1,470298,470952,344105,126847,2.712756313,268562,256,163,124,0,124,0,81,0,0.016129032,empty,mBC-0716-2
"D9,G5",15813,15986,12003,3983,7812,0,3477,3485,2472,1013,2.440276407,1631,1369,835,519,0,519,0,267,0,0.019267823,empty,mBC-0716-2
"D9,G6",27489,27957,21409,6548,13440,3,5866,5888,4157,1731,2.401502022,2660,274,182,119,0,119,0,82,0,0,empty,mBC-0716-2
"D9,G7",22880,23605,17558,6047,11418,0,5094,5108,3605,1503,2.398536261,2457,2058,1243,793,1,792,1,316,0,0.053030303,empty,mBC-0716-2
"D9,G8",17665,18418,13342,5076,8914,3,4233,4245,3017,1228,2.456840391,2100,1643,975,605,0,605,0,288,0,0.034710744,empty,mBC-0716-2
"D9,G9",12242,12826,9064,3762,6207,0,2931,2933,2147,786,2.731552163,1491,14647,4478,2714,4,2710,2,773,0,0.042435424,empty,mBC-0716-2
"D9,G10",1395329,1585601,924790,660811,753931,6,483704,484374,379408,104966,3.614579959,280836,72139,46485,25923,15,25908,2,2901,0,0.000578972,mm10,mBC-0716-2
"D9,G11",14292,14808,10918,3890,7202,0,3184,3188,2215,973,2.276464543,1537,714,405,261,0,261,0,133,0,0.022988506,empty,mBC-0716-2
"D9,G12",13085,13313,9805,3508,6535,0,3067,3071,2164,907,2.385887541,1449,5620,1992,1181,1,1180,1,395,0,0.024576271,empty,mBC-0716-2
"D9,H1",24610,24957,18737,6220,12002,21,5464,5498,3937,1561,2.522101217,2568,2809,1092,689,1,688,1,279,0,0.036337209,empty,mBC-0716-2
"D9,H2",28288,29324,21618,7706,13914,2,6341,6365,4519,1846,2.447995666,3069,2196,1347,829,0,829,0,342,0,0.024125452,empty,mBC-0716-2
"D9,H3",25719,26145,18965,7180,12503,27,5870,5910,4176,1734,2.408304498,2873,21662,6485,4001,6,3995,3,966,0,0.10212766,empty,mBC-0716-2
"D9,H4",17745,18235,13483,4752,8801,0,4151,4157,2936,1221,2.404586405,1988,324,200,139,0,139,0,103,0,0.028776978,empty,mBC-0716-2
"D9,H5",20503,21026,15417,5609,10149,1,4674,4684,3305,1379,2.396664249,2278,1432,880,540,0,540,0,259,0,0.040740741,empty,mBC-0716-2
"D9,H6",1435445,1460152,1063964,396188,698755,4,344391,344988,281076,63912,4.397859557,171515,30236,19408,11080,3,11077,1,2055,0,0.002166652,mm10,mBC-0716-2
"D9,H7",19745,20567,14808,5759,10089,2,4739,4756,3285,1471,2.233174711,2378,1491,812,499,0,499,0,244,0,0.048096192,empty,mBC-0716-2
"D9,H8",16684,17083,12682,4401,8367,0,3868,3874,2771,1103,2.512239347,1802,1808,1144,721,0,721,0,315,0,0.033287101,empty,mBC-0716-2
"D9,H9",19508,19964,14758,5206,9785,0,4534,4545,3255,1290,2.523255814,2224,1452,888,597,0,597,0,281,0,0.006700168,empty,mBC-0716-2
"D9,H10",19185,19843,14328,5515,9844,3,4686,4697,3291,1406,2.340682788,2349,1596,926,618,1,617,1,321,0,0.006482982,empty,mBC-0716-2
"D9,H11",19789,20760,14758,6002,10020,0,4671,4679,3299,1380,2.39057971,2374,1027,385,251,1,250,1,124,0,0.004,empty,mBC-0716-2
"D9,H12",629037,689112,439866,249246,339403,1,196700,196998,134876,62122,2.171147098,110570,12281,7192,4044,2,4042,1,893,0,0.003958436,mm10,mBC-0716-2
"D10,A1",770356,862372,512301,350071,429188,0,272413,272795,209646,63149,3.319862547,157649,10321,4301,2492,3,2489,2,695,0,0.039373242,mm10,mBC-0716-2
"D10,A2",1097646,1172002,774079,397923,557561,11,306730,307209,251766,55443,4.540988042,164625,72076,47105,26229,14,26215,1,2845,0,0.001182529,mm10,mBC-0716-2
"D10,A3",18322,19055,13789,5266,9125,0,4254,4263,3022,1241,2.435132957,2061,831,484,268,0,268,0,140,0,0.007462687,empty,mBC-0716-2
"D10,A4",24103,24701,18827,5874,11673,29,5099,5146,3688,1458,2.529492455,2282,561,300,197,0,197,0,99,0,0.116751269,empty,mBC-0716-2
"D10,A5",19782,20369,14836,5533,9925,0,4620,4631,3246,1385,2.34368231,2230,6621,2134,1335,0,1335,0,430,0,0.023220974,empty,mBC-0716-2
"D10,A6",22522,24072,16808,7264,12099,0,6137,6152,4574,1578,2.89860583,3126,1169,662,439,1,438,1,212,0,0.043378995,empty,mBC-0716-2
"D10,A7",818252,911336,582034,329302,445907,0,250561,250922,192345,58577,3.283626679,140772,52094,32294,18008,5,18003,1,2304,0,0.001999667,mm10,mBC-0716-2
"D10,A8",1138728,1250277,842381,407896,610141,8,325458,326057,249617,76440,3.265528519,174223,103615,64122,35499,15,35484,1,3579,0,0.003466351,mm10,mBC-0716-2
"D10,A9",21545,21657,16621,5036,10554,0,4609,4620,3244,1376,2.35755814,2134,1083,687,426,0,426,0,207,0,0.039906103,empty,mBC-0716-2
"D10,A10",17431,17874,13236,4638,8631,2,3941,3955,2809,1146,2.45113438,1837,529,270,172,0,172,0,93,0,0.005813953,empty,mBC-0716-2
"D10,A11",20129,20919,15374,5545,10226,1,4620,4636,3296,1340,2.459701493,2170,934,542,356,0,356,0,174,0,0.039325843,empty,mBC-0716-2
"D10,A12",23343,24016,17997,6019,11496,1,5130,5140,3635,1505,2.415282392,2421,10499,3355,2015,4,2011,2,544,0,0.095972153,empty,mBC-0716-2
"D10,B1",1071707,1143541,791881,351660,546800,0,282795,283244,214988,68256,3.149730427,148371,25095,15866,8920,1,8919,1,1443,0,0.003027245,mm10,mBC-0716-2
"D10,B2",21654,22519,16608,5911,10793,3,4945,4954,3402,1552,2.192010309,2453,389,211,152,0,152,0,80,0,0.006578947,empty,mBC-0716-2
"D10,B3",21277,21612,16201,5411,10622,20,4807,4840,3391,1449,2.340234645,2333,2813,1265,742,1,741,1,264,0,0.151147099,empty,mBC-0716-2
"D10,B4",18008,18674,13845,4829,8951,0,3987,3997,2822,1175,2.401702128,1917,790,419,286,0,286,0,141,0,0.034965035,empty,mBC-0716-2
"D10,B5",9720,5811,4023,1788,3716,1,1806,1823,1290,533,2.420262664,1010,718,463,301,0,301,0,141,0,0.093023256,empty,mBC-0716-2
"D10,B6",14098,14908,10532,4376,7387,0,3559,3568,2522,1046,2.411089866,1824,1043,648,409,0,409,0,169,0,0.029339853,empty,mBC-0716-2
"D10,B7",17932,18846,13779,5067,9133,0,4205,4209,2931,1278,2.29342723,2058,876,536,311,0,311,0,146,0,0.006430868,empty,mBC-0716-2
"D10,B8",14141,14696,10933,3763,7220,8,3244,3258,2273,985,2.307614213,1509,955,551,339,0,339,0,183,0,0.005899705,empty,mBC-0716-2
"D10,B9",17321,17675,13113,4562,8500,3,3883,3894,2725,1169,2.331052181,1879,593,361,236,0,236,0,115,0,0.038135593,empty,mBC-0716-2
"D10,B10",18383,18643,13899,4744,9315,0,4353,4368,2981,1387,2.14924297,2104,461,271,165,0,165,0,77,0,0.03030303,empty,mBC-0716-2
"D10,B11",1369808,1556028,897400,658628,729785,1,474591,475267,369419,105848,3.490089562,276212,13475,8769,4896,0,4896,0,987,0,0.001633987,mm10,mBC-0716-2
"D10,B12",20250,20782,15340,5442,10018,11,4659,4675,3348,1327,2.522984175,2193,2571,1083,670,0,670,0,226,0,0.156716418,empty,mBC-0716-2
"D10,C1",24147,24438,18695,5743,11699,0,4918,4933,3500,1433,2.442428472,2268,578,356,218,0,218,0,97,0,0.059633028,empty,mBC-0716-2
"D10,C2",665147,701403,503802,197601,340978,0,156612,156903,121980,34923,3.492827077,80848,115593,75969,41664,20,41644,3,3422,0,0.001536836,mm10,mBC-0716-2
"D10,C3",617482,630000,474024,155976,308931,31,136110,136443,104704,31739,3.298906708,65931,8340,4815,2792,1,2791,1,702,0,0.001074884,mm10,mBC-0716-2
"D10,C4",982153,1050783,702922,347861,510078,1,282909,283427,228917,54510,4.199541369,150933,7566,4930,2774,2,2772,1,658,0,0.012265512,mm10,mBC-0716-2
"D10,C5",19068,20076,14259,5817,9701,0,4628,4637,3347,1290,2.594573643,2311,1192,662,420,2,418,1,192,0,0.014354067,empty,mBC-0716-2
"D10,C6",874909,945894,633688,312206,472419,4,253791,254250,203777,50473,4.0373467,135513,60345,40108,22008,9,21999,3,2612,0,0.001409155,mm10,mBC-0716-2
"D10,C7",18377,19145,14019,5126,9168,26,4217,4251,2911,1340,2.17238806,2019,350,216,129,0,129,0,78,0,0.031007752,empty,mBC-0716-2
"D10,C8",16696,17304,12699,4605,8436,0,3827,3831,2661,1170,2.274358974,1796,1314,711,414,0,414,0,182,0,0.019323671,empty,mBC-0716-2
"D10,C9",14111,14614,10681,3933,7207,0,3385,3386,2395,991,2.416750757,1645,748,472,312,0,312,0,136,0,0.03525641,empty,mBC-0716-2
"D10,C10",15432,15966,11783,4183,7835,0,3642,3647,2567,1080,2.376851852,1750,1249,765,468,0,468,0,164,0,0.061965812,empty,mBC-0716-2
"D10,C11",747701,839260,533062,306198,410539,2,231730,232089,182615,49474,3.691130695,129540,53459,33409,19019,12,19007,4,2451,0,0.001578366,mm10,mBC-0716-2
"D10,C12",22524,22964,16945,6019,11057,36,5067,5121,3610,1511,2.389146261,2441,877,570,317,0,317,0,134,0,0.03785489,empty,mBC-0716-2
"D10,D1",13447,14171,10011,4160,6944,20,3297,3327,2250,1077,2.08913649,1700,1690,593,356,0,356,0,141,0,0.064606742,empty,mBC-0716-2
"D10,D2",888878,978944,617190,361754,479996,0,288379,288766,210060,78706,2.668919777,160543,15762,9292,5222,2,5220,1,1133,0,0.012068966,mm10,mBC-0716-2
"D10,D3",984372,1117235,654918,462317,543588,6,349205,349675,262861,86814,3.027864169,203128,16344,10009,5618,5,5613,1,1185,0,0.00249421,mm10,mBC-0716-2
"D10,D4",15615,16025,11857,4168,7996,0,3656,3663,2603,1060,2.455660377,1731,1144,654,408,0,408,0,216,0,0.012254902,empty,mBC-0716-2
"D10,D5",15201,15856,11423,4433,7816,18,3656,3680,2581,1099,2.348498635,1836,906,527,333,1,332,1,149,0,0.03313253,empty,mBC-0716-2
"D10,D6",13955,14522,10484,4038,7148,19,3448,3477,2503,974,2.569815195,1718,1040,577,350,0,350,0,179,0,0.025714286,empty,mBC-0716-2
"D10,D7",936401,1023820,660209,363611,492403,0,273036,273462,228048,45414,5.021535209,149157,149597,92208,51751,23,51728,4,4061,0,0.002667801,mm10,mBC-0716-2
"D10,D8",17383,18241,12986,5255,8886,17,4235,4260,2940,1320,2.227272727,2134,730,431,261,0,261,0,127,0,0.019157088,empty,mBC-0716-2
"D10,D9",6040,6096,4415,1681,3166,0,1483,1487,1104,383,2.882506527,750,1440,892,551,1,550,1,258,0,0.023636364,empty,mBC-0716-2
"D10,D10",14880,15626,11175,4451,7528,18,3612,3636,2586,1050,2.462857143,1774,548,348,202,1,201,1,110,0,0.029850746,empty,mBC-0716-2
"D10,D11",14900,15567,11417,4150,7644,10,3517,3535,2467,1068,2.309925094,1666,1469,910,603,0,603,0,234,0,0.071310116,empty,mBC-0716-2
"D10,D12",22182,23279,16937,6342,11214,0,5117,5129,3578,1551,2.306898775,2478,2116,1277,758,1,757,1,271,0,0.036988111,empty,mBC-0716-2
"D10,E1",24022,24843,18421,6422,11864,0,5348,5357,3706,1651,2.244700182,2522,1299,753,474,0,474,0,221,0,0.065400844,empty,mBC-0716-2
"D10,E2",685063,695178,508569,186609,340687,25,161620,161934,127887,34047,3.756189973,80021,44881,19907,11802,7,11795,2,2111,0,0.068503603,mm10,mBC-0716-2
"D10,E3",13620,14020,10387,3633,6829,0,3032,3039,2168,871,2.489092997,1466,1765,1002,597,0,597,0,227,0,0.110552764,empty,mBC-0716-2
"D10,E4",16574,16838,12604,4234,8114,0,3648,3657,2580,1077,2.395543175,1725,994,558,367,0,367,0,158,0,0.021798365,empty,mBC-0716-2
"D10,E5",24238,24876,18707,6169,11989,98,5241,5352,3859,1493,2.584728734,2492,4706,1648,977,0,977,0,328,0,0.032753327,empty,mBC-0716-2
"D10,E6",1710114,1867891,1210409,657482,883852,16,503469,504313,403988,100325,4.026792923,276772,162809,103900,58329,21,58308,3,4411,0,0.001629279,mm10,mBC-0716-2
"D10,E7",802863,879787,575962,303825,426011,6,234610,234958,188513,46445,4.058843794,126895,41780,27404,15010,9,15001,1,2066,0,0.002266516,mm10,mBC-0716-2
"D10,E8",19698,20507,15044,5463,10006,9,4480,4499,3146,1353,2.325203252,2151,1437,826,494,0,494,0,200,0,0.074898785,empty,mBC-0716-2
"D10,E9",10268,10534,7622,2912,5135,4,2405,2416,1699,717,2.369595537,1128,790,448,287,0,287,0,126,0,0,empty,mBC-0716-2
"D10,E10",13816,14797,10512,4285,7211,0,3369,3382,2331,1051,2.217887726,1706,1415,718,444,0,444,0,193,0,0.054054054,empty,mBC-0716-2
"D10,E11",10448,10961,7933,3028,5412,11,2473,2489,1747,742,2.354447439,1212,818,465,311,0,311,0,147,0,0.01607717,empty,mBC-0716-2
"D10,E12",16755,17711,12726,4985,8766,0,4144,4150,2891,1259,2.296266878,2078,1220,740,451,0,451,0,163,0,0.033259424,empty,mBC-0716-2
"D10,F1",20055,20401,15360,5041,10005,17,4528,4555,3180,1375,2.312727273,2060,1168,713,443,1,442,1,197,0,0.018099548,empty,mBC-0716-2
"D10,F2",26459,27833,20036,7797,13719,29,6590,6634,4711,1923,2.449817993,3345,2407,1441,845,1,844,1,344,0,0.045023697,empty,mBC-0716-2
"D10,F3",18022,18514,13554,4960,9136,21,4279,4304,3080,1224,2.516339869,2097,1489,883,554,0,554,0,228,0,0.016245487,empty,mBC-0716-2
"D10,F4",18027,18233,13296,4937,9023,7,4135,4163,2904,1259,2.306592534,2022,581,330,188,0,188,0,89,0,0.090425532,empty,mBC-0716-2
"D10,F5",27559,28463,20879,7584,13967,10,6390,6416,4578,1838,2.490750816,3161,3594,1515,912,1,911,1,376,0,0.021953897,empty,mBC-0716-2
"D10,F6",931911,993556,695126,298430,475713,2,235280,235702,178768,56934,3.139916394,123197,92417,59211,33047,14,33033,1,3079,0,0.001059547,mm10,mBC-0716-2
"D10,F7",22422,22574,17158,5416,11031,39,4870,4924,3460,1464,2.363387978,2251,2784,976,595,0,595,0,188,0,0.062184874,empty,mBC-0716-2
"D10,F8",25574,26383,19371,7012,12972,1,6081,6097,4409,1688,2.611966825,2895,843,331,198,0,198,0,92,0,0.060606061,empty,mBC-0716-2
"D10,F9",16099,16485,12364,4121,8146,5,3669,3686,2545,1141,2.230499562,1719,1193,718,454,0,454,0,176,0,0.024229075,empty,mBC-0716-2
"D10,F10",23342,23357,17988,5369,11292,3,4882,4890,3459,1431,2.417190776,2227,1423,929,497,0,497,0,196,0,0.046277666,empty,mBC-0716-2
"D10,F11",12342,12570,9424,3146,6178,5,2768,2782,1952,830,2.351807229,1277,844,512,345,0,345,0,160,0,0.055072464,empty,mBC-0716-2
"D10,F12",16012,16426,12041,4385,7813,5,3633,3647,2555,1092,2.33974359,1770,192,122,76,0,76,0,47,0,0,empty,mBC-0716-2
"D10,G1",11393,11741,8738,3003,5751,26,2522,2557,1779,778,2.286632391,1219,1433,823,468,1,467,1,193,0,0.029978587,empty,mBC-0716-2
"D10,G2",23026,23718,17623,6095,11565,10,5192,5213,3639,1574,2.311944091,2472,712,447,283,0,283,0,151,0,0.035335689,empty,mBC-0716-2
"D10,G3",1174699,1407348,748250,659098,674989,3,460832,461426,306430,154996,1.977018762,285025,63226,38150,21078,17,21061,4,2628,0,0.004178339,mm10,mBC-0716-2
"D10,G4",31239,31600,23972,7628,15354,17,6688,6718,4711,2007,2.347284504,3106,121,70,52,0,52,0,41,0,0,empty,mBC-0716-2
"D10,G5",563854,576264,434488,141776,282470,20,121211,121484,76383,45101,1.693598812,60297,10892,6488,3599,2,3597,1,892,0,0.005838198,mm10,mBC-0716-2
"D10,G6",26260,26616,20260,6356,12844,2,5705,5724,4070,1654,2.46070133,2622,208,124,88,0,88,0,60,0,0,empty,mBC-0716-2
"D10,G7",21715,22245,16666,5579,10912,1,4881,4887,3441,1446,2.37966805,2281,1713,993,585,0,585,0,247,0,0.041025641,empty,mBC-0716-2
"D10,G8",16049,16799,12157,4642,8276,10,3953,3968,2775,1193,2.326068734,1894,1343,812,496,0,496,0,227,0,0.052419355,empty,mBC-0716-2
"D10,G9",11872,12420,8957,3463,6116,1,2827,2835,1981,854,2.319672131,1414,1328,735,450,0,450,0,218,0,0.04,empty,mBC-0716-2
"D10,G10",14530,15119,11092,4027,7368,0,3318,3329,2327,1002,2.322355289,1589,1206,782,478,0,478,0,226,0,0.016736402,empty,mBC-0716-2
"D10,G11",13234,13836,10077,3759,6704,1,3069,3077,2126,951,2.235541535,1487,618,372,228,0,228,0,97,0,0.01754386,empty,mBC-0716-2
"D10,G12",13163,13711,9659,4052,6726,5,3278,3286,2325,961,2.419354839,1656,6284,2102,1230,1,1229,1,377,0,0.113100081,empty,mBC-0716-2
"D10,H1",22705,23141,17113,6028,11380,0,5305,5322,3748,1574,2.381194409,2586,736,439,272,0,272,0,130,0,0.073529412,empty,mBC-0716-2
"D10,H2",26521,27392,20600,6792,13198,0,5960,5973,4205,1768,2.378393665,2835,2029,1220,745,0,745,0,285,0,0.008053691,empty,mBC-0716-2
"D10,H3",22844,23421,17338,6083,11563,0,5362,5372,3871,1501,2.578947368,2624,1237,736,466,0,466,0,213,0,0.051502146,empty,mBC-0716-2
"D10,H4",16022,16534,12138,4396,8052,0,3742,3749,2647,1102,2.40199637,1816,192,120,87,0,87,0,78,0,0.022988506,empty,mBC-0716-2
"D10,H5",19885,20227,15064,5163,9722,20,4461,4489,3139,1350,2.325185185,2096,1269,790,467,1,466,1,199,0,0.02360515,empty,mBC-0716-2
"D10,H6",16855,17397,12749,4648,8540,13,3984,4008,2796,1212,2.306930693,1940,1833,925,545,0,545,0,203,0,0.025688073,empty,mBC-0716-2
"D10,H7",18531,19650,14180,5470,9662,0,4457,4475,3121,1354,2.305022157,2187,1253,769,428,0,428,0,191,0,0.044392523,empty,mBC-0716-2
"D10,H8",1632585,1768861,1166729,602132,841249,0,485207,485913,361674,124239,2.911114867,263272,34025,22364,12374,3,12371,2,2029,0,0.001374182,mm10,mBC-0716-2
"D10,H9",17665,18194,13416,4778,8834,0,3950,3957,2853,1104,2.58423913,1891,1143,656,406,0,406,0,204,0,0.012315271,empty,mBC-0716-2
"D10,H10",456991,485837,296569,189268,235646,2,149784,149989,87757,62232,1.410158761,84540,8251,3909,2250,0,2250,0,654,0,0.032888889,mm10,mBC-0716-2
"D10,H11",746585,851301,519966,331335,417397,14,242797,243126,204147,38979,5.237358578,139276,3539,2252,1299,0,1299,0,341,0,0.005388761,mm10,mBC-0716-2
"D10,H12",647549,730646,428700,301946,362414,0,231015,231380,186883,44497,4.199901117,134918,6124,3848,2111,0,2111,0,597,0,0.00568451,mm10,mBC-0716-2
"D11,A1",14292,14694,10788,3906,7346,0,3452,3455,2435,1020,2.387254902,1706,3595,1339,748,1,747,1,268,0,0.058902276,empty,mBC-0716-2
"D11,A2",19383,19451,14570,4881,9343,0,4196,4206,2936,1270,2.311811024,1989,3014,1118,699,0,699,0,229,0,0.117310443,empty,mBC-0716-2
"D11,A3",16264,17307,12326,4981,8430,31,3932,3967,2822,1145,2.464628821,2019,665,356,239,0,239,0,115,0,0.025104603,empty,mBC-0716-2
"D11,A4",21841,22334,16719,5615,10898,34,4862,4904,3414,1490,2.291275168,2323,473,304,202,0,202,0,111,0,0.034653465,empty,mBC-0716-2
"D11,A5",662619,743087,464506,278581,370471,17,217184,217465,156123,61342,2.545124059,122585,30476,20266,11152,9,11143,2,1711,0,0.001256394,mm10,mBC-0716-2
"D11,A6",13390,14054,10053,4001,6848,0,3249,3256,2273,983,2.312309257,1625,4416,1642,1012,1,1011,1,314,0,0.173095945,empty,mBC-0716-2
"D11,A7",15913,16615,12151,4464,8243,0,3761,3774,2544,1230,2.068292683,1831,1174,586,361,0,361,0,162,0,0.022160665,empty,mBC-0716-2
"D11,A8",10881,11298,8277,3021,5562,0,2543,2546,1783,763,2.336828309,1215,864,481,315,1,314,1,171,0,0.02866242,empty,mBC-0716-2
"D11,A9",19046,19654,14394,5260,9546,21,4352,4386,3116,1270,2.453543307,2103,892,548,340,0,340,0,152,0,0.05,empty,mBC-0716-2
"D11,A10",16013,16326,12191,4135,8163,0,3727,3740,2577,1163,2.215821152,1779,337,185,109,0,109,0,69,0,0.018348624,empty,mBC-0716-2
"D11,A11",18747,19189,14401,4788,9406,44,4287,4339,3021,1318,2.292109256,1993,2547,1002,592,0,592,0,224,0,0.050675676,empty,mBC-0716-2
"D11,A12",1155882,1275768,816886,458882,606861,1,353436,353987,265445,88542,2.997955772,193857,74182,44801,24939,9,24930,1,2957,0,0.003329322,mm10,mBC-0716-2
"D11,B1",19209,19858,14670,5188,9614,2,4368,4375,3107,1268,2.450315457,2015,733,432,265,1,264,1,125,0,0.034090909,empty,mBC-0716-2
"D11,B2",20168,20517,15593,4924,9923,8,4377,4402,3101,1301,2.383551115,2072,419,228,144,0,144,0,69,0,0.083333333,empty,mBC-0716-2
"D11,B3",18317,18564,14144,4420,9218,0,4145,4153,2886,1267,2.277821626,1966,1274,612,401,0,401,0,168,0,0.057356608,empty,mBC-0716-2
"D11,B4",16930,17500,13148,4352,8549,4,3810,3823,2697,1126,2.395204263,1723,700,397,227,0,227,0,113,0,0.04845815,empty,mBC-0716-2
"D11,B5",11745,8102,5784,2318,4852,0,2345,2356,1740,616,2.824675325,1250,606,330,198,0,198,0,113,0,0.005050505,empty,mBC-0716-2
"D11,B6",12568,13209,9679,3530,6765,0,3177,3183,2218,965,2.298445596,1580,798,462,307,0,307,0,145,0,0.019543974,empty,mBC-0716-2
"D11,B7",16784,16997,12905,4092,8409,27,3708,3749,2614,1135,2.3030837,1721,896,518,319,0,319,0,127,0,0.053291536,empty,mBC-0716-2
"D11,B8",13670,14182,10386,3796,7044,1,3280,3285,2274,1011,2.24925816,1603,678,406,253,0,253,0,143,0,0.011857708,empty,mBC-0716-2
"D11,B9",14784,15011,11505,3506,7383,1,3203,3217,2240,977,2.292732856,1448,436,274,173,0,173,0,86,0,0.075144509,empty,mBC-0716-2
"D11,B10",16443,16648,12251,4397,8521,15,3937,3967,2730,1237,2.206952304,1941,1300,554,332,0,332,0,116,0,0.06626506,empty,mBC-0716-2
"D11,B11",15954,16403,12134,4269,7987,1,3687,3699,2603,1096,2.375,1745,124,78,56,0,56,0,40,0,0,empty,mBC-0716-2
"D11,B12",18257,18871,14024,4847,9238,2,4309,4312,3011,1301,2.314373559,2022,1016,486,308,0,308,0,147,0,0.025974026,empty,mBC-0716-2
"D11,C1",22503,23066,17379,5687,11066,1,4850,4866,3421,1445,2.367474048,2219,620,334,229,0,229,0,104,0,0.03930131,empty,mBC-0716-2
"D11,C2",18235,19009,13807,5202,9239,7,4377,4392,2999,1393,2.152907394,2143,1136,600,376,1,375,1,148,0,0.048,empty,mBC-0716-2
"D11,C3",22501,23664,16968,6696,11485,0,5522,5531,3840,1691,2.270845653,2748,434,290,187,0,187,0,79,0,0.032085561,empty,mBC-0716-2
"D11,C4",17350,17402,13191,4211,8654,0,3850,3860,2730,1130,2.415929204,1822,927,580,319,1,318,1,126,0,0.059748428,empty,mBC-0716-2
"D11,C5",775088,840122,571422,268700,412765,1,211463,211801,168932,42869,3.940656418,112539,70131,46077,25650,7,25643,1,2789,0,0.001520883,mm10,mBC-0716-2
"D11,C6",759824,782418,546512,235906,395582,0,207467,207846,162792,45054,3.613264083,106392,18758,9463,5588,2,5586,1,1241,0,0.055137845,mm10,mBC-0716-2
"D11,C7",16383,16510,12363,4147,8101,9,3766,3778,2674,1104,2.422101449,1781,2051,643,386,0,386,0,142,0,0.049222798,empty,mBC-0716-2
"D11,C8",846451,932966,588723,344243,458677,0,266579,266981,215908,51073,4.227439156,147810,89189,53079,29490,14,29476,3,3109,0,0.000610666,mm10,mBC-0716-2
"D11,C9",486307,489895,361854,128041,234829,13,110531,110770,90482,20288,4.45987776,54417,21514,14279,8040,1,8039,1,1289,0,0.00310984,mm10,mBC-0716-2
"D11,C10",13680,14038,10428,3610,6996,0,3277,3283,2278,1005,2.266666667,1541,773,447,278,0,278,0,131,0,0.039568345,empty,mBC-0716-2
"D11,C11",11822,12197,8898,3299,5915,25,2728,2759,1896,863,2.196987254,1313,653,418,246,0,246,0,103,0,0.012195122,empty,mBC-0716-2
"D11,C12",19492,19958,14783,5175,9829,8,4470,4497,3075,1422,2.162447257,2113,1038,585,333,1,332,1,116,0,0.177710843,empty,mBC-0716-2
"D11,D1",12353,12669,9168,3501,6196,0,2933,2945,2057,888,2.316441441,1428,10663,3164,1913,6,1907,1,514,0,0.07760881,empty,mBC-0716-2
"D11,D2",1011769,1051050,765598,285452,505823,48,234850,235316,199470,35846,5.564637616,116272,124428,76392,41993,18,41975,4,3870,0,0.003835616,mm10,mBC-0716-2
"D11,D3",814019,971895,515753,456142,482531,1,328853,329211,212019,117192,1.809159328,204306,14599,9423,5064,0,5064,0,1108,0,0.003159558,mm10,mBC-0716-2
"D11,D4",15761,16127,11915,4212,7978,33,3611,3658,2556,1102,2.319419238,1783,4223,1483,886,0,886,0,314,0,0.015801354,empty,mBC-0716-2
"D11,D5",644947,662283,486529,175754,329187,0,156833,157102,122227,34875,3.504716846,77659,10997,6205,3594,4,3590,2,796,0,0.01448468,mm10,mBC-0716-2
"D11,D6",12667,13154,9569,3585,6654,5,3212,3225,2291,934,2.452890792,1621,831,492,316,0,316,0,150,0,0.003164557,empty,mBC-0716-2
"D11,D7",12791,13375,9579,3796,6454,14,3032,3052,2115,937,2.257203842,1502,979,538,327,0,327,0,134,0,0.067278287,empty,mBC-0716-2
"D11,D8",15746,16512,11801,4711,8173,9,3897,3916,2680,1236,2.16828479,1921,923,390,247,1,246,1,124,0,0.036585366,empty,mBC-0716-2
"D11,D9",5470,5605,4041,1564,2887,0,1417,1417,996,421,2.365795724,688,1085,600,391,0,391,0,195,0,0.05370844,empty,mBC-0716-2
"D11,D10",13247,14265,9926,4339,6956,0,3320,3323,2322,1001,2.31968032,1715,658,320,179,0,179,0,86,0,0.016759777,empty,mBC-0716-2
"D11,D11",753220,792141,572384,219757,386802,29,180228,180609,140244,40365,3.474396135,90777,60231,39738,22266,8,22258,3,2586,0,0.000359421,mm10,mBC-0716-2
"D11,D12",20444,21169,15535,5634,10142,15,4581,4606,3239,1367,2.369422092,2221,1889,1065,667,1,666,1,228,0,0.06006006,empty,mBC-0716-2
"D11,E1",946230,1051126,634270,416856,512809,12,315899,316349,244832,71517,3.423409819,180348,58080,37280,20767,8,20759,1,2569,0,0.0015415,mm10,mBC-0716-2
"D11,E2",16181,16721,12271,4450,8299,1,3760,3772,2618,1154,2.268630849,1818,1006,591,310,0,310,0,135,0,0.009677419,empty,mBC-0716-2
"D11,E3",12425,12855,9520,3335,6349,27,2798,2827,1969,858,2.294871795,1320,1120,675,401,0,401,0,178,0,0.047381546,empty,mBC-0716-2
"D11,E4",14958,15459,11211,4248,7651,0,3605,3612,2558,1054,2.426944972,1809,931,546,337,0,337,0,146,0,0.038575668,empty,mBC-0716-2
"D11,E5",21091,21737,16235,5502,10701,7,4744,4767,3385,1382,2.44934877,2258,960,555,331,0,331,0,175,0,0.01510574,empty,mBC-0716-2
"D11,E6",13970,14157,10600,3557,6916,13,3110,3126,2208,918,2.405228758,1464,1167,672,395,0,395,0,191,0,0.126582278,empty,mBC-0716-2
"D11,E7",14056,13896,10613,3283,6897,0,3068,3079,2221,858,2.588578089,1396,1888,758,442,0,442,0,156,0,0.085972851,empty,mBC-0716-2
"D11,E8",18215,18633,13892,4741,9065,8,3998,4020,2776,1244,2.231511254,1921,2285,999,598,4,594,1,193,0,0.067340067,empty,mBC-0716-2
"D11,E9",9076,9228,6893,2335,4530,0,2055,2056,1427,629,2.268680445,988,707,407,227,0,227,0,97,0,0.039647577,empty,mBC-0716-2
"D11,E10",12729,13150,9661,3489,6477,13,2967,2984,2047,937,2.184631804,1440,855,533,336,0,336,0,134,0,0.035714286,empty,mBC-0716-2
"D11,E11",750508,842510,517685,324825,417583,2,247279,247644,201108,46536,4.321557504,139712,65769,37012,20792,11,20781,1,2437,0,0.006448198,mm10,mBC-0716-2
"D11,E12",794673,931041,514298,416743,460250,1,300761,301128,240800,60328,3.991513062,179987,64253,42039,23662,13,23649,2,2625,0,0.00232568,mm10,mBC-0716-2
"D11,F1",19034,19545,14593,4952,9537,0,4308,4319,3052,1267,2.408839779,2033,1827,876,518,0,518,0,226,0,0.121621622,empty,mBC-0716-2
"D11,F2",831802,944558,583293,361265,465696,19,277164,277527,199319,78208,2.548575593,158297,33698,21782,12154,7,12147,2,1886,0,0.00271672,mm10,mBC-0716-2
"D11,F3",15978,16476,12071,4405,8227,0,3857,3863,2672,1191,2.243492863,1901,1261,745,449,0,449,0,204,0,0.022271715,empty,mBC-0716-2
"D11,F4",16101,16189,11970,4219,8185,0,3741,3749,2531,1218,2.077996716,1757,438,252,149,0,149,0,83,0,0.033557047,empty,mBC-0716-2
"D11,F5",955896,1019487,675187,344300,495821,0,277271,277669,196082,81587,2.403348573,150985,14689,8796,4947,1,4946,1,1130,0,0.007480793,mm10,mBC-0716-2
"D11,F6",23624,24103,17805,6298,11884,7,5490,5509,3901,1608,2.425995025,2672,9787,3300,1952,1,1951,1,544,0,0.078421322,empty,mBC-0716-2
"D11,F7",20564,21277,15773,5504,10382,16,4629,4656,3212,1444,2.224376731,2168,532,334,218,0,218,0,102,0,0.027522936,empty,mBC-0716-2
"D11,F8",22859,23855,17384,6471,11681,0,5375,5399,3792,1607,2.359676416,2620,1333,467,305,0,305,0,128,0,0.02295082,empty,mBC-0716-2
"D11,F9",15393,15598,11854,3744,7676,98,3432,3533,2421,1112,2.177158273,1625,1026,589,380,0,380,0,150,0,0.042105263,empty,mBC-0716-2
"D11,F10",21090,21170,16400,4770,10380,0,4492,4504,3178,1326,2.39668175,2048,1097,681,399,0,399,0,156,0,0.047619048,empty,mBC-0716-2
"D11,F11",11596,11666,8905,2761,5851,1,2563,2574,1780,794,2.241813602,1193,736,423,254,0,254,0,125,0,0.031496063,empty,mBC-0716-2
"D11,F12",14544,15145,11088,4057,7384,0,3432,3440,2443,997,2.450351053,1715,327,102,62,0,62,0,38,0,0,empty,mBC-0716-2
"D11,G1",11000,11039,8085,2954,5375,0,2396,2401,1665,736,2.262228261,1114,8104,2954,1797,0,1797,0,425,0,0.225375626,empty,mBC-0716-2
"D11,G2",1942063,2020091,1441971,578120,957462,3,481603,482498,400285,82213,4.868877185,242124,34695,21662,11998,3,11995,2,1875,0,0.004668612,mm10,mBC-0716-2
"D11,G3",21557,22526,16317,6209,11046,3,5308,5313,3723,1590,2.341509434,2560,1218,788,465,0,465,0,206,0,0.030107527,empty,mBC-0716-2
"D11,G4",34780,35663,26631,9032,17280,10,7592,7622,5551,2071,2.680347658,3604,123,74,51,0,51,0,42,0,0,empty,mBC-0716-2
"D11,G5",13919,14565,10550,4015,6984,12,3267,3283,2354,929,2.533907427,1598,842,460,279,0,279,0,147,0,0.050179211,empty,mBC-0716-2
"D11,G6",24622,25237,19239,5998,12209,0,5380,5388,3815,1573,2.425301971,2451,246,140,89,0,89,0,50,0,0.011235955,empty,mBC-0716-2
"D11,G7",19619,20295,15072,5223,10054,0,4486,4492,3146,1346,2.337295691,2137,1151,700,420,0,420,0,195,0,0.045238095,empty,mBC-0716-2
"D11,G8",14456,15006,10964,4042,7487,1,3507,3519,2514,1005,2.501492537,1744,1180,736,430,1,429,1,198,0,0.004662005,empty,mBC-0716-2
"D11,G9",10852,11214,8156,3058,5485,1,2554,2565,1818,747,2.43373494,1272,697,402,263,0,263,0,146,0,0.057034221,empty,mBC-0716-2
"D11,G10",13590,13897,10332,3565,7057,0,3226,3237,2186,1051,2.079923882,1554,854,504,308,0,308,0,170,0,0.048701299,empty,mBC-0716-2
"D11,G11",12460,12982,9385,3597,6375,2,2928,2932,2038,894,2.279642058,1487,385,242,158,0,158,0,94,0,0.03164557,empty,mBC-0716-2
"D11,G12",11803,12061,9007,3054,5915,16,2740,2762,1974,788,2.505076142,1272,2330,947,583,0,583,0,211,0,0.058319039,empty,mBC-0716-2
"D11,H1",23118,23668,17544,6124,11668,0,5361,5381,3758,1623,2.315465188,2595,713,418,258,1,257,1,116,0,0.046692607,empty,mBC-0716-2
"D11,H2",24841,25549,19023,6526,12464,10,5658,5681,4119,1562,2.637003841,2746,1371,847,537,1,536,1,258,0,0.016791045,empty,mBC-0716-2
"D11,H3",818805,860020,592460,267560,420608,1,222260,222638,163044,59594,2.735913011,116633,38154,14045,8109,7,8102,3,1673,0,0.024685263,mm10,mBC-0716-2
"D11,H4",14500,14996,10913,4083,7276,23,3374,3400,2285,1115,2.049327354,1658,387,176,112,0,112,0,68,0,0,empty,mBC-0716-2
"D11,H5",18257,18898,13764,5134,9241,0,4307,4311,3003,1308,2.29587156,2090,987,598,346,0,346,0,162,0,0.014450867,empty,mBC-0716-2
"D11,H6",686704,769100,469578,299522,379631,20,225939,226255,178635,47620,3.751259975,128089,77569,50276,27761,11,27750,1,2908,0,0.001801802,mm10,mBC-0716-2
"D11,H7",16828,17336,12557,4779,8628,25,3982,4017,2793,1224,2.281862745,2000,1197,742,437,0,437,0,168,0,0.018306636,empty,mBC-0716-2
"D11,H8",13842,14619,10349,4270,7122,0,3333,3335,2294,1041,2.203650336,1719,1149,762,481,2,479,1,207,0,0.014613779,empty,mBC-0716-2
"D11,H9",16881,17304,12678,4626,8596,0,3945,3953,2745,1208,2.272350993,1962,1367,685,443,1,442,1,197,0,0.097285068,empty,mBC-0716-2
"D11,H10",14738,14967,11106,3861,7491,12,3465,3490,2452,1038,2.362235067,1722,1068,643,398,0,398,0,206,0,0.020100503,empty,mBC-0716-2
"D11,H11",17008,17695,12939,4756,8677,21,4091,4119,2911,1208,2.409768212,1986,185,109,74,0,74,0,53,0,0.013513514,empty,mBC-0716-2
"D11,H12",6278,6574,4719,1855,3281,16,1556,1579,1067,512,2.083984375,787,1058,379,249,0,249,0,113,0,0.016064257,empty,mBC-0716-2
"D12,A1",13600,13881,10249,3632,6932,0,3241,3253,2263,990,2.285858586,1540,961,563,312,0,312,0,139,0,0.016025641,empty,mBC-0716-2
"D12,A2",18195,18551,14104,4447,8962,0,3946,3953,2758,1195,2.307949791,1846,921,536,291,0,291,0,120,0,0.020618557,empty,mBC-0716-2
"D12,A3",16327,16837,12364,4473,8302,0,3833,3854,2671,1183,2.257819104,1870,767,463,254,0,254,0,106,0,0,empty,mBC-0716-2
"D12,A4",850641,903791,633631,270160,431866,1,215492,215866,170110,45756,3.717763791,111287,21219,13659,7525,1,7524,1,1323,0,0.001727804,mm10,mBC-0716-2
"D12,A5",17234,17960,13066,4894,8751,1,4090,4098,2870,1228,2.33713355,2029,1203,734,421,0,421,0,174,0,0.047505938,empty,mBC-0716-2
"D12,A6",12296,12882,9351,3531,6393,0,3022,3023,2070,953,2.172088143,1530,1031,625,371,0,371,0,159,0,0.059299191,empty,mBC-0716-2
"D12,A7",16422,16914,12390,4524,8306,0,3801,3813,2653,1160,2.287068966,1799,918,508,289,1,288,1,121,0,0.027777778,empty,mBC-0716-2
"D12,A8",492306,549576,350678,198898,270894,0,151580,151814,126828,24986,5.075962539,83769,86927,56070,31334,8,31326,1,3118,0,0.000861904,mm10,mBC-0716-2
"D12,A9",18742,19314,14357,4957,9172,0,4086,4097,2897,1200,2.414166667,1965,1054,654,365,1,364,1,173,0,0.024725275,empty,mBC-0716-2
"D12,A10",15429,15966,11689,4277,7761,1,3621,3628,2474,1154,2.143847487,1727,328,205,129,0,129,0,77,0,0.085271318,empty,mBC-0716-2
"D12,A11",18630,18740,13994,4746,8953,1,4141,4162,2875,1287,2.233877234,1985,12013,4154,2536,2,2534,2,534,0,0.316495659,empty,mBC-0716-2
"D12,A12",20400,20801,15695,5106,10056,12,4383,4408,3036,1372,2.212827988,2046,1985,1200,708,1,707,1,216,0,0.084865629,empty,mBC-0716-2
"D12,B1",19370,19535,14904,4631,9503,7,4166,4180,3013,1167,2.581833762,1934,2695,966,585,2,583,1,199,0,0.068610635,empty,mBC-0716-2
"D12,B2",2391835,2691593,1569638,1121955,1273885,3,821572,822616,603033,219583,2.74626451,480880,26586,15832,8859,2,8857,1,1496,0,0.002371006,mm10,mBC-0716-2
"D12,B3",18401,18895,13999,4896,9198,6,4252,4276,2903,1373,2.114348143,1991,881,524,318,0,318,0,148,0,0.025157233,empty,mBC-0716-2
"D12,B4",17191,17633,13125,4508,8533,2,3803,3822,2729,1093,2.496797804,1879,827,450,270,0,270,0,118,0,0.007407407,empty,mBC-0716-2
"D12,B5",8816,5153,3524,1629,3339,19,1649,1684,1142,542,2.10701107,931,592,318,215,0,215,0,93,0,0.041860465,empty,mBC-0716-2
"D12,B6",12041,12529,8943,3586,6181,0,2943,2947,2051,896,2.2890625,1484,872,525,305,0,305,0,126,0,0.068852459,empty,mBC-0716-2
"D12,B7",16565,17450,12670,4780,8514,3,3934,3940,2804,1136,2.468309859,1941,852,525,298,0,298,0,111,0,0.046979866,empty,mBC-0716-2
"D12,B8",12897,13000,9958,3042,6460,0,2842,2847,2032,815,2.493251534,1269,716,425,257,0,257,0,135,0,0.011673152,empty,mBC-0716-2
"D12,B9",15472,16007,11842,4165,7603,15,3482,3505,2454,1051,2.334919125,1626,535,337,196,0,196,0,95,0,0.056122449,empty,mBC-0716-2
"D12,B10",16235,16397,12193,4204,8162,0,3813,3830,2617,1213,2.157460841,1813,443,241,147,0,147,0,60,0,0.006802721,empty,mBC-0716-2
"D12,B11",15623,16140,11956,4184,7887,0,3587,3591,2498,1093,2.285452882,1709,141,97,68,0,68,0,46,0,0,empty,mBC-0716-2
"D12,B12",18663,19144,14236,4908,9446,13,4242,4268,3065,1203,2.547797174,2004,1502,781,458,0,458,0,170,0,0.063318777,empty,mBC-0716-2
"D12,C1",22689,22814,17496,5318,10936,0,4642,4654,3278,1376,2.382267442,2159,530,323,177,0,177,0,75,0,0.107344633,empty,mBC-0716-2
"D12,C2",18123,18988,13727,5261,9009,0,4152,4158,2916,1242,2.347826087,2036,1219,766,460,0,460,0,160,0,0.039130435,empty,mBC-0716-2
"D12,C3",19974,20721,15072,5649,9968,2,4716,4732,3303,1429,2.311406578,2340,553,305,166,0,166,0,73,0,0.084337349,empty,mBC-0716-2
"D12,C4",16871,17135,12875,4260,8399,0,3764,3769,2634,1135,2.320704846,1788,991,584,359,0,359,0,133,0,0.072423398,empty,mBC-0716-2
"D12,C5",16988,17628,12901,4727,8718,0,4123,4129,2869,1260,2.276984127,2015,995,517,313,0,313,0,134,0,0.124600639,empty,mBC-0716-2
"D12,C6",15997,16471,11964,4507,8328,3,3911,3921,2754,1167,2.359897172,1950,1128,684,372,0,372,0,158,0,0.043010753,empty,mBC-0716-2
"D12,C7",16604,17109,12496,4613,8170,1,3827,3832,2711,1121,2.41837645,1812,285,170,107,0,107,0,64,0,0.102803738,empty,mBC-0716-2
"D12,C8",15415,15569,11650,3919,7716,7,3485,3506,2301,1205,1.909543568,1632,2034,829,505,0,505,0,214,0,0.069306931,empty,mBC-0716-2
"D12,C9",12978,13405,9772,3633,6571,3,3048,3061,2104,957,2.198537095,1497,551,326,197,0,197,0,86,0,0,empty,mBC-0716-2
"D12,C10",666355,696594,502544,194050,340536,19,167746,168085,120452,47633,2.528751076,85206,5518,3360,1956,1,1955,1,546,0,0.007161125,mm10,mBC-0716-2
"D12,C11",11822,12218,8891,3327,6136,11,2972,2992,2062,930,2.217204301,1481,649,389,224,1,223,1,103,0,0.004484305,empty,mBC-0716-2
"D12,C12",20096,20544,14967,5577,9919,0,4582,4592,3391,1201,2.823480433,2218,3995,1556,891,2,889,2,254,0,0.196850394,empty,mBC-0716-2
"D12,D1",10685,11166,8011,3155,5544,0,2598,2601,1792,809,2.215080346,1254,450,246,164,0,164,0,68,0,0,empty,mBC-0716-2
"D12,D2",691066,719773,514158,205615,350295,5,176812,177121,142532,34589,4.120732025,89099,11190,7000,3994,2,3992,1,890,0,0.01252505,mm10,mBC-0716-2
"D12,D3",708490,758126,525228,232898,369973,0,186715,187026,155138,31888,4.865090316,97174,146479,94286,52207,17,52190,1,3980,0,0.002759149,mm10,mBC-0716-2
"D12,D4",14890,15457,11299,4158,7463,0,3410,3419,2403,1016,2.36515748,1690,901,512,325,0,325,0,163,0,0.033846154,empty,mBC-0716-2
"D12,D5",13642,13764,10454,3310,6811,0,3090,3098,2144,954,2.247379455,1416,989,606,329,0,329,0,126,0,0.063829787,empty,mBC-0716-2
"D12,D6",12737,13231,9519,3712,6508,0,3131,3138,2167,971,2.231719876,1532,882,503,300,0,300,0,126,0,0.116666667,empty,mBC-0716-2
"D12,D7",12278,12987,9372,3615,6363,1,2960,2965,2049,916,2.236899563,1469,948,591,350,0,350,0,131,0,0.097142857,empty,mBC-0716-2
"D12,D8",15873,16385,11922,4463,8068,15,3719,3740,2560,1180,2.169491525,1857,608,360,224,0,224,0,102,0,0.0625,empty,mBC-0716-2
"D12,D9",4705,4760,3497,1263,2374,0,1100,1103,770,333,2.312312312,550,2753,1134,686,0,686,0,275,0,0.029154519,empty,mBC-0716-2
"D12,D10",13806,14428,10379,4049,6890,0,3241,3245,2233,1012,2.206521739,1642,1347,579,332,0,332,0,119,0,0.081325301,empty,mBC-0716-2
"D12,D11",13096,13616,9955,3661,6664,3,3049,3058,2091,967,2.162357808,1481,1397,880,504,0,504,0,204,0,0.009920635,empty,mBC-0716-2
"D12,D12",20678,21155,15876,5279,10139,28,4550,4588,3192,1396,2.286532951,2169,2045,1218,694,0,694,0,235,0,0.037463977,empty,mBC-0716-2
"D12,E1",21433,21566,16178,5388,10632,0,4751,4758,3370,1388,2.42795389,2304,2706,1264,719,1,718,1,271,0,0.055710306,empty,mBC-0716-2
"D12,E2",16251,16761,12427,4334,8038,0,3616,3625,2525,1100,2.295454545,1722,1201,636,392,0,392,0,153,0,0.048469388,empty,mBC-0716-2
"D12,E3",609200,658968,443693,215275,322413,0,177639,177904,131774,46130,2.856579233,93626,23818,15445,8772,4,8768,1,1531,0,0.006729015,mm10,mBC-0716-2
"D12,E4",15505,16318,11766,4552,7759,14,3586,3611,2575,1036,2.485521236,1732,842,481,302,1,301,1,135,0,0.026578073,empty,mBC-0716-2
"D12,E5",21422,22211,16443,5768,10734,0,4846,4865,3516,1349,2.606375093,2333,1041,663,404,0,404,0,181,0,0.051980198,empty,mBC-0716-2
"D12,E6",13761,14043,10538,3505,6767,1,3099,3109,2183,926,2.357451404,1496,925,542,368,1,367,1,162,0,0.051771117,empty,mBC-0716-2
"D12,E7",14155,14317,10631,3686,7076,18,3263,3286,2324,962,2.415800416,1526,1060,642,361,1,360,1,127,0,0.05,empty,mBC-0716-2
"D12,E8",17819,18191,13639,4552,8807,5,3934,3944,2771,1173,2.362318841,1831,1390,769,448,0,448,0,178,0,0.03125,empty,mBC-0716-2
"D12,E9",697478,746241,478668,267573,360413,3,210998,211301,166063,45238,3.670874044,115963,11079,5195,2829,4,2825,1,795,0,0.016637168,mm10,mBC-0716-2
"D12,E10",13333,13640,10204,3436,6734,5,3115,3126,2138,988,2.163967611,1492,1039,639,403,0,403,0,150,0,0.024813896,empty,mBC-0716-2
"D12,E11",8984,9203,6719,2484,4588,0,2164,2170,1522,648,2.348765432,1065,1231,540,343,0,343,0,133,0,0.005830904,empty,mBC-0716-2
"D12,E12",14682,15244,10997,4247,7467,0,3433,3445,2411,1034,2.33172147,1683,829,484,295,0,295,0,113,0,0.050847458,empty,mBC-0716-2
"D12,F1",18443,18604,13967,4637,9144,0,4169,4180,2950,1230,2.398373984,1986,1053,645,387,0,387,0,181,0,0.036175711,empty,mBC-0716-2
"D12,F2",22701,23785,17221,6564,11390,1,5271,5280,3746,1534,2.441981747,2521,2139,1333,841,0,841,0,312,0,0.051129608,empty,mBC-0716-2
"D12,F3",15848,16530,12019,4511,8154,0,3817,3825,2656,1169,2.272027374,1905,2228,988,613,1,612,1,252,0,0.053921569,empty,mBC-0716-2
"D12,F4",15391,15013,11330,3683,7604,0,3450,3451,2380,1071,2.222222222,1601,341,190,131,0,131,0,63,0,0.007633588,empty,mBC-0716-2
"D12,F5",1602150,1772295,1138346,633949,845765,19,484339,485097,352064,133033,2.646441109,270628,78424,51162,28418,14,28404,3,3131,0,0.001056189,mm10,mBC-0716-2
"D12,F6",23174,24296,17614,6682,11567,9,5268,5294,3734,1560,2.393589744,2558,1546,891,567,0,567,0,189,0,0.049382716,empty,mBC-0716-2
"D12,F7",20790,21189,15886,5303,10284,3,4615,4629,3171,1458,2.174897119,2124,2201,882,530,0,530,0,185,0,0.032075472,empty,mBC-0716-2
"D12,F8",22534,23535,17115,6420,11404,0,5267,5277,3630,1647,2.204007286,2586,245,156,94,0,94,0,54,0,0.053191489,empty,mBC-0716-2
"D12,F9",14808,15281,11230,4051,7357,13,3375,3394,2383,1011,2.357072206,1639,1624,908,510,0,510,0,179,0,0.121568627,empty,mBC-0716-2
"D12,F10",21423,22207,16528,5679,10519,0,4642,4656,3284,1372,2.393586006,2180,1099,657,384,0,384,0,152,0,0.0546875,empty,mBC-0716-2
"D12,F11",11014,11282,8383,2899,5575,0,2522,2525,1748,777,2.24967825,1231,898,482,292,0,292,0,132,0,0.065068493,empty,mBC-0716-2
"D12,F12",14343,14543,10815,3728,7026,5,3171,3179,2191,988,2.217611336,1490,131,86,58,0,58,0,32,0,0.086206897,empty,mBC-0716-2
"D12,G1",10434,10646,8093,2553,5186,5,2226,2234,1592,642,2.479750779,1031,1624,966,578,2,576,2,165,0,0.034722222,empty,mBC-0716-2
"D12,G2",2100738,2291344,1527500,763844,1071424,29,578137,579077,496735,82342,6.032583615,313710,31766,20395,11410,5,11405,1,1764,0,0.002981149,mm10,mBC-0716-2
"D12,G3",23157,24610,17445,7165,11977,0,5762,5770,4056,1714,2.366394399,2965,2944,1319,802,0,802,0,275,0,0.029925187,empty,mBC-0716-2
"D12,G4",1431907,1664922,928147,736775,788775,2,529856,530553,362532,168021,2.157658864,316840,412,262,146,0,146,0,66,0,0,empty,mBC-0716-2
"D12,G5",13368,13969,10123,3846,6767,0,3156,3157,2243,914,2.45404814,1523,841,445,277,0,277,0,135,0,0.032490975,empty,mBC-0716-2
"D12,G6",24262,25126,18670,6456,12015,108,5192,5317,3777,1540,2.452597403,2552,160,89,68,0,68,0,41,0,0,empty,mBC-0716-2
"D12,G7",20657,21133,15987,5146,10150,0,4502,4514,3152,1362,2.314243759,2068,1099,671,419,0,419,0,176,0,0.071599045,empty,mBC-0716-2
"D12,G8",14544,15098,10990,4108,7391,0,3506,3506,2476,1030,2.403883495,1659,1126,703,422,0,422,0,180,0,0.035545024,empty,mBC-0716-2
"D12,G9",10798,11180,8143,3037,5528,0,2636,2638,1887,751,2.5126498,1312,768,462,286,0,286,0,134,0,0.006993007,empty,mBC-0716-2
"D12,G10",13505,13845,10264,3581,6753,1,3092,3107,2213,894,2.475391499,1460,919,529,339,0,339,0,155,0,0.026548673,empty,mBC-0716-2
"D12,G11",12322,12800,9398,3402,6165,0,2787,2788,1937,851,2.276145711,1346,698,427,252,0,252,0,109,0,0.027777778,empty,mBC-0716-2
"D12,G12",11826,12051,8915,3136,5905,9,2704,2722,1887,835,2.25988024,1305,919,533,300,0,300,0,107,0,0.053333333,empty,mBC-0716-2
"D12,H1",21005,21419,15858,5561,10510,20,4812,4837,3469,1368,2.535818713,2296,873,536,345,1,344,1,136,0,0.023255814,empty,mBC-0716-2
"D12,H2",26229,27022,19969,7053,13155,12,5964,5983,4297,1686,2.548635824,2859,1353,795,482,0,482,0,204,0,0.037344398,empty,mBC-0716-2
"D12,H3",20872,22073,15755,6318,10621,44,4972,5023,3537,1486,2.380215343,2522,1388,726,462,1,461,1,191,0,0.169197397,empty,mBC-0716-2
"D12,H4",13711,14216,10342,3874,6960,6,3166,3182,2181,1001,2.178821179,1562,178,91,64,0,64,0,44,0,0,empty,mBC-0716-2
"D12,H5",18233,18891,13957,4934,9170,0,4217,4219,2982,1237,2.410670978,2024,1118,693,405,0,405,0,166,0,0.064197531,empty,mBC-0716-2
"D12,H6",14032,14342,10771,3571,7070,9,3201,3215,2225,990,2.247474747,1500,1118,625,386,0,386,0,163,0,0.018134715,empty,mBC-0716-2
"D12,H7",960425,1159971,592363,567608,564999,16,395647,396113,282261,113852,2.479192285,248079,42250,27168,14811,6,14805,3,2051,0,0.004457953,mm10,mBC-0716-2
"D12,H8",20955,21963,15375,6588,10778,0,5417,5437,4106,1331,3.084898573,2770,1337,784,454,2,452,1,197,0,0.019911504,empty,mBC-0716-2
"D12,H9",560889,587805,415100,172705,290208,2,141397,141682,117117,24565,4.767636882,72935,73757,41403,23281,10,23271,2,2846,0,0.004340166,mm10,mBC-0716-2
"D12,H10",1092715,1161538,776908,384630,561591,8,301065,301531,259112,42419,6.108394823,161060,150844,99148,55268,22,55246,4,4419,0,0.001592876,mm10,mBC-0716-2
"D12,H11",17137,17780,13133,4647,8538,0,3974,3996,2780,1216,2.286184211,1885,133,80,54,0,54,0,40,0,0,empty,mBC-0716-2
"D12,H12",5954,6262,4464,1798,3122,0,1490,1492,1020,472,2.161016949,766,482,329,181,0,181,0,69,0,0.143646409,empty,mBC-0716-2
"E1,A1",1120954,1226059,793339,432720,610931,1,351010,351453,274907,76546,3.591396023,193063,52689,32115,18065,4,18061,1,2504,0,0.002214717,mm10,mBC-0716-2
"E1,A2",18389,18870,14086,4784,9288,23,4156,4185,2941,1244,2.36414791,1973,1318,755,479,0,479,0,219,0,0.012526096,empty,mBC-0716-2
"E1,A3",16295,16768,12379,4389,8202,19,3794,3822,2730,1092,2.5,1811,1380,810,482,0,482,0,222,0,0.01659751,empty,mBC-0716-2
"E1,A4",21834,22381,16898,5483,10656,0,4725,4744,3284,1460,2.249315068,2221,781,435,280,0,280,0,165,0,0.003571429,empty,mBC-0716-2
"E1,A5",17647,17995,13644,4351,9045,0,4087,4093,2859,1234,2.316855754,1918,1818,1055,695,0,695,0,317,0,0.043165468,empty,mBC-0716-2
"E1,A6",25965,27587,19577,8010,13909,1,6684,6693,5091,1602,3.177902622,3371,9420,3274,1916,1,1915,1,594,0,0.041775457,empty,mBC-0716-2
"E1,A7",1358994,1474782,991769,483013,716252,34,381859,382462,318263,64199,4.95744482,203439,201802,126478,71019,27,70992,4,4897,0,0.001535384,mm10,mBC-0716-2
"E1,A8",10816,11084,8351,2733,5569,3,2547,2552,1849,703,2.630156472,1205,1706,1069,671,1,670,1,261,0,0.044776119,empty,mBC-0716-2
"E1,A9",20838,21572,15859,5713,10428,0,4798,4816,3438,1378,2.494920174,2305,1503,870,547,1,546,1,237,0,0.06043956,empty,mBC-0716-2
"E1,A10",15898,16723,11951,4772,8129,19,3764,3796,2658,1138,2.335676626,1896,847,436,294,0,294,0,153,0,0,empty,mBC-0716-2
"E1,A11",17238,17631,13195,4436,8863,11,3973,3994,2746,1248,2.200320513,1845,2761,1250,782,1,781,1,350,0,0.065300896,empty,mBC-0716-2
"E1,A12",20911,21109,16093,5016,10144,0,4379,4390,3058,1332,2.295795796,2054,2200,1253,756,0,756,0,302,0,0.035714286,empty,mBC-0716-2
"E1,B1",19488,19978,15037,4941,9732,18,4382,4405,3080,1325,2.324528302,2061,1272,792,474,0,474,0,205,0,0.061181435,empty,mBC-0716-2
"E1,B2",19848,20295,15206,5089,10007,1,4518,4535,3066,1469,2.087134105,2083,583,333,226,0,226,0,103,0,0.075221239,empty,mBC-0716-2
"E1,B3",18773,19504,14320,5184,9453,0,4257,4274,2978,1296,2.297839506,2092,1316,834,512,0,512,0,227,0,0.046875,empty,mBC-0716-2
"E1,B4",16404,17135,12607,4528,8347,2,3803,3815,2622,1193,2.19782062,1892,1332,727,463,0,463,0,205,0,0.047516199,empty,mBC-0716-2
"E1,B5",580475,324032,212001,112031,211871,4,110439,111242,93898,17344,5.413860701,63589,83896,55347,30167,14,30153,3,3066,0,0.000895433,mm10,mBC-0716-2
"E1,B6",13387,13864,9936,3928,6821,3,3300,3307,2381,926,2.571274298,1639,2063,1028,640,1,639,1,279,0,0.0657277,empty,mBC-0716-2
"E1,B7",17479,18169,13214,4955,8971,4,4244,4253,2782,1471,1.891230455,2078,2184,915,585,0,585,0,253,0,0.008547009,empty,mBC-0716-2
"E1,B8",13350,13827,10156,3671,6837,7,3165,3179,2223,956,2.325313808,1551,1429,914,601,0,601,0,265,0,0.011647255,empty,mBC-0716-2
"E1,B9",15220,15618,11647,3971,7394,4,3270,3287,2356,931,2.530612245,1504,1113,609,401,0,401,0,185,0,0.039900249,empty,mBC-0716-2
"E1,B10",16610,16853,12318,4535,8469,10,3926,3956,2716,1240,2.190322581,1882,2340,876,555,0,555,0,233,0,0.081081081,empty,mBC-0716-2
"E1,B11",1287288,1409909,896834,513075,664980,2,386775,387350,289560,97790,2.961038961,215918,5769,3795,2147,0,2147,0,503,0,0.001397299,mm10,mBC-0716-2
"E1,B12",18740,19447,14287,5160,9594,0,4414,4429,3150,1279,2.462861611,2162,1396,804,490,0,490,0,216,0,0.02244898,empty,mBC-0716-2
"E1,C1",24423,23761,18261,5500,10995,47,4670,4727,3370,1357,2.483419307,2128,13582,4321,2688,8,2680,2,594,0,0.327985075,empty,mBC-0716-2
"E1,C2",18338,18959,13827,5132,9048,0,4162,4165,2864,1301,2.201383551,2032,1756,947,589,0,589,0,238,0,0.054329372,empty,mBC-0716-2
"E1,C3",20178,20744,15312,5432,10027,0,4680,4689,3302,1387,2.380677722,2283,626,354,194,0,194,0,105,0,0,empty,mBC-0716-2
"E1,C4",17176,17380,13243,4137,8534,0,3746,3752,2639,1113,2.371069182,1722,1340,804,462,1,461,1,187,0,0.04989154,empty,mBC-0716-2
"E1,C5",16510,17140,12581,4559,8384,0,3792,3799,2573,1226,2.098694943,1921,1374,838,533,0,533,0,246,0,0.020637899,empty,mBC-0716-2
"E1,C6",17010,17054,12689,4365,8652,0,3961,3966,2745,1221,2.248157248,1882,17945,5114,3144,4,3140,2,879,0,0.02866242,empty,mBC-0716-2
"E1,C7",16825,17810,12694,5116,8516,1,4080,4088,2846,1242,2.291465378,1991,453,299,177,0,177,0,94,0,0.016949153,empty,mBC-0716-2
"E1,C8",15154,15751,11553,4198,7804,11,3602,3625,2526,1099,2.298453139,1774,3457,1531,949,0,949,0,322,0,0.115911486,empty,mBC-0716-2
"E1,C9",17824,19144,13441,5703,9238,0,4523,4535,3334,1201,2.776019983,2319,2050,1043,627,1,626,1,239,0,0.004792332,empty,mBC-0716-2
"E1,C10",13224,13638,10061,3577,6832,0,3101,3112,2105,1007,2.090367428,1547,1269,792,502,0,502,0,214,0,0.035856574,empty,mBC-0716-2
"E1,C11",1669082,1911046,1147615,763431,923458,15,568213,568998,444638,124360,3.5754101,330450,150494,93309,52355,25,52330,4,4267,0,0.002961972,mm10,mBC-0716-2
"E1,C12",21206,22110,16114,5996,10619,47,4863,4923,3442,1481,2.324105334,2415,1323,806,480,0,480,0,204,0,0.020833333,empty,mBC-0716-2
"E1,D1",13264,13721,9937,3784,6867,0,3264,3267,2336,931,2.509129968,1573,824,498,309,1,308,1,142,0,0.051948052,empty,mBC-0716-2
"E1,D2",1206392,1295976,888208,407768,616002,13,317279,317803,265265,52538,5.049012144,164850,246014,163915,91171,32,91139,3,5331,0,0.001371531,mm10,mBC-0716-2
"E1,D3",13762,14388,10411,3977,7181,0,3344,3346,2314,1032,2.242248062,1683,1550,969,611,1,610,1,266,0,0.027868852,empty,mBC-0716-2
"E1,D4",14573,14900,11178,3722,7322,19,3352,3371,2334,1037,2.25072324,1610,1581,922,588,2,586,1,311,0,0.040955631,empty,mBC-0716-2
"E1,D5",13835,14030,10318,3712,7039,2,3305,3311,2342,969,2.416924665,1586,4296,1939,1206,0,1206,0,323,0,0.34079602,empty,mBC-0716-2
"E1,D6",12291,12729,9248,3481,6349,9,3007,3024,2145,879,2.440273038,1531,1591,961,619,0,619,0,247,0,0.050080775,empty,mBC-0716-2
"E1,D7",12568,12981,9550,3431,6421,0,3038,3044,2108,936,2.252136752,1445,1733,1005,595,0,595,0,252,0,0.030252101,empty,mBC-0716-2
"E1,D8",15891,16559,12197,4362,8137,0,3770,3781,2617,1164,2.248281787,1804,1858,868,554,1,553,1,237,0,0.099457505,empty,mBC-0716-2
"E1,D9",4940,5121,3569,1552,2635,0,1270,1272,920,352,2.613636364,656,2284,1141,711,0,711,0,336,0,0.032348805,empty,mBC-0716-2
"E1,D10",13430,13989,10134,3855,6828,0,3123,3127,2218,909,2.440044004,1556,1965,965,593,0,593,0,200,0,0.178752108,empty,mBC-0716-2
"E1,D11",13296,13529,10159,3370,6717,4,3084,3092,2128,964,2.20746888,1485,1933,1229,730,0,730,0,307,0,0.032876712,empty,mBC-0716-2
"E1,D12",20429,20995,15646,5349,10132,0,4646,4658,3249,1409,2.305890703,2184,2105,1282,764,0,764,0,311,0,0.035340314,empty,mBC-0716-2
"E1,E1",1455667,1630151,974403,655748,776753,4,486239,486929,368671,118258,3.117514249,279426,63693,41193,23014,9,23005,1,2770,0,0.005781352,mm10,mBC-0716-2
"E1,E2",15954,16459,11939,4520,8006,18,3548,3578,2519,1059,2.378659112,1760,1634,975,594,0,594,0,255,0,0.005050505,empty,mBC-0716-2
"E1,E3",12555,12808,9706,3102,6290,0,2887,2891,2008,883,2.274065685,1317,1646,1053,656,0,656,0,291,0,0.028963415,empty,mBC-0716-2
"E1,E4",15791,16391,12027,4364,7881,0,3655,3659,2559,1100,2.326363636,1739,1430,851,522,1,521,1,231,0,0.063339731,empty,mBC-0716-2
"E1,E5",1256592,1334503,928045,406458,633509,5,323705,324254,285698,38556,7.409949165,166813,124336,82455,46321,22,46299,2,3836,0,0.000907147,mm10,mBC-0716-2
"E1,E6",13777,14039,10612,3427,7022,0,3233,3240,2301,939,2.450479233,1539,1940,1039,642,0,642,0,288,0,0.031152648,empty,mBC-0716-2
"E1,E7",1551477,1621906,1148988,472918,769915,1,386632,387332,313861,73471,4.2719032,197343,119125,78343,43605,22,43583,1,3848,0,0.001032513,mm10,mBC-0716-2
"E1,E8",17363,17403,13414,3989,8616,0,3775,3790,2652,1138,2.330404218,1701,2438,1303,801,0,801,0,292,0,0.053682896,empty,mBC-0716-2
"E1,E9",8875,9185,6698,2487,4557,3,2131,2141,1464,677,2.162481536,1067,1159,710,410,0,410,0,176,0,0.087804878,empty,mBC-0716-2
"E1,E10",13133,13478,9976,3502,6748,13,3136,3155,2156,999,2.158158158,1487,1478,885,541,0,541,0,232,0,0.070240296,empty,mBC-0716-2
"E1,E11",9016,9144,6853,2291,4563,0,2068,2073,1428,645,2.213953488,962,1285,761,491,0,491,0,226,0,0.042769857,empty,mBC-0716-2
"E1,E12",14621,14858,10967,3891,7615,0,3581,3588,2483,1105,2.247058824,1761,1145,684,424,0,424,0,198,0,0.023584906,empty,mBC-0716-2
"E1,F1",803401,879190,578787,300403,429315,8,236040,236438,176355,60083,2.935189654,128267,41905,27096,15343,4,15339,1,2075,0,0.001890606,mm10,mBC-0716-2
"E1,F2",22358,23069,16833,6236,11322,1,5384,5390,3768,1622,2.323057953,2660,3055,1889,1163,0,1163,0,507,0,0.018916595,empty,mBC-0716-2
"E1,F3",16461,17125,12370,4755,8491,7,4093,4107,2849,1258,2.264705882,2020,2570,1379,864,2,862,1,363,0,0.039443155,empty,mBC-0716-2
"E1,F4",15834,16015,11863,4152,8037,0,3639,3650,2578,1072,2.404850746,1722,4505,1454,879,1,878,1,328,0,0.027334852,empty,mBC-0716-2
"E1,F5",24610,25325,18796,6529,12516,4,5608,5630,3979,1651,2.410054512,2716,2385,1409,932,0,932,0,405,0,0.025751073,empty,mBC-0716-2
"E1,F6",23178,24370,17417,6953,11827,0,5609,5614,3972,1642,2.419001218,2758,2324,1402,798,0,798,0,320,0,0.072681704,empty,mBC-0716-2
"E1,F7",20680,21094,15628,5466,10313,2,4657,4667,3301,1366,2.416544656,2181,2115,927,542,0,542,0,225,0,0.031365314,empty,mBC-0716-2
"E1,F8",908492,994515,650371,344144,484609,1,266488,266902,210584,56318,3.739195284,144463,14643,9333,5241,3,5238,2,1059,0,0.000954563,mm10,mBC-0716-2
"E1,F9",14800,15341,11239,4102,7518,0,3451,3456,2446,1010,2.421782178,1606,1745,1042,648,0,648,0,265,0,0.047839506,empty,mBC-0716-2
"E1,F10",21276,21656,16722,4934,10536,0,4610,4627,3214,1413,2.274593064,2094,1398,879,533,0,533,0,230,0,0.041275797,empty,mBC-0716-2
"E1,F11",11302,11714,8668,3046,5808,0,2614,2620,1831,789,2.320659062,1266,5317,1957,1193,0,1193,0,394,0,0.01424979,empty,mBC-0716-2
"E1,F12",14846,15123,11380,3743,7277,1,3324,3327,2361,966,2.444099379,1488,145,91,62,0,62,0,50,0,0,empty,mBC-0716-2
"E1,G1",10167,10366,7849,2517,5149,0,2272,2282,1615,667,2.421289355,1055,1835,1166,705,1,704,1,269,0,0.046875,empty,mBC-0716-2
"E1,G2",21589,22149,16397,5752,10711,0,4834,4843,3415,1428,2.391456583,2270,788,516,321,0,321,0,172,0,0.034267913,empty,mBC-0716-2
"E1,G3",603605,621572,447017,174555,306754,0,150269,150496,117910,32586,3.618425091,76002,26129,13779,7894,4,7890,1,1709,0,0.017617237,mm10,mBC-0716-2
"E1,G4",29383,29948,22889,7059,14445,70,6183,6265,4371,1894,2.30781415,2877,257,167,120,0,120,0,85,0,0.008333333,empty,mBC-0716-2
"E1,G5",778725,858192,564232,293960,419072,1,230230,230564,178304,52260,3.411863758,125197,57167,36446,20494,11,20483,1,2476,0,0.001806376,mm10,mBC-0716-2
"E1,G6",24727,25086,18882,6204,12145,55,5245,5308,3748,1560,2.402564103,2431,329,210,136,0,136,0,88,0,0,empty,mBC-0716-2
"E1,G7",20405,20662,15742,4920,10240,0,4507,4527,3226,1301,2.479631053,2046,2264,1416,858,0,858,0,362,0,0.054778555,empty,mBC-0716-2
"E1,G8",15187,15727,11397,4330,7758,16,3711,3730,2670,1060,2.518867925,1859,1730,1061,661,0,661,0,278,0,0.037821483,empty,mBC-0716-2
"E1,G9",741572,840852,523818,317034,409319,9,229273,229596,197626,31970,6.181607757,129175,213970,139398,76840,30,76810,1,5016,0,0.000403593,mm10,mBC-0716-2
"E1,G10",13433,13871,10228,3643,6738,33,3069,3117,2179,938,2.323027719,1462,1516,907,612,0,612,0,301,0,0.016339869,empty,mBC-0716-2
"E1,G11",12695,13034,9672,3362,6317,1,2849,2855,2080,775,2.683870968,1314,762,432,269,0,269,0,140,0,0.003717472,empty,mBC-0716-2
"E1,G12",11203,11540,8549,2991,5754,0,2666,2674,1909,765,2.495424837,1307,1202,760,442,0,442,0,190,0,0.092760181,empty,mBC-0716-2
"E1,H1",21066,21917,16221,5696,10647,2,4925,4929,3466,1463,2.36910458,2375,1069,607,380,0,380,0,194,0,0.010526316,empty,mBC-0716-2
"E1,H2",1217336,1393110,812634,580476,670426,22,426941,427532,354888,72644,4.885303673,248431,100894,67031,37217,13,37204,2,3435,0,0.000537577,mm10,mBC-0716-2
"E1,H3",20144,20410,15021,5389,10124,0,4647,4654,3334,1320,2.525757576,2217,28384,8595,5192,9,5183,1,1189,0,0.067721397,empty,mBC-0716-2
"E1,H4",13910,14148,10501,3647,6926,0,3204,3215,2271,944,2.405720339,1503,309,188,129,0,129,0,92,0,0.031007752,empty,mBC-0716-2
"E1,H5",1263059,1414685,879836,534849,669483,18,395449,395959,306842,89117,3.443136551,223245,111967,72890,40498,8,40490,1,3591,0,0.001061991,mm10,mBC-0716-2
"E1,H6",850234,930577,586507,344070,451813,0,258143,258505,214532,43973,4.878721033,142792,269053,173234,94929,34,94895,2,5669,0,0.000969493,mm10,mBC-0716-2
"E1,H7",16676,17067,12607,4460,8433,0,3774,3779,2659,1120,2.374107143,1793,1970,1140,741,0,741,0,303,0,0.102564103,empty,mBC-0716-2
"E1,H8",13686,14117,10304,3813,6787,36,3158,3202,2258,944,2.391949153,1554,2316,1309,818,1,817,1,338,0,0.045287638,empty,mBC-0716-2
"E1,H9",18010,18013,12991,5022,8674,4,4158,4170,2953,1217,2.426458505,2097,27701,8662,5354,2,5352,1,1151,0,0.193198804,empty,mBC-0716-2
"E1,H10",14276,14773,10976,3797,7374,0,3439,3449,2387,1062,2.247645951,1662,1595,994,632,0,632,0,311,0,0.017405063,empty,mBC-0716-2
"E1,H11",16917,17157,12772,4385,8479,0,3908,3915,2712,1203,2.25436409,1826,514,227,153,2,151,1,104,0,0.039735099,empty,mBC-0716-2
"E1,H12",6192,6410,4564,1846,3206,0,1498,1500,1044,456,2.289473684,767,762,469,292,1,291,1,121,0,0.120274914,empty,mBC-0716-2
"E2,A1",1201904,1302488,858878,443610,635088,0,344237,344673,291824,52849,5.521845257,186288,189929,119520,66638,25,66613,3,4773,0,0.000600483,mm10,mBC-0716-2
"E2,A2",15986,16289,12163,4126,7901,3,3450,3456,2439,1017,2.398230088,1650,1101,668,389,0,389,0,185,0,0.059125964,empty,mBC-0716-2
"E2,A3",15285,15414,11810,3604,7432,0,3364,3376,2387,989,2.413549039,1562,1245,629,353,0,353,0,184,0,0.033994334,empty,mBC-0716-2
"E2,A4",19783,20113,14930,5183,9790,0,4392,4402,3084,1318,2.339908953,2101,2664,867,524,0,524,0,210,0,0.005725191,empty,mBC-0716-2
"E2,A5",608343,654417,450134,204283,321255,4,162229,162523,134929,27594,4.889794883,85206,142410,78106,43438,16,43422,3,3935,0,0.005964718,mm10,mBC-0716-2
"E2,A6",15976,16604,11934,4670,8283,34,3893,3941,2750,1191,2.308984047,1935,1484,882,563,0,563,0,272,0,0.047957371,empty,mBC-0716-2
"E2,A7",15346,16187,11372,4815,7694,0,3632,3640,2520,1120,2.25,1840,9571,3216,2002,1,2001,1,522,0,0.172413793,empty,mBC-0716-2
"E2,A8",10153,10598,7842,2756,5059,0,2260,2264,1563,701,2.229671897,1067,5492,1922,1169,0,1169,0,403,0,0.044482464,empty,mBC-0716-2
"E2,A9",19231,19867,14770,5097,9377,2,4181,4195,2961,1234,2.399513776,1958,2675,1245,794,0,794,0,339,0,0.042821159,empty,mBC-0716-2
"E2,A10",648808,695831,472201,223630,338024,12,175422,175700,144573,31127,4.644617213,92449,28252,16754,9618,6,9612,3,1546,0,0.006554307,mm10,mBC-0716-2
"E2,A11",16175,16264,12312,3952,8048,0,3629,3642,2521,1121,2.248884924,1682,1413,898,545,0,545,0,217,0,0.064220183,empty,mBC-0716-2
"E2,A12",813585,897914,577714,320200,428813,28,241746,242131,196344,45787,4.288204075,132455,124458,80580,44517,17,44500,2,3799,0,0.004696629,mm10,mBC-0716-2
"E2,B1",996808,1081484,711673,369811,516932,2,284893,285405,219729,65676,3.345651379,155079,45554,27556,15634,7,15627,1,2059,0,0.004479427,mm10,mBC-0716-2
"E2,B2",19244,19914,14637,5277,9517,25,4312,4351,3075,1276,2.409874608,2161,345,197,117,0,117,0,79,0,0,empty,mBC-0716-2
"E2,B3",17445,17563,13429,4134,8546,1,3817,3825,2651,1174,2.258091993,1725,1528,752,473,0,473,0,200,0,0.069767442,empty,mBC-0716-2
"E2,B4",15537,16013,11729,4284,7657,1,3495,3498,2467,1031,2.392822502,1715,3530,1405,869,0,869,0,284,0,0.055235903,empty,mBC-0716-2
"E2,B5",10856,7563,5402,2161,4514,0,2246,2267,1537,730,2.105479452,1229,844,474,303,0,303,0,133,0,0.059405941,empty,mBC-0716-2
"E2,B6",556162,623677,391626,232051,306718,1,175265,175517,138207,37310,3.704288395,98802,59271,39737,22499,9,22490,1,2854,0,0.001244998,mm10,mBC-0716-2
"E2,B7",2383507,2591657,1706803,884854,1218490,0,695836,696940,571886,125054,4.573112415,374762,121213,77523,43327,23,43304,3,4016,0,0.001731942,mm10,mBC-0716-2
"E2,B8",13189,13769,10112,3657,6716,0,3084,3093,2230,863,2.58400927,1476,1117,701,420,0,420,0,229,0,0.030952381,empty,mBC-0716-2
"E2,B9",14280,14797,10923,3874,6939,26,3122,3157,2208,949,2.326659642,1533,1081,518,334,0,334,0,173,0,0.020958084,empty,mBC-0716-2
"E2,B10",15251,15093,11052,4041,7602,4,3616,3633,2561,1072,2.388992537,1785,8495,2412,1498,0,1498,0,463,0,0.024032043,empty,mBC-0716-2
"E2,B11",16515,16911,12228,4683,8183,3,3912,3923,2579,1344,1.91889881,1946,453,191,138,0,138,0,83,0,0.065217391,empty,mBC-0716-2
"E2,B12",773240,844037,552716,291321,411649,0,227609,227953,186152,41801,4.453290591,123765,39999,23612,13090,6,13084,1,1923,0,0.004280037,mm10,mBC-0716-2
"E2,C1",946729,1020172,687143,333029,487062,1,262668,263047,214195,48852,4.384569721,138863,23188,14878,8276,7,8269,2,1376,0,0.000967469,mm10,mBC-0716-2
"E2,C2",17176,17630,12826,4804,8385,3,3912,3926,2731,1195,2.285355649,1891,7754,3005,1803,0,1803,0,464,0,0.151968941,empty,mBC-0716-2
"E2,C3",1815522,2098067,1221888,876179,998550,12,643232,644037,479431,164606,2.912597354,379313,29481,19411,11152,7,11145,2,1702,0,0.001794527,mm10,mBC-0716-2
"E2,C4",15683,15879,11971,3908,7724,0,3441,3443,2364,1079,2.190917516,1615,1297,786,455,0,455,0,166,0,0.030769231,empty,mBC-0716-2
"E2,C5",719225,759683,538239,221444,368283,1,180064,180357,147675,32682,4.518542317,91997,72590,47271,26712,10,26702,1,2857,0,0.002097221,mm10,mBC-0716-2
"E2,C6",15697,15958,11742,4216,8084,0,3764,3772,2672,1100,2.429090909,1844,2947,1243,780,0,780,0,276,0,0.033333333,empty,mBC-0716-2
"E2,C7",15330,15648,11678,3970,7482,18,3323,3344,2346,998,2.350701403,1577,374,205,142,0,142,0,93,0,0.007042254,empty,mBC-0716-2
"E2,C8",13240,13304,10112,3192,6654,0,2971,2976,2088,888,2.351351351,1373,1129,689,448,0,448,0,208,0,0.035714286,empty,mBC-0716-2
"E2,C9",388518,391669,270288,121381,184726,0,96040,96194,63731,32463,1.963188861,50924,23422,15443,8764,3,8761,1,1360,0,0.002739413,mm10,mBC-0716-2
"E2,C10",1277474,1373315,914761,458554,659535,13,358384,358882,287317,71565,4.01476979,192505,91123,58199,33062,19,33043,2,3578,0,0.002088188,mm10,mBC-0716-2
"E2,C11",11448,11781,8604,3177,5702,0,2681,2684,1899,785,2.41910828,1251,4204,1595,942,1,941,1,317,0,0.070138151,empty,mBC-0716-2
"E2,C12",1213153,1318905,872103,446802,635821,1,357114,357677,277593,80084,3.466272913,193582,34605,21244,11890,9,11881,2,2026,0,0.028701288,mm10,mBC-0716-2
"E2,D1",9521,9744,7156,2588,4914,0,2284,2287,1592,695,2.290647482,1064,905,419,247,0,247,0,113,0,0.016194332,empty,mBC-0716-2
"E2,D2",667064,684553,494905,189648,334311,27,164372,164660,134021,30639,4.374196286,81775,9201,5956,3217,2,3215,1,940,0,0.021150855,mm10,mBC-0716-2
"E2,D3",12126,12866,9124,3742,6310,12,2983,3004,2023,981,2.062181448,1488,1073,612,406,0,406,0,213,0,0.0591133,empty,mBC-0716-2
"E2,D4",13125,13294,9919,3375,6510,1,3041,3049,2127,922,2.306941432,1446,1351,780,513,0,513,0,248,0,0.134502924,empty,mBC-0716-2
"E2,D5",12088,12644,9205,3439,6158,5,2904,2918,2104,814,2.584766585,1420,1549,753,470,1,469,1,182,0,0.017057569,empty,mBC-0716-2
"E2,D6",614482,706490,423428,283062,345642,37,209339,209628,141233,68395,2.064960889,123192,49605,32882,18693,11,18682,1,2488,0,0.001338186,mm10,mBC-0716-2
"E2,D7",11168,11272,8493,2779,5512,0,2530,2533,1754,779,2.251604621,1141,1439,870,512,0,512,0,205,0,0.06640625,empty,mBC-0716-2
"E2,D8",17510,18399,13413,4986,8876,0,4125,4137,3023,1114,2.713644524,1993,832,489,317,0,317,0,142,0,0.018927445,empty,mBC-0716-2
"E2,D9",397762,423463,278594,144869,214154,0,118229,118370,85673,32697,2.620209805,65044,25990,15786,8818,5,8813,2,1545,0,0.003744468,mm10,mBC-0716-2
"E2,D10",14254,15028,10783,4245,7117,0,3367,3376,2427,949,2.557428872,1648,621,338,205,0,205,0,112,0,0.058536585,empty,mBC-0716-2
"E2,D11",12616,12882,9411,3471,6216,16,2841,2861,2032,829,2.451145959,1342,5048,1954,1215,1,1214,1,417,0,0.057660626,empty,mBC-0716-2
"E2,D12",18917,19286,14579,4707,9398,2,4213,4229,2881,1348,2.137240356,2001,1816,1081,666,0,666,0,276,0,0.058558559,empty,mBC-0716-2
"E2,E1",20114,20788,15436,5352,10015,0,4575,4587,3222,1365,2.36043956,2197,1818,922,587,0,587,0,263,0,0.04088586,empty,mBC-0716-2
"E2,E2",14232,14578,10951,3627,7040,0,3112,3121,2221,900,2.467777778,1421,1165,701,443,0,443,0,193,0,0.0248307,empty,mBC-0716-2
"E2,E3",715796,776901,515297,261604,375724,1,203285,203615,169012,34603,4.884316389,108416,110752,72211,41422,16,41406,1,3532,0,0.001449065,mm10,mBC-0716-2
"E2,E4",14170,14526,10739,3787,7156,0,3277,3288,2299,989,2.324570273,1574,1191,675,387,0,387,0,196,0,0.059431525,empty,mBC-0716-2
"E2,E5",19605,20044,15143,4901,9803,1,4273,4282,2954,1328,2.22439759,1967,1560,898,530,1,529,1,238,0,0.001890359,empty,mBC-0716-2
"E2,E6",11999,12313,9185,3128,6052,0,2733,2737,1937,800,2.42125,1310,3764,1496,974,2,972,1,389,0,0.059670782,empty,mBC-0716-2
"E2,E7",535085,561712,399848,161864,275127,2,135403,135621,98942,36679,2.697510837,68822,30070,18307,10487,3,10484,1,1674,0,0.003147654,mm10,mBC-0716-2
"E2,E8",16236,16565,12367,4198,7984,0,3493,3498,2429,1069,2.272217025,1635,2410,1173,689,0,689,0,272,0,0.033381713,empty,mBC-0716-2
"E2,E9",8167,8379,6152,2227,4037,0,1885,1892,1359,533,2.549718574,888,1012,607,377,0,377,0,165,0,0.074270557,empty,mBC-0716-2
"E2,E10",12264,12574,9368,3206,6137,1,2835,2842,1936,906,2.136865342,1346,1217,722,461,0,461,0,217,0,0.026030369,empty,mBC-0716-2
"E2,E11",8391,8807,6428,2379,4276,27,1918,1948,1357,591,2.296108291,989,1042,594,368,0,368,0,165,0,0.067934783,empty,mBC-0716-2
"E2,E12",15460,15840,11720,4120,7741,57,3557,3620,2560,1060,2.41509434,1700,5393,1978,1163,0,1163,0,349,0,0.058469475,empty,mBC-0716-2
"E2,F1",17673,18286,13525,4761,8722,0,3973,3985,2802,1183,2.368554522,1912,1685,952,579,0,579,0,246,0,0.027633851,empty,mBC-0716-2
"E2,F2",22744,23804,17052,6752,11504,0,5455,5474,3814,1660,2.297590361,2722,2636,1669,1080,1,1079,1,430,0,0.032437442,empty,mBC-0716-2
"E2,F3",14748,15220,11133,4087,7496,21,3577,3603,2560,1043,2.454458293,1745,1856,1090,695,1,694,1,318,0,0.025936599,empty,mBC-0716-2
"E2,F4",13987,14011,10462,3549,7041,0,3197,3210,2274,936,2.429487179,1512,516,265,172,0,172,0,88,0,0.104651163,empty,mBC-0716-2
"E2,F5",22555,23039,17198,5841,11002,0,5048,5061,3580,1481,2.417285618,2358,10320,3410,2091,1,2090,1,668,0,0.005263158,empty,mBC-0716-2
"E2,F6",21353,21990,16252,5738,10565,45,4837,4890,3471,1419,2.446088795,2367,1706,1047,605,0,605,0,277,0,0.018181818,empty,mBC-0716-2
"E2,F7",18615,19025,14024,5001,9360,17,4229,4256,2956,1300,2.273846154,2050,773,464,290,1,289,1,142,0,0.07266436,empty,mBC-0716-2
"E2,F8",806123,896058,567189,328869,432703,33,245755,246139,206681,39458,5.237999899,136544,9649,6469,3878,2,3876,1,830,0,0.000257998,mm10,mBC-0716-2
"E2,F9",13670,13815,10631,3184,6629,0,2929,2940,2042,898,2.273942094,1367,1710,1022,608,1,607,1,225,0,0.10214168,empty,mBC-0716-2
"E2,F10",966612,1060866,695156,365710,508160,30,277265,277722,232928,44794,5.19998214,150413,58971,39345,22160,10,22150,2,2589,0,0.001309255,mm10,mBC-0716-2
"E2,F11",10045,10464,7587,2877,5125,0,2387,2389,1653,736,2.245923913,1162,869,498,323,1,322,1,186,0,0.00931677,empty,mBC-0716-2
"E2,F12",13211,13783,9847,3936,6683,0,3152,3156,2238,918,2.437908497,1549,195,128,90,0,90,0,56,0,0.011111111,empty,mBC-0716-2
"E2,G1",1235346,1351642,879442,472200,652611,1,371153,371711,273565,98146,2.787327043,204200,78540,51116,28771,8,28763,1,3274,0,0.001251608,mm10,mBC-0716-2
"E2,G2",19653,20134,14991,5143,9711,5,4323,4345,3054,1291,2.365608056,2048,1112,523,346,0,346,0,180,0,0.046242775,empty,mBC-0716-2
"E2,G3",18632,19063,14138,4925,9301,0,4168,4181,2869,1312,2.186737805,2057,2066,1263,799,0,799,0,345,0,0.026282854,empty,mBC-0716-2
"E2,G4",543600,531540,420789,110751,260306,34,104416,104664,82517,22147,3.725877094,47637,312,185,125,0,125,0,78,0,0.008,empty,mBC-0716-2
"E2,G5",12053,12384,9220,3164,6092,3,2776,2785,1938,847,2.288075561,1318,1251,742,477,1,476,1,229,0,0.008403361,empty,mBC-0716-2
"E2,G6",23101,23962,17631,6331,11412,14,5076,5102,3579,1523,2.34996717,2454,244,140,91,0,91,0,62,0,0,empty,mBC-0716-2
"E2,G7",19196,19798,14688,5110,9647,7,4324,4344,3001,1343,2.234549516,2100,1759,1022,646,0,646,0,293,0,0.037151703,empty,mBC-0716-2
"E2,G8",13243,14052,9924,4128,6840,3,3271,3279,2210,1069,2.067352666,1659,1524,921,593,0,593,0,271,0,0.020236088,empty,mBC-0716-2
"E2,G9",9609,9791,7268,2523,4842,1,2240,2252,1592,660,2.412121212,1060,1154,704,442,1,441,1,230,0,0.01814059,empty,mBC-0716-2
"E2,G10",504876,532292,373431,158861,263730,3,133306,133516,105038,28478,3.688391039,69431,16628,9158,5100,4,5096,2,1320,0,0.00588697,mm10,mBC-0716-2
"E2,G11",13124,13681,10028,3653,6617,10,2989,3015,2175,840,2.589285714,1420,780,414,261,0,261,0,120,0,0,empty,mBC-0716-2
"E2,G12",10338,10565,7760,2805,5175,0,2436,2445,1714,731,2.344733242,1178,1108,571,347,0,347,0,159,0,0.13832853,empty,mBC-0716-2
"E2,H1",828506,859441,625017,234424,410238,7,192442,192815,165004,27811,5.933048075,95074,78347,51138,28510,9,28501,3,2869,0,0.001157854,mm10,mBC-0716-2
"E2,H2",898635,935743,656207,279536,450374,9,235604,235946,187337,48609,3.853957086,121392,11333,6696,3805,2,3803,1,936,0,0.001051801,mm10,mBC-0716-2
"E2,H3",508051,526724,352588,174136,252931,11,141483,141693,98471,43222,2.278261071,77418,8955,4925,2764,4,2760,1,810,0,0.024275362,mm10,mBC-0716-2
"E2,H4",11955,12529,9128,3401,6211,0,2907,2911,1998,913,2.188389923,1454,209,136,97,0,97,0,70,0,0,empty,mBC-0716-2
"E2,H5",16081,16809,12156,4653,8062,15,3703,3725,2582,1143,2.258967629,1841,1260,767,492,0,492,0,235,0,0.018292683,empty,mBC-0716-2
"E2,H6",12227,12588,9180,3408,6068,1,2847,2849,1979,870,2.274712644,1373,2238,1257,777,0,777,0,253,0,0.207207207,empty,mBC-0716-2
"E2,H7",704075,781746,488761,292985,385535,12,231131,231455,170206,61249,2.778918839,129652,21819,13283,7580,4,7576,1,1348,0,0.007127772,mm10,mBC-0716-2
"E2,H8",1051174,1121732,768383,353349,540833,0,285948,286405,220120,66285,3.320811647,150193,87044,57049,32829,14,32815,2,3429,0,0.004113972,mm10,mBC-0716-2
"E2,H9",14621,15089,10972,4117,7377,0,3413,3425,2453,972,2.523662551,1696,9660,3675,2298,0,2298,0,595,0,0.262402089,empty,mBC-0716-2
"E2,H10",12665,12904,9458,3446,6393,5,2949,2964,2063,901,2.289678135,1420,1368,849,518,0,518,0,271,0,0.007722008,empty,mBC-0716-2
"E2,H11",15228,15846,11578,4268,7689,0,3473,3476,2437,1039,2.345524543,1695,384,170,113,0,113,0,87,0,0.07079646,empty,mBC-0716-2
"E2,H12",5462,5557,4107,1450,2734,25,1264,1291,935,356,2.626404494,610,532,349,207,0,207,0,99,0,0.057971014,empty,mBC-0716-2
"E3,A1",13882,14400,10520,3880,7230,12,3356,3375,2342,1033,2.267182962,1609,1214,723,469,0,469,0,205,0,0.017057569,empty,mBC-0716-2
"E3,A2",1730573,1814533,1260515,554018,858664,5,444803,445580,366154,79426,4.610001763,230210,151464,100479,55877,27,55850,1,4345,0,0.001002686,mm10,mBC-0716-2
"E3,A3",849358,975996,570245,405751,480131,9,308077,308426,217874,90552,2.406065023,180995,25141,13705,7775,5,7770,1,1543,0,0.003346203,mm10,mBC-0716-2
"E3,A4",21379,21687,16346,5341,10720,6,4836,4853,3473,1380,2.516666667,2273,826,462,288,0,288,0,144,0,0.0625,empty,mBC-0716-2
"E3,A5",645935,688119,481242,206877,338864,11,166282,166573,142732,23841,5.986829412,85683,90232,59611,32523,10,32513,2,3187,0,0.00159936,mm10,mBC-0716-2
"E3,A6",12986,13332,9888,3444,6718,0,3174,3188,2250,938,2.398720682,1525,15255,5167,3122,6,3116,3,768,0,0.14987163,empty,mBC-0716-2
"E3,A7",15052,15627,11592,4035,7866,3,3635,3653,2555,1098,2.326958106,1767,1407,834,534,0,534,0,233,0,0.02247191,empty,mBC-0716-2
"E3,A8",10559,11123,7914,3209,5489,0,2573,2576,1784,792,2.252525253,1308,2477,1195,698,0,698,0,281,0,0.047277937,empty,mBC-0716-2
"E3,A9",18126,18454,13856,4598,8907,0,3995,4004,2835,1169,2.425149701,1863,1643,1002,610,0,610,0,264,0,0.054098361,empty,mBC-0716-2
"E3,A10",15635,16072,11887,4185,7988,0,3643,3652,2476,1176,2.105442177,1724,1101,482,276,0,276,0,128,0,0,empty,mBC-0716-2
"E3,A11",17021,17415,13086,4329,8567,1,3810,3829,2772,1057,2.622516556,1755,2692,1030,642,0,642,0,279,0,0.04517134,empty,mBC-0716-2
"E3,A12",19959,20003,15339,4664,9710,0,4275,4295,3068,1227,2.500407498,1962,2851,1634,922,0,922,0,314,0,0.0835141,empty,mBC-0716-2
"E3,B1",18747,19478,14362,5116,9409,11,4273,4289,3075,1214,2.532948929,2035,1303,791,505,1,504,1,203,0,0.015873016,empty,mBC-0716-2
"E3,B2",20183,20924,15381,5543,10142,27,4665,4701,3283,1418,2.315232722,2292,544,328,206,0,206,0,105,0,0.029126214,empty,mBC-0716-2
"E3,B3",18527,19141,13974,5167,9367,0,4343,4349,3062,1287,2.379176379,2146,1544,950,568,1,567,1,242,0,0.014109347,empty,mBC-0716-2
"E3,B4",1027719,1115092,755478,359614,535042,12,284642,285079,219503,65576,3.347306942,152108,60771,39367,21605,7,21598,1,2483,0,0.002176127,mm10,mBC-0716-2
"E3,B5",9524,5901,4190,1711,3743,0,1771,1788,1270,518,2.451737452,956,940,556,338,0,338,0,150,0,0.014792899,empty,mBC-0716-2
"E3,B6",758363,843662,525168,318494,412182,1,239536,239967,191346,48621,3.935459986,134337,165940,110414,61731,31,61700,5,4534,0,0.000615883,mm10,mBC-0716-2
"E3,B7",1329927,1454249,923305,530944,691634,3,403536,404095,335091,69004,4.856109791,221944,31703,20693,11416,2,11414,1,1730,0,0.000788505,mm10,mBC-0716-2
"E3,B8",12739,13169,9859,3310,6493,0,2973,2979,2127,852,2.496478873,1365,2253,1189,727,0,727,0,297,0,0.020632737,empty,mBC-0716-2
"E3,B9",14791,14988,11299,3689,7367,16,3310,3329,2344,985,2.379695431,1558,977,533,337,0,337,0,170,0,0.005934718,empty,mBC-0716-2
"E3,B10",15833,16051,11733,4318,8112,5,3788,3807,2602,1205,2.1593361,1850,1842,666,394,0,394,0,171,0,0.025380711,empty,mBC-0716-2
"E3,B11",15351,15567,11510,4057,7599,11,3563,3583,2509,1074,2.336126629,1679,931,424,274,0,274,0,133,0,0.040145985,empty,mBC-0716-2
"E3,B12",17279,18071,13221,4850,8959,0,4126,4135,2912,1223,2.381030253,1987,1401,788,489,0,489,0,224,0,0.032719836,empty,mBC-0716-2
"E3,C1",21880,22277,16980,5297,10714,6,4611,4620,3280,1340,2.447761194,2120,901,538,328,0,328,0,162,0,0.030487805,empty,mBC-0716-2
"E3,C2",17528,17862,13307,4555,8554,1,3844,3858,2746,1112,2.46942446,1796,2336,1286,777,0,777,0,260,0,0.048906049,empty,mBC-0716-2
"E3,C3",19344,19942,14735,5207,9667,20,4461,4493,3135,1358,2.308541973,2141,715,399,243,0,243,0,113,0,0.061728395,empty,mBC-0716-2
"E3,C4",16887,17162,12909,4253,8461,16,3731,3756,2641,1115,2.368609865,1751,1424,844,527,0,527,0,211,0,0.045540797,empty,mBC-0716-2
"E3,C5",17043,17883,12866,5017,8845,27,4097,4134,2971,1163,2.554600172,2015,4311,1682,1041,1,1040,1,405,0,0.065384615,empty,mBC-0716-2
"E3,C6",15886,16361,11901,4460,8340,12,3941,3965,2756,1209,2.279569892,2006,1584,941,568,0,568,0,247,0,0.01584507,empty,mBC-0716-2
"E3,C7",15319,15435,11487,3948,7755,10,3572,3597,2550,1047,2.435530086,1702,799,417,263,0,263,0,139,0,0.034220532,empty,mBC-0716-2
"E3,C8",646586,695006,466877,228129,346862,3,189191,189494,144211,45283,3.18466091,101415,25492,16293,9308,5,9303,1,1596,0,0.009136838,mm10,mBC-0716-2
"E3,C9",12755,13069,9676,3393,6437,4,3024,3032,2129,903,2.357696567,1415,1028,626,381,0,381,0,163,0,0.062992126,empty,mBC-0716-2
"E3,C10",957198,975158,750682,224476,473304,5,187555,187922,127625,60297,2.116606133,96070,44642,27816,15480,2,15478,1,2248,0,0.001679804,mm10,mBC-0716-2
"E3,C11",11033,11270,8333,2937,5655,0,2632,2633,1856,777,2.388674389,1281,1089,644,385,1,384,1,180,0,0.0390625,empty,mBC-0716-2
"E3,C12",19021,19881,14348,5533,9774,29,4517,4562,3209,1353,2.371766445,2233,1328,758,461,1,460,1,197,0,0.047826087,empty,mBC-0716-2
"E3,D1",11188,11595,8227,3368,5764,0,2773,2779,1992,787,2.531130877,1385,6661,2184,1285,0,1285,0,366,0,0.116731518,empty,mBC-0716-2
"E3,D2",20614,20788,15962,4826,10357,8,4513,4534,3193,1341,2.381058911,2092,3221,1974,1188,0,1188,0,438,0,0.037037037,empty,mBC-0716-2
"E3,D3",13251,13874,9880,3994,6942,19,3261,3289,2297,992,2.315524194,1679,1615,981,568,0,568,0,258,0,0.051056338,empty,mBC-0716-2
"E3,D4",865666,1002571,582547,420024,492420,0,310997,311386,231699,79687,2.907613538,182046,61236,38964,21341,9,21332,2,2656,0,0.000890681,mm10,mBC-0716-2
"E3,D5",13173,13500,10055,3445,6685,0,3019,3023,2045,978,2.091002045,1384,1255,738,471,0,471,0,205,0,0.033970276,empty,mBC-0716-2
"E3,D6",511246,546836,385700,161136,271199,17,131612,131838,100072,31766,3.15028647,67868,68396,44781,24756,7,24749,1,2743,0,0.00420219,mm10,mBC-0716-2
"E3,D7",12366,12670,9318,3352,6117,21,2829,2853,2039,814,2.504914005,1390,1874,1178,696,0,696,0,246,0,0.094827586,empty,mBC-0716-2
"E3,D8",15664,16069,11756,4313,7969,2,3776,3783,2607,1176,2.216836735,1834,1275,824,495,0,495,0,217,0,0.042424242,empty,mBC-0716-2
"E3,D9",189278,198017,135463,62554,100685,5,50808,50890,42805,8085,5.294372294,26862,131107,85702,47502,18,47484,1,3877,0,0.000463314,mm10,mBC-0716-2
"E3,D10",13471,14092,10288,3804,6902,0,3251,3259,2271,988,2.298582996,1588,780,433,251,0,251,0,130,0,0.027888446,empty,mBC-0716-2
"E3,D11",12865,13071,9754,3317,6556,2,3032,3045,2151,894,2.406040268,1495,2186,1304,800,0,800,0,326,0,0.035,empty,mBC-0716-2
"E3,D12",19853,20667,14936,5731,9948,5,4545,4563,3107,1456,2.133928571,2177,2559,1537,954,2,952,2,325,0,0.051470588,empty,mBC-0716-2
"E3,E1",20772,21149,15816,5333,10519,0,4714,4721,3369,1352,2.491863905,2258,1823,1051,673,0,673,0,296,0,0.035661218,empty,mBC-0716-2
"E3,E2",15315,15504,11856,3648,7639,12,3360,3377,2393,984,2.431910569,1549,2172,1097,679,0,679,0,264,0,0.119293078,empty,mBC-0716-2
"E3,E3",12041,12382,9265,3117,6151,0,2797,2804,1955,849,2.302709069,1307,2239,1356,802,0,802,0,315,0,0.043640898,empty,mBC-0716-2
"E3,E4",15209,15672,11441,4231,7723,6,3599,3615,2592,1023,2.53372434,1752,1469,876,516,0,516,0,226,0,0.03875969,empty,mBC-0716-2
"E3,E5",1250325,1408855,854271,554584,676347,1,406024,406593,334331,72262,4.626650245,233993,5877,3158,1903,0,1903,0,752,0,0.02679979,mm10,mBC-0716-2
"E3,E6",948078,998420,704370,294050,487391,1,243126,243518,199059,44459,4.477361164,125570,156071,99701,54317,20,54297,3,4314,0,0.001454961,mm10,mBC-0716-2
"E3,E7",17576,18865,12932,5933,9064,0,4452,4471,2702,1769,1.52741662,2361,20685,6343,3788,4,3784,2,959,0,0.0647463,empty,mBC-0716-2
"E3,E8",1131629,1281908,750798,531110,619625,4,391194,391767,285831,105936,2.698147938,228308,190340,99499,55699,31,55668,8,4484,0,0.025328735,mm10,mBC-0716-2
"E3,E9",8190,8492,6172,2320,4139,0,1911,1916,1335,581,2.297762478,931,1253,712,369,0,369,0,157,0,0.013550136,empty,mBC-0716-2
"E3,E10",12413,12817,9483,3334,6290,0,2917,2919,2028,891,2.276094276,1379,1667,1017,613,0,613,0,250,0,0.032626427,empty,mBC-0716-2
"E3,E11",8771,9234,6592,2642,4624,0,2193,2197,1492,705,2.116312057,1122,6366,2277,1399,0,1399,0,436,0,0.023588277,empty,mBC-0716-2
"E3,E12",1523533,1778848,1001725,777123,870435,1,572766,573437,431811,141626,3.048952876,343277,78363,47287,25663,16,25647,3,3098,0,0.002456428,mm10,mBC-0716-2
"E3,F1",17432,17952,13306,4646,8956,0,4137,4149,2843,1306,2.176875957,1958,1725,1011,617,0,617,0,268,0,0.032414911,empty,mBC-0716-2
"E3,F2",21714,22792,16367,6425,11248,0,5312,5318,3700,1618,2.286773795,2620,3057,1925,1154,0,1154,0,463,0,0.024263432,empty,mBC-0716-2
"E3,F3",15770,16305,12026,4279,8112,23,3845,3882,2672,1210,2.208264463,1851,2343,1343,786,0,786,0,337,0,0.044529262,empty,mBC-0716-2
"E3,F4",15392,15644,11584,4060,7813,3,3616,3624,2594,1030,2.518446602,1701,2457,915,578,1,577,1,237,0,0.060658579,empty,mBC-0716-2
"E3,F5",23746,24606,17994,6612,12132,9,5571,5598,3882,1716,2.262237762,2768,2272,1296,815,0,815,0,371,0,0.049079755,empty,mBC-0716-2
"E3,F6",21987,22478,16788,5690,10986,0,5031,5040,3575,1465,2.440273038,2369,5946,2630,1566,0,1566,0,523,0,0.100255428,empty,mBC-0716-2
"E3,F7",28113,30328,20824,9504,14669,3,7535,7549,5405,2144,2.520988806,3794,1120,657,394,0,394,0,174,0,0.02284264,empty,mBC-0716-2
"E3,F8",23377,23847,17523,6324,11805,0,5390,5404,3790,1614,2.348203222,2574,386,234,162,0,162,0,116,0,0.00617284,empty,mBC-0716-2
"E3,F9",923375,1020248,617908,402340,501031,0,316997,317380,250930,66450,3.776222724,179498,12045,7528,4166,1,4165,1,1128,0,0.007202881,mm10,mBC-0716-2
"E3,F10",938073,1016500,693077,323423,492188,0,262881,263329,182661,80668,2.264355135,138636,31698,19153,10914,5,10909,1,1644,0,0.00284169,mm10,mBC-0716-2
"E3,F11",10592,10712,8119,2593,5470,0,2471,2477,1783,694,2.569164265,1154,1211,753,454,0,454,0,208,0,0.035242291,empty,mBC-0716-2
"E3,F12",13916,14462,10498,3964,6938,56,3208,3266,2274,992,2.29233871,1591,227,124,98,0,98,0,69,0,0.020408163,empty,mBC-0716-2
"E3,G1",627390,696740,429610,267130,343890,0,213464,213774,165624,48150,3.439750779,118978,41358,20180,11363,6,11357,2,1914,0,0.042176631,mm10,mBC-0716-2
"E3,G2",20813,21189,15816,5373,10548,0,4811,4816,3410,1406,2.425320057,2290,2175,877,584,0,584,0,253,0,0.042808219,empty,mBC-0716-2
"E3,G3",618090,653485,450156,203329,321926,0,166515,166804,135879,30925,4.393823767,87051,37194,20719,11740,8,11732,2,2036,0,0.008012274,mm10,mBC-0716-2
"E3,G4",2120294,2216868,1556992,659876,1043964,6,551663,552639,458326,94313,4.859626987,281625,1197,685,393,0,393,0,130,0,0.027989822,empty,mBC-0716-2
"E3,G5",13037,13592,9938,3654,6774,0,3126,3133,2242,891,2.51627385,1514,2826,1111,712,0,712,0,304,0,0.058988764,empty,mBC-0716-2
"E3,G6",23540,23900,18281,5619,11628,72,5042,5126,3711,1415,2.622614841,2333,254,168,120,0,120,0,69,0,0.058333333,empty,mBC-0716-2
"E3,G7",19575,19964,15153,4811,9870,0,4437,4446,3222,1224,2.632352941,2013,2443,1492,873,0,873,0,346,0,0.063001145,empty,mBC-0716-2
"E3,G8",1429581,1540182,1053765,486417,739271,1,389233,389865,320357,69508,4.608922714,204943,223743,139859,76626,30,76596,3,5266,0,0.001240274,mm10,mBC-0716-2
"E3,G9",10305,10789,7742,3047,5318,6,2408,2422,1694,728,2.326923077,1170,1530,912,583,1,582,1,272,0,0.030927835,empty,mBC-0716-2
"E3,G10",13022,13482,9976,3506,6707,0,3061,3067,2151,916,2.348253275,1481,2566,1178,744,1,743,1,328,0,0.033647376,empty,mBC-0716-2
"E3,G11",11453,12084,8727,3357,5934,0,2697,2699,1928,771,2.500648508,1306,790,471,312,0,312,0,154,0,0,empty,mBC-0716-2
"E3,G12",10970,11305,8330,2975,5657,0,2674,2680,1892,788,2.401015228,1300,1800,882,526,1,525,1,214,0,0.07047619,empty,mBC-0716-2
"E3,H1",20091,20930,15176,5754,10319,23,4806,4845,3384,1461,2.316221766,2351,1006,579,368,0,368,0,189,0,0.04076087,empty,mBC-0716-2
"E3,H2",940175,1036735,684091,352644,503008,0,271552,271974,195136,76838,2.539576772,149472,100258,63746,34912,19,34893,3,3397,0,0.001461611,mm10,mBC-0716-2
"E3,H3",19130,19871,14441,5430,9842,0,4524,4543,3198,1345,2.377695167,2264,1825,1047,652,1,651,1,279,0,0.026113671,empty,mBC-0716-2
"E3,H4",14136,14642,10572,4070,7215,26,3457,3490,2377,1113,2.135669362,1690,341,208,151,1,150,1,100,0,0.006666667,empty,mBC-0716-2
"E3,H5",22739,24455,16890,7565,11806,0,5933,5944,4215,1729,2.437825333,3088,1811,1120,652,0,652,0,264,0,0.015337423,empty,mBC-0716-2
"E3,H6",13774,14285,10341,3944,7068,7,3322,3338,2374,964,2.462655602,1665,2179,1298,780,0,780,0,289,0,0.046153846,empty,mBC-0716-2
"E3,H7",16235,16603,12191,4412,8165,8,3788,3810,2748,1062,2.587570621,1867,20112,6259,3761,6,3755,2,974,0,0.051131824,empty,mBC-0716-2
"E3,H8",13435,13949,10102,3847,6813,29,3243,3273,2339,934,2.504282655,1588,1915,1126,736,0,736,0,313,0,0.029891304,empty,mBC-0716-2
"E3,H9",15553,16071,11762,4309,7924,9,3714,3731,2668,1063,2.509877705,1737,5004,2113,1304,0,1304,0,427,0,0.159509202,empty,mBC-0716-2
"E3,H10",685581,742377,484479,257898,365382,2,209070,209371,165410,43961,3.762653261,114377,12624,8174,4700,4,4696,2,1100,0,0.007453152,mm10,mBC-0716-2
"E3,H11",744767,837190,518386,318804,411064,7,238713,239063,197682,41381,4.777119934,135113,5863,3194,1800,0,1800,0,473,0,0.006666667,mm10,mBC-0716-2
"E3,H12",5728,5955,4260,1695,2946,0,1446,1447,999,448,2.229910714,707,781,504,287,0,287,0,131,0,0.024390244,empty,mBC-0716-2
"E4,A1",581650,613685,435764,177921,304574,11,149669,149913,115299,34614,3.33099324,76100,61694,37932,21383,15,21368,3,2596,0,0.001684762,mm10,mBC-0716-2
"E4,A2",16893,17068,12972,4096,8371,27,3719,3750,2619,1131,2.315649867,1725,989,592,356,0,356,0,168,0,0.02247191,empty,mBC-0716-2
"E4,A3",15406,16158,11747,4411,7707,12,3622,3642,2521,1121,2.248884924,1785,857,551,327,0,327,0,137,0,0.03058104,empty,mBC-0716-2
"E4,A4",20516,20667,15587,5080,9927,11,4433,4457,3198,1259,2.540111199,2043,534,323,200,0,200,0,110,0,0.02,empty,mBC-0716-2
"E4,A5",721845,818917,503430,315487,402399,3,242673,243041,179962,63079,2.852962159,136954,48106,30591,17153,10,17143,2,2309,0,0.002508312,mm10,mBC-0716-2
"E4,A6",11815,12351,8882,3469,6046,0,2869,2876,2027,849,2.387514723,1422,2105,1277,740,0,740,0,275,0,0.013513514,empty,mBC-0716-2
"E4,A7",15026,15376,11323,4053,7437,0,3388,3403,2387,1016,2.349409449,1656,2133,1289,769,1,768,1,260,0,0.02734375,empty,mBC-0716-2
"E4,A8",10801,11049,7778,3271,5235,6,2506,2523,1721,802,2.145885287,1227,19016,6028,3593,3,3590,2,914,0,0.094986072,empty,mBC-0716-2
"E4,A9",18038,18374,14022,4352,8688,0,3729,3744,2708,1036,2.613899614,1691,1065,586,371,0,371,0,188,0,0.018867925,empty,mBC-0716-2
"E4,A10",14963,15275,11555,3720,7463,37,3383,3427,2436,991,2.458123108,1617,291,175,133,0,133,0,88,0,0.015037594,empty,mBC-0716-2
"E4,A11",16679,16964,12791,4173,8271,0,3606,3615,2495,1120,2.227678571,1666,2345,931,570,0,570,0,220,0,0.033333333,empty,mBC-0716-2
"E4,A12",19830,20477,15384,5093,9712,0,4266,4275,2926,1349,2.169014085,2022,2017,1178,684,0,684,0,228,0,0.05994152,empty,mBC-0716-2
"E4,B1",19023,19809,14578,5231,9335,22,4242,4276,3078,1198,2.569282137,2062,953,522,319,0,319,0,144,0,0.05015674,empty,mBC-0716-2
"E4,B2",19103,19607,14391,5216,9401,0,4304,4317,3020,1297,2.32845027,2095,397,223,130,0,130,0,67,0,0.015384615,empty,mBC-0716-2
"E4,B3",1146209,1278247,785666,492581,609256,25,372966,373535,286334,87201,3.283609133,210376,23003,14908,8210,2,8208,1,1427,0,0.001461988,mm10,mBC-0716-2
"E4,B4",1159564,1332528,768793,563735,634309,1,403919,404433,337205,67228,5.015841614,236484,69257,43526,24350,8,24342,2,2694,0,0.001889738,mm10,mBC-0716-2
"E4,B5",8646,4873,3501,1372,3089,35,1382,1432,1023,409,2.501222494,759,2942,1837,992,0,992,0,291,0,0.008064516,empty,mBC-0716-2
"E4,B6",11388,11717,8588,3129,5714,21,2719,2744,1851,893,2.072788354,1264,4716,1926,1161,0,1161,0,383,0,0.028423773,empty,mBC-0716-2
"E4,B7",15887,16506,12214,4292,7954,5,3537,3549,2486,1063,2.338664158,1729,1525,966,564,0,564,0,194,0,0.017730496,empty,mBC-0716-2
"E4,B8",12351,12896,9397,3499,6295,0,2959,2965,2084,881,2.365493757,1476,1707,1041,632,0,632,0,241,0,0.023734177,empty,mBC-0716-2
"E4,B9",14678,15078,11220,3858,7222,13,3338,3356,2351,1005,2.339303483,1638,647,378,244,0,244,0,112,0,0.040983607,empty,mBC-0716-2
"E4,B10",14982,15157,11204,3953,7510,0,3433,3445,2350,1095,2.146118721,1643,619,332,195,0,195,0,91,0,0.035897436,empty,mBC-0716-2
"E4,B11",14954,15621,11452,4169,7475,0,3437,3447,2415,1032,2.340116279,1662,240,114,81,0,81,0,57,0,0.037037037,empty,mBC-0716-2
"E4,B12",17446,18076,13278,4798,8705,1,3963,3981,2775,1206,2.300995025,1926,1310,790,482,0,482,0,176,0,0.128630705,empty,mBC-0716-2
"E4,C1",21618,21687,16671,5016,10396,0,4528,4532,3125,1407,2.221037669,2103,629,381,220,1,219,1,119,0,0,empty,mBC-0716-2
"E4,C2",16816,17456,12710,4746,8409,3,3808,3818,2689,1129,2.381753764,1876,1666,958,525,0,525,0,176,0,0.020952381,empty,mBC-0716-2
"E4,C3",18846,19833,14139,5694,9528,0,4502,4519,3143,1376,2.284156977,2296,551,305,181,0,181,0,86,0,0.011049724,empty,mBC-0716-2
"E4,C4",16317,16530,12311,4219,7983,0,3552,3560,2403,1157,2.076923077,1691,2506,1118,635,0,635,0,243,0,0.031496063,empty,mBC-0716-2
"E4,C5",15217,15602,11575,4027,7658,28,3567,3604,2469,1135,2.175330396,1727,2321,1467,899,0,899,0,310,0,0.003337041,empty,mBC-0716-2
"E4,C6",849440,926385,602553,323832,461852,1,254504,254918,221521,33397,6.632961044,138763,113307,73392,40555,21,40534,3,3647,0,0.000912814,mm10,mBC-0716-2
"E4,C7",1211744,1305790,887129,418661,632930,0,335322,335882,260013,75869,3.427130976,178586,18369,11646,6622,9,6613,1,1270,0,0.000604869,mm10,mBC-0716-2
"E4,C8",13903,14233,10395,3838,6880,0,3112,3121,2143,978,2.191206544,1520,2115,1343,773,0,773,0,271,0,0.023285899,empty,mBC-0716-2
"E4,C9",11900,12435,9025,3410,5977,0,2819,2823,1914,909,2.105610561,1348,1087,568,368,0,368,0,157,0,0.002717391,empty,mBC-0716-2
"E4,C10",12996,13533,10116,3417,6548,48,2913,2969,2085,884,2.358597285,1433,770,433,260,0,260,0,140,0,0.065384615,empty,mBC-0716-2
"E4,C11",10995,11318,8398,2920,5562,0,2605,2608,1867,741,2.519568151,1202,772,441,275,0,275,0,140,0,0.018181818,empty,mBC-0716-2
"E4,C12",961626,1119104,629069,490035,532946,2,346994,347486,277682,69804,3.978024182,206427,49985,33324,18454,11,18443,1,2257,0,0.001355528,mm10,mBC-0716-2
"E4,D1",10750,10987,8078,2909,5324,2,2503,2506,1772,734,2.414168937,1160,11987,3342,1974,2,1972,2,519,0,0.09178499,empty,mBC-0716-2
"E4,D2",20330,21073,15864,5209,10246,6,4508,4526,3110,1416,2.196327684,2071,2114,1335,841,0,841,0,318,0,0.047562426,empty,mBC-0716-2
"E4,D3",12762,13091,9611,3480,6440,0,3012,3018,2071,947,2.186906019,1437,2607,1019,648,2,646,1,246,0,0.117647059,empty,mBC-0716-2
"E4,D4",898338,998670,628835,369835,480175,4,276553,276930,233321,43609,5.350294664,153686,91709,59720,33131,19,33112,3,3262,0,0.001208021,mm10,mBC-0716-2
"E4,D5",12763,13137,9503,3634,6410,0,3042,3048,2069,979,2.113381001,1490,7471,2954,1728,2,1726,1,474,0,0.064889919,empty,mBC-0716-2
"E4,D6",11972,12346,8850,3496,5957,0,2837,2844,1956,888,2.202702703,1388,11581,4487,2731,3,2728,2,577,0,0.299120235,empty,mBC-0716-2
"E4,D7",11796,11817,8909,2908,5746,0,2671,2680,1814,866,2.094688222,1229,2143,1376,803,0,803,0,269,0,0.0124533,empty,mBC-0716-2
"E4,D8",16237,17161,12176,4985,8274,13,4023,4046,2806,1240,2.262903226,2040,1099,725,410,0,410,0,180,0,0.017073171,empty,mBC-0716-2
"E4,D9",4160,4211,3013,1198,2133,0,1010,1012,727,285,2.550877193,492,1990,868,554,1,553,1,261,0,0.066907776,empty,mBC-0716-2
"E4,D10",13476,13818,10402,3416,6740,61,3080,3147,2205,942,2.340764331,1467,1887,665,368,1,367,1,147,0,0.038147139,empty,mBC-0716-2
"E4,D11",12458,12624,9545,3079,6119,0,2708,2711,1869,842,2.219714964,1229,1379,774,504,0,504,0,213,0,0.051587302,empty,mBC-0716-2
"E4,D12",1063173,1210921,719347,491574,581146,0,363853,364351,228682,135669,1.685587717,213516,40430,26124,14686,1,14685,1,2062,0,0.002110998,mm10,mBC-0716-2
"E4,E1",21388,21189,16162,5027,10221,40,4479,4527,3192,1335,2.391011236,2038,18961,5417,3244,6,3238,3,836,0,0.042001235,empty,mBC-0716-2
"E4,E2",14987,15252,11503,3749,7412,0,3312,3315,2359,956,2.467573222,1525,2445,1052,654,0,654,0,244,0,0.032110092,empty,mBC-0716-2
"E4,E3",13285,12987,9442,3545,6003,1,2837,2843,1985,858,2.313519814,1317,44861,13763,8221,5,8216,1,1570,0,0.135467381,empty,mBC-0716-2
"E4,E4",15161,15660,11749,3911,7516,2,3439,3448,2410,1038,2.32177264,1638,1320,801,477,0,477,0,188,0,0.029350105,empty,mBC-0716-2
"E4,E5",20694,21436,16142,5294,10262,0,4519,4526,3223,1303,2.47352264,2124,2771,1742,1000,0,1000,0,337,0,0.003,empty,mBC-0716-2
"E4,E6",13615,13916,10375,3541,6807,9,3070,3081,2129,952,2.236344538,1467,2779,1823,1135,0,1135,0,380,0,0.022026432,empty,mBC-0716-2
"E4,E7",12740,12783,9632,3151,6204,0,2741,2746,1914,832,2.300480769,1313,2112,1341,782,0,782,0,268,0,0.017902813,empty,mBC-0716-2
"E4,E8",16399,16587,12644,3943,8211,0,3602,3614,2470,1144,2.159090909,1656,2370,1447,848,0,848,0,272,0,0.034198113,empty,mBC-0716-2
"E4,E9",8064,8368,6121,2247,4040,0,1923,1928,1346,582,2.312714777,957,891,528,307,0,307,0,125,0,0.009771987,empty,mBC-0716-2
"E4,E10",12825,13112,9632,3480,6282,0,2920,2924,2020,904,2.234513274,1386,1026,620,401,0,401,0,177,0,0.059850374,empty,mBC-0716-2
"E4,E11",8582,9073,6581,2492,4400,0,2074,2080,1444,636,2.270440252,1014,1000,576,313,0,313,0,155,0,0.047923323,empty,mBC-0716-2
"E4,E12",13878,14109,10383,3726,7003,10,3222,3240,2253,987,2.282674772,1579,2154,898,520,0,520,0,191,0,0.030769231,empty,mBC-0716-2
"E4,F1",17454,17632,13446,4186,8497,1,3758,3762,2709,1053,2.572649573,1759,1394,842,519,0,519,0,233,0,0.088631985,empty,mBC-0716-2
"E4,F2",20789,21640,15795,5845,10532,20,4849,4880,3396,1484,2.288409704,2347,2357,1433,884,1,883,1,354,0,0.029445074,empty,mBC-0716-2
"E4,F3",797748,894415,558610,335805,434378,18,250789,251143,211354,39789,5.311870115,141152,83984,53237,29688,7,29681,2,3182,0,0.001212897,mm10,mBC-0716-2
"E4,F4",679140,710341,485739,224602,354216,18,185448,185745,159840,25905,6.170237406,98084,29682,18798,10284,4,10280,1,1760,0,0.001264591,mm10,mBC-0716-2
"E4,F5",558590,584963,417610,167353,286267,13,139041,139298,97954,41344,2.369243421,72271,11142,6515,3726,2,3724,1,933,0,0.002148228,mm10,mBC-0716-2
"E4,F6",20884,21663,15848,5815,10405,0,4823,4845,3404,1441,2.362248439,2365,2332,1475,872,2,870,1,307,0,0.02183908,empty,mBC-0716-2
"E4,F7",19438,20433,14896,5537,9802,0,4520,4529,3133,1396,2.244269341,2181,905,556,354,0,354,0,160,0,0.011299435,empty,mBC-0716-2
"E4,F8",21063,21799,15965,5834,10416,6,4753,4767,3380,1387,2.436914203,2252,399,250,158,0,158,0,88,0,0,empty,mBC-0716-2
"E4,F9",13507,13726,10335,3391,6763,0,2990,2999,2109,890,2.369662921,1381,1150,704,430,0,430,0,177,0,0.006976744,empty,mBC-0716-2
"E4,F10",980318,1059140,712665,346475,507805,4,269521,269934,214221,55713,3.84508104,144091,65092,42529,23631,7,23624,4,2697,0,0.000846597,mm10,mBC-0716-2
"E4,F11",10612,11468,7897,3571,5562,1,2699,2707,1674,1033,1.620522749,1445,955,558,359,0,359,0,176,0,0.091922006,empty,mBC-0716-2
"E4,F12",13700,14045,10255,3790,6874,1,3175,3186,2183,1003,2.176470588,1541,172,105,67,0,67,0,34,0,0,empty,mBC-0716-2
"E4,G1",9603,9900,7578,2322,4975,4,2174,2179,1505,674,2.232937685,1029,1388,855,540,1,539,1,199,0,0.016697588,empty,mBC-0716-2
"E4,G2",20054,20139,15287,4852,9793,0,4422,4426,3036,1390,2.184172662,1993,885,465,279,0,279,0,137,0,0.032258065,empty,mBC-0716-2
"E4,G3",19257,19791,14625,5166,9739,0,4457,4462,3150,1312,2.400914634,2145,1665,937,582,0,582,0,264,0,0.032646048,empty,mBC-0716-2
"E4,G4",27422,27896,21142,6754,13393,10,5942,5968,4180,1788,2.337807606,2776,173,119,80,0,80,0,53,0,0,empty,mBC-0716-2
"E4,G5",13592,13995,10227,3768,6873,31,3102,3139,2243,896,2.503348214,1535,2299,1488,856,0,856,0,282,0,0.018691589,empty,mBC-0716-2
"E4,G6",22850,23330,17617,5713,11369,0,5040,5052,3565,1487,2.397444519,2362,235,140,98,0,98,0,60,0,0.051020408,empty,mBC-0716-2
"E4,G7",19214,19481,14816,4665,9503,7,4171,4191,2955,1236,2.390776699,1883,2344,1371,807,0,807,0,303,0,0.026022305,empty,mBC-0716-2
"E4,G8",2059720,2324232,1449247,874985,1100932,0,654513,655404,514624,140780,3.65551925,370246,158487,95975,53918,25,53893,3,4431,0,0.004972817,mm10,mBC-0716-2
"E4,G9",869745,948525,619618,328907,452870,6,246313,246700,202075,44625,4.528291317,134522,5716,2728,1633,2,1631,2,719,0,0.011649295,mm10,mBC-0716-2
"E4,G10",12837,13146,9929,3217,6438,0,2927,2932,2035,897,2.268673356,1395,1218,755,482,0,482,0,220,0,0.049792531,empty,mBC-0716-2
"E4,G11",11714,11874,8830,3044,5754,6,2635,2642,1822,820,2.22195122,1223,3592,1238,772,1,771,1,250,0,0.012970169,empty,mBC-0716-2
"E4,G12",10805,10996,8365,2631,5262,0,2330,2332,1632,700,2.331428571,1046,1006,588,346,1,345,1,132,0,0.089855072,empty,mBC-0716-2
"E4,H1",19481,19606,14901,4705,9431,2,4206,4211,3003,1208,2.485927152,1896,776,477,299,0,299,0,136,0,0.08361204,empty,mBC-0716-2
"E4,H2",25633,26518,19605,6913,12893,1,6018,6040,4359,1681,2.593099346,2909,1827,1154,711,0,711,0,305,0,0.021097046,empty,mBC-0716-2
"E4,H3",18245,19065,13842,5223,9182,0,4289,4297,2940,1357,2.166543847,2046,1248,747,455,0,455,0,198,0,0.026373626,empty,mBC-0716-2
"E4,H4",12616,13090,9468,3622,6340,3,2879,2889,2002,887,2.257046223,1437,222,140,95,0,95,0,71,0,0.021052632,empty,mBC-0716-2
"E4,H5",971329,1097641,665668,431973,523838,3,319404,319864,251697,68167,3.692358473,182840,52484,34073,19121,10,19111,1,2432,0,0.002145361,mm10,mBC-0716-2
"E4,H6",12911,13677,9795,3882,6624,0,3162,3165,2229,936,2.381410256,1580,2138,1385,840,1,839,1,275,0,0.026221692,empty,mBC-0716-2
"E4,H7",15802,15869,12012,3857,7943,0,3678,3690,2600,1090,2.385321101,1743,1855,1116,670,1,669,1,274,0,0.064275037,empty,mBC-0716-2
"E4,H8",705202,761429,499670,261759,367580,1,200623,200886,174483,26403,6.608453585,108586,98384,63129,35668,18,35650,3,3341,0,0.002356241,mm10,mBC-0716-2
"E4,H9",610632,647825,433861,213964,318525,0,170690,170951,145211,25740,5.641452991,91363,70630,43399,24178,8,24170,1,2667,0,0.00103434,mm10,mBC-0716-2
"E4,H10",1751606,1897088,1213391,683697,904639,21,526288,527044,388445,138599,2.802653699,293464,93111,61520,34246,10,34236,1,3695,0,0.001285197,mm10,mBC-0716-2
"E4,H11",758953,834056,545949,288107,403384,0,216207,216556,184199,32357,5.69270946,117992,3789,2395,1314,0,1314,0,355,0,0,mm10,mBC-0716-2
"E4,H12",5721,5817,4276,1541,2883,0,1360,1362,893,469,1.904051173,658,630,330,181,0,181,0,83,0,0.033149171,empty,mBC-0716-2
"E5,A1",13651,13728,10322,3406,6919,2,3163,3168,2220,948,2.341772152,1497,1302,766,460,0,460,0,185,0,0.045652174,empty,mBC-0716-2
"E5,A2",979122,1057681,680448,377233,509930,1,291072,291427,212630,78797,2.698452987,161144,76476,50861,28587,13,28574,2,3077,0,0.001084902,mm10,mBC-0716-2
"E5,A3",765305,827561,559979,267582,406016,2,213543,213867,161835,52032,3.110297509,113825,65700,39697,22286,10,22276,2,2659,0,0.003815766,mm10,mBC-0716-2
"E5,A4",20586,21052,15896,5156,10208,0,4466,4469,3224,1245,2.589558233,2033,741,428,266,1,265,1,154,0,0.011320755,empty,mBC-0716-2
"E5,A5",17499,18161,13274,4887,8868,3,4028,4036,2807,1229,2.283970708,1886,1749,999,613,0,613,0,251,0,0.039151713,empty,mBC-0716-2
"E5,A6",12496,13248,9446,3802,6533,0,3131,3140,2175,965,2.25388601,1583,5364,1634,1003,0,1003,0,350,0,0.069790628,empty,mBC-0716-2
"E5,A7",20645,21664,15940,5724,10671,0,4907,4914,3404,1510,2.254304636,2364,7067,2489,1487,4,1483,2,444,0,0.049898854,empty,mBC-0716-2
"E5,A8",10395,10470,7964,2506,5291,0,2387,2390,1664,726,2.292011019,1084,1929,1107,702,2,700,1,282,0,0.045714286,empty,mBC-0716-2
"E5,A9",24373,25515,18540,6975,12434,0,5997,6003,4317,1686,2.560498221,2923,1971,1106,678,0,678,0,274,0,0.044247788,empty,mBC-0716-2
"E5,A10",14980,15527,11383,4144,7681,3,3555,3565,2530,1035,2.444444444,1716,428,257,171,0,171,0,108,0,0,empty,mBC-0716-2
"E5,A11",17236,17401,13072,4329,8770,3,3950,3961,2768,1193,2.320201174,1846,1581,940,530,0,530,0,213,0,0.086792453,empty,mBC-0716-2
"E5,A12",20961,21532,16118,5414,10390,55,4602,4673,3303,1370,2.410948905,2175,23993,7504,4402,0,4402,0,1035,0,0.043389368,empty,mBC-0716-2
"E5,B1",18839,19478,14494,4984,9532,2,4424,4439,3071,1368,2.244883041,2127,1276,752,471,0,471,0,202,0,0.042462845,empty,mBC-0716-2
"E5,B2",19873,20245,14929,5316,9970,0,4517,4521,3166,1355,2.336531365,2140,648,349,196,0,196,0,104,0,0.056122449,empty,mBC-0716-2
"E5,B3",850244,951200,600716,350484,467266,2,270294,270677,197702,72975,2.709174375,152189,60249,37522,21162,15,21147,1,2608,0,0.002742706,mm10,mBC-0716-2
"E5,B4",1814592,2077827,1239355,838472,1000586,1,628091,628915,450495,178420,2.524913126,360880,145011,88462,49773,28,49745,2,4309,0,0.00231179,mm10,mBC-0716-2
"E5,B5",677254,383943,238038,145905,253224,5,141888,142845,107021,35824,2.987410674,84197,88595,55995,31271,13,31258,3,3193,0,0.001023738,mm10,mBC-0716-2
"E5,B6",12046,12603,9083,3520,6150,0,2963,2970,2083,887,2.348365276,1455,1516,898,563,0,563,0,234,0,0.058614565,empty,mBC-0716-2
"E5,B7",16392,17063,12655,4408,8275,42,3742,3789,2680,1109,2.416591524,1758,1045,613,385,0,385,0,165,0,0.038961039,empty,mBC-0716-2
"E5,B8",12913,13460,9872,3588,6799,1,3256,3264,2353,911,2.58287596,1594,1333,806,487,0,487,0,254,0,0.01026694,empty,mBC-0716-2
"E5,B9",14795,15317,11439,3878,7431,1,3352,3360,2315,1045,2.215311005,1561,828,465,294,0,294,0,143,0,0.054421769,empty,mBC-0716-2
"E5,B10",16004,16318,11752,4566,8169,27,3778,3816,2604,1212,2.148514851,1887,600,348,198,0,198,0,88,0,0.111111111,empty,mBC-0716-2
"E5,B11",18087,19307,13504,5803,9421,0,4626,4631,3345,1286,2.601088647,2321,286,184,113,0,113,0,81,0,0.026548673,empty,mBC-0716-2
"E5,B12",755354,801797,564707,237090,393247,22,192189,192586,158404,34182,4.634134925,98771,104392,68184,38017,17,38000,1,3502,0,0.001026316,mm10,mBC-0716-2
"E5,C1",22837,22711,17429,5282,10968,18,4652,4683,3253,1430,2.274825175,2103,4856,1607,981,0,981,0,324,0,0.058103976,empty,mBC-0716-2
"E5,C2",17018,17010,12853,4157,8514,0,3840,3854,2714,1140,2.380701754,1811,2438,1175,695,2,693,1,270,0,0.073593074,empty,mBC-0716-2
"E5,C3",1098484,1206593,788665,417928,578617,46,319231,319745,250289,69456,3.603561967,174853,35186,21964,12342,4,12338,2,1800,0,0.003323067,mm10,mBC-0716-2
"E5,C4",16802,17170,12866,4304,8517,0,3853,3860,2711,1149,2.359442994,1788,1146,669,403,0,403,0,167,0,0.062034739,empty,mBC-0716-2
"E5,C5",16647,17315,12589,4726,8468,9,3883,3902,2739,1163,2.355116079,1899,5502,2011,1263,1,1262,1,405,0,0.076069731,empty,mBC-0716-2
"E5,C6",15559,16106,11681,4425,8138,0,3815,3820,2666,1154,2.310225303,1837,1490,889,556,0,556,0,235,0,0.026978417,empty,mBC-0716-2
"E5,C7",16397,17585,12409,5176,8703,0,4305,4317,2976,1341,2.219239374,2178,474,278,165,1,164,1,86,0,0.006097561,empty,mBC-0716-2
"E5,C8",781177,861531,552295,309236,428119,16,246090,246475,201396,45079,4.467623505,135489,91516,52785,29627,18,29609,1,3144,0,0.004863386,mm10,mBC-0716-2
"E5,C9",12607,12856,9370,3486,6359,8,3059,3079,2157,922,2.339479393,1450,4935,1618,972,1,971,1,314,0,0.053553038,empty,mBC-0716-2
"E5,C10",13111,13225,9901,3324,6726,11,3078,3098,2144,954,2.247379455,1496,1150,645,420,0,420,0,194,0,0.047619048,empty,mBC-0716-2
"E5,C11",11558,12021,8721,3300,5908,2,2827,2835,1998,837,2.387096774,1382,1145,682,423,0,423,0,173,0,0.016548463,empty,mBC-0716-2
"E5,C12",19596,20351,14803,5548,9919,1,4560,4574,3178,1396,2.276504298,2206,1705,931,530,1,529,1,195,0,0.064272212,empty,mBC-0716-2
"E5,D1",10758,10800,8130,2670,5574,0,2581,2587,1782,805,2.213664596,1213,637,330,209,0,209,0,109,0,0.009569378,empty,mBC-0716-2
"E5,D2",20977,21178,16138,5040,10327,21,4545,4571,3150,1421,2.216748768,2068,4622,2159,1332,0,1332,0,471,0,0.042792793,empty,mBC-0716-2
"E5,D3",779796,823384,577286,246098,406464,6,208988,209311,164664,44647,3.688131341,107952,15657,8737,4959,5,4954,3,1095,0,0.006661284,mm10,mBC-0716-2
"E5,D4",14046,14558,10786,3772,7172,0,3171,3177,2237,940,2.379787234,1495,1539,921,571,0,571,0,284,0,0.008756567,empty,mBC-0716-2
"E5,D5",13558,14287,10305,3982,7034,55,3311,3371,2356,1015,2.321182266,1679,1324,794,474,0,474,0,192,0,0.075949367,empty,mBC-0716-2
"E5,D6",12222,12702,9268,3434,6256,26,2937,2970,2057,913,2.253012048,1427,1436,844,537,0,537,0,213,0,0.039106145,empty,mBC-0716-2
"E5,D7",12664,13095,9614,3481,6354,69,2812,2889,2005,884,2.268099548,1397,1349,808,491,0,491,0,201,0,0.044806517,empty,mBC-0716-2
"E5,D8",16116,16528,11882,4646,8194,0,3911,3927,2742,1185,2.313924051,1901,3436,1251,750,1,749,1,280,0,0.054739653,empty,mBC-0716-2
"E5,D9",4663,4844,3492,1352,2529,7,1211,1222,880,342,2.573099415,620,1956,1173,690,1,689,1,314,0,0.046444122,empty,mBC-0716-2
"E5,D10",13391,13710,10250,3460,6714,0,3131,3140,2188,952,2.298319328,1511,871,494,280,0,280,0,120,0,0.021428571,empty,mBC-0716-2
"E5,D11",830685,915557,579146,336411,446029,0,253059,253436,217157,36279,5.985749332,140103,208200,132788,74410,34,74376,3,4855,0,0.001411746,mm10,mBC-0716-2
"E5,D12",19521,20306,15005,5301,9827,0,4527,4532,3149,1383,2.276934201,2219,3989,2056,1221,0,1221,0,398,0,0.048321048,empty,mBC-0716-2
"E5,E1",21376,21740,16477,5263,10574,0,4581,4593,3242,1351,2.399703923,2072,1991,1167,731,0,731,0,303,0,0.054719562,empty,mBC-0716-2
"E5,E2",15453,15885,11894,3991,7931,1,3602,3619,2569,1050,2.446666667,1733,2322,1099,659,0,659,0,232,0,0.075872534,empty,mBC-0716-2
"E5,E3",11952,12367,9197,3170,6183,0,2831,2834,2009,825,2.435151515,1357,4324,1793,1133,0,1133,0,392,0,0.043248014,empty,mBC-0716-2
"E5,E4",14922,15388,11232,4156,7514,1,3551,3559,2502,1057,2.367076632,1733,1395,855,489,0,489,0,221,0,0.059304703,empty,mBC-0716-2
"E5,E5",20309,20939,15658,5281,10226,17,4597,4622,3307,1315,2.514828897,2149,1815,1202,673,0,673,0,290,0,0.026745914,empty,mBC-0716-2
"E5,E6",13340,13529,10224,3305,6613,0,2988,2991,2120,871,2.433983927,1372,1895,1141,627,0,627,0,266,0,0.027113238,empty,mBC-0716-2
"E5,E7",13444,13894,10324,3570,6781,5,3082,3090,2197,893,2.460246361,1488,1400,859,533,1,532,1,228,0,0.056390977,empty,mBC-0716-2
"E5,E8",17240,17511,13221,4290,8578,0,3769,3776,2619,1157,2.263612792,1684,6404,2321,1418,5,1413,3,455,0,0.053078556,empty,mBC-0716-2
"E5,E9",8835,9002,6775,2227,4461,0,1998,2003,1388,615,2.256910569,957,1251,743,436,0,436,0,164,0,0.061926606,empty,mBC-0716-2
"E5,E10",12979,13333,9834,3499,6588,21,3042,3068,2132,936,2.277777778,1480,1418,748,478,0,478,0,202,0,0.081589958,empty,mBC-0716-2
"E5,E11",8835,9148,6671,2477,4507,0,2130,2133,1476,657,2.246575342,1005,2529,1144,687,1,686,1,248,0,0.037900875,empty,mBC-0716-2
"E5,E12",14423,14993,10775,4218,7466,27,3545,3579,2472,1107,2.233062331,1787,1209,702,411,0,411,0,170,0,0.04136253,empty,mBC-0716-2
"E5,F1",17700,18389,13393,4996,8879,0,4046,4048,2860,1188,2.407407407,1981,1725,999,599,0,599,0,271,0,0.020033389,empty,mBC-0716-2
"E5,F2",23072,23735,17602,6133,11861,4,5441,5462,3885,1577,2.463538364,2606,3228,2021,1228,0,1228,0,456,0,0.035016287,empty,mBC-0716-2
"E5,F3",15232,15909,11533,4376,7988,1,3742,3755,2635,1120,2.352678571,1831,1999,1218,726,0,726,0,303,0,0.027548209,empty,mBC-0716-2
"E5,F4",15264,15267,11352,3915,7595,1,3391,3400,2332,1068,2.183520599,1650,664,368,228,0,228,0,107,0,0.01754386,empty,mBC-0716-2
"E5,F5",791284,807486,595078,212408,394078,39,185963,186317,149302,37015,4.033553965,91264,17378,10926,6100,2,6098,1,1292,0,0.007871433,mm10,mBC-0716-2
"E5,F6",30252,32006,22957,9049,15634,6,7468,7481,5596,1885,2.968700265,3755,5452,2639,1521,2,1519,1,439,0,0.083607637,empty,mBC-0716-2
"E5,F7",828574,908091,595693,312398,447634,1,242431,242776,202895,39881,5.087510343,131901,59245,37775,21195,11,21184,1,2493,0,0.001227341,mm10,mBC-0716-2
"E5,F8",23115,23904,17553,6351,11813,0,5494,5514,3878,1636,2.370415648,2671,378,222,159,0,159,0,110,0,0.006289308,empty,mBC-0716-2
"E5,F9",14261,14415,10601,3814,7230,0,3373,3376,2399,977,2.455475947,1683,20392,5965,3514,8,3506,2,868,0,0.060182544,empty,mBC-0716-2
"E5,F10",22268,22979,17241,5738,11115,16,4972,4994,3528,1466,2.406548431,2312,1331,765,496,0,496,0,214,0,0.060483871,empty,mBC-0716-2
"E5,F11",10887,11260,8218,3042,5619,18,2550,2574,1770,804,2.201492537,1253,1159,663,405,0,405,0,186,0,0.041975309,empty,mBC-0716-2
"E5,F12",2015240,2174023,1471222,702801,1029445,15,554653,555556,446139,109417,4.077419414,297389,15462,9827,5514,5,5509,1,1039,0,0.001815211,mm10,mBC-0716-2
"E5,G1",296333,301025,222173,78852,152242,1,71180,71358,53384,17974,2.970067876,34770,36141,12257,7273,5,7268,3,1640,0,0.045266924,mm10,mBC-0716-2
"E5,G2",703001,717474,521799,195675,355809,2,175177,175485,139091,36394,3.821811288,87033,4662,3012,1695,4,1691,2,544,0,0.00295683,mm10,mBC-0716-2
"E5,G3",851462,921234,628096,293138,448843,6,237094,237470,176049,61421,2.866267238,125301,49130,31549,17589,9,17580,1,2338,0,0.000853242,mm10,mBC-0716-2
"E5,G4",27293,28070,21037,7033,13717,23,5976,6013,4264,1749,2.437964551,2838,200,132,96,0,96,0,68,0,0.020833333,empty,mBC-0716-2
"E5,G5",958383,1091910,634364,457546,528024,1,335410,335836,265720,70116,3.789719893,195350,101661,63897,36037,26,36011,4,3412,0,0.001277387,mm10,mBC-0716-2
"E5,G6",23401,24163,17901,6262,11790,0,5315,5323,3776,1547,2.440853264,2528,298,185,130,0,130,0,86,0,0.007692308,empty,mBC-0716-2
"E5,G7",19343,19777,14908,4869,9814,0,4400,4413,3129,1284,2.436915888,2093,4296,1809,1095,0,1095,0,384,0,0.038356164,empty,mBC-0716-2
"E5,G8",787200,911917,542363,369554,444603,3,268511,268878,193221,75657,2.553907768,157358,98633,64905,36379,24,36355,1,3489,0,0.001127768,mm10,mBC-0716-2
"E5,G9",10051,10359,7677,2682,5158,7,2382,2395,1734,661,2.623298033,1122,1362,824,496,0,496,0,246,0,0.022177419,empty,mBC-0716-2
"E5,G10",675543,712161,509079,203082,351177,1,168316,168632,138115,30517,4.525838057,84814,116012,77191,43112,17,43095,3,3737,0,0.000904977,mm10,mBC-0716-2
"E5,G11",11987,12260,9112,3148,6150,0,2782,2786,1906,880,2.165909091,1344,2219,790,467,2,465,1,186,0,0.055913978,empty,mBC-0716-2
"E5,G12",11733,12296,8766,3530,6066,0,2890,2897,2081,816,2.550245098,1451,5655,2595,1617,0,1617,0,418,0,0.314780458,empty,mBC-0716-2
"E5,H1",20640,21506,15737,5769,10496,3,4792,4812,3431,1381,2.484431571,2297,1087,660,409,0,409,0,175,0,0.039119804,empty,mBC-0716-2
"E5,H2",24802,25361,18679,6682,12349,21,5628,5654,4011,1643,2.441265977,2746,2266,1373,840,0,840,0,353,0,0.007142857,empty,mBC-0716-2
"E5,H3",1134480,1295770,756507,539263,626673,0,399323,399841,288661,111180,2.59633927,233881,51557,31437,17817,6,17811,1,2329,0,0.002751109,mm10,mBC-0716-2
"E5,H4",710180,796132,478190,317942,393399,0,245409,245735,184925,60810,3.041029436,141523,1301,799,472,0,472,0,178,0,0.002118644,empty,mBC-0716-2
"E5,H5",17542,18173,13233,4940,8819,6,4095,4106,2840,1266,2.24328594,2063,1495,873,526,1,525,1,236,0,0.017142857,empty,mBC-0716-2
"E5,H6",13901,14461,10553,3908,7017,0,3204,3214,2265,949,2.386722866,1508,1637,959,589,0,589,0,268,0,0.076400679,empty,mBC-0716-2
"E5,H7",16822,16941,12520,4421,8435,0,3889,3897,2733,1164,2.347938144,1902,7918,2671,1638,1,1637,1,550,0,0.051313378,empty,mBC-0716-2
"E5,H8",13009,13302,9827,3475,6555,0,3042,3042,2148,894,2.402684564,1433,7284,2420,1489,0,1489,0,482,0,0.021490934,empty,mBC-0716-2
"E5,H9",16376,16554,12500,4054,8221,0,3735,3750,2649,1101,2.40599455,1793,1587,1022,647,0,647,0,304,0,0.037094281,empty,mBC-0716-2
"E5,H10",14171,14650,10607,4043,7190,3,3342,3350,2361,989,2.387259858,1615,5588,2098,1293,1,1292,1,482,0,0.061919505,empty,mBC-0716-2
"E5,H11",17768,17825,12701,5124,8611,0,4168,4175,2838,1337,2.122662678,2075,1880,688,436,1,435,1,168,0,0.025287356,empty,mBC-0716-2
"E5,H12",5876,6175,4372,1803,3131,3,1442,1446,1023,423,2.418439716,752,945,576,337,0,337,0,119,0,0.103857567,empty,mBC-0716-2
"E6,A1",14303,14897,11035,3862,7261,0,3327,3337,2316,1021,2.268364349,1620,1167,666,414,0,414,0,197,0,0.065217391,empty,mBC-0716-2
"E6,A2",19661,20123,14961,5162,9405,21,4181,4213,2954,1259,2.346306593,1931,3379,1322,812,0,812,0,295,0,0.078817734,empty,mBC-0716-2
"E6,A3",809058,945248,530594,414654,454200,21,297056,297461,215739,81722,2.639913365,177481,49616,31709,17893,12,17881,2,2278,0,0.000167776,mm10,mBC-0716-2
"E6,A4",1136759,1259566,774648,484918,596684,4,370040,370579,292518,78061,3.747300188,207740,8576,5215,2882,2,2880,1,694,0,0.007638889,mm10,mBC-0716-2
"E6,A5",17602,18375,13413,4962,8783,1,4007,4016,2810,1206,2.330016584,1904,1340,806,513,1,512,1,247,0,0.013671875,empty,mBC-0716-2
"E6,A6",13114,13757,10094,3663,6540,5,3026,3031,2127,904,2.352876106,1417,1568,903,559,0,559,0,254,0,0.035778175,empty,mBC-0716-2
"E6,A7",16586,17469,12605,4864,8245,0,3869,3875,2731,1144,2.387237762,1911,1294,784,477,0,477,0,185,0,0.020964361,empty,mBC-0716-2
"E6,A8",10709,11111,8126,2985,5385,1,2518,2522,1759,763,2.305373526,1195,1587,913,559,0,559,0,249,0,0.057245081,empty,mBC-0716-2
"E6,A9",20452,21061,15683,5378,9816,21,4303,4339,2939,1400,2.099285714,2027,1324,840,525,0,525,0,235,0,0.045714286,empty,mBC-0716-2
"E6,A10",16272,16877,12351,4526,8018,0,3704,3716,2577,1139,2.262510975,1825,383,236,148,0,148,0,91,0,0.006756757,empty,mBC-0716-2
"E6,A11",18735,18921,14127,4794,9022,13,4089,4107,2849,1258,2.264705882,1920,1446,885,550,0,550,0,222,0,0.076363636,empty,mBC-0716-2
"E6,A12",21181,21508,16466,5042,10187,8,4457,4475,3069,1406,2.182788051,2053,2530,1376,800,0,800,0,261,0,0.05875,empty,mBC-0716-2
"E6,B1",19718,20133,15106,5027,9544,0,4262,4276,3018,1258,2.399046105,1996,2201,980,635,0,635,0,259,0,0.044094488,empty,mBC-0716-2
"E6,B2",20826,21393,15904,5489,10183,16,4565,4600,3151,1449,2.174603175,2210,682,384,236,0,236,0,107,0,0.016949153,empty,mBC-0716-2
"E6,B3",18618,19359,13975,5384,9231,17,4188,4213,2880,1333,2.160540135,2030,1074,632,389,0,389,0,184,0,0.097686375,empty,mBC-0716-2
"E6,B4",367156,364095,291517,72578,178995,0,66963,67123,46270,20853,2.218865391,30636,5247,3131,1788,1,1787,1,534,0,0.011191942,mm10,mBC-0716-2
"E6,B5",10179,6363,4526,1837,3872,0,1895,1915,1385,530,2.613207547,1018,1038,569,336,0,336,0,154,0,0.020833333,empty,mBC-0716-2
"E6,B6",666511,750963,466190,284773,362467,0,210794,211062,158600,52462,3.023140559,120450,32290,21432,12073,3,12070,1,1777,0,0.0004971,mm10,mBC-0716-2
"E6,B7",21963,23094,16998,6096,10844,0,4999,5004,3516,1488,2.362903226,2375,1442,748,460,0,460,0,187,0,0.065217391,empty,mBC-0716-2
"E6,B8",13500,13847,10310,3537,6577,0,3016,3024,2125,899,2.363737486,1469,1329,849,485,0,485,0,228,0,0.020618557,empty,mBC-0716-2
"E6,B9",15061,15550,11719,3831,7416,0,3340,3346,2343,1003,2.335992024,1567,737,424,258,0,258,0,130,0,0.108527132,empty,mBC-0716-2
"E6,B10",17026,17120,12689,4431,8587,0,3925,3935,2766,1169,2.366124893,1941,615,329,199,0,199,0,92,0,0.015075377,empty,mBC-0716-2
"E6,B11",15919,16327,12215,4112,7688,4,3431,3440,2411,1029,2.343051506,1612,513,262,170,0,170,0,98,0,0.011764706,empty,mBC-0716-2
"E6,B12",1183215,1276852,869466,407386,615354,46,320242,320844,263835,57009,4.627953481,169492,95173,60143,33404,17,33387,2,3438,0,0.002336239,mm10,mBC-0716-2
"E6,C1",1214319,1272119,926417,345702,584662,7,269822,270400,229930,40470,5.681492464,133675,72382,47861,26419,14,26405,2,2836,0,0.001098277,mm10,mBC-0716-2
"E6,C2",19282,19882,14410,5472,9558,0,4379,4390,3089,1301,2.37432744,2216,1628,971,572,1,571,1,227,0,0.061295972,empty,mBC-0716-2
"E6,C3",22319,23145,16720,6425,11031,0,5243,5250,3770,1480,2.547297297,2590,687,404,238,0,238,0,117,0,0.046218487,empty,mBC-0716-2
"E6,C4",19167,19102,14178,4924,8878,0,3996,4001,2831,1170,2.41965812,1910,13296,4453,2711,0,2711,0,687,0,0.156399852,empty,mBC-0716-2
"E6,C5",16589,17220,12638,4582,8241,0,3884,3892,2776,1116,2.487455197,1883,2966,1288,694,1,693,1,272,0,0.024531025,empty,mBC-0716-2
"E6,C6",16732,17647,12612,5035,8717,0,4032,4035,2849,1186,2.402192243,2033,1588,958,541,0,541,0,217,0,0.020332717,empty,mBC-0716-2
"E6,C7",16572,16992,12427,4565,8073,19,3791,3815,2629,1186,2.216694772,1812,1790,625,391,0,391,0,155,0,0.038363171,empty,mBC-0716-2
"E6,C8",15275,15758,11556,4202,7574,0,3457,3469,2344,1125,2.083555556,1693,1518,913,559,1,558,1,225,0,0.064516129,empty,mBC-0716-2
"E6,C9",12922,13514,9910,3604,6449,0,2942,2948,2088,860,2.427906977,1414,886,558,329,0,329,0,145,0,0.003039514,empty,mBC-0716-2
"E6,C10",798010,855798,583384,272414,408843,1,215132,215455,165877,49578,3.345778369,112823,41450,26627,15031,7,15024,1,1968,0,0.001664004,mm10,mBC-0716-2
"E6,C11",11864,12510,8915,3595,5854,9,2760,2774,1929,845,2.282840237,1373,751,424,275,0,275,0,135,0,0.032727273,empty,mBC-0716-2
"E6,C12",954103,1019665,691638,328027,479567,16,257704,258118,189129,68989,2.741437041,136123,37676,22953,12860,7,12853,2,1952,0,0.006768848,mm10,mBC-0716-2
"E6,D1",11992,12325,8980,3345,5903,1,2737,2742,1920,822,2.335766423,1316,618,353,193,0,193,0,108,0,0.005181347,empty,mBC-0716-2
"E6,D2",21029,21457,16213,5244,10386,1,4567,4578,3244,1334,2.431784108,2187,3148,1674,1016,0,1016,0,375,0,0.057086614,empty,mBC-0716-2
"E6,D3",14320,14693,10765,3928,7095,12,3432,3448,2419,1029,2.350826045,1698,1878,918,563,0,563,0,230,0,0.078152753,empty,mBC-0716-2
"E6,D4",15766,16012,11758,4254,7502,19,3495,3525,2474,1051,2.35394862,1687,8745,3486,2162,0,2162,0,613,0,0.090656799,empty,mBC-0716-2
"E6,D5",17681,19227,13227,6000,9208,13,4607,4633,3048,1585,1.923028391,2427,1246,768,467,2,465,1,184,0,0.025806452,empty,mBC-0716-2
"E6,D6",12789,13489,9549,3940,6382,34,2952,2992,2125,867,2.450980392,1516,1300,846,535,0,535,0,236,0,0.044859813,empty,mBC-0716-2
"E6,D7",25303,28155,18403,9752,13187,0,7244,7262,5204,2058,2.52866861,3908,1856,1152,659,0,659,0,228,0,0.04400607,empty,mBC-0716-2
"E6,D8",15817,16607,12004,4603,7880,3,3649,3658,2589,1069,2.421889616,1776,874,522,324,0,324,0,165,0,0.095679012,empty,mBC-0716-2
"E6,D9",5523,5724,4076,1648,2796,4,1375,1381,984,397,2.478589421,695,1706,1070,649,0,649,0,266,0,0.057010786,empty,mBC-0716-2
"E6,D10",13837,14474,10436,4038,6846,0,3235,3243,2217,1026,2.160818713,1652,741,409,248,0,248,0,124,0,0.076612903,empty,mBC-0716-2
"E6,D11",13524,13624,10248,3376,6529,0,2965,2969,2088,881,2.370034052,1361,5784,2113,1204,0,1204,0,457,0,0.024916944,empty,mBC-0716-2
"E6,D12",24434,25591,18833,6758,12074,0,5684,5706,4116,1590,2.588679245,2717,4250,2130,1268,1,1267,1,382,0,0.09629045,empty,mBC-0716-2
"E6,E1",22210,22732,16918,5814,10805,16,4863,4901,3504,1397,2.508231926,2320,1784,1049,655,0,655,0,263,0,0.036641221,empty,mBC-0716-2
"E6,E2",721228,751848,543504,208344,360874,4,170493,170864,141745,29119,4.867783921,85628,70965,43750,24639,9,24630,1,2892,0,0.003369874,mm10,mBC-0716-2
"E6,E3",727932,818717,513627,305090,392885,1,230197,230541,169473,61068,2.775152289,129079,109964,72211,40280,18,40262,4,3474,0,0.001813124,mm10,mBC-0716-2
"E6,E4",1933933,2166970,1351525,815445,1008496,1,604016,604793,440511,164282,2.681431928,340952,118994,74259,41350,20,41330,4,3819,0,0.001040406,mm10,mBC-0716-2
"E6,E5",21184,21502,16156,5346,10233,0,4531,4539,3180,1359,2.33995585,2157,7906,2754,1629,2,1627,2,493,0,0.108789183,empty,mBC-0716-2
"E6,E6",774838,821237,570181,251056,388502,2,198260,198616,153902,44714,3.441919757,103028,60169,37458,21189,7,21182,1,2476,0,0.001133037,mm10,mBC-0716-2
"E6,E7",14024,14613,10737,3876,6943,5,3179,3187,2163,1024,2.112304688,1539,1343,814,458,0,458,0,196,0,0.043668122,empty,mBC-0716-2
"E6,E8",1044645,1131990,740396,391594,535683,2,299623,300146,232809,67337,3.457371133,163359,96570,61031,34097,16,34081,2,3251,0,0.002875502,mm10,mBC-0716-2
"E6,E9",9212,9262,6980,2282,4415,1,2001,2004,1415,589,2.40237691,900,998,561,350,0,350,0,157,0,0.011428571,empty,mBC-0716-2
"E6,E10",648401,715777,476177,239600,344862,0,182494,182811,151438,31373,4.827016862,98681,95075,56410,32031,10,32021,4,3248,0,0.010930327,mm10,mBC-0716-2
"E6,E11",9594,10017,7277,2740,4981,6,2269,2277,1563,714,2.18907563,1160,1195,766,447,0,447,0,187,0,0.035794183,empty,mBC-0716-2
"E6,E12",395064,405618,306950,98668,200400,0,84751,84896,58118,26778,2.170363731,41572,33081,15042,8314,2,8312,1,1713,0,0.018166506,mm10,mBC-0716-2
"E6,F1",671825,716988,504229,212759,345411,0,171163,171444,144104,27340,5.270811997,88214,87379,52845,29415,15,29400,4,3175,0,0.003945578,mm10,mBC-0716-2
"E6,F2",852412,956372,595194,361178,458719,1,267623,268012,219786,48226,4.557417161,151017,130047,80979,44976,27,44949,6,3944,0,0.005606354,mm10,mBC-0716-2
"E6,F3",22800,23891,17293,6598,11448,0,5349,5363,3874,1489,2.601746138,2653,4179,2149,1242,0,1242,0,418,0,0.020933977,empty,mBC-0716-2
"E6,F4",16859,16790,12860,3930,8240,12,3670,3691,2546,1145,2.223580786,1656,5587,1743,1059,1,1058,1,335,0,0.043478261,empty,mBC-0716-2
"E6,F5",24296,25164,18594,6570,12159,0,5649,5662,4018,1644,2.444038929,2719,3531,1559,958,1,957,1,408,0,0.029258098,empty,mBC-0716-2
"E6,F6",23515,24076,17676,6400,11332,0,5188,5202,3628,1574,2.304955527,2480,2504,1432,809,1,808,1,299,0,0.054455446,empty,mBC-0716-2
"E6,F7",20667,21396,15754,5642,10392,0,4666,4676,3228,1448,2.229281768,2271,735,423,260,0,260,0,127,0,0.023076923,empty,mBC-0716-2
"E6,F8",22600,23747,17097,6650,11304,0,5190,5201,3625,1576,2.300126904,2526,327,194,135,0,135,0,97,0,0,empty,mBC-0716-2
"E6,F9",1057036,1163820,743265,420555,552736,5,320234,320684,236895,83789,2.827280431,176423,77491,50658,27892,8,27884,2,3071,0,0.001900732,mm10,mBC-0716-2
"E6,F10",20536,20869,15596,5273,10050,24,4378,4411,3039,1372,2.215014577,2133,2673,1138,713,0,713,0,261,0,0.018232819,empty,mBC-0716-2
"E6,F11",11193,11473,8623,2850,5576,2,2528,2533,1796,737,2.436906377,1185,952,600,370,0,370,0,183,0,0.018918919,empty,mBC-0716-2
"E6,F12",14132,14461,10750,3711,6841,0,3125,3130,2181,949,2.298208641,1492,137,80,47,0,47,0,40,0,0,empty,mBC-0716-2
"E6,G1",10336,10791,7926,2865,5185,0,2346,2355,1616,739,2.186738836,1102,1886,1153,658,0,658,0,231,0,0.053191489,empty,mBC-0716-2
"E6,G2",21593,21609,16479,5130,10314,5,4617,4631,3192,1439,2.218207088,2109,803,531,293,0,293,0,156,0,0.013651877,empty,mBC-0716-2
"E6,G3",689226,704781,510814,193967,339500,16,163612,163918,126674,37244,3.401192138,82498,8752,5602,3186,1,3185,1,920,0,0.010361068,mm10,mBC-0716-2
"E6,G4",28325,28559,21858,6701,13621,9,5995,6016,4298,1718,2.501746217,2739,217,133,87,0,87,0,62,0,0.011494253,empty,mBC-0716-2
"E6,G5",13899,14324,10629,3695,6851,0,3064,3066,2094,972,2.154320988,1460,1398,770,488,0,488,0,226,0,0.05942623,empty,mBC-0716-2
"E6,G6",24365,24847,18632,6215,12007,8,5268,5298,3705,1593,2.325800377,2481,245,156,101,0,101,0,67,0,0.03960396,empty,mBC-0716-2
"E6,G7",20468,20810,15577,5233,9961,54,4420,4491,3122,1369,2.280496713,2147,4498,1731,1005,2,1003,1,351,0,0.021934197,empty,mBC-0716-2
"E6,G8",14926,15385,11297,4088,7371,0,3520,3532,2410,1122,2.147950089,1746,1536,978,556,1,555,1,239,0,0.088288288,empty,mBC-0716-2
"E6,G9",10604,10832,8085,2747,5250,1,2350,2356,1649,707,2.332390382,1121,1388,886,524,0,524,0,238,0,0.053435115,empty,mBC-0716-2
"E6,G10",13821,14556,10579,3977,6930,3,3277,3289,2290,999,2.292292292,1603,9878,3093,1904,2,1902,1,536,0,0.038906414,empty,mBC-0716-2
"E6,G11",12382,12484,9377,3107,6063,0,2718,2724,1869,855,2.185964912,1277,785,458,278,0,278,0,117,0,0.028776978,empty,mBC-0716-2
"E6,G12",11329,11739,8650,3089,5686,1,2585,2590,1820,770,2.363636364,1239,1091,682,409,0,409,0,163,0,0.063569682,empty,mBC-0716-2
"E6,H1",21475,21678,16294,5384,10403,0,4735,4741,3392,1349,2.514455152,2183,2293,945,613,0,613,0,218,0,0.04730832,empty,mBC-0716-2
"E6,H2",1247869,1363609,881654,481955,639410,1,362699,363219,299648,63571,4.713595822,198717,88964,54884,30574,12,30562,4,3246,0,0.002224985,mm10,mBC-0716-2
"E6,H3",20797,21280,15909,5371,10258,3,4733,4749,3334,1415,2.356183746,2240,1583,920,574,0,574,0,247,0,0.054006969,empty,mBC-0716-2
"E6,H4",14953,15424,11304,4120,7221,9,3353,3371,2365,1006,2.350894632,1645,237,160,117,0,117,0,72,0,0,empty,mBC-0716-2
"E6,H5",18100,18451,13782,4669,8783,9,3969,3984,2790,1194,2.336683417,1890,1333,795,500,0,500,0,216,0,0.054,empty,mBC-0716-2
"E6,H6",505902,578841,346296,232545,277421,1,173349,173589,134559,39030,3.447578786,98496,59628,39167,22172,7,22165,1,2512,0,0.002165576,mm10,mBC-0716-2
"E6,H7",1070535,1206053,712523,493530,579713,2,371955,372424,276572,95852,2.885406669,215659,23295,14360,8071,5,8066,2,1582,0,0.007810563,mm10,mBC-0716-2
"E6,H8",14077,14691,10492,4199,6902,0,3234,3240,2242,998,2.246492986,1623,1649,938,608,0,608,0,265,0,0.041118421,empty,mBC-0716-2
"E6,H9",17026,17881,12789,5092,8475,25,3817,3848,2703,1145,2.36069869,1928,1344,827,537,0,537,0,239,0,0.074487896,empty,mBC-0716-2
"E6,H10",14867,15430,11164,4266,7344,0,3393,3411,2391,1020,2.344117647,1685,1264,743,528,0,528,0,261,0,0.034090909,empty,mBC-0716-2
"E6,H11",17921,18559,13237,5322,8693,0,4041,4063,2833,1230,2.303252033,1985,1748,597,385,1,384,1,143,0,0.135416667,empty,mBC-0716-2
"E6,H12",6091,6298,4620,1678,3010,0,1391,1394,986,408,2.416666667,655,559,290,192,0,192,0,93,0,0.015625,empty,mBC-0716-2
"E7,A1",401838,406595,299124,107471,206763,0,96683,96823,75601,21222,3.562388088,47950,8655,4950,2827,1,2826,1,825,0,0.014861996,mm10,mBC-0716-2
"E7,A2",1334378,1357494,994511,362983,650454,2,312976,313490,249226,64264,3.878158845,154820,78885,52410,29868,12,29856,2,3204,0,0.001373258,mm10,mBC-0716-2
"E7,A3",16451,16789,12561,4228,8275,0,3772,3779,2633,1146,2.297556719,1773,1176,675,432,0,432,0,188,0,0.053240741,empty,mBC-0716-2
"E7,A4",21445,22097,16680,5417,10686,19,4690,4719,3347,1372,2.439504373,2138,752,461,256,0,256,0,117,0,0.046875,empty,mBC-0716-2
"E7,A5",17266,17765,13277,4488,8831,8,3999,4010,2895,1115,2.596412556,1905,1450,885,549,0,549,0,233,0,0.069216758,empty,mBC-0716-2
"E7,A6",22826,25004,16554,8450,12436,5,6718,6729,5288,1441,3.669673838,3613,1409,787,513,0,513,0,231,0,0.038986355,empty,mBC-0716-2
"E7,A7",15906,16578,12259,4319,8118,8,3743,3755,2664,1091,2.441796517,1801,1385,757,475,1,474,1,184,0,0.042194093,empty,mBC-0716-2
"E7,A8",10757,11054,8137,2917,5367,0,2524,2529,1809,720,2.5125,1156,2963,1348,848,0,848,0,309,0,0.158018868,empty,mBC-0716-2
"E7,A9",18415,19001,14021,4980,9110,3,4115,4126,2928,1198,2.444073456,1950,1734,925,542,0,542,0,213,0,0.073800738,empty,mBC-0716-2
"E7,A10",15523,16150,11803,4347,7786,3,3522,3525,2406,1119,2.150134048,1652,481,295,196,0,196,0,83,0,0.051020408,empty,mBC-0716-2
"E7,A11",18457,18776,14259,4517,9141,2,4023,4034,2841,1193,2.38139145,1828,1264,665,401,0,401,0,167,0,0.027431421,empty,mBC-0716-2
"E7,A12",21094,21979,16275,5704,10492,0,4641,4660,3251,1409,2.307310149,2215,2554,1573,913,0,913,0,293,0,0.099671413,empty,mBC-0716-2
"E7,B1",19266,19984,14719,5265,9655,1,4450,4457,3187,1270,2.509448819,2131,1419,757,449,0,449,0,196,0,0.037861915,empty,mBC-0716-2
"E7,B2",19529,19794,14820,4974,9616,0,4187,4193,2896,1297,2.232845027,1952,3523,953,570,1,569,1,212,0,0.031634446,empty,mBC-0716-2
"E7,B3",17912,18487,13569,4918,9011,13,4051,4076,2865,1211,2.365813377,1981,1054,635,389,0,389,0,164,0,0.061696658,empty,mBC-0716-2
"E7,B4",16090,16479,12421,4058,8086,0,3690,3700,2618,1082,2.419593346,1728,1213,704,417,0,417,0,161,0,0.06235012,empty,mBC-0716-2
"E7,B5",16796,14107,8518,5589,7919,4,4617,4649,3172,1477,2.147596479,2687,805,429,258,0,258,0,122,0,0,empty,mBC-0716-2
"E7,B6",12570,13217,9540,3677,6472,0,3039,3046,2085,961,2.169614984,1510,1178,699,433,0,433,0,186,0,0.030023095,empty,mBC-0716-2
"E7,B7",16183,16684,12371,4313,8032,0,3602,3613,2557,1056,2.421401515,1710,1046,634,376,0,376,0,149,0,0.013297872,empty,mBC-0716-2
"E7,B8",12946,13171,9841,3330,6440,0,2922,2927,2067,860,2.403488372,1375,1253,803,512,0,512,0,217,0,0.0546875,empty,mBC-0716-2
"E7,B9",14911,15117,11351,3766,7224,0,3256,3266,2315,951,2.434279706,1507,778,484,282,0,282,0,133,0,0.042553191,empty,mBC-0716-2
"E7,B10",16015,16214,11984,4230,8265,0,3809,3822,2624,1198,2.190317195,1840,703,407,236,1,235,1,95,0,0.119148936,empty,mBC-0716-2
"E7,B11",17200,17996,13046,4950,8638,15,3963,3978,2793,1185,2.356962025,1951,239,165,109,0,109,0,72,0,0,empty,mBC-0716-2
"E7,B12",17788,18327,13575,4752,9009,0,4083,4096,2910,1186,2.453625632,1932,1459,898,530,0,530,0,182,0,0.083018868,empty,mBC-0716-2
"E7,C1",24835,25256,19247,6009,12224,0,5218,5231,3691,1540,2.396753247,2402,1079,575,357,0,357,0,136,0,0.047619048,empty,mBC-0716-2
"E7,C2",18700,19087,14122,4965,9338,0,4331,4340,3060,1280,2.390625,2028,1602,901,541,0,541,0,191,0,0.066543438,empty,mBC-0716-2
"E7,C3",20323,21375,15345,6030,10101,103,4575,4697,3366,1331,2.52892562,2280,687,435,229,0,229,0,90,0,0.013100437,empty,mBC-0716-2
"E7,C4",23931,25000,18071,6929,11902,7,5451,5473,3930,1543,2.54698639,2678,22224,5994,3623,4,3619,1,923,0,0.043934789,empty,mBC-0716-2
"E7,C5",16050,16804,12106,4698,8211,1,3866,3874,2662,1212,2.196369637,1944,1189,647,386,0,386,0,175,0,0.005181347,empty,mBC-0716-2
"E7,C6",16554,17439,12496,4943,8706,2,4173,4185,2951,1234,2.391410049,2091,1347,819,479,0,479,0,191,0,0.03131524,empty,mBC-0716-2
"E7,C7",16239,17035,12325,4710,8295,4,3939,3948,2759,1189,2.320437342,1929,333,189,129,0,129,0,75,0,0.062015504,empty,mBC-0716-2
"E7,C8",14971,15748,11346,4402,7658,0,3475,3480,2324,1156,2.010380623,1735,1563,934,515,0,515,0,207,0,0.038834951,empty,mBC-0716-2
"E7,C9",983567,1144932,646509,498423,557002,0,368656,369101,251246,117855,2.131823003,220233,14831,9354,5270,1,5269,1,1141,0,0.001897893,mm10,mBC-0716-2
"E7,C10",13560,14177,10341,3836,6926,0,3190,3208,2163,1045,2.069856459,1566,1204,627,384,0,384,0,160,0,0.052083333,empty,mBC-0716-2
"E7,C11",578378,623592,417314,206278,309565,10,169583,169866,125078,44788,2.792667679,91319,27822,14280,8270,2,8268,1,1584,0,0.020077407,mm10,mBC-0716-2
"E7,C12",19865,20376,14976,5400,9875,13,4498,4528,3167,1361,2.326965467,2233,1506,724,427,1,426,1,154,0,0.056338028,empty,mBC-0716-2
"E7,D1",590647,606591,424886,181705,303959,2,156763,157008,126781,30227,4.19429649,80553,3276,2039,1098,0,1098,0,368,0,0.017304189,mm10,mBC-0716-2
"E7,D2",20594,21026,15958,5068,10365,0,4656,4669,3175,1494,2.125167336,2164,2538,1518,892,1,891,1,314,0,0.034792368,empty,mBC-0716-2
"E7,D3",14878,15539,11315,4224,7825,0,3686,3695,2591,1104,2.34692029,1832,1240,756,481,0,481,0,178,0,0.085239085,empty,mBC-0716-2
"E7,D4",14235,14771,10622,4149,7227,0,3394,3414,2348,1066,2.202626642,1734,1798,953,546,0,546,0,248,0,0.038461538,empty,mBC-0716-2
"E7,D5",13989,14729,10766,3963,7028,16,3272,3293,2349,944,2.488347458,1568,1116,628,355,2,353,2,169,0,0.028328612,empty,mBC-0716-2
"E7,D6",12826,13138,9523,3615,6417,0,2992,2997,2077,920,2.257608696,1475,10203,3234,2011,2,2009,2,586,0,0.154803385,empty,mBC-0716-2
"E7,D7",540202,581241,398196,183045,287674,1,148901,149178,112715,36463,3.091215753,78987,38553,23716,13426,8,13418,2,2012,0,0.000894321,mm10,mBC-0716-2
"E7,D8",15867,16732,12047,4685,8171,0,3982,3988,2758,1230,2.242276423,1939,3289,1130,662,0,662,0,235,0,0.019637462,empty,mBC-0716-2
"E7,D9",385202,440103,248434,191669,219519,3,142173,142345,101793,40552,2.510184455,85126,56596,35670,19846,7,19839,2,2487,0,0.000907304,mm10,mBC-0716-2
"E7,D10",13054,13700,9865,3835,6658,5,3102,3111,2219,892,2.487668161,1569,940,516,329,0,329,0,116,0,0.05775076,empty,mBC-0716-2
"E7,D11",13444,13722,10190,3532,6769,16,3101,3135,2182,953,2.289611752,1536,1619,1013,639,0,639,0,227,0,0.028169014,empty,mBC-0716-2
"E7,D12",19948,20643,15293,5350,9869,0,4461,4478,3094,1384,2.235549133,2114,2403,1438,870,0,870,0,280,0,0.06091954,empty,mBC-0716-2
"E7,E1",21748,22022,16598,5424,10694,0,4704,4722,3312,1410,2.34893617,2230,1840,1026,611,0,611,0,244,0,0.036006547,empty,mBC-0716-2
"E7,E2",1690236,1854576,1201815,652761,903605,9,515938,516726,422463,94263,4.481747876,283482,151001,90195,50851,33,50818,3,4571,0,0.006100201,mm10,mBC-0716-2
"E7,E3",12307,12602,9423,3179,6122,1,2758,2768,1938,830,2.334939759,1282,1678,953,556,0,556,0,226,0,0.017985612,empty,mBC-0716-2
"E7,E4",15179,15933,11409,4524,7701,1,3622,3635,2556,1079,2.368860056,1815,1196,733,450,0,450,0,175,0,0.04,empty,mBC-0716-2
"E7,E5",2438864,2728800,1686445,1042355,1285780,12,793532,794620,596201,198419,3.004757609,444985,151780,94356,53040,25,53015,2,4358,0,0.004338395,mm10,mBC-0716-2
"E7,E6",14260,14852,10902,3950,7171,12,3311,3326,2302,1024,2.248046875,1602,2276,1304,749,0,749,0,281,0,0.068090788,empty,mBC-0716-2
"E7,E7",1053084,1189793,711942,477851,570739,7,346934,347400,299486,47914,6.250490462,198555,138480,88268,49560,22,49538,2,4265,0,0.001413057,mm10,mBC-0716-2
"E7,E8",18185,18550,13748,4802,9022,1,4102,4110,2847,1263,2.25415677,1927,1856,1119,675,0,675,0,254,0,0.08,empty,mBC-0716-2
"E7,E9",9333,9577,6958,2619,4677,1,2208,2216,1551,665,2.332330827,1076,1253,654,399,0,399,0,144,0,0.042606516,empty,mBC-0716-2
"E7,E10",1021274,1080181,758653,321528,529917,5,269376,269835,204117,65718,3.105952707,140253,37502,23457,13167,4,13163,1,2184,0,0.00288688,mm10,mBC-0716-2
"E7,E11",9191,9454,7038,2416,4696,7,2149,2159,1506,653,2.306278714,1020,1100,689,417,0,417,0,167,0,0.026378897,empty,mBC-0716-2
"E7,E12",1283055,1448632,888885,559747,713926,8,433353,433874,314747,119127,2.642113039,248843,37056,24079,13182,6,13176,1,2060,0,0.00273224,mm10,mBC-0716-2
"E7,F1",18042,18879,13853,5026,9228,2,4232,4246,2949,1297,2.273708558,2057,1680,1031,597,1,596,1,240,0,0.02852349,empty,mBC-0716-2
"E7,F2",23703,24559,17979,6580,11913,3,5570,5582,3853,1729,2.228455755,2743,5524,2378,1414,1,1413,1,506,0,0.061571125,empty,mBC-0716-2
"E7,F3",16583,17463,12616,4847,8573,0,4111,4119,2888,1231,2.346060114,1997,1882,1164,705,0,705,0,263,0,0.019858156,empty,mBC-0716-2
"E7,F4",16440,16938,12467,4471,8425,1,3793,3799,2627,1172,2.241467577,1917,548,310,196,0,196,0,100,0,0.015306122,empty,mBC-0716-2
"E7,F5",24653,25115,18730,6385,12125,28,5409,5457,3806,1651,2.305269534,2584,2148,1343,797,0,797,0,296,0,0.056461731,empty,mBC-0716-2
"E7,F6",23508,24219,17777,6442,11638,1,5300,5315,3743,1572,2.381043257,2531,2062,1294,747,1,746,1,259,0,0.036193029,empty,mBC-0716-2
"E7,F7",21684,21845,16287,5558,10784,0,4872,4882,3377,1505,2.243853821,2278,4345,1651,1069,1,1068,1,334,0,0.079588015,empty,mBC-0716-2
"E7,F8",24332,24562,18599,5963,12004,0,5396,5410,3840,1570,2.445859873,2550,933,344,231,0,231,0,136,0,0,empty,mBC-0716-2
"E7,F9",14762,15532,11218,4314,7488,7,3490,3499,2414,1085,2.224884793,1729,1387,782,473,0,473,0,177,0,0.10359408,empty,mBC-0716-2
"E7,F10",20810,21513,15914,5599,10360,4,4689,4700,3266,1434,2.277545328,2171,5477,2076,1252,1,1251,1,363,0,0.076738609,empty,mBC-0716-2
"E7,F11",10797,11012,8342,2670,5421,0,2338,2343,1660,683,2.43045388,1097,1115,678,403,0,403,0,159,0,0.101736973,empty,mBC-0716-2
"E7,F12",13765,14276,10353,3923,6888,0,3213,3214,2268,946,2.397463002,1594,139,73,46,0,46,0,38,0,0,empty,mBC-0716-2
"E7,G1",10155,10549,7929,2620,5047,7,2258,2279,1619,660,2.453030303,1007,1940,1130,650,1,649,1,239,0,0.010785824,empty,mBC-0716-2
"E7,G2",20778,21358,15940,5418,10471,0,4720,4737,3325,1412,2.354815864,2267,662,419,255,0,255,0,129,0,0.047058824,empty,mBC-0716-2
"E7,G3",19783,20509,14922,5587,9838,0,4579,4596,3207,1389,2.308855292,2187,2136,1288,775,1,774,1,283,0,0.034883721,empty,mBC-0716-2
"E7,G4",27480,28295,21351,6944,13676,9,5897,5918,4242,1676,2.531026253,2801,198,116,76,0,76,0,58,0,0,empty,mBC-0716-2
"E7,G5",13328,13623,10221,3402,6730,15,3070,3085,2166,919,2.356909684,1399,1513,851,513,0,513,0,213,0,0.126705653,empty,mBC-0716-2
"E7,G6",24146,24450,18621,5829,12015,22,5225,5259,3756,1503,2.499001996,2396,247,161,97,0,97,0,61,0,0.010309278,empty,mBC-0716-2
"E7,G7",20101,20603,15518,5085,10060,13,4504,4527,3212,1315,2.442585551,2123,2556,1312,813,1,812,1,293,0,0.118226601,empty,mBC-0716-2
"E7,G8",761104,857855,535139,322716,418284,0,242190,242514,211508,31006,6.821518416,136164,162857,100342,56027,30,55997,2,4411,0,0.002250121,mm10,mBC-0716-2
"E7,G9",10459,11028,7995,3033,5381,33,2460,2502,1776,726,2.446280992,1224,1325,805,500,0,500,0,188,0,0.024,empty,mBC-0716-2
"E7,G10",13871,14146,10666,3480,6805,0,3011,3014,2115,899,2.352614016,1344,1492,970,596,1,595,1,225,0,0.057142857,empty,mBC-0716-2
"E7,G11",12288,12825,9291,3534,6251,36,2885,2928,2064,864,2.388888889,1421,1434,694,370,1,369,1,127,0,0.016260163,empty,mBC-0716-2
"E7,G12",11731,12273,8775,3498,6018,0,2818,2823,1893,930,2.035483871,1405,5789,2230,1343,1,1342,1,346,0,0.191505216,empty,mBC-0716-2
"E7,H1",20783,21695,15841,5854,10528,21,4735,4762,3401,1361,2.498897869,2277,996,620,384,0,384,0,138,0,0.052083333,empty,mBC-0716-2
"E7,H2",23913,24605,18221,6384,11955,9,5503,5521,3836,1685,2.276557864,2656,2033,1293,784,0,784,0,312,0,0.028061224,empty,mBC-0716-2
"E7,H3",20935,21708,15845,5863,10409,22,4885,4918,3492,1426,2.448807854,2347,1523,927,561,1,560,1,220,0,0.066071429,empty,mBC-0716-2
"E7,H4",14277,15125,10896,4229,7462,25,3493,3520,2480,1040,2.384615385,1721,216,141,92,0,92,0,58,0,0,empty,mBC-0716-2
"E7,H5",917772,1016911,633718,383193,492103,1,288534,289003,197048,91955,2.142874232,167768,20514,13291,7524,5,7519,1,1372,0,0.004654874,mm10,mBC-0716-2
"E7,H6",14472,14738,10834,3904,7346,17,3349,3373,2373,1000,2.373,1579,1987,1169,738,0,738,0,241,0,0.074525745,empty,mBC-0716-2
"E7,H7",17039,17646,12862,4784,8579,0,3912,3924,2806,1118,2.509838998,1930,2451,1162,742,2,740,1,256,0,0.095945946,empty,mBC-0716-2
"E7,H8",14032,14443,10614,3829,7077,0,3339,3349,2371,978,2.424335378,1567,1439,822,514,0,514,0,221,0,0.050583658,empty,mBC-0716-2
"E7,H9",16404,16656,12599,4057,8101,10,3624,3639,2591,1048,2.472328244,1684,1561,846,505,0,505,0,225,0,0.063366337,empty,mBC-0716-2
"E7,H10",14920,15256,11199,4057,7351,13,3346,3365,2404,961,2.501560874,1584,4397,1739,1043,0,1043,0,365,0,0.031639501,empty,mBC-0716-2
"E7,H11",16695,17317,12671,4646,8428,0,3933,3945,2683,1262,2.125990491,1864,151,85,64,0,64,0,55,0,0,empty,mBC-0716-2
"E7,H12",6236,6494,4749,1745,3209,3,1503,1511,1037,474,2.187763713,750,510,271,175,0,175,0,89,0,0.034285714,empty,mBC-0716-2
"E8,A1",16046,17079,12149,4930,8401,1,4074,4085,2868,1217,2.356614626,2044,1944,958,589,3,586,1,263,0,0.035836177,empty,mBC-0716-2
"E8,A2",20851,20962,16110,4852,10230,0,4529,4536,3151,1385,2.275090253,2087,1593,944,580,0,580,0,266,0,0.043103448,empty,mBC-0716-2
"E8,A3",18028,18517,13626,4891,8958,23,4205,4236,3005,1231,2.441104793,1988,1294,826,489,0,489,0,216,0,0.040899796,empty,mBC-0716-2
"E8,A4",22938,23253,17676,5577,11185,2,4884,4909,3505,1404,2.496438746,2277,880,509,320,0,320,0,153,0,0.0875,empty,mBC-0716-2
"E8,A5",18977,19618,14401,5217,9704,0,4595,4603,3146,1457,2.159231297,2211,2546,1717,1006,0,1006,0,382,0,0.021868787,empty,mBC-0716-2
"E8,A6",871960,998264,595292,402972,479899,1,292376,292773,216773,76000,2.852276316,170272,102715,60259,34118,12,34106,4,3340,0,0.003665044,mm10,mBC-0716-2
"E8,A7",17314,17733,13111,4622,8682,11,3988,4003,2761,1242,2.223027375,1897,2028,1216,721,1,720,1,280,0,0.040277778,empty,mBC-0716-2
"E8,A8",11238,11426,8692,2734,5687,4,2598,2610,1856,754,2.461538462,1137,2010,1153,750,2,748,1,321,0,0.058823529,empty,mBC-0716-2
"E8,A9",22905,23481,17601,5880,11346,2,5048,5063,3653,1410,2.590780142,2359,1753,1010,641,0,641,0,292,0,0.060842434,empty,mBC-0716-2
"E8,A10",613680,649578,442030,207548,319043,23,171336,171621,137647,33974,4.051539412,90523,7247,3717,2246,0,2246,0,670,0,0.021371327,mm10,mBC-0716-2
"E8,A11",884053,921336,678073,243263,440387,4,204543,204946,155723,49223,3.163622697,100690,35377,22852,12747,5,12742,2,2017,0,0.002040496,mm10,mBC-0716-2
"E8,A12",2004490,2174649,1446482,728167,1006523,1,563551,564453,420089,144364,2.909929068,301773,302423,188751,106426,46,106380,4,6080,0,0.001673247,mm10,mBC-0716-2
"E8,B1",20269,20722,15510,5212,10158,0,4632,4640,3298,1342,2.45752608,2217,1256,794,518,0,518,0,237,0,0.073359073,empty,mBC-0716-2
"E8,B2",20282,21258,15631,5627,10275,0,4612,4632,3242,1390,2.332374101,2235,591,323,186,0,186,0,105,0,0,empty,mBC-0716-2
"E8,B3",19936,20601,15194,5407,9943,0,4535,4548,3156,1392,2.267241379,2200,1460,903,518,1,517,1,235,0,0.046421663,empty,mBC-0716-2
"E8,B4",17173,17781,13119,4662,8865,0,4015,4025,2864,1161,2.466838932,1933,1252,742,422,0,422,0,212,0,0.014218009,empty,mBC-0716-2
"E8,B5",12082,8087,5465,2622,4884,0,2462,2483,1748,735,2.378231293,1402,1660,978,622,0,622,0,239,0,0.056270096,empty,mBC-0716-2
"E8,B6",13446,14157,10235,3922,7112,0,3441,3445,2472,973,2.540596095,1725,1896,1166,674,0,674,0,289,0,0.004451039,empty,mBC-0716-2
"E8,B7",17672,18361,13642,4719,8961,9,4082,4099,2830,1269,2.230102443,2009,1529,912,548,0,548,0,226,0,0.052919708,empty,mBC-0716-2
"E8,B8",14941,15053,11392,3661,7461,18,3373,3401,2398,1003,2.390827517,1561,1893,1164,758,0,758,0,311,0,0.022427441,empty,mBC-0716-2
"E8,B9",16137,16405,12530,3875,7735,0,3492,3497,2450,1047,2.340019102,1522,1876,837,540,0,540,0,244,0,0.012962963,empty,mBC-0716-2
"E8,B10",614377,632470,425277,207193,319547,20,171561,172127,128028,44099,2.903195084,92163,12772,8400,4839,1,4838,1,932,0,0.004960728,mm10,mBC-0716-2
"E8,B11",766173,809604,578413,231191,387601,40,184577,184890,151097,33793,4.471251443,93646,8009,5042,2830,1,2829,1,669,0,0.001413927,mm10,mBC-0716-2
"E8,B12",697253,762067,509208,252859,375488,1,202303,202642,170252,32390,5.256313677,108688,34351,20087,11208,4,11204,4,1758,0,0.030524813,mm10,mBC-0716-2
"E8,C1",23607,23689,17997,5692,11306,17,4879,4909,3402,1507,2.257465163,2277,4817,1583,966,1,965,1,317,0,0.047668394,empty,mBC-0716-2
"E8,C2",19914,20534,15220,5314,9996,35,4487,4531,3204,1327,2.414468726,2189,1871,1188,680,0,680,0,262,0,0.052941176,empty,mBC-0716-2
"E8,C3",23181,23865,17546,6319,11736,0,5518,5531,3955,1576,2.509517766,2724,760,446,265,0,265,0,128,0,0.033962264,empty,mBC-0716-2
"E8,C4",19066,19333,14569,4764,9314,0,4072,4079,2885,1194,2.416247906,1882,3786,1580,959,0,959,0,337,0,0.101147028,empty,mBC-0716-2
"E8,C5",1130586,1292816,751234,541582,619338,1,396500,397001,319984,77017,4.154719088,231063,92516,60196,33823,18,33805,4,3321,0,0.001774885,mm10,mBC-0716-2
"E8,C6",17983,18425,13504,4921,9269,0,4380,4387,3161,1226,2.578303426,2164,2557,1590,917,1,916,1,340,0,0.016375546,empty,mBC-0716-2
"E8,C7",18798,19709,14139,5570,9635,13,4545,4572,3196,1376,2.322674419,2239,595,349,241,1,240,1,130,0,0.004166667,empty,mBC-0716-2
"E8,C8",16629,17281,12662,4619,8541,0,3959,3967,2796,1171,2.387702818,1900,2443,1557,901,0,901,0,330,0,0.059933407,empty,mBC-0716-2
"E8,C9",14414,14888,10996,3892,7241,0,3400,3406,2385,1021,2.335945152,1677,1306,780,475,0,475,0,208,0,0.052631579,empty,mBC-0716-2
"E8,C10",1133395,1249870,798744,451126,592998,2,338944,339493,285986,53507,5.344833386,186108,125919,77540,43222,13,43209,3,3816,0,0.0013886,mm10,mBC-0716-2
"E8,C11",12500,12974,9516,3458,6304,4,2895,2905,2007,898,2.234966592,1384,1342,788,443,0,443,0,188,0,0.011286682,empty,mBC-0716-2
"E8,C12",694271,728355,513657,214698,353578,0,181295,181615,136573,45042,3.032125572,93753,8894,5819,3240,0,3240,0,782,0,0.006790123,mm10,mBC-0716-2
"E8,D1",13543,14209,10093,4116,6947,4,3392,3407,2366,1041,2.272814601,1716,886,486,290,0,290,0,138,0,0.024137931,empty,mBC-0716-2
"E8,D2",23365,23835,17811,6024,11565,6,5108,5122,3543,1579,2.243825206,2399,23423,7755,4623,8,4615,4,1082,0,0.018851571,empty,mBC-0716-2
"E8,D3",15200,15965,11420,4545,7787,43,3757,3808,2678,1130,2.369911504,1895,1711,1033,664,0,664,0,267,0,0.03313253,empty,mBC-0716-2
"E8,D4",622187,637208,489405,147803,309527,0,130565,130792,96625,34167,2.82802119,61705,28296,17281,9841,2,9839,1,1767,0,0.005386726,mm10,mBC-0716-2
"E8,D5",15216,15879,11524,4355,7756,0,3583,3592,2502,1090,2.295412844,1725,1506,958,610,1,609,1,245,0,0.036124795,empty,mBC-0716-2
"E8,D6",14114,15109,10511,4598,7308,4,3539,3549,2434,1115,2.182959641,1817,2123,1221,762,2,760,1,317,0,0.030263158,empty,mBC-0716-2
"E8,D7",13651,13995,10409,3586,6848,0,3121,3129,2166,963,2.249221184,1518,2079,1291,773,0,773,0,279,0,0.02457956,empty,mBC-0716-2
"E8,D8",974957,1062766,698465,364301,509208,30,281301,281719,232155,49564,4.683943992,152070,50405,32962,18389,7,18382,1,2327,0,0.002937656,mm10,mBC-0716-2
"E8,D9",274259,286534,195753,90781,141651,2,72351,72464,60945,11519,5.290823856,38319,110306,70150,38839,18,38821,4,3589,0,0.00206074,mm10,mBC-0716-2
"E8,D10",14071,14701,10640,4061,7133,0,3251,3262,2258,1004,2.249003984,1595,1007,576,369,0,369,0,163,0,0.032520325,empty,mBC-0716-2
"E8,D11",748330,830453,533812,296641,406213,6,230215,230549,188473,42076,4.479346896,127061,119694,76241,42299,24,42275,3,3766,0,0.000756949,mm10,mBC-0716-2
"E8,D12",21420,22056,16451,5605,10682,0,4899,4901,3439,1462,2.352257182,2255,2730,1621,957,0,957,0,325,0,0.027168234,empty,mBC-0716-2
"E8,E1",23556,24396,18008,6388,11919,0,5409,5422,3840,1582,2.427307206,2627,2064,1159,743,0,743,0,348,0,0.051144011,empty,mBC-0716-2
"E8,E2",18280,18909,14018,4891,9202,1,4157,4165,2930,1235,2.372469636,1996,1702,958,594,0,594,0,265,0,0.038720539,empty,mBC-0716-2
"E8,E3",12926,13155,9898,3257,6589,0,2899,2907,2012,895,2.248044693,1386,2019,1293,783,1,782,1,334,0,0.040920716,empty,mBC-0716-2
"E8,E4",1529052,1631923,1113734,518189,773122,40,423543,424222,320773,103449,3.100783961,223002,38756,20699,11639,6,11633,2,2246,0,0.012206653,mm10,mBC-0716-2
"E8,E5",22778,23426,17441,5985,11483,0,5269,5283,3726,1557,2.393063584,2482,7595,2842,1732,1,1731,1,557,0,0.056036973,empty,mBC-0716-2
"E8,E6",15348,15650,11704,3946,7618,7,3424,3437,2443,994,2.457746479,1602,3104,1893,1127,0,1127,0,422,0,0.013309672,empty,mBC-0716-2
"E8,E7",16394,16732,12415,4317,8187,0,3721,3732,2628,1104,2.380434783,1878,7074,2751,1686,4,1682,3,539,0,0.030915577,empty,mBC-0716-2
"E8,E8",18976,19766,14607,5159,9579,0,4316,4328,3037,1291,2.352439969,2080,2768,1586,934,0,934,0,368,0,0.043897216,empty,mBC-0716-2
"E8,E9",9981,9952,7530,2422,4980,2,2307,2318,1628,690,2.35942029,1076,1349,822,480,0,480,0,188,0,0.120833333,empty,mBC-0716-2
"E8,E10",13926,14366,10588,3778,7094,19,3240,3259,2308,951,2.426919033,1562,1602,982,620,0,620,0,260,0,0.033870968,empty,mBC-0716-2
"E8,E11",10314,10693,7811,2882,5227,1,2413,2419,1690,729,2.31824417,1159,1430,878,553,2,551,1,237,0,0.019963702,empty,mBC-0716-2
"E8,E12",17593,18349,13293,5056,8929,13,4261,4282,3057,1225,2.495510204,2099,1818,898,565,1,564,1,231,0,0.120567376,empty,mBC-0716-2
"E8,F1",19970,20479,14891,5588,10049,17,4611,4637,3203,1434,2.233612273,2284,8569,3108,1886,2,1884,1,565,0,0.112526539,empty,mBC-0716-2
"E8,F2",945356,1027985,687347,340638,494077,3,268965,269419,205733,63686,3.230427409,144374,62771,39944,22597,8,22589,2,2763,0,0.001505157,mm10,mBC-0716-2
"E8,F3",17988,19008,13633,5375,9243,0,4408,4425,3184,1241,2.565672844,2148,2315,1427,868,1,867,1,363,0,0.036908881,empty,mBC-0716-2
"E8,F4",898004,1034238,573023,461215,509768,26,340016,340396,275819,64577,4.271164656,201596,33045,19962,11137,7,11130,1,1755,0,0.001257862,mm10,mBC-0716-2
"E8,F5",996943,1138905,678873,460032,547115,4,336554,337029,240980,96049,2.508927735,195680,68327,42708,24302,12,24290,1,2877,0,0.001934953,mm10,mBC-0716-2
"E8,F6",982505,1047446,734566,312880,497924,0,248908,249371,166221,83150,1.99904991,129974,69689,42969,24259,9,24250,1,2715,0,0.005030928,mm10,mBC-0716-2
"E8,F7",21740,22716,16606,6110,10934,16,5034,5060,3574,1486,2.405114401,2399,1265,794,489,0,489,0,202,0,0.036809816,empty,mBC-0716-2
"E8,F8",1055452,1213794,712685,501109,584994,7,366237,366706,306936,59770,5.13528526,212357,14701,9463,5319,4,5315,1,976,0,0.003762935,mm10,mBC-0716-2
"E8,F9",856920,920443,614452,305991,447707,1,246883,247296,184526,62770,2.939716425,133647,16116,10328,5904,5,5899,1,1233,0,0.007628412,mm10,mBC-0716-2
"E8,F10",27338,27969,21453,6516,13555,2,5905,5927,4292,1635,2.625076453,2725,2058,1106,697,0,697,0,287,0,0.044476327,empty,mBC-0716-2
"E8,F11",13707,14094,10502,3592,7059,1,3208,3214,2242,972,2.306584362,1524,1423,887,589,0,589,0,254,0,0.010186757,empty,mBC-0716-2
"E8,F12",15009,15181,11512,3669,7256,0,3242,3247,2303,944,2.439618644,1422,287,175,114,0,114,0,88,0,0,empty,mBC-0716-2
"E8,G1",10495,10491,8180,2311,5157,3,2193,2203,1584,619,2.558966074,937,2066,1259,755,0,755,0,284,0,0.031788079,empty,mBC-0716-2
"E8,G2",22568,23081,17421,5660,11207,0,5024,5032,3459,1573,2.198982835,2321,953,590,396,0,396,0,226,0,0.022727273,empty,mBC-0716-2
"E8,G3",22836,23683,16972,6711,11742,12,5624,5652,3936,1716,2.293706294,2800,2212,1306,810,1,809,1,396,0,0.019777503,empty,mBC-0716-2
"E8,G4",2567647,2887323,1755239,1132084,1348000,21,838212,839375,653391,185984,3.513157046,479246,1871,1059,590,1,589,1,206,0,0,empty,mBC-0716-2
"E8,G5",1533679,1630044,1131954,498090,781608,4,403733,404441,289182,115259,2.508975438,211776,103935,58649,33088,15,33073,2,3865,0,0.00846612,mm10,mBC-0716-2
"E8,G6",25000,25608,19193,6415,12593,48,5700,5763,4016,1747,2.298797939,2721,617,253,168,0,168,0,109,0,0.023809524,empty,mBC-0716-2
"E8,G7",21328,21773,16369,5404,10631,15,4687,4713,3374,1339,2.519790889,2173,2841,1624,1013,0,1013,0,418,0,0.029615005,empty,mBC-0716-2
"E8,G8",16015,16891,12290,4601,8074,0,3807,3814,2712,1102,2.460980036,1790,2269,1416,875,1,874,1,353,0,0.029748284,empty,mBC-0716-2
"E8,G9",1049628,1146226,742701,403525,544140,9,306085,306510,253065,53445,4.735054729,166022,123464,80417,45036,20,45016,1,3808,0,0.000888573,mm10,mBC-0716-2
"E8,G10",3903708,4277047,2785160,1491887,1961181,3,1152831,1154511,944699,209812,4.502597564,624249,522105,338696,188770,84,188686,5,7478,0,0.00195033,mm10,mBC-0716-2
"E8,G11",13244,13503,10093,3410,6606,0,3064,3074,2191,883,2.481313703,1470,837,519,309,0,309,0,140,0,0.022653722,empty,mBC-0716-2
"E8,G12",12648,13372,9575,3797,6432,1,3055,3058,2131,927,2.298813376,1544,1368,817,488,0,488,0,222,0,0.032786885,empty,mBC-0716-2
"E8,H1",23079,23412,17334,6078,11296,3,5187,5195,3776,1419,2.661028894,2458,4243,2028,1266,3,1263,1,325,0,0.408551069,empty,mBC-0716-2
"E8,H2",26949,27728,20650,7078,13318,7,6090,6109,4387,1722,2.547619048,2883,2429,1488,937,1,936,1,401,0,0.051282051,empty,mBC-0716-2
"E8,H3",969345,1085342,663076,422266,521359,8,313243,313678,262436,51242,5.121501893,178173,104103,62316,34686,18,34668,3,3520,0,0.001182647,mm10,mBC-0716-2
"E8,H4",16400,16917,12406,4511,8302,19,3810,3840,2684,1156,2.321799308,1876,355,226,147,1,146,1,100,0,0,empty,mBC-0716-2
"E8,H5",19509,20091,14667,5424,9746,0,4531,4540,3209,1331,2.410969196,2255,2228,1353,854,0,854,0,334,0,0.021077283,empty,mBC-0716-2
"E8,H6",16677,17512,12738,4774,8493,0,3973,3988,2760,1228,2.247557003,1922,2252,1290,790,0,790,0,324,0,0.012658228,empty,mBC-0716-2
"E8,H7",18399,19199,13692,5507,9419,0,4378,4386,3051,1335,2.285393258,2250,2256,1356,878,1,877,1,343,0,0.049030787,empty,mBC-0716-2
"E8,H8",14981,15292,11329,3963,7668,5,3618,3630,2554,1076,2.373605948,1792,3576,1711,1083,1,1082,1,415,0,0.014787431,empty,mBC-0716-2
"E8,H9",19804,19981,14651,5330,9745,1,4507,4514,3285,1229,2.672904801,2199,13166,4242,2652,0,2652,0,809,0,0.053167421,empty,mBC-0716-2
"E8,H10",709689,738967,536459,202508,355995,1,169365,169674,126025,43649,2.887236821,84758,37903,25367,14186,5,14181,1,2041,0,0.002327057,mm10,mBC-0716-2
"E8,H11",806876,943226,540958,402268,460776,5,293087,293510,240329,53181,4.519076362,173966,3282,2113,1117,0,1117,0,355,0,0,mm10,mBC-0716-2
"E8,H12",6966,7382,5232,2150,3621,0,1730,1735,1198,537,2.230912477,878,5266,1628,973,0,973,0,342,0,0.048304214,empty,mBC-0716-2
"E9,A1",14158,14321,10663,3658,7213,16,3351,3376,2335,1041,2.243035543,1652,1658,1020,612,0,612,0,238,0,0.003267974,empty,mBC-0716-2
"E9,A2",18990,18821,14398,4423,9090,4,3984,3998,2722,1276,2.13322884,1791,1690,1047,636,0,636,0,249,0,0.034591195,empty,mBC-0716-2
"E9,A3",16854,17207,12732,4475,8390,0,3910,3913,2747,1166,2.355917667,1876,1791,1033,621,0,621,0,217,0,0.045088567,empty,mBC-0716-2
"E9,A4",22600,22721,17459,5262,10890,0,4773,4779,3468,1311,2.645308924,2140,930,552,340,0,340,0,154,0,0.002941176,empty,mBC-0716-2
"E9,A5",1110467,1197495,796497,400998,570971,3,309020,309554,261835,47719,5.48701775,165304,95708,60926,33861,10,33851,2,3314,0,0.001033943,mm10,mBC-0716-2
"E9,A6",16180,16982,12137,4845,8352,31,3969,4008,2912,1096,2.656934307,1993,4079,1601,990,1,989,1,355,0,0.045500506,empty,mBC-0716-2
"E9,A7",16951,17652,12715,4937,8544,3,4024,4034,2763,1271,2.173878836,1997,1264,775,464,0,464,0,186,0,0.066810345,empty,mBC-0716-2
"E9,A8",401732,434624,299239,135385,215623,1,108710,108886,85736,23150,3.70349892,57176,58956,36859,20993,8,20985,3,2644,0,0.008101025,mm10,mBC-0716-2
"E9,A9",19720,20052,15154,4898,9564,8,4206,4225,3039,1186,2.562394604,1967,1646,819,487,0,487,0,229,0,0.014373717,empty,mBC-0716-2
"E9,A10",16683,17338,12671,4667,8331,10,3820,3841,2645,1196,2.211538462,1866,484,289,193,0,193,0,110,0,0.020725389,empty,mBC-0716-2
"E9,A11",889006,945397,640948,304449,454456,0,243231,243648,200460,43188,4.641567102,127583,52313,27639,15554,6,15548,2,2279,0,0.006496012,mm10,mBC-0716-2
"E9,A12",21903,21943,16753,5190,10449,0,4585,4598,3246,1352,2.400887574,2100,2328,1427,827,0,827,0,271,0,0.056831923,empty,mBC-0716-2
"E9,B1",20804,21367,15830,5537,10141,38,4566,4621,3175,1446,2.19571231,2217,1408,842,515,0,515,0,212,0,0.029126214,empty,mBC-0716-2
"E9,B2",21615,22142,16490,5652,10554,0,4785,4794,3276,1518,2.158102767,2213,994,555,343,0,343,0,126,0,0.040816327,empty,mBC-0716-2
"E9,B3",20172,20640,15461,5179,9975,11,4527,4541,3222,1319,2.442759666,2098,1641,986,565,1,564,1,238,0,0.007092199,empty,mBC-0716-2
"E9,B4",1062362,1231442,707772,523670,592935,1,377632,378124,286180,91944,3.112546768,223186,44538,28910,16449,9,16440,1,2145,0,0.002007299,mm10,mBC-0716-2
"E9,B5",16955,13871,9140,4731,7657,0,4079,4096,3103,993,3.124874119,2244,639,388,228,0,228,0,119,0,0.00877193,empty,mBC-0716-2
"E9,B6",1844281,2028018,1309646,718372,970039,25,554170,555060,429284,125776,3.413083577,308718,114856,73820,41732,15,41717,3,4042,0,0.001342378,mm10,mBC-0716-2
"E9,B7",17877,18402,13485,4917,8932,14,4053,4079,2845,1234,2.305510535,1972,959,532,348,0,348,0,162,0,0.068965517,empty,mBC-0716-2
"E9,B8",720406,773577,537424,236153,380622,10,194753,195069,142110,52959,2.68339659,101373,41531,26696,14925,7,14918,1,2348,0,0.010792331,mm10,mBC-0716-2
"E9,B9",16178,16618,12317,4301,8087,0,3673,3685,2518,1167,2.157669237,1759,1646,645,410,0,410,0,197,0,0.041463415,empty,mBC-0716-2
"E9,B10",17173,17623,12849,4774,8732,0,4113,4127,2805,1322,2.121785174,1965,579,344,193,0,193,0,94,0,0.067357513,empty,mBC-0716-2
"E9,B11",1028740,1186033,680276,505757,563509,7,361404,361915,296513,65402,4.533699275,213100,2348,1403,789,0,789,0,252,0,0.001267427,empty,mBC-0716-2
"E9,B12",1031937,1162991,695782,467209,560905,2,347187,347714,278186,69528,4.001064319,197937,71481,47375,26111,8,26103,1,2980,0,0.000919435,mm10,mBC-0716-2
"E9,C1",23666,24109,18257,5852,11393,0,4837,4847,3363,1484,2.266172507,2285,1105,687,415,0,415,0,169,0,0.01686747,empty,mBC-0716-2
"E9,C2",19080,19337,14166,5171,9209,20,4188,4219,2972,1247,2.383319968,2025,2947,1510,882,0,882,0,292,0,0.040816327,empty,mBC-0716-2
"E9,C3",21588,22146,16240,5906,10499,17,4748,4780,3292,1488,2.212365591,2298,1069,642,369,0,369,0,137,0,0.062330623,empty,mBC-0716-2
"E9,C4",17418,17548,13116,4432,8649,0,3814,3825,2669,1156,2.308823529,1825,1206,742,441,0,441,0,188,0,0.0430839,empty,mBC-0716-2
"E9,C5",21849,22813,16017,6796,11067,0,5355,5368,3900,1468,2.656675749,2716,1167,721,427,0,427,0,192,0,0.039812646,empty,mBC-0716-2
"E9,C6",17454,18247,13035,5212,8916,1,4167,4180,2924,1256,2.328025478,2047,3817,1435,913,1,912,1,313,0,0.035087719,empty,mBC-0716-2
"E9,C7",17004,17500,12734,4766,8396,3,3957,3962,2771,1191,2.326616289,1949,1300,479,297,0,297,0,128,0,0.084175084,empty,mBC-0716-2
"E9,C8",15630,16061,11833,4228,7792,0,3517,3525,2454,1071,2.291316527,1702,1340,787,482,0,482,0,196,0,0.014522822,empty,mBC-0716-2
"E9,C9",789535,891255,550409,340846,432781,1,255006,255356,205920,49436,4.165385549,144701,52935,30273,17139,12,17127,2,2281,0,0.010743271,mm10,mBC-0716-2
"E9,C10",14077,14552,10757,3795,7164,0,3211,3219,2208,1011,2.183976261,1587,992,578,330,0,330,0,165,0,0.048484848,empty,mBC-0716-2
"E9,C11",12234,12629,9179,3450,6229,0,3004,3013,2118,895,2.366480447,1481,759,438,284,0,284,0,138,0,0.038732394,empty,mBC-0716-2
"E9,C12",20924,21359,15691,5668,10197,1,4640,4659,3270,1389,2.354211663,2239,1112,611,382,0,382,0,163,0,0.041884817,empty,mBC-0716-2
"E9,D1",11848,12313,8814,3499,6139,1,2910,2924,1996,928,2.150862069,1457,1119,573,364,0,364,0,158,0,0.03021978,empty,mBC-0716-2
"E9,D2",22558,22772,17060,5712,10994,4,4872,4895,3439,1456,2.361950549,2289,7164,3093,1944,1,1943,1,603,0,0.085949563,empty,mBC-0716-2
"E9,D3",13903,14636,10330,4306,7115,0,3408,3414,2369,1045,2.266985646,1690,1486,878,555,0,555,0,242,0,0.014414414,empty,mBC-0716-2
"E9,D4",3018393,3335416,2076124,1259292,1554555,2,953752,955084,784566,170518,4.601074373,534483,147466,94740,52962,16,52946,2,4507,0,0.001945378,mm10,mBC-0716-2
"E9,D5",759085,833449,539221,294228,406194,3,227999,228291,190898,37393,5.105180114,124761,71963,45757,25744,9,25735,1,2818,0,0.00547892,mm10,mBC-0716-2
"E9,D6",1733123,1970612,1167024,803588,946430,3,594672,595448,460914,134534,3.426003835,346644,151054,97397,54760,30,54730,1,4418,0,0.001151105,mm10,mBC-0716-2
"E9,D7",12994,13163,9906,3257,6354,2,2899,2906,1997,909,2.196919692,1290,5713,2081,1208,0,1208,0,390,0,0.027317881,empty,mBC-0716-2
"E9,D8",17510,18210,12892,5318,8967,27,4328,4358,3020,1338,2.257100149,2207,4135,1495,882,0,882,0,317,0,0.090702948,empty,mBC-0716-2
"E9,D9",4976,5184,3619,1565,2674,0,1299,1301,992,309,3.210355987,684,1410,786,531,0,531,0,281,0,0.013182674,empty,mBC-0716-2
"E9,D10",17599,18242,12901,5341,8773,0,4299,4309,3102,1207,2.570008285,2178,7643,2484,1556,1,1555,1,407,0,0.140192926,empty,mBC-0716-2
"E9,D11",13780,14057,10390,3667,6875,0,3200,3213,2245,968,2.319214876,1601,1433,845,504,0,504,0,256,0,0.053571429,empty,mBC-0716-2
"E9,D12",21810,22281,16708,5573,10655,0,4796,4800,3407,1393,2.445800431,2197,2429,1413,835,1,834,1,298,0,0.057553957,empty,mBC-0716-2
"E9,E1",22580,22547,17378,5169,10971,5,4783,4804,3352,1452,2.308539945,2227,1982,1156,708,1,707,1,310,0,0.014144272,empty,mBC-0716-2
"E9,E2",16720,17055,12949,4106,8213,41,3587,3639,2521,1118,2.254919499,1711,2361,1219,704,1,703,1,251,0,0.041251778,empty,mBC-0716-2
"E9,E3",12814,13062,9765,3297,6539,22,2963,2996,2071,925,2.238918919,1441,4346,1945,1158,0,1158,0,403,0,0.055267703,empty,mBC-0716-2
"E9,E4",16667,16639,12547,4092,8102,35,3662,3705,2580,1125,2.293333333,1786,3479,1587,951,0,951,0,334,0,0.036803365,empty,mBC-0716-2
"E9,E5",22592,23143,17255,5888,10964,0,4888,4900,3486,1414,2.465346535,2268,2664,1232,773,0,773,0,323,0,0.032341527,empty,mBC-0716-2
"E9,E6",14312,14544,10998,3546,7030,18,3090,3117,2142,975,2.196923077,1466,1482,942,595,1,594,1,263,0,0.028619529,empty,mBC-0716-2
"E9,E7",14027,14254,10692,3562,6967,0,3201,3206,2145,1061,2.021677663,1493,2234,951,573,0,573,0,206,0,0.052356021,empty,mBC-0716-2
"E9,E8",18671,18582,14428,4154,8968,0,3803,3817,2627,1190,2.207563025,1690,2191,1168,695,0,695,0,239,0,0.102158273,empty,mBC-0716-2
"E9,E9",9689,10514,7092,3422,5003,1,2452,2453,1705,748,2.279411765,1273,4762,1896,1089,1,1088,1,391,0,0.022977941,empty,mBC-0716-2
"E9,E10",14198,14705,10738,3967,7062,2,3253,3268,2238,1030,2.172815534,1574,1294,759,468,0,468,0,207,0,0.085470085,empty,mBC-0716-2
"E9,E11",9450,9786,7269,2517,4870,8,2255,2266,1603,663,2.417797888,1061,1100,635,371,0,371,0,175,0,0.053908356,empty,mBC-0716-2
"E9,E12",15303,15598,11529,4069,7652,0,3594,3602,2521,1081,2.332099907,1691,900,500,316,0,316,0,143,0,0.056962025,empty,mBC-0716-2
"E9,F1",19585,20245,14660,5585,9837,4,4623,4636,3243,1393,2.328068916,2294,7609,2639,1587,2,1585,2,498,0,0.018927445,empty,mBC-0716-2
"E9,F2",24785,25955,18578,7377,12359,106,5728,5850,4019,1831,2.194975423,2896,3229,1941,1150,0,1150,0,426,0,0.033913043,empty,mBC-0716-2
"E9,F3",16757,17273,12605,4668,8428,0,3956,3966,2716,1250,2.1728,1900,1863,1039,664,0,664,0,290,0,0.015060241,empty,mBC-0716-2
"E9,F4",16204,16338,12257,4081,8064,0,3606,3612,2463,1149,2.143603133,1710,2540,927,567,1,566,1,238,0,0.007067138,empty,mBC-0716-2
"E9,F5",26437,27184,20013,7171,13122,0,6040,6050,4205,1845,2.279132791,2864,2227,1201,793,0,793,0,331,0,0.04665826,empty,mBC-0716-2
"E9,F6",24310,24671,18344,6327,12023,0,5485,5495,3850,1645,2.340425532,2555,6086,2265,1346,0,1346,0,462,0,0.047548291,empty,mBC-0716-2
"E9,F7",933492,1032702,677601,355101,501137,2,272391,272793,219541,53252,4.122680838,147974,60543,40691,22941,12,22929,3,2712,0,0.001831741,mm10,mBC-0716-2
"E9,F8",23717,24613,18067,6546,11869,1,5439,5444,3845,1599,2.404627892,2564,396,259,154,1,153,1,90,0,0,empty,mBC-0716-2
"E9,F9",959187,1073307,653054,420253,521010,6,324556,325018,236033,88985,2.652503231,183936,27889,17416,9793,2,9791,1,1654,0,0.004902461,mm10,mBC-0716-2
"E9,F10",22079,22473,17027,5446,10889,0,4821,4824,3441,1383,2.488069414,2220,1227,762,444,0,444,0,192,0,0.042792793,empty,mBC-0716-2
"E9,F11",11616,12042,8867,3175,5957,0,2669,2678,1846,832,2.21875,1296,918,562,334,0,334,0,152,0,0.017964072,empty,mBC-0716-2
"E9,F12",14942,15204,11407,3797,7369,40,3284,3339,2341,998,2.345691383,1574,196,123,80,0,80,0,54,0,0,empty,mBC-0716-2
"E9,G1",10754,10733,8149,2584,5309,0,2333,2339,1633,706,2.313031161,1062,5150,2197,1280,2,1278,1,368,0,0.089984351,empty,mBC-0716-2
"E9,G2",22872,23124,17642,5482,11051,0,4896,4907,3481,1426,2.441093969,2237,690,442,257,0,257,0,141,0,0.027237354,empty,mBC-0716-2
"E9,G3",20880,21388,15747,5641,10262,0,4644,4651,3305,1346,2.455423477,2254,2380,1532,919,1,918,1,346,0,0.039215686,empty,mBC-0716-2
"E9,G4",1043383,1076729,802035,274694,509390,0,230434,230911,181544,49367,3.677436344,111961,681,423,242,1,241,1,114,0,0.012448133,empty,mBC-0716-2
"E9,G5",14764,15042,11283,3759,7326,0,3385,3397,2400,997,2.407221665,1595,1315,836,536,0,536,0,246,0,0.027985075,empty,mBC-0716-2
"E9,G6",26024,25866,20052,5814,12597,0,5524,5543,3914,1629,2.402701044,2496,262,177,120,0,120,0,64,0,0,empty,mBC-0716-2
"E9,G7",21878,22203,16715,5488,10681,37,4729,4777,3371,1406,2.397581792,2229,2133,1158,742,0,742,0,282,0,0.017520216,empty,mBC-0716-2
"E9,G8",15113,15552,11506,4046,7558,0,3530,3534,2474,1060,2.333962264,1660,1300,773,497,2,495,2,220,0,0.03030303,empty,mBC-0716-2
"E9,G9",11398,11880,8613,3267,5745,6,2667,2681,1859,822,2.261557178,1310,1232,770,468,0,468,0,227,0,0.025641026,empty,mBC-0716-2
"E9,G10",14363,14320,10890,3430,7018,0,3137,3146,2167,979,2.213483146,1434,1333,815,520,0,520,0,267,0,0.021153846,empty,mBC-0716-2
"E9,G11",907907,964126,680980,283146,459890,1,225420,225792,180206,45586,3.953099636,114857,103874,64063,35511,18,35493,1,3414,0,0.00098611,mm10,mBC-0716-2
"E9,G12",12075,12330,9125,3205,6044,0,2767,2772,1991,781,2.549295775,1350,10013,3457,2035,1,2034,1,529,0,0.127826942,empty,mBC-0716-2
"E9,H1",21519,22501,16235,6266,10776,0,5027,5036,3565,1471,2.423521414,2477,1224,753,437,0,437,0,182,0,0.004576659,empty,mBC-0716-2
"E9,H2",1157387,1278929,814603,464326,610448,0,353379,353900,283729,70171,4.043393995,196040,72061,48110,26963,12,26951,2,2805,0,0.001298653,mm10,mBC-0716-2
"E9,H3",20406,20871,15560,5311,10038,0,4600,4604,3242,1362,2.380323054,2186,1720,1002,629,0,629,0,272,0,0.017488076,empty,mBC-0716-2
"E9,H4",14598,14830,10966,3864,7311,60,3354,3420,2350,1070,2.196261682,1650,196,123,84,0,84,0,68,0,0,empty,mBC-0716-2
"E9,H5",18642,19306,13995,5311,9233,28,4202,4233,2969,1264,2.348892405,2109,1362,792,483,0,483,0,234,0,0.062111801,empty,mBC-0716-2
"E9,H6",752899,833515,519595,313920,405894,8,238339,238674,195049,43625,4.471037249,133924,94145,62018,34449,16,34433,5,3344,0,0.000871257,mm10,mBC-0716-2
"E9,H7",17586,17984,13309,4675,8765,24,4053,4079,2862,1217,2.35168447,1910,1728,909,578,0,578,0,249,0,0.105536332,empty,mBC-0716-2
"E9,H8",616001,674086,430271,243815,328606,10,187732,188006,150513,37493,4.01442936,104207,47606,31350,17699,9,17690,1,2212,0,0.002091577,mm10,mBC-0716-2
"E9,H9",17231,17506,12795,4711,8561,26,3961,3990,2828,1162,2.43373494,1984,1310,781,526,0,526,0,247,0,0.007604563,empty,mBC-0716-2
"E9,H10",747510,842709,495806,346903,404818,3,246000,246347,197469,48878,4.040038463,142968,92037,60193,33794,11,33783,2,3717,0,0.00127283,mm10,mBC-0716-2
"E9,H11",17406,18283,13271,5012,8891,8,4215,4229,2973,1256,2.367038217,2087,242,130,91,0,91,0,72,0,0,empty,mBC-0716-2
"E9,H12",479284,513677,348347,165330,256567,5,138882,139112,108326,30786,3.518677321,73841,7240,4636,2670,2,2668,1,641,0,0.013868066,mm10,mBC-0716-2
"E10,A1",12674,12907,9488,3419,6608,0,3097,3101,2252,849,2.652532391,1546,6944,2304,1374,3,1371,2,456,0,0.024070022,empty,mBC-0716-2
"E10,A2",17592,17720,13425,4295,8525,1,3740,3750,2598,1152,2.255208333,1693,1363,765,490,2,488,2,223,0,0.024590164,empty,mBC-0716-2
"E10,A3",14902,15330,11388,3942,7549,0,3508,3521,2497,1024,2.438476563,1728,1398,843,467,1,466,1,194,0,0.019313305,empty,mBC-0716-2
"E10,A4",19200,19212,14768,4444,9306,6,4004,4016,2840,1176,2.414965986,1839,873,489,300,1,299,1,152,0,0.026755853,empty,mBC-0716-2
"E10,A5",400204,417682,302989,114693,209062,5,97136,97302,68197,29105,2.343136918,50201,19388,10548,6066,4,6062,1,1269,0,0.004453976,mm10,mBC-0716-2
"E10,A6",23493,25044,17513,7531,12388,2,6175,6191,4753,1438,3.305285118,3154,3572,1592,994,0,994,0,372,0,0.039235412,empty,mBC-0716-2
"E10,A7",14289,14820,10813,4007,7244,0,3335,3356,2376,980,2.424489796,1621,1410,809,496,0,496,0,200,0,0.060483871,empty,mBC-0716-2
"E10,A8",9738,9926,7415,2511,4857,5,2234,2243,1536,707,2.172560113,1040,1416,826,531,0,531,0,240,0,0.04519774,empty,mBC-0716-2
"E10,A9",16762,17008,13091,3917,8129,0,3591,3600,2518,1082,2.327171904,1633,1380,833,510,0,510,0,221,0,0.017647059,empty,mBC-0716-2
"E10,A10",14193,14492,10717,3775,7024,0,3196,3197,2234,963,2.319833853,1532,542,294,195,0,195,0,112,0,0.051282051,empty,mBC-0716-2
"E10,A11",16351,17020,12491,4529,8391,0,3856,3867,2702,1165,2.319313305,1867,1446,826,515,1,514,1,205,0,0.042801556,empty,mBC-0716-2
"E10,A12",18424,19083,14109,4974,9224,10,4128,4150,2916,1234,2.363047002,2007,2742,1623,924,2,922,1,301,0,0.045553145,empty,mBC-0716-2
"E10,B1",17426,17834,13305,4529,8753,1,3970,3982,2776,1206,2.301824212,1897,1428,860,494,0,494,0,196,0,0.042510121,empty,mBC-0716-2
"E10,B2",779240,857162,550654,306508,421740,1,240803,241142,159254,81888,1.944778234,135635,17234,8534,4850,2,4848,2,1039,0,0.024958746,mm10,mBC-0716-2
"E10,B3",17501,18238,13356,4882,8997,18,4113,4141,2965,1176,2.521258503,2059,1437,874,533,0,533,0,227,0,0.03564728,empty,mBC-0716-2
"E10,B4",14662,15406,11200,4206,7406,0,3440,3452,2337,1115,2.095964126,1691,1523,889,510,0,510,0,182,0,0.054901961,empty,mBC-0716-2
"E10,B5",7985,4587,3166,1421,2987,0,1459,1477,994,483,2.057971014,800,990,524,286,1,285,1,130,0,0.045614035,empty,mBC-0716-2
"E10,B6",11307,11712,8541,3171,5793,3,2731,2740,1919,821,2.337393423,1325,1480,872,530,0,530,0,215,0,0.047169811,empty,mBC-0716-2
"E10,B7",14885,15330,11189,4141,7476,0,3363,3371,2366,1005,2.354228856,1585,1187,709,417,0,417,0,182,0,0.03117506,empty,mBC-0716-2
"E10,B8",447020,472429,314994,157435,234458,0,129855,130055,103180,26875,3.839255814,69648,9173,5882,3242,1,3241,1,907,0,0.010799136,mm10,mBC-0716-2
"E10,B9",15620,15387,11116,4271,7028,0,3220,3226,2250,976,2.305327869,1516,19076,6099,3689,8,3681,2,812,0,0.244770443,empty,mBC-0716-2
"E10,B10",14824,15265,10746,4519,7650,8,3602,3629,2527,1102,2.293103448,1855,4972,1559,927,1,926,1,302,0,0.052915767,empty,mBC-0716-2
"E10,B11",16192,15868,11565,4303,7301,0,3411,3415,2394,1021,2.344760039,1588,3067,1034,635,1,634,1,220,0,0.11829653,empty,mBC-0716-2
"E10,B12",16051,16902,12142,4760,8205,20,3709,3734,2613,1121,2.330954505,1891,1609,1024,580,0,580,0,199,0,0.039655172,empty,mBC-0716-2
"E10,C1",1137535,1249144,813388,435756,588548,0,323274,323830,273844,49986,5.478413956,175472,85254,57081,31423,14,31409,2,3050,0,0.00111433,mm10,mBC-0716-2
"E10,C2",16323,16776,12364,4412,8140,0,3720,3732,2638,1094,2.411334552,1790,2891,1436,845,2,843,2,270,0,0.036773428,empty,mBC-0716-2
"E10,C3",19833,20783,14923,5860,10011,1,4636,4650,3221,1429,2.254023793,2291,638,366,244,0,244,0,117,0,0.045081967,empty,mBC-0716-2
"E10,C4",21314,22422,15971,6451,10893,9,5074,5091,3644,1447,2.518313753,2532,4168,1715,1012,1,1011,1,322,0,0.036597428,empty,mBC-0716-2
"E10,C5",15706,16146,11854,4292,7910,0,3750,3751,2662,1089,2.444444444,1833,1465,868,568,0,568,0,253,0,0.014084507,empty,mBC-0716-2
"E10,C6",15663,16024,11734,4290,7913,0,3659,3669,2620,1049,2.497616778,1783,2267,1163,681,0,681,0,265,0,0.046989721,empty,mBC-0716-2
"E10,C7",14895,15825,11109,4716,7701,3,3693,3704,2598,1106,2.349005425,1903,3891,1070,640,1,639,1,215,0,0.021909233,empty,mBC-0716-2
"E10,C8",1142612,1200422,840358,360064,583474,0,294180,294675,246930,47745,5.171850456,152252,122009,80053,44441,24,44417,2,3986,0,0.001575973,mm10,mBC-0716-2
"E10,C9",11174,11747,8421,3326,5731,31,2655,2689,1877,812,2.311576355,1366,817,473,288,2,286,2,141,0,0.031468531,empty,mBC-0716-2
"E10,C10",12467,12789,9258,3531,6302,0,2892,2894,2013,881,2.284903519,1453,1417,874,504,0,504,0,193,0,0.057539683,empty,mBC-0716-2
"E10,C11",10805,11275,8152,3123,5510,2,2601,2611,1798,813,2.211562116,1265,1168,683,393,0,393,0,173,0,0.030534351,empty,mBC-0716-2
"E10,C12",621545,674332,459033,215299,327603,0,169329,169625,141490,28135,5.028967478,89570,78948,51533,28428,19,28409,2,2943,0,0.001372804,mm10,mBC-0716-2
"E10,D1",548529,616190,381371,234819,306409,10,180176,180423,129001,51422,2.50867333,103901,9783,5688,3278,4,3274,1,716,0,0.004276115,mm10,mBC-0716-2
"E10,D2",18760,18861,14228,4633,9332,0,4142,4152,2869,1283,2.236165238,1919,2853,1802,1097,2,1095,1,392,0,0.053881279,empty,mBC-0716-2
"E10,D3",585105,654682,416044,238638,324227,2,184304,184535,137654,46881,2.936242828,103297,42570,26814,15123,8,15115,2,2100,0,0.007674496,mm10,mBC-0716-2
"E10,D4",15219,16048,11373,4675,7976,0,3803,3814,2666,1148,2.322299652,1966,6939,2339,1471,1,1470,1,448,0,0.032653061,empty,mBC-0716-2
"E10,D5",12015,12750,9005,3745,6206,0,2935,2938,2034,904,2.25,1500,1284,769,469,0,469,0,188,0,0.02771855,empty,mBC-0716-2
"E10,D6",11214,11767,8361,3406,5852,0,2794,2799,1961,838,2.340095465,1416,1736,915,575,0,575,0,245,0,0.034782609,empty,mBC-0716-2
"E10,D7",11474,11866,8601,3265,5654,4,2557,2566,1796,770,2.332467532,1208,1572,1002,546,0,546,0,212,0,0.029304029,empty,mBC-0716-2
"E10,D8",14492,15195,10926,4269,7332,1,3402,3406,2437,969,2.51496388,1716,1086,672,415,0,415,0,187,0,0.038554217,empty,mBC-0716-2
"E10,D9",5139,5381,3807,1574,2745,0,1302,1305,913,392,2.329081633,674,2969,1372,796,0,796,0,349,0,0.020100503,empty,mBC-0716-2
"E10,D10",540472,548825,411762,137063,268587,10,121791,122010,86685,35325,2.453927813,59496,7507,4837,2770,2,2768,1,687,0,0.005057803,mm10,mBC-0716-2
"E10,D11",12420,12488,9204,3284,6080,1,2816,2824,2021,803,2.516811955,1337,26258,7823,4599,2,4597,2,1137,0,0.040243637,empty,mBC-0716-2
"E10,D12",18583,18793,13945,4848,9105,0,4162,4165,2947,1218,2.41954023,2002,11067,4394,2649,1,2648,1,682,0,0.174848943,empty,mBC-0716-2
"E10,E1",19533,19326,14938,4388,9456,0,4295,4304,3066,1238,2.476575121,1871,1927,1080,692,1,691,1,290,0,0.037626628,empty,mBC-0716-2
"E10,E2",14696,14896,11115,3781,7267,1,3329,3338,2360,978,2.413087935,1533,11671,3908,2290,5,2285,1,683,0,0.063894967,empty,mBC-0716-2
"E10,E3",11235,11506,8608,2898,5656,0,2557,2564,1812,752,2.409574468,1189,1760,1136,731,0,731,0,314,0,0.030095759,empty,mBC-0716-2
"E10,E4",14112,14688,10793,3895,6983,0,3158,3167,2282,885,2.578531073,1518,1522,893,563,0,563,0,210,0,0.008880995,empty,mBC-0716-2
"E10,E5",20402,21145,15772,5373,10340,2,4551,4567,3215,1352,2.37795858,2124,1939,1096,694,0,694,0,306,0,0.03314121,empty,mBC-0716-2
"E10,E6",12543,12851,9528,3323,6300,11,2891,2910,2033,877,2.318129989,1387,1961,1212,753,0,753,0,297,0,0.018592297,empty,mBC-0716-2
"E10,E7",1082289,1140651,800353,340298,551744,1,277663,278100,227954,50146,4.545806246,143449,119310,70306,39351,25,39326,2,4074,0,0.008238824,mm10,mBC-0716-2
"E10,E8",15762,15670,12034,3636,7833,1,3503,3511,2410,1101,2.188919164,1583,4564,1895,1105,0,1105,0,392,0,0.081447964,empty,mBC-0716-2
"E10,E9",8057,8339,6034,2305,4128,1,1867,1873,1275,598,2.132107023,923,2589,989,578,0,578,0,215,0,0.038062284,empty,mBC-0716-2
"E10,E10",11511,11970,8785,3185,5729,20,2607,2634,1875,759,2.470355731,1193,1369,785,465,0,465,0,184,0,0.079569892,empty,mBC-0716-2
"E10,E11",8467,8853,6441,2412,4440,17,2087,2106,1491,615,2.424390244,1057,1325,790,448,1,447,1,205,0,0.022371365,empty,mBC-0716-2
"E10,E12",13886,14556,10299,4257,7185,12,3380,3396,2320,1076,2.156133829,1726,4322,1666,991,3,988,1,324,0,0.16194332,empty,mBC-0716-2
"E10,F1",16223,16640,12397,4243,8066,16,3583,3608,2579,1029,2.506316812,1731,1765,1110,614,0,614,0,246,0,0.021172638,empty,mBC-0716-2
"E10,F2",743450,799641,539285,260356,389453,14,208965,209341,166654,42687,3.904092581,111091,101761,66099,36649,11,36638,1,3359,0,0.001555762,mm10,mBC-0716-2
"E10,F3",682686,758448,484107,274341,371145,19,208585,208902,171186,37716,4.538816417,116280,135154,88222,48616,28,48588,6,4016,0,0.000967317,mm10,mBC-0716-2
"E10,F4",14070,14111,10456,3655,7088,1,3256,3264,2236,1028,2.175097276,1531,2844,1004,566,0,566,0,203,0,0.033568905,empty,mBC-0716-2
"E10,F5",745233,809119,542527,266592,390375,32,205162,205547,178813,26734,6.688598788,109849,133565,82122,45356,28,45328,3,4036,0,0.000639781,mm10,mBC-0716-2
"E10,F6",20832,20972,15626,5346,10297,12,4768,4797,3375,1422,2.373417722,2322,2554,1540,943,0,943,0,342,0,0.020148462,empty,mBC-0716-2
"E10,F7",17979,18453,13676,4777,9100,5,4051,4071,2882,1189,2.423885618,2006,1173,738,426,0,426,0,179,0,0.03286385,empty,mBC-0716-2
"E10,F8",20150,20769,15372,5397,10073,18,4725,4749,3344,1405,2.380071174,2210,701,411,232,0,232,0,121,0,0.004310345,empty,mBC-0716-2
"E10,F9",13055,13012,10103,2909,6517,0,2912,2921,1994,927,2.151024811,1310,1740,963,609,0,609,0,222,0,0.070607553,empty,mBC-0716-2
"E10,F10",18917,19501,14574,4927,9292,0,4127,4131,2957,1174,2.518739353,1929,1631,1041,599,1,598,1,216,0,0.038461538,empty,mBC-0716-2
"E10,F11",10333,10715,7931,2784,5156,0,2308,2312,1641,671,2.445603577,1087,1061,651,405,0,405,0,194,0,0.037037037,empty,mBC-0716-2
"E10,F12",12821,13252,9771,3481,6453,14,2982,3003,2118,885,2.393220339,1456,209,118,88,0,88,0,60,0,0,empty,mBC-0716-2
"E10,G1",8574,8627,6602,2025,4306,5,1894,1913,1336,577,2.31542461,855,2122,1265,762,0,762,0,239,0,0.027559055,empty,mBC-0716-2
"E10,G2",948167,980848,722457,258391,467696,4,213687,214085,186543,27542,6.773037543,104553,40532,25955,15000,6,14994,1,1943,0,0.002267574,mm10,mBC-0716-2
"E10,G3",508593,531919,381519,150400,262274,16,127163,127409,100679,26730,3.766517022,64305,23026,14807,8507,7,8500,1,1616,0,0.007882353,mm10,mBC-0716-2
"E10,G4",25990,26436,19903,6533,12830,19,5752,5787,4143,1644,2.520072993,2756,183,111,82,0,82,0,61,0,0.024390244,empty,mBC-0716-2
"E10,G5",12215,12355,9197,3158,5973,3,2671,2681,1853,828,2.237922705,1289,1456,874,525,1,524,1,255,0,0.017175573,empty,mBC-0716-2
"E10,G6",928702,965459,683682,281777,459242,6,225537,225947,196528,29419,6.680308644,115730,14250,7721,4059,3,4056,1,975,0,0.00147929,mm10,mBC-0716-2
"E10,G7",920269,1009024,671082,337942,486271,15,258543,258980,209659,49321,4.250907321,138888,165953,106005,58200,25,58175,2,4362,0,0.000979802,mm10,mBC-0716-2
"E10,G8",12904,13387,9812,3575,6457,22,2938,2964,2086,878,2.375854214,1409,1971,1206,742,0,742,0,269,0,0.029649596,empty,mBC-0716-2
"E10,G9",9566,9817,7056,2761,4857,0,2254,2257,1578,679,2.324005891,1128,1570,994,588,0,588,0,229,0,0.051020408,empty,mBC-0716-2
"E10,G10",12209,12699,9464,3235,6153,0,2820,2827,1962,865,2.268208092,1309,1587,960,602,0,602,0,259,0,0.056478405,empty,mBC-0716-2
"E10,G11",10742,10876,8242,2634,5337,0,2423,2430,1687,743,2.270524899,1117,865,516,328,0,328,0,142,0,0.00304878,empty,mBC-0716-2
"E10,G12",895452,1039596,587785,451811,509549,0,337893,338306,256269,82037,3.123822178,199454,38711,24332,13771,5,13766,1,2008,0,0.005375563,mm10,mBC-0716-2
"E10,H1",18621,19391,14363,5028,9355,0,4338,4350,3119,1231,2.533712429,2026,1244,738,461,0,461,0,184,0,0.045553145,empty,mBC-0716-2
"E10,H2",21968,22213,16680,5533,10883,1,4967,4981,3494,1487,2.349697377,2356,9699,3817,2193,1,2192,1,657,0,0.057025547,empty,mBC-0716-2
"E10,H3",853033,923915,609924,313991,444861,0,245014,245407,199264,46143,4.318401491,132121,52836,34463,18847,8,18839,1,2430,0,0.002388662,mm10,mBC-0716-2
"E10,H4",12770,13041,9536,3505,6361,1,3017,3024,2168,856,2.53271028,1433,310,200,141,0,141,0,99,0,0,empty,mBC-0716-2
"E10,H5",1721810,2031914,1134871,897043,966939,3,629302,630148,484193,145955,3.317412901,377903,232698,149351,82819,35,82784,4,5370,0,0.000918052,mm10,mBC-0716-2
"E10,H6",15584,16001,11855,4146,7789,0,3603,3612,2566,1046,2.453154876,1687,2013,1232,730,2,728,1,297,0,0.028846154,empty,mBC-0716-2
"E10,H7",14899,15341,11149,4192,7621,0,3552,3557,2510,1047,2.397325692,1750,1638,990,609,0,609,0,275,0,0.008210181,empty,mBC-0716-2
"E10,H8",13632,14186,10263,3923,6947,2,3291,3299,2383,916,2.601528384,1610,1845,1160,720,1,719,1,296,0,0.041724618,empty,mBC-0716-2
"E10,H9",14671,15067,11081,3986,7287,9,3368,3381,2454,927,2.647249191,1655,1897,1150,713,1,712,1,304,0,0.047752809,empty,mBC-0716-2
"E10,H10",13307,14034,9976,4058,6781,3,3217,3224,2251,973,2.313463515,1602,2021,1071,699,1,698,1,288,0,0.150429799,empty,mBC-0716-2
"E10,H11",14733,15048,11057,3991,7470,0,3457,3463,2414,1049,2.301239276,1669,209,133,104,0,104,0,81,0,0.057692308,empty,mBC-0716-2
"E10,H12",5550,5757,4194,1563,2942,1,1377,1380,992,388,2.556701031,694,716,432,259,0,259,0,126,0,0.065637066,empty,mBC-0716-2
"E11,A1",14002,14245,10321,3924,7234,6,3431,3447,2350,1097,2.142206016,1703,1283,785,485,1,484,1,211,0,0.022727273,empty,mBC-0716-2
"E11,A2",18592,19265,14160,5105,9308,7,4142,4156,2870,1286,2.231726283,1995,1443,889,532,0,532,0,259,0,0.045112782,empty,mBC-0716-2
"E11,A3",16571,17003,12545,4458,8416,0,3919,3929,2753,1176,2.340986395,1878,1398,825,501,0,501,0,224,0,0.027944112,empty,mBC-0716-2
"E11,A4",23393,23707,18041,5666,11311,51,4885,4945,3568,1377,2.59114016,2280,914,510,354,0,354,0,182,0,0.039548023,empty,mBC-0716-2
"E11,A5",17869,18400,13588,4812,9208,0,4249,4260,2942,1318,2.232169954,2036,1912,1097,669,0,669,0,306,0,0.065769806,empty,mBC-0716-2
"E11,A6",12772,13142,9777,3365,6447,3,3004,3009,2126,883,2.407701019,1420,1982,1197,703,0,703,0,321,0,0.032716927,empty,mBC-0716-2
"E11,A7",16452,17431,12330,5101,8563,0,4030,4042,2836,1206,2.351575456,2074,1581,912,558,0,558,0,254,0,0.0609319,empty,mBC-0716-2
"E11,A8",11137,11483,8570,2913,5642,2,2596,2604,1779,825,2.156363636,1208,1714,1004,656,0,656,0,307,0,0.047256098,empty,mBC-0716-2
"E11,A9",21344,21413,16271,5142,10464,0,4664,4674,3324,1350,2.462222222,2155,1600,985,652,0,652,0,269,0,0.070552147,empty,mBC-0716-2
"E11,A10",544401,560055,397170,162885,276504,3,139252,139476,102737,36739,2.796401644,71588,3976,2246,1235,1,1234,1,436,0,0.0089141,mm10,mBC-0716-2
"E11,A11",18822,19412,14416,4996,9517,35,4278,4327,3013,1314,2.292998478,2103,1478,876,562,1,561,1,256,0,0.026737968,empty,mBC-0716-2
"E11,A12",21652,22087,16670,5417,10381,1,4563,4574,3313,1261,2.627279937,2105,2844,1695,1001,0,1001,0,341,0,0.032967033,empty,mBC-0716-2
"E11,B1",966005,1051872,695215,356657,503745,1,272608,273041,230535,42506,5.423587258,147770,78868,51458,29171,13,29158,2,3205,0,0.000891694,mm10,mBC-0716-2
"E11,B2",21333,21852,16085,5767,10790,0,5015,5028,3479,1549,2.245965139,2476,506,308,203,0,203,0,111,0,0.073891626,empty,mBC-0716-2
"E11,B3",21024,21598,15791,5807,10483,54,4830,4898,3523,1375,2.562181818,2349,3993,1610,991,1,990,1,366,0,0.070707071,empty,mBC-0716-2
"E11,B4",20429,21472,15847,5625,10334,3,4871,4886,3570,1316,2.712765957,2298,1420,861,504,0,504,0,227,0,0.067460317,empty,mBC-0716-2
"E11,B5",11235,7461,5081,2380,4534,0,2277,2289,1639,650,2.521538462,1262,1562,710,458,1,457,1,193,0,0.021881838,empty,mBC-0716-2
"E11,B6",760730,881489,507447,374042,431933,8,278371,278733,214429,64304,3.33461371,163490,50790,33275,18743,4,18739,1,2635,0,0.002348044,mm10,mBC-0716-2
"E11,B7",1159662,1280302,828967,451335,608973,27,334835,335321,274478,60843,4.511250267,182689,130035,87020,48220,21,48199,1,3990,0,0.000435694,mm10,mBC-0716-2
"E11,B8",14029,14485,10719,3766,7046,0,3145,3145,2212,933,2.370846731,1502,2874,1303,826,0,826,0,349,0,0.033898305,empty,mBC-0716-2
"E11,B9",16279,16639,12661,3978,7985,26,3631,3667,2603,1064,2.446428571,1624,858,510,280,0,280,0,141,0,0.035714286,empty,mBC-0716-2
"E11,B10",508081,499777,339243,160534,258234,18,138241,138780,108740,30040,3.619840213,73774,7359,3235,1778,2,1776,2,567,0,0.034346847,mm10,mBC-0716-2
"E11,B11",16497,16909,12481,4428,8233,10,3763,3781,2644,1137,2.325417766,1792,320,190,129,0,129,0,94,0,0.054263566,empty,mBC-0716-2
"E11,B12",2050758,2199187,1450498,748689,1066817,23,618463,619372,414168,205204,2.01832323,336514,49887,26890,15074,5,15069,3,2696,0,0.0075652,mm10,mBC-0716-2
"E11,C1",24194,24397,18813,5584,11573,7,4884,4901,3529,1372,2.572157434,2149,808,480,319,0,319,0,194,0,0.006269592,empty,mBC-0716-2
"E11,C2",18429,18561,13924,4637,9055,0,4136,4145,2899,1246,2.326645265,1908,3261,1477,964,1,963,1,355,0,0.050882658,empty,mBC-0716-2
"E11,C3",21669,21898,16314,5584,10522,0,4780,4792,3321,1471,2.257647859,2322,686,434,271,0,271,0,134,0,0.014760148,empty,mBC-0716-2
"E11,C4",1101772,1237920,736924,500996,597370,15,369874,370443,279397,91046,3.068745469,214506,85424,53894,30177,22,30155,2,3073,0,0.000795888,mm10,mBC-0716-2
"E11,C5",914530,1004508,635756,368752,484406,2,278710,279090,221528,57562,3.848511171,155089,55414,36986,20501,10,20491,2,2479,0,0.000927236,mm10,mBC-0716-2
"E11,C6",21148,21726,15793,5933,10990,1,5138,5150,3789,1361,2.783982366,2516,1711,1006,606,0,606,0,270,0,0.061056106,empty,mBC-0716-2
"E11,C7",984562,1142866,651875,490991,552692,2,353551,354015,275006,79009,3.480692073,209619,23727,13878,7874,4,7870,1,1362,0,0.010546379,mm10,mBC-0716-2
"E11,C8",15974,16622,11983,4639,7929,2,3667,3679,2560,1119,2.287756926,1766,15039,4706,2852,1,2851,1,728,0,0.118905647,empty,mBC-0716-2
"E11,C9",13535,14019,10092,3927,6823,0,3186,3193,2178,1015,2.145812808,1631,1121,665,407,0,407,0,185,0,0.061425061,empty,mBC-0716-2
"E11,C10",14966,15525,11202,4323,7723,9,3629,3642,2538,1104,2.298913043,1841,1494,899,542,0,542,0,230,0,0.062730627,empty,mBC-0716-2
"E11,C11",11848,12504,8857,3647,6100,0,2888,2899,2030,869,2.336018412,1435,1207,722,438,0,438,0,212,0,0.01826484,empty,mBC-0716-2
"E11,C12",791398,868042,560818,307224,418536,1,234608,234981,186802,48179,3.877249424,129246,77701,51704,29098,14,29084,1,2844,0,0.00065328,mm10,mBC-0716-2
"E11,D1",11498,11766,8587,3179,5861,0,2807,2814,1964,850,2.310588235,1362,5451,1795,1104,2,1102,1,350,0,0.08892922,empty,mBC-0716-2
"E11,D2",1014169,1111726,726312,385414,534911,24,296684,297160,236535,60625,3.901608247,161203,166862,108859,60690,25,60665,3,4552,0,0.00103849,mm10,mBC-0716-2
"E11,D3",14182,14701,10700,4001,7253,0,3452,3455,2401,1054,2.277988615,1674,5129,2124,1306,0,1306,0,466,0,0.016845329,empty,mBC-0716-2
"E11,D4",15774,16010,11694,4316,7935,0,3680,3689,2638,1051,2.509990485,1737,12853,4531,2810,4,2806,3,830,0,0.081610834,empty,mBC-0716-2
"E11,D5",16139,16779,12370,4409,8448,0,3858,3862,2766,1096,2.523722628,1861,2067,1034,648,0,648,0,248,0,0.013888889,empty,mBC-0716-2
"E11,D6",12677,13410,9347,4063,6520,0,3148,3154,2256,898,2.512249443,1600,1671,1001,592,0,592,0,257,0,0.032094595,empty,mBC-0716-2
"E11,D7",13446,13790,10059,3731,6468,18,3010,3032,2090,942,2.218683652,1497,7107,2431,1503,2,1501,1,486,0,0.036642239,empty,mBC-0716-2
"E11,D8",16854,17464,12740,4724,8607,0,4147,4155,2904,1251,2.321342926,1997,1318,776,488,0,488,0,228,0,0.053278689,empty,mBC-0716-2
"E11,D9",462475,498115,319491,178624,248180,7,138434,138648,108542,30106,3.605327842,77415,210135,117899,66181,32,66149,4,5257,0,0.009493719,mm10,mBC-0716-2
"E11,D10",634901,695447,462159,233288,341058,1,183367,183684,146188,37496,3.898762535,98967,45674,30035,16885,6,16879,1,2192,0,0.001718111,mm10,mBC-0716-2
"E11,D11",13705,14315,10285,4030,6948,0,3244,3247,2259,988,2.286437247,1612,2146,1306,784,1,783,1,345,0,0.054916986,empty,mBC-0716-2
"E11,D12",21335,21950,16103,5847,10646,11,4847,4867,3333,1534,2.172750978,2369,2849,1732,1003,0,1003,0,376,0,0.049850449,empty,mBC-0716-2
"E11,E1",23463,24069,17672,6397,11651,5,5324,5341,3698,1643,2.250760803,2589,1817,1126,697,0,697,0,329,0,0.047345768,empty,mBC-0716-2
"E11,E2",16782,17185,12689,4496,8249,25,3735,3769,2645,1124,2.353202847,1745,1588,866,563,1,562,1,254,0,0.040925267,empty,mBC-0716-2
"E11,E3",13094,13039,9939,3100,6628,0,3017,3018,2137,881,2.425652667,1398,1811,1164,728,1,727,1,341,0,0.027510316,empty,mBC-0716-2
"E11,E4",16253,16731,12033,4698,8168,0,3813,3823,2728,1095,2.491324201,1879,1385,801,490,0,490,0,239,0,0.008163265,empty,mBC-0716-2
"E11,E5",22425,22755,17268,5487,11183,8,4916,4933,3399,1534,2.21577575,2266,1963,1218,780,0,780,0,370,0,0.021794872,empty,mBC-0716-2
"E11,E6",633786,645289,492373,152916,313002,34,136198,136510,83168,53342,1.559146639,64793,19046,12233,6863,0,6863,0,1300,0,0.002039924,mm10,mBC-0716-2
"E11,E7",14026,14477,10630,3847,7063,2,3207,3217,2254,963,2.340602285,1565,1648,874,545,0,545,0,254,0,0.060550459,empty,mBC-0716-2
"E11,E8",18637,18963,14241,4722,9190,0,4129,4141,2862,1279,2.237685692,1963,2339,1295,819,0,819,0,315,0,0.063492063,empty,mBC-0716-2
"E11,E9",9093,9290,6792,2498,4643,0,2205,2216,1478,738,2.002710027,1103,1211,721,431,1,430,1,188,0,0.025581395,empty,mBC-0716-2
"E11,E10",13608,13645,10168,3477,6853,13,3111,3140,2194,946,2.319238901,1486,1613,919,588,0,588,0,264,0,0.044217687,empty,mBC-0716-2
"E11,E11",9597,10032,7247,2785,5035,2,2374,2379,1642,737,2.227951153,1184,7138,2330,1400,4,1396,1,449,0,0.017908309,empty,mBC-0716-2
"E11,E12",15861,16650,11936,4714,8279,0,3985,3995,2811,1184,2.374155405,1980,1305,802,512,0,512,0,189,0,0.01171875,empty,mBC-0716-2
"E11,F1",1853662,2078334,1301920,776414,985312,2,583354,584143,459726,124417,3.695041674,328035,210899,137925,76232,27,76205,2,5052,0,0.002230825,mm10,mBC-0716-2
"E11,F2",27557,28153,20767,7386,13625,14,6298,6331,4423,1908,2.318134172,3017,4107,2507,1519,0,1519,0,543,0,0.037524687,empty,mBC-0716-2
"E11,F3",775693,846330,557849,288481,410771,2,220939,221251,188004,33247,5.654765844,119738,140990,89552,49993,33,49960,1,4176,0,0.000880705,mm10,mBC-0716-2
"E11,F4",15253,15360,11523,3837,7703,0,3461,3465,2400,1065,2.253521127,1615,671,383,247,0,247,0,119,0,0.020242915,empty,mBC-0716-2
"E11,F5",25146,26125,19423,6702,12757,0,5879,5891,4163,1728,2.409143519,2883,6103,2359,1475,2,1473,2,574,0,0.032586558,empty,mBC-0716-2
"E11,F6",23416,23963,17608,6355,11523,27,5350,5389,3793,1596,2.376566416,2588,2557,1552,958,0,958,0,362,0,0.038622129,empty,mBC-0716-2
"E11,F7",21778,22127,16512,5615,11007,9,4995,5022,3593,1429,2.514345696,2384,1068,625,401,0,401,0,211,0,0.014962594,empty,mBC-0716-2
"E11,F8",23789,24646,17849,6797,12192,0,5737,5752,4062,1690,2.403550296,2927,477,306,219,0,219,0,132,0,0.00456621,empty,mBC-0716-2
"E11,F9",15562,15616,11937,3679,7669,0,3418,3433,2346,1087,2.158233671,1619,1879,1063,651,0,651,0,278,0,0.076804916,empty,mBC-0716-2
"E11,F10",1994805,2098778,1456223,642555,987371,1,522569,523432,437482,85950,5.089959279,271316,86767,56929,31499,9,31490,1,3381,0,0.006986345,mm10,mBC-0716-2
"E11,F11",11668,11768,8890,2878,5771,4,2522,2533,1719,814,2.111793612,1191,2049,961,604,0,604,0,245,0,0.031456954,empty,mBC-0716-2
"E11,F12",14950,15244,11275,3969,7315,0,3388,3392,2377,1015,2.341871921,1576,279,186,132,0,132,0,72,0,0,empty,mBC-0716-2
"E11,G1",428113,455647,319722,135925,226254,0,115418,115576,85923,29653,2.897615756,59192,37147,23403,13281,13,13268,1,1944,0,0.002034971,mm10,mBC-0716-2
"E11,G2",23199,23981,17687,6294,11501,9,5139,5155,3696,1459,2.533241947,2460,848,544,369,0,369,0,214,0,0.046070461,empty,mBC-0716-2
"E11,G3",20353,21104,15433,5671,10127,0,4548,4559,3157,1402,2.251783167,2168,2674,1457,914,0,914,0,421,0,0.016411379,empty,mBC-0716-2
"E11,G4",2309472,2469801,1681139,788662,1145311,12,616678,617653,519332,98321,5.282004862,324485,1995,1244,685,0,685,0,234,0,0,empty,mBC-0716-2
"E11,G5",866157,922135,636814,285321,442513,56,225040,225498,191077,34421,5.551175155,116839,95459,62853,35563,13,35550,2,3266,0,0.001040788,mm10,mBC-0716-2
"E11,G6",1661250,1793029,1215012,578017,858696,1,463960,464688,351007,113681,3.087648772,245693,6690,4351,2487,3,2484,1,597,0,0.000402576,mm10,mBC-0716-2
"E11,G7",21420,21719,16615,5104,10546,0,4638,4647,3275,1372,2.387026239,2101,2305,1296,785,0,785,0,317,0,0.05477707,empty,mBC-0716-2
"E11,G8",14839,15419,11169,4250,7645,0,3624,3631,2539,1092,2.325091575,1826,1814,1095,678,1,677,1,315,0,0.06351551,empty,mBC-0716-2
"E11,G9",11005,11340,8372,2968,5611,4,2603,2611,1831,780,2.347435897,1234,2658,1314,848,0,848,0,375,0,0.048349057,empty,mBC-0716-2
"E11,G10",13914,14146,10408,3738,7188,1,3270,3277,2254,1023,2.203323558,1606,1638,1058,691,0,691,0,302,0,0.026049204,empty,mBC-0716-2
"E11,G11",709043,749817,530053,219764,365026,4,179314,179634,149430,30204,4.947357966,91428,38398,24968,14262,5,14257,1,1930,0,0.002665357,mm10,mBC-0716-2
"E11,G12",11901,12244,8861,3383,5991,2,2721,2730,1928,802,2.403990025,1364,1410,809,491,0,491,0,205,0,0.038696538,empty,mBC-0716-2
"E11,H1",4433824,4832623,3154254,1678369,2173735,14,1295215,1297128,1102166,194962,5.653234989,700619,226665,145841,80656,40,80616,5,5285,0,0.002369257,mm10,mBC-0716-2
"E11,H2",29049,29872,21778,8094,14559,5,6950,6973,5134,1839,2.791734638,3354,2776,1764,1097,1,1096,1,423,0,0.047445255,empty,mBC-0716-2
"E11,H3",20882,21636,15754,5882,10375,0,4876,4887,3396,1491,2.277665996,2330,2376,1261,772,3,769,1,339,0,0.054616385,empty,mBC-0716-2
"E11,H4",14174,14595,10605,3990,7217,0,3439,3447,2410,1037,2.324011572,1738,265,170,129,0,129,0,98,0,0.007751938,empty,mBC-0716-2
"E11,H5",18813,19695,14055,5640,9437,22,4388,4418,3080,1338,2.301943199,2208,1506,860,539,1,538,1,264,0,0.016728625,empty,mBC-0716-2
"E11,H6",14396,14859,10675,4184,7369,0,3509,3517,2438,1079,2.259499537,1735,15767,4900,2914,1,2913,1,834,0,0.017164435,empty,mBC-0716-2
"E11,H7",17488,17830,12913,4917,8874,1,4118,4126,2859,1267,2.256511444,2028,1544,965,624,0,624,0,287,0,0.040064103,empty,mBC-0716-2
"E11,H8",752226,862475,494048,368427,418642,0,270636,270941,193182,77759,2.484368369,160067,53514,33070,18506,4,18502,1,2468,0,0.002053832,mm10,mBC-0716-2
"E11,H9",953144,1027595,671416,356179,494643,0,273984,274400,231927,42473,5.460574953,149435,107299,67302,38051,18,38033,5,3509,0,0.000972839,mm10,mBC-0716-2
"E11,H10",15901,16425,11926,4499,8085,0,3800,3814,2707,1107,2.445347787,1907,2593,1431,912,0,912,0,358,0,0.046052632,empty,mBC-0716-2
"E11,H11",17089,17755,12866,4889,8732,4,3985,4008,2884,1124,2.565836299,1974,311,182,122,0,122,0,83,0,0.008196721,empty,mBC-0716-2
"E11,H12",5729,5963,4260,1703,2961,0,1356,1359,952,407,2.339066339,674,719,408,250,0,250,0,131,0,0.04,empty,mBC-0716-2
"E12,A1",13872,14372,10521,3851,6995,25,3162,3194,2256,938,2.405117271,1576,1463,887,550,1,549,1,247,0,0.025500911,empty,mBC-0716-2
"E12,A2",18172,18213,14058,4155,8894,16,3930,3954,2760,1194,2.311557789,1813,1277,795,515,0,515,0,245,0,0.07961165,empty,mBC-0716-2
"E12,A3",16700,17586,12406,5180,8430,2,3964,3973,2843,1130,2.515929204,1992,9723,3090,1866,2,1864,1,535,0,0.042381974,empty,mBC-0716-2
"E12,A4",22224,22505,17248,5257,10789,0,4720,4735,3389,1346,2.517830609,2138,1044,609,378,0,378,0,157,0,0.029100529,empty,mBC-0716-2
"E12,A5",17333,17926,13034,4892,8814,1,4105,4115,2801,1314,2.131659056,2057,6673,2531,1530,1,1529,1,507,0,0.062132112,empty,mBC-0716-2
"E12,A6",707434,808205,476362,331843,394715,16,247054,247396,200480,46916,4.273169068,142778,66133,42195,23553,15,23538,4,2802,0,0.005353046,mm10,mBC-0716-2
"E12,A7",16494,17100,12615,4485,8287,0,3774,3781,2614,1167,2.239931448,1829,1322,805,524,0,524,0,229,0,0.030534351,empty,mBC-0716-2
"E12,A8",225915,225717,174062,51655,114101,0,47330,47419,36930,10489,3.520831347,22273,9100,5869,3342,3,3339,1,936,0,0.010781671,empty,mBC-0716-2
"E12,A9",20426,21138,15600,5538,10093,7,4622,4640,3361,1279,2.627834246,2253,1589,977,597,1,596,1,282,0,0.025167785,empty,mBC-0716-2
"E12,A10",15996,16525,12072,4453,8004,0,3652,3662,2505,1157,2.165082109,1831,615,348,223,0,223,0,132,0,0.01793722,empty,mBC-0716-2
"E12,A11",17342,17908,13236,4672,8775,0,3963,3971,2722,1249,2.179343475,1875,2994,1163,712,1,711,1,286,0,0.016877637,empty,mBC-0716-2
"E12,A12",823643,884237,607232,277005,422526,2,218521,218880,171649,47231,3.634244458,114065,116606,78286,44409,18,44391,2,3750,0,0.00193733,mm10,mBC-0716-2
"E12,B1",19800,20548,15255,5293,9916,0,4359,4367,3092,1275,2.425098039,2085,1825,1025,602,1,601,1,220,0,0.06156406,empty,mBC-0716-2
"E12,B2",21150,21691,15967,5724,10308,0,4652,4667,3226,1441,2.238723109,2228,1716,685,425,0,425,0,160,0,0.063529412,empty,mBC-0716-2
"E12,B3",19015,19523,14626,4897,9618,15,4441,4461,3070,1391,2.207045291,2161,1393,902,551,0,551,0,228,0,0.041742287,empty,mBC-0716-2
"E12,B4",17410,17986,13355,4631,8583,8,3816,3841,2704,1137,2.378188215,1810,1611,801,507,0,507,0,239,0,0.065088757,empty,mBC-0716-2
"E12,B5",10627,7048,4889,2159,4291,14,2084,2112,1517,595,2.549579832,1160,979,557,326,0,326,0,152,0,0.079754601,empty,mBC-0716-2
"E12,B6",678129,719500,471737,247763,351542,23,198140,198439,120451,77988,1.544481202,110086,10837,5570,3306,1,3305,1,884,0,0.005748865,mm10,mBC-0716-2
"E12,B7",735179,747846,547906,199940,365828,1,176286,176604,142817,33787,4.226980791,86565,7028,4058,2299,0,2299,0,687,0,0.017398869,mm10,mBC-0716-2
"E12,B8",13800,14451,10589,3862,7100,0,3259,3269,2285,984,2.322154472,1583,1319,782,519,0,519,0,275,0,0.011560694,empty,mBC-0716-2
"E12,B9",15489,16195,11880,4315,7895,26,3536,3567,2494,1073,2.324324324,1739,831,555,353,1,352,1,168,0,0.008522727,empty,mBC-0716-2
"E12,B10",511486,501231,353280,147951,257309,1,128984,129522,100282,29240,3.429616963,66534,13533,6784,3940,3,3937,1,938,0,0.055372111,mm10,mBC-0716-2
"E12,B11",16016,16776,12134,4642,7971,11,3712,3730,2604,1126,2.312611012,1786,377,218,142,0,142,0,91,0,0,empty,mBC-0716-2
"E12,B12",18818,19118,14326,4792,9295,0,4276,4287,3051,1236,2.468446602,2005,1403,815,481,0,481,0,202,0,0.018711019,empty,mBC-0716-2
"E12,C1",23919,24283,18510,5773,11494,2,4909,4922,3407,1515,2.248844884,2252,842,566,326,0,326,0,159,0,0.033742331,empty,mBC-0716-2
"E12,C2",17680,17840,13395,4445,8743,9,3970,3993,2784,1209,2.302729529,1864,1705,1014,644,0,644,0,248,0,0.048136646,empty,mBC-0716-2
"E12,C3",20892,22001,15827,6174,10346,0,4797,4806,3295,1511,2.18067505,2418,1167,555,367,0,367,0,160,0,0.029972752,empty,mBC-0716-2
"E12,C4",17362,17419,13398,4021,8599,0,3768,3774,2572,1202,2.139767055,1738,3044,1254,738,0,738,0,265,0,0.013550136,empty,mBC-0716-2
"E12,C5",888689,975140,631376,343764,470406,2,261656,262051,212563,49488,4.295243291,143791,88061,58134,32978,18,32960,2,3285,0,0.001668689,mm10,mBC-0716-2
"E12,C6",16165,16497,12100,4397,8240,23,3729,3757,2691,1066,2.524390244,1809,1534,902,560,0,560,0,267,0,0.028571429,empty,mBC-0716-2
"E12,C7",16909,17259,12920,4339,8528,0,3985,3990,2808,1182,2.375634518,1869,429,252,162,1,161,1,85,0,0.02484472,empty,mBC-0716-2
"E12,C8",687049,703630,503647,199983,345180,5,169538,169840,120894,48946,2.469946472,87641,23471,15187,8560,4,8556,2,1595,0,0.00315568,mm10,mBC-0716-2
"E12,C9",13558,13879,10202,3677,6670,1,3084,3094,2178,916,2.377729258,1525,868,503,344,0,344,0,178,0,0.049418605,empty,mBC-0716-2
"E12,C10",688938,710715,534555,176160,345574,2,149679,149925,118425,31500,3.75952381,72683,3060,1472,884,2,882,1,416,0,0.026077098,empty,mBC-0716-2
"E12,C11",12164,12764,9129,3635,6191,40,2887,2929,2039,890,2.291011236,1436,1109,715,384,0,384,0,181,0,0.03125,empty,mBC-0716-2
"E12,C12",20332,21040,15486,5554,9955,0,4562,4579,3153,1426,2.211079944,2206,2747,1200,730,1,729,1,258,0,0.064471879,empty,mBC-0716-2
"E12,D1",11257,11751,8558,3193,5917,0,2785,2799,1889,910,2.075824176,1421,668,389,255,0,255,0,120,0,0.125490196,empty,mBC-0716-2
"E12,D2",22861,22870,17234,5636,11039,0,4891,4897,3444,1453,2.37026841,2245,32595,10286,6294,6,6288,2,1428,0,0.069497455,empty,mBC-0716-2
"E12,D3",13621,14299,10052,4247,7038,15,3396,3422,2362,1060,2.228301887,1732,1413,827,511,0,511,0,274,0,0.066536204,empty,mBC-0716-2
"E12,D4",868185,984752,602398,382354,479651,1,285653,286086,214263,71823,2.983208721,163936,90304,49444,27950,14,27936,2,3238,0,0.017898053,mm10,mBC-0716-2
"E12,D5",542972,560052,394501,165551,278488,2,142847,143095,112141,30954,3.622827421,73616,17401,7235,4225,3,4222,1,1127,0,0.018948366,mm10,mBC-0716-2
"E12,D6",1183086,1321961,816448,505513,642287,6,375696,376331,300777,75554,3.98095402,215395,16079,8629,4749,1,4748,1,1474,0,0.00716091,mm10,mBC-0716-2
"E12,D7",12590,13126,9660,3466,6328,4,2971,2980,2038,942,2.163481953,1388,1464,852,521,1,520,1,224,0,0.013461538,empty,mBC-0716-2
"E12,D8",902931,989183,651767,337416,476716,6,258092,258483,220878,37605,5.873633825,139665,72606,47732,27177,14,27163,2,2797,0,0.001251703,mm10,mBC-0716-2
"E12,D9",4334,4436,3206,1230,2294,14,1129,1145,799,346,2.309248555,558,9841,3207,1926,3,1923,1,632,0,0.075403016,empty,mBC-0716-2
"E12,D10",15077,15893,11356,4537,7851,0,3724,3731,2633,1098,2.397996357,1917,991,563,346,0,346,0,147,0,0.054913295,empty,mBC-0716-2
"E12,D11",13638,13661,10329,3332,6673,3,3054,3060,2154,906,2.377483444,1423,6006,2536,1571,0,1571,0,478,0,0.155951623,empty,mBC-0716-2
"E12,D12",20581,21203,15814,5389,10244,0,4549,4558,3180,1378,2.307692308,2180,3175,1687,1034,0,1034,0,354,0,0.041586074,empty,mBC-0716-2
"E12,E1",22046,22595,16915,5680,10891,15,4827,4851,3468,1383,2.507592191,2282,6267,2334,1428,2,1426,2,469,0,0.050490884,empty,mBC-0716-2
"E12,E2",16495,16605,12528,4077,8084,0,3658,3668,2590,1078,2.402597403,1708,8206,2957,1814,2,1812,1,522,0,0.112582781,empty,mBC-0716-2
"E12,E3",47064,46682,34471,12211,22278,0,10086,10115,8086,2029,3.985214391,4896,7959,5155,2950,2,2948,1,703,0,0.014246947,empty,mBC-0716-2
"E12,E4",1545389,1698125,1071440,626685,789146,4,460496,461246,390928,70318,5.559430018,257159,170962,98834,56179,22,56157,2,4478,0,0.012322596,mm10,mBC-0716-2
"E12,E5",21858,22162,16992,5170,10761,11,4651,4676,3344,1332,2.510510511,2162,1678,1029,627,2,625,1,293,0,0.0416,empty,mBC-0716-2
"E12,E6",13440,13714,10245,3469,6672,0,2970,2977,2059,918,2.24291939,1382,4973,2076,1226,0,1226,0,433,0,0.064437194,empty,mBC-0716-2
"E12,E7",863141,950393,608275,342118,454492,15,252376,252769,209003,43766,4.775464973,138753,171855,113480,63606,25,63581,1,4602,0,0.000943678,mm10,mBC-0716-2
"E12,E8",18351,18636,14079,4557,9071,0,3964,3971,2719,1252,2.17172524,1869,1912,1196,737,0,737,0,265,0,0.069199457,empty,mBC-0716-2
"E12,E9",8609,8676,6567,2109,4259,2,1957,1962,1340,622,2.154340836,883,1035,625,368,0,368,0,180,0,0.027173913,empty,mBC-0716-2
"E12,E10",13877,14580,10475,4105,6928,46,3167,3221,2238,983,2.276703967,1564,5672,2188,1318,0,1318,0,413,0,0.097116844,empty,mBC-0716-2
"E12,E11",1539088,1638730,1130607,508123,788119,6,407961,408627,343571,65056,5.281157772,213168,224464,141642,79145,27,79118,3,5076,0,0.002641624,mm10,mBC-0716-2
"E12,E12",407955,410065,303008,107057,205716,3,96664,96837,73507,23330,3.150750107,47893,7095,4176,2300,0,2300,0,686,0,0.01826087,mm10,mBC-0716-2
"E12,F1",18404,18583,13963,4620,9020,0,4046,4055,2846,1209,2.35401158,1855,1640,1013,644,1,643,1,265,0,0.027993779,empty,mBC-0716-2
"E12,F2",22889,23500,17405,6095,11376,14,5315,5339,3779,1560,2.422435897,2472,3087,1906,1193,0,1193,0,502,0,0.027661358,empty,mBC-0716-2
"E12,F3",16752,17651,12733,4918,8612,0,4032,4044,2864,1180,2.427118644,2046,1956,1202,705,0,705,0,313,0,0.026950355,empty,mBC-0716-2
"E12,F4",15861,15933,11924,4009,7983,7,3611,3631,2512,1119,2.244861483,1732,538,321,209,0,209,0,120,0,0.033492823,empty,mBC-0716-2
"E12,F5",25034,25718,18992,6726,12480,0,5699,5719,4015,1704,2.356220657,2773,3012,1596,996,0,996,0,397,0,0.041164659,empty,mBC-0716-2
"E12,F6",22979,23550,17193,6357,11404,4,5359,5384,3718,1666,2.231692677,2588,2152,1341,777,0,777,0,309,0,0.028314028,empty,mBC-0716-2
"E12,F7",2186090,2431635,1532692,898943,1154007,6,683502,684536,536199,148337,3.614735366,382671,71891,47191,26103,7,26096,1,2852,0,0.001839362,mm10,mBC-0716-2
"E12,F8",644046,705976,459020,246956,348878,32,195981,196303,139138,57165,2.433971836,107923,3282,1913,1155,0,1155,0,381,0,0.028571429,mm10,mBC-0716-2
"E12,F9",1226618,1377145,802700,574445,653582,14,416876,417436,327479,89957,3.640394855,238881,208107,131423,73187,25,73162,5,5052,0,0.002678986,mm10,mBC-0716-2
"E12,F10",1019870,1071395,777624,293771,508818,3,237062,237533,197996,39537,5.00786605,117998,129929,83590,46528,26,46502,3,3878,0,0.000838674,mm10,mBC-0716-2
"E12,F11",11068,11413,8377,3036,5553,3,2456,2470,1695,775,2.187096774,1168,1069,714,450,0,450,0,226,0,0.028888889,empty,mBC-0716-2
"E12,F12",14792,15355,11349,4006,7283,14,3328,3352,2329,1023,2.276637341,1561,246,138,92,0,92,0,60,0,0,empty,mBC-0716-2
"E12,G1",10700,11273,8159,3114,5417,51,2393,2445,1679,766,2.191906005,1192,1704,1018,666,0,666,0,250,0,0.055555556,empty,mBC-0716-2
"E12,G2",140355,128793,120837,7956,64974,0,8124,8171,5697,2474,2.302748585,3123,1321,798,486,0,486,0,243,0,0.002057613,empty,mBC-0716-2
"E12,G3",20145,20845,15246,5599,10031,13,4674,4694,3229,1465,2.204095563,2241,2331,1439,864,0,864,0,350,0,0.049768519,empty,mBC-0716-2
"E12,G4",29086,30213,22276,7937,14394,4,6420,6436,4503,1933,2.329539576,3145,208,130,98,0,98,0,84,0,0.020408163,empty,mBC-0716-2
"E12,G5",969974,1046308,695404,350904,497133,0,270912,271303,222263,49040,4.532279772,145732,70683,42256,23794,21,23773,3,2593,0,0.002061162,mm10,mBC-0716-2
"E12,G6",24505,24737,18933,5804,12022,5,5204,5225,3756,1469,2.556841389,2360,257,140,97,0,97,0,74,0,0,empty,mBC-0716-2
"E12,G7",20991,21245,16313,4932,10360,0,4620,4631,3250,1381,2.353367125,2094,1948,1119,749,0,749,0,318,0,0.073431242,empty,mBC-0716-2
"E12,G8",14711,15382,11035,4347,7410,0,3439,3454,2413,1041,2.317963497,1736,1548,920,573,0,573,0,291,0,0.010471204,empty,mBC-0716-2
"E12,G9",11089,11570,8392,3178,5639,0,2630,2631,1826,805,2.268322981,1295,2112,1073,675,0,675,0,285,0,0.026666667,empty,mBC-0716-2
"E12,G10",14106,14463,10873,3590,6996,0,3146,3153,2264,889,2.546681665,1455,1603,1053,662,0,662,0,291,0,0.058912387,empty,mBC-0716-2
"E12,G11",12605,12936,9506,3430,6262,7,2816,2834,1988,846,2.349881797,1383,966,533,334,0,334,0,153,0,0.026946108,empty,mBC-0716-2
"E12,G12",11747,11812,8674,3138,5894,2,2739,2756,1931,825,2.340606061,1345,1154,684,459,0,459,0,188,0,0.052287582,empty,mBC-0716-2
"E12,H1",21317,21764,15980,5784,10659,2,4853,4864,3515,1349,2.605633803,2321,2661,1064,669,0,669,0,266,0,0.050822123,empty,mBC-0716-2
"E12,H2",24851,25402,18933,6469,12258,39,5631,5674,3964,1710,2.318128655,2696,3864,1873,1206,0,1206,0,455,0,0.035655058,empty,mBC-0716-2
"E12,H3",783921,891003,533400,357603,435026,0,269363,269713,204976,64737,3.166288212,156493,38385,25057,14038,6,14032,1,2021,0,0.003563284,mm10,mBC-0716-2
"E12,H4",13860,14278,10297,3981,6911,5,3272,3279,2311,968,2.387396694,1594,316,190,137,0,137,0,98,0,0.03649635,empty,mBC-0716-2
"E12,H5",1746043,1744524,1394825,349699,804916,0,333742,334459,266814,67645,3.944327001,149098,147134,96081,53372,23,53349,1,4304,0,0.000787269,mm10,mBC-0716-2
"E12,H6",13531,13842,10146,3696,6783,4,3157,3174,2193,981,2.235474006,1535,1900,1136,687,0,687,0,283,0,0.03202329,empty,mBC-0716-2
"E12,H7",17040,17449,12851,4598,8615,0,3933,3942,2756,1186,2.323777403,1858,1815,994,653,1,652,1,280,0,0.010736196,empty,mBC-0716-2
"E12,H8",13554,14099,10323,3776,6832,0,3167,3182,2205,977,2.256908905,1563,2042,1193,731,0,731,0,333,0,0.017783858,empty,mBC-0716-2
"E12,H9",15619,16005,11800,4205,7930,15,3649,3666,2577,1089,2.366391185,1838,1632,1021,637,1,636,1,312,0,0.045597484,empty,mBC-0716-2
"E12,H10",14136,14450,10646,3804,6958,5,3222,3234,2195,1039,2.112608277,1532,1693,1009,657,0,657,0,333,0,0.03652968,empty,mBC-0716-2
"E12,H11",16764,18075,12641,5434,8621,0,4056,4064,2852,1212,2.353135314,2048,321,191,122,0,122,0,88,0,0.032786885,empty,mBC-0716-2
"E12,H12",6005,6287,4573,1714,3081,0,1444,1446,1014,432,2.347222222,736,662,415,249,0,249,0,118,0,0.040160643,empty,mBC-0716-2
"F1,A1",14451,15126,10793,4333,7672,9,3633,3643,2557,1086,2.354511971,1848,1204,669,409,0,409,0,180,0,0.026894866,empty,mBC-0716-2
"F1,A2",19467,19620,14988,4632,9438,13,4150,4173,2958,1215,2.434567901,1879,1470,953,570,0,570,0,230,0,0.070175439,empty,mBC-0716-2
"F1,A3",740075,790390,543094,247296,386469,0,199279,199596,161666,37930,4.262219879,104363,69626,45722,25751,15,25736,1,2757,0,0.003846752,mm10,mBC-0716-2
"F1,A4",21672,22080,16834,5246,10672,0,4749,4754,3352,1402,2.390870185,2143,9124,2656,1581,4,1577,3,503,0,0.014584654,empty,mBC-0716-2
"F1,A5",934534,1027109,661672,365437,502168,4,292106,292521,213753,78768,2.713703534,160794,25629,12843,7283,0,7283,0,1457,0,0.013593299,mm10,mBC-0716-2
"F1,A6",552200,603224,390524,212700,298521,0,168681,168876,114348,54528,2.097051056,94051,16606,10129,5583,7,5576,2,1169,0,0.004304161,mm10,mBC-0716-2
"F1,A7",17699,18479,13577,4902,9024,25,4189,4222,2943,1279,2.301016419,2072,1391,783,469,0,469,0,178,0,0.046908316,empty,mBC-0716-2
"F1,A8",11143,11348,8647,2701,5534,17,2391,2411,1674,737,2.271370421,1082,1496,826,514,0,514,0,219,0,0.03307393,empty,mBC-0716-2
"F1,A9",20813,21528,15928,5600,10447,0,4655,4658,3341,1317,2.53682612,2187,1282,699,429,1,428,1,192,0,0.051401869,empty,mBC-0716-2
"F1,A10",16231,16331,12365,3966,8030,0,3660,3667,2530,1137,2.225153914,1658,429,283,184,0,184,0,90,0,0.027173913,empty,mBC-0716-2
"F1,A11",18568,18853,14204,4649,9208,0,4018,4035,2815,1220,2.307377049,1827,1152,645,411,0,411,0,183,0,0.00486618,empty,mBC-0716-2
"F1,A12",20979,21090,16060,5030,10215,2,4443,4452,3156,1296,2.435185185,2058,2943,1819,1054,0,1054,0,295,0,0.207779886,empty,mBC-0716-2
"F1,B1",19205,19762,14707,5055,9684,0,4358,4371,3046,1325,2.298867925,2066,1010,623,377,0,377,0,158,0,0.013262599,empty,mBC-0716-2
"F1,B2",21559,22225,16433,5792,10659,70,4742,4820,3389,1431,2.368273934,2268,471,238,158,1,157,1,82,0,0.057324841,empty,mBC-0716-2
"F1,B3",830033,891599,612498,279101,434651,6,229368,229748,156789,72959,2.149001494,121737,29291,17721,9951,6,9945,2,1577,0,0.005128205,mm10,mBC-0716-2
"F1,B4",17127,18254,13181,5073,8782,13,4077,4099,2833,1266,2.237756714,2025,1186,649,403,1,402,1,162,0,0.119402985,empty,mBC-0716-2
"F1,B5",13872,10296,7135,3161,5985,0,2851,2881,2077,804,2.583333333,1569,882,544,327,0,327,0,161,0,0.021406728,empty,mBC-0716-2
"F1,B6",12448,12929,9428,3501,6526,0,3099,3110,2187,923,2.369447454,1527,1302,803,504,0,504,0,192,0,0.061507937,empty,mBC-0716-2
"F1,B7",17056,17424,13186,4238,8580,20,3821,3859,2678,1181,2.267569856,1780,937,532,347,0,347,0,161,0,0.069164265,empty,mBC-0716-2
"F1,B8",14848,15377,11232,4145,7460,0,3472,3477,2404,1073,2.240447344,1731,2754,1273,764,0,764,0,289,0,0.176701571,empty,mBC-0716-2
"F1,B9",15476,15881,11825,4056,7716,8,3432,3449,2440,1009,2.418235877,1638,832,457,283,0,283,0,130,0,0.035335689,empty,mBC-0716-2
"F1,B10",17214,17068,12686,4382,8560,4,3877,3898,2702,1196,2.259197324,1844,768,470,277,0,277,0,107,0,0.054151625,empty,mBC-0716-2
"F1,B11",19768,20788,15211,5577,10064,0,4564,4575,3209,1366,2.349194729,2234,284,162,101,0,101,0,63,0,0.01980198,empty,mBC-0716-2
"F1,B12",1002332,1167694,659905,507789,570242,1,372711,373252,298806,74446,4.013728071,220462,56060,36573,20048,10,20038,2,2425,0,0.001946302,mm10,mBC-0716-2
"F1,C1",22674,22794,17453,5341,10871,0,4705,4727,3361,1366,2.460468521,2187,815,507,286,1,285,1,113,0,0.031578947,empty,mBC-0716-2
"F1,C2",810713,889323,577975,311348,433258,18,241017,241397,178756,62641,2.853658147,132434,81771,54041,29980,15,29965,2,3151,0,0.001601869,mm10,mBC-0716-2
"F1,C3",20363,20646,15386,5260,10095,0,4669,4683,3290,1393,2.361809045,2206,607,338,208,0,208,0,93,0,0.024038462,empty,mBC-0716-2
"F1,C4",17710,18292,13571,4721,8869,0,3971,3982,2871,1111,2.584158416,1921,1021,585,363,0,363,0,150,0,0.099173554,empty,mBC-0716-2
"F1,C5",18058,19038,13616,5422,9149,0,4371,4387,2956,1431,2.06568833,2211,1212,716,452,0,452,0,195,0,0.019911504,empty,mBC-0716-2
"F1,C6",18877,19291,13946,5345,9804,0,4633,4638,3268,1370,2.38540146,2317,3679,1449,879,0,879,0,318,0,0.048919226,empty,mBC-0716-2
"F1,C7",871471,914508,662424,252084,439313,0,208139,208494,169838,38656,4.393574089,103083,21000,12990,7186,2,7184,1,1272,0,0.004732739,mm10,mBC-0716-2
"F1,C8",15649,16010,11861,4149,7797,3,3575,3588,2531,1057,2.394512772,1706,1525,864,503,1,502,1,198,0,0.013944223,empty,mBC-0716-2
"F1,C9",476030,479205,357525,121680,236790,0,108455,108655,86384,22271,3.878766108,52772,9284,5902,3348,1,3347,1,832,0,0.011652226,mm10,mBC-0716-2
"F1,C10",616852,657425,442766,214659,325310,56,178725,179012,136825,42187,3.243297698,95157,9349,5933,3301,1,3300,1,764,0,0.00969697,mm10,mBC-0716-2
"F1,C11",12443,12813,9353,3460,6299,2,2928,2934,2043,891,2.292929293,1419,5468,2008,1220,1,1219,1,389,0,0.06316653,empty,mBC-0716-2
"F1,C12",906387,1033771,606960,426811,501988,14,319580,320047,247048,72999,3.384265538,186629,13465,8588,4826,0,4826,0,1035,0,0.005594695,mm10,mBC-0716-2
"F1,D1",15206,15563,11495,4068,7698,1,3614,3624,2584,1040,2.484615385,1751,779,451,258,0,258,0,99,0,0.023255814,empty,mBC-0716-2
"F1,D2",22056,22445,16924,5521,11075,8,4865,4881,3396,1485,2.286868687,2255,9167,3778,2266,3,2263,2,627,0,0.127264693,empty,mBC-0716-2
"F1,D3",831265,1018022,514082,503940,503322,10,354795,355242,216320,138922,1.55713278,225634,28447,17964,10147,5,10142,1,1632,0,0.002267797,mm10,mBC-0716-2
"F1,D4",14877,15737,11332,4405,7716,1,3504,3520,2362,1158,2.039723661,1757,1389,827,536,0,536,0,239,0,0.026119403,empty,mBC-0716-2
"F1,D5",14356,14730,10792,3938,7245,3,3392,3406,2325,1081,2.150786309,1655,982,558,332,1,331,1,160,0,0.021148036,empty,mBC-0716-2
"F1,D6",12598,13267,9521,3746,6539,0,3049,3055,2124,931,2.28141783,1495,1250,701,431,1,430,1,210,0,0.023255814,empty,mBC-0716-2
"F1,D7",13281,13860,10172,3688,6774,0,3115,3126,2135,991,2.154389506,1504,1622,970,580,0,580,0,213,0,0.068965517,empty,mBC-0716-2
"F1,D8",1528142,1718627,1075483,643144,833664,1,486890,487541,399741,87800,4.55285877,274771,124484,79955,44275,14,44261,3,4057,0,0.001513748,mm10,mBC-0716-2
"F1,D9",5423,5379,4034,1345,2749,0,1279,1279,924,355,2.602816901,606,1595,939,583,0,583,0,267,0,0.005145798,empty,mBC-0716-2
"F1,D10",924572,1012453,672449,340004,487817,0,265070,265415,196734,68681,2.864460331,143427,72867,43794,24794,6,24788,1,2826,0,0.001775052,mm10,mBC-0716-2
"F1,D11",13527,14141,10316,3825,6913,0,3134,3140,2180,960,2.270833333,1581,1620,932,557,0,557,0,249,0,0.023339318,empty,mBC-0716-2
"F1,D12",20746,21460,15788,5672,10372,0,4795,4810,3326,1484,2.241239892,2302,2377,1439,833,1,832,1,298,0,0.027644231,empty,mBC-0716-2
"F1,E1",1231928,1394174,819654,574520,668513,11,425975,426560,322166,104394,3.086058586,246515,61188,40673,22845,10,22835,2,2550,0,0.002058244,mm10,mBC-0716-2
"F1,E2",16919,17154,12769,4385,8464,2,3855,3869,2678,1191,2.248530647,1839,1403,844,491,0,491,0,189,0,0.054989817,empty,mBC-0716-2
"F1,E3",12423,12899,9552,3347,6346,15,2887,2906,2045,861,2.37514518,1389,1419,824,511,0,511,0,221,0,0.058708415,empty,mBC-0716-2
"F1,E4",16621,17086,12597,4489,8279,37,3793,3840,2680,1160,2.310344828,1868,6153,2067,1258,0,1258,0,391,0,0.06518283,empty,mBC-0716-2
"F1,E5",1888726,2081648,1301553,780095,994753,3,597404,598318,473800,124518,3.805072359,335026,89860,59631,33359,16,33343,1,3528,0,0.001289626,mm10,mBC-0716-2
"F1,E6",14398,14542,10992,3550,7064,30,3136,3169,2232,937,2.382070438,1444,1672,1021,641,0,641,0,258,0,0.065522621,empty,mBC-0716-2
"F1,E7",14535,14907,11043,3864,7287,0,3300,3305,2210,1095,2.01826484,1605,1384,834,518,1,517,1,189,0,0.059961315,empty,mBC-0716-2
"F1,E8",17559,17693,13569,4124,8684,9,3818,3836,2700,1136,2.376760563,1743,2206,1157,690,1,689,1,245,0,0.021770682,empty,mBC-0716-2
"F1,E9",9450,9612,7054,2558,4685,1,2198,2202,1523,679,2.243004418,1081,1010,631,409,0,409,0,160,0,0.026894866,empty,mBC-0716-2
"F1,E10",13494,13711,10243,3468,6783,1,3162,3172,2250,922,2.440347072,1537,3674,1414,850,0,850,0,314,0,0.021176471,empty,mBC-0716-2
"F1,E11",9365,9655,6996,2659,4833,0,2192,2201,1506,695,2.166906475,1054,1304,859,520,0,520,0,189,0,0.030769231,empty,mBC-0716-2
"F1,E12",15762,16669,11851,4818,8124,1,3911,3912,2672,1240,2.15483871,1933,1044,608,363,0,363,0,150,0,0.019283747,empty,mBC-0716-2
"F1,F1",1086159,1229085,741941,487144,589481,0,361428,361874,299964,61910,4.845162332,206087,81313,48826,27441,14,27427,3,3030,0,0.003244978,mm10,mBC-0716-2
"F1,F2",22827,23681,17199,6482,11556,3,5377,5393,3866,1527,2.531761624,2596,2594,1529,969,2,967,1,395,0,0.02688728,empty,mBC-0716-2
"F1,F3",16152,17203,12050,5153,8479,0,4151,4157,2899,1258,2.30445151,2116,1667,976,611,0,611,0,291,0,0.04091653,empty,mBC-0716-2
"F1,F4",16735,16856,12544,4312,8368,19,3798,3824,2608,1216,2.144736842,1827,375,204,124,0,124,0,66,0,0.048387097,empty,mBC-0716-2
"F1,F5",586578,579529,463983,115546,282805,2,109297,109529,81679,27850,2.932818671,48235,18786,9512,5474,3,5471,1,1316,0,0.022116615,mm10,mBC-0716-2
"F1,F6",723284,775474,525224,250250,383725,16,205579,205875,164291,41584,3.950822432,109735,20386,10742,6067,4,6063,1,1287,0,0.010390896,mm10,mBC-0716-2
"F1,F7",20835,21426,15795,5631,10497,8,4761,4781,3382,1399,2.417441029,2269,812,493,274,2,272,1,120,0,0.110294118,empty,mBC-0716-2
"F1,F8",23034,23639,17507,6132,11564,29,5421,5462,3791,1671,2.268701376,2639,400,238,149,0,149,0,97,0,0,empty,mBC-0716-2
"F1,F9",15381,15957,11681,4276,7713,42,3424,3475,2424,1051,2.306374881,1693,1861,1097,647,0,647,0,214,0,0.027820711,empty,mBC-0716-2
"F1,F10",21350,21887,16377,5510,10655,2,4721,4735,3363,1372,2.451166181,2210,1314,845,518,0,518,0,216,0,0.038610039,empty,mBC-0716-2
"F1,F11",11535,11782,8853,2929,5813,33,2553,2594,1796,798,2.250626566,1234,1105,685,408,0,408,0,193,0,0.012254902,empty,mBC-0716-2
"F1,F12",15352,15879,11543,4336,7660,0,3560,3566,2457,1109,2.215509468,1747,192,116,75,0,75,0,56,0,0,empty,mBC-0716-2
"F1,G1",10871,11308,8393,2915,5360,8,2424,2435,1694,741,2.286099865,1124,1808,1147,673,0,673,0,208,0,0.004457652,empty,mBC-0716-2
"F1,G2",21576,21974,16390,5584,10717,0,4878,4890,3431,1459,2.351610692,2307,1663,655,419,0,419,0,207,0,0.023866348,empty,mBC-0716-2
"F1,G3",1062631,1188738,736777,451961,571123,1,338929,339369,229319,110050,2.083771013,194181,45952,30166,16862,5,16857,1,2236,0,0.002135611,mm10,mBC-0716-2
"F1,G4",29840,30367,22653,7714,14822,0,6560,6570,4600,1970,2.335025381,3161,265,135,91,0,91,0,58,0,0.021978022,empty,mBC-0716-2
"F1,G5",14198,14814,10694,4120,7343,0,3401,3410,2374,1036,2.291505792,1682,1501,867,530,0,530,0,232,0,0.037735849,empty,mBC-0716-2
"F1,G6",914085,987623,669186,318437,477720,1,250778,251192,210797,40395,5.218393366,132362,4574,3046,1649,0,1649,0,418,0,0,mm10,mBC-0716-2
"F1,G7",20749,21209,15762,5447,10348,0,4550,4564,3197,1367,2.338697879,2143,2964,1517,930,0,930,0,328,0,0.02688172,empty,mBC-0716-2
"F1,G8",656974,707710,497650,210060,344457,3,167660,167983,129961,38022,3.418047446,87004,73454,46680,26425,16,26409,3,2901,0,0.001628233,mm10,mBC-0716-2
"F1,G9",623178,619866,474386,145480,302410,7,129658,129890,95175,34715,2.741610255,61851,20451,12642,7287,6,7281,3,1463,0,0.002884219,mm10,mBC-0716-2
"F1,G10",14151,14483,10791,3692,7113,0,3256,3258,2286,972,2.351851852,1529,3572,1464,854,0,854,0,313,0,0.028103044,empty,mBC-0716-2
"F1,G11",947630,997113,706993,290120,477846,0,232927,233399,196847,36552,5.385396148,118344,70831,46826,25819,15,25804,3,2679,0,0.001317625,mm10,mBC-0716-2
"F1,G12",11733,12432,8824,3608,6177,0,2982,2986,2076,910,2.281318681,1518,1138,715,403,0,403,0,159,0,0.044665012,empty,mBC-0716-2
"F1,H1",21214,21883,16235,5648,10671,1,4807,4822,3427,1395,2.456630824,2315,947,601,344,1,343,1,160,0,0.034985423,empty,mBC-0716-2
"F1,H2",799964,839658,603728,235930,409593,0,200983,201330,146248,55082,2.655096039,103099,11929,7592,4176,0,4176,0,941,0,0.012212644,mm10,mBC-0716-2
"F1,H3",20711,21333,15907,5426,10295,41,4686,4743,3408,1335,2.552808989,2250,1493,870,524,0,524,0,216,0,0.049618321,empty,mBC-0716-2
"F1,H4",14584,15052,11011,4041,7287,6,3319,3328,2341,987,2.37183384,1596,285,153,103,0,103,0,76,0,0,empty,mBC-0716-2
"F1,H5",342701,313256,303940,9316,153603,0,13532,13661,10167,3494,2.909845449,3474,21130,11904,6499,3,6496,1,1250,0,0.005080049,empty,mBC-0716-2
"F1,H6",14819,15486,11070,4416,7406,0,3429,3432,2437,995,2.449246231,1716,1615,961,590,1,589,1,229,0,0.061120543,empty,mBC-0716-2
"F1,H7",551510,566091,410432,155659,284027,1,136375,136636,109540,27096,4.042663124,68688,25824,16591,9426,2,9424,1,1740,0,0.002758913,mm10,mBC-0716-2
"F1,H8",13898,14376,10424,3952,6913,0,3253,3267,2279,988,2.306680162,1555,2016,1090,636,0,636,0,267,0,0.031446541,empty,mBC-0716-2
"F1,H9",16458,17079,12478,4601,8371,0,3765,3769,2670,1099,2.429481347,1843,1436,824,516,0,516,0,230,0,0.021317829,empty,mBC-0716-2
"F1,H10",861895,931354,615982,315372,447083,2,239804,240158,177051,63107,2.80556832,131586,95126,59091,32846,15,32831,4,3325,0,0.001096525,mm10,mBC-0716-2
"F1,H11",17397,18037,13133,4904,8895,0,4140,4150,2848,1302,2.187403994,2100,246,137,94,0,94,0,61,0,0.042553191,empty,mBC-0716-2
"F1,H12",661783,732402,462632,269770,360441,1,206002,206298,170330,35968,4.73559831,114975,85374,56097,31405,13,31392,4,3068,0,0.003727064,mm10,mBC-0716-2
"F2,A1",454387,463701,335972,127729,232848,11,112706,112939,89876,23063,3.896977843,56291,6950,4175,2255,1,2254,1,700,0,0.014640639,mm10,mBC-0716-2
"F2,A2",19583,20050,14969,5081,9635,0,4247,4257,3048,1209,2.521091811,2014,6861,2628,1479,1,1478,1,479,0,0.045331529,empty,mBC-0716-2
"F2,A3",790714,845365,590347,255018,408459,18,204560,204890,167567,37323,4.489644455,105509,48732,31759,17933,1,17932,1,2248,0,0.003178675,mm10,mBC-0716-2
"F2,A4",20998,21558,16224,5334,10318,1,4500,4506,3275,1231,2.660438668,2086,992,594,331,0,331,0,136,0,0.078549849,empty,mBC-0716-2
"F2,A5",17328,17739,13336,4403,8739,0,3975,3990,2878,1112,2.588129496,1877,1756,1043,592,0,592,0,238,0,0.038851351,empty,mBC-0716-2
"F2,A6",13292,13708,9936,3772,6884,4,3255,3264,2324,940,2.472340426,1620,12675,3737,2242,4,2238,1,670,0,0.050044683,empty,mBC-0716-2
"F2,A7",15574,15777,11818,3959,7754,3,3546,3555,2476,1079,2.294717331,1674,2843,1117,692,0,692,0,248,0,0.112716763,empty,mBC-0716-2
"F2,A8",10625,11412,7984,3428,5585,25,2599,2631,1783,848,2.10259434,1351,1793,1104,670,0,670,0,246,0,0.050746269,empty,mBC-0716-2
"F2,A9",20778,20924,15531,5393,9709,9,4370,4384,3174,1210,2.623140496,2115,8567,3592,2208,2,2206,2,505,0,0.353581142,empty,mBC-0716-2
"F2,A10",656161,722475,457722,264753,357675,0,211786,212050,164270,47780,3.438049393,117805,3733,2108,1193,0,1193,0,354,0,0.010058676,mm10,mBC-0716-2
"F2,A11",19202,19418,14476,4942,9525,8,4306,4325,3017,1308,2.306574924,2040,6398,2261,1353,3,1350,1,406,0,0.075555556,empty,mBC-0716-2
"F2,A12",21396,21791,16350,5441,10772,0,4872,4887,3407,1480,2.302027027,2225,2832,1672,975,1,974,1,288,0,0.054414784,empty,mBC-0716-2
"F2,B1",18872,19275,14513,4762,9366,1,4204,4223,3003,1220,2.46147541,1941,1365,736,456,0,456,0,197,0,0.030701754,empty,mBC-0716-2
"F2,B2",19631,20496,14822,5674,9908,0,4616,4624,3271,1353,2.41759054,2309,449,249,141,0,141,0,72,0,0.141843972,empty,mBC-0716-2
"F2,B3",19112,19893,14552,5341,9749,9,4532,4551,3298,1253,2.632083001,2182,1180,749,468,2,466,1,202,0,0.06223176,empty,mBC-0716-2
"F2,B4",16522,17249,12533,4716,8367,21,3831,3856,2667,1189,2.243061396,1936,9588,3026,1786,3,1783,1,448,0,0.157599551,empty,mBC-0716-2
"F2,B5",559617,351246,195999,155247,226630,4,142826,143584,119004,24580,4.841497152,88274,77716,51390,28387,14,28373,2,2870,0,0.002044197,mm10,mBC-0716-2
"F2,B6",13131,13834,9797,4037,6715,1,3274,3283,2310,973,2.374100719,1644,3430,1326,786,1,785,1,252,0,0.104458599,empty,mBC-0716-2
"F2,B7",15867,16559,12095,4464,8203,5,3799,3811,2701,1110,2.433333333,1872,1215,734,423,1,422,1,161,0,0.021327014,empty,mBC-0716-2
"F2,B8",15725,16207,11996,4211,7867,15,3552,3579,2576,1003,2.568295115,1691,1669,1000,595,0,595,0,236,0,0.03697479,empty,mBC-0716-2
"F2,B9",14574,14771,11279,3492,7114,7,3047,3058,2158,900,2.397777778,1446,1420,600,344,1,343,1,156,0,0.032069971,empty,mBC-0716-2
"F2,B10",16536,16695,12264,4431,8328,10,3865,3884,2689,1195,2.250209205,1887,659,359,208,1,207,1,90,0,0.111111111,empty,mBC-0716-2
"F2,B11",16495,17124,12592,4532,8193,0,3670,3691,2594,1097,2.364630811,1809,237,145,94,0,94,0,60,0,0.053191489,empty,mBC-0716-2
"F2,B12",18086,18630,13484,5146,9164,13,4230,4253,3014,1239,2.432606941,2029,1437,866,538,0,538,0,209,0,0.057620818,empty,mBC-0716-2
"F2,C1",21526,21772,16869,4903,10331,4,4379,4391,3118,1273,2.449332286,1936,741,442,276,0,276,0,126,0,0.06884058,empty,mBC-0716-2
"F2,C2",18299,18845,13959,4886,9162,8,4186,4205,2939,1266,2.321484992,2048,1635,911,496,0,496,0,198,0,0.086693548,empty,mBC-0716-2
"F2,C3",21976,22986,16408,6578,11197,0,5371,5386,3845,1541,2.49513303,2687,749,442,244,0,244,0,107,0,0.024590164,empty,mBC-0716-2
"F2,C4",17856,17897,13544,4353,8668,0,3825,3835,2647,1188,2.228114478,1837,2666,1278,795,1,794,1,233,0,0.129722922,empty,mBC-0716-2
"F2,C5",17041,17566,12747,4819,8808,15,4201,4229,3006,1223,2.457890433,2055,10773,3467,1987,2,1985,1,572,0,0.015617128,empty,mBC-0716-2
"F2,C6",17063,17535,12957,4578,8723,21,4017,4052,2876,1176,2.445578231,1918,1619,972,599,0,599,0,214,0,0.005008347,empty,mBC-0716-2
"F2,C7",15793,16707,11799,4908,8086,1,3807,3818,2643,1175,2.249361702,1941,510,332,179,0,179,0,79,0,0.005586592,empty,mBC-0716-2
"F2,C8",15383,15830,11568,4262,7581,0,3500,3511,2411,1100,2.191818182,1653,8539,2841,1655,1,1654,1,476,0,0.068319226,empty,mBC-0716-2
"F2,C9",12963,13594,9566,4028,6655,0,3218,3221,2307,914,2.524070022,1635,797,473,290,0,290,0,128,0,0.048275862,empty,mBC-0716-2
"F2,C10",13891,14029,10459,3570,7073,8,3242,3255,2247,1008,2.229166667,1552,1379,877,499,0,499,0,193,0,0.018036072,empty,mBC-0716-2
"F2,C11",11462,12154,8709,3445,5966,0,2808,2815,1939,876,2.21347032,1427,1141,699,395,0,395,0,152,0,0.060759494,empty,mBC-0716-2
"F2,C12",20153,20585,14999,5586,9918,1,4566,4577,3154,1423,2.216444132,2262,1394,744,425,0,425,0,164,0,0.028235294,empty,mBC-0716-2
"F2,D1",737914,850568,489107,361461,419378,1,267049,267404,217559,49845,4.364710603,157996,31165,18012,10226,5,10221,1,1650,0,0.00264162,mm10,mBC-0716-2
"F2,D2",20359,20611,15703,4908,9969,0,4391,4400,3058,1342,2.278688525,1991,3100,1847,1080,3,1077,1,345,0,0.060352832,empty,mBC-0716-2
"F2,D3",322942,301017,276681,24336,150984,1,33585,33712,22296,11416,1.953048353,10549,3706,2052,1289,1,1288,1,574,0,0.026397516,empty,mBC-0716-2
"F2,D4",14353,14737,10821,3916,7272,1,3333,3339,2386,953,2.503672613,1627,1410,806,534,1,533,1,242,0,0.041275797,empty,mBC-0716-2
"F2,D5",776079,843541,552094,291447,413731,24,235994,236350,175671,60679,2.895087262,128220,34305,22097,12577,7,12570,2,1771,0,0.001352426,mm10,mBC-0716-2
"F2,D6",12832,13439,9746,3693,6436,17,3031,3050,2159,891,2.42312009,1478,1514,888,515,0,515,0,215,0,0.046601942,empty,mBC-0716-2
"F2,D7",13682,14100,10260,3840,6786,0,3183,3185,2219,966,2.297101449,1533,16704,5066,3042,6,3036,2,769,0,0.062252964,empty,mBC-0716-2
"F2,D8",19702,20915,14748,6167,10120,10,4780,4799,3462,1337,2.589379207,2399,1268,815,482,0,482,0,164,0,0.06846473,empty,mBC-0716-2
"F2,D9",6237,6613,4615,1998,3276,1,1584,1587,1144,443,2.582392777,804,1849,1082,659,0,659,0,259,0,0.074355083,empty,mBC-0716-2
"F2,D10",13094,13711,10006,3705,6618,11,3076,3102,2185,917,2.382769902,1494,1255,577,340,0,340,0,146,0,0.064705882,empty,mBC-0716-2
"F2,D11",13798,14347,10309,4038,7029,0,3294,3299,2292,1007,2.276067527,1616,16504,5714,3356,4,3352,2,830,0,0.017303103,empty,mBC-0716-2
"F2,D12",19172,19933,14700,5233,9700,32,4376,4421,3078,1343,2.291883842,2171,2889,1687,922,2,920,1,288,0,0.054347826,empty,mBC-0716-2
"F2,E1",876343,905681,634858,270823,438976,2,229477,229828,164126,65702,2.498036589,120206,23909,14733,8367,0,8367,0,1507,0,0.00585634,mm10,mBC-0716-2
"F2,E2",17290,17756,13144,4612,8623,0,4050,4060,2816,1244,2.263665595,1935,4098,1712,1012,1,1011,1,337,0,0.065281899,empty,mBC-0716-2
"F2,E3",12125,12645,9362,3283,6222,0,2842,2849,2002,847,2.363636364,1372,1774,1071,659,0,659,0,288,0,0.02276176,empty,mBC-0716-2
"F2,E4",15301,15743,11517,4226,7761,0,3626,3634,2543,1091,2.330889093,1745,1513,826,438,1,437,1,188,0,0.036613272,empty,mBC-0716-2
"F2,E5",20784,21159,15892,5267,10373,1,4613,4631,3233,1398,2.312589413,2175,1607,962,581,0,581,0,227,0,0.030981067,empty,mBC-0716-2
"F2,E6",14669,15241,11093,4148,7183,0,3312,3317,2348,969,2.423116615,1623,2758,1395,788,0,788,0,288,0,0.079949239,empty,mBC-0716-2
"F2,E7",13660,13877,10319,3558,6811,5,3125,3136,2125,1011,2.101879327,1488,1437,912,542,0,542,0,202,0,0.057195572,empty,mBC-0716-2
"F2,E8",635194,630560,505188,125372,305917,22,114351,114630,82131,32499,2.527185452,51560,38860,21591,12350,1,12349,1,2037,0,0.003886954,mm10,mBC-0716-2
"F2,E9",9776,10217,7277,2940,4915,15,2313,2330,1581,749,2.110814419,1138,11464,3668,2320,5,2315,2,596,0,0.140820734,empty,mBC-0716-2
"F2,E10",700735,719526,526144,193382,350679,5,166203,166545,133099,33446,3.979519225,82314,19865,12400,7071,3,7068,1,1397,0,0.005093379,mm10,mBC-0716-2
"F2,E11",9704,10163,7311,2852,5041,8,2360,2374,1626,748,2.173796791,1199,6244,2063,1208,0,1208,0,375,0,0.031456954,empty,mBC-0716-2
"F2,E12",16289,17094,12437,4657,8400,0,3955,3957,2744,1213,2.262159934,1950,1157,699,411,0,411,0,159,0,0.092457421,empty,mBC-0716-2
"F2,F1",18266,18893,13878,5015,9009,22,4085,4118,2871,1247,2.302325581,1950,1759,1082,677,1,676,1,241,0,0.056213018,empty,mBC-0716-2
"F2,F2",1142675,1272218,790155,482063,606539,1,362919,363399,281215,82184,3.421773095,203950,159309,104978,58986,30,58956,1,4163,0,0.001238212,mm10,mBC-0716-2
"F2,F3",835569,940021,588846,351175,457243,0,263453,263811,217148,46663,4.653537064,148222,148542,97528,55490,22,55468,2,4375,0,0.000865364,mm10,mBC-0716-2
"F2,F4",16901,17181,12714,4467,8697,2,3965,3983,2899,1084,2.674354244,1944,459,286,183,0,183,0,88,0,0,empty,mBC-0716-2
"F2,F5",25201,25897,18969,6928,12580,8,5838,5852,4123,1729,2.384615385,2850,2010,1265,763,1,762,1,309,0,0.015748031,empty,mBC-0716-2
"F2,F6",1158372,1250313,820949,429364,592007,1,326975,327469,279254,48215,5.79184901,177298,157706,103889,57713,21,57692,1,4351,0,0.003657353,mm10,mBC-0716-2
"F2,F7",19535,20445,14926,5519,9943,0,4617,4626,3204,1422,2.253164557,2210,896,525,324,0,324,0,146,0,0.037037037,empty,mBC-0716-2
"F2,F8",23040,23428,17647,5781,11551,17,5347,5383,3842,1541,2.493186243,2476,394,232,131,0,131,0,74,0,0.083969466,empty,mBC-0716-2
"F2,F9",14875,15364,11171,4193,7640,0,3573,3581,2510,1071,2.343604108,1740,1670,1081,611,1,610,1,219,0,0.016393443,empty,mBC-0716-2
"F2,F10",20126,20525,15517,5008,9866,0,4325,4332,3069,1263,2.429928741,1959,2091,1011,609,0,609,0,226,0,0.08045977,empty,mBC-0716-2
"F2,F11",11418,11681,8808,2873,5775,0,2564,2571,1756,815,2.154601227,1219,1062,600,382,0,382,0,158,0,0.034031414,empty,mBC-0716-2
"F2,F12",13860,14211,10502,3709,6853,0,3179,3186,2206,980,2.251020408,1517,133,72,47,0,47,0,33,0,0,empty,mBC-0716-2
"F2,G1",10203,10598,7713,2885,5178,0,2387,2388,1663,725,2.293793103,1128,5293,2124,1302,1,1301,1,408,0,0.06302844,empty,mBC-0716-2
"F2,G2",20774,21309,15812,5497,10405,21,4674,4701,3248,1453,2.235375086,2219,889,573,347,0,347,0,166,0,0.023054755,empty,mBC-0716-2
"F2,G3",19824,20504,14968,5536,9939,3,4660,4679,3203,1476,2.170054201,2239,6855,2749,1671,1,1670,1,498,0,0.137724551,empty,mBC-0716-2
"F2,G4",28281,28379,21506,6873,14201,3,6348,6362,4614,1748,2.639588101,2955,173,106,74,0,74,0,55,0,0,empty,mBC-0716-2
"F2,G5",14114,14521,10629,3892,7202,0,3286,3298,2306,992,2.324596774,1626,5916,2158,1292,3,1289,1,424,0,0.062063615,empty,mBC-0716-2
"F2,G6",23221,23897,18175,5722,11456,7,5058,5080,3563,1517,2.348714568,2309,182,101,70,0,70,0,57,0,0,empty,mBC-0716-2
"F2,G7",19669,20362,14973,5389,9908,16,4529,4552,3200,1352,2.366863905,2233,2254,1343,826,0,826,0,280,0,0.032687651,empty,mBC-0716-2
"F2,G8",711233,740777,529553,211224,359823,1,179638,179937,143705,36232,3.966245308,90899,85951,34938,20059,19,20040,2,2977,0,0.022904192,mm10,mBC-0716-2
"F2,G9",10647,10640,8061,2579,5404,10,2421,2436,1760,676,2.603550296,1119,1553,905,530,0,530,0,233,0,0.073584906,empty,mBC-0716-2
"F2,G10",14383,14598,10866,3732,7726,14,3568,3586,2588,998,2.593186373,1698,2061,1150,693,0,693,0,272,0,0.080808081,empty,mBC-0716-2
"F2,G11",12712,13111,9738,3373,6398,3,2859,2874,2093,781,2.679897567,1389,1147,644,386,0,386,0,149,0,0.012953368,empty,mBC-0716-2
"F2,G12",11782,12218,8870,3348,5873,58,2644,2712,1876,836,2.244019139,1339,1274,797,477,0,477,0,153,0,0.094339623,empty,mBC-0716-2
"F2,H1",20886,21347,16028,5319,10220,25,4503,4530,3221,1309,2.46065699,2120,2845,1062,594,0,594,0,219,0,0.069023569,empty,mBC-0716-2
"F2,H2",23894,24768,18235,6533,11935,4,5368,5386,3809,1577,2.415345593,2623,2341,1473,900,2,898,2,315,0,0.056792873,empty,mBC-0716-2
"F2,H3",21907,22414,16562,5852,10781,0,4993,5002,3633,1369,2.65376187,2280,1573,934,582,0,582,0,219,0,0.072164948,empty,mBC-0716-2
"F2,H4",14670,15215,11269,3946,7329,0,3371,3374,2326,1048,2.219465649,1563,259,143,92,0,92,0,69,0,0,empty,mBC-0716-2
"F2,H5",754651,850177,528622,321555,412209,1,241719,242083,198931,43152,4.610006489,136029,38442,24958,14154,6,14148,2,1960,0,0.003180662,mm10,mBC-0716-2
"F2,H6",15139,15799,11491,4308,7748,9,3559,3582,2549,1033,2.467570184,1788,1862,1143,664,0,664,0,266,0,0.040662651,empty,mBC-0716-2
"F2,H7",17069,17737,12838,4899,8774,0,4043,4053,2815,1238,2.273828756,2005,1666,1026,634,0,634,0,233,0,0.047318612,empty,mBC-0716-2
"F2,H8",14289,15146,10686,4460,7355,1,3400,3412,2412,1000,2.412,1739,1800,1142,719,0,719,0,264,0,0.075104312,empty,mBC-0716-2
"F2,H9",16591,17144,12532,4612,8396,5,3869,3887,2733,1154,2.368284229,1906,1543,847,538,1,537,1,238,0,0.018621974,empty,mBC-0716-2
"F2,H10",532273,482538,452687,29851,230307,0,43172,43362,32639,10723,3.043831017,11609,16794,8850,4871,5,4866,1,1165,0,0.009658857,empty,mBC-0716-2
"F2,H11",17282,17603,13018,4585,8744,4,4062,4077,2876,1201,2.394671107,1986,207,102,65,0,65,0,51,0,0,empty,mBC-0716-2
"F2,H12",6195,6677,4662,2015,3316,1,1595,1599,1169,430,2.718604651,820,692,379,201,0,201,0,95,0,0.039800995,empty,mBC-0716-2
"F3,A1",756549,830648,544112,286536,409533,6,222946,223314,177302,46012,3.853386073,121583,96918,63080,35543,15,35528,1,3421,0,0.001154019,mm10,mBC-0716-2
"F3,A2",21341,21621,16367,5254,10479,0,4631,4649,3254,1395,2.332616487,2156,3458,1551,962,0,962,0,345,0,0.161122661,empty,mBC-0716-2
"F3,A3",18277,18754,13822,4932,9235,46,4365,4417,3070,1347,2.279138827,2115,1275,748,476,0,476,0,215,0,0.012605042,empty,mBC-0716-2
"F3,A4",1008985,1084186,728199,355987,516522,8,274747,275211,235335,39876,5.901670178,146438,31223,20907,11742,6,11736,1,1697,0,0.001448534,mm10,mBC-0716-2
"F3,A5",19324,20332,14787,5545,10032,32,4639,4682,3294,1388,2.373198847,2291,1897,1130,738,0,738,0,334,0,0.029810298,empty,mBC-0716-2
"F3,A6",15935,16774,11906,4868,8241,4,3943,3963,2784,1179,2.361323155,2004,18384,5223,3036,3,3033,1,877,0,0.025057699,empty,mBC-0716-2
"F3,A7",18054,18682,13707,4975,9010,2,4159,4168,2920,1248,2.33974359,2001,11742,3751,2288,1,2287,1,642,0,0.090074333,empty,mBC-0716-2
"F3,A8",756380,826149,542241,283908,404029,8,225158,225498,165754,59744,2.774404124,122208,51796,27556,15418,7,15411,1,2216,0,0.007397314,mm10,mBC-0716-2
"F3,A9",20220,20936,15584,5352,10068,11,4566,4587,3183,1404,2.267094017,2123,1623,1030,648,1,647,1,289,0,0.060278207,empty,mBC-0716-2
"F3,A10",19332,19839,14893,4946,9742,0,4395,4411,3102,1309,2.369747899,2090,730,390,247,1,246,1,159,0,0.008130081,empty,mBC-0716-2
"F3,A11",20323,20871,15435,5436,10323,1,4733,4741,3333,1408,2.3671875,2298,4003,1722,1048,0,1048,0,381,0,0.092557252,empty,mBC-0716-2
"F3,A12",21888,22682,16615,6067,10956,25,4997,5036,3527,1509,2.337309476,2504,2960,1714,1021,1,1020,1,339,0,0.074509804,empty,mBC-0716-2
"F3,B1",21004,21851,16084,5767,10505,10,4765,4789,3413,1376,2.480377907,2296,3785,1502,915,1,914,1,323,0,0.030634573,empty,mBC-0716-2
"F3,B2",20699,20861,16110,4751,10123,0,4533,4539,3200,1339,2.389843167,2031,671,383,248,0,248,0,110,0,0.056451613,empty,mBC-0716-2
"F3,B3",19378,19957,14927,5030,9812,0,4347,4351,3112,1239,2.511702986,2092,4392,1545,944,0,944,0,358,0,0.092161017,empty,mBC-0716-2
"F3,B4",18103,18656,13798,4858,8972,3,4068,4077,2831,1246,2.272070626,1958,3014,1233,798,0,798,0,311,0,0.061403509,empty,mBC-0716-2
"F3,B5",11294,7657,5255,2402,4733,0,2321,2334,1669,665,2.509774436,1290,2534,980,594,1,593,1,263,0,0.075885329,empty,mBC-0716-2
"F3,B6",14086,14824,10616,4208,7369,12,3517,3533,2501,1032,2.423449612,1797,1407,876,555,0,555,0,251,0,0.009009009,empty,mBC-0716-2
"F3,B7",17679,18035,13692,4343,8942,18,4046,4068,2882,1186,2.430016863,1894,1314,774,485,0,485,0,231,0,0.070103093,empty,mBC-0716-2
"F3,B8",14459,14954,11204,3750,7351,5,3337,3344,2287,1057,2.163670766,1567,2101,1264,728,0,728,0,317,0,0.031593407,empty,mBC-0716-2
"F3,B9",789131,826536,585128,241408,398646,30,195356,195726,167815,27911,6.012504031,100420,29838,19451,11102,2,11100,2,1718,0,0.001711712,mm10,mBC-0716-2
"F3,B10",18168,18428,13371,5057,9233,2,4266,4287,2958,1329,2.225733634,2098,899,464,269,0,269,0,122,0,0.007434944,empty,mBC-0716-2
"F3,B11",17609,18092,13658,4434,8774,4,3943,3961,2790,1171,2.382578992,1823,375,218,164,0,164,0,116,0,0,empty,mBC-0716-2
"F3,B12",1434006,1561155,1042555,518600,757395,3,411065,411739,331064,80675,4.10367524,220522,89403,59065,32158,18,32140,4,3466,0,0.001244555,mm10,mBC-0716-2
"F3,C1",1395464,1534067,974591,559476,722113,39,418818,419510,329902,89608,3.681613249,230114,36146,23689,13285,6,13279,1,1885,0,0.001506138,mm10,mBC-0716-2
"F3,C2",1494462,1566812,1118958,447854,747634,4,367815,368467,296293,72174,4.105259512,187529,122990,75152,41992,18,41974,4,3914,0,0.00228713,mm10,mBC-0716-2
"F3,C3",21506,22369,16336,6033,10791,59,4979,5049,3509,1540,2.278571429,2470,651,402,243,0,243,0,123,0,0.012345679,empty,mBC-0716-2
"F3,C4",19045,19389,14612,4777,9610,0,4187,4206,2926,1280,2.2859375,2020,1121,652,380,0,380,0,174,0,0.055263158,empty,mBC-0716-2
"F3,C5",20277,21751,15149,6602,10567,18,5020,5055,3636,1419,2.562367865,2663,1410,806,546,0,546,0,282,0,0.062271062,empty,mBC-0716-2
"F3,C6",18219,18600,13689,4911,9346,13,4353,4374,3068,1306,2.349157734,2165,1594,920,588,0,588,0,274,0,0.045918367,empty,mBC-0716-2
"F3,C7",17537,18340,13158,5182,8898,0,4134,4148,2920,1228,2.377850163,2020,564,346,216,0,216,0,138,0,0.009259259,empty,mBC-0716-2
"F3,C8",16469,17169,12586,4583,8476,23,3922,3961,2747,1214,2.26276771,1923,1863,1093,674,1,673,1,247,0,0.059435364,empty,mBC-0716-2
"F3,C9",14198,14620,10672,3948,7095,0,3299,3303,2310,993,2.326283988,1596,971,593,372,1,371,1,173,0,0.043126685,empty,mBC-0716-2
"F3,C10",15472,15850,11727,4123,7652,44,3483,3533,2475,1058,2.339319471,1670,1303,805,529,1,528,1,247,0,0.017045455,empty,mBC-0716-2
"F3,C11",12165,13135,9294,3841,6395,0,3041,3049,2116,933,2.26795284,1578,3009,1247,751,1,750,1,270,0,0.053333333,empty,mBC-0716-2
"F3,C12",21772,22412,16538,5874,10801,17,4863,4890,3418,1472,2.32201087,2379,2024,938,565,0,565,0,219,0,0.046017699,empty,mBC-0716-2
"F3,D1",13413,13765,10125,3640,6815,5,3223,3231,2279,952,2.393907563,1518,706,429,285,0,285,0,141,0,0.031578947,empty,mBC-0716-2
"F3,D2",1319816,1393833,965144,428689,659547,0,342387,343020,292245,50775,5.755686854,176279,163333,106535,58673,31,58642,5,4419,0,0.001261894,mm10,mBC-0716-2
"F3,D3",15123,15687,11342,4345,7797,0,3683,3690,2582,1108,2.33032491,1831,1617,1015,641,0,641,0,284,0,0.015600624,empty,mBC-0716-2
"F3,D4",842836,923590,605766,317824,450051,18,246028,246395,200026,46369,4.313787229,133220,123013,76475,42443,14,42429,1,3811,0,0.001861934,mm10,mBC-0716-2
"F3,D5",1777975,1895279,1316485,578794,902800,9,464705,465469,381617,83852,4.55107809,241171,254318,165835,91729,51,91678,6,5676,0,0.000992605,mm10,mBC-0716-2
"F3,D6",953800,988984,709387,279597,485667,3,238175,238609,189437,49172,3.85253803,121213,40360,21402,12473,5,12468,1,2283,0,0.014517164,mm10,mBC-0716-2
"F3,D7",14352,14550,10742,3808,7122,5,3263,3286,2243,1043,2.150527325,1565,3867,1520,920,0,920,0,308,0,0.035869565,empty,mBC-0716-2
"F3,D8",16814,17784,12671,5113,8705,0,4169,4182,2924,1258,2.324324324,2093,1117,645,407,0,407,0,212,0,0.054054054,empty,mBC-0716-2
"F3,D9",6811,7062,4937,2125,3515,3,1728,1731,1275,456,2.796052632,852,1679,901,614,0,614,0,324,0,0.013029316,empty,mBC-0716-2
"F3,D10",15342,15829,11664,4165,7706,16,3517,3537,2442,1095,2.230136986,1660,969,534,324,0,324,0,166,0,0.037037037,empty,mBC-0716-2
"F3,D11",14180,14512,10822,3690,7151,2,3253,3263,2315,948,2.441983122,1556,1762,1049,681,0,681,0,313,0,0.026431718,empty,mBC-0716-2
"F3,D12",873887,956315,630823,325492,463961,1,251902,252242,217738,34504,6.310514723,136323,115952,76616,42828,12,42816,2,3764,0,0.001915172,mm10,mBC-0716-2
"F3,E1",1232090,1355935,859523,496412,647576,4,379793,380370,314747,65623,4.796290935,208562,62285,37941,21201,13,21188,2,2632,0,0.003350953,mm10,mBC-0716-2
"F3,E2",18218,18978,13813,5165,9321,7,4253,4262,3000,1262,2.377179081,2076,1799,1038,644,0,644,0,280,0,0.045031056,empty,mBC-0716-2
"F3,E3",13136,13393,10084,3309,6682,4,3050,3059,2104,955,2.203141361,1421,2046,1244,785,0,785,0,367,0,0.042038217,empty,mBC-0716-2
"F3,E4",16660,17510,12694,4816,8547,1,3990,4009,2847,1162,2.450086059,1958,1599,941,584,0,584,0,254,0,0.054794521,empty,mBC-0716-2
"F3,E5",22799,23136,17449,5687,11318,0,5000,5019,3556,1463,2.43062201,2305,1811,1043,680,0,680,0,353,0,0.057352941,empty,mBC-0716-2
"F3,E6",17865,18511,13472,5039,8977,16,4126,4155,2905,1250,2.324,2033,2150,1267,772,0,772,0,333,0,0.046632124,empty,mBC-0716-2
"F3,E7",15621,15565,11783,3782,7594,0,3474,3489,2401,1088,2.206801471,1640,1575,947,585,0,585,0,255,0,0.030769231,empty,mBC-0716-2
"F3,E8",715237,709036,543642,165394,344534,35,149623,149978,101334,48644,2.083175726,70652,11230,7259,4082,2,4080,1,1079,0,0.007843137,mm10,mBC-0716-2
"F3,E9",11327,11490,8423,3067,5471,1,2488,2504,1729,775,2.230967742,1192,39712,11596,6788,9,6779,2,1397,0,0.061218469,empty,mBC-0716-2
"F3,E10",13628,14224,10360,3864,6949,1,3205,3213,2271,942,2.410828025,1545,1354,873,541,0,541,0,272,0,0.053604436,empty,mBC-0716-2
"F3,E11",9876,10249,7566,2683,5163,9,2381,2394,1693,701,2.415121255,1171,1359,887,547,0,547,0,232,0,0.031078611,empty,mBC-0716-2
"F3,E12",595310,650947,440045,210902,321761,14,166983,167232,136708,30524,4.478705281,89061,60185,39889,22519,7,22512,1,2569,0,0.001421464,mm10,mBC-0716-2
"F3,F1",19259,19638,14538,5100,9712,0,4415,4442,3049,1393,2.188801149,2114,8211,3114,1983,2,1981,1,624,0,0.044422009,empty,mBC-0716-2
"F3,F2",24662,25415,18556,6859,12714,0,6068,6075,4257,1818,2.341584158,3017,3637,2245,1338,2,1336,1,524,0,0.011227545,empty,mBC-0716-2
"F3,F3",18759,19677,13928,5749,9684,0,4710,4727,3328,1399,2.37884203,2345,7173,2752,1706,0,1706,0,577,0,0.045134818,empty,mBC-0716-2
"F3,F4",18309,18390,13885,4505,9073,0,4102,4116,2816,1300,2.166153846,1905,617,360,232,1,231,1,121,0,0.025974026,empty,mBC-0716-2
"F3,F5",26666,27788,20194,7594,13379,0,6172,6177,4453,1724,2.582946636,2981,2148,1268,835,0,835,0,418,0,0.013173653,empty,mBC-0716-2
"F3,F6",26252,27140,19710,7430,13144,0,6099,6124,4214,1910,2.206282723,3055,13362,4765,2867,1,2866,1,834,0,0.079204466,empty,mBC-0716-2
"F3,F7",32567,34839,23983,10856,16782,23,8670,8714,6245,2469,2.529364115,4498,1057,644,419,1,418,1,215,0,0.028708134,empty,mBC-0716-2
"F3,F8",24490,25537,18587,6950,12410,82,5727,5830,4109,1721,2.387565369,2791,544,370,238,1,237,1,129,0,0.012658228,empty,mBC-0716-2
"F3,F9",16083,16429,12272,4157,7944,0,3582,3590,2554,1036,2.465250965,1674,1790,1064,679,0,679,0,255,0,0.081001473,empty,mBC-0716-2
"F3,F10",21644,22071,16603,5468,10857,10,4834,4864,3493,1371,2.547775346,2245,1692,959,633,0,633,0,259,0,0.06793049,empty,mBC-0716-2
"F3,F11",831241,911658,597975,313683,443570,32,242561,243002,198418,44584,4.450430648,132004,53405,34079,19263,11,19252,2,2375,0,0.000934968,mm10,mBC-0716-2
"F3,F12",15826,16464,12032,4432,7968,17,3690,3716,2594,1122,2.311942959,1800,217,136,91,0,91,0,62,0,0.065934066,empty,mBC-0716-2
"F3,G1",631157,677939,465270,212669,332785,12,172903,173173,142365,30808,4.62103999,89755,94941,61252,34300,11,34289,3,3370,0,0.001108227,mm10,mBC-0716-2
"F3,G2",1107929,1183120,805392,377728,564191,0,290622,291110,244151,46959,5.199237633,154127,38808,25323,14289,8,14281,1,1946,0,0.000560185,mm10,mBC-0716-2
"F3,G3",23226,23865,17369,6496,11473,37,5379,5428,3822,1606,2.379825654,2636,24179,8234,4978,5,4973,3,1178,0,0.194852202,empty,mBC-0716-2
"F3,G4",31294,31672,24110,7562,15340,2,6653,6674,4814,1860,2.588172043,3080,251,157,118,0,118,0,90,0,0,empty,mBC-0716-2
"F3,G5",14450,14889,10918,3971,7263,10,3317,3330,2307,1023,2.255131965,1571,1604,947,594,0,594,0,316,0,0.031986532,empty,mBC-0716-2
"F3,G6",25792,26257,19653,6604,12714,1,5682,5691,3997,1694,2.359504132,2634,1221,489,310,0,310,0,136,0,0.064516129,empty,mBC-0716-2
"F3,G7",21865,22273,16958,5315,10963,0,4932,4945,3553,1392,2.552442529,2278,3246,1645,976,0,976,0,411,0,0.042008197,empty,mBC-0716-2
"F3,G8",1719542,1941826,1213894,727932,920499,2,539643,540437,423751,116686,3.631549629,303200,282831,177512,99567,51,99516,7,5832,0,0.001929338,mm10,mBC-0716-2
"F3,G9",11315,11847,8517,3330,5934,1,2784,2793,1971,822,2.397810219,1353,2322,1170,734,3,731,1,334,0,0.049247606,empty,mBC-0716-2
"F3,G10",14504,14495,11114,3381,7244,0,3179,3185,2220,965,2.300518135,1450,1782,1075,678,1,677,1,319,0,0.028064993,empty,mBC-0716-2
"F3,G11",13304,13793,10155,3638,6660,0,3094,3106,2171,935,2.321925134,1470,937,572,360,0,360,0,164,0,0.005555556,empty,mBC-0716-2
"F3,G12",12616,13026,9580,3446,6451,48,2959,3018,2122,896,2.368303571,1445,1505,917,550,0,550,0,249,0,0.034545455,empty,mBC-0716-2
"F3,H1",22719,23634,17313,6321,11417,0,5314,5322,3738,1584,2.359848485,2582,1149,650,425,0,425,0,195,0,0.011764706,empty,mBC-0716-2
"F3,H2",1937207,2116814,1417265,699549,1004018,3,558326,559164,414904,144260,2.876084847,297186,76324,47394,26585,15,26570,2,3087,0,0.00380128,mm10,mBC-0716-2
"F3,H3",563784,600435,425541,174894,296133,0,145603,145843,104157,41686,2.498608646,75274,23830,14759,8334,7,8327,1,1427,0,0.002401825,mm10,mBC-0716-2
"F3,H4",16816,17379,12702,4677,8375,5,3850,3861,2766,1095,2.526027397,1827,784,311,197,0,197,0,117,0,0,empty,mBC-0716-2
"F3,H5",998965,1086512,717093,369419,517021,1,280111,280591,238093,42498,5.60245188,151282,68456,45426,25230,11,25219,2,2826,0,0.003687696,mm10,mBC-0716-2
"F3,H6",17906,18437,13507,4930,9136,0,4317,4324,3087,1237,2.495553759,2100,2199,1333,820,2,818,1,350,0,0.030562347,empty,mBC-0716-2
"F3,H7",18071,18646,13733,4913,9188,0,4283,4287,3005,1282,2.34399376,2076,2468,1346,834,0,834,0,331,0,0.017985612,empty,mBC-0716-2
"F3,H8",848181,915731,618813,296918,439160,14,229698,230078,190701,39377,4.842954009,121639,156246,100268,56254,30,56224,2,4304,0,0.000818156,mm10,mBC-0716-2
"F3,H9",19810,20639,14824,5815,10124,9,4835,4857,3478,1379,2.522117476,2382,12662,4020,2552,1,2551,1,781,0,0.045864367,empty,mBC-0716-2
"F3,H10",2332992,2421061,1720788,700273,1144156,2,582669,583610,423508,160102,2.64523866,299148,140805,85792,47635,25,47610,5,4437,0,0.006112161,mm10,mBC-0716-2
"F3,H11",26325,27763,19255,8508,13462,0,6635,6650,4767,1883,2.531598513,3449,789,351,250,0,250,0,147,0,0.064,empty,mBC-0716-2
"F3,H12",6672,6886,4977,1909,3360,0,1567,1571,1108,463,2.393088553,727,610,328,222,0,222,0,124,0,0.031531532,empty,mBC-0716-2
"F4,A1",14747,15313,11253,4060,7554,19,3522,3541,2502,1039,2.408084697,1663,780,477,283,0,283,0,133,0,0.024734982,empty,mBC-0716-2
"F4,A2",19430,19237,14886,4351,9328,0,4022,4031,2842,1189,2.390243902,1801,948,572,349,0,349,0,146,0,0.040114613,empty,mBC-0716-2
"F4,A3",16346,16748,12340,4408,8331,0,3875,3876,2756,1120,2.460714286,1837,722,424,238,0,238,0,124,0,0.016806723,empty,mBC-0716-2
"F4,A4",1215537,1328184,868714,459470,622368,20,352946,353534,258745,94789,2.729694374,192345,24628,14062,7946,7,7939,1,1394,0,0.00554226,mm10,mBC-0716-2
"F4,A5",1491979,1628579,1060763,567816,780650,9,439140,439803,371367,68436,5.42648606,239294,132841,84355,46767,28,46739,2,4000,0,0.001412097,mm10,mBC-0716-2
"F4,A6",13053,13684,9897,3787,6733,11,3223,3238,2253,985,2.287309645,1543,875,527,333,0,333,0,149,0,0.069069069,empty,mBC-0716-2
"F4,A7",15917,16390,12186,4204,8108,5,3694,3711,2589,1122,2.307486631,1803,952,503,294,0,294,0,133,0,0.037414966,empty,mBC-0716-2
"F4,A8",11028,11183,8117,3066,5486,0,2525,2536,1803,733,2.459754434,1237,4869,1893,1218,2,1216,2,325,0,0.292763158,empty,mBC-0716-2
"F4,A9",18899,19122,14525,4597,9111,11,4056,4081,2909,1172,2.482081911,1911,799,468,290,1,289,1,147,0,0.010380623,empty,mBC-0716-2
"F4,A10",16429,17059,12354,4705,8247,0,3887,3891,2737,1154,2.371750433,1915,427,223,140,0,140,0,71,0,0.121428571,empty,mBC-0716-2
"F4,A11",18349,18593,13901,4692,9016,0,4118,4121,2906,1215,2.391769547,1920,890,541,298,0,298,0,131,0,0.110738255,empty,mBC-0716-2
"F4,A12",20990,20999,16045,4954,10084,14,4395,4416,3163,1253,2.52434158,2000,5209,2339,1439,2,1437,1,371,0,0.281141267,empty,mBC-0716-2
"F4,B1",19281,19942,14571,5371,9505,5,4385,4397,3057,1340,2.281343284,2103,897,552,333,0,333,0,134,0,0.084084084,empty,mBC-0716-2
"F4,B2",19350,19649,14609,5040,9610,3,4362,4378,3013,1365,2.207326007,2080,289,167,106,0,106,0,57,0,0.028301887,empty,mBC-0716-2
"F4,B3",20056,20412,15262,5150,9998,11,4548,4568,3233,1335,2.421722846,2198,3589,1319,777,0,777,0,292,0,0.041184041,empty,mBC-0716-2
"F4,B4",16637,17340,12520,4820,8419,1,3948,3965,2820,1145,2.462882096,1914,723,443,244,0,244,0,107,0,0.004098361,empty,mBC-0716-2
"F4,B5",9325,5466,3771,1695,3532,12,1650,1679,1155,524,2.204198473,948,498,290,186,0,186,0,86,0,0.053763441,empty,mBC-0716-2
"F4,B6",12549,13384,9481,3903,6675,54,3124,3184,2175,1009,2.155599604,1613,812,487,324,0,324,0,132,0,0.033950617,empty,mBC-0716-2
"F4,B7",16277,17178,12451,4727,8323,1,3843,3849,2729,1120,2.436607143,1888,482,326,211,0,211,0,91,0,0.056872038,empty,mBC-0716-2
"F4,B8",13080,13422,10041,3381,6497,9,2937,2952,2098,854,2.456674473,1384,736,423,274,0,274,0,147,0,0.02919708,empty,mBC-0716-2
"F4,B9",14715,15541,11206,4335,7364,0,3393,3408,2355,1053,2.236467236,1670,403,237,144,0,144,0,76,0,0.020833333,empty,mBC-0716-2
"F4,B10",16541,16701,12363,4338,8433,0,3935,3944,2675,1269,2.107959023,1870,509,252,157,0,157,0,59,0,0.044585987,empty,mBC-0716-2
"F4,B11",17541,18081,12960,5121,8621,0,4133,4140,2899,1241,2.336019339,2083,504,208,130,0,130,0,67,0,0.061538462,empty,mBC-0716-2
"F4,B12",18336,19096,13952,5144,9396,0,4424,4429,3133,1296,2.417438272,2175,6549,2265,1325,3,1322,2,396,0,0.068078669,empty,mBC-0716-2
"F4,C1",22392,22619,17209,5410,10771,0,4716,4727,3330,1397,2.383679313,2136,555,331,184,0,184,0,81,0,0.032608696,empty,mBC-0716-2
"F4,C2",18937,19598,14413,5185,9355,1,4377,4383,3074,1309,2.348357525,2104,5914,2052,1219,3,1216,1,358,0,0.043585526,empty,mBC-0716-2
"F4,C3",19483,19901,14870,5031,9636,0,4399,4419,3077,1342,2.292846498,2102,364,188,118,0,118,0,67,0,0.016949153,empty,mBC-0716-2
"F4,C4",1149283,1228218,819886,408332,581227,0,318370,318894,254191,64703,3.928581364,168397,62630,42037,23390,9,23381,2,2595,0,0.001240323,mm10,mBC-0716-2
"F4,C5",16111,17003,12302,4701,8266,0,3866,3872,2734,1138,2.402460457,1897,830,509,312,1,311,1,124,0,0.038585209,empty,mBC-0716-2
"F4,C6",17471,17964,13110,4854,8922,0,4126,4142,2935,1207,2.431648716,2015,10012,3070,1812,1,1811,1,516,0,0.038652678,empty,mBC-0716-2
"F4,C7",500537,493801,388514,105287,240621,0,95338,95525,72188,23337,3.093285341,43734,1779,1032,565,0,565,0,198,0,0.042477876,empty,mBC-0716-2
"F4,C8",15472,15895,11670,4225,7778,7,3558,3578,2497,1081,2.309898242,1781,933,577,356,0,356,0,158,0,0.019662921,empty,mBC-0716-2
"F4,C9",12894,13157,9728,3429,6498,3,3008,3016,2110,906,2.328918322,1487,3902,1299,796,0,796,0,254,0,0.077889447,empty,mBC-0716-2
"F4,C10",13441,13740,10172,3568,6922,0,3130,3143,2178,965,2.256994819,1549,597,369,204,0,204,0,109,0,0.039215686,empty,mBC-0716-2
"F4,C11",834742,974728,565637,409091,472076,1,294445,294774,219546,75228,2.91840804,172934,40494,26697,15017,8,15009,1,2043,0,0.002798321,mm10,mBC-0716-2
"F4,C12",19543,20105,14732,5373,9736,2,4430,4447,3089,1358,2.27466863,2211,764,431,230,0,230,0,93,0,0.07826087,empty,mBC-0716-2
"F4,D1",584896,636221,417626,218595,312477,18,168885,169120,144075,25045,5.752645239,91993,30951,19570,10957,11,10946,2,1659,0,0.000639503,mm10,mBC-0716-2
"F4,D2",20945,20633,16042,4591,10282,0,4479,4486,3124,1362,2.293685756,2003,2077,1059,636,1,635,1,250,0,0.121259843,empty,mBC-0716-2
"F4,D3",14331,15141,10783,4358,7461,0,3597,3600,2506,1094,2.290676417,1845,868,519,290,0,290,0,131,0,0.044827586,empty,mBC-0716-2
"F4,D4",14453,14956,11132,3824,7252,0,3327,3333,2349,984,2.387195122,1536,1350,744,479,0,479,0,197,0,0.029227557,empty,mBC-0716-2
"F4,D5",13826,14197,10408,3789,7022,0,3240,3245,2289,956,2.394351464,1567,826,495,303,1,302,1,128,0,0.01986755,empty,mBC-0716-2
"F4,D6",13040,13252,9798,3454,6522,0,3098,3112,2118,994,2.130784708,1474,2566,920,560,1,559,1,210,0,0.026833631,empty,mBC-0716-2
"F4,D7",733631,781462,539203,242259,375890,2,192604,192922,159521,33401,4.775934852,100440,87567,48443,27024,9,27015,1,2998,0,0.00692208,mm10,mBC-0716-2
"F4,D8",15653,16262,11837,4425,7807,0,3687,3696,2541,1155,2.2,1827,712,433,266,0,266,0,96,0,0.105263158,empty,mBC-0716-2
"F4,D9",287160,309614,205713,103901,154770,2,83817,83931,59575,24356,2.446009197,45852,19962,11982,6730,4,6726,1,1298,0,0.002230152,mm10,mBC-0716-2
"F4,D10",13238,13854,10105,3749,6689,1,3119,3128,2214,914,2.422319475,1534,687,434,257,0,257,0,91,0,0.101167315,empty,mBC-0716-2
"F4,D11",13470,13787,10156,3631,6945,0,3239,3242,2284,958,2.384133612,1570,1186,735,457,0,457,0,202,0,0.032822757,empty,mBC-0716-2
"F4,D12",20166,20658,15517,5141,9856,0,4442,4446,3173,1273,2.492537313,2105,1590,1055,589,0,589,0,215,0,0.052631579,empty,mBC-0716-2
"F4,E1",2745798,3064849,1861918,1202931,1412635,6,879491,880757,704738,176019,4.003760958,498703,132515,81859,46012,21,45991,2,3958,0,0.00289187,mm10,mBC-0716-2
"F4,E2",16309,16767,12226,4541,8267,6,3730,3742,2582,1160,2.225862069,1821,846,483,295,0,295,0,125,0,0.101694915,empty,mBC-0716-2
"F4,E3",12343,12853,9479,3374,6374,0,2942,2945,2035,910,2.236263736,1403,991,560,360,0,360,0,182,0,0.038888889,empty,mBC-0716-2
"F4,E4",1664852,1874594,1147829,726765,891091,27,542904,543638,405024,138614,2.921955935,310308,44720,28300,15878,11,15867,1,2229,0,0.001071406,mm10,mBC-0716-2
"F4,E5",20574,21255,15916,5339,10210,0,4552,4560,3190,1370,2.328467153,2173,868,519,314,0,314,0,173,0,0,empty,mBC-0716-2
"F4,E6",605691,623717,465694,158023,299436,1,133550,133807,90403,43404,2.082826468,67287,8272,5271,2938,1,2937,1,729,0,0.004766769,mm10,mBC-0716-2
"F4,E7",14196,14478,10839,3639,7012,13,3165,3189,2201,988,2.227732794,1479,886,539,343,0,343,0,149,0,0.04664723,empty,mBC-0716-2
"F4,E8",17816,18186,13602,4584,8780,70,3812,3888,2740,1148,2.386759582,1842,1206,737,418,0,418,0,175,0,0.028708134,empty,mBC-0716-2
"F4,E9",9570,9898,7262,2636,4794,9,2248,2258,1581,677,2.335302806,1070,710,398,259,0,259,0,101,0,0.003861004,empty,mBC-0716-2
"F4,E10",13143,13762,9941,3821,6636,3,3120,3129,2148,981,2.189602446,1556,898,606,362,0,362,0,136,0,0.019337017,empty,mBC-0716-2
"F4,E11",9314,9294,7150,2144,4734,3,2145,2153,1511,642,2.353582555,972,770,512,317,0,317,0,143,0,0.03785489,empty,mBC-0716-2
"F4,E12",16480,17054,12379,4675,8462,0,4132,4140,2886,1254,2.301435407,2066,2548,797,462,0,462,0,189,0,0.051948052,empty,mBC-0716-2
"F4,F1",18688,18710,14332,4378,9112,95,4112,4216,2992,1224,2.444444444,1911,1117,589,331,0,331,0,147,0,0.066465257,empty,mBC-0716-2
"F4,F2",23234,24068,17220,6848,11840,1,5670,5679,3986,1693,2.354400473,2835,2048,1174,715,0,715,0,296,0,0.044755245,empty,mBC-0716-2
"F4,F3",835368,909947,597525,312422,437357,62,239267,239693,197443,42250,4.673207101,129839,81525,52784,29292,14,29278,2,3145,0,0.001161282,mm10,mBC-0716-2
"F4,F4",713812,736466,543878,192588,360333,30,159181,159520,134835,24685,5.462224023,78651,15687,9904,5482,0,5482,0,1029,0,0.001459321,mm10,mBC-0716-2
"F4,F5",24282,25437,18467,6970,12259,0,5760,5766,4084,1682,2.428061831,2880,1271,802,456,1,455,1,216,0,0.035164835,empty,mBC-0716-2
"F4,F6",24498,25161,18401,6760,12212,5,5675,5697,4024,1673,2.405260012,2776,1277,767,431,0,431,0,183,0,0.018561485,empty,mBC-0716-2
"F4,F7",20313,21023,15522,5501,10167,11,4667,4699,3290,1409,2.334989354,2206,441,279,181,0,181,0,104,0,0.038674033,empty,mBC-0716-2
"F4,F8",22088,23143,16746,6397,11155,3,5213,5221,3682,1539,2.392462638,2509,237,139,91,0,91,0,54,0,0,empty,mBC-0716-2
"F4,F9",596395,605192,444269,160923,296716,32,139614,139946,112204,27742,4.044553385,69197,6610,4301,2428,0,2428,0,693,0,0.01029654,mm10,mBC-0716-2
"F4,F10",20139,20710,15411,5299,9979,0,4421,4446,3070,1376,2.231104651,2102,882,520,315,0,315,0,145,0,0,empty,mBC-0716-2
"F4,F11",11822,11938,8900,3038,6058,2,2733,2745,1917,828,2.315217391,1314,2659,995,598,0,598,0,233,0,0.011705686,empty,mBC-0716-2
"F4,F12",14259,14720,10931,3789,7161,0,3315,3325,2264,1061,2.133836004,1631,91,47,28,0,28,0,22,0,0,empty,mBC-0716-2
"F4,G1",10489,10612,8074,2538,5238,10,2364,2376,1693,683,2.478770132,1063,1158,727,430,0,430,0,168,0,0.027906977,empty,mBC-0716-2
"F4,G2",1771729,1888041,1304398,583643,889343,1,468590,469358,382310,87048,4.391944674,242695,28808,17788,9849,4,9845,1,1725,0,0.008329101,mm10,mBC-0716-2
"F4,G3",19778,19871,14988,4883,9831,6,4618,4629,3216,1413,2.276008493,2118,1757,841,522,0,522,0,231,0,0.051724138,empty,mBC-0716-2
"F4,G4",1181102,1253765,870028,383737,590674,28,306496,307017,256564,50453,5.085208015,158458,611,372,210,1,209,1,85,0,0,empty,mBC-0716-2
"F4,G5",14253,14677,10728,3949,7255,0,3386,3396,2375,1021,2.326150833,1638,923,593,356,0,356,0,161,0,0.005617978,empty,mBC-0716-2
"F4,G6",3007475,3205545,2174288,1031257,1466527,7,814118,815440,652552,162888,4.006139188,429145,8588,5330,3012,1,3011,1,689,0,0.000996347,mm10,mBC-0716-2
"F4,G7",20067,20378,15520,4858,9840,1,4428,4439,3099,1340,2.312686567,2053,1211,764,496,0,496,0,203,0,0.0625,empty,mBC-0716-2
"F4,G8",14746,15204,11085,4119,7538,21,3533,3559,2492,1067,2.33552015,1723,1018,548,335,0,335,0,170,0,0.065671642,empty,mBC-0716-2
"F4,G9",12899,13432,9669,3763,6673,0,3180,3185,2309,876,2.635844749,1586,1061,635,383,0,383,0,181,0,0.046997389,empty,mBC-0716-2
"F4,G10",13823,14068,10541,3527,6806,0,3112,3117,2247,870,2.582758621,1429,1034,632,387,0,387,0,178,0,0.028423773,empty,mBC-0716-2
"F4,G11",12760,13163,9755,3408,6438,0,2965,2975,2071,904,2.290929204,1470,534,311,190,0,190,0,90,0,0.036842105,empty,mBC-0716-2
"F4,G12",12523,12929,9023,3906,6100,11,2899,2914,2115,799,2.647058824,1428,8833,3380,2013,2,2011,2,424,0,0.316260567,empty,mBC-0716-2
"F4,H1",21054,21484,15996,5488,10439,0,4813,4820,3417,1403,2.435495367,2305,803,477,276,0,276,0,121,0,0.072463768,empty,mBC-0716-2
"F4,H2",24544,25213,18827,6386,12083,0,5511,5524,3949,1575,2.507301587,2666,4219,1480,897,1,896,1,320,0,0.005580357,empty,mBC-0716-2
"F4,H3",20779,21208,15710,5498,10260,0,4794,4806,3349,1457,2.298558682,2225,4539,1604,920,0,920,0,337,0,0.067391304,empty,mBC-0716-2
"F4,H4",14638,15480,11115,4365,7591,0,3558,3565,2482,1083,2.291782087,1778,156,107,74,0,74,0,51,0,0.013513514,empty,mBC-0716-2
"F4,H5",18014,19034,13499,5535,9181,6,4383,4400,3180,1220,2.606557377,2161,14897,4198,2495,3,2492,1,725,0,0.047351525,empty,mBC-0716-2
"F4,H6",15850,16293,11902,4391,7951,32,3606,3641,2554,1087,2.349586017,1786,1759,767,476,0,476,0,184,0,0.016806723,empty,mBC-0716-2
"F4,H7",17113,17734,12864,4870,8813,29,4031,4075,2934,1141,2.571428571,2032,5667,1903,1105,1,1104,1,345,0,0.025362319,empty,mBC-0716-2
"F4,H8",450592,481026,313571,167455,231582,4,129488,129680,92551,37129,2.492687657,70917,41368,24226,13651,8,13643,2,1985,0,0.015172616,mm10,mBC-0716-2
"F4,H9",16588,16863,12583,4280,8253,5,3710,3723,2711,1012,2.678853755,1759,1033,612,409,0,409,0,196,0,0.036674817,empty,mBC-0716-2
"F4,H10",16211,16520,12056,4464,8207,31,3847,3888,2768,1120,2.471428571,1896,1880,828,479,1,478,1,199,0,0.050209205,empty,mBC-0716-2
"F4,H11",16713,17370,12631,4739,8406,0,3981,3987,2787,1200,2.3225,1962,128,78,60,0,60,0,42,0,0.033333333,empty,mBC-0716-2
"F4,H12",6090,6432,4577,1855,3206,0,1524,1526,1080,446,2.421524664,772,368,216,148,0,148,0,69,0,0.054054054,empty,mBC-0716-2
"F5,A1",14902,15148,11238,3910,7477,7,3491,3504,2413,1091,2.211732356,1630,1306,757,460,0,460,0,194,0,0.047826087,empty,mBC-0716-2
"F5,A2",990322,1031014,743577,287437,488559,17,230467,230981,198087,32894,6.021979692,115488,127980,82289,45340,12,45328,2,3855,0,0.000860395,mm10,mBC-0716-2
"F5,A3",17648,18322,13467,4855,8809,0,4110,4120,2922,1198,2.439065109,1958,1111,691,403,0,403,0,164,0,0.084367246,empty,mBC-0716-2
"F5,A4",22253,22983,17089,5894,10966,0,4899,4912,3413,1499,2.276851234,2327,759,474,306,0,306,0,143,0,0.035947712,empty,mBC-0716-2
"F5,A5",18539,19142,14328,4814,9375,0,4318,4329,3051,1278,2.387323944,1994,1822,1130,707,0,707,0,260,0,0.052333805,empty,mBC-0716-2
"F5,A6",14299,14709,10571,4138,7121,0,3439,3452,2395,1057,2.265846736,1710,33626,10251,6082,5,6077,1,1417,0,0.03439197,empty,mBC-0716-2
"F5,A7",16828,17273,12760,4513,8503,0,3863,3872,2697,1175,2.295319149,1911,1382,846,540,0,540,0,207,0,0.062962963,empty,mBC-0716-2
"F5,A8",11604,12214,8784,3430,6019,14,2790,2810,1997,813,2.456334563,1407,1515,892,578,0,578,0,243,0,0.022491349,empty,mBC-0716-2
"F5,A9",22886,23414,17355,6059,11203,17,5144,5170,3831,1339,2.861090366,2376,1589,891,573,0,573,0,252,0,0.029668412,empty,mBC-0716-2
"F5,A10",16126,16545,12125,4420,8048,0,3657,3666,2541,1125,2.258666667,1745,1919,745,457,0,457,0,201,0,0.039387309,empty,mBC-0716-2
"F5,A11",991388,1065591,709374,356217,509688,1,276374,276839,212504,64335,3.303085412,148508,65338,41796,23232,9,23223,1,2626,0,0.000947337,mm10,mBC-0716-2
"F5,A12",22275,22583,17213,5370,10726,32,4694,4740,3440,1300,2.646153846,2183,2555,1475,881,0,881,0,315,0,0.048808173,empty,mBC-0716-2
"F5,B1",20421,20766,15274,5492,10146,0,4717,4726,3264,1462,2.23255814,2314,3073,1189,730,1,729,1,278,0,0.086419753,empty,mBC-0716-2
"F5,B2",21230,21761,16259,5502,10449,0,4660,4671,3233,1438,2.248261474,2154,467,266,152,0,152,0,89,0,0.046052632,empty,mBC-0716-2
"F5,B3",19328,19762,14610,5152,9648,44,4365,4416,3026,1390,2.176978417,2153,1244,759,450,1,449,1,201,0,0.013363029,empty,mBC-0716-2
"F5,B4",17444,17718,13227,4491,8709,8,4027,4046,2851,1195,2.385774059,1932,1361,667,413,0,413,0,177,0,0.02905569,empty,mBC-0716-2
"F5,B5",745944,415289,268683,146606,271497,6,144828,145800,120797,25003,4.831300244,83912,63681,41749,23019,9,23010,2,2634,0,0.000434594,mm10,mBC-0716-2
"F5,B6",13446,14075,10177,3898,6937,54,3238,3298,2328,970,2.4,1618,1359,836,483,1,482,1,224,0,0.053941909,empty,mBC-0716-2
"F5,B7",16978,17209,13197,4012,8448,0,3701,3708,2588,1120,2.310714286,1681,1248,705,394,0,394,0,180,0,0.027918782,empty,mBC-0716-2
"F5,B8",13689,14213,10542,3671,7085,48,3162,3215,2294,921,2.490770901,1540,1402,828,517,0,517,0,241,0,0.058027079,empty,mBC-0716-2
"F5,B9",892907,986704,633331,353373,472764,1,267350,267751,223157,44594,5.004193389,147342,71781,44205,24335,12,24323,3,2723,0,0.002919048,mm10,mBC-0716-2
"F5,B10",17403,17390,12765,4625,8741,1,4025,4041,2808,1233,2.277372263,1923,670,398,216,1,215,1,98,0,0.041860465,empty,mBC-0716-2
"F5,B11",16832,17413,12737,4676,8322,38,3786,3834,2737,1097,2.494986326,1891,1267,441,287,0,287,0,121,0,0.076655052,empty,mBC-0716-2
"F5,B12",19435,19843,14865,4978,9764,52,4435,4492,3231,1261,2.562252181,2092,3294,1354,793,0,793,0,292,0,0.04035309,empty,mBC-0716-2
"F5,C1",1198656,1261267,897329,363938,592377,12,293366,293874,231290,62584,3.695673015,148386,45911,28766,15945,5,15940,1,2203,0,0.00119197,mm10,mBC-0716-2
"F5,C2",19418,19966,14793,5173,9679,0,4456,4464,3152,1312,2.402439024,2151,1780,1090,597,0,597,0,231,0,0.040201005,empty,mBC-0716-2
"F5,C3",23572,24691,17606,7085,12112,2,5888,5901,4113,1788,2.30033557,2942,672,380,254,1,253,1,105,0,0.027667984,empty,mBC-0716-2
"F5,C4",18281,18456,13945,4511,9084,12,4050,4065,2849,1216,2.342927632,1884,1148,678,367,2,365,1,157,0,0.04109589,empty,mBC-0716-2
"F5,C5",19020,19971,14339,5632,9828,0,4606,4627,3270,1357,2.40972734,2299,1487,932,592,1,591,1,239,0,0.045685279,empty,mBC-0716-2
"F5,C6",19378,19953,14233,5720,9856,0,4653,4675,3358,1317,2.549734244,2285,42984,11898,7006,8,6998,3,1483,0,0.032580737,empty,mBC-0716-2
"F5,C7",16568,17236,12616,4620,8477,0,3951,3961,2701,1260,2.143650794,1928,429,254,161,0,161,0,91,0,0.00621118,empty,mBC-0716-2
"F5,C8",15750,16083,11838,4245,7769,15,3537,3561,2484,1077,2.306406685,1703,1661,977,613,0,613,0,236,0,0.063621533,empty,mBC-0716-2
"F5,C9",13918,14440,10406,4034,7047,9,3319,3338,2381,957,2.487983281,1627,896,521,336,0,336,0,168,0,0.035714286,empty,mBC-0716-2
"F5,C10",14168,14742,10854,3888,7232,0,3238,3252,2223,1029,2.160349854,1534,1102,635,423,0,423,0,185,0,0.052009456,empty,mBC-0716-2
"F5,C11",11924,12709,9018,3691,6276,1,2991,2996,2078,918,2.263616558,1561,1001,593,382,0,382,0,173,0,0.010471204,empty,mBC-0716-2
"F5,C12",20807,21265,15788,5477,10257,4,4650,4667,3211,1456,2.205357143,2231,1204,735,424,1,423,1,199,0,0.026004728,empty,mBC-0716-2
"F5,D1",1176501,1289489,841169,448320,633772,0,360586,361089,275106,85983,3.199539444,198105,35061,22122,12164,9,12155,1,1910,0,0.001809955,mm10,mBC-0716-2
"F5,D2",21840,22338,17046,5292,11051,10,4824,4839,3449,1390,2.481294964,2257,2512,1516,922,1,921,1,368,0,0.04451683,empty,mBC-0716-2
"F5,D3",14448,15152,10834,4318,7416,0,3568,3580,2501,1079,2.317886932,1799,2218,1122,710,0,710,0,288,0,0.033802817,empty,mBC-0716-2
"F5,D4",18772,19038,13601,5437,9117,14,4416,4439,3182,1257,2.531424025,2154,27594,8023,4864,12,4852,4,1192,0,0.058738664,empty,mBC-0716-2
"F5,D5",14300,14859,10760,4099,7230,0,3378,3382,2380,1002,2.375249501,1670,1099,655,407,1,406,1,186,0,0.056650246,empty,mBC-0716-2
"F5,D6",916316,981628,668723,312905,470368,16,245733,246222,205082,41140,4.984978123,129375,91074,53882,29780,13,29767,3,3222,0,0.005408674,mm10,mBC-0716-2
"F5,D7",13671,13571,10252,3319,6681,7,3154,3171,2164,1007,2.148957299,1505,2353,1126,714,0,714,0,264,0,0.012605042,empty,mBC-0716-2
"F5,D8",16586,17240,12543,4697,8361,0,3903,3912,2666,1246,2.13964687,1883,1022,639,412,0,412,0,189,0,0.009708738,empty,mBC-0716-2
"F5,D9",5468,5628,3985,1643,2966,1,1462,1469,1005,464,2.165948276,775,2773,1263,813,1,812,1,345,0,0.034482759,empty,mBC-0716-2
"F5,D10",769883,861977,546900,315077,420151,3,238595,238936,200553,38383,5.225047547,132690,56276,37224,20591,8,20583,1,2439,0,0.002769276,mm10,mBC-0716-2
"F5,D11",15231,16107,11514,4593,7807,0,3637,3646,2570,1076,2.388475836,1822,1924,1138,681,0,681,0,268,0,0.057268722,empty,mBC-0716-2
"F5,D12",21088,21611,16183,5428,10432,6,4761,4777,3350,1427,2.347582341,2258,2512,1501,881,0,881,0,302,0,0.038592509,empty,mBC-0716-2
"F5,E1",4133186,4219963,3111357,1108606,1864182,8,927012,928796,783093,145703,5.374583914,456109,258842,161459,89128,28,89100,3,5924,0,0.0028844,mm10,mBC-0716-2
"F5,E2",17196,17630,13095,4535,8646,1,3863,3876,2796,1080,2.588888889,1881,2276,1247,719,0,719,0,255,0,0.044506259,empty,mBC-0716-2
"F5,E3",13276,13797,10141,3656,6660,0,3002,3016,2084,932,2.236051502,1470,1978,1258,751,1,750,1,279,0,0.064,empty,mBC-0716-2
"F5,E4",16342,16549,12408,4141,8252,0,3816,3823,2696,1127,2.392191659,1858,2303,1122,673,0,673,0,228,0,0.111441308,empty,mBC-0716-2
"F5,E5",21165,21723,16274,5449,10765,0,4849,4860,3433,1427,2.405746321,2287,1727,1040,598,0,598,0,286,0,0.028428094,empty,mBC-0716-2
"F5,E6",14841,15088,11392,3696,7265,0,3238,3245,2339,906,2.581677704,1509,1982,1089,691,0,691,0,280,0,0.05065123,empty,mBC-0716-2
"F5,E7",14266,14473,10856,3617,7072,8,3226,3248,2245,1003,2.238285145,1513,1338,847,527,0,527,0,213,0,0.05313093,empty,mBC-0716-2
"F5,E8",18861,19151,14387,4764,9387,23,4126,4162,2948,1214,2.428336079,1998,2043,1257,741,1,740,1,288,0,0.058108108,empty,mBC-0716-2
"F5,E9",9410,9522,7022,2500,4624,4,2112,2128,1465,663,2.209653092,978,1079,606,352,0,352,0,151,0,0.09375,empty,mBC-0716-2
"F5,E10",14050,14643,10659,3984,7129,0,3329,3330,2331,999,2.333333333,1603,1300,780,472,0,472,0,211,0,0.021186441,empty,mBC-0716-2
"F5,E11",9755,10165,7392,2773,5126,3,2412,2423,1739,684,2.542397661,1227,1144,684,404,0,404,0,184,0,0.024752475,empty,mBC-0716-2
"F5,E12",16194,16522,12145,4377,8128,0,3828,3844,2641,1203,2.195344971,1829,1400,793,458,0,458,0,174,0,0.026200873,empty,mBC-0716-2
"F5,F1",893637,961932,658166,303766,462326,1,236225,236646,202178,34468,5.865672508,123610,131820,85836,47073,20,47053,1,3985,0,0.001126389,mm10,mBC-0716-2
"F5,F2",1097925,1240701,751119,489582,594143,2,354226,354837,285788,69049,4.138915842,204236,159148,101846,56643,21,56622,3,4329,0,0.00487443,mm10,mBC-0716-2
"F5,F3",16678,17094,12422,4672,8527,0,4082,4092,2823,1269,2.224586288,2026,2030,1251,784,1,783,1,302,0,0.03192848,empty,mBC-0716-2
"F5,F4",16633,16825,12347,4478,8362,37,3796,3847,2707,1140,2.374561404,1872,956,437,281,0,281,0,120,0,0.042704626,empty,mBC-0716-2
"F5,F5",27168,27732,20540,7192,13191,0,6080,6094,4290,1804,2.37804878,2878,2377,1468,871,0,871,0,358,0,0.063145809,empty,mBC-0716-2
"F5,F6",29457,30420,22558,7862,14539,0,6681,6699,4813,1886,2.551961824,3201,3246,2047,1196,1,1195,1,387,0,0.051882845,empty,mBC-0716-2
"F5,F7",21529,22538,16328,6210,11082,1,5073,5091,3512,1579,2.224192527,2510,3179,1287,768,0,768,0,277,0,0.040364583,empty,mBC-0716-2
"F5,F8",982785,1117294,664086,453208,542844,0,339301,339774,261710,78064,3.352505636,196050,7688,4923,2884,2,2882,1,649,0,0.003469813,mm10,mBC-0716-2
"F5,F9",15639,16049,11981,4068,7808,20,3485,3512,2466,1046,2.357552581,1658,1571,953,553,0,553,0,221,0,0.023508137,empty,mBC-0716-2
"F5,F10",25960,26914,20043,6871,12853,0,5869,5878,4225,1653,2.555958863,2706,1447,878,524,0,524,0,209,0,0.028625954,empty,mBC-0716-2
"F5,F11",11912,12171,9183,2988,6129,0,2735,2748,1925,823,2.339003645,1329,1165,715,442,0,442,0,199,0,0.074660633,empty,mBC-0716-2
"F5,F12",15144,15562,11512,4050,7518,0,3468,3474,2475,999,2.477477477,1647,251,154,97,0,97,0,51,0,0,empty,mBC-0716-2
"F5,G1",10315,10657,8203,2454,5251,1,2278,2289,1530,759,2.015810277,1020,1810,1115,624,0,624,0,223,0,0.004807692,empty,mBC-0716-2
"F5,G2",22350,22889,17133,5756,11053,0,4997,5004,3558,1446,2.460580913,2298,733,461,310,0,310,0,167,0,0.025806452,empty,mBC-0716-2
"F5,G3",906347,1039011,618076,420935,503134,3,310120,310557,244568,65989,3.706193456,179811,71397,47077,26296,6,26290,1,3091,0,0.001939901,mm10,mBC-0716-2
"F5,G4",30922,31489,23573,7916,15371,26,6842,6888,4892,1996,2.450901804,3291,166,118,89,0,89,0,63,0,0,empty,mBC-0716-2
"F5,G5",14135,14372,10609,3763,7077,0,3271,3287,2296,991,2.316851665,1554,1426,872,542,0,542,0,279,0,0.033210332,empty,mBC-0716-2
"F5,G6",24975,25422,19170,6252,12268,1,5432,5446,3897,1549,2.515816656,2476,278,167,109,0,109,0,66,0,0.036697248,empty,mBC-0716-2
"F5,G7",1542107,1744448,1037223,707225,823663,4,517647,518370,406503,111867,3.633806216,297185,137192,90093,49298,22,49276,1,3978,0,0.000953811,mm10,mBC-0716-2
"F5,G8",15552,16048,11968,4080,7728,16,3568,3596,2423,1173,2.065643649,1724,2332,1241,761,0,761,0,312,0,0.043363995,empty,mBC-0716-2
"F5,G9",11437,11820,8525,3295,5854,36,2732,2780,1950,830,2.34939759,1395,6782,2395,1439,1,1438,1,483,0,0.066759388,empty,mBC-0716-2
"F5,G10",885228,938630,642107,296523,455184,1,244930,245282,184515,60767,3.036434249,128397,19857,11792,6624,7,6617,2,1445,0,0.00513828,mm10,mBC-0716-2
"F5,G11",13082,13354,10063,3291,6494,0,2930,2937,2057,880,2.3375,1347,1083,507,302,0,302,0,142,0,0.086092715,empty,mBC-0716-2
"F5,G12",12458,13065,9461,3604,6301,9,2975,2989,2091,898,2.328507795,1431,1389,849,512,0,512,0,191,0,0.087890625,empty,mBC-0716-2
"F5,H1",21790,22290,16602,5688,10862,17,4924,4956,3492,1464,2.385245902,2365,1099,683,432,0,432,0,185,0,0.037037037,empty,mBC-0716-2
"F5,H2",1446724,1602349,984737,617612,757122,0,464859,465556,382901,82655,4.632520719,261445,104117,67489,37136,28,37108,4,3598,0,0.001805541,mm10,mBC-0716-2
"F5,H3",23933,24512,18132,6380,11817,8,5427,5451,3838,1613,2.379417235,2587,1928,1079,609,0,609,0,272,0,0.016420361,empty,mBC-0716-2
"F5,H4",14807,15376,11159,4217,7545,13,3569,3592,2537,1055,2.404739336,1758,275,163,116,0,116,0,78,0,0,empty,mBC-0716-2
"F5,H5",18684,19538,14381,5157,9326,0,4379,4386,3075,1311,2.345537757,2099,2280,984,599,0,599,0,250,0,0.020033389,empty,mBC-0716-2
"F5,H6",15602,15678,11508,4170,7791,0,3619,3624,2520,1104,2.282608696,1778,12509,4526,2735,1,2734,1,866,0,0.056327725,empty,mBC-0716-2
"F5,H7",17874,18666,13525,5141,9159,0,4244,4259,2983,1276,2.337774295,2084,1806,1065,624,0,624,0,280,0,0.028846154,empty,mBC-0716-2
"F5,H8",14499,14998,10972,4026,7221,1,3333,3334,2378,956,2.487447699,1635,1906,1176,683,0,683,0,275,0,0.01317716,empty,mBC-0716-2
"F5,H9",18224,19021,13948,5073,9246,69,4295,4370,3163,1207,2.62054681,2109,1396,843,511,0,511,0,266,0,0.021526419,empty,mBC-0716-2
"F5,H10",657902,722277,467249,255028,352360,12,197905,198221,151960,46261,3.284840362,109165,55249,31426,17303,9,17294,3,2317,0,0.005261941,mm10,mBC-0716-2
"F5,H11",781997,881723,549155,332568,431168,1,253524,253910,190351,63559,2.994870907,143893,2199,1512,861,1,860,1,256,0,0.004651163,empty,mBC-0716-2
"F5,H12",6608,7094,5007,2087,3432,0,1651,1661,1122,539,2.081632653,853,582,339,214,1,213,1,110,0,0.070422535,empty,mBC-0716-2
"F6,A1",16202,16892,12299,4593,8498,0,4087,4104,2891,1213,2.383347073,2043,1800,1134,704,0,704,0,289,0,0.061079545,empty,mBC-0716-2
"F6,A2",21836,22529,16318,6211,10588,1,4804,4813,3337,1476,2.260840108,2351,14904,4955,2993,1,2992,1,760,0,0.096925134,empty,mBC-0716-2
"F6,A3",1045640,1158982,741546,417436,556845,0,314985,315464,246267,69197,3.558925965,175171,52327,33667,18787,8,18779,1,2367,0,0.002875552,mm10,mBC-0716-2
"F6,A4",22786,23054,17723,5331,11310,0,5000,5012,3577,1435,2.492682927,2267,1080,659,444,0,444,0,216,0,0.038288288,empty,mBC-0716-2
"F6,A5",19467,20045,14706,5339,10002,0,4709,4714,3292,1422,2.315049226,2295,2315,1285,816,0,816,0,380,0,0.023284314,empty,mBC-0716-2
"F6,A6",629883,685678,455311,230367,333714,9,177698,177937,154534,23403,6.603170534,95556,144364,83848,46891,28,46863,4,4165,0,0.003969016,mm10,mBC-0716-2
"F6,A7",16938,17608,13005,4603,8552,0,3961,3972,2779,1193,2.329421626,1901,1621,898,603,0,603,0,269,0,0.053067993,empty,mBC-0716-2
"F6,A8",11839,12234,8910,3324,6003,0,2818,2820,1934,886,2.182844244,1351,2175,1318,814,1,813,1,333,0,0.072570726,empty,mBC-0716-2
"F6,A9",23487,24146,17959,6187,11779,7,5320,5331,3763,1568,2.399872449,2620,2234,1442,840,0,840,0,332,0,0.027380952,empty,mBC-0716-2
"F6,A10",17463,17909,13238,4671,8779,1,4170,4180,2923,1257,2.325377884,1963,725,419,265,0,265,0,160,0,0.018867925,empty,mBC-0716-2
"F6,A11",19977,20269,15275,4994,10013,2,4457,4466,3111,1355,2.295940959,2113,1780,1022,714,1,713,1,332,0,0.01542777,empty,mBC-0716-2
"F6,A12",957167,1038393,698165,340228,492129,1,260074,260481,223855,36626,6.111915033,137534,288432,190203,104711,42,104669,3,5586,0,0.001671937,mm10,mBC-0716-2
"F6,B1",20014,20886,15309,5577,10181,0,4596,4601,3242,1359,2.385577631,2150,1823,913,580,0,580,0,286,0,0.05,empty,mBC-0716-2
"F6,B2",1106922,1204277,811816,392461,574373,3,299571,300071,242616,57455,4.222713428,158520,28854,17674,9991,6,9985,2,1532,0,0.003104657,mm10,mBC-0716-2
"F6,B3",19966,21293,15278,6015,10333,0,4810,4822,3358,1464,2.293715847,2405,6457,2290,1440,4,1436,1,500,0,0.02367688,empty,mBC-0716-2
"F6,B4",630624,633512,483346,150166,311599,0,136451,136688,107165,29523,3.629881787,65171,23527,14224,8138,4,8134,2,1530,0,0.002581756,mm10,mBC-0716-2
"F6,B5",735337,383667,260614,123053,253303,17,122920,123939,105135,18804,5.591097639,70130,83795,52906,29045,13,29032,2,3023,0,0.001687793,mm10,mBC-0716-2
"F6,B6",768401,849154,545945,303209,411665,1,229347,229667,190692,38975,4.892674792,126090,107595,72372,40520,9,40511,2,3590,0,0.00069117,mm10,mBC-0716-2
"F6,B7",725679,799200,516813,282387,391255,16,229678,230038,139083,90955,1.529140784,126367,29103,11618,6703,3,6700,3,1476,0,0.047164179,mm10,mBC-0716-2
"F6,B8",14996,15246,11487,3759,7535,13,3384,3399,2408,991,2.429868819,1559,2246,1479,904,0,904,0,362,0,0.055309735,empty,mBC-0716-2
"F6,B9",15604,16212,11974,4238,7899,1,3637,3645,2595,1050,2.471428571,1770,1154,655,438,0,438,0,206,0,0.068493151,empty,mBC-0716-2
"F6,B10",1543591,1562624,1093622,469002,771987,8,389745,391064,320495,70569,4.541583415,202708,49426,31816,17506,17,17489,2,2370,0,0.001601006,mm10,mBC-0716-2
"F6,B11",17418,18074,13387,4687,8796,6,4018,4030,2847,1183,2.406593407,1958,353,218,152,0,152,0,106,0,0.019736842,empty,mBC-0716-2
"F6,B12",19191,19951,14646,5305,9857,0,4564,4567,3220,1347,2.390497402,2214,1949,1181,681,0,681,0,281,0,0.039647577,empty,mBC-0716-2
"F6,C1",23734,24122,18347,5775,11767,2,5088,5101,3621,1480,2.446621622,2351,1000,603,397,0,397,0,197,0,0.090680101,empty,mBC-0716-2
"F6,C2",20014,20483,15418,5065,9891,12,4575,4591,3234,1357,2.383198231,2148,2162,1298,786,0,786,0,295,0,0.044529262,empty,mBC-0716-2
"F6,C3",27135,28076,20438,7638,13783,1,6592,6615,4835,1780,2.716292135,3235,1116,722,456,0,456,0,208,0,0.028508772,empty,mBC-0716-2
"F6,C4",19402,19421,14832,4589,9475,0,4154,4160,2998,1162,2.580034423,1865,1573,974,591,1,590,1,241,0,0.038983051,empty,mBC-0716-2
"F6,C5",18645,19458,14085,5373,9535,12,4583,4600,3298,1302,2.533026114,2255,1849,1151,712,0,712,0,321,0,0.037921348,empty,mBC-0716-2
"F6,C6",18284,18696,13885,4811,9478,0,4454,4468,3138,1330,2.359398496,2118,1766,1083,696,0,696,0,321,0,0.031609195,empty,mBC-0716-2
"F6,C7",18302,18869,13855,5014,9239,0,4316,4331,3099,1232,2.515422078,2087,616,366,258,0,258,0,142,0,0.015503876,empty,mBC-0716-2
"F6,C8",16462,17040,12085,4955,8415,0,4023,4023,2803,1220,2.297540984,2018,6209,2783,1737,1,1736,1,522,0,0.215437788,empty,mBC-0716-2
"F6,C9",13897,14646,10611,4035,7096,13,3315,3333,2355,978,2.40797546,1590,1181,663,441,0,441,0,228,0,0.020408163,empty,mBC-0716-2
"F6,C10",15285,16007,11648,4359,7830,0,3629,3639,2574,1065,2.416901408,1756,9042,2926,1796,1,1795,1,544,0,0.051810585,empty,mBC-0716-2
"F6,C11",12286,12791,9163,3628,6287,0,2938,2943,2032,911,2.230515917,1505,1248,757,487,0,487,0,236,0,0.028747433,empty,mBC-0716-2
"F6,C12",21847,22828,16410,6418,10852,0,5063,5075,3631,1444,2.514542936,2515,1597,911,572,0,572,0,238,0,0.041958042,empty,mBC-0716-2
"F6,D1",13266,13783,9942,3841,6992,25,3382,3408,2417,991,2.438950555,1695,904,562,351,0,351,0,173,0,0.017094017,empty,mBC-0716-2
"F6,D2",21975,22372,16987,5385,10950,0,4817,4831,3396,1435,2.366550523,2258,3462,2091,1317,1,1316,1,541,0,0.045592705,empty,mBC-0716-2
"F6,D3",670210,702857,496360,206497,342489,3,170098,170416,145281,25135,5.78002785,87274,157796,83718,47162,34,47128,3,4196,0,0.005983704,mm10,mBC-0716-2
"F6,D4",15623,15955,11850,4105,7934,10,3646,3659,2547,1112,2.290467626,1756,2159,1303,863,0,863,0,411,0,0.022016222,empty,mBC-0716-2
"F6,D5",18100,19076,13757,5319,9369,2,4543,4554,3067,1487,2.062542031,2260,1646,967,581,0,581,0,274,0,0.015490534,empty,mBC-0716-2
"F6,D6",14073,15056,10490,4566,7287,0,3529,3539,2461,1078,2.282931354,1789,1647,987,625,1,624,1,313,0,0.025641026,empty,mBC-0716-2
"F6,D7",20835,22358,15402,6956,10692,0,5573,5583,3955,1628,2.429361179,2853,2135,1299,774,0,774,0,321,0,0.033591731,empty,mBC-0716-2
"F6,D8",17537,18357,13095,5262,8881,26,4237,4270,3021,1249,2.418734988,2126,3232,1232,786,0,786,0,331,0,0.043256997,empty,mBC-0716-2
"F6,D9",6791,7181,5011,2170,3658,15,1767,1786,1290,496,2.600806452,931,2201,1285,834,0,834,0,398,0,0.056354916,empty,mBC-0716-2
"F6,D10",15816,16814,11869,4945,8117,0,3906,3915,2698,1217,2.216926869,1972,1658,888,547,0,547,0,235,0,0.115173675,empty,mBC-0716-2
"F6,D11",1691511,1906723,1178241,728482,914403,4,541511,542286,438461,103825,4.223077294,306628,377735,222270,123824,78,123746,7,6433,0,0.010812471,mm10,mBC-0716-2
"F6,D12",25679,26877,19734,7143,12793,6,6024,6045,4352,1693,2.570584761,2908,3327,2089,1229,2,1227,1,388,0,0.044824776,empty,mBC-0716-2
"F6,E1",1230009,1351038,855464,495574,645279,20,382261,382798,303679,79119,3.838256297,212399,68112,42468,23892,8,23884,3,2696,0,0.002554011,mm10,mBC-0716-2
"F6,E2",17644,18209,13509,4700,9052,6,4121,4138,2937,1201,2.445462115,1997,2183,1179,712,0,712,0,321,0,0.061797753,empty,mBC-0716-2
"F6,E3",13257,13504,10154,3350,6714,1,3081,3095,2068,1027,2.013631938,1451,2343,1442,885,1,884,1,377,0,0.031674208,empty,mBC-0716-2
"F6,E4",16627,16629,12535,4094,8243,35,3657,3705,2694,1011,2.664688427,1764,3073,1363,878,1,877,1,349,0,0.028506271,empty,mBC-0716-2
"F6,E5",22502,23292,17187,6105,11363,17,5046,5072,3604,1468,2.455040872,2447,3915,1800,1112,0,1112,0,436,0,0.054856115,empty,mBC-0716-2
"F6,E6",802333,858133,584449,273684,412857,9,217304,217683,184034,33649,5.469226426,114694,89686,55939,30823,16,30807,3,3375,0,0.001493167,mm10,mBC-0716-2
"F6,E7",15681,16293,11748,4545,8107,0,3877,3899,2767,1132,2.44434629,1954,2530,1389,855,0,855,0,340,0,0.106432749,empty,mBC-0716-2
"F6,E8",562988,577341,410410,166931,286842,0,143575,143818,102394,41424,2.471852066,72573,11939,6306,3493,1,3492,1,975,0,0.024914089,mm10,mBC-0716-2
"F6,E9",10520,10633,8118,2515,5095,13,2262,2279,1611,668,2.411676647,1006,1369,881,542,0,542,0,217,0,0.049815498,empty,mBC-0716-2
"F6,E10",14041,14478,10729,3749,6973,3,3195,3208,2182,1026,2.126705653,1507,2013,1264,771,0,771,0,303,0,0.04539559,empty,mBC-0716-2
"F6,E11",760909,857197,520889,336308,422320,6,255102,255508,210661,44847,4.697326466,145634,83376,54555,30456,6,30450,1,3145,0,0.002200328,mm10,mBC-0716-2
"F6,E12",811877,965276,520995,444281,473894,9,323468,323856,237053,86803,2.730930959,195395,49633,31172,17540,4,17536,1,2401,0,0.004219891,mm10,mBC-0716-2
"F6,F1",1079517,1167412,776125,391287,555500,23,302131,302600,260210,42390,6.138476056,162090,146089,90901,50322,32,50290,6,4146,0,0.001710082,mm10,mBC-0716-2
"F6,F2",2662075,2911548,1897558,1013990,1362093,22,787071,788236,618567,169669,3.645727858,431867,226718,147431,81955,30,81925,3,5568,0,0.003039365,mm10,mBC-0716-2
"F6,F3",24745,25966,18701,7265,12691,6,5975,5991,4301,1690,2.544970414,2969,6331,3115,1963,0,1963,0,606,0,0.128884361,empty,mBC-0716-2
"F6,F4",697420,720867,505048,215819,361321,1,186947,187253,143790,43463,3.308331224,96357,8717,5225,2953,0,2953,0,723,0,0.003386387,mm10,mBC-0716-2
"F6,F5",27063,28728,20628,8100,13994,20,6614,6646,4722,1924,2.454261954,3319,5610,2593,1647,0,1647,0,592,0,0.034608379,empty,mBC-0716-2
"F6,F6",1370903,1360033,1037559,322474,651422,3,295904,296479,236114,60365,3.911438748,137525,97943,48801,27848,14,27834,1,3823,0,0.028921463,mm10,mBC-0716-2
"F6,F7",21479,22047,16576,5471,10888,28,4922,4967,3542,1425,2.485614035,2324,1160,674,452,1,451,1,223,0,0.055432373,empty,mBC-0716-2
"F6,F8",23785,24477,18242,6235,12077,1,5547,5560,3944,1616,2.440594059,2614,625,415,276,0,276,0,159,0,0.032608696,empty,mBC-0716-2
"F6,F9",15859,16507,11939,4568,8126,0,3834,3850,2690,1160,2.318965517,1896,3943,1811,1040,0,1040,0,392,0,0.036538462,empty,mBC-0716-2
"F6,F10",22115,23334,16955,6379,11202,0,4981,4998,3430,1568,2.1875,2454,1839,1082,646,1,645,1,300,0,0.052713178,empty,mBC-0716-2
"F6,F11",1625859,1727211,1187208,540003,827986,38,439882,440596,366225,74371,4.92429845,229837,136228,88247,49277,20,49257,2,4266,0,0.001197799,mm10,mBC-0716-2
"F6,F12",15737,16240,11853,4387,7867,0,3617,3625,2522,1103,2.286491387,1753,533,222,159,0,159,0,98,0,0.13836478,empty,mBC-0716-2
"F6,G1",10821,11071,8448,2623,5490,3,2446,2454,1683,771,2.182879377,1120,2077,1236,803,0,803,0,292,0,0.02366127,empty,mBC-0716-2
"F6,G2",22979,23473,17716,5757,11561,7,5213,5237,3656,1581,2.312460468,2482,923,594,429,0,429,0,246,0,0.002331002,empty,mBC-0716-2
"F6,G3",21818,22587,16607,5980,10943,0,5024,5031,3505,1526,2.296854522,2413,2634,1596,973,1,972,1,436,0,0.04526749,empty,mBC-0716-2
"F6,G4",30823,31180,23581,7599,15187,45,6560,6615,4693,1922,2.441727367,3135,387,215,138,0,138,0,93,0,0.014492754,empty,mBC-0716-2
"F6,G5",1014183,1101575,738159,363416,523714,5,281146,281586,225383,56203,4.0101596,150434,102450,64535,36050,21,36029,5,3564,0,0.001498793,mm10,mBC-0716-2
"F6,G6",1216655,1386546,806252,580294,664666,15,420190,420736,280079,140657,1.991219776,250788,3828,2372,1352,0,1352,0,383,0,0.011094675,mm10,mBC-0716-2
"F6,G7",21512,21817,16289,5528,10741,0,4763,4769,3354,1415,2.370318021,2267,5403,2341,1383,0,1383,0,514,0,0.070137383,empty,mBC-0716-2
"F6,G8",16235,17167,12274,4893,8297,0,3984,3997,2742,1255,2.184860558,2017,2211,1318,861,0,861,0,384,0,0.018583043,empty,mBC-0716-2
"F6,G9",832284,904277,597094,307183,438145,7,242322,242671,199595,43076,4.633554648,130515,79665,52596,29667,14,29653,4,3062,0,0.000741915,mm10,mBC-0716-2
"F6,G10",14769,15441,11292,4149,7501,2,3402,3418,2397,1021,2.347698335,1681,1973,1233,837,1,836,1,367,0,0.011961722,empty,mBC-0716-2
"F6,G11",506251,550475,376727,173748,269693,0,140609,140843,107934,32909,3.279771491,73918,31792,20817,11354,4,11350,1,1622,0,0.006784141,mm10,mBC-0716-2
"F6,G12",12256,12872,9248,3624,6511,0,3101,3110,2196,914,2.402625821,1542,1464,889,537,0,537,0,227,0,0.054003724,empty,mBC-0716-2
"F6,H1",883498,972790,628869,343921,471118,0,262089,262464,217434,45030,4.828647568,144379,70133,46504,25815,6,25809,1,2763,0,0.001123639,mm10,mBC-0716-2
"F6,H2",30383,31820,23120,8700,15799,0,7432,7453,5391,2062,2.614451988,3749,3035,1898,1158,1,1157,1,455,0,0.02852204,empty,mBC-0716-2
"F6,H3",23261,23987,17784,6203,11705,15,5315,5342,3867,1475,2.621694915,2594,2292,1313,772,0,772,0,349,0,0.051813472,empty,mBC-0716-2
"F6,H4",16694,17034,12599,4435,8412,1,3851,3858,2709,1149,2.35770235,1874,474,303,219,0,219,0,156,0,0,empty,mBC-0716-2
"F6,H5",709763,775775,519359,256416,377282,17,196883,197217,167711,29506,5.683962584,106114,105621,66833,37060,19,37041,1,3567,0,0.001538835,mm10,mBC-0716-2
"F6,H6",16225,16663,12245,4418,8211,1,3901,3908,2752,1156,2.380622837,1840,3925,1688,1049,0,1049,0,431,0,0.03336511,empty,mBC-0716-2
"F6,H7",19083,19609,14380,5229,9643,1,4496,4511,3252,1259,2.583002383,2118,2347,1335,863,0,863,0,373,0,0.017381228,empty,mBC-0716-2
"F6,H8",15366,15889,11666,4223,7835,2,3682,3689,2637,1052,2.506653992,1816,2569,1550,973,1,972,1,412,0,0.014403292,empty,mBC-0716-2
"F6,H9",740205,777566,560502,217064,377227,0,173461,173700,150994,22706,6.649960363,86960,165195,109673,61074,30,61044,3,4363,0,0.001376057,mm10,mBC-0716-2
"F6,H10",1741513,1899171,1220682,678489,897667,8,518957,519743,406567,113176,3.5923429,286765,116728,74698,42027,12,42015,1,3912,0,0.001570868,mm10,mBC-0716-2
"F6,H11",17964,18731,13459,5272,9105,17,4268,4302,2996,1306,2.294027565,2115,394,208,141,0,141,0,118,0,0.04964539,empty,mBC-0716-2
"F6,H12",6623,6898,5083,1815,3357,4,1551,1557,1103,454,2.429515419,711,793,452,278,0,278,0,147,0,0.053956835,empty,mBC-0716-2
"F7,A1",18929,20235,14394,5841,9831,0,4559,4571,3393,1178,2.880305603,2268,890,500,330,0,330,0,147,0,0.006060606,empty,mBC-0716-2
"F7,A2",20751,21092,15792,5300,10153,8,4466,4487,3231,1256,2.572452229,2080,1042,588,370,0,370,0,159,0,0.083783784,empty,mBC-0716-2
"F7,A3",17508,18130,13222,4908,8902,0,4219,4222,3032,1190,2.54789916,2051,1046,609,383,0,383,0,154,0,0.039164491,empty,mBC-0716-2
"F7,A4",22861,23138,17464,5674,11249,56,4911,4984,3601,1383,2.603759942,2221,913,403,220,0,220,0,130,0,0.018181818,empty,mBC-0716-2
"F7,A5",17733,18459,13503,4956,9259,3,4299,4313,3030,1283,2.361652377,2144,1208,755,439,0,439,0,200,0,0.047835991,empty,mBC-0716-2
"F7,A6",14130,14546,10659,3887,7104,0,3259,3270,2314,956,2.420502092,1568,1233,744,458,1,457,1,226,0,0.067833698,empty,mBC-0716-2
"F7,A7",17333,17757,13377,4380,8687,45,3911,3971,2758,1213,2.273701566,1804,1011,696,419,0,419,0,171,0,0.026252983,empty,mBC-0716-2
"F7,A8",11098,11611,8551,3060,5706,0,2648,2653,1882,771,2.440985733,1269,991,553,342,0,342,0,178,0,0.029239766,empty,mBC-0716-2
"F7,A9",21196,21369,16085,5284,10247,6,4575,4597,3284,1313,2.501142422,2113,2884,1266,801,0,801,0,270,0,0.149812734,empty,mBC-0716-2
"F7,A10",17374,17755,13366,4389,8539,0,3948,3951,2800,1151,2.432667246,1790,432,232,149,0,149,0,82,0,0.020134228,empty,mBC-0716-2
"F7,A11",19952,20323,15104,5219,10056,4,4523,4542,3193,1349,2.366938473,2176,4297,1474,917,2,915,1,330,0,0.098360656,empty,mBC-0716-2
"F7,A12",827887,894631,602316,292315,429441,7,228249,228632,184202,44430,4.145892415,120327,153496,96949,53502,28,53474,2,4189,0,0.003852339,mm10,mBC-0716-2
"F7,B1",20931,21454,16086,5368,10515,0,4784,4803,3377,1426,2.368162693,2242,1022,647,378,1,377,1,185,0,0.026525199,empty,mBC-0716-2
"F7,B2",21040,21507,16077,5430,10602,0,4801,4810,3345,1465,2.283276451,2252,430,250,156,0,156,0,82,0,0.083333333,empty,mBC-0716-2
"F7,B3",19993,20328,15018,5310,9838,2,4556,4575,3205,1370,2.339416058,2179,12767,3997,2416,0,2416,0,710,0,0.01365894,empty,mBC-0716-2
"F7,B4",17704,18368,13515,4853,8837,30,4014,4052,2852,1200,2.376666667,1972,829,428,257,1,256,1,138,0,0.0078125,empty,mBC-0716-2
"F7,B5",9614,5715,3901,1814,3666,0,1785,1804,1240,564,2.19858156,957,645,375,225,0,225,0,100,0,0.106666667,empty,mBC-0716-2
"F7,B6",14124,14688,10608,4080,7280,16,3386,3414,2415,999,2.417417417,1715,962,616,370,1,369,1,166,0,0.070460705,empty,mBC-0716-2
"F7,B7",17563,18184,13310,4874,8825,1,4090,4098,2884,1214,2.375617792,1971,5947,1878,1109,2,1107,2,364,0,0.028906956,empty,mBC-0716-2
"F7,B8",14345,14767,10969,3798,7147,0,3199,3208,2257,951,2.373291272,1528,4472,1680,1014,2,1012,2,387,0,0.029644269,empty,mBC-0716-2
"F7,B9",15887,16275,12205,4070,7852,0,3532,3543,2544,999,2.546546547,1702,608,377,232,1,231,1,115,0,0.025974026,empty,mBC-0716-2
"F7,B10",17632,17992,13015,4977,8998,0,4209,4224,2956,1268,2.331230284,2041,488,243,144,0,144,0,86,0,0.006944444,empty,mBC-0716-2
"F7,B11",17406,17729,13262,4467,8594,2,3937,3954,2658,1296,2.050925926,1875,276,157,116,0,116,0,78,0,0.00862069,empty,mBC-0716-2
"F7,B12",19229,19680,14717,4963,9644,0,4362,4372,3173,1199,2.646371977,2069,970,571,342,0,342,0,163,0,0.029239766,empty,mBC-0716-2
"F7,C1",1340738,1446842,968379,478463,677921,18,368072,368718,296971,71747,4.139141706,195624,24577,16214,9191,3,9188,1,1496,0,0.001523727,mm10,mBC-0716-2
"F7,C2",1212916,1313439,864553,448886,620981,0,346552,347040,298226,48814,6.109435818,186497,63821,41151,23181,8,23173,1,2667,0,0.00388383,mm10,mBC-0716-2
"F7,C3",1870535,2108222,1291026,817196,1011543,3,619838,620680,472784,147896,3.196732839,356863,20716,13300,7299,4,7295,1,1300,0,0.002878684,mm10,mBC-0716-2
"F7,C4",22035,22801,16780,6021,11157,0,5144,5152,3581,1571,2.279439847,2475,1263,765,435,0,435,0,187,0,0.066666667,empty,mBC-0716-2
"F7,C5",17457,18179,13294,4885,8976,2,4272,4280,3009,1271,2.367427223,2082,995,604,389,0,389,0,191,0,0.059125964,empty,mBC-0716-2
"F7,C6",17778,18289,13477,4812,9153,1,4353,4371,3135,1236,2.536407767,2078,1116,663,397,0,397,0,176,0,0.022670025,empty,mBC-0716-2
"F7,C7",17668,18202,13226,4976,8897,1,4192,4206,2956,1250,2.3648,2017,1230,448,258,0,258,0,103,0,0.03875969,empty,mBC-0716-2
"F7,C8",16547,17264,12490,4774,8394,1,3908,3918,2762,1156,2.389273356,1924,1333,777,480,0,480,0,186,0,0.047916667,empty,mBC-0716-2
"F7,C9",14119,14462,10751,3711,7099,0,3260,3271,2293,978,2.344580777,1618,772,459,278,0,278,0,153,0,0.039568345,empty,mBC-0716-2
"F7,C10",987105,1179214,630749,548465,573989,1,393041,393543,273457,120086,2.277176357,240775,41898,19864,11018,11,11007,1,1883,0,0.005360225,mm10,mBC-0716-2
"F7,C11",12456,12739,9343,3396,6244,0,2904,2904,2035,869,2.341772152,1417,844,452,300,0,300,0,149,0,0.076666667,empty,mBC-0716-2
"F7,C12",20797,21397,15725,5672,10471,42,4766,4814,3397,1417,2.397318278,2302,1286,658,425,0,425,0,168,0,0.058823529,empty,mBC-0716-2
"F7,D1",12702,13703,9406,4297,6694,1,3291,3301,2346,955,2.456544503,1695,449,229,142,0,142,0,87,0,0.014084507,empty,mBC-0716-2
"F7,D2",22355,22797,17258,5539,11050,5,4839,4847,3401,1446,2.352005533,2210,1826,1150,695,0,695,0,316,0,0.044604317,empty,mBC-0716-2
"F7,D3",15136,15853,11419,4434,7686,10,3650,3668,2578,1090,2.365137615,1789,1052,614,385,0,385,0,180,0,0.085714286,empty,mBC-0716-2
"F7,D4",1892087,2102752,1350154,752598,997846,1,568176,569059,429738,139321,3.084517051,316618,87846,57554,31797,11,31786,1,3252,0,0.001006733,mm10,mBC-0716-2
"F7,D5",14622,15334,10959,4375,7542,11,3515,3531,2496,1035,2.411594203,1781,933,527,321,0,321,0,149,0,0.049844237,empty,mBC-0716-2
"F7,D6",13392,13876,9945,3931,6837,25,3305,3338,2325,1013,2.295162883,1700,1044,634,371,0,371,0,179,0,0.02425876,empty,mBC-0716-2
"F7,D7",13608,14020,10226,3794,6925,0,3247,3260,2279,981,2.323139653,1606,1186,712,447,0,447,0,194,0,0.053691275,empty,mBC-0716-2
"F7,D8",17944,18577,13098,5479,8648,1,4115,4122,2870,1252,2.292332268,2037,11061,3305,1972,1,1971,1,518,0,0.155251142,empty,mBC-0716-2
"F7,D9",224347,238779,157499,81280,120660,4,65230,65337,56547,8790,6.433105802,35613,80904,52726,29122,10,29112,4,3057,0,0.001270954,mm10,mBC-0716-2
"F7,D10",14356,15016,11010,4006,7206,16,3314,3333,2292,1041,2.201729107,1629,4291,1426,892,0,892,0,282,0,0.061659193,empty,mBC-0716-2
"F7,D11",909936,1027949,618229,409720,499682,1,307414,307821,220944,86877,2.54318174,177768,52855,34534,19062,12,19050,1,2360,0,0.001207349,mm10,mBC-0716-2
"F7,D12",856269,944782,623136,321646,458729,13,250756,251107,202993,48114,4.219000707,135057,42478,27718,15248,7,15241,1,2113,0,0.001509087,mm10,mBC-0716-2
"F7,E1",23090,23748,17610,6138,11629,0,5238,5248,3712,1536,2.416666667,2506,1375,883,512,0,512,0,246,0,0.029296875,empty,mBC-0716-2
"F7,E2",17191,17591,13010,4581,8760,0,4067,4074,2917,1157,2.521175454,1978,1066,579,364,0,364,0,180,0,0.041208791,empty,mBC-0716-2
"F7,E3",12977,13283,9849,3434,6557,0,2949,2958,2039,919,2.218715996,1364,2587,1095,686,1,685,1,268,0,0.01459854,empty,mBC-0716-2
"F7,E4",16511,16838,12722,4116,8096,14,3640,3663,2601,1062,2.449152542,1689,789,463,296,1,295,1,151,0,0.054237288,empty,mBC-0716-2
"F7,E5",21746,22567,16688,5879,11087,10,5063,5085,3652,1433,2.548499651,2390,1077,708,446,0,446,0,209,0,0.029147982,empty,mBC-0716-2
"F7,E6",15598,16042,11838,4204,7841,21,3519,3551,2482,1069,2.321796071,1752,1636,894,553,0,553,0,245,0,0.054249548,empty,mBC-0716-2
"F7,E7",15904,15902,11764,4138,7443,1,3415,3425,2350,1075,2.186046512,1570,14481,5025,3075,0,3075,0,774,0,0.17398374,empty,mBC-0716-2
"F7,E8",19379,20109,15011,5098,9759,5,4387,4397,3047,1350,2.257037037,2078,1705,984,550,0,550,0,224,0,0.038181818,empty,mBC-0716-2
"F7,E9",514343,558886,374818,184068,274078,13,143969,144207,110631,33576,3.294942816,76616,50801,27533,15126,7,15119,1,2376,0,0.004960646,mm10,mBC-0716-2
"F7,E10",14199,14934,10709,4225,7287,1,3420,3431,2349,1082,2.170979667,1691,1067,634,389,0,389,0,172,0,0.025706941,empty,mBC-0716-2
"F7,E11",9660,9937,7412,2525,5019,0,2286,2290,1619,671,2.412816692,1099,1002,585,346,0,346,0,163,0,0.014450867,empty,mBC-0716-2
"F7,E12",16898,17529,12760,4769,8647,0,4101,4110,2851,1259,2.264495631,2039,4288,1693,1006,2,1004,1,341,0,0.121513944,empty,mBC-0716-2
"F7,F1",19002,19628,14574,5054,9539,0,4397,4399,3089,1310,2.358015267,2040,1926,928,577,1,576,1,251,0,0.055555556,empty,mBC-0716-2
"F7,F2",895928,937337,671603,265734,450702,2,216556,216981,168378,48603,3.464354052,110088,79674,52947,29344,7,29337,1,3085,0,0.002351979,mm10,mBC-0716-2
"F7,F3",17896,18697,13443,5254,9227,0,4406,4412,3053,1359,2.246504783,2202,9328,3028,1829,2,1827,1,592,0,0.072796935,empty,mBC-0716-2
"F7,F4",17233,17417,13026,4391,8779,0,3965,3970,2787,1183,2.355874894,1900,417,221,135,0,135,0,77,0,0.022222222,empty,mBC-0716-2
"F7,F5",4131214,4413024,2916734,1496290,2018242,4,1190664,1192505,882072,310433,2.84142472,650256,101093,62514,34605,18,34587,1,3823,0,0.00211062,mm10,mBC-0716-2
"F7,F6",24456,25249,18547,6702,12097,2,5491,5514,3919,1595,2.457053292,2696,1695,954,552,1,551,1,236,0,0.038112523,empty,mBC-0716-2
"F7,F7",2344831,2615596,1668538,947058,1233712,54,710860,711983,568068,143915,3.947246639,394068,86713,56236,31239,12,31227,2,3346,0,0.001889391,mm10,mBC-0716-2
"F7,F8",23551,24492,17976,6516,12063,1,5610,5631,3911,1720,2.273837209,2782,396,234,150,0,150,0,88,0,0.106666667,empty,mBC-0716-2
"F7,F9",16494,17013,12531,4482,8098,38,3656,3705,2598,1107,2.346883469,1728,5886,1947,1170,0,1170,0,394,0,0.036752137,empty,mBC-0716-2
"F7,F10",21294,21641,16495,5146,10627,13,4601,4629,3265,1364,2.393695015,2103,919,571,348,0,348,0,173,0,0.025862069,empty,mBC-0716-2
"F7,F11",12679,12731,9333,3398,6153,0,2848,2850,1958,892,2.195067265,1360,18698,5669,3370,4,3366,4,929,0,0.062982769,empty,mBC-0716-2
"F7,F12",15583,16059,11602,4457,7744,0,3637,3644,2499,1145,2.182532751,1836,367,123,85,0,85,0,55,0,0,empty,mBC-0716-2
"F7,G1",10467,10617,8062,2555,5282,1,2351,2356,1636,720,2.272222222,1086,1295,788,478,0,478,0,195,0,0.039748954,empty,mBC-0716-2
"F7,G2",23565,24024,17859,6165,11763,14,5232,5256,3684,1572,2.34351145,2533,667,389,244,1,243,1,134,0,0.008230453,empty,mBC-0716-2
"F7,G3",1034437,1174299,699249,475050,567533,0,354689,355161,263639,91522,2.880607941,207330,11744,6711,3850,0,3850,0,912,0,0.02,mm10,mBC-0716-2
"F7,G4",29858,30505,22896,7609,14882,16,6538,6579,4649,1930,2.40880829,3121,199,124,86,0,86,0,57,0,0.011627907,empty,mBC-0716-2
"F7,G5",690922,720528,522837,197691,350332,52,165351,165708,130707,35001,3.734379018,82232,48175,29753,16743,6,16737,2,2055,0,0.002867897,mm10,mBC-0716-2
"F7,G6",26108,26483,20168,6315,12755,23,5549,5591,3900,1691,2.306327617,2607,233,138,77,0,77,0,55,0,0,empty,mBC-0716-2
"F7,G7",21458,22049,16450,5599,10682,3,4835,4845,3407,1438,2.369262865,2283,1437,814,521,0,521,0,244,0,0.040307102,empty,mBC-0716-2
"F7,G8",1806333,1945607,1320388,625219,914976,1,491319,492093,370396,121697,3.043591872,261743,106541,64805,35654,11,35643,2,3703,0,0.001234464,mm10,mBC-0716-2
"F7,G9",11042,11407,8261,3146,5783,10,2742,2759,1945,814,2.389434889,1338,1270,757,454,0,454,0,215,0,0.00660793,empty,mBC-0716-2
"F7,G10",13794,14221,10537,3684,6967,0,3072,3074,2185,889,2.457817773,1428,1249,787,492,1,491,1,233,0,0.069246436,empty,mBC-0716-2
"F7,G11",13227,13677,9959,3718,6506,10,2994,3004,2171,833,2.606242497,1400,3054,1001,617,2,615,1,230,0,0.029268293,empty,mBC-0716-2
"F7,G12",11753,11991,8928,3063,5964,5,2698,2712,1941,771,2.517509728,1286,1118,694,398,0,398,0,181,0,0.045226131,empty,mBC-0716-2
"F7,H1",21548,22082,16332,5750,10913,0,4946,4957,3605,1352,2.666420118,2350,2332,926,529,0,529,0,218,0,0.026465028,empty,mBC-0716-2
"F7,H2",29973,30974,22585,8389,15169,38,7248,7294,5211,2083,2.501680269,3466,1584,1019,617,0,617,0,274,0,0.064829822,empty,mBC-0716-2
"F7,H3",22567,23237,17245,5992,11367,24,5241,5268,3792,1476,2.569105691,2500,1345,756,488,0,488,0,224,0,0.040983607,empty,mBC-0716-2
"F7,H4",15416,16148,11603,4545,7979,0,3836,3842,2738,1104,2.480072464,1922,231,150,103,0,103,0,79,0,0,empty,mBC-0716-2
"F7,H5",19016,19860,14342,5518,9519,38,4400,4452,3133,1319,2.375284306,2197,1424,827,501,0,501,0,208,0,0.071856287,empty,mBC-0716-2
"F7,H6",1328045,1364985,983340,381645,659814,2,329966,330547,264539,66008,4.007680887,166087,38230,18643,10601,3,10598,1,1993,0,0.06086054,mm10,mBC-0716-2
"F7,H7",17693,18340,13440,4900,9157,0,4333,4346,3053,1293,2.361175561,2140,1194,709,440,0,440,0,196,0,0.034090909,empty,mBC-0716-2
"F7,H8",23805,24408,17694,6714,12213,0,5865,5885,4220,1665,2.534534535,2943,1387,817,490,0,490,0,234,0,0.063265306,empty,mBC-0716-2
"F7,H9",812248,875350,587964,287386,426541,3,225482,225823,177309,48514,3.654800676,120339,91725,56328,31797,17,31780,2,3276,0,0.01346759,mm10,mBC-0716-2
"F7,H10",16158,16682,12130,4552,8116,0,3830,3839,2723,1116,2.439964158,1924,3316,1275,763,1,762,1,339,0,0.014435696,empty,mBC-0716-2
"F7,H11",17242,17842,12903,4939,8859,3,4127,4146,2934,1212,2.420792079,2093,172,89,65,0,65,0,51,0,0,empty,mBC-0716-2
"F7,H12",559112,613631,400725,212906,303326,0,166410,166654,139039,27615,5.034908564,90207,63344,42267,23294,6,23288,1,2656,0,0.001245277,mm10,mBC-0716-2
"F8,A1",14858,15363,11210,4153,7486,0,3447,3451,2388,1063,2.246472248,1668,2798,1208,707,0,707,0,231,0,0.079207921,empty,mBC-0716-2
"F8,A2",19820,19885,15158,4727,9401,12,4047,4067,2807,1260,2.227777778,1884,993,584,348,0,348,0,122,0,0.043103448,empty,mBC-0716-2
"F8,A3",17801,17964,13520,4444,8635,25,3929,3966,2783,1183,2.35249366,1900,1017,566,350,0,350,0,137,0,0.017142857,empty,mBC-0716-2
"F8,A4",974200,1066541,692363,374178,515588,5,299134,299573,221375,78198,2.830954756,163413,8813,5435,3070,0,3070,0,705,0,0.000977199,mm10,mBC-0716-2
"F8,A5",748334,797299,533278,264021,390615,14,211397,211776,145914,65862,2.215450487,116397,24848,14569,8303,4,8299,1,1516,0,0.009278226,mm10,mBC-0716-2
"F8,A6",13502,14111,10256,3855,6816,0,3118,3122,2173,949,2.289778714,1498,1282,714,432,0,432,0,169,0,0.041666667,empty,mBC-0716-2
"F8,A7",17487,17923,13243,4680,8659,26,3935,3975,2707,1268,2.134858044,1921,1102,654,390,0,390,0,145,0,0.007692308,empty,mBC-0716-2
"F8,A8",11623,12150,8798,3352,5780,0,2666,2668,1834,834,2.199040767,1241,1091,602,374,0,374,0,167,0,0.045454545,empty,mBC-0716-2
"F8,A9",19782,19985,15113,4872,9552,0,4185,4190,3032,1158,2.618307427,1924,987,588,349,0,349,0,165,0,0.017191977,empty,mBC-0716-2
"F8,A10",16796,17443,12840,4603,8311,0,3763,3768,2620,1148,2.282229965,1783,1244,476,305,1,304,1,123,0,0.032894737,empty,mBC-0716-2
"F8,A11",18591,19233,14084,5149,9309,0,4239,4247,2930,1317,2.224753227,2060,1110,649,374,0,374,0,147,0,0.104278075,empty,mBC-0716-2
"F8,A12",23095,23715,17833,5882,11135,13,4836,4870,3437,1433,2.398464759,2274,1985,1201,676,0,676,0,210,0,0.068047337,empty,mBC-0716-2
"F8,B1",20921,21494,16144,5350,10340,12,4633,4651,3355,1296,2.588734568,2174,1217,675,390,0,390,0,143,0,0.043589744,empty,mBC-0716-2
"F8,B2",22047,22310,17016,5294,10540,0,4701,4708,3272,1436,2.278551532,2134,655,306,187,0,187,0,74,0,0.080213904,empty,mBC-0716-2
"F8,B3",1086830,1163543,784283,379260,557543,20,303767,304228,245098,59130,4.145070184,160271,54366,33389,18806,5,18801,1,2395,0,0.002499867,mm10,mBC-0716-2
"F8,B4",17922,18687,13745,4942,9006,0,4113,4117,2915,1202,2.425124792,1971,993,603,349,0,349,0,118,0,0.063037249,empty,mBC-0716-2
"F8,B5",9941,5947,4220,1727,3811,0,1843,1857,1293,564,2.292553191,1004,533,218,151,0,151,0,76,0,0,empty,mBC-0716-2
"F8,B6",13187,13589,10118,3471,6557,1,2948,2955,2087,868,2.40437788,1407,887,537,333,0,333,0,133,0,0.027027027,empty,mBC-0716-2
"F8,B7",17937,18401,13703,4698,8944,20,3992,4024,2834,1190,2.381512605,1870,791,388,235,0,235,0,100,0,0.017021277,empty,mBC-0716-2
"F8,B8",14584,15008,11336,3672,7195,0,3249,3262,2194,1068,2.054307116,1473,958,572,347,0,347,0,152,0,0.054755043,empty,mBC-0716-2
"F8,B9",16877,17374,12953,4421,8151,1,3688,3694,2555,1139,2.243195786,1725,772,486,301,0,301,0,113,0,0.086378738,empty,mBC-0716-2
"F8,B10",36683,36693,23547,13146,18749,14,10683,10733,7388,3345,2.208669656,6045,8909,2369,1316,2,1314,1,412,0,0.00761035,empty,mBC-0716-2
"F8,B11",21325,22381,15935,6446,10600,0,5150,5158,3690,1468,2.513623978,2559,111,72,43,0,43,0,32,0,0,empty,mBC-0716-2
"F8,B12",19878,20588,15115,5473,9984,0,4559,4573,3223,1350,2.387407407,2178,1121,674,390,0,390,0,146,0,0.061538462,empty,mBC-0716-2
"F8,C1",24866,25415,19365,6050,11866,17,5142,5176,3668,1508,2.432360743,2385,775,497,286,0,286,0,104,0,0.129370629,empty,mBC-0716-2
"F8,C2",19779,19913,14835,5078,9674,0,4450,4458,3147,1311,2.400457666,2086,5774,1882,1149,3,1146,1,322,0,0.144851658,empty,mBC-0716-2
"F8,C3",21829,22218,16559,5659,10735,43,4915,4969,3512,1457,2.410432395,2372,531,276,154,0,154,0,71,0,0.058441558,empty,mBC-0716-2
"F8,C4",18936,19640,14492,5148,9185,41,4010,4059,2905,1154,2.517331023,1908,1162,742,394,1,393,1,131,0,0.091603053,empty,mBC-0716-2
"F8,C5",19941,20885,14689,6196,9934,0,4713,4730,3434,1296,2.649691358,2383,21908,6675,4168,3,4165,1,977,0,0.092917167,empty,mBC-0716-2
"F8,C6",17523,17951,13100,4851,9083,1,4238,4246,2961,1285,2.304280156,2105,1065,662,421,0,421,0,160,0,0.042755344,empty,mBC-0716-2
"F8,C7",17469,17912,13292,4620,8496,38,3938,3982,2700,1282,2.106084243,1837,513,274,179,0,179,0,74,0,0.022346369,empty,mBC-0716-2
"F8,C8",16458,17082,12598,4484,8294,11,3745,3767,2611,1156,2.258650519,1781,1317,753,425,1,424,1,167,0,0.018867925,empty,mBC-0716-2
"F8,C9",13417,13647,10340,3307,6682,4,3038,3046,2082,964,2.159751037,1428,745,484,276,0,276,0,103,0,0.047101449,empty,mBC-0716-2
"F8,C10",15647,16141,11828,4313,7712,0,3580,3587,2460,1127,2.182786158,1730,1206,687,416,0,416,0,151,0,0.074519231,empty,mBC-0716-2
"F8,C11",12547,13038,9547,3491,6470,0,3065,3069,2150,919,2.339499456,1483,1205,588,344,0,344,0,127,0,0.046511628,empty,mBC-0716-2
"F8,C12",21282,22088,16015,6073,10648,19,4993,5020,3475,1545,2.249190939,2453,979,632,389,0,389,0,140,0,0.043701799,empty,mBC-0716-2
"F8,D1",1272832,1345141,926767,418374,656573,6,351837,352421,266944,85477,3.12299215,184791,16481,9297,5352,1,5351,1,1161,0,0.011025976,mm10,mBC-0716-2
"F8,D2",27948,28751,21567,7184,13899,5,6184,6211,4447,1764,2.520975057,2902,2243,1279,730,1,729,1,272,0,0.053497942,empty,mBC-0716-2
"F8,D3",14643,15165,10859,4306,7280,0,3383,3391,2310,1081,2.136910268,1666,1220,666,414,1,413,1,163,0,0.012106538,empty,mBC-0716-2
"F8,D4",15069,15787,11429,4358,7744,6,3552,3564,2511,1053,2.384615385,1807,1793,890,563,1,562,1,220,0,0.058718861,empty,mBC-0716-2
"F8,D5",852914,963038,565469,397569,472836,0,302916,303314,244700,58614,4.174770533,176148,7967,5082,2730,1,2729,1,734,0,0.005496519,mm10,mBC-0716-2
"F8,D6",796009,885462,560846,324616,427677,1,239494,239850,204138,35712,5.716229839,134003,113102,73970,41973,17,41956,2,3591,0,0.000619697,mm10,mBC-0716-2
"F8,D7",13420,13741,10303,3438,6657,0,3062,3070,2123,947,2.241816262,1455,1691,864,504,0,504,0,182,0,0.023809524,empty,mBC-0716-2
"F8,D8",17288,18216,13109,5107,8668,17,4080,4105,2852,1253,2.276137271,2011,853,560,328,0,328,0,121,0,0.057926829,empty,mBC-0716-2
"F8,D9",5116,5318,3744,1574,2612,1,1216,1217,828,389,2.128534704,635,1211,718,435,0,435,0,170,0,0.062068966,empty,mBC-0716-2
"F8,D10",15618,16073,11680,4393,7782,41,3630,3682,2558,1124,2.275800712,1809,741,424,269,0,269,0,102,0,0.026022305,empty,mBC-0716-2
"F8,D11",14393,14865,11013,3852,7199,14,3263,3286,2225,1061,2.097078228,1564,1281,800,493,0,493,0,189,0,0.014198783,empty,mBC-0716-2
"F8,D12",22016,22705,16690,6015,10789,39,4942,4988,3422,1566,2.185185185,2330,1946,1202,741,1,740,1,249,0,0.056756757,empty,mBC-0716-2
"F8,E1",23224,23848,17757,6091,11400,11,5076,5100,3577,1523,2.348653972,2430,1095,688,417,0,417,0,193,0,0.052757794,empty,mBC-0716-2
"F8,E2",17583,18184,13531,4653,8662,1,3925,3933,2761,1172,2.355802048,1818,2036,824,529,0,529,0,197,0,0.026465028,empty,mBC-0716-2
"F8,E3",13334,13684,10303,3381,6626,0,2942,2955,2018,937,2.153681964,1372,1618,824,508,0,508,0,213,0,0.039370079,empty,mBC-0716-2
"F8,E4",17082,17772,13207,4565,8236,0,3803,3816,2686,1130,2.37699115,1771,1064,600,337,1,336,1,138,0,0.05952381,empty,mBC-0716-2
"F8,E5",23964,24666,18399,6267,12089,0,5423,5430,3815,1615,2.362229102,2607,1101,692,436,1,435,1,173,0,0.043678161,empty,mBC-0716-2
"F8,E6",999079,1079732,709278,370454,510871,2,284990,285428,234881,50547,4.646784181,154047,78713,50961,28418,12,28406,2,2903,0,0.002182637,mm10,mBC-0716-2
"F8,E7",14728,15303,11180,4123,7430,8,3321,3337,2339,998,2.343687375,1631,1564,879,524,0,524,0,189,0,0.045801527,empty,mBC-0716-2
"F8,E8",1042021,1130318,729518,400800,545436,4,318371,318853,247669,71184,3.479279051,172549,22333,13623,7693,1,7692,1,1329,0,0.00351014,mm10,mBC-0716-2
"F8,E9",548425,592777,396751,196026,289997,8,156591,156814,115304,41510,2.777740304,83729,52695,31458,18053,6,18047,2,2382,0,0.002992187,mm10,mBC-0716-2
"F8,E10",14125,14846,10798,4048,7155,1,3307,3312,2260,1052,2.148288973,1623,997,536,344,0,344,0,133,0,0.061046512,empty,mBC-0716-2
"F8,E11",749337,839462,518489,320973,411849,23,241340,241680,196891,44789,4.39596776,136519,122508,77659,43514,21,43493,2,3688,0,0.000919688,mm10,mBC-0716-2
"F8,E12",15788,16342,11893,4449,7943,6,3683,3695,2587,1108,2.334837545,1815,934,516,312,0,312,0,137,0,0.012820513,empty,mBC-0716-2
"F8,F1",20077,20834,15199,5635,10003,7,4553,4573,3163,1410,2.243262411,2226,2434,1037,627,0,627,0,224,0,0.03030303,empty,mBC-0716-2
"F8,F2",25210,25660,18614,7046,12178,0,5621,5647,3927,1720,2.283139535,2708,27109,8221,4982,7,4975,3,1104,0,0.12361809,empty,mBC-0716-2
"F8,F3",16729,17665,12656,5009,8617,0,4123,4135,2846,1289,2.207913111,2020,1422,805,494,0,494,0,210,0,0.028340081,empty,mBC-0716-2
"F8,F4",16730,16799,12456,4343,8403,0,3804,3815,2647,1168,2.266267123,1902,295,149,90,0,90,0,51,0,0.033333333,empty,mBC-0716-2
"F8,F5",27479,28101,21023,7078,13295,0,6065,6079,4267,1812,2.354856512,2833,1647,947,554,0,554,0,231,0,0.018050542,empty,mBC-0716-2
"F8,F6",26989,27386,20591,6795,12974,6,5870,5893,4154,1739,2.388729155,2667,1776,999,637,0,637,0,225,0,0.034536892,empty,mBC-0716-2
"F8,F7",21963,22119,16972,5147,10607,0,4709,4713,3267,1446,2.2593361,2076,738,449,279,0,279,0,104,0,0.103942652,empty,mBC-0716-2
"F8,F8",24660,25607,18802,6805,12263,0,5729,5737,3972,1765,2.250424929,2770,271,175,107,0,107,0,68,0,0,empty,mBC-0716-2
"F8,F9",16241,16487,12408,4079,8069,10,3580,3609,2539,1070,2.372897196,1746,1258,716,446,0,446,0,156,0,0.060538117,empty,mBC-0716-2
"F8,F10",24931,25501,19180,6321,12124,48,5255,5317,3790,1527,2.481990832,2479,1096,640,367,0,367,0,163,0,0.019073569,empty,mBC-0716-2
"F8,F11",13453,14295,10528,3767,6891,0,3135,3147,2168,979,2.214504597,1522,863,491,290,0,290,0,131,0,0.044827586,empty,mBC-0716-2
"F8,F12",15538,15948,11708,4240,7597,0,3411,3420,2335,1085,2.152073733,1647,104,66,49,0,49,0,26,0,0,empty,mBC-0716-2
"F8,G1",11138,11384,8726,2658,5511,0,2391,2395,1631,764,2.134816754,1074,1596,961,531,1,530,1,187,0,0.020754717,empty,mBC-0716-2
"F8,G2",1167813,1219480,876941,342539,573328,0,274729,275248,226134,49114,4.604267622,137705,21810,12971,7349,2,7347,1,1244,0,0.0027222,mm10,mBC-0716-2
"F8,G3",21163,22029,16220,5809,10454,3,4844,4870,3365,1505,2.235880399,2300,1969,1214,730,0,730,0,257,0,0.050684932,empty,mBC-0716-2
"F8,G4",1083127,1172522,774240,398282,566200,38,316801,317297,242914,74383,3.265719318,171736,426,239,147,0,147,0,75,0,0,empty,mBC-0716-2
"F8,G5",14603,15110,11117,3993,7289,5,3235,3257,2249,1008,2.231150794,1630,10155,3071,1859,0,1859,0,547,0,0.031737493,empty,mBC-0716-2
"F8,G6",26202,26404,20097,6307,12647,13,5530,5551,3912,1639,2.386821232,2518,114,77,58,0,58,0,44,0,0,empty,mBC-0716-2
"F8,G7",21732,22242,16624,5618,10780,7,4781,4804,3374,1430,2.359440559,2265,1476,857,513,0,513,0,190,0,0.031189084,empty,mBC-0716-2
"F8,G8",15453,16419,11691,4728,7869,4,3698,3712,2590,1122,2.308377897,1852,3074,1124,670,1,669,1,255,0,0.050822123,empty,mBC-0716-2
"F8,G9",11286,11908,8586,3322,5783,1,2672,2676,1880,796,2.361809045,1364,1062,651,384,1,383,1,157,0,0.033942559,empty,mBC-0716-2
"F8,G10",15296,15768,11624,4144,7597,0,3435,3442,2360,1082,2.181146026,1645,1412,848,476,0,476,0,193,0,0.035714286,empty,mBC-0716-2
"F8,G11",13442,13688,10283,3405,6590,2,2920,2938,2109,829,2.544028951,1361,975,451,269,0,269,0,114,0,0.003717472,empty,mBC-0716-2
"F8,G12",12524,13221,9540,3681,6398,37,2956,2998,2181,817,2.669522644,1444,1018,607,344,0,344,0,135,0,0.011627907,empty,mBC-0716-2
"F8,H1",22552,23510,16998,6512,11322,8,5311,5326,3779,1547,2.442792502,2613,740,445,291,1,290,1,126,0,0.010344828,empty,mBC-0716-2
"F8,H2",25974,26675,19857,6818,12596,5,5660,5679,3947,1732,2.27886836,2717,1404,831,540,1,539,1,229,0,0.020408163,empty,mBC-0716-2
"F8,H3",24548,25720,18575,7145,12377,1,5851,5866,4155,1711,2.428404442,2865,1299,702,421,0,421,0,173,0,0.118764846,empty,mBC-0716-2
"F8,H4",863338,973286,588928,384358,469964,0,283067,283442,225326,58116,3.877176681,163421,3679,2213,1321,0,1321,0,334,0,0.000757002,mm10,mBC-0716-2
"F8,H5",19963,20905,14928,5977,9830,2,4624,4638,3306,1332,2.481981982,2295,11365,3430,2021,2,2019,1,551,0,0.050520059,empty,mBC-0716-2
"F8,H6",14457,14884,10987,3897,7303,0,3359,3369,2396,973,2.462487153,1632,5041,1912,1107,0,1107,0,317,0,0.073170732,empty,mBC-0716-2
"F8,H7",17728,17840,13389,4451,8718,11,3899,3923,2721,1202,2.263727121,1855,2315,985,577,1,576,1,212,0,0.059027778,empty,mBC-0716-2
"F8,H8",22100,23432,16514,6918,11491,30,5647,5699,4107,1592,2.579773869,2913,1475,861,480,0,480,0,204,0,0.052083333,empty,mBC-0716-2
"F8,H9",16532,16824,12639,4185,8211,10,3688,3707,2618,1089,2.404040404,1766,1266,740,450,0,450,0,193,0,0.055555556,empty,mBC-0716-2
"F8,H10",603087,632300,447514,184786,307210,8,150268,150521,106245,44276,2.399607011,77052,54541,31727,17982,11,17971,4,2412,0,0.007901619,mm10,mBC-0716-2
"F8,H11",18030,18472,13525,4947,8968,3,4137,4149,2843,1306,2.176875957,2051,115,56,40,0,40,0,33,0,0.025,empty,mBC-0716-2
"F8,H12",6510,6870,4858,2012,3347,0,1600,1603,1160,443,2.618510158,823,523,300,194,0,194,0,79,0,0.082474227,empty,mBC-0716-2
"F9,A1",14330,14934,10780,4154,7344,1,3504,3516,2435,1081,2.252543941,1724,1333,701,429,0,429,0,180,0,0.055944056,empty,mBC-0716-2
"F9,A2",19714,20009,14947,5062,9617,16,4263,4288,3045,1243,2.449718423,2027,2928,1224,714,0,714,0,296,0,0.042016807,empty,mBC-0716-2
"F9,A3",17260,17772,13063,4709,8556,0,3957,3958,2744,1214,2.26029654,1897,917,525,297,0,297,0,115,0,0.037037037,empty,mBC-0716-2
"F9,A4",23366,24314,17968,6346,11597,25,5238,5272,3716,1556,2.388174807,2518,588,332,209,0,209,0,113,0,0.023923445,empty,mBC-0716-2
"F9,A5",18467,19384,13847,5537,9430,24,4333,4367,3025,1342,2.254098361,2168,2235,1141,691,2,689,2,272,0,0.031930334,empty,mBC-0716-2
"F9,A6",945070,1045410,663103,382307,501029,9,288174,288642,226473,62169,3.64286059,160222,107203,64900,36506,14,36492,3,3537,0,0.008029157,mm10,mBC-0716-2
"F9,A7",16803,17393,12792,4601,8445,0,3887,3892,2669,1223,2.182338512,1823,1329,774,430,0,430,0,156,0,0.109302326,empty,mBC-0716-2
"F9,A8",11483,11870,8507,3363,5915,21,2832,2857,2013,844,2.38507109,1447,1751,1061,613,0,613,0,225,0,0.057096248,empty,mBC-0716-2
"F9,A9",19670,19459,15084,4375,9259,0,3990,3998,2792,1206,2.315091211,1750,1473,967,590,0,590,0,200,0,0.096610169,empty,mBC-0716-2
"F9,A10",882079,1024964,571537,453427,498924,5,331060,331446,251660,79786,3.154187451,197594,22375,13272,7414,1,7413,1,1333,0,0.001888574,mm10,mBC-0716-2
"F9,A11",18934,19418,14320,5098,9225,1,4196,4201,2916,1285,2.2692607,1979,4750,1699,1001,0,1001,0,345,0,0.02997003,empty,mBC-0716-2
"F9,A12",1197732,1292496,877904,414592,607070,0,324663,325252,231644,93608,2.474617554,172667,100626,64726,35580,14,35566,2,3522,0,0.001180903,mm10,mBC-0716-2
"F9,B1",20408,21011,15608,5403,10087,0,4597,4604,3232,1372,2.355685131,2201,1011,599,377,0,377,0,152,0,0.076923077,empty,mBC-0716-2
"F9,B2",21523,21968,16498,5470,10560,0,4635,4641,3267,1374,2.377729258,2167,479,238,132,0,132,0,61,0,0.075757576,empty,mBC-0716-2
"F9,B3",19585,20163,14927,5236,9644,22,4305,4340,3024,1316,2.29787234,2069,1329,852,512,0,512,0,186,0,0.091796875,empty,mBC-0716-2
"F9,B4",17711,18177,13570,4607,8837,0,4050,4056,2878,1178,2.443123939,1955,1035,556,344,0,344,0,140,0,0.095930233,empty,mBC-0716-2
"F9,B5",10655,6991,4685,2306,4283,23,2117,2153,1495,658,2.272036474,1193,2873,947,558,0,558,0,187,0,0.007168459,empty,mBC-0716-2
"F9,B6",12859,13143,9866,3277,6518,6,2997,3007,2103,904,2.326327434,1368,1160,678,412,0,412,0,188,0,0.038834951,empty,mBC-0716-2
"F9,B7",18026,18465,13939,4526,8950,5,3956,3967,2784,1183,2.353338969,1864,894,524,312,0,312,0,148,0,0.118589744,empty,mBC-0716-2
"F9,B8",1687950,1889036,1171769,717267,901589,0,535788,536549,392052,144497,2.71321896,304513,117128,77480,42919,22,42897,1,3955,0,0.000652726,mm10,mBC-0716-2
"F9,B9",743882,810935,544405,266530,391350,13,205946,206297,165714,40583,4.083335387,110431,37407,24484,13495,5,13490,1,1999,0,0.001111935,mm10,mBC-0716-2
"F9,B10",17261,17059,12706,4353,8677,7,4016,4046,2688,1358,1.979381443,1948,1318,440,281,0,281,0,135,0,0.021352313,empty,mBC-0716-2
"F9,B11",21350,22283,16004,6279,10714,0,5161,5170,3746,1424,2.630617978,2498,274,144,99,0,99,0,64,0,0.03030303,empty,mBC-0716-2
"F9,B12",19547,20278,14783,5495,10122,0,4650,4667,3266,1401,2.331192006,2393,1427,824,473,0,473,0,188,0,0.046511628,empty,mBC-0716-2
"F9,C1",24224,24380,18865,5515,11506,0,4882,4896,3507,1389,2.524838013,2133,650,397,236,0,236,0,115,0,0.004237288,empty,mBC-0716-2
"F9,C2",19280,19667,14689,4978,9354,22,4137,4164,2994,1170,2.558974359,1926,1491,834,499,1,498,1,174,0,0.108433735,empty,mBC-0716-2
"F9,C3",21376,22085,15932,6153,10595,44,4921,4978,3439,1539,2.234567901,2486,656,375,218,1,217,1,99,0,0.055299539,empty,mBC-0716-2
"F9,C4",18141,18177,13849,4328,8822,11,3771,3786,2708,1078,2.512059369,1751,1172,642,372,0,372,0,153,0,0.077956989,empty,mBC-0716-2
"F9,C5",16762,17209,12582,4627,8430,3,3935,3944,2775,1169,2.373823781,1896,1284,790,499,2,497,1,202,0,0.020120724,empty,mBC-0716-2
"F9,C6",18967,19453,14177,5276,9560,0,4449,4454,3163,1291,2.45003873,2154,1067,633,382,0,382,0,165,0,0.013089005,empty,mBC-0716-2
"F9,C7",17169,17559,12984,4575,8466,19,3902,3932,2770,1162,2.383820998,1825,468,274,186,0,186,0,90,0,0.005376344,empty,mBC-0716-2
"F9,C8",15594,15905,11966,3939,7793,14,3439,3463,2354,1109,2.122633003,1616,1563,960,583,0,583,0,203,0,0.048027444,empty,mBC-0716-2
"F9,C9",13899,14723,10666,4057,7159,44,3339,3388,2326,1062,2.190207156,1712,1049,652,385,2,383,1,148,0,0.01305483,empty,mBC-0716-2
"F9,C10",14337,14804,10944,3860,7287,0,3389,3398,2318,1080,2.146296296,1602,1099,608,351,0,351,0,168,0,0.074074074,empty,mBC-0716-2
"F9,C11",12603,13110,9586,3524,6428,0,3066,3073,2050,1023,2.003910068,1499,961,587,363,0,363,0,157,0,0.035812672,empty,mBC-0716-2
"F9,C12",21515,21956,16346,5610,10475,18,4789,4824,3365,1459,2.306374229,2252,1423,802,475,1,474,1,160,0,0.029535865,empty,mBC-0716-2
"F9,D1",11544,11870,8738,3132,5856,0,2720,2725,1849,876,2.110730594,1281,689,353,216,0,216,0,96,0,0.074074074,empty,mBC-0716-2
"F9,D2",22451,22831,17229,5602,11292,2,5057,5074,3526,1548,2.277777778,2450,2844,1703,972,0,972,0,355,0,0.040123457,empty,mBC-0716-2
"F9,D3",14645,15084,10947,4137,7395,20,3566,3600,2551,1049,2.431839847,1764,5471,1968,1243,1,1242,1,409,0,0.04589372,empty,mBC-0716-2
"F9,D4",15378,15848,11765,4083,7813,0,3531,3535,2418,1117,2.164726947,1715,1401,834,533,0,533,0,250,0,0.052532833,empty,mBC-0716-2
"F9,D5",13981,14239,10489,3750,7103,6,3286,3298,2275,1023,2.223851417,1615,1287,770,433,1,432,1,167,0,0.046296296,empty,mBC-0716-2
"F9,D6",13235,13587,9822,3765,6626,0,3099,3116,2142,974,2.199178645,1550,1259,676,436,1,435,1,180,0,0.068965517,empty,mBC-0716-2
"F9,D7",760200,778983,551725,227258,378970,8,192337,192716,155372,37344,4.160561268,98319,28935,17679,9924,5,9919,3,1698,0,0.00625063,mm10,mBC-0716-2
"F9,D8",1766102,1976339,1249274,727065,942777,34,543210,544021,423111,120910,3.499387975,307127,105507,63489,35561,16,35545,2,3516,0,0.001913068,mm10,mBC-0716-2
"F9,D9",4347,4362,3167,1195,2253,0,1050,1050,769,281,2.736654804,521,1702,948,582,0,582,0,249,0,0.036082474,empty,mBC-0716-2
"F9,D10",622641,615439,473925,141514,299010,0,128749,128983,96592,32391,2.982062919,60227,5892,3422,1945,1,1944,1,578,0,0.005658436,mm10,mBC-0716-2
"F9,D11",14100,14602,10672,3930,7149,0,3307,3315,2291,1024,2.237304688,1615,1489,933,556,0,556,0,221,0,0.037769784,empty,mBC-0716-2
"F9,D12",22046,22517,16806,5711,10821,0,4977,4990,3443,1547,2.225597931,2331,2269,1363,803,1,802,1,273,0,0.078553616,empty,mBC-0716-2
"F9,E1",22662,23132,17251,5881,11301,9,4916,4938,3501,1437,2.436325678,2394,1834,1078,612,2,610,2,244,0,0.037704918,empty,mBC-0716-2
"F9,E2",16916,17303,12759,4544,8388,0,3778,3785,2675,1110,2.40990991,1823,1361,691,412,0,412,0,187,0,0.007281553,empty,mBC-0716-2
"F9,E3",12992,13115,9969,3146,6474,0,2856,2858,1995,863,2.31170336,1279,1589,955,586,0,586,0,238,0,0.046075085,empty,mBC-0716-2
"F9,E4",16308,16481,12532,3949,7997,0,3599,3607,2477,1130,2.192035398,1662,1082,593,364,0,364,0,183,0,0.013736264,empty,mBC-0716-2
"F9,E5",23215,23795,17757,6038,11370,9,5017,5033,3524,1509,2.335321405,2374,1563,947,610,0,610,0,244,0,0.063934426,empty,mBC-0716-2
"F9,E6",14219,14428,10763,3665,6913,1,3079,3092,2174,918,2.368191721,1455,1642,970,556,0,556,0,220,0,0.057553957,empty,mBC-0716-2
"F9,E7",15512,15877,11869,4008,7673,21,3431,3456,2362,1094,2.15904936,1638,1237,789,428,0,428,0,180,0,0.018691589,empty,mBC-0716-2
"F9,E8",18494,18602,14263,4339,9172,2,4065,4076,2820,1256,2.24522293,1886,1646,1006,603,0,603,0,224,0,0.11774461,empty,mBC-0716-2
"F9,E9",9141,9377,6926,2451,4561,1,2087,2094,1449,645,2.246511628,993,1375,774,444,1,443,1,166,0,0.045146727,empty,mBC-0716-2
"F9,E10",950652,1010698,681831,328867,488920,6,274898,275319,209203,66116,3.164181136,144338,17905,9222,5299,3,5296,2,1176,0,0.011329305,mm10,mBC-0716-2
"F9,E11",726978,786755,530249,256506,388260,0,205317,205671,161371,44300,3.64268623,109725,95969,59644,33247,19,33228,2,3202,0,0.000872758,mm10,mBC-0716-2
"F9,E12",15361,15743,11519,4224,7868,1,3670,3676,2617,1059,2.471199245,1780,1027,574,359,0,359,0,150,0,0.072423398,empty,mBC-0716-2
"F9,F1",19379,20050,14690,5360,9720,0,4481,4486,3142,1344,2.337797619,2200,1365,770,494,0,494,0,214,0,0.036437247,empty,mBC-0716-2
"F9,F2",25124,25943,19019,6924,12638,0,5884,5893,4147,1746,2.375143184,2855,2860,1649,1024,0,1024,0,396,0,0.016601563,empty,mBC-0716-2
"F9,F3",16411,16748,12584,4164,8314,1,3842,3852,2655,1197,2.218045113,1814,1849,1112,645,0,645,0,271,0,0.03255814,empty,mBC-0716-2
"F9,F4",16160,16116,12133,3983,7907,0,3540,3554,2472,1082,2.284658041,1668,459,220,147,0,147,0,93,0,0,empty,mBC-0716-2
"F9,F5",3179232,3474122,2100637,1373485,1606729,5,1031353,1032825,755308,277517,2.721663898,584882,150944,91018,51069,35,51034,3,4344,0,0.003899361,mm10,mBC-0716-2
"F9,F6",23639,24502,17744,6758,11761,3,5447,5461,3798,1663,2.283824414,2584,2285,1265,762,1,761,1,291,0,0.02890933,empty,mBC-0716-2
"F9,F7",21580,22007,16561,5446,10730,1,4768,4783,3346,1437,2.328462074,2173,924,589,362,0,362,0,141,0,0.049723757,empty,mBC-0716-2
"F9,F8",23827,24370,17976,6394,11917,4,5461,5476,3804,1672,2.275119617,2634,233,153,106,0,106,0,76,0,0,empty,mBC-0716-2
"F9,F9",16340,16494,12397,4097,7980,0,3616,3626,2613,1013,2.57946693,1676,2850,1322,756,0,756,0,254,0,0.100529101,empty,mBC-0716-2
"F9,F10",22468,22876,17347,5529,11095,15,4883,4909,3486,1423,2.449754041,2247,1231,691,426,0,426,0,183,0,0.058685446,empty,mBC-0716-2
"F9,F11",1055124,1122181,773243,348938,533825,3,273600,274067,237629,36438,6.521461112,142385,123750,78418,44528,27,44501,3,3865,0,0.001662884,mm10,mBC-0716-2
"F9,F12",15199,15696,11475,4221,7612,1,3537,3542,2455,1087,2.25850966,1698,113,65,48,0,48,0,40,0,0,empty,mBC-0716-2
"F9,G1",16132,17386,12195,5191,8545,15,4216,4242,2583,1659,1.556962025,2210,2309,1331,798,0,798,0,321,0,0.007518797,empty,mBC-0716-2
"F9,G2",22881,23437,17514,5923,11152,37,4922,4974,3430,1544,2.221502591,2288,601,373,214,0,214,0,122,0,0.046728972,empty,mBC-0716-2
"F9,G3",27644,28447,20213,8234,13742,10,6755,6782,4796,1986,2.41490433,3371,24257,7432,4379,9,4370,4,1103,0,0.075057208,empty,mBC-0716-2
"F9,G4",2385540,2511365,1761935,749430,1155813,7,590504,591609,505128,86481,5.840913033,305143,1225,727,442,0,442,0,150,0,0.00678733,empty,mBC-0716-2
"F9,G5",14560,14916,11061,3855,7334,0,3376,3384,2377,1007,2.360476663,1606,1375,754,477,0,477,0,214,0,0.077568134,empty,mBC-0716-2
"F9,G6",2121671,2243688,1572789,670899,1046612,0,546912,547845,436361,111484,3.914113236,279823,8316,5411,2975,0,2975,0,662,0,0.000672269,mm10,mBC-0716-2
"F9,G7",21927,22271,16690,5581,10636,1,4679,4693,3305,1388,2.381123919,2149,1973,1208,751,0,751,0,281,0,0.017310253,empty,mBC-0716-2
"F9,G8",890119,980766,631782,348984,474281,16,275300,275719,210321,65398,3.21601578,150726,26917,17552,10035,4,10031,1,1620,0,0.00209351,mm10,mBC-0716-2
"F9,G9",11362,11595,8568,3027,5685,4,2636,2645,1884,761,2.475689882,1250,6452,2245,1356,1,1355,1,441,0,0.136531365,empty,mBC-0716-2
"F9,G10",931665,982795,693579,289216,474877,3,235705,236081,198919,37162,5.352752812,119967,86747,56204,31985,14,31971,1,3163,0,0.005598824,mm10,mBC-0716-2
"F9,G11",13285,13351,10030,3321,6469,0,2854,2861,2023,838,2.414081146,1321,871,487,296,0,296,0,127,0,0.006756757,empty,mBC-0716-2
"F9,G12",11947,12444,9110,3334,6122,0,2828,2833,2003,830,2.413253012,1348,1206,775,467,0,467,0,167,0,0.085653105,empty,mBC-0716-2
"F9,H1",22229,22874,17038,5836,11158,2,5026,5039,3566,1473,2.420909708,2432,1000,566,336,0,336,0,154,0,0.044642857,empty,mBC-0716-2
"F9,H2",1434821,1646838,952772,694066,782348,2,507058,507644,377220,130424,2.892259093,295770,84517,53295,29620,7,29613,1,3178,0,0.011042448,mm10,mBC-0716-2
"F9,H3",20673,21217,15542,5675,10350,0,4819,4823,3388,1435,2.36097561,2320,1477,901,546,0,546,0,228,0,0.025641026,empty,mBC-0716-2
"F9,H4",820551,904248,580020,324228,435650,0,244041,244378,202045,42333,4.772754116,134964,5871,3678,1946,0,1946,0,476,0,0,mm10,mBC-0716-2
"F9,H5",18656,19243,14242,5001,9251,3,4259,4273,2992,1281,2.335675254,2014,1454,888,551,1,550,1,199,0,0.063636364,empty,mBC-0716-2
"F9,H6",14543,14906,11058,3848,7242,0,3370,3380,2346,1034,2.268858801,1614,1707,1036,608,0,608,0,230,0,0.009868421,empty,mBC-0716-2
"F9,H7",17853,18291,13343,4948,8857,1,4149,4160,2911,1249,2.330664532,1989,33562,9769,5821,6,5815,3,1278,0,0.022012038,empty,mBC-0716-2
"F9,H8",14310,14830,10808,4022,7221,0,3426,3432,2408,1024,2.3515625,1683,1602,916,583,1,582,1,256,0,0.029209622,empty,mBC-0716-2
"F9,H9",16816,16838,12741,4097,8452,0,3805,3806,2714,1092,2.485347985,1788,1213,697,422,0,422,0,194,0,0.002369668,empty,mBC-0716-2
"F9,H10",16212,16855,12231,4624,8256,0,3816,3827,2738,1089,2.514233242,1886,1258,730,468,1,467,1,224,0,0.040685225,empty,mBC-0716-2
"F9,H11",17397,17912,12981,4931,8787,3,4110,4120,2880,1240,2.322580645,2033,171,102,68,0,68,0,53,0,0.073529412,empty,mBC-0716-2
"F9,H12",6280,6509,4772,1737,3246,0,1536,1537,1092,445,2.453932584,752,516,312,208,0,208,0,91,0,0,empty,mBC-0716-2
"F10,A1",15441,15700,11405,4295,7975,0,3815,3823,2676,1147,2.33304272,1852,7933,2878,1659,0,1659,0,516,0,0.028330319,empty,mBC-0716-2
"F10,A2",21309,21460,16361,5099,10235,1,4466,4474,3153,1321,2.38682816,2047,1410,850,504,0,504,0,216,0,0.051587302,empty,mBC-0716-2
"F10,A3",17917,18579,13501,5078,9057,3,4233,4247,2985,1262,2.365293185,2052,1212,721,416,0,416,0,162,0,0.079326923,empty,mBC-0716-2
"F10,A4",23070,23179,17816,5363,11200,0,5003,5013,3581,1432,2.500698324,2270,829,480,294,0,294,0,142,0,0.017006803,empty,mBC-0716-2
"F10,A5",19345,19809,14632,5177,9926,0,4643,4654,3197,1457,2.194234729,2259,2545,1390,885,0,885,0,315,0,0.047457627,empty,mBC-0716-2
"F10,A6",1914925,2131188,1352006,779182,1020041,1,597507,598406,436730,161676,2.701266731,335380,142565,92453,52246,23,52223,5,4414,0,0.001072324,mm10,mBC-0716-2
"F10,A7",18074,18591,13732,4859,9136,0,4134,4142,2859,1283,2.228371005,1969,1397,843,466,1,465,1,181,0,0.101075269,empty,mBC-0716-2
"F10,A8",11622,12218,8679,3539,6069,0,2867,2882,2044,838,2.439140811,1473,1674,1029,612,0,612,0,247,0,0.057189542,empty,mBC-0716-2
"F10,A9",21900,22323,16675,5648,10838,0,4969,4982,3495,1487,2.350369872,2369,1437,877,525,0,525,0,218,0,0.04,empty,mBC-0716-2
"F10,A10",17084,17359,12843,4516,8437,0,3799,3802,2616,1186,2.205733558,1794,571,328,225,0,225,0,112,0,0,empty,mBC-0716-2
"F10,A11",19447,20077,14767,5310,9811,3,4519,4532,3100,1432,2.164804469,2179,1506,810,494,0,494,0,215,0,0.024291498,empty,mBC-0716-2
"F10,A12",22812,23052,17472,5580,10805,0,4719,4728,3319,1409,2.355571327,2136,7605,2995,1729,1,1728,1,522,0,0.065972222,empty,mBC-0716-2
"F10,B1",20881,21321,15828,5493,10328,0,4665,4675,3191,1484,2.150269542,2214,3218,1204,751,0,751,0,271,0,0.074567244,empty,mBC-0716-2
"F10,B2",1236022,1337590,899401,438189,636549,15,349747,350301,248918,101383,2.455224249,185783,9941,6567,3570,1,3569,1,746,0,0.001961334,mm10,mBC-0716-2
"F10,B3",793693,855855,567280,288575,420195,15,233646,234022,162355,71667,2.265408068,128018,14862,8834,5008,3,5005,1,1119,0,0.007392607,mm10,mBC-0716-2
"F10,B4",17963,18497,13754,4743,8958,0,4058,4074,2770,1304,2.124233129,1924,1183,636,383,0,383,0,169,0,0.039164491,empty,mBC-0716-2
"F10,B5",9992,5712,4124,1588,3672,0,1780,1791,1235,556,2.221223022,935,3094,1113,651,1,650,1,226,0,0.021538462,empty,mBC-0716-2
"F10,B6",848310,902451,607424,295027,432544,0,231518,231903,198170,33733,5.874662793,123523,78700,52195,29388,11,29377,2,3057,0,0.001770092,mm10,mBC-0716-2
"F10,B7",18127,18607,13791,4816,8954,7,4079,4096,2918,1178,2.477079796,1918,2667,1125,687,0,687,0,268,0,0.011644833,empty,mBC-0716-2
"F10,B8",1516855,1687471,1076359,611112,809248,0,463021,463778,384228,79550,4.830018856,256485,124698,81857,46036,22,46014,1,3919,0,0.000956231,mm10,mBC-0716-2
"F10,B9",17483,18255,13266,4989,8758,0,4048,4063,2760,1303,2.118188795,2019,934,559,327,0,327,0,157,0,0.039755352,empty,mBC-0716-2
"F10,B10",18219,18029,13474,4555,9082,0,4177,4195,2900,1295,2.239382239,2014,1071,530,325,0,325,0,125,0,0.061538462,empty,mBC-0716-2
"F10,B11",18085,18610,13660,4950,9043,4,4104,4119,2914,1205,2.418257261,1993,276,163,102,0,102,0,66,0,0,empty,mBC-0716-2
"F10,B12",19901,20211,15106,5105,9994,10,4616,4636,3308,1328,2.490963855,2143,1449,962,549,0,549,0,209,0,0.061930783,empty,mBC-0716-2
"F10,C1",25273,25006,19519,5487,12140,12,5107,5128,3573,1555,2.297749196,2269,3314,1068,660,0,660,0,258,0,0.027272727,empty,mBC-0716-2
"F10,C2",20036,20572,14958,5614,9926,55,4525,4593,3182,1411,2.2551382,2236,1767,1067,616,1,615,1,218,0,0.037398374,empty,mBC-0716-2
"F10,C3",23901,25063,17826,7237,12242,6,5822,5834,4227,1607,2.630367144,2902,2835,991,594,2,592,1,232,0,0.030405405,empty,mBC-0716-2
"F10,C4",1246518,1355803,847655,508148,650859,1,396015,396593,293020,103573,2.829115696,221358,21175,13084,7412,1,7411,1,1429,0,0.003238429,mm10,mBC-0716-2
"F10,C5",1402337,1625787,907099,718688,771410,0,511064,511774,407014,104760,3.885204276,304298,88340,56813,31500,12,31488,1,3099,0,0.000952744,mm10,mBC-0716-2
"F10,C6",18666,19066,13884,5182,9832,0,4608,4616,3273,1343,2.437081162,2338,1526,887,529,0,529,0,224,0,0.026465028,empty,mBC-0716-2
"F10,C7",639659,647366,476563,170803,317310,1,148747,149023,121566,27457,4.427504826,73191,6449,2789,1661,0,1661,0,504,0,0.007224564,mm10,mBC-0716-2
"F10,C8",16193,16796,12304,4492,8225,0,3848,3851,2628,1223,2.148814391,1862,4396,1757,1085,0,1085,0,353,0,0.060829493,empty,mBC-0716-2
"F10,C9",14012,14736,10632,4104,7138,1,3350,3361,2443,918,2.661220044,1655,1190,677,436,0,436,0,179,0,0.055045872,empty,mBC-0716-2
"F10,C10",972838,1136768,634047,502721,550572,5,362581,363056,272743,90313,3.019974976,217218,63551,33919,19010,8,19002,3,2499,0,0.004999474,mm10,mBC-0716-2
"F10,C11",12867,13315,9577,3738,6574,5,3147,3163,2096,1067,1.964386129,1531,3522,1402,856,1,855,1,282,0,0.05380117,empty,mBC-0716-2
"F10,C12",21848,22308,16388,5920,10830,0,4910,4921,3494,1427,2.448493343,2343,1374,841,458,2,456,1,167,0,0.030701754,empty,mBC-0716-2
"F10,D1",13027,13671,9820,3851,6904,0,3277,3280,2232,1048,2.129770992,1654,757,406,258,0,258,0,112,0,0.034883721,empty,mBC-0716-2
"F10,D2",2183445,2373275,1569790,803485,1115444,38,637707,638753,491986,146767,3.35215682,341187,171322,111463,61841,18,61823,1,4666,0,0.001730747,mm10,mBC-0716-2
"F10,D3",14917,15318,11393,3925,7685,0,3644,3658,2595,1063,2.441204139,1687,1565,964,620,0,620,0,264,0,0.074193548,empty,mBC-0716-2
"F10,D4",15507,15858,11867,3991,7700,0,3577,3586,2482,1104,2.248188406,1649,2117,1157,705,0,705,0,316,0,0.036879433,empty,mBC-0716-2
"F10,D5",834818,888732,618275,270457,431003,2,221068,221398,166132,55266,3.006043499,114758,40626,26204,14952,3,14949,1,1987,0,0.002207506,mm10,mBC-0716-2
"F10,D6",13921,14549,10460,4089,6927,2,3335,3342,2310,1032,2.238372093,1610,1297,786,486,0,486,0,209,0,0.034979424,empty,mBC-0716-2
"F10,D7",14084,14440,10711,3729,6952,0,3189,3197,2262,935,2.419251337,1450,1583,935,575,0,575,0,234,0,0.005217391,empty,mBC-0716-2
"F10,D8",17139,18101,12866,5235,8802,0,4272,4274,2988,1286,2.32348367,2191,1099,574,358,1,357,1,187,0,0.070028011,empty,mBC-0716-2
"F10,D9",5832,6112,4272,1840,3030,4,1462,1473,1060,413,2.566585956,715,1829,1017,660,1,659,1,298,0,0.010622155,empty,mBC-0716-2
"F10,D10",15716,16214,11893,4321,7876,0,3655,3665,2558,1107,2.310749774,1780,764,445,292,0,292,0,136,0,0.010273973,empty,mBC-0716-2
"F10,D11",1059607,1102313,768373,333940,540452,1,282232,282759,221779,60980,3.636913742,146719,66021,32795,18468,14,18454,6,2996,0,0.012896933,mm10,mBC-0716-2
"F10,D12",1029784,1163042,705871,457171,559752,0,336870,337402,229727,107675,2.133522173,196367,110713,64092,35301,17,35284,4,3269,0,0.00272078,mm10,mBC-0716-2
"F10,E1",23307,23901,17864,6037,11470,6,5089,5108,3607,1501,2.403064624,2336,1819,1081,689,0,689,0,291,0,0.044992743,empty,mBC-0716-2
"F10,E2",17152,17713,13126,4587,8818,9,4020,4035,2852,1183,2.410819949,1911,1567,902,538,0,538,0,217,0,0.046468401,empty,mBC-0716-2
"F10,E3",13378,13721,10016,3705,6701,20,3036,3057,2174,883,2.462061155,1474,1877,1143,707,0,707,0,293,0,0.031117397,empty,mBC-0716-2
"F10,E4",16727,17253,12587,4666,8256,33,3752,3791,2631,1160,2.268103448,1827,1342,732,456,0,456,0,213,0,0.013157895,empty,mBC-0716-2
"F10,E5",25983,26726,19988,6738,13097,16,5861,5894,4186,1708,2.450819672,2840,1597,996,598,1,597,1,258,0,0.031825796,empty,mBC-0716-2
"F10,E6",14872,15203,11279,3924,7459,0,3306,3311,2339,972,2.406378601,1594,1800,1153,692,0,692,0,299,0,0.059248555,empty,mBC-0716-2
"F10,E7",17747,18331,13335,4996,8892,0,4213,4220,2918,1302,2.241167435,2068,1502,897,554,1,553,1,219,0,0.065099458,empty,mBC-0716-2
"F10,E8",19312,19653,14756,4897,9660,5,4313,4324,3103,1221,2.541359541,2034,1801,1052,653,0,653,0,265,0,0.049004594,empty,mBC-0716-2
"F10,E9",9946,10212,7564,2648,4987,0,2302,2310,1614,696,2.318965517,1122,1144,645,390,0,390,0,164,0,0.046153846,empty,mBC-0716-2
"F10,E10",1037717,1042068,811211,230857,504334,1,209925,210380,159850,50530,3.163467247,97281,38065,23445,13373,4,13369,1,2217,0,0.011444386,mm10,mBC-0716-2
"F10,E11",10051,10146,7690,2456,5091,0,2358,2364,1565,799,1.958698373,1077,1265,738,432,0,432,0,190,0,0.041666667,empty,mBC-0716-2
"F10,E12",545132,560233,399705,160528,279733,0,141169,141402,110855,30547,3.628997938,71559,15616,9706,5466,4,5462,1,1108,0,0.016660564,mm10,mBC-0716-2
"F10,F1",19457,19693,14811,4882,9657,0,4360,4373,3067,1306,2.348392037,2069,1861,1161,705,0,705,0,274,0,0.031205674,empty,mBC-0716-2
"F10,F2",983495,1135227,663652,471575,549685,1,342141,342600,281179,61421,4.577896811,200975,132465,85678,47759,25,47734,2,4025,0,0.001675954,mm10,mBC-0716-2
"F10,F3",18092,18626,13664,4962,9171,0,4326,4329,3029,1300,2.33,2120,4595,2023,1214,2,1212,1,432,0,0.056105611,empty,mBC-0716-2
"F10,F4",17337,17697,13035,4662,8684,6,4003,4016,2781,1235,2.251821862,1979,602,375,228,0,228,0,90,0,0.100877193,empty,mBC-0716-2
"F10,F5",27402,28351,20628,7723,13714,0,6377,6389,4483,1906,2.35204617,3202,7303,2837,1755,3,1752,2,562,0,0.046803653,empty,mBC-0716-2
"F10,F6",25099,26125,18923,7202,12445,0,5749,5764,4024,1740,2.312643678,2832,9380,3404,2048,1,2047,1,586,0,0.069858329,empty,mBC-0716-2
"F10,F7",22264,22655,16913,5742,11292,0,5166,5177,3664,1513,2.421678784,2471,1103,629,386,2,384,2,185,0,0.033854167,empty,mBC-0716-2
"F10,F8",760726,829537,562237,267300,402860,1,209047,209398,169236,40162,4.213833972,110767,6013,3737,2181,2,2179,1,541,0,0.000458926,mm10,mBC-0716-2
"F10,F9",15910,16166,12100,4066,7893,1,3570,3585,2525,1060,2.382075472,1641,1560,927,541,1,540,1,216,0,0.040740741,empty,mBC-0716-2
"F10,F10",22301,22699,17215,5484,10953,34,4849,4888,3492,1396,2.501432665,2224,1358,855,510,0,510,0,196,0,0.060784314,empty,mBC-0716-2
"F10,F11",12389,12627,9420,3207,6265,13,2802,2827,2005,822,2.439172749,1348,1244,746,457,3,454,1,212,0,0.024229075,empty,mBC-0716-2
"F10,F12",15950,16400,11961,4439,7820,0,3682,3688,2623,1065,2.462910798,1750,323,173,106,0,106,0,65,0,0.066037736,empty,mBC-0716-2
"F10,G1",11132,11385,8454,2931,5627,31,2542,2581,1798,783,2.296296296,1192,1892,1212,682,0,682,0,244,0,0.049853372,empty,mBC-0716-2
"F10,G2",23503,23717,17870,5847,11647,0,5234,5242,3753,1489,2.520483546,2453,808,487,306,0,306,0,164,0,0.022875817,empty,mBC-0716-2
"F10,G3",23673,24311,17778,6533,11847,0,5418,5438,3808,1630,2.336196319,2636,2697,1511,895,0,895,0,329,0,0.072625698,empty,mBC-0716-2
"F10,G4",31239,31763,24115,7648,15310,0,6696,6712,4782,1930,2.477720207,3187,194,130,89,0,89,0,65,0,0,empty,mBC-0716-2
"F10,G5",734854,818997,520726,298271,398319,0,226591,226952,186396,40556,4.596015386,126272,76747,49011,27216,12,27204,2,2827,0,0.002536392,mm10,mBC-0716-2
"F10,G6",26291,26780,20087,6693,12942,9,5752,5782,4153,1629,2.54941682,2713,546,296,172,0,172,0,88,0,0,empty,mBC-0716-2
"F10,G7",22214,22688,17048,5640,11000,0,4915,4930,3479,1451,2.397656788,2265,2929,1478,923,0,923,0,324,0,0.040086674,empty,mBC-0716-2
"F10,G8",605182,651556,436706,214850,320798,56,174010,174353,123029,51324,2.397104668,94914,22397,14187,8045,4,8041,2,1512,0,0.006093769,mm10,mBC-0716-2
"F10,G9",11975,12423,9045,3378,5978,0,2794,2799,1987,812,2.447044335,1352,1631,1036,652,0,652,0,280,0,0.047546012,empty,mBC-0716-2
"F10,G10",15030,15259,11471,3788,7568,2,3428,3446,2435,1011,2.408506429,1602,6330,2289,1394,1,1393,1,473,0,0.031586504,empty,mBC-0716-2
"F10,G11",786036,878442,535235,343207,429760,17,261752,262068,214211,47857,4.476064108,148789,41345,24780,13850,4,13846,2,1985,0,0.002094468,mm10,mBC-0716-2
"F10,G12",12571,12970,9501,3469,6389,0,2980,2981,2076,905,2.293922652,1419,1315,828,491,0,491,0,202,0,0.038696538,empty,mBC-0716-2
"F10,H1",704322,742246,534133,208113,359864,8,167463,167829,143717,24112,5.960393165,84478,57802,37632,20708,13,20695,3,2480,0,0.00111138,mm10,mBC-0716-2
"F10,H2",27647,28156,21028,7128,13636,0,6259,6276,4465,1811,2.46548868,3004,10413,3713,2260,1,2259,1,666,0,0.058875609,empty,mBC-0716-2
"F10,H3",22754,23480,17207,6273,11448,0,5290,5303,3739,1564,2.390664962,2546,1813,1074,656,0,656,0,273,0,0.045731707,empty,mBC-0716-2
"F10,H4",15805,16290,11876,4414,7889,19,3651,3675,2598,1077,2.412256267,1775,273,150,100,0,100,0,80,0,0.01,empty,mBC-0716-2
"F10,H5",838938,932057,590598,341459,450467,10,256892,257263,212599,44664,4.759963281,143856,104518,64077,35455,13,35442,2,3423,0,0.001721122,mm10,mBC-0716-2
"F10,H6",18196,18862,13598,5264,9283,10,4367,4387,3121,1266,2.465244866,2156,3158,1466,832,0,832,0,333,0,0.013221154,empty,mBC-0716-2
"F10,H7",826507,873542,603295,270247,426285,2,221994,222398,177832,44566,3.990306512,115757,57630,37370,20955,14,20941,3,2532,0,0.002005635,mm10,mBC-0716-2
"F10,H8",16985,17669,12900,4769,8499,1,4005,4012,2848,1164,2.446735395,1962,1911,1055,630,0,630,0,291,0,0.020634921,empty,mBC-0716-2
"F10,H9",18146,18373,13690,4683,9051,0,4134,4144,2980,1164,2.560137457,1961,1817,1084,669,0,669,0,288,0,0.016442451,empty,mBC-0716-2
"F10,H10",16307,16607,12142,4465,8223,3,3797,3805,2727,1078,2.529684601,1833,1639,993,608,0,608,0,269,0,0.016447368,empty,mBC-0716-2
"F10,H11",18183,18768,13793,4975,9123,12,4201,4222,2902,1320,2.198484848,2045,314,143,100,0,100,0,68,0,0,empty,mBC-0716-2
"F10,H12",6627,6894,4959,1935,3458,6,1697,1707,1224,483,2.534161491,855,840,389,221,0,221,0,107,0,0.031674208,empty,mBC-0716-2
"F11,A1",14480,14815,10999,3816,7452,0,3482,3489,2463,1026,2.400584795,1666,851,489,278,0,278,0,125,0,0.086330935,empty,mBC-0716-2
"F11,A2",19245,18993,14787,4206,9314,0,4002,4002,2790,1212,2.301980198,1723,929,556,333,0,333,0,158,0,0.021021021,empty,mBC-0716-2
"F11,A3",17052,17883,13079,4804,8693,34,4045,4089,2887,1202,2.401830283,1956,754,432,273,0,273,0,120,0,0.06959707,empty,mBC-0716-2
"F11,A4",22688,23351,17579,5772,11247,0,4979,4985,3431,1554,2.207850708,2311,658,389,229,0,229,0,106,0,0.135371179,empty,mBC-0716-2
"F11,A5",17613,18404,13402,5002,9126,0,4306,4310,3062,1248,2.453525641,2108,1264,774,468,0,468,0,209,0,0.021367521,empty,mBC-0716-2
"F11,A6",20666,21650,15215,6435,10939,3,5355,5370,3903,1467,2.660531697,2741,1297,769,487,0,487,0,200,0,0.063655031,empty,mBC-0716-2
"F11,A7",16454,16872,12575,4297,8279,0,3683,3702,2615,1087,2.405703772,1759,1072,582,341,0,341,0,151,0,0.014662757,empty,mBC-0716-2
"F11,A8",413509,428675,308034,120641,213665,0,103927,104060,82375,21685,3.798708785,52245,18900,12148,7060,4,7056,1,1337,0,0.004676871,mm10,mBC-0716-2
"F11,A9",21149,21789,16342,5447,10448,0,4734,4744,3378,1366,2.472913616,2216,1033,629,378,0,378,0,174,0,0.031746032,empty,mBC-0716-2
"F11,A10",16244,16420,12361,4059,8134,0,3684,3691,2554,1137,2.246262093,1730,705,279,162,0,162,0,84,0,0.061728395,empty,mBC-0716-2
"F11,A11",18875,19252,14210,5042,9419,0,4218,4223,2941,1282,2.294071763,1997,1327,709,426,0,426,0,169,0,0.049295775,empty,mBC-0716-2
"F11,A12",718631,772710,526177,246533,373598,1,196733,197064,145609,51455,2.829831892,104200,58742,33877,18964,6,18958,2,2575,0,0.015982699,mm10,mBC-0716-2
"F11,B1",20593,21270,15905,5365,10162,0,4595,4604,3254,1350,2.41037037,2127,871,541,319,0,319,0,131,0,0.021943574,empty,mBC-0716-2
"F11,B2",21445,21925,16557,5368,10455,7,4577,4600,3205,1395,2.297491039,2109,447,264,161,0,161,0,64,0,0.01863354,empty,mBC-0716-2
"F11,B3",20310,21001,15336,5665,10320,0,4735,4745,3327,1418,2.346262341,2328,6971,2088,1335,2,1333,2,438,0,0.083270818,empty,mBC-0716-2
"F11,B4",996832,1149661,668136,481525,559504,2,362658,363159,275757,87402,3.155042219,211365,19939,12095,6926,0,6926,0,1373,0,0.007363558,mm10,mBC-0716-2
"F11,B5",9484,5800,4060,1740,3685,0,1826,1833,1239,594,2.085858586,989,624,388,224,0,224,0,94,0,0.03125,empty,mBC-0716-2
"F11,B6",12821,13573,9764,3809,6681,1,3108,3119,2212,907,2.438809261,1512,996,604,386,0,386,0,156,0,0.077720207,empty,mBC-0716-2
"F11,B7",17707,18643,13584,5059,9027,6,4135,4148,2892,1256,2.302547771,1982,883,483,300,0,300,0,134,0,0.096666667,empty,mBC-0716-2
"F11,B8",14492,14724,10959,3765,7193,20,3258,3287,2298,989,2.323559151,1550,8069,2705,1590,0,1590,0,452,0,0.10754717,empty,mBC-0716-2
"F11,B9",16055,16421,12435,3986,7872,26,3526,3557,2496,1061,2.352497644,1663,740,434,248,1,247,1,112,0,0.052631579,empty,mBC-0716-2
"F11,B10",17158,17189,12859,4330,8701,0,4055,4070,2781,1289,2.157486424,1901,485,249,149,0,149,0,68,0,0.093959732,empty,mBC-0716-2
"F11,B11",19664,20249,14905,5344,9741,49,4542,4609,3328,1281,2.597970336,2240,141,89,71,0,71,0,49,0,0,empty,mBC-0716-2
"F11,B12",19160,19698,14718,4980,9566,0,4402,4412,3055,1357,2.251289609,2088,1028,630,367,0,367,0,146,0,0.029972752,empty,mBC-0716-2
"F11,C1",3865926,3967832,2904351,1063481,1741066,5,875840,877564,738171,139393,5.295610253,430560,96521,59067,33106,21,33085,4,3437,0,0.001964637,mm10,mBC-0716-2
"F11,C2",19642,20760,14676,6084,9864,41,4629,4680,3259,1421,2.293455313,2405,1149,724,415,0,415,0,152,0,0.03373494,empty,mBC-0716-2
"F11,C3",23711,24527,17781,6746,11871,53,5608,5677,3978,1699,2.341377281,2805,1779,716,415,0,415,0,154,0,0.05060241,empty,mBC-0716-2
"F11,C4",18135,18248,13954,4294,8909,1,3935,3939,2795,1144,2.443181818,1815,1005,628,353,0,353,0,129,0,0.031161473,empty,mBC-0716-2
"F11,C5",891450,1004236,609781,394455,491942,17,302650,303079,216898,86181,2.516772839,175203,7544,4771,2656,4,2652,1,648,0,0.009426848,mm10,mBC-0716-2
"F11,C6",17750,18521,13198,5323,9067,1,4220,4226,2988,1238,2.413570275,2103,936,606,406,0,406,0,168,0,0.051724138,empty,mBC-0716-2
"F11,C7",17601,18305,13222,5083,8893,0,4168,4173,2826,1347,2.097995546,2067,385,225,129,0,129,0,71,0,0.023255814,empty,mBC-0716-2
"F11,C8",15569,16091,11777,4314,7811,2,3564,3573,2424,1149,2.109660574,1747,1407,816,466,0,466,0,187,0,0.060085837,empty,mBC-0716-2
"F11,C9",13383,14072,10187,3885,6785,5,3120,3128,2136,992,2.153225806,1491,735,410,263,0,263,0,126,0,0.060836502,empty,mBC-0716-2
"F11,C10",910077,980048,667323,312725,471362,21,244726,245146,211869,33277,6.366829943,127950,131303,84820,47690,17,47673,2,3806,0,0.00050343,mm10,mBC-0716-2
"F11,C11",12693,12959,9553,3406,6295,29,2963,2994,2034,960,2.11875,1430,6877,2126,1303,2,1301,1,409,0,0.043812452,empty,mBC-0716-2
"F11,C12",21123,21463,15896,5567,10380,0,4730,4733,3392,1341,2.52945563,2290,1220,743,420,0,420,0,155,0,0.071428571,empty,mBC-0716-2
"F11,D1",11741,11955,8818,3137,5970,8,2751,2762,1933,829,2.33172497,1333,634,395,227,0,227,0,86,0,0,empty,mBC-0716-2
"F11,D2",23112,23582,17843,5739,11394,1,5083,5096,3542,1554,2.279279279,2360,3715,1648,980,0,980,0,332,0,0.155102041,empty,mBC-0716-2
"F11,D3",783895,914541,514271,400270,449649,3,290784,291189,240284,50905,4.720243591,173263,79571,49089,28263,17,28246,2,3028,0,0.004283792,mm10,mBC-0716-2
"F11,D4",15313,15626,11763,3863,7646,1,3472,3483,2414,1069,2.25818522,1577,1196,706,435,0,435,0,198,0,0.066666667,empty,mBC-0716-2
"F11,D5",16065,16618,12072,4546,8127,0,3707,3715,2674,1041,2.568683958,1821,1048,604,369,0,369,0,135,0,0.097560976,empty,mBC-0716-2
"F11,D6",13433,14189,10165,4024,7055,17,3440,3459,2405,1054,2.281783681,1722,1042,596,330,0,330,0,142,0,0.081818182,empty,mBC-0716-2
"F11,D7",12853,13073,9595,3478,6527,22,3057,3087,2160,927,2.330097087,1504,1138,633,355,0,355,0,142,0,0.022535211,empty,mBC-0716-2
"F11,D8",17222,18088,13026,5062,8764,8,4244,4266,2975,1291,2.304415182,2101,1422,685,408,0,408,0,171,0,0.093137255,empty,mBC-0716-2
"F11,D9",5137,5355,3772,1583,2727,0,1296,1299,931,368,2.529891304,654,1331,793,504,0,504,0,223,0,0.03968254,empty,mBC-0716-2
"F11,D10",14567,14970,11021,3949,7209,1,3366,3372,2306,1066,2.163227017,1615,717,421,248,0,248,0,108,0,0.060483871,empty,mBC-0716-2
"F11,D11",14153,14570,10725,3845,7234,68,3326,3396,2386,1010,2.362376238,1676,1393,844,490,0,490,0,200,0,0.006122449,empty,mBC-0716-2
"F11,D12",21006,21674,16170,5504,10483,0,4726,4740,3296,1444,2.282548476,2185,1670,974,623,2,621,1,220,0,0.066022544,empty,mBC-0716-2
"F11,E1",23080,23401,17664,5737,11286,11,4931,4951,3530,1421,2.48416608,2345,1096,648,401,0,401,0,178,0,0.044887781,empty,mBC-0716-2
"F11,E2",17306,17353,13266,4087,8488,10,3760,3786,2749,1037,2.650916104,1731,1069,629,402,3,399,1,171,0,0.012531328,empty,mBC-0716-2
"F11,E3",662168,742143,465118,277025,364784,7,211489,211819,133648,78171,1.709687736,121068,33313,19824,11331,7,11324,1,1779,0,0.002384316,mm10,mBC-0716-2
"F11,E4",16723,17316,12688,4628,8328,18,3870,3891,2746,1145,2.398253275,1852,951,488,313,0,313,0,134,0,0.108626198,empty,mBC-0716-2
"F11,E5",22501,22975,17340,5635,11043,0,4827,4838,3379,1459,2.315969842,2270,1127,635,375,0,375,0,175,0,0.021333333,empty,mBC-0716-2
"F11,E6",14813,15037,11392,3645,7341,0,3271,3279,2327,952,2.444327731,1539,1303,763,467,0,467,0,204,0,0.014989293,empty,mBC-0716-2
"F11,E7",853756,919443,621532,297911,442393,3,231264,231638,174059,57579,3.02295976,122922,48526,29790,16957,10,16947,1,2331,0,0.001947247,mm10,mBC-0716-2
"F11,E8",18971,19212,14560,4652,9291,28,4158,4191,2877,1314,2.189497717,1885,1347,829,494,0,494,0,193,0,0.097165992,empty,mBC-0716-2
"F11,E9",9124,9291,6818,2473,4626,0,2148,2155,1526,629,2.426073132,1071,947,592,340,1,339,1,113,0,0.053097345,empty,mBC-0716-2
"F11,E10",13765,14177,10458,3719,6976,5,3213,3224,2161,1063,2.032925682,1541,1240,694,420,0,420,0,171,0,0.057142857,empty,mBC-0716-2
"F11,E11",9883,10432,7488,2944,5109,22,2425,2457,1708,749,2.280373832,1226,1149,651,374,0,374,0,144,0,0.06684492,empty,mBC-0716-2
"F11,E12",473494,499784,345747,154037,250693,4,131412,131627,99415,32212,3.086272197,69202,6025,3853,2107,1,2106,1,567,0,0.00617284,mm10,mBC-0716-2
"F11,F1",1090627,1174041,796248,377793,557593,0,296121,296574,247493,49081,5.04254192,156856,76819,51055,28306,8,28298,2,2904,0,0.002261644,mm10,mBC-0716-2
"F11,F2",968930,1098839,659791,439048,534699,2,334859,335322,249780,85542,2.919969138,193243,29232,17590,10104,4,10100,2,1823,0,0.006930693,mm10,mBC-0716-2
"F11,F3",16712,16937,12526,4411,8454,4,3993,4008,2789,1219,2.287940935,1918,3155,1319,812,0,812,0,316,0,0.044334975,empty,mBC-0716-2
"F11,F4",17070,17141,12585,4556,8446,73,3790,3871,2699,1172,2.302901024,1891,559,313,193,0,193,0,82,0,0.020725389,empty,mBC-0716-2
"F11,F5",25938,26851,19747,7104,12934,0,5997,6009,4199,1810,2.319889503,2909,1694,992,638,0,638,0,279,0,0.036050157,empty,mBC-0716-2
"F11,F6",738793,796815,536106,260709,389166,0,204287,204600,162997,41603,3.917914573,110083,109368,63717,35555,15,35540,2,3464,0,0.001406866,mm10,mBC-0716-2
"F11,F7",694048,731375,521733,209642,361636,3,179413,179730,138804,40926,3.391584812,91028,11293,5002,2885,4,2881,2,798,0,0.012842763,mm10,mBC-0716-2
"F11,F8",1635694,1815924,1126517,689407,884599,17,545951,546689,396435,150254,2.638432255,307649,2744,1532,904,0,904,0,290,0,0.007743363,empty,mBC-0716-2
"F11,F9",15443,15964,11706,4258,7855,1,3595,3606,2446,1160,2.10862069,1740,1252,718,425,0,425,0,166,0,0.049411765,empty,mBC-0716-2
"F11,F10",23168,23521,17787,5734,11406,20,5026,5063,3560,1503,2.368596141,2363,3150,1256,756,0,756,0,252,0,0.07010582,empty,mBC-0716-2
"F11,F11",11630,11808,8953,2855,5864,0,2543,2548,1766,782,2.25831202,1174,854,514,304,0,304,0,142,0,0.032894737,empty,mBC-0716-2
"F11,F12",15466,15829,11475,4354,7565,29,3547,3582,2587,995,2.6,1732,96,57,39,0,39,0,32,0,0,empty,mBC-0716-2
"F11,G1",11343,11421,8711,2710,5610,0,2534,2542,1733,809,2.142150803,1182,21801,6065,3604,4,3600,2,875,0,0.032777778,empty,mBC-0716-2
"F11,G2",2943237,3072334,2175579,896755,1426340,40,742883,744196,560587,183609,3.053156436,381734,40164,24181,13321,6,13315,2,2153,0,0.009087495,mm10,mBC-0716-2
"F11,G3",874222,913432,645536,267896,440476,17,220087,220470,178325,42145,4.231225531,112442,65653,43451,24102,4,24098,2,2989,0,0.002863308,mm10,mBC-0716-2
"F11,G4",1155880,1230327,840934,389393,585413,16,305729,306206,261498,44708,5.84902031,160175,640,398,218,0,218,0,97,0,0,empty,mBC-0716-2
"F11,G5",799133,871139,574016,297123,424746,23,242267,242682,180595,62087,2.90874096,130971,28406,15634,9022,7,9015,1,1577,0,0.00587909,mm10,mBC-0716-2
"F11,G6",26107,26539,20004,6535,12708,0,5647,5664,4012,1652,2.428571429,2613,624,238,158,0,158,0,69,0,0.018987342,empty,mBC-0716-2
"F11,G7",21146,21994,16287,5707,10600,0,4662,4672,3279,1393,2.353912419,2191,1456,860,525,0,525,0,221,0,0.060952381,empty,mBC-0716-2
"F11,G8",15410,15887,11617,4270,7741,0,3593,3601,2509,1092,2.297619048,1751,1340,855,525,0,525,0,215,0,0.015238095,empty,mBC-0716-2
"F11,G9",10935,11253,8233,3020,5555,1,2556,2559,1765,794,2.222921914,1263,1979,828,486,0,486,0,219,0,0.037037037,empty,mBC-0716-2
"F11,G10",14553,14891,11256,3635,7190,0,3160,3168,2217,951,2.331230284,1473,1225,803,507,0,507,0,210,0,0.035502959,empty,mBC-0716-2
"F11,G11",13008,12907,9976,2931,6295,0,2751,2762,1961,801,2.448189763,1229,616,372,225,0,225,0,106,0,0.017777778,empty,mBC-0716-2
"F11,G12",12118,12660,9111,3549,6334,0,2903,2911,2042,869,2.349827388,1457,1083,595,333,2,331,1,130,0,0.081570997,empty,mBC-0716-2
"F11,H1",24822,25623,18534,7089,12146,0,5693,5705,4100,1605,2.554517134,2849,8305,2338,1375,1,1374,1,444,0,0.061863173,empty,mBC-0716-2
"F11,H2",25215,26280,19050,7230,12656,22,5839,5872,4080,1792,2.276785714,2876,1579,1008,602,0,602,0,244,0,0.034883721,empty,mBC-0716-2
"F11,H3",21212,21799,16143,5656,10416,0,4775,4786,3393,1393,2.435750179,2247,1347,776,497,0,497,0,238,0,0.056338028,empty,mBC-0716-2
"F11,H4",854826,932701,603456,329245,451484,32,256703,257103,208849,48254,4.328117876,140325,2580,1531,820,2,818,1,247,0,0.019559902,empty,mBC-0716-2
"F11,H5",19450,20033,14873,5160,9631,1,4425,4436,3172,1264,2.509493671,2113,1097,651,402,0,402,0,177,0,0.027363184,empty,mBC-0716-2
"F11,H6",14682,15253,11146,4107,7522,0,3466,3477,2446,1031,2.372453928,1760,1254,698,441,0,441,0,177,0,0.027210884,empty,mBC-0716-2
"F11,H7",17300,17630,12951,4679,8767,1,4052,4065,2825,1240,2.278225806,2002,2498,1043,597,3,594,2,220,0,0.033670034,empty,mBC-0716-2
"F11,H8",13669,14259,10286,3973,7051,0,3352,3360,2316,1044,2.218390805,1676,1174,730,439,0,439,0,196,0,0.006833713,empty,mBC-0716-2
"F11,H9",16313,16522,12325,4197,8069,0,3693,3695,2608,1087,2.399264029,1740,6136,1927,1193,3,1190,1,402,0,0.065546218,empty,mBC-0716-2
"F11,H10",15528,15876,11890,3986,7810,0,3599,3610,2530,1080,2.342592593,1714,1227,742,471,0,471,0,231,0,0.036093418,empty,mBC-0716-2
"F11,H11",17873,18835,13615,5220,9143,0,4275,4285,2956,1329,2.224228743,2173,166,92,62,0,62,0,44,0,0.016129032,empty,mBC-0716-2
"F11,H12",6384,6678,4760,1918,3364,0,1617,1619,1108,511,2.168297456,819,407,217,131,0,131,0,73,0,0.007633588,empty,mBC-0716-2
"F12,A1",15614,16371,11738,4633,8132,44,3752,3808,2571,1237,2.078415521,1938,976,578,331,0,331,0,131,0,0.048338369,empty,mBC-0716-2
"F12,A2",1168408,1254668,833124,421544,588868,22,320333,320920,274885,46035,5.971217552,170201,110764,73514,40987,26,40961,2,3539,0,0.00119626,mm10,mBC-0716-2
"F12,A3",17859,18491,13591,4900,8930,0,4148,4149,2870,1279,2.243940579,2006,800,517,318,0,318,0,118,0,0.037735849,empty,mBC-0716-2
"F12,A4",21796,22042,16969,5073,10462,0,4551,4558,3199,1359,2.353936718,2058,1380,578,354,0,354,0,123,0,0.093220339,empty,mBC-0716-2
"F12,A5",18246,19127,13961,5166,9242,0,4292,4303,2982,1321,2.257380772,2051,1925,855,512,1,511,1,208,0,0.029354207,empty,mBC-0716-2
"F12,A6",14409,15163,10781,4382,7313,15,3505,3531,2502,1029,2.43148688,1710,6460,2164,1293,0,1293,0,401,0,0.050270688,empty,mBC-0716-2
"F12,A7",16712,17598,12607,4991,8486,10,3982,4002,2739,1263,2.168646081,1992,1053,628,360,0,360,0,140,0,0.038888889,empty,mBC-0716-2
"F12,A8",11298,11650,8515,3135,5759,1,2698,2702,1924,778,2.473007712,1293,1235,718,406,0,406,0,162,0,0.086206897,empty,mBC-0716-2
"F12,A9",24644,25616,19101,6515,12022,1,5488,5500,3996,1504,2.656914894,2586,3061,1312,795,1,794,1,256,0,0.040302267,empty,mBC-0716-2
"F12,A10",17026,17657,13047,4610,8502,10,3899,3917,2730,1187,2.299915754,1917,257,149,98,1,97,1,58,0,0.010309278,empty,mBC-0716-2
"F12,A11",791965,826033,582056,243977,400976,0,210544,210919,157814,53105,2.971735242,106613,9015,5785,3264,3,3261,1,785,0,0.005826434,mm10,mBC-0716-2
"F12,A12",23394,23453,17567,5886,11016,25,4874,4910,3486,1424,2.448033708,2274,6024,3105,1829,0,1829,0,475,0,0.308365227,empty,mBC-0716-2
"F12,B1",20281,21111,15504,5607,9981,0,4431,4448,3111,1337,2.326851159,2095,1059,648,378,0,378,0,128,0,0.079365079,empty,mBC-0716-2
"F12,B2",1832201,1986064,1327629,658435,942201,3,519437,520296,420413,99883,4.209054594,277795,45055,27999,15757,6,15751,2,2200,0,0.002920449,mm10,mBC-0716-2
"F12,B3",19133,19750,14605,5145,9509,0,4362,4384,3057,1327,2.30369254,2056,1102,649,374,0,374,0,141,0,0.090909091,empty,mBC-0716-2
"F12,B4",17782,18729,13722,5007,8959,14,4042,4063,2839,1224,2.319444444,2044,1643,734,437,2,435,1,160,0,0.089655172,empty,mBC-0716-2
"F12,B5",597095,358006,206549,151457,231975,15,140792,141628,112511,29117,3.86410001,86575,49964,30466,16854,6,16848,1,2245,0,0.001780627,mm10,mBC-0716-2
"F12,B6",13205,14129,10114,4015,6861,0,3277,3285,2326,959,2.42544317,1634,1027,619,350,1,349,1,149,0,0.065902579,empty,mBC-0716-2
"F12,B7",17760,18301,13531,4770,8765,0,3942,3951,2727,1224,2.227941176,1884,5687,1694,989,0,989,0,288,0,0.015166835,empty,mBC-0716-2
"F12,B8",14011,14398,10760,3638,6886,0,3070,3087,2154,933,2.308681672,1435,2231,907,555,2,553,1,216,0,0.068716094,empty,mBC-0716-2
"F12,B9",15732,16247,12080,4167,7734,0,3447,3456,2476,980,2.526530612,1632,657,421,261,0,261,0,108,0,0.030651341,empty,mBC-0716-2
"F12,B10",17919,18236,13324,4912,9064,0,4197,4204,2827,1377,2.053013798,2039,413,226,137,0,137,0,67,0,0.01459854,empty,mBC-0716-2
"F12,B11",1125808,1323968,725086,598882,623158,1,417411,417996,305360,112636,2.711033773,251959,3799,2480,1435,1,1434,1,367,0,0,mm10,mBC-0716-2
"F12,B12",19278,19517,14639,4878,9479,21,4311,4343,3038,1305,2.327969349,2002,1862,845,520,1,519,1,192,0,0.036608863,empty,mBC-0716-2
"F12,C1",23037,22776,17850,4926,10828,0,4538,4545,3199,1346,2.37667162,2037,544,319,201,0,201,0,93,0,0.039800995,empty,mBC-0716-2
"F12,C2",19965,20850,15270,5580,9970,3,4607,4631,3233,1398,2.312589413,2249,1255,699,407,0,407,0,159,0,0.068796069,empty,mBC-0716-2
"F12,C3",20790,21416,15688,5728,10276,0,4791,4802,3364,1438,2.339360223,2329,582,316,181,0,181,0,76,0,0.016574586,empty,mBC-0716-2
"F12,C4",18814,19221,14384,4837,9313,6,4077,4096,2872,1224,2.346405229,1890,833,473,271,0,271,0,109,0,0.05904059,empty,mBC-0716-2
"F12,C5",20663,21504,15524,5980,10432,40,4910,4977,3439,1538,2.236020806,2436,1303,724,453,0,453,0,164,0,0.024282561,empty,mBC-0716-2
"F12,C6",17805,18353,13498,4855,9095,0,4177,4186,2954,1232,2.397727273,1978,2762,1125,654,0,654,0,237,0,0.067278287,empty,mBC-0716-2
"F12,C7",18200,19214,13889,5325,9043,10,4113,4144,2878,1266,2.273301738,2005,329,181,106,0,106,0,53,0,0,empty,mBC-0716-2
"F12,C8",23104,24435,17669,6766,11796,5,5544,5561,3738,1823,2.050466264,2740,2143,1330,797,0,797,0,235,0,0.042659975,empty,mBC-0716-2
"F12,C9",13856,14460,10496,3964,7046,0,3380,3383,2398,985,2.434517766,1631,708,355,221,0,221,0,91,0,0.135746606,empty,mBC-0716-2
"F12,C10",14623,15038,11129,3909,7239,14,3223,3241,2228,1013,2.1994077,1547,921,553,310,0,310,0,122,0,0.009677419,empty,mBC-0716-2
"F12,C11",12542,13080,9340,3740,6343,32,2995,3027,2086,941,2.216790648,1527,4243,1588,933,0,933,0,298,0,0.192926045,empty,mBC-0716-2
"F12,C12",20784,21847,15732,6115,10374,16,4715,4744,3345,1399,2.390993567,2335,973,574,317,0,317,0,111,0,0.094637224,empty,mBC-0716-2
"F12,D1",14055,14515,10492,4023,7026,0,3300,3312,2311,1001,2.308691309,1657,7123,1994,1148,1,1147,1,332,0,0.074978204,empty,mBC-0716-2
"F12,D2",21432,22200,16378,5822,10704,0,4778,4783,3377,1406,2.401849218,2357,1828,1080,678,0,678,0,239,0,0.025073746,empty,mBC-0716-2
"F12,D3",14800,15347,11058,4289,7435,0,3514,3524,2414,1110,2.174774775,1745,3779,1223,735,0,735,0,256,0,0.084353741,empty,mBC-0716-2
"F12,D4",15450,16057,11612,4445,7716,18,3568,3592,2556,1036,2.467181467,1745,1041,629,383,0,383,0,149,0,0.033942559,empty,mBC-0716-2
"F12,D5",14590,15244,11199,4045,7447,0,3381,3390,2391,999,2.393393393,1621,927,497,289,0,289,0,117,0,0.038062284,empty,mBC-0716-2
"F12,D6",1045832,1133073,762465,370608,554200,1,300965,301435,226274,75161,3.010524075,163662,21463,12435,7126,3,7123,1,1348,0,0.00996771,mm10,mBC-0716-2
"F12,D7",13899,14440,10495,3945,6889,28,3112,3154,2204,950,2.32,1531,1135,699,375,0,375,0,143,0,0.072,empty,mBC-0716-2
"F12,D8",17153,18092,13143,4949,8496,45,3893,3944,2694,1250,2.1552,1888,2171,868,513,0,513,0,183,0,0.037037037,empty,mBC-0716-2
"F12,D9",6596,6733,5013,1720,3272,4,1544,1550,1105,445,2.483146067,730,1547,866,514,0,514,0,183,0,0.021400778,empty,mBC-0716-2
"F12,D10",15111,15590,11543,4047,7496,0,3446,3458,2379,1079,2.204819277,1652,678,356,192,0,192,0,77,0,0.046875,empty,mBC-0716-2
"F12,D11",14518,14963,10924,4039,7349,17,3422,3440,2383,1057,2.254493851,1693,1403,804,491,0,491,0,185,0,0.050916497,empty,mBC-0716-2
"F12,D12",21109,21899,15946,5953,10272,0,4739,4758,3313,1445,2.292733564,2226,2382,1523,856,1,855,1,248,0,0.065497076,empty,mBC-0716-2
"F12,E1",23104,23595,17696,5899,11473,1,5112,5125,3688,1437,2.566457898,2418,1298,788,459,0,459,0,178,0,0.043572985,empty,mBC-0716-2
"F12,E2",18590,18949,14225,4724,9079,0,4109,4125,2869,1256,2.284235669,1896,1491,807,468,0,468,0,160,0,0.057692308,empty,mBC-0716-2
"F12,E3",661205,713322,458564,254758,350068,10,203845,204154,163154,41000,3.979365854,111763,8647,5593,3174,1,3173,1,883,0,0.001890955,mm10,mBC-0716-2
"F12,E4",16981,17551,12954,4597,8200,28,3653,3687,2580,1107,2.330623306,1767,1240,806,443,0,443,0,146,0,0.038374718,empty,mBC-0716-2
"F12,E5",22091,22556,17095,5461,10740,6,4758,4771,3374,1397,2.415175376,2198,1205,707,425,1,424,1,154,0,0.047169811,empty,mBC-0716-2
"F12,E6",15386,16145,11765,4380,7606,0,3432,3433,2379,1054,2.25711575,1708,1516,926,544,0,544,0,184,0,0.060661765,empty,mBC-0716-2
"F12,E7",14531,15185,11072,4113,7265,0,3299,3302,2319,983,2.359104781,1605,1327,813,441,0,441,0,146,0,0.052154195,empty,mBC-0716-2
"F12,E8",805137,858869,598786,260083,415402,0,208345,208674,157510,51164,3.07853178,108063,86143,50686,28357,17,28340,1,3120,0,0.004834157,mm10,mBC-0716-2
"F12,E9",10394,10819,7928,2891,5256,0,2436,2444,1742,702,2.481481481,1192,998,564,312,0,312,0,125,0,0.028846154,empty,mBC-0716-2
"F12,E10",13613,13819,10190,3629,6764,1,3106,3115,2173,942,2.306794055,1498,7362,2633,1595,1,1594,1,411,0,0.212672522,empty,mBC-0716-2
"F12,E11",9922,10508,7577,2931,5135,0,2412,2415,1653,762,2.169291339,1157,958,608,329,0,329,0,126,0,0.051671733,empty,mBC-0716-2
"F12,E12",16220,17128,12166,4962,8510,0,4064,4071,2794,1277,2.187940486,2063,2286,940,510,0,510,0,178,0,0.035294118,empty,mBC-0716-2
"F12,F1",18955,19604,14535,5069,9352,1,4186,4199,2898,1301,2.227517294,1969,2366,1073,616,1,615,1,226,0,0.040650407,empty,mBC-0716-2
"F12,F2",24022,24918,18244,6674,11914,0,5474,5490,3864,1626,2.376383764,2660,2165,1308,741,1,740,1,271,0,0.055405405,empty,mBC-0716-2
"F12,F3",17720,18814,13271,5543,8962,31,4236,4286,2988,1298,2.302003082,2161,1509,867,507,0,507,0,209,0,0.009861933,empty,mBC-0716-2
"F12,F4",17686,18524,13206,5318,9014,0,4179,4186,2983,1203,2.479634248,2058,428,200,126,1,125,1,65,0,0.056,empty,mBC-0716-2
"F12,F5",26363,26963,19855,7108,13019,0,6000,6008,4207,1801,2.335924486,2914,1377,763,480,1,479,1,206,0,0.064718163,empty,mBC-0716-2
"F12,F6",29116,30214,22032,8182,14661,4,7107,7116,5033,2083,2.416226596,3464,2185,1292,731,0,731,0,261,0,0.045143639,empty,mBC-0716-2
"F12,F7",21880,22607,16604,6003,11022,6,5117,5132,3621,1511,2.396426208,2498,3747,1352,828,1,827,1,279,0,0.058041112,empty,mBC-0716-2
"F12,F8",25607,26524,19637,6887,12786,39,5805,5857,4148,1709,2.42715038,2810,662,259,168,0,168,0,81,0,0.095238095,empty,mBC-0716-2
"F12,F9",15258,15815,11659,4156,7682,0,3442,3450,2368,1082,2.188539741,1610,1144,679,376,0,376,0,158,0,0.042553191,empty,mBC-0716-2
"F12,F10",20828,21340,16200,5140,10280,0,4458,4465,3178,1287,2.469308469,2039,1028,587,374,0,374,0,147,0,0.013368984,empty,mBC-0716-2
"F12,F11",12128,12562,9247,3315,5989,2,2714,2721,1847,874,2.113272311,1322,803,445,272,0,272,0,129,0,0.069852941,empty,mBC-0716-2
"F12,F12",15527,16339,11771,4568,7625,26,3492,3530,2526,1004,2.515936255,1737,201,106,58,0,58,0,31,0,0.034482759,empty,mBC-0716-2
"F12,G1",10066,10211,7809,2402,5069,3,2215,2220,1509,711,2.122362869,999,1470,913,487,0,487,0,168,0,0.014373717,empty,mBC-0716-2
"F12,G2",22583,22975,17326,5649,10934,0,4854,4864,3442,1422,2.420534459,2258,460,248,164,0,164,0,94,0,0.006097561,empty,mBC-0716-2
"F12,G3",21431,22039,16267,5772,10506,2,4814,4831,3395,1436,2.364206128,2253,1759,1092,599,0,599,0,231,0,0.060100167,empty,mBC-0716-2
"F12,G4",29655,30677,22876,7801,14516,87,6256,6361,4471,1890,2.365608466,3018,90,61,43,0,43,0,30,0,0,empty,mBC-0716-2
"F12,G5",14762,15185,11184,4001,7289,17,3305,3326,2291,1035,2.21352657,1599,956,554,322,0,322,0,144,0,0.037267081,empty,mBC-0716-2
"F12,G6",25800,26833,19758,7075,12828,4,5805,5828,4159,1669,2.491911324,2844,155,74,53,0,53,0,35,0,0,empty,mBC-0716-2
"F12,G7",20563,21295,15861,5434,10291,0,4565,4580,3151,1429,2.205038488,2169,1530,836,517,0,517,0,204,0,0.048355899,empty,mBC-0716-2
"F12,G8",15871,16306,11950,4356,7773,10,3615,3637,2544,1093,2.327538884,1738,6678,2311,1402,1,1401,1,423,0,0.059243398,empty,mBC-0716-2
"F12,G9",1776397,1934489,1301685,632804,908571,9,495296,496088,397832,98256,4.048933398,263818,138460,86115,48044,13,48031,1,4147,0,0.000978535,mm10,mBC-0716-2
"F12,G10",14789,15147,11282,3865,7313,0,3254,3265,2243,1022,2.194716243,1567,1007,661,390,0,390,0,170,0,0.030769231,empty,mBC-0716-2
"F12,G11",13246,13527,10148,3379,6554,0,2916,2922,2001,921,2.172638436,1404,598,352,190,0,190,0,83,0,0.015789474,empty,mBC-0716-2
"F12,G12",12278,12879,9359,3520,6158,0,2853,2853,2019,834,2.420863309,1421,1171,692,400,1,399,1,142,0,0.050125313,empty,mBC-0716-2
"F12,H1",22594,23595,17312,6283,11294,0,5189,5203,3698,1505,2.457142857,2534,782,417,224,0,224,0,103,0,0.071428571,empty,mBC-0716-2
"F12,H2",25197,26024,19388,6636,12623,0,5854,5872,4188,1684,2.486935867,2756,2180,1125,693,0,693,0,258,0,0.031746032,empty,mBC-0716-2
"F12,H3",23946,25004,18013,6991,11946,0,5580,5594,4003,1591,2.516027656,2755,3130,1143,679,1,678,1,223,0,0.08259587,empty,mBC-0716-2
"F12,H4",15759,15874,11792,4082,7690,0,3537,3551,2449,1102,2.222323049,1667,449,195,126,0,126,0,69,0,0,empty,mBC-0716-2
"F12,H5",19094,19866,14467,5399,9447,0,4381,4391,3028,1363,2.221570066,2189,1270,834,492,1,491,1,163,0,0.097759674,empty,mBC-0716-2
"F12,H6",16232,16746,12292,4454,8202,41,3775,3822,2674,1148,2.329268293,1817,1476,824,466,0,466,0,184,0,0.040772532,empty,mBC-0716-2
"F12,H7",18487,18843,13918,4925,9061,0,4139,4148,2964,1184,2.503378378,1987,1027,579,353,0,353,0,158,0,0.02266289,empty,mBC-0716-2
"F12,H8",606788,648371,453667,194704,315617,0,154201,154489,119401,35088,3.402901277,80663,94372,60849,33602,13,33589,3,3409,0,0.001369496,mm10,mBC-0716-2
"F12,H9",17967,18332,13521,4811,8885,16,4058,4091,2918,1173,2.487638534,1967,8059,2537,1536,4,1532,3,466,0,0.033942559,empty,mBC-0716-2
"F12,H10",16512,17181,12445,4736,8350,0,3977,3987,2775,1212,2.28960396,1958,1197,770,480,1,479,1,178,0,0.060542797,empty,mBC-0716-2
"F12,H11",17939,18518,13579,4939,8855,0,4134,4144,2911,1233,2.360908354,2028,117,77,55,0,55,0,36,0,0.036363636,empty,mBC-0716-2
"F12,H12",6570,6810,4891,1919,3368,1,1609,1615,1121,494,2.269230769,798,513,290,188,0,188,0,79,0,0.04787234,empty,mBC-0716-2
"G1,A1",13918,14642,10512,4130,7223,0,3483,3491,2462,1029,2.392614189,1740,857,481,301,0,301,0,145,0,0.013289037,empty,mBC-0716-2
"G1,A2",18664,18794,14419,4375,9196,0,4046,4058,2810,1248,2.251602564,1798,926,558,354,0,354,0,139,0,0.062146893,empty,mBC-0716-2
"G1,A3",16028,16301,12318,3983,8025,4,3549,3559,2560,999,2.562562563,1658,752,439,281,0,281,0,138,0,0.010676157,empty,mBC-0716-2
"G1,A4",21429,21779,16399,5380,10588,6,4694,4708,3361,1347,2.495174462,2147,617,402,246,0,246,0,118,0,0.040650407,empty,mBC-0716-2
"G1,A5",1581243,1747990,1117942,630048,847087,2,487003,487774,401358,86416,4.644487132,269768,135166,85453,48240,31,48209,4,4167,0,0.000684519,mm10,mBC-0716-2
"G1,A6",21918,23448,16409,7039,11657,21,5721,5754,4233,1521,2.783037475,2889,961,571,357,0,357,0,182,0,0.039215686,empty,mBC-0716-2
"G1,A7",16808,17703,12788,4915,8748,0,3947,3958,2742,1216,2.254934211,1959,858,514,318,0,318,0,133,0,0.062893082,empty,mBC-0716-2
"G1,A8",10899,11200,8175,3025,5580,0,2611,2615,1769,846,2.091016548,1257,1009,601,363,1,362,1,176,0,0.005524862,empty,mBC-0716-2
"G1,A9",22432,22829,16864,5965,11050,0,5001,5010,3626,1384,2.619942197,2321,3333,1274,796,0,796,0,279,0,0.021356784,empty,mBC-0716-2
"G1,A10",816373,964645,527488,437157,473164,30,315772,316216,228434,87782,2.602287485,192310,9314,5939,3446,2,3444,1,761,0,0.00029036,mm10,mBC-0716-2
"G1,A11",17917,18269,13662,4607,9124,13,4108,4131,2908,1223,2.377759608,1943,904,530,324,0,324,0,168,0,0.021604938,empty,mBC-0716-2
"G1,A12",21114,21585,16149,5436,10311,0,4551,4564,3205,1359,2.358351729,2137,1948,1143,628,0,628,0,201,0,0.078025478,empty,mBC-0716-2
"G1,B1",19622,20201,14993,5208,9773,93,4389,4497,3212,1285,2.499610895,2185,810,459,293,0,293,0,137,0,0.037542662,empty,mBC-0716-2
"G1,B2",20770,20936,15271,5665,9847,29,4489,4520,3201,1319,2.426838514,2140,6320,1954,1206,1,1205,1,381,0,0.082987552,empty,mBC-0716-2
"G1,B3",19805,20101,15241,4860,9762,0,4401,4404,3136,1268,2.47318612,1984,1051,631,346,1,345,1,163,0,0.069565217,empty,mBC-0716-2
"G1,B4",16140,16458,12437,4021,8039,0,3559,3569,2533,1036,2.444980695,1656,808,484,289,0,289,0,127,0,0.024221453,empty,mBC-0716-2
"G1,B5",8681,5198,3699,1499,3310,0,1596,1604,1141,463,2.464362851,849,633,333,204,0,204,0,105,0,0.009803922,empty,mBC-0716-2
"G1,B6",11943,12694,9006,3688,6263,10,2941,2955,2078,877,2.369441277,1478,963,590,351,0,351,0,156,0,0.094017094,empty,mBC-0716-2
"G1,B7",16405,16865,12638,4227,8331,0,3659,3676,2606,1070,2.435514019,1711,1017,501,335,0,335,0,142,0,0.068656716,empty,mBC-0716-2
"G1,B8",2337941,2476207,1723118,753089,1168166,5,619413,620446,502762,117684,4.272135549,318996,123652,81040,45359,20,45339,1,4228,0,0.000771962,mm10,mBC-0716-2
"G1,B9",15287,15434,11586,3848,7531,14,3395,3414,2352,1062,2.214689266,1604,1366,524,304,1,303,1,157,0,0.00330033,empty,mBC-0716-2
"G1,B10",16240,16011,12007,4004,8111,0,3740,3753,2640,1113,2.371967655,1756,399,212,140,0,140,0,75,0,0.007142857,empty,mBC-0716-2
"G1,B11",20498,21543,15686,5857,10475,6,4787,4810,3398,1412,2.406515581,2393,242,141,93,0,93,0,62,0,0,empty,mBC-0716-2
"G1,B12",18470,18853,13972,4881,9386,10,4206,4225,2939,1286,2.285381026,2071,909,498,303,0,303,0,152,0,0.00990099,empty,mBC-0716-2
"G1,C1",22499,23019,17393,5626,10978,3,4622,4642,3243,1399,2.318084346,2185,465,311,206,0,206,0,106,0,0.053398058,empty,mBC-0716-2
"G1,C2",17681,18273,13447,4826,8928,0,4154,4160,2919,1241,2.352135375,2023,1163,686,409,1,408,1,153,0,0.083333333,empty,mBC-0716-2
"G1,C3",19784,20546,15004,5542,9969,7,4600,4612,3219,1393,2.310839914,2235,496,278,167,0,167,0,86,0,0,empty,mBC-0716-2
"G1,C4",17206,17287,13091,4196,8547,1,3808,3818,2671,1147,2.328683522,1826,874,514,313,0,313,0,138,0,0.063897764,empty,mBC-0716-2
"G1,C5",16449,17090,12438,4652,8328,25,3901,3935,2717,1218,2.230706076,1921,876,485,326,0,326,0,172,0,0.018404908,empty,mBC-0716-2
"G1,C6",17935,18692,13345,5347,9512,22,4505,4532,3227,1305,2.472796935,2316,2397,1042,676,1,675,1,237,0,0.035555556,empty,mBC-0716-2
"G1,C7",16058,16798,12181,4617,8176,0,3904,3910,2677,1233,2.171127332,1881,376,234,111,0,111,0,68,0,0.045045045,empty,mBC-0716-2
"G1,C8",14948,15793,11348,4445,7686,22,3516,3546,2473,1073,2.304753029,1806,1433,773,497,2,495,1,213,0,0.032323232,empty,mBC-0716-2
"G1,C9",13100,13706,9958,3748,6693,0,3178,3182,2209,973,2.270298047,1561,712,425,252,1,251,1,121,0,0.019920319,empty,mBC-0716-2
"G1,C10",14084,14617,10722,3895,7148,11,3362,3393,2319,1074,2.159217877,1642,955,576,385,1,384,1,154,0,0.065104167,empty,mBC-0716-2
"G1,C11",12130,12767,9246,3521,6287,0,2910,2919,2004,915,2.190163934,1446,848,459,266,1,265,1,122,0,0.030188679,empty,mBC-0716-2
"G1,C12",807984,890548,574767,315781,432396,2,243116,243500,177810,65690,2.706804689,135289,27627,16545,9412,5,9407,3,1676,0,0.004889976,mm10,mBC-0716-2
"G1,D1",13031,13714,9770,3944,6823,0,3286,3291,2303,988,2.33097166,1617,420,238,147,0,147,0,72,0,0.027210884,empty,mBC-0716-2
"G1,D2",21562,21871,16573,5298,10663,0,4703,4712,3346,1366,2.449487555,2136,2077,1275,775,1,774,1,295,0,0.059431525,empty,mBC-0716-2
"G1,D3",13950,14487,10595,3892,7151,36,3350,3392,2319,1073,2.161230196,1672,891,568,338,0,338,0,177,0,0.026627219,empty,mBC-0716-2
"G1,D4",14494,15147,10986,4161,7441,3,3472,3488,2395,1093,2.191216834,1672,1246,753,467,0,467,0,213,0,0.027837259,empty,mBC-0716-2
"G1,D5",13935,14340,10560,3780,6953,0,3170,3177,2230,947,2.354804646,1530,6526,2323,1384,1,1383,1,428,0,0.07230658,empty,mBC-0716-2
"G1,D6",12724,13400,9537,3863,6568,3,3185,3193,2223,970,2.291752577,1613,920,515,346,0,346,0,177,0,0.037572254,empty,mBC-0716-2
"G1,D7",12617,12680,9658,3022,6310,0,2844,2849,2028,821,2.470158343,1284,1131,687,413,0,413,0,167,0,0.03874092,empty,mBC-0716-2
"G1,D8",16016,16869,12176,4693,8164,26,3804,3848,2636,1212,2.174917492,1892,1070,566,289,0,289,0,147,0,0.01384083,empty,mBC-0716-2
"G1,D9",5521,5653,4088,1565,2798,1,1320,1321,955,366,2.609289617,629,1116,683,429,0,429,0,222,0,0.025641026,empty,mBC-0716-2
"G1,D10",839563,913759,604317,309442,444757,0,241195,241564,184166,57398,3.208578696,131219,48227,30367,17006,5,17001,1,2290,0,0.001058761,mm10,mBC-0716-2
"G1,D11",12957,12844,9865,2979,6454,0,2912,2925,2054,871,2.358208955,1323,1142,723,443,0,443,0,208,0,0.042889391,empty,mBC-0716-2
"G1,D12",660150,692952,501229,191723,341436,18,158088,158428,136163,22265,6.115562542,79702,81008,52956,29452,17,29435,1,3244,0,0.003499236,mm10,mBC-0716-2
"G1,E1",21722,22035,16686,5349,10911,1,4943,4957,3485,1472,2.367527174,2340,1774,870,544,0,544,0,250,0,0.014705882,empty,mBC-0716-2
"G1,E2",409039,408183,309094,99089,203768,6,90123,90320,70809,19511,3.629183537,43104,6081,3900,2113,1,2112,1,625,0,0.019412879,mm10,mBC-0716-2
"G1,E3",12134,12565,9259,3306,6043,5,2758,2763,1945,818,2.377750611,1298,1637,1019,613,0,613,0,236,0,0.055464927,empty,mBC-0716-2
"G1,E4",706634,822956,425141,397815,403797,1,284938,285285,101644,183641,0.553492956,179160,10051,5837,2968,2,2966,1,841,0,0.016520566,empty,mBC-0716-2
"G1,E5",21728,22413,16616,5797,10829,0,4923,4938,3485,1453,2.398485891,2326,1098,666,439,1,438,1,207,0,0.029680365,empty,mBC-0716-2
"G1,E6",831295,889460,593457,296003,428566,1,233060,233437,189570,43867,4.321471721,123974,92770,60693,33743,9,33734,1,3280,0,0.001185747,mm10,mBC-0716-2
"G1,E7",14012,14108,10408,3700,6945,1,3219,3235,2178,1057,2.060548723,1554,1846,873,546,0,546,0,216,0,0.067765568,empty,mBC-0716-2
"G1,E8",17461,17872,13303,4569,8835,1,4013,4018,2881,1137,2.533861038,1885,2311,1182,691,0,691,0,240,0,0.034732272,empty,mBC-0716-2
"G1,E9",8954,9190,6641,2549,4547,0,2170,2173,1507,666,2.262762763,1103,10462,3304,2032,0,2032,0,516,0,0.153051181,empty,mBC-0716-2
"G1,E10",621900,673407,462985,210422,333162,7,168580,168853,127126,41727,3.046612505,88463,100484,67809,37524,8,37516,1,3469,0,0.002079113,mm10,mBC-0716-2
"G1,E11",8976,9260,6925,2335,4629,0,2108,2114,1469,645,2.27751938,969,641,384,251,0,251,0,124,0,0.019920319,empty,mBC-0716-2
"G1,E12",14516,15147,10836,4311,7536,14,3580,3604,2523,1081,2.333950046,1806,809,454,285,0,285,0,135,0,0.01754386,empty,mBC-0716-2
"G1,F1",17820,18357,13565,4792,8961,0,4083,4090,2833,1257,2.253778839,1886,1061,648,460,0,460,0,204,0,0.05,empty,mBC-0716-2
"G1,F2",22280,22531,16759,5772,11198,6,5077,5095,3600,1495,2.408026756,2425,2458,1441,871,0,871,0,340,0,0.041331803,empty,mBC-0716-2
"G1,F3",895726,970087,649944,320143,471845,1,248756,249126,210343,38783,5.423587654,133389,88199,55607,31647,15,31632,3,3217,0,0.00480526,mm10,mBC-0716-2
"G1,F4",15428,15657,11713,3944,7936,3,3614,3626,2560,1066,2.401500938,1753,405,267,138,0,138,0,65,0,0.072463768,empty,mBC-0716-2
"G1,F5",908409,951413,681130,270283,457515,2,219509,219923,181888,38035,4.78212173,110496,59039,37383,20732,9,20723,4,2614,0,0.001254645,mm10,mBC-0716-2
"G1,F6",24013,24731,18103,6628,12009,16,5544,5566,3922,1644,2.385644769,2677,2198,1258,718,1,717,1,261,0,0.009762901,empty,mBC-0716-2
"G1,F7",19790,20023,15263,4760,10012,0,4396,4404,3069,1335,2.298876404,2009,700,407,236,0,236,0,115,0,0.016949153,empty,mBC-0716-2
"G1,F8",22241,22803,16789,6014,11339,0,5245,5270,3715,1555,2.389067524,2507,285,168,106,0,106,0,75,0,0,empty,mBC-0716-2
"G1,F9",15120,15525,11659,3866,7559,0,3402,3415,2361,1054,2.240037951,1589,1234,712,423,0,423,0,182,0,0.085106383,empty,mBC-0716-2
"G1,F10",21115,21656,16221,5435,10553,14,4689,4712,3294,1418,2.322990127,2253,8546,2697,1590,2,1588,2,434,0,0.079974811,empty,mBC-0716-2
"G1,F11",10973,11268,8430,2838,5656,4,2544,2552,1817,735,2.472108844,1233,836,489,321,1,320,1,155,0,0.021875,empty,mBC-0716-2
"G1,F12",14718,15353,11255,4098,7298,5,3399,3412,2410,1002,2.405189621,1646,161,103,50,0,50,0,31,0,0.1,empty,mBC-0716-2
"G1,G1",10143,10518,7853,2665,5246,0,2311,2320,1577,743,2.122476447,1063,1261,764,482,1,481,1,169,0,0.081081081,empty,mBC-0716-2
"G1,G2",1942766,2097090,1390759,706331,1002369,2,562685,563537,421761,141776,2.974840594,302871,22886,14571,8292,2,8290,1,1507,0,0.000844391,mm10,mBC-0716-2
"G1,G3",22126,23132,16568,6564,11130,0,5127,5136,3601,1535,2.345928339,2554,10301,3271,1896,1,1895,1,532,0,0.074934037,empty,mBC-0716-2
"G1,G4",28278,28760,21816,6944,14069,8,6207,6233,4412,1821,2.422844591,2901,131,82,59,0,59,0,45,0,0.033898305,empty,mBC-0716-2
"G1,G5",14153,14388,10345,4043,6937,0,3293,3300,2319,981,2.363914373,1611,10728,3547,2175,5,2170,2,691,0,0.074654378,empty,mBC-0716-2
"G1,G6",24836,25404,19242,6162,12159,4,5238,5255,3689,1566,2.355683269,2390,339,167,110,0,110,0,59,0,0.036363636,empty,mBC-0716-2
"G1,G7",20327,20684,15711,4973,10238,0,4558,4571,3233,1338,2.416292975,2069,1335,789,496,0,496,0,206,0,0.054435484,empty,mBC-0716-2
"G1,G8",15160,15778,11586,4192,7540,0,3423,3432,2411,1021,2.361410382,1637,1271,753,432,0,432,0,202,0,0.025462963,empty,mBC-0716-2
"G1,G9",630588,668686,480378,188308,328357,0,155060,155309,121751,33558,3.628076763,78023,64736,43040,24643,14,24629,3,2723,0,0.000812051,mm10,mBC-0716-2
"G1,G10",13383,13444,10282,3162,6653,15,2946,2961,2090,871,2.399540758,1303,1115,720,431,0,431,0,198,0,0.032482599,empty,mBC-0716-2
"G1,G11",233895,244865,176306,68559,120018,16,58119,58233,46521,11712,3.972079918,28930,12235,8125,4401,1,4400,1,886,0,0.001590909,mm10,mBC-0716-2
"G1,G12",1315575,1398289,969564,428725,689285,1,355011,355565,285465,70100,4.072253923,185214,128366,82686,46762,20,46742,3,3959,0,0.001198066,mm10,mBC-0716-2
"G1,H1",20476,20900,15840,5060,10297,0,4552,4567,3255,1312,2.480945122,2072,593,343,215,0,215,0,113,0,0,empty,mBC-0716-2
"G1,H2",24262,24665,18534,6131,12038,49,5326,5395,3841,1554,2.471685972,2520,1528,948,567,0,567,0,255,0,0.02292769,empty,mBC-0716-2
"G1,H3",19445,20077,14502,5575,9790,4,4580,4597,3185,1412,2.255665722,2212,1066,622,392,0,392,0,200,0,0.035714286,empty,mBC-0716-2
"G1,H4",13532,13913,10282,3631,6804,0,3124,3129,2165,964,2.245850622,1507,187,108,78,0,78,0,61,0,0,empty,mBC-0716-2
"G1,H5",17951,18223,13498,4725,9034,3,4142,4150,2878,1272,2.262578616,2008,4790,1691,1025,0,1025,0,333,0,0.148292683,empty,mBC-0716-2
"G1,H6",14089,14507,10664,3843,7160,0,3342,3356,2372,984,2.410569106,1595,1145,720,449,0,449,0,199,0,0.017817372,empty,mBC-0716-2
"G1,H7",878759,934768,649107,285661,455711,19,231225,231643,190522,41121,4.633204445,119612,76936,48325,26768,8,26760,2,2902,0,0.002204783,mm10,mBC-0716-2
"G1,H8",12949,13448,9734,3714,6787,0,3189,3196,2209,987,2.238095238,1590,1571,849,552,0,552,0,230,0,0.06884058,empty,mBC-0716-2
"G1,H9",15441,15737,11772,3965,7872,0,3565,3574,2499,1075,2.324651163,1697,1028,585,419,0,419,0,209,0,0.100238663,empty,mBC-0716-2
"G1,H10",14578,15149,10784,4365,7353,0,3457,3468,2424,1044,2.32183908,1743,11879,3519,2165,1,2164,1,633,0,0.043438078,empty,mBC-0716-2
"G1,H11",1220486,1313845,891284,422561,641650,1,336087,336656,273974,62682,4.370856067,179627,3557,2033,1192,1,1191,1,366,0,0.011754828,mm10,mBC-0716-2
"G1,H12",6014,6098,4501,1597,3000,0,1381,1384,958,426,2.248826291,644,451,252,161,0,161,0,89,0,0.055900621,empty,mBC-0716-2
"G2,A1",12588,12992,9484,3508,6532,3,3021,3032,2094,938,2.232409382,1466,1102,656,400,1,399,1,200,0,0.027568922,empty,mBC-0716-2
"G2,A2",17863,18088,13457,4631,8711,0,3883,3898,2763,1135,2.434361233,1896,12932,3974,2389,1,2388,1,620,0,0.16959799,empty,mBC-0716-2
"G2,A3",15325,15743,11455,4288,7573,0,3427,3432,2452,980,2.502040816,1674,1027,650,422,1,421,1,179,0,0.03087886,empty,mBC-0716-2
"G2,A4",20506,21141,15815,5326,10119,0,4506,4511,3208,1303,2.462010744,2144,1161,505,330,0,330,0,176,0,0.009090909,empty,mBC-0716-2
"G2,A5",16250,16888,12289,4599,8151,1,3741,3750,2592,1158,2.238341969,1795,1591,956,583,1,582,1,271,0,0.032646048,empty,mBC-0716-2
"G2,A6",12192,12809,9215,3594,6086,3,2882,2893,2019,874,2.31006865,1400,3704,1462,946,0,946,0,384,0,0.048625793,empty,mBC-0716-2
"G2,A7",15306,15731,11629,4102,7714,0,3511,3520,2447,1073,2.280521901,1659,1100,631,357,0,357,0,192,0,0.042016807,empty,mBC-0716-2
"G2,A8",10230,10541,7804,2737,5104,2,2300,2311,1607,704,2.282670455,1056,1494,885,580,0,580,0,231,0,0.082758621,empty,mBC-0716-2
"G2,A9",3144555,3339629,2300252,1039377,1513186,5,809915,811181,691721,119460,5.79039846,420179,342718,217893,121628,47,121581,7,6335,0,0.002204292,mm10,mBC-0716-2
"G2,A10",14374,14698,11012,3686,7254,0,3333,3340,2354,986,2.387423935,1609,628,379,241,0,241,0,128,0,0.008298755,empty,mBC-0716-2
"G2,A11",16417,16607,12545,4062,8129,5,3635,3659,2495,1164,2.14347079,1707,2020,977,580,1,579,1,246,0,0.005181347,empty,mBC-0716-2
"G2,A12",934123,1065697,626105,439592,510479,1,329789,330197,234522,95675,2.451235955,190694,50150,29724,16723,10,16713,3,2398,0,0.006940705,mm10,mBC-0716-2
"G2,B1",18545,18794,14159,4635,9096,0,4171,4184,2946,1238,2.379644588,1964,1287,699,453,1,452,1,229,0,0.013274336,empty,mBC-0716-2
"G2,B2",999745,1078702,729585,349117,514701,1,270966,271374,229962,41412,5.553028108,143075,44687,26519,14923,10,14913,2,2016,0,0.0006035,mm10,mBC-0716-2
"G2,B3",796218,831893,597178,234715,402972,1,201181,201549,161492,40057,4.031555034,100961,8457,5028,2928,1,2927,1,754,0,0.005466348,mm10,mBC-0716-2
"G2,B4",15688,16131,11986,4145,7791,0,3538,3548,2527,1021,2.475024486,1748,1121,664,407,0,407,0,171,0,0.068796069,empty,mBC-0716-2
"G2,B5",8546,5011,3427,1584,3193,0,1551,1562,1104,458,2.410480349,887,797,470,318,0,318,0,133,0,0.018867925,empty,mBC-0716-2
"G2,B6",11663,11851,8815,3036,5932,0,2849,2854,1971,883,2.23216308,1316,1197,688,458,0,458,0,223,0,0.026200873,empty,mBC-0716-2
"G2,B7",15854,16201,12214,3987,7912,0,3574,3594,2559,1035,2.472463768,1643,2414,1077,652,1,651,1,241,0,0.078341014,empty,mBC-0716-2
"G2,B8",14903,15407,11512,3895,7529,6,3430,3439,2519,920,2.738043478,1584,1785,1091,712,0,712,0,301,0,0.032303371,empty,mBC-0716-2
"G2,B9",14786,15263,11326,3937,7281,3,3327,3337,2304,1033,2.230396902,1628,899,478,301,0,301,0,166,0,0.023255814,empty,mBC-0716-2
"G2,B10",15593,15517,11626,3891,7787,0,3615,3628,2528,1100,2.298181818,1649,649,361,218,0,218,0,123,0,0.032110092,empty,mBC-0716-2
"G2,B11",16130,16506,12230,4276,8173,2,3767,3785,2698,1087,2.482060718,1839,341,207,150,0,150,0,96,0,0.013333333,empty,mBC-0716-2
"G2,B12",882158,936770,647788,288982,453241,4,234309,234684,192721,41963,4.592641136,121405,73024,46777,25818,13,25805,2,2802,0,0.001976361,mm10,mBC-0716-2
"G2,C1",21939,22429,17035,5394,10669,32,4536,4578,3186,1392,2.288793103,2122,1012,494,325,0,325,0,159,0,0.030769231,empty,mBC-0716-2
"G2,C2",17608,17910,13349,4561,8597,8,4024,4042,2808,1234,2.275526742,1935,11294,3570,2110,0,2110,0,582,0,0.039810427,empty,mBC-0716-2
"G2,C3",18983,19599,14285,5314,9501,2,4420,4430,3014,1416,2.128531073,2154,638,369,211,0,211,0,108,0,0.004739336,empty,mBC-0716-2
"G2,C4",15843,15735,12126,3609,7736,0,3357,3368,2333,1035,2.25410628,1540,1106,641,404,0,404,0,183,0,0.034653465,empty,mBC-0716-2
"G2,C5",20132,20898,14993,5905,10370,0,4959,4974,3644,1330,2.739849624,2450,1390,812,513,0,513,0,254,0,0.029239766,empty,mBC-0716-2
"G2,C6",16480,17074,12304,4770,8380,0,3981,3989,2811,1178,2.386247878,1951,1521,881,551,0,551,0,239,0,0.041742287,empty,mBC-0716-2
"G2,C7",807584,869481,589554,279927,419546,18,219419,219806,176852,42954,4.1172417,117108,8735,5498,3040,2,3038,1,681,0,0.003949967,mm10,mBC-0716-2
"G2,C8",14110,14455,10487,3968,7099,31,3276,3312,2257,1055,2.139336493,1653,18303,5470,3273,4,3269,1,848,0,0.035484858,empty,mBC-0716-2
"G2,C9",12230,12902,9253,3649,6132,0,2804,2806,1908,898,2.124721604,1332,1967,740,452,0,452,0,218,0,0.042035398,empty,mBC-0716-2
"G2,C10",13018,13616,9969,3647,6617,38,3067,3111,2120,991,2.13925328,1461,1179,711,429,0,429,0,193,0,0.044289044,empty,mBC-0716-2
"G2,C11",725682,814697,520006,294691,397774,0,228107,228383,164072,64311,2.551227628,126333,57685,37017,21188,8,21180,2,2229,0,0.001369216,mm10,mBC-0716-2
"G2,C12",20204,20738,15315,5423,9894,18,4583,4622,3288,1334,2.464767616,2207,1108,660,391,1,390,1,170,0,0.023076923,empty,mBC-0716-2
"G2,D1",1812851,1900785,1323336,577449,910370,6,469635,470420,377540,92880,4.064814815,244581,107736,66932,37298,18,37280,3,3602,0,0.00193133,mm10,mBC-0716-2
"G2,D2",20400,20844,15839,5005,10131,5,4445,4463,3174,1289,2.462373933,2064,3067,1829,1093,0,1093,0,411,0,0.033851784,empty,mBC-0716-2
"G2,D3",12364,13012,9214,3798,6413,0,3055,3063,2082,981,2.122324159,1532,1338,850,518,0,518,0,251,0,0.027027027,empty,mBC-0716-2
"G2,D4",13215,13905,10097,3808,6718,0,3127,3134,2178,956,2.278242678,1498,1616,999,652,1,651,1,316,0,0.01843318,empty,mBC-0716-2
"G2,D5",12489,13027,9523,3504,6278,7,2919,2934,2101,833,2.522208884,1371,7616,2574,1533,1,1532,1,459,0,0.079634465,empty,mBC-0716-2
"G2,D6",1662217,1830868,1183012,647856,881308,14,501252,502050,399938,102112,3.916660138,277047,161512,104294,57958,25,57933,2,4618,0,0.000863066,mm10,mBC-0716-2
"G2,D7",896365,939587,674365,265222,457181,1,209145,209518,172690,36828,4.689095254,112280,117648,73242,40927,17,40910,2,3592,0,0.002322171,mm10,mBC-0716-2
"G2,D8",17019,17779,12854,4925,8576,4,4080,4091,2863,1228,2.331433225,1995,1118,634,434,0,434,0,220,0,0.006912442,empty,mBC-0716-2
"G2,D9",4109,4132,3058,1074,2154,0,979,984,711,273,2.604395604,464,1806,1050,649,0,649,0,322,0,0.023112481,empty,mBC-0716-2
"G2,D10",15431,16326,11523,4803,7892,1,3775,3785,2705,1080,2.50462963,1936,843,440,257,1,256,1,126,0,0.05859375,empty,mBC-0716-2
"G2,D11",12730,13060,9542,3518,6275,0,2889,2895,2048,847,2.417945691,1376,9676,4291,2632,0,2632,0,714,0,0.170592705,empty,mBC-0716-2
"G2,D12",18865,19517,14388,5129,9444,0,4286,4299,2995,1304,2.296779141,2065,2432,1409,865,0,865,0,327,0,0.023121387,empty,mBC-0716-2
"G2,E1",954642,1019274,694574,324700,488904,3,256104,256484,215900,40584,5.319830475,134355,99246,62978,34996,15,34981,2,3432,0,0.007232498,mm10,mBC-0716-2
"G2,E2",14998,15304,11449,3855,7448,2,3334,3345,2320,1025,2.263414634,1591,1533,888,528,0,528,0,235,0,0.043560606,empty,mBC-0716-2
"G2,E3",11543,11968,8755,3213,5876,0,2703,2708,1831,877,2.087799316,1305,1937,1215,730,1,729,1,317,0,0.004115226,empty,mBC-0716-2
"G2,E4",1974917,2108742,1453517,655225,977282,6,508305,509180,431690,77490,5.570912376,264025,319386,194769,109379,46,109333,6,6047,0,0.002213421,mm10,mBC-0716-2
"G2,E5",20497,21244,15794,5450,10469,13,4837,4861,3396,1465,2.318088737,2343,1652,949,617,0,617,0,300,0,0.022690438,empty,mBC-0716-2
"G2,E6",12679,13224,9604,3620,6471,54,2935,2999,2086,913,2.284775465,1437,2047,1162,711,0,711,0,316,0,0.075949367,empty,mBC-0716-2
"G2,E7",13091,13451,10157,3294,6494,6,2894,2911,2088,823,2.537059538,1301,1187,744,482,0,482,0,231,0,0.031120332,empty,mBC-0716-2
"G2,E8",997138,1075846,709077,366769,517891,7,286578,286997,229159,57838,3.962083751,155007,105818,61337,34717,22,34695,4,3375,0,0.011701974,mm10,mBC-0716-2
"G2,E9",8189,8303,6378,1925,4094,0,1865,1867,1297,570,2.275438596,832,1118,690,423,0,423,0,196,0,0.040189125,empty,mBC-0716-2
"G2,E10",12436,12803,9472,3331,6303,0,2880,2889,2006,883,2.27180068,1390,1421,792,494,0,494,0,223,0,0.020242915,empty,mBC-0716-2
"G2,E11",8560,8962,6473,2489,4431,5,2029,2042,1438,604,2.380794702,973,1075,628,373,1,372,1,190,0,0.010752688,empty,mBC-0716-2
"G2,E12",14668,15072,11226,3846,7392,0,3440,3449,2435,1014,2.401380671,1607,1275,747,433,0,433,0,168,0,0.032332564,empty,mBC-0716-2
"G2,F1",17405,17742,13493,4249,8612,0,3891,3902,2631,1271,2.070023603,1781,2503,1220,785,0,785,0,315,0,0.045859873,empty,mBC-0716-2
"G2,F2",21677,22289,16483,5806,10832,0,5107,5122,3575,1547,2.31092437,2406,3105,1935,1253,0,1253,0,508,0,0.046288907,empty,mBC-0716-2
"G2,F3",15171,15558,11420,4138,7709,0,3575,3579,2483,1096,2.265510949,1715,1929,1132,676,0,676,0,346,0,0.031065089,empty,mBC-0716-2
"G2,F4",733012,773510,514502,259008,382687,6,207217,207556,177954,29602,6.011553273,111628,37506,24288,13442,7,13435,2,1874,0,0.000744325,mm10,mBC-0716-2
"G2,F5",1048530,1143523,732348,411175,543386,32,310541,311030,264151,46879,5.634740502,170900,104403,66898,37471,21,37450,3,3569,0,0.001121495,mm10,mBC-0716-2
"G2,F6",776093,856719,540321,316398,416059,2,240525,240893,199976,40917,4.887357333,134303,90215,56513,31564,10,31554,1,3335,0,0.001711352,mm10,mBC-0716-2
"G2,F7",19310,20137,14805,5332,9686,26,4292,4328,3078,1250,2.4624,2095,914,529,332,0,332,0,177,0,0.018072289,empty,mBC-0716-2
"G2,F8",703247,749339,527254,222085,362325,0,173871,174187,150424,23763,6.330177166,89183,13729,8796,4727,0,4727,0,960,0,0.001480855,mm10,mBC-0716-2
"G2,F9",13823,14259,10630,3629,6997,3,3152,3162,2219,943,2.353128314,1545,1505,822,541,0,541,0,211,0,0.077634011,empty,mBC-0716-2
"G2,F10",19986,20208,15294,4914,9887,58,4322,4386,3052,1334,2.287856072,2051,1209,772,489,0,489,0,233,0,0.036809816,empty,mBC-0716-2
"G2,F11",818404,870880,601446,269434,419190,14,212582,212954,181515,31439,5.7735615,110122,130566,83411,46387,19,46368,3,3885,0,0.001250863,mm10,mBC-0716-2
"G2,F12",13623,13912,10174,3738,6875,0,3243,3251,2334,917,2.54525627,1573,280,179,114,0,114,0,58,0,0,empty,mBC-0716-2
"G2,G1",398586,402471,311287,91184,197998,32,83361,83566,66186,17380,3.808170311,38314,28492,16285,9186,5,9181,1,1741,0,0.005772792,mm10,mBC-0716-2
"G2,G2",20632,21236,15895,5341,10031,0,4489,4493,3137,1356,2.313421829,2093,2044,897,569,0,569,0,254,0,0.019332162,empty,mBC-0716-2
"G2,G3",21098,21535,15855,5680,10479,1,4921,4930,3554,1376,2.582848837,2418,6153,2280,1432,0,1432,0,501,0,0.032122905,empty,mBC-0716-2
"G2,G4",27997,28284,21215,7069,13522,20,5962,5990,4320,1670,2.586826347,2786,425,182,118,0,118,0,83,0,0.033898305,empty,mBC-0716-2
"G2,G5",13209,13374,9916,3458,6487,0,3108,3113,2190,923,2.372697725,1505,1265,714,486,0,486,0,245,0,0.04526749,empty,mBC-0716-2
"G2,G6",23924,24266,18334,5932,11610,16,5158,5179,3774,1405,2.686120996,2402,1252,438,276,0,276,0,131,0,0.018115942,empty,mBC-0716-2
"G2,G7",19568,20048,15149,4899,9729,11,4324,4341,3070,1271,2.415420928,2012,1823,1065,670,0,670,0,297,0,0.055223881,empty,mBC-0716-2
"G2,G8",14480,15182,10829,4353,7407,11,3538,3555,2441,1114,2.191202873,1749,1757,952,608,0,608,0,292,0,0.026315789,empty,mBC-0716-2
"G2,G9",10096,10567,7626,2941,5118,0,2389,2392,1662,730,2.276712329,1177,1391,856,557,1,556,1,291,0,0.053956835,empty,mBC-0716-2
"G2,G10",13123,13442,10131,3311,6330,3,2851,2858,1965,893,2.200447928,1277,1488,906,588,0,588,0,280,0,0.028911565,empty,mBC-0716-2
"G2,G11",12935,13391,9785,3606,6350,0,2923,2934,2127,807,2.635687732,1397,1620,740,462,2,460,1,179,0,0.05,empty,mBC-0716-2
"G2,G12",10661,10998,8119,2879,5405,0,2493,2497,1674,823,2.034021871,1196,1300,714,414,1,413,1,157,0,0.055690073,empty,mBC-0716-2
"G2,H1",626088,658645,468377,190268,324187,1,164034,164322,128195,36127,3.548454065,83484,7528,3813,2279,1,2278,1,647,0,0.022827041,mm10,mBC-0716-2
"G2,H2",26264,26573,19920,6653,12939,71,5827,5910,4280,1630,2.625766871,2786,2178,1304,854,0,854,0,354,0,0.022248244,empty,mBC-0716-2
"G2,H3",19236,20191,14437,5754,9931,8,4701,4714,3311,1403,2.359942979,2386,1721,992,627,0,627,0,275,0,0.036682616,empty,mBC-0716-2
"G2,H4",12796,13302,9659,3643,6478,0,3014,3028,2099,929,2.25941873,1502,364,242,172,0,172,0,112,0,0.058139535,empty,mBC-0716-2
"G2,H5",17120,17295,12886,4409,8291,24,3778,3810,2668,1142,2.336252189,1791,1663,1013,639,0,639,0,269,0,0.053208138,empty,mBC-0716-2
"G2,H6",770488,831420,544929,286491,404152,0,224148,224478,185878,38600,4.815492228,121150,51782,30944,17042,6,17036,3,2448,0,0.005165532,mm10,mBC-0716-2
"G2,H7",16131,16453,11970,4483,8142,13,3816,3836,2685,1151,2.332754127,1831,1847,1014,647,0,647,0,281,0,0.060278207,empty,mBC-0716-2
"G2,H8",12785,13255,9686,3569,6460,1,3106,3109,2238,871,2.56946039,1549,1849,1141,660,1,659,1,298,0,0.019726859,empty,mBC-0716-2
"G2,H9",765812,801989,564033,237956,389437,2,193499,193801,164445,29356,5.60175092,99563,90582,52085,29549,20,29529,4,3159,0,0.010498154,mm10,mBC-0716-2
"G2,H10",13377,13962,9945,4017,6772,4,3209,3219,2277,942,2.417197452,1654,3532,1492,942,1,941,1,365,0,0.038257173,empty,mBC-0716-2
"G2,H11",749815,852955,522723,330232,416126,22,247588,247968,176711,71257,2.479910746,143006,2693,1693,977,0,977,0,298,0,0.001023541,empty,mBC-0716-2
"G2,H12",5649,5813,4225,1588,2886,0,1356,1359,960,399,2.406015038,696,681,412,252,0,252,0,116,0,0.123015873,empty,mBC-0716-2
"G3,A1",778802,897954,508931,389023,446832,0,289435,289742,184995,104747,1.766112633,176472,8743,5560,2948,3,2945,1,706,0,0.00237691,mm10,mBC-0716-2
"G3,A2",18950,18729,14245,4484,9217,0,4086,4094,2886,1208,2.389072848,1840,1392,702,423,0,423,0,183,0,0.028368794,empty,mBC-0716-2
"G3,A3",535103,569363,393103,176260,285632,10,149116,149397,118740,30657,3.873177415,77969,4474,2807,1570,1,1569,1,441,0,0.009560229,mm10,mBC-0716-2
"G3,A4",2060226,2177482,1524741,652741,1016278,33,531675,532515,407823,124692,3.270642864,275879,21625,13921,7680,4,7676,2,1382,0,0.001563314,mm10,mBC-0716-2
"G3,A5",17555,18077,13143,4934,9104,0,4223,4232,2940,1292,2.275541796,2087,1281,787,508,1,507,1,216,0,0.033530572,empty,mBC-0716-2
"G3,A6",13453,13935,10128,3807,7002,1,3257,3266,2339,927,2.523193096,1572,1417,874,521,0,521,0,236,0,0.040307102,empty,mBC-0716-2
"G3,A7",16729,17059,12598,4461,8370,0,3776,3793,2600,1193,2.179379715,1830,6049,2043,1169,0,1169,0,380,0,0.027373824,empty,mBC-0716-2
"G3,A8",10528,10849,8001,2848,5378,0,2437,2445,1706,739,2.308525034,1180,1121,668,397,0,397,0,172,0,0.025188917,empty,mBC-0716-2
"G3,A9",19007,19280,14620,4660,9302,2,4187,4194,2891,1303,2.218726017,1938,1192,733,437,0,437,0,183,0,0.032036613,empty,mBC-0716-2
"G3,A10",1576438,1675576,1156135,519441,802781,0,420095,420795,339749,81046,4.192051428,218759,34676,22196,12223,9,12214,1,1754,0,0.000982479,mm10,mBC-0716-2
"G3,A11",18120,18093,13798,4295,8954,1,4001,4014,2801,1213,2.309150866,1796,1103,655,400,0,400,0,170,0,0.0675,empty,mBC-0716-2
"G3,A12",20778,21301,15963,5338,10169,1,4457,4470,3137,1333,2.353338335,2090,2002,1106,655,1,654,1,224,0,0.055045872,empty,mBC-0716-2
"G3,B1",697070,740348,516159,224189,356337,7,185181,185482,145065,40417,3.589207512,95100,25053,16691,9287,2,9285,1,1523,0,0.001400108,mm10,mBC-0716-2
"G3,B2",20936,21407,15924,5483,10671,0,4897,4906,3415,1491,2.290409121,2333,364,196,124,0,124,0,67,0,0.016129032,empty,mBC-0716-2
"G3,B3",19740,20164,15037,5127,9971,1,4580,4591,3250,1341,2.423564504,2155,1254,778,449,0,449,0,185,0,0,empty,mBC-0716-2
"G3,B4",16902,17551,12777,4774,8570,18,3983,4006,2850,1156,2.465397924,1922,2905,1075,662,1,661,1,235,0,0.033282905,empty,mBC-0716-2
"G3,B5",17203,14538,9146,5392,8142,44,4508,4587,3373,1214,2.778418451,2624,724,409,225,0,225,0,111,0,0.004444444,empty,mBC-0716-2
"G3,B6",12967,13385,9768,3617,6801,1,3192,3198,2210,988,2.236842105,1550,1358,732,438,0,438,0,212,0,0.02283105,empty,mBC-0716-2
"G3,B7",17202,17824,13113,4711,8894,16,4051,4077,2911,1166,2.496569468,1972,3979,1356,820,1,819,1,264,0,0.026862027,empty,mBC-0716-2
"G3,B8",13519,14303,10336,3967,6988,0,3162,3175,2271,904,2.512168142,1537,1356,688,410,1,409,1,177,0,0.114914425,empty,mBC-0716-2
"G3,B9",15495,15662,11797,3865,7536,13,3354,3370,2339,1031,2.268671193,1550,3177,1150,644,0,644,0,260,0,0.045031056,empty,mBC-0716-2
"G3,B10",17081,17138,12409,4729,8617,3,4032,4043,2752,1291,2.131680868,2011,2702,828,499,1,498,1,170,0,0.002008032,empty,mBC-0716-2
"G3,B11",1091455,1159812,783601,376211,549569,0,294465,294993,248305,46688,5.318390164,155785,9816,6137,3405,2,3403,1,765,0,0.000881575,mm10,mBC-0716-2
"G3,B12",18479,19085,14139,4946,9277,10,4229,4252,2988,1264,2.363924051,1995,1057,617,404,1,403,1,157,0,0.044665012,empty,mBC-0716-2
"G3,C1",23061,23431,17777,5654,11293,0,4799,4810,3433,1377,2.493100944,2217,804,460,284,0,284,0,130,0,0.091549296,empty,mBC-0716-2
"G3,C2",18396,18538,13885,4653,9008,0,4066,4076,2863,1213,2.360263809,1924,1849,910,521,0,521,0,196,0,0.063339731,empty,mBC-0716-2
"G3,C3",844227,891024,612558,278466,433438,33,229341,229818,177866,51952,3.423660302,121066,9016,5539,3048,3,3045,1,744,0,0.00591133,mm10,mBC-0716-2
"G3,C4",17633,18174,13394,4780,8786,0,3931,3938,2760,1178,2.34295416,1861,1038,573,349,0,349,0,138,0,0.05730659,empty,mBC-0716-2
"G3,C5",945537,1003209,684068,319141,485288,6,251242,251735,208824,42911,4.866444501,132318,83160,53482,29727,14,29713,1,3147,0,0.000706761,mm10,mBC-0716-2
"G3,C6",16942,17425,12723,4702,8696,7,4083,4099,2959,1140,2.595614035,1950,1106,693,414,0,414,0,184,0,0.028985507,empty,mBC-0716-2
"G3,C7",16303,16763,12325,4438,8210,13,3732,3755,2657,1098,2.419854281,1833,345,205,126,0,126,0,70,0,0.055555556,empty,mBC-0716-2
"G3,C8",783262,819902,590515,229387,401809,0,192751,193041,151564,41477,3.654169781,96715,82304,49268,27587,16,27571,4,2970,0,0.004352399,mm10,mBC-0716-2
"G3,C9",1164501,1318308,783225,535083,632746,2,392872,393425,300399,93026,3.229193989,228617,46440,29130,16106,4,16102,1,2164,0,0.000931561,mm10,mBC-0716-2
"G3,C10",963904,1095487,653881,441606,531160,0,327618,328022,255571,72451,3.527501346,188231,72121,45655,25305,7,25298,1,2759,0,0.002095027,mm10,mBC-0716-2
"G3,C11",12269,13095,9115,3980,6319,26,3010,3042,2091,951,2.19873817,1557,772,521,301,0,301,0,131,0,0.056478405,empty,mBC-0716-2
"G3,C12",941431,1054828,646430,408398,510575,1,315079,315497,241959,73538,3.290258098,179492,21012,7363,4189,7,4182,3,952,0,0.050215208,mm10,mBC-0716-2
"G3,D1",11299,11482,8566,2916,5685,0,2615,2615,1811,804,2.252487562,1195,607,367,213,0,213,0,98,0,0.042253521,empty,mBC-0716-2
"G3,D2",846516,894761,637450,257311,435877,1,219658,220063,159093,60970,2.609365262,111705,32374,21134,11637,5,11632,2,1842,0,0.003868638,mm10,mBC-0716-2
"G3,D3",13705,14321,10308,4013,6989,5,3334,3352,2348,1004,2.338645418,1683,1046,627,406,0,406,0,196,0,0.027093596,empty,mBC-0716-2
"G3,D4",18276,18953,13851,5102,9542,1,4516,4529,3174,1355,2.342435424,2227,1207,719,466,0,466,0,216,0,0.027896996,empty,mBC-0716-2
"G3,D5",13722,14130,10409,3721,6949,0,3209,3220,2219,1001,2.216783217,1533,1089,692,419,0,419,0,165,0,0.007159905,empty,mBC-0716-2
"G3,D6",12316,12858,9375,3483,6401,0,2992,2992,2115,877,2.411630559,1468,2510,1085,617,1,616,1,242,0,0.063311688,empty,mBC-0716-2
"G3,D7",801624,902728,532288,370440,439268,8,272312,272722,226023,46699,4.839996574,158255,116282,77832,42679,18,42661,4,3670,0,0.000796981,mm10,mBC-0716-2
"G3,D8",15929,16570,12075,4495,8050,18,3685,3713,2581,1132,2.280035336,1811,872,550,309,0,309,0,132,0,0.003236246,empty,mBC-0716-2
"G3,D9",4353,4447,3198,1249,2383,13,1106,1121,759,362,2.096685083,585,1231,752,454,0,454,0,208,0,0.037444934,empty,mBC-0716-2
"G3,D10",13741,14365,10230,4135,6905,0,3274,3284,2256,1028,2.194552529,1647,9706,2958,1764,0,1764,0,457,0,0.082199546,empty,mBC-0716-2
"G3,D11",14112,14174,10360,3814,7383,16,3456,3486,2499,987,2.531914894,1689,1426,873,519,0,519,0,225,0,0.007707129,empty,mBC-0716-2
"G3,D12",20772,21496,15659,5837,10498,7,4825,4844,3354,1490,2.251006711,2377,2363,1322,766,0,766,0,269,0,0.028720627,empty,mBC-0716-2
"G3,E1",22113,22464,16854,5610,11029,21,4973,5000,3566,1434,2.486750349,2339,1256,721,439,0,439,0,221,0,0.027334852,empty,mBC-0716-2
"G3,E2",653758,727008,447860,279148,361732,0,219350,219637,173918,45719,3.804063956,124372,28778,12310,7133,0,7133,0,1388,0,0.159820552,mm10,mBC-0716-2
"G3,E3",13071,13207,9923,3284,6437,0,2896,2909,2013,896,2.246651786,1359,1535,908,541,0,541,0,222,0,0.038817006,empty,mBC-0716-2
"G3,E4",15752,16048,12109,3939,7841,0,3621,3630,2510,1120,2.241071429,1698,1015,586,362,0,362,0,153,0,0.038674033,empty,mBC-0716-2
"G3,E5",22250,22394,17042,5352,11061,0,4897,4918,3454,1464,2.359289617,2250,2154,1034,652,0,652,0,247,0,0.084355828,empty,mBC-0716-2
"G3,E6",15536,16308,11617,4691,7964,0,3794,3813,2670,1143,2.335958005,1895,1387,816,509,0,509,0,227,0,0.043222004,empty,mBC-0716-2
"G3,E7",13880,14545,10504,4041,7134,3,3385,3393,2387,1006,2.372763419,1645,1170,676,423,0,423,0,179,0,0.056737589,empty,mBC-0716-2
"G3,E8",17727,17808,13695,4113,8797,0,3754,3757,2681,1076,2.491635688,1749,1498,861,503,0,503,0,206,0,0.031809145,empty,mBC-0716-2
"G3,E9",9065,9300,6789,2511,4590,0,2150,2153,1471,682,2.156891496,1081,1129,632,357,0,357,0,155,0,0.078431373,empty,mBC-0716-2
"G3,E10",796785,830716,595715,235001,405438,6,203003,203419,158765,44654,3.55544856,102162,23477,11321,6553,1,6552,1,1326,0,0.039835165,mm10,mBC-0716-2
"G3,E11",9193,9527,6923,2604,4709,0,2189,2191,1511,680,2.222058824,1032,1008,616,376,0,376,0,156,0,0.063829787,empty,mBC-0716-2
"G3,E12",15314,15564,11642,3922,7817,4,3678,3684,2594,1090,2.379816514,1741,3219,1061,634,2,632,1,233,0,0.07278481,empty,mBC-0716-2
"G3,F1",18784,18815,14141,4674,9455,0,4309,4326,3002,1324,2.267371601,2022,5296,1732,1097,1,1096,1,357,0,0.050182482,empty,mBC-0716-2
"G3,F2",23799,25098,17743,7355,12348,3,5918,5937,4237,1700,2.492352941,2986,2293,1406,828,0,828,0,352,0,0.037439614,empty,mBC-0716-2
"G3,F3",979129,1103993,654343,449650,537404,4,336431,336891,278635,58256,4.782940813,194475,84843,53464,29708,10,29698,2,2970,0,0.001111186,mm10,mBC-0716-2
"G3,F4",16011,16402,12079,4323,8119,0,3655,3684,2493,1191,2.093198992,1800,449,237,153,2,151,2,72,0,0.01986755,empty,mBC-0716-2
"G3,F5",24868,25510,18947,6563,12451,10,5632,5657,3995,1662,2.403730445,2663,1396,830,527,0,527,0,247,0,0.030360531,empty,mBC-0716-2
"G3,F6",23233,23536,17562,5974,11396,47,5134,5191,3702,1489,2.486232371,2462,1963,1075,668,0,668,0,255,0,0.073353293,empty,mBC-0716-2
"G3,F7",930935,989921,694287,295634,483604,3,241623,242047,199736,42311,4.720663657,124017,31203,17942,10105,6,10099,2,1596,0,0.004257847,mm10,mBC-0716-2
"G3,F8",23009,23751,17437,6314,11570,1,5285,5302,3725,1577,2.362079899,2532,291,164,119,0,119,0,71,0,0,empty,mBC-0716-2
"G3,F9",14904,15238,11483,3755,7560,0,3319,3327,2316,1011,2.290801187,1571,1404,851,510,0,510,0,176,0,0.070588235,empty,mBC-0716-2
"G3,F10",21519,21962,16296,5666,10677,1,4790,4807,3424,1383,2.475777296,2258,2627,1349,858,0,858,0,250,0,0.278554779,empty,mBC-0716-2
"G3,F11",11631,11887,8827,3060,5891,1,2703,2707,1871,836,2.238038278,1293,895,558,356,0,356,0,172,0,0.014044944,empty,mBC-0716-2
"G3,F12",736502,782726,552779,229947,377627,1,187462,187779,154244,33535,4.599493067,95578,3555,2280,1286,0,1286,0,326,0,0,mm10,mBC-0716-2
"G3,G1",641141,706105,471070,235035,346367,0,182941,183263,155196,28067,5.529483023,97047,122644,78271,43507,16,43491,2,3886,0,0.001402589,mm10,mBC-0716-2
"G3,G2",21776,22374,16561,5813,10891,7,4843,4858,3435,1423,2.413914266,2392,602,367,240,0,240,0,136,0,0.016666667,empty,mBC-0716-2
"G3,G3",20109,20900,15105,5795,10221,0,4772,4781,3344,1437,2.327070285,2341,1915,1136,684,0,684,0,265,0,0.046783626,empty,mBC-0716-2
"G3,G4",30981,31470,23041,8429,15077,17,6818,6850,4841,2009,2.409656546,3312,470,191,123,0,123,0,64,0,0.048780488,empty,mBC-0716-2
"G3,G5",13890,14367,10561,3806,6942,2,3187,3197,2274,923,2.463705309,1581,883,480,319,0,319,0,179,0,0.031347962,empty,mBC-0716-2
"G3,G6",1410481,1549543,982376,567167,735930,1,434785,435441,322113,113328,2.842307285,241098,4374,2661,1553,1,1552,1,385,0,0.00128866,mm10,mBC-0716-2
"G3,G7",1777130,1934865,1284212,650653,930535,0,519506,520309,359021,161288,2.225962254,282445,116237,62164,35240,21,35219,4,3891,0,0.015531389,mm10,mBC-0716-2
"G3,G8",595775,616030,442166,173864,303300,0,150436,150698,119170,31528,3.779814768,76462,8305,5317,3060,1,3059,1,865,0,0.015691402,mm10,mBC-0716-2
"G3,G9",808476,909737,566908,342829,444990,0,262612,262987,205514,57473,3.57583561,147836,61364,38496,21632,10,21622,1,2559,0,0.001387476,mm10,mBC-0716-2
"G3,G10",14671,14643,10797,3846,7514,0,3558,3566,2556,1010,2.530693069,1712,1237,755,449,0,449,0,208,0,0.031180401,empty,mBC-0716-2
"G3,G11",12223,12296,9370,2926,6027,2,2660,2667,1863,804,2.317164179,1208,1622,702,396,0,396,0,166,0,0.053030303,empty,mBC-0716-2
"G3,G12",11242,11788,8373,3415,5893,0,2792,2794,1947,847,2.298701299,1399,947,558,338,0,338,0,159,0,0.023668639,empty,mBC-0716-2
"G3,H1",20443,21330,15609,5721,10453,11,4792,4813,3410,1403,2.430506058,2345,790,479,283,0,283,0,141,0,0.017667845,empty,mBC-0716-2
"G3,H2",33846,36135,25362,10773,17469,5,8648,8676,6102,2574,2.370629371,4392,1958,1119,646,0,646,0,297,0,0.034055728,empty,mBC-0716-2
"G3,H3",20561,21205,15459,5746,10090,34,4580,4619,3265,1354,2.411373708,2229,1516,856,523,0,523,0,206,0,0.108986616,empty,mBC-0716-2
"G3,H4",14003,14401,10525,3876,7098,2,3241,3256,2237,1019,2.1952895,1619,490,195,130,1,129,1,77,0,0.015503876,empty,mBC-0716-2
"G3,H5",22046,23299,16609,6690,11136,43,5252,5313,3734,1579,2.36478784,2639,1386,888,495,0,495,0,195,0,0.012121212,empty,mBC-0716-2
"G3,H6",733455,820354,489605,330749,405363,7,255072,255417,190779,64638,2.951499118,146135,43290,28480,16027,6,16021,1,2122,0,0.002746395,mm10,mBC-0716-2
"G3,H7",16632,16825,12566,4259,8423,0,3860,3868,2730,1138,2.398945518,1782,1146,689,405,0,405,0,188,0,0.051851852,empty,mBC-0716-2
"G3,H8",13684,13881,10321,3560,6913,0,3178,3194,2233,961,2.323621228,1546,1407,791,472,1,471,1,222,0,0.031847134,empty,mBC-0716-2
"G3,H9",15883,16008,11877,4131,7884,0,3551,3557,2542,1015,2.504433498,1713,1154,701,463,0,463,0,204,0,0.056155508,empty,mBC-0716-2
"G3,H10",13994,14632,10630,4002,7169,15,3297,3317,2296,1021,2.24877571,1654,1078,632,397,0,397,0,199,0,0.070528967,empty,mBC-0716-2
"G3,H11",22781,23992,16680,7312,11731,0,5657,5678,4087,1591,2.568824639,2920,213,152,105,0,105,0,64,0,0.00952381,empty,mBC-0716-2
"G3,H12",5970,6025,4459,1566,3041,0,1421,1425,983,442,2.2239819,670,813,443,254,0,254,0,92,0,0.011811024,empty,mBC-0716-2
"G4,A1",14607,15253,10918,4335,7374,0,3502,3513,2476,1037,2.387656702,1782,1149,716,421,0,421,0,200,0,0.004750594,empty,mBC-0716-2
"G4,A2",19240,19146,14660,4486,9193,4,4043,4055,2870,1185,2.421940928,1829,8339,2747,1634,1,1633,1,478,0,0.074709124,empty,mBC-0716-2
"G4,A3",860109,984690,579991,404699,474880,21,294776,295196,229967,65229,3.525533122,171721,61403,39139,22093,6,22087,1,2701,0,0.001675194,mm10,mBC-0716-2
"G4,A4",20890,21650,16139,5511,10396,0,4709,4718,3327,1391,2.391804457,2265,797,502,305,0,305,0,154,0,0.036065574,empty,mBC-0716-2
"G4,A5",17227,17872,12955,4917,8574,3,3939,3948,2732,1216,2.246710526,1935,1479,884,552,0,552,0,234,0,0.018115942,empty,mBC-0716-2
"G4,A6",12687,13131,9517,3614,6408,10,3015,3034,2172,862,2.519721578,1480,1412,893,564,0,564,0,240,0,0.012411348,empty,mBC-0716-2
"G4,A7",15815,16602,11878,4724,8133,3,3765,3771,2628,1143,2.299212598,1922,1103,685,413,0,413,0,190,0,0.03874092,empty,mBC-0716-2
"G4,A8",10650,11037,8110,2927,5371,5,2466,2479,1807,672,2.688988095,1178,2832,1203,750,1,749,1,286,0,0.058744993,empty,mBC-0716-2
"G4,A9",970369,1032414,717708,314706,489677,1,249670,250105,206750,43355,4.768769461,128881,48051,30826,17366,4,17362,1,2246,0,0.002879853,mm10,mBC-0716-2
"G4,A10",17133,17579,13111,4468,8530,3,3836,3856,2703,1153,2.344319167,1835,499,301,194,0,194,0,103,0,0,empty,mBC-0716-2
"G4,A11",751586,802859,560540,242319,388593,0,195572,195847,139977,55870,2.505405405,102517,27383,17864,10240,6,10234,1,1618,0,0.001856557,mm10,mBC-0716-2
"G4,A12",1439900,1533771,1072955,460816,720941,1,367207,367807,268858,98949,2.717137111,192645,118726,65277,37136,14,37122,2,4044,0,0.007839017,mm10,mBC-0716-2
"G4,B1",19277,19542,14383,5159,9398,0,4250,4254,3088,1166,2.648370497,2030,8249,2990,1860,3,1857,3,498,0,0.158319871,empty,mBC-0716-2
"G4,B2",19719,20353,15115,5238,9822,16,4391,4417,3125,1292,2.41873065,2102,377,213,152,0,152,0,86,0,0.039473684,empty,mBC-0716-2
"G4,B3",1177925,1315807,818291,497516,625705,2,372230,372772,299945,72827,4.118596125,209769,52702,29222,16388,9,16379,3,2302,0,0.00854753,mm10,mBC-0716-2
"G4,B4",1591323,1770971,1131373,639598,848235,2,493388,494134,364476,129658,2.81105678,275306,69539,38395,21577,13,21564,3,2791,0,0.00621406,mm10,mBC-0716-2
"G4,B5",530107,291943,196253,95690,189183,30,98165,98907,74386,24521,3.033563068,55898,7217,4710,2704,2,2702,1,630,0,0.003330866,mm10,mBC-0716-2
"G4,B6",12377,13135,9406,3729,6363,2,3029,3044,2137,907,2.356119074,1500,1498,774,471,0,471,0,193,0,0.121019108,empty,mBC-0716-2
"G4,B7",15713,16300,12236,4064,7887,11,3588,3606,2567,1039,2.470644851,1673,896,508,317,0,317,0,130,0,0.085173502,empty,mBC-0716-2
"G4,B8",13512,13916,10124,3792,6657,0,3096,3107,2174,933,2.330117899,1515,5226,1904,1199,2,1197,2,440,0,0.081871345,empty,mBC-0716-2
"G4,B9",14759,15086,11411,3675,7201,9,3177,3196,2179,1017,2.142576205,1474,2170,887,529,0,529,0,191,0,0.039697543,empty,mBC-0716-2
"G4,B10",16465,16612,12322,4290,8292,6,3903,3917,2708,1209,2.239867659,1846,2048,721,414,0,414,0,149,0,0.050724638,empty,mBC-0716-2
"G4,B11",16582,17066,12408,4658,8029,11,3709,3728,2600,1128,2.304964539,1814,1292,446,300,0,300,0,136,0,0.023333333,empty,mBC-0716-2
"G4,B12",17266,17362,13285,4077,8468,0,3753,3755,2604,1151,2.262380539,1686,1263,732,409,0,409,0,171,0,0.124694377,empty,mBC-0716-2
"G4,C1",21684,22038,16899,5139,10492,0,4473,4481,3157,1324,2.384441088,2056,649,422,253,0,253,0,122,0,0.051383399,empty,mBC-0716-2
"G4,C2",18714,19319,14248,5071,9168,0,4213,4222,2968,1254,2.366826156,2039,1283,761,443,0,443,0,187,0,0.042889391,empty,mBC-0716-2
"G4,C3",20080,20800,15234,5566,9846,0,4456,4463,3120,1343,2.323157111,2133,489,274,188,0,188,0,98,0,0.005319149,empty,mBC-0716-2
"G4,C4",17546,17999,13453,4546,8784,7,3876,3890,2696,1194,2.257956449,1824,1001,525,341,0,341,0,149,0,0.11143695,empty,mBC-0716-2
"G4,C5",15993,16454,12173,4281,8069,0,3732,3745,2655,1090,2.435779817,1848,1124,683,452,1,451,1,214,0,0.033259424,empty,mBC-0716-2
"G4,C6",16505,16700,12511,4189,8465,0,3853,3864,2693,1171,2.299743809,1855,1101,661,415,0,415,0,190,0,0.014457831,empty,mBC-0716-2
"G4,C7",16332,16761,12372,4389,8052,0,3736,3741,2650,1091,2.428964253,1741,553,262,162,0,162,0,94,0,0.030864198,empty,mBC-0716-2
"G4,C8",14769,15320,11226,4094,7482,5,3476,3489,2396,1093,2.192131747,1687,1430,860,510,0,510,0,202,0,0.019607843,empty,mBC-0716-2
"G4,C9",12561,12925,9527,3398,6189,0,2799,2808,1933,875,2.209142857,1328,1421,645,408,0,408,0,164,0,0.026960784,empty,mBC-0716-2
"G4,C10",13214,13832,10096,3736,6698,0,3058,3066,2165,901,2.402885683,1507,1060,655,411,1,410,1,156,0,0.046341463,empty,mBC-0716-2
"G4,C11",12928,13154,9597,3557,6301,38,2977,3021,2001,1020,1.961764706,1465,11855,3888,2300,0,2300,0,619,0,0.107391304,empty,mBC-0716-2
"G4,C12",19764,20302,14777,5525,9639,2,4459,4470,3151,1319,2.388931008,2135,930,491,294,0,294,0,139,0,0.047619048,empty,mBC-0716-2
"G4,D1",12104,12562,9050,3512,6067,1,2865,2871,1952,919,2.124047878,1396,2584,902,547,0,547,0,205,0,0.031078611,empty,mBC-0716-2
"G4,D2",21469,21933,16529,5404,10498,16,4576,4607,3248,1359,2.389992642,2159,2204,1323,877,0,877,0,348,0,0.041049031,empty,mBC-0716-2
"G4,D3",13511,14188,10363,3825,7005,24,3236,3266,2276,990,2.298989899,1602,1251,775,463,1,462,1,223,0,0.002164502,empty,mBC-0716-2
"G4,D4",16503,17472,12751,4721,8571,0,4105,4122,2997,1125,2.664,2038,1265,708,471,0,471,0,235,0,0.061571125,empty,mBC-0716-2
"G4,D5",13699,14031,10257,3774,6856,19,3176,3200,2220,980,2.265306122,1558,1155,747,422,2,420,1,165,0,0.104761905,empty,mBC-0716-2
"G4,D6",12615,12881,9354,3527,6358,15,2975,2991,2080,911,2.283205269,1457,3839,1346,815,0,815,0,299,0,0.039263804,empty,mBC-0716-2
"G4,D7",12696,13632,9632,4000,6641,3,3216,3223,2239,984,2.275406504,1658,1419,857,502,0,502,0,200,0,0.039840637,empty,mBC-0716-2
"G4,D8",17084,18019,12884,5135,8615,0,4047,4050,2837,1213,2.338829349,2015,1511,780,463,0,463,0,185,0,0.056155508,empty,mBC-0716-2
"G4,D9",5560,5709,4213,1496,2882,0,1373,1378,938,440,2.131818182,652,3970,1511,963,0,963,0,394,0,0.065420561,empty,mBC-0716-2
"G4,D10",13282,13790,9951,3839,6635,9,3095,3122,2186,936,2.335470085,1460,738,419,283,0,283,0,114,0,0.081272085,empty,mBC-0716-2
"G4,D11",13075,13706,10157,3549,6548,0,3013,3018,2134,884,2.414027149,1406,2772,1208,779,0,779,0,295,0,0.019255456,empty,mBC-0716-2
"G4,D12",1060431,1241422,692924,548498,590077,1,385159,385627,304499,81128,3.753315748,228984,266616,174776,96675,42,96633,3,5497,0,0.001200418,mm10,mBC-0716-2
"G4,E1",21413,21590,16333,5257,10491,1,4687,4705,3358,1347,2.49294729,2206,1649,1033,595,1,594,1,251,0,0.02020202,empty,mBC-0716-2
"G4,E2",16233,16416,12153,4263,7919,3,3585,3595,2548,1047,2.433619866,1706,1435,834,479,0,479,0,203,0,0.077244259,empty,mBC-0716-2
"G4,E3",711417,779952,513841,266111,375491,3,203073,203374,166214,37160,4.472927879,109389,107193,71519,40134,21,40113,4,3455,0,0.001246479,mm10,mBC-0716-2
"G4,E4",15253,15840,11640,4200,7632,0,3535,3539,2486,1053,2.360873694,1697,1293,775,452,0,452,0,164,0,0.03539823,empty,mBC-0716-2
"G4,E5",20363,21058,15814,5244,10131,0,4576,4581,3223,1358,2.373343152,2162,1285,851,532,1,531,1,234,0,0.058380414,empty,mBC-0716-2
"G4,E6",15111,15370,11538,3832,7390,0,3288,3299,2342,957,2.44723093,1568,1414,819,513,0,513,0,246,0,0.048732943,empty,mBC-0716-2
"G4,E7",13307,14003,10187,3816,6643,0,3047,3057,2088,969,2.154798762,1426,1366,811,490,0,490,0,198,0,0.075510204,empty,mBC-0716-2
"G4,E8",17341,17678,13500,4178,8631,0,3863,3866,2721,1145,2.376419214,1798,1527,918,592,1,591,1,236,0,0.023688663,empty,mBC-0716-2
"G4,E9",9689,9845,7181,2664,4666,82,2016,2100,1552,548,2.832116788,1000,3002,1310,798,1,797,1,227,0,0.293601004,empty,mBC-0716-2
"G4,E10",12432,12890,9611,3279,6319,0,2856,2859,2005,854,2.347775176,1369,1122,642,425,0,425,0,178,0,0.042352941,empty,mBC-0716-2
"G4,E11",9320,9686,6998,2688,4745,0,2287,2293,1584,709,2.234132581,1076,2221,940,557,0,557,0,220,0,0.080789946,empty,mBC-0716-2
"G4,E12",15414,15923,11677,4246,7609,4,3530,3537,2509,1028,2.440661479,1652,965,609,367,0,367,0,147,0,0.108991826,empty,mBC-0716-2
"G4,F1",19630,20444,14941,5503,9918,1,4614,4630,3299,1331,2.478587528,2265,1618,939,571,0,571,0,234,0,0.03502627,empty,mBC-0716-2
"G4,F2",22504,23349,17137,6212,11178,2,5222,5241,3668,1573,2.331849968,2524,2655,1543,929,1,928,1,373,0,0.029094828,empty,mBC-0716-2
"G4,F3",15520,16234,11617,4617,8098,1,3822,3837,2748,1089,2.523415978,1919,1606,944,648,0,648,0,288,0,0.054012346,empty,mBC-0716-2
"G4,F4",16645,16968,12643,4325,8363,16,3831,3855,2705,1150,2.352173913,1791,1802,602,346,1,345,1,141,0,0.005797101,empty,mBC-0716-2
"G4,F5",24528,25149,18673,6476,12028,33,5466,5514,3846,1668,2.305755396,2648,1882,1141,717,0,717,0,297,0,0.051603905,empty,mBC-0716-2
"G4,F6",810030,864305,574353,289952,416048,19,230260,230665,183023,47642,3.841631334,123693,61703,34714,19934,8,19926,1,2676,0,0.00838101,mm10,mBC-0716-2
"G4,F7",20667,21164,15891,5273,10018,3,4485,4501,3155,1346,2.343982169,2092,671,391,250,0,250,0,141,0,0,empty,mBC-0716-2
"G4,F8",22006,22821,16733,6088,11051,0,5086,5103,3534,1569,2.252390057,2512,372,185,126,0,126,0,77,0,0,empty,mBC-0716-2
"G4,F9",14597,14910,11057,3853,7184,0,3216,3231,2237,994,2.250503018,1540,1734,889,512,0,512,0,194,0,0.072265625,empty,mBC-0716-2
"G4,F10",19963,20669,15314,5355,9920,0,4423,4438,3136,1302,2.408602151,2149,1129,647,389,0,389,0,183,0,0.064267352,empty,mBC-0716-2
"G4,F11",10973,11286,8548,2738,5581,0,2486,2492,1724,768,2.244791667,1162,1032,606,388,0,388,0,169,0,0.074742268,empty,mBC-0716-2
"G4,F12",14319,14820,10956,3864,7129,55,3257,3326,2366,960,2.464583333,1620,257,176,113,0,113,0,60,0,0.008849558,empty,mBC-0716-2
"G4,G1",9873,9984,7580,2404,4861,21,2117,2148,1460,688,2.122093023,990,1517,900,530,0,530,0,211,0,0.024528302,empty,mBC-0716-2
"G4,G2",21298,21984,16256,5728,10481,0,4650,4669,3246,1423,2.281096275,2275,621,387,258,0,258,0,146,0,0,empty,mBC-0716-2
"G4,G3",940608,1092645,624773,467872,524709,3,339089,339574,261045,78529,3.32418597,200770,68091,45146,25657,8,25649,2,2739,0,0.002222309,mm10,mBC-0716-2
"G4,G4",28314,28717,21930,6787,13829,36,5984,6026,4266,1760,2.423863636,2819,156,88,70,0,70,0,46,0,0,empty,mBC-0716-2
"G4,G5",14534,14970,10994,3976,7224,0,3300,3302,2322,980,2.369387755,1621,6691,2271,1336,0,1336,0,457,0,0.020209581,empty,mBC-0716-2
"G4,G6",1018540,1085778,756102,329676,514090,1,259957,260408,226385,34023,6.653881198,134398,3486,2380,1387,0,1387,0,351,0,0.002162942,mm10,mBC-0716-2
"G4,G7",1005928,1100382,740001,360381,524507,6,274874,275346,219299,56047,3.91276964,146194,164200,106308,58987,28,58959,2,4370,0,0.00939636,mm10,mBC-0716-2
"G4,G8",14726,14891,11089,3802,7181,0,3348,3354,2377,977,2.432958035,1589,1330,822,528,0,528,0,225,0,0.034090909,empty,mBC-0716-2
"G4,G9",12466,12775,9705,3070,6120,0,2758,2758,1978,780,2.535897436,1248,3060,1128,673,0,673,0,263,0,0.014858841,empty,mBC-0716-2
"G4,G10",13628,14102,10585,3517,6810,4,3081,3091,2196,895,2.453631285,1469,3923,1463,904,1,903,1,338,0,0.024363234,empty,mBC-0716-2
"G4,G11",12469,12759,9610,3149,6198,0,2804,2813,1916,897,2.136008919,1336,1568,667,409,0,409,0,183,0,0.078239609,empty,mBC-0716-2
"G4,G12",11261,11786,8655,3131,5711,0,2668,2673,1920,753,2.549800797,1214,1241,764,431,0,431,0,161,0,0.05800464,empty,mBC-0716-2
"G4,H1",20249,20869,15216,5653,10123,0,4622,4638,3298,1340,2.46119403,2267,839,513,322,0,322,0,153,0,0.077639752,empty,mBC-0716-2
"G4,H2",29857,31312,22476,8836,15229,0,7367,7382,5404,1978,2.732052578,3707,2133,1399,827,0,827,0,334,0,0.047158404,empty,mBC-0716-2
"G4,H3",959952,1042415,701655,340760,497365,3,265424,265836,211331,54505,3.877277314,141752,65037,40083,22635,9,22626,1,2683,0,0.001856272,mm10,mBC-0716-2
"G4,H4",14284,14845,10746,4099,7155,0,3296,3306,2249,1057,2.127719962,1586,233,142,102,0,102,0,72,0,0.049019608,empty,mBC-0716-2
"G4,H5",18325,19422,14096,5326,9135,0,4288,4301,3034,1267,2.394632991,2136,1179,725,448,0,448,0,188,0,0.024553571,empty,mBC-0716-2
"G4,H6",14830,15662,11242,4420,7485,13,3603,3622,2529,1093,2.313815188,1787,1631,1023,585,0,585,0,223,0,0.005128205,empty,mBC-0716-2
"G4,H7",17153,17901,12936,4965,8612,0,3925,3939,2758,1181,2.33530906,1988,1448,895,557,0,557,0,234,0,0.026929982,empty,mBC-0716-2
"G4,H8",13884,14438,10447,3991,7039,0,3355,3365,2373,992,2.392137097,1665,2146,1162,686,1,685,1,294,0,0.027737226,empty,mBC-0716-2
"G4,H9",1538819,1680954,1094483,586471,802241,15,446738,447418,365837,81581,4.484340717,244773,147746,97817,54286,26,54260,3,4433,0,0.00082934,mm10,mBC-0716-2
"G4,H10",15087,15425,11414,4011,7487,7,3414,3429,2443,986,2.477687627,1649,1592,983,616,1,615,1,281,0,0.001626016,empty,mBC-0716-2
"G4,H11",16689,17505,12455,5050,8289,7,3884,3900,2723,1177,2.313508921,1868,228,131,87,0,87,0,59,0,0.034482759,empty,mBC-0716-2
"G4,H12",6150,6464,4688,1776,3221,0,1491,1491,1065,426,2.5,745,480,322,184,0,184,0,83,0,0.010869565,empty,mBC-0716-2
"G5,A1",190505,217470,121204,96266,107155,0,72352,72452,42781,29671,1.441845573,43582,7272,2851,1723,1,1722,1,525,0,0.044134727,mm10,mBC-0716-2
"G5,A2",21611,22268,16583,5685,10530,5,4679,4698,3283,1415,2.320141343,2280,2539,1026,596,0,596,0,195,0,0.048657718,empty,mBC-0716-2
"G5,A3",18524,19549,13820,5729,9478,15,4556,4583,3190,1393,2.290021536,2350,811,463,273,0,273,0,132,0,0.010989011,empty,mBC-0716-2
"G5,A4",23435,23880,17870,6010,11396,0,5075,5080,3563,1517,2.348714568,2357,1823,644,384,0,384,0,151,0,0.088541667,empty,mBC-0716-2
"G5,A5",20086,20721,15417,5304,10013,23,4594,4628,3214,1414,2.272984441,2208,1524,899,564,0,564,0,220,0,0.033687943,empty,mBC-0716-2
"G5,A6",14714,15583,11251,4332,7461,1,3442,3453,2352,1101,2.136239782,1662,1642,780,509,0,509,0,226,0,0.027504912,empty,mBC-0716-2
"G5,A7",848779,980344,565807,414537,478761,5,303737,304205,196315,107890,1.819584762,184988,5978,3958,2132,2,2130,1,538,0,0.007042254,mm10,mBC-0716-2
"G5,A8",12180,12616,9000,3616,6168,4,2892,2903,2037,866,2.352193995,1432,10678,3188,1949,2,1947,2,576,0,0.054956343,empty,mBC-0716-2
"G5,A9",22723,23111,17208,5903,10862,0,4864,4883,3382,1501,2.253164557,2292,5073,1911,1168,1,1167,1,384,0,0.071979434,empty,mBC-0716-2
"G5,A10",17754,18141,13434,4707,8832,41,4044,4101,2873,1228,2.339576547,1910,335,192,125,0,125,0,77,0,0.008,empty,mBC-0716-2
"G5,A11",1122696,1196124,795326,400798,564739,1,312291,312845,248159,64686,3.836363355,166335,55694,36298,20136,13,20123,2,2375,0,0.001441137,mm10,mBC-0716-2
"G5,A12",22885,23363,17559,5804,11035,0,4828,4845,3387,1458,2.323045267,2258,2243,1319,759,1,758,1,237,0,0.084432718,empty,mBC-0716-2
"G5,B1",21008,21731,16060,5671,10338,1,4678,4690,3298,1392,2.369252874,2190,6908,2109,1280,4,1276,1,420,0,0.056426332,empty,mBC-0716-2
"G5,B2",1965802,2142531,1382320,760211,1015760,3,595711,596541,478265,118276,4.043635226,325944,14309,9071,5091,1,5090,1,1025,0,0.004518664,mm10,mBC-0716-2
"G5,B3",22008,22874,16783,6091,11002,22,5104,5139,3692,1447,2.551485833,2460,893,572,337,0,337,0,159,0,0.044510386,empty,mBC-0716-2
"G5,B4",20478,20580,14942,5638,9539,0,4449,4458,3154,1304,2.418711656,2106,18150,5350,3280,1,3279,1,813,0,0.113449222,empty,mBC-0716-2
"G5,B5",589469,347246,222528,124718,223758,6,121510,122310,95959,26351,3.64156958,70609,38707,22168,12627,8,12619,1,1847,0,0.004200016,mm10,mBC-0716-2
"G5,B6",14212,15091,10841,4250,7340,0,3468,3473,2421,1052,2.301330798,1769,1228,770,450,0,450,0,180,0,0.017777778,empty,mBC-0716-2
"G5,B7",18196,18886,13939,4947,8957,0,4026,4040,2800,1240,2.258064516,1928,2102,857,511,0,511,0,168,0,0.150684932,empty,mBC-0716-2
"G5,B8",14349,14765,10984,3781,7261,0,3302,3316,2344,972,2.411522634,1582,972,541,357,0,357,0,168,0,0.022408964,empty,mBC-0716-2
"G5,B9",16559,17425,12740,4685,8197,1,3761,3768,2604,1164,2.237113402,1839,956,418,253,0,253,0,118,0,0.090909091,empty,mBC-0716-2
"G5,B10",19498,19501,14306,5195,9541,25,4453,4495,3070,1425,2.154385965,2095,1893,685,408,1,407,1,157,0,0.14987715,empty,mBC-0716-2
"G5,B11",17340,17935,13335,4600,8559,0,3882,3889,2752,1137,2.420404573,1826,167,91,62,0,62,0,41,0,0,empty,mBC-0716-2
"G5,B12",20136,20874,15331,5543,10193,9,4693,4719,3351,1368,2.449561404,2251,8046,2570,1515,1,1514,1,466,0,0.036327609,empty,mBC-0716-2
"G5,C1",24135,24163,18515,5648,11584,0,4900,4916,3482,1434,2.428172943,2269,451,256,183,0,183,0,95,0,0.016393443,empty,mBC-0716-2
"G5,C2",21543,22651,16172,6479,10656,106,4866,4987,3460,1527,2.265880812,2540,1389,805,486,0,486,0,185,0,0.026748971,empty,mBC-0716-2
"G5,C3",1223211,1416268,805221,611047,672265,3,433063,433660,348661,84999,4.101942376,255536,33955,20894,11581,9,11572,2,1808,0,0.00095057,mm10,mBC-0716-2
"G5,C4",991151,1063589,708611,354978,513234,0,278999,279454,224302,55152,4.066978532,149912,52560,34398,19491,12,19479,1,2406,0,0.002104831,mm10,mBC-0716-2
"G5,C5",1304457,1549606,850663,698943,740361,11,497981,498636,308531,190105,1.622950475,303702,25194,15233,8554,3,8551,1,1538,0,0.002806689,mm10,mBC-0716-2
"G5,C6",902978,986619,636288,350331,489295,47,273393,273851,234074,39777,5.884656963,150950,82734,53235,29947,6,29941,3,3129,0,0.001235764,mm10,mBC-0716-2
"G5,C7",18737,19748,14164,5584,9310,0,4362,4370,2972,1398,2.125894134,2189,1107,432,267,0,267,0,116,0,0,empty,mBC-0716-2
"G5,C8",16926,17120,12862,4258,8371,0,3762,3770,2654,1116,2.378136201,1770,1371,806,461,2,459,2,198,0,0.02832244,empty,mBC-0716-2
"G5,C9",14897,15711,11393,4318,7446,44,3464,3516,2561,955,2.681675393,1761,651,401,255,0,255,0,116,0,0.023529412,empty,mBC-0716-2
"G5,C10",15410,15613,11563,4050,7571,0,3431,3438,2405,1033,2.328170378,1658,5309,1706,1023,0,1023,0,335,0,0.051808407,empty,mBC-0716-2
"G5,C11",12865,13516,9730,3786,6485,0,3088,3098,2152,946,2.274841438,1513,911,465,293,0,293,0,117,0,0.081911263,empty,mBC-0716-2
"G5,C12",21173,21885,15953,5932,10752,0,4945,4962,3455,1507,2.292634373,2409,2667,1142,674,1,673,1,211,0,0.106983655,empty,mBC-0716-2
"G5,D1",13697,13991,10334,3657,6826,0,3178,3183,2280,903,2.524916944,1491,1651,580,357,1,356,1,140,0,0.04494382,empty,mBC-0716-2
"G5,D2",22910,23531,17532,5999,11370,0,5006,5019,3483,1536,2.267578125,2389,1987,1185,726,0,726,0,285,0,0.05785124,empty,mBC-0716-2
"G5,D3",15103,15861,11363,4498,7910,23,3791,3823,2613,1210,2.159504132,1900,1204,505,322,0,322,0,167,0,0.00931677,empty,mBC-0716-2
"G5,D4",17598,18490,13221,5269,8992,0,4324,4341,3100,1241,2.497985496,2177,1061,625,403,0,403,0,181,0,0.066997519,empty,mBC-0716-2
"G5,D5",15802,16093,12047,4046,7803,42,3587,3636,2560,1076,2.379182156,1759,1561,786,444,2,442,2,169,0,0.058823529,empty,mBC-0716-2
"G5,D6",14399,14764,11104,3660,7170,0,3296,3306,2346,960,2.44375,1589,1013,615,331,0,331,0,138,0,0.036253776,empty,mBC-0716-2
"G5,D7",14704,15264,11185,4079,7297,43,3394,3442,2417,1025,2.35804878,1667,2174,1085,582,0,582,0,225,0,0.018900344,empty,mBC-0716-2
"G5,D8",17761,18722,13189,5533,8994,30,4178,4227,2933,1294,2.266615147,2206,988,601,358,0,358,0,145,0,0.033519553,empty,mBC-0716-2
"G5,D9",6601,6854,4931,1923,3352,1,1556,1559,1141,418,2.729665072,769,3601,1411,897,1,896,1,362,0,0.0390625,empty,mBC-0716-2
"G5,D10",15122,15490,11521,3969,7520,0,3391,3395,2373,1022,2.321917808,1606,823,429,263,0,263,0,103,0,0.049429658,empty,mBC-0716-2
"G5,D11",16744,17209,12689,4520,8412,22,3900,3928,2785,1143,2.436570429,1893,4286,1497,871,2,869,1,330,0,0.036823936,empty,mBC-0716-2
"G5,D12",22593,23293,17097,6196,11027,2,5063,5080,3567,1513,2.357567746,2375,1830,1109,675,0,675,0,247,0,0.031111111,empty,mBC-0716-2
"G5,E1",25132,25410,19073,6337,12168,31,5352,5410,3823,1587,2.4089477,2563,1598,889,512,0,512,0,221,0,0.064453125,empty,mBC-0716-2
"G5,E2",18377,18766,13915,4851,9036,1,4097,4107,2902,1205,2.408298755,1952,1394,814,508,1,507,1,190,0,0.029585799,empty,mBC-0716-2
"G5,E3",13412,13903,10240,3663,6741,16,3048,3070,2098,972,2.158436214,1459,1406,851,534,0,534,0,219,0,0.046816479,empty,mBC-0716-2
"G5,E4",17548,18282,13479,4803,8568,10,3920,3942,2779,1163,2.389509888,1902,2671,1127,676,0,676,0,226,0,0.025147929,empty,mBC-0716-2
"G5,E5",23227,23545,17943,5602,11324,0,4958,4974,3462,1512,2.28968254,2278,1213,684,419,0,419,0,165,0,0.093078759,empty,mBC-0716-2
"G5,E6",15770,16174,12120,4054,7916,0,3606,3619,2566,1053,2.436847104,1739,1334,788,493,0,493,0,195,0,0.026369168,empty,mBC-0716-2
"G5,E7",15151,15532,11646,3886,7573,11,3449,3472,2463,1009,2.441030723,1638,993,605,358,0,358,0,154,0,0.033519553,empty,mBC-0716-2
"G5,E8",1220445,1375064,833200,541864,659789,16,410027,410619,331525,79094,4.191531595,232925,67974,43222,24034,3,24031,1,2746,0,0.00328742,mm10,mBC-0716-2
"G5,E9",10141,10573,7595,2978,5104,0,2369,2374,1628,746,2.18230563,1169,996,670,368,0,368,0,133,0,0.051630435,empty,mBC-0716-2
"G5,E10",14204,14753,10808,3945,7203,0,3361,3369,2363,1006,2.348906561,1626,1088,612,346,0,346,0,136,0,0.080924855,empty,mBC-0716-2
"G5,E11",10661,10677,8222,2455,5311,0,2382,2389,1638,751,2.181091877,1105,913,539,308,0,308,0,141,0,0.038961039,empty,mBC-0716-2
"G5,E12",785293,925802,520913,404889,454599,1,296053,296392,187142,109250,1.712970252,178784,18787,12525,7125,2,7123,1,1210,0,0.000982732,mm10,mBC-0716-2
"G5,F1",869035,945780,623511,322269,457365,5,255699,256090,192842,63248,3.048981786,138646,23001,14694,8340,2,8338,1,1400,0,0.001079396,mm10,mBC-0716-2
"G5,F2",26533,27651,19851,7800,13472,0,6436,6455,4519,1936,2.334194215,3209,2407,1390,861,0,861,0,327,0,0.036004646,empty,mBC-0716-2
"G5,F3",1020314,1135662,711621,424041,544611,18,316100,316595,270741,45854,5.90441401,176678,110342,72707,40882,17,40865,5,3575,0,0.001027774,mm10,mBC-0716-2
"G5,F4",18442,18879,13940,4939,9488,6,4328,4350,3068,1282,2.393135725,2120,552,287,198,0,198,0,84,0,0.095959596,empty,mBC-0716-2
"G5,F5",1229357,1348007,844972,503035,640292,3,389233,389746,297572,92174,3.228372426,216454,17731,10155,5611,3,5608,1,1234,0,0.005706134,mm10,mBC-0716-2
"G5,F6",942190,1035582,662686,372896,495794,1,280763,281152,233244,47908,4.868581448,155500,103865,68558,38398,13,38385,2,3534,0,0.001719422,mm10,mBC-0716-2
"G5,F7",22205,22728,16966,5762,10968,2,4938,4953,3428,1525,2.247868852,2331,545,273,169,0,169,0,87,0,0.106508876,empty,mBC-0716-2
"G5,F8",24840,25623,18801,6822,12286,13,5716,5735,4095,1640,2.49695122,2755,235,148,109,0,109,0,72,0,0.036697248,empty,mBC-0716-2
"G5,F9",16697,17117,12591,4526,8167,7,3674,3687,2559,1128,2.268617021,1794,1325,773,427,1,426,1,162,0,0.049295775,empty,mBC-0716-2
"G5,F10",25374,25926,19604,6322,12498,20,5416,5453,3842,1611,2.384854128,2541,2457,1059,648,0,648,0,233,0,0.033950617,empty,mBC-0716-2
"G5,F11",12226,12502,9404,3098,6111,12,2721,2736,1883,853,2.207502931,1249,977,570,337,0,337,0,159,0,0.023738872,empty,mBC-0716-2
"G5,F12",737737,784082,562696,221386,374298,30,176906,177270,142613,34657,4.114983986,89523,4815,2919,1622,1,1621,1,380,0,0.001233806,mm10,mBC-0716-2
"G5,G1",10997,11341,8495,2846,5475,10,2435,2449,1690,759,2.226613966,1120,3005,1351,787,1,786,1,257,0,0.020356234,empty,mBC-0716-2
"G5,G2",23219,24032,17606,6426,11607,2,5286,5303,3763,1540,2.443506494,2595,519,305,196,0,196,0,115,0,0.005102041,empty,mBC-0716-2
"G5,G3",23734,24225,17933,6292,11812,0,5528,5536,3994,1542,2.590142672,2620,1589,914,552,0,552,0,223,0,0.048913043,empty,mBC-0716-2
"G5,G4",1169209,1304757,803125,501632,623975,77,383747,384340,274071,110269,2.485476426,216479,276,172,108,0,108,0,60,0,0,empty,mBC-0716-2
"G5,G5",15277,15766,11625,4141,7612,11,3500,3522,2480,1042,2.380038388,1718,919,540,343,0,343,0,154,0,0.075801749,empty,mBC-0716-2
"G5,G6",26263,26874,20035,6839,12923,15,5689,5724,4070,1654,2.46070133,2722,152,94,64,0,64,0,39,0,0,empty,mBC-0716-2
"G5,G7",1360992,1480773,974056,506717,697015,17,395318,395935,306089,89846,3.406818334,210395,77087,48441,27217,9,27208,2,3033,0,0.001653925,mm10,mBC-0716-2
"G5,G8",16773,16938,12312,4626,8196,1,3862,3873,2699,1174,2.298977853,1911,5658,2229,1369,3,1366,1,379,0,0.212298682,empty,mBC-0716-2
"G5,G9",11954,12581,9073,3508,6080,1,2852,2853,2074,779,2.662387677,1414,2597,1020,598,0,598,0,234,0,0.036789298,empty,mBC-0716-2
"G5,G10",15243,15908,11646,4262,7698,0,3461,3476,2416,1060,2.279245283,1698,944,555,374,0,374,0,197,0,0.002673797,empty,mBC-0716-2
"G5,G11",13526,13691,10401,3290,6599,8,2887,2903,2063,840,2.455952381,1321,707,424,247,0,247,0,106,0,0.04048583,empty,mBC-0716-2
"G5,G12",13115,13515,9938,3577,6549,12,3007,3026,2105,921,2.285559175,1447,1093,658,396,0,396,0,146,0,0.141414141,empty,mBC-0716-2
"G5,H1",23299,23986,17833,6153,11468,26,5164,5195,3702,1493,2.479571333,2461,5966,2061,1224,2,1222,2,349,0,0.090016367,empty,mBC-0716-2
"G5,H2",29113,29838,22394,7444,14290,0,6315,6331,4432,1899,2.333859926,2998,1849,1019,595,0,595,0,260,0,0.016806723,empty,mBC-0716-2
"G5,H3",25759,26821,19727,7094,12859,0,5957,5963,4227,1736,2.434907834,2834,1335,741,474,0,474,0,199,0,0.02742616,empty,mBC-0716-2
"G5,H4",16390,17327,12213,5114,8265,1,3845,3867,2727,1140,2.392105263,2023,149,98,70,0,70,0,58,0,0,empty,mBC-0716-2
"G5,H5",1001199,1045132,760775,284357,489555,0,226272,226745,192839,33906,5.687459447,111757,101163,67062,37075,16,37059,4,3392,0,0.000593648,mm10,mBC-0716-2
"G5,H6",17216,17955,12994,4961,8706,0,4119,4128,2910,1218,2.389162562,2022,1260,792,467,0,467,0,175,0,0.019271949,empty,mBC-0716-2
"G5,H7",870007,936064,624664,311400,458069,0,255598,256000,195468,60532,3.229168043,136492,18079,11344,6416,6,6410,1,1244,0,0.003588144,mm10,mBC-0716-2
"G5,H8",16231,16790,12127,4663,8003,0,3746,3754,2664,1090,2.444036697,1799,16243,4920,3028,1,3027,1,774,0,0.130822597,empty,mBC-0716-2
"G5,H9",18162,18765,13993,4772,8978,7,4016,4031,2817,1214,2.320428336,1906,1202,746,457,0,457,0,202,0,0.039387309,empty,mBC-0716-2
"G5,H10",17701,18656,13273,5383,9145,0,4409,4426,3089,1337,2.31039641,2277,3540,1198,754,0,754,0,304,0,0.027851459,empty,mBC-0716-2
"G5,H11",18627,19446,13988,5458,9356,0,4302,4311,2901,1410,2.057446809,2198,199,132,90,0,90,0,57,0,0.166666667,empty,mBC-0716-2
"G5,H12",7062,7361,5283,2078,3652,0,1670,1672,1188,484,2.454545455,837,1236,503,275,0,275,0,113,0,0.032727273,empty,mBC-0716-2
"G6,A1",1032789,1182436,683231,499205,577432,0,371807,372284,273398,98886,2.764779645,218591,29027,17698,10020,8,10012,2,1666,0,0.009288853,mm10,mBC-0716-2
"G6,A2",20061,20206,15281,4925,9781,4,4313,4329,3064,1265,2.422134387,2034,1598,881,529,0,529,0,204,0,0.085066163,empty,mBC-0716-2
"G6,A3",17432,17890,13141,4749,8689,26,4038,4070,2885,1185,2.434599156,1976,899,522,318,0,318,0,156,0,0.066037736,empty,mBC-0716-2
"G6,A4",22341,23050,17131,5919,10938,22,4818,4847,3510,1337,2.625280479,2325,813,398,276,0,276,0,133,0,0.003623188,empty,mBC-0716-2
"G6,A5",1119062,1221842,788696,433146,584312,2,331035,331558,275367,56191,4.900553469,180447,83120,54128,30527,14,30513,1,3076,0,0.000884869,mm10,mBC-0716-2
"G6,A6",13834,14544,10509,4035,7143,7,3336,3351,2289,1062,2.155367232,1688,4282,1572,974,0,974,0,366,0,0.024640657,empty,mBC-0716-2
"G6,A7",17249,17960,12924,5036,8632,5,3957,3967,2733,1234,2.214748784,1961,4253,1705,988,1,987,1,310,0,0.195542047,empty,mBC-0716-2
"G6,A8",11952,12367,8909,3458,6003,6,2905,2913,1993,920,2.166304348,1381,3016,1269,790,2,788,1,295,0,0.025380711,empty,mBC-0716-2
"G6,A9",20909,21131,15981,5150,10274,0,4597,4602,3299,1303,2.531849578,2129,1187,653,408,0,408,0,191,0,0.068627451,empty,mBC-0716-2
"G6,A10",16893,17622,12916,4706,8606,5,4003,4014,2821,1193,2.364626991,1879,415,199,138,0,138,0,94,0,0.043478261,empty,mBC-0716-2
"G6,A11",19047,19184,14580,4604,9338,5,4081,4091,2924,1167,2.505569837,1865,1130,675,460,0,460,0,182,0,0.12826087,empty,mBC-0716-2
"G6,A12",22202,22376,17128,5248,10652,0,4700,4713,3274,1439,2.275191105,2163,2872,1322,788,1,787,1,280,0,0.022871665,empty,mBC-0716-2
"G6,B1",19708,20661,15280,5381,9850,0,4449,4454,3098,1356,2.284660767,2119,874,532,291,0,291,0,133,0,0.024054983,empty,mBC-0716-2
"G6,B2",20070,20375,15254,5121,9932,0,4415,4429,3141,1288,2.438664596,2060,505,270,167,0,167,0,77,0,0.023952096,empty,mBC-0716-2
"G6,B3",19374,19833,14739,5094,9564,0,4373,4383,3013,1370,2.199270073,2082,770,490,301,0,301,0,149,0,0.023255814,empty,mBC-0716-2
"G6,B4",17204,18225,13202,5023,8925,3,4100,4118,2829,1289,2.194724593,2062,831,489,307,0,307,0,125,0,0.094462541,empty,mBC-0716-2
"G6,B5",13042,9197,6417,2780,5466,37,2623,2687,1905,782,2.436061381,1470,592,308,201,0,201,0,107,0,0.07960199,empty,mBC-0716-2
"G6,B6",13150,13709,9910,3799,6696,11,3191,3204,2213,991,2.233097881,1581,2140,897,565,0,565,0,221,0,0.086725664,empty,mBC-0716-2
"G6,B7",20623,21662,15830,5832,10480,0,4804,4814,3412,1402,2.433666191,2355,937,537,337,0,337,0,130,0,0.083086053,empty,mBC-0716-2
"G6,B8",13687,13952,10482,3470,6855,0,3052,3059,2120,939,2.25772098,1416,1035,669,399,0,399,0,190,0,0.012531328,empty,mBC-0716-2
"G6,B9",1058736,1236061,700248,535813,591675,23,388107,388645,310861,77784,3.996464569,229140,30596,19574,11158,9,11149,1,1713,0,0.002332048,mm10,mBC-0716-2
"G6,B10",1061124,1085292,750221,335071,543295,6,277154,278103,219099,59004,3.713290624,145339,32113,19780,11156,5,11151,2,1916,0,0.001703883,mm10,mBC-0716-2
"G6,B11",18645,19511,14091,5420,9419,53,4398,4458,3265,1193,2.736797988,2195,197,134,88,0,88,0,57,0,0.034090909,empty,mBC-0716-2
"G6,B12",18950,19587,14446,5141,9668,0,4471,4486,3178,1308,2.429663609,2157,872,447,284,0,284,0,149,0,0.01056338,empty,mBC-0716-2
"G6,C1",23646,23897,18417,5480,11338,17,4809,4835,3406,1429,2.383484955,2160,588,373,216,0,216,0,97,0,0.064814815,empty,mBC-0716-2
"G6,C2",19062,19685,14548,5137,9634,0,4362,4375,3008,1367,2.200438917,2124,1029,654,393,0,393,0,142,0,0.040712468,empty,mBC-0716-2
"G6,C3",20789,21982,15609,6373,10318,0,4833,4854,3354,1500,2.236,2449,454,238,143,0,143,0,73,0,0.027972028,empty,mBC-0716-2
"G6,C4",899360,975955,637856,338099,473817,53,261023,261461,216746,44715,4.8472772,142644,61207,39426,21942,7,21935,1,2549,0,0.002780944,mm10,mBC-0716-2
"G6,C5",19408,20438,14443,5995,10026,0,4905,4915,3481,1434,2.427475593,2503,806,465,301,0,301,0,160,0,0.003322259,empty,mBC-0716-2
"G6,C6",17409,17947,13123,4824,9002,0,4256,4263,3024,1239,2.440677966,2041,1030,607,364,0,364,0,178,0,0.021978022,empty,mBC-0716-2
"G6,C7",849174,957319,592866,364453,462565,40,269190,269564,222853,46711,4.770889084,152372,25937,16167,9166,2,9164,1,1478,0,0.000327368,mm10,mBC-0716-2
"G6,C8",15809,16229,11775,4454,7932,8,3719,3734,2585,1149,2.249782419,1796,1429,878,540,1,539,1,167,0,0.055658627,empty,mBC-0716-2
"G6,C9",13162,13424,10108,3316,6507,0,2926,2935,2048,887,2.308906426,1376,742,415,251,0,251,0,114,0,0.115537849,empty,mBC-0716-2
"G6,C10",14976,15420,11137,4283,7353,0,3489,3496,2464,1032,2.387596899,1721,6277,1989,1210,0,1210,0,377,0,0.163636364,empty,mBC-0716-2
"G6,C11",11986,12434,9157,3277,6086,11,2874,2888,2012,876,2.296803653,1389,828,440,286,0,286,0,142,0,0.062937063,empty,mBC-0716-2
"G6,C12",20790,21304,15658,5646,10166,0,4701,4710,3320,1390,2.388489209,2300,1018,622,383,0,383,0,155,0,0.039164491,empty,mBC-0716-2
"G6,D1",12126,12621,9030,3591,6201,7,2918,2927,2017,910,2.216483516,1418,617,312,173,1,172,1,87,0,0.01744186,empty,mBC-0716-2
"G6,D2",21893,22459,17017,5442,10858,0,4824,4836,3357,1479,2.269776876,2266,2112,1315,743,0,743,0,300,0,0.043068641,empty,mBC-0716-2
"G6,D3",852335,894527,651232,243295,429183,2,194322,194685,156585,38100,4.10984252,97869,50337,30828,17335,6,17329,1,2260,0,0.000865601,mm10,mBC-0716-2
"G6,D4",15140,15736,11394,4342,7724,8,3551,3565,2572,993,2.590130916,1775,1236,784,464,0,464,0,216,0,0.045258621,empty,mBC-0716-2
"G6,D5",16740,17489,12463,5026,8469,0,4074,4081,2709,1372,1.974489796,1996,1918,823,490,0,490,0,224,0,0.120408163,empty,mBC-0716-2
"G6,D6",811066,955712,534245,421467,464588,25,299894,300304,235754,64550,3.652269558,179458,104727,65288,36479,16,36463,2,3506,0,0.000411376,mm10,mBC-0716-2
"G6,D7",18023,19015,13446,5569,9153,0,4553,4562,3290,1272,2.586477987,2298,1140,695,432,0,432,0,186,0,0.053240741,empty,mBC-0716-2
"G6,D8",16981,17557,12901,4656,8382,34,3874,3916,2764,1152,2.399305556,1895,963,569,360,1,359,1,150,0,0.08913649,empty,mBC-0716-2
"G6,D9",6011,6331,4526,1805,3180,20,1501,1525,1097,428,2.563084112,789,1294,687,428,1,427,1,228,0,0.06557377,empty,mBC-0716-2
"G6,D10",16501,17362,12408,4954,8592,0,4199,4206,2942,1264,2.327531646,2104,2405,854,511,1,510,1,193,0,0.066666667,empty,mBC-0716-2
"G6,D11",14081,14699,10670,4029,7202,0,3332,3343,2306,1037,2.223722276,1620,1911,928,555,1,554,1,221,0,0.068592058,empty,mBC-0716-2
"G6,D12",24015,24854,18104,6750,11845,9,5581,5597,4042,1555,2.599356913,2701,2231,1305,795,0,795,0,271,0,0.065408805,empty,mBC-0716-2
"G6,E1",903155,978168,646097,332071,473746,17,258753,259154,215172,43982,4.892274112,139836,58290,37631,20766,6,20760,1,2598,0,0.002312139,mm10,mBC-0716-2
"G6,E2",17996,18068,13344,4724,8678,5,3918,3928,2809,1119,2.510277033,1853,41748,12854,7650,5,7645,1,1622,0,0.088293002,empty,mBC-0716-2
"G6,E3",13075,13509,9899,3610,6473,2,2978,2987,2097,890,2.356179775,1428,1821,993,586,0,586,0,219,0,0.071672355,empty,mBC-0716-2
"G6,E4",16533,16842,12553,4289,8132,6,3709,3735,2602,1133,2.296557811,1745,3709,1323,826,1,825,1,280,0,0.064242424,empty,mBC-0716-2
"G6,E5",22715,23158,17258,5900,11079,0,4893,4908,3440,1468,2.343324251,2277,12722,3729,2239,2,2237,1,679,0,0.028162718,empty,mBC-0716-2
"G6,E6",1445426,1504863,1076275,428588,711367,1,356032,356626,279200,77426,3.606023816,180218,53465,35015,19755,11,19744,4,2679,0,0.001671394,mm10,mBC-0716-2
"G6,E7",14337,14759,11066,3693,7161,0,3269,3271,2273,998,2.27755511,1553,1908,847,522,2,520,1,196,0,0.071153846,empty,mBC-0716-2
"G6,E8",682644,689318,521336,167982,336828,54,151976,152305,113390,38915,2.913786458,72465,15483,8596,5042,1,5041,1,1101,0,0.005554453,mm10,mBC-0716-2
"G6,E9",9542,9962,7299,2663,4731,1,2184,2194,1500,694,2.161383285,1025,887,520,310,0,310,0,119,0,0.109677419,empty,mBC-0716-2
"G6,E10",13629,14317,10434,3883,6961,7,3191,3207,2212,995,2.223115578,1558,1146,701,425,0,425,0,185,0,0.04,empty,mBC-0716-2
"G6,E11",9767,10107,7421,2686,4949,3,2284,2288,1595,693,2.301587302,1076,710,442,291,0,291,0,131,0,0.034364261,empty,mBC-0716-2
"G6,E12",16413,16778,12294,4484,8317,0,3886,3900,2704,1196,2.260869565,1897,940,509,306,0,306,0,124,0,0.058823529,empty,mBC-0716-2
"G6,F1",19006,19615,14567,5048,9614,3,4386,4399,3151,1248,2.524839744,2106,1250,811,505,1,504,1,224,0,0.033730159,empty,mBC-0716-2
"G6,F2",24464,25510,18327,7183,12186,7,5713,5731,4023,1708,2.355386417,2884,25131,7450,4505,1,4504,1,1110,0,0.101021314,empty,mBC-0716-2
"G6,F3",20821,21833,15623,6210,10608,0,5116,5125,3634,1491,2.437290409,2485,1755,1062,658,0,658,0,258,0,0.03343465,empty,mBC-0716-2
"G6,F4",17386,17302,13039,4263,8616,0,3827,3840,2711,1129,2.401240035,1837,1335,546,331,0,331,0,151,0,0.021148036,empty,mBC-0716-2
"G6,F5",25738,26173,19609,6564,12599,1,5790,5807,4085,1722,2.37224158,2722,3227,1408,820,1,819,1,329,0,0.042735043,empty,mBC-0716-2
"G6,F6",24687,25360,18756,6604,12298,0,5636,5652,3978,1674,2.376344086,2834,1917,1098,687,0,687,0,276,0,0.045123726,empty,mBC-0716-2
"G6,F7",21661,22423,16532,5891,10766,0,4888,4901,3365,1536,2.190755208,2337,573,369,225,0,225,0,118,0,0.013333333,empty,mBC-0716-2
"G6,F8",23512,24378,17873,6505,11707,35,5323,5369,3697,1672,2.211124402,2623,324,192,139,0,139,0,90,0,0,empty,mBC-0716-2
"G6,F9",15596,15806,11961,3845,7683,0,3460,3467,2408,1059,2.273843248,1621,3521,1311,783,1,782,1,278,0,0.078005115,empty,mBC-0716-2
"G6,F10",1940239,2059285,1440320,618965,966043,2,497779,498665,414645,84020,4.935074982,255792,112044,68832,38754,17,38737,1,3843,0,0.003743191,mm10,mBC-0716-2
"G6,F11",11658,11788,8914,2874,5845,8,2626,2637,1844,793,2.325346784,1208,869,492,307,0,307,0,153,0,0.026058632,empty,mBC-0716-2
"G6,F12",15194,15881,11280,4601,7548,0,3528,3536,2445,1091,2.241063245,1805,517,217,127,0,127,0,63,0,0.047244094,empty,mBC-0716-2
"G6,G1",807782,862639,600806,261833,414518,0,210858,211271,154695,56576,2.734286623,109361,63312,41098,23543,9,23534,1,2629,0,0.002337044,mm10,mBC-0716-2
"G6,G2",21730,22396,16587,5809,10648,0,4787,4792,3389,1403,2.415538133,2246,498,326,225,0,225,0,125,0,0.008888889,empty,mBC-0716-2
"G6,G3",794516,839367,597089,242278,405577,4,204029,204396,154812,49584,3.122216844,103512,16546,9240,5163,4,5159,1,1182,0,0.012211669,mm10,mBC-0716-2
"G6,G4",963281,1006010,732414,273596,478741,8,221139,221560,190611,30949,6.158874277,109989,963,593,376,0,376,0,130,0,0.002659574,empty,mBC-0716-2
"G6,G5",14579,15459,10883,4576,7500,2,3544,3558,2478,1080,2.294444444,1839,11383,3533,2144,4,2140,1,609,0,0.075233645,empty,mBC-0716-2
"G6,G6",25951,26622,20045,6577,12550,15,5551,5571,3919,1652,2.372276029,2571,213,133,98,0,98,0,60,0,0.020408163,empty,mBC-0716-2
"G6,G7",21040,21675,16245,5430,10470,4,4587,4605,3214,1391,2.310567937,2212,1695,835,496,0,496,0,207,0,0.068548387,empty,mBC-0716-2
"G6,G8",15543,16124,11906,4218,7741,0,3604,3609,2510,1099,2.283894449,1721,1099,648,422,1,421,1,192,0,0.052256532,empty,mBC-0716-2
"G6,G9",11854,12534,9114,3420,5990,0,2757,2768,1914,854,2.241217799,1342,1123,685,414,0,414,0,191,0,0.033816425,empty,mBC-0716-2
"G6,G10",14396,14944,11069,3875,7255,7,3229,3244,2262,982,2.303462322,1557,1288,782,493,1,492,1,200,0,0.048780488,empty,mBC-0716-2
"G6,G11",12932,13395,9905,3490,6474,0,2914,2921,2020,901,2.241953385,1432,505,315,198,0,198,0,103,0,0.015151515,empty,mBC-0716-2
"G6,G12",12079,12272,9049,3223,6068,1,2797,2811,1983,828,2.394927536,1386,4597,1507,947,0,947,0,315,0,0.063357973,empty,mBC-0716-2
"G6,H1",1003955,1111495,711969,399526,533659,1,308329,308734,234071,74663,3.135033417,169752,31100,18267,10092,6,10086,2,1655,0,0.002676978,mm10,mBC-0716-2
"G6,H2",27301,28347,20711,7636,13660,0,6309,6324,4520,1804,2.505543237,3091,1722,1073,655,0,655,0,273,0,0.044274809,empty,mBC-0716-2
"G6,H3",869964,937817,630144,307673,451500,4,241171,241566,181783,59783,3.040713915,129207,46723,27041,15181,9,15172,3,2031,0,0.003559188,mm10,mBC-0716-2
"G6,H4",625754,684440,445018,239422,332704,3,182673,183005,154517,28488,5.423932884,100101,3850,2567,1475,2,1473,2,413,0,0.00203666,mm10,mBC-0716-2
"G6,H5",18965,19241,14452,4789,9251,17,4160,4192,2964,1228,2.413680782,1973,2409,1000,630,0,630,0,243,0,0.063492063,empty,mBC-0716-2
"G6,H6",15842,16178,11942,4236,7930,0,3636,3648,2535,1113,2.277628032,1749,6719,2417,1556,0,1556,0,513,0,0.093830334,empty,mBC-0716-2
"G6,H7",17863,18302,13582,4720,9140,22,4237,4266,2941,1325,2.219622642,2045,2243,990,632,0,632,0,231,0,0.047468354,empty,mBC-0716-2
"G6,H8",14478,14823,10842,3981,7189,0,3371,3380,2328,1052,2.212927757,1652,1128,645,400,0,400,0,216,0,0.0375,empty,mBC-0716-2
"G6,H9",758733,819796,549455,270341,399419,1,212408,212725,174252,38473,4.529202298,114284,52488,34427,19459,6,19453,1,2319,0,0.000719683,mm10,mBC-0716-2
"G6,H10",1305921,1416138,924544,491594,677361,1,370959,371595,309495,62100,4.983816425,202853,167799,109734,62106,17,62089,1,4693,0,0.001787756,mm10,mBC-0716-2
"G6,H11",17597,18312,13452,4860,8868,0,4118,4123,2784,1339,2.079163555,1978,215,119,71,0,71,0,51,0,0.014084507,empty,mBC-0716-2
"G6,H12",6343,6814,4775,2039,3424,0,1675,1682,1223,459,2.664488017,887,478,299,172,0,172,0,87,0,0,empty,mBC-0716-2
"G7,A1",3070272,3384616,2150908,1233708,1607660,5,955592,956843,786820,170023,4.627726837,529748,257008,164049,91552,39,91513,3,5714,0,0.001289434,mm10,mBC-0716-2
"G7,A2",19219,19595,14784,4811,9421,1,4128,4136,2975,1161,2.562446167,1929,1192,681,401,0,401,0,194,0,0.027431421,empty,mBC-0716-2
"G7,A3",692995,706178,515788,190390,345350,17,163909,164251,134185,30066,4.463014701,81406,17840,10067,5843,6,5837,2,1265,0,0.016960768,mm10,mBC-0716-2
"G7,A4",22826,23006,17536,5470,11148,0,4919,4928,3455,1473,2.345553293,2265,2705,988,594,0,594,0,225,0,0.037037037,empty,mBC-0716-2
"G7,A5",17894,18649,13743,4906,9193,0,4277,4282,2992,1290,2.319379845,2064,3000,1908,1122,2,1120,1,374,0,0.001785714,empty,mBC-0716-2
"G7,A6",13647,14192,10233,3959,7024,3,3339,3359,2389,970,2.462886598,1669,6049,2567,1527,1,1526,1,469,0,0.095674967,empty,mBC-0716-2
"G7,A7",16864,17292,12830,4462,8441,0,3905,3916,2710,1206,2.247097844,1903,1922,1153,699,1,698,1,232,0,0.015759312,empty,mBC-0716-2
"G7,A8",11185,11538,8323,3215,5789,32,2622,2660,1857,803,2.312577833,1334,2449,1189,718,0,718,0,261,0,0.050139276,empty,mBC-0716-2
"G7,A9",22984,23428,17447,5981,11378,10,5193,5216,3813,1403,2.717747684,2416,1402,847,514,1,513,1,218,0,0.035087719,empty,mBC-0716-2
"G7,A10",16128,16414,12303,4111,8051,25,3575,3605,2476,1129,2.193091231,1711,425,260,174,0,174,0,99,0,0.034482759,empty,mBC-0716-2
"G7,A11",18790,19553,14358,5195,9518,0,4332,4346,3052,1294,2.358578053,2131,1177,719,449,0,449,0,186,0,0.020044543,empty,mBC-0716-2
"G7,A12",22240,22637,17146,5491,10796,15,4721,4746,3430,1316,2.606382979,2264,2172,1259,722,1,721,1,255,0,0.024965326,empty,mBC-0716-2
"G7,B1",20296,20493,15546,4947,9963,1,4455,4469,3128,1341,2.332587621,2066,1135,713,431,0,431,0,170,0,0.030162413,empty,mBC-0716-2
"G7,B2",21425,21857,16168,5689,10501,0,4824,4831,3414,1417,2.409315455,2328,952,412,252,0,252,0,105,0,0.035714286,empty,mBC-0716-2
"G7,B3",19365,19729,14859,4870,9417,1,4202,4216,2903,1313,2.210967251,1905,1043,681,433,1,432,1,185,0,0.090277778,empty,mBC-0716-2
"G7,B4",16984,17717,12988,4729,8568,0,3895,3902,2811,1091,2.576535289,1909,993,536,344,0,344,0,155,0,0.029069767,empty,mBC-0716-2
"G7,B5",9492,5555,3823,1732,3560,39,1682,1733,1207,526,2.294676806,974,17122,5242,3087,1,3086,1,755,0,0.047310434,empty,mBC-0716-2
"G7,B6",12702,13190,9479,3711,6559,3,3066,3078,2135,943,2.264050901,1518,2717,1378,873,0,873,0,306,0,0.013745704,empty,mBC-0716-2
"G7,B7",17249,17758,13258,4500,8771,1,3941,3960,2799,1161,2.410852713,1856,1760,1127,659,1,658,1,211,0,0.041033435,empty,mBC-0716-2
"G7,B8",13580,14063,10373,3690,6937,0,3121,3136,2235,901,2.480577137,1503,1485,886,515,0,515,0,231,0,0.046601942,empty,mBC-0716-2
"G7,B9",15570,16324,11758,4566,7764,18,3549,3574,2479,1095,2.263926941,1749,666,371,240,0,240,0,130,0,0.091666667,empty,mBC-0716-2
"G7,B10",17085,16932,12623,4309,8601,0,3946,3962,2701,1261,2.141950833,1875,524,276,186,1,185,1,92,0,0.091891892,empty,mBC-0716-2
"G7,B11",16835,17405,12702,4703,8523,19,3942,3964,2836,1128,2.514184397,1918,255,139,92,0,92,0,70,0,0,empty,mBC-0716-2
"G7,B12",19145,19848,14566,5282,9745,0,4512,4527,3226,1301,2.479631053,2170,2634,1124,656,1,655,1,258,0,0.029007634,empty,mBC-0716-2
"G7,C1",25374,25621,19576,6045,12236,39,5310,5362,3739,1623,2.303758472,2430,932,519,332,0,332,0,131,0,0,empty,mBC-0716-2
"G7,C2",2735438,2914701,1996827,917874,1350897,45,721848,723075,597887,125188,4.775913027,378882,161512,103411,57805,23,57782,5,4602,0,0.000848015,mm10,mBC-0716-2
"G7,C3",21279,22007,15971,6036,10603,3,4933,4946,3440,1506,2.284196547,2429,1409,593,386,0,386,0,167,0,0.049222798,empty,mBC-0716-2
"G7,C4",1030930,1085824,760622,325202,522919,0,263254,263739,218016,45723,4.768191064,136058,70108,41030,23108,5,23103,2,2686,0,0.026057222,mm10,mBC-0716-2
"G7,C5",17612,18106,13052,5054,8646,2,4083,4095,2898,1197,2.421052632,1946,4317,2112,1301,1,1300,1,396,0,0.186923077,empty,mBC-0716-2
"G7,C6",17513,18067,13281,4786,8827,6,4116,4129,2893,1236,2.340614887,1941,4270,2140,1214,0,1214,0,386,0,0.037891269,empty,mBC-0716-2
"G7,C7",877136,980847,612874,367973,476343,4,276777,277145,231902,45243,5.125699003,155671,22006,14332,8318,2,8316,1,1338,0,0.000841751,mm10,mBC-0716-2
"G7,C8",1075210,1176281,757287,418994,570211,0,326240,326740,251041,75699,3.316305367,179386,94577,60389,33573,11,33562,1,3236,0,0.000923664,mm10,mBC-0716-2
"G7,C9",13791,14162,10355,3807,6820,1,3162,3172,2136,1036,2.061776062,1517,785,453,315,0,315,0,148,0,0.034920635,empty,mBC-0716-2
"G7,C10",14461,14731,11017,3714,7044,0,3198,3204,2158,1046,2.063097514,1521,955,527,330,0,330,0,156,0,0.042424242,empty,mBC-0716-2
"G7,C11",987975,1039168,739134,300034,495546,2,242262,242772,205334,37438,5.484641274,122925,88953,54091,30264,18,30246,4,3115,0,0.001157178,mm10,mBC-0716-2
"G7,C12",20454,20786,15330,5456,10048,9,4510,4532,3222,1310,2.459541985,2197,1225,651,406,1,405,1,147,0,0.044444444,empty,mBC-0716-2
"G7,D1",12381,12510,8836,3674,6128,1,2950,2959,2040,919,2.219804135,1500,12716,3861,2369,3,2366,2,598,0,0.14454776,empty,mBC-0716-2
"G7,D2",21846,22023,16849,5174,10803,19,4722,4755,3370,1385,2.433212996,2162,3444,1683,1033,1,1032,1,370,0,0.093992248,empty,mBC-0716-2
"G7,D3",14352,14761,10784,3977,7248,4,3303,3320,2254,1066,2.114446529,1591,2611,1033,652,0,652,0,254,0,0.049079755,empty,mBC-0716-2
"G7,D4",15158,15754,11544,4210,7683,14,3528,3549,2497,1052,2.373574144,1717,1509,886,501,0,501,0,238,0,0.001996008,empty,mBC-0716-2
"G7,D5",13732,14276,10486,3790,7035,0,3269,3280,2284,996,2.293172691,1570,1897,1166,691,1,690,1,241,0,0.027536232,empty,mBC-0716-2
"G7,D6",12773,13346,9703,3643,6545,30,2998,3035,2046,989,2.06875632,1520,1840,1124,687,0,687,0,249,0,0.036390102,empty,mBC-0716-2
"G7,D7",13047,13414,9944,3470,6584,0,2983,2990,2080,910,2.285714286,1394,1889,1176,713,1,712,1,230,0,0.029494382,empty,mBC-0716-2
"G7,D8",17291,18321,12968,5353,8726,24,4172,4207,2855,1352,2.111686391,2105,5454,1918,1162,0,1162,0,391,0,0.050774527,empty,mBC-0716-2
"G7,D9",4894,4830,3653,1177,2506,0,1152,1155,823,332,2.478915663,577,1923,1117,648,0,648,0,296,0,0.007716049,empty,mBC-0716-2
"G7,D10",14580,15194,11015,4179,7262,0,3424,3427,2375,1052,2.257604563,1668,848,496,275,0,275,0,124,0,0.036363636,empty,mBC-0716-2
"G7,D11",13603,14037,10428,3609,6968,0,3179,3191,2173,1018,2.134577603,1516,1473,863,539,0,539,0,230,0,0.016697588,empty,mBC-0716-2
"G7,D12",21055,21569,16087,5482,10325,8,4597,4613,3251,1362,2.386930984,2155,1907,1147,738,0,738,0,280,0,0.08401084,empty,mBC-0716-2
"G7,E1",21981,22588,16856,5732,10974,0,4837,4848,3430,1418,2.418899859,2329,1534,955,584,2,582,1,245,0,0.065292096,empty,mBC-0716-2
"G7,E2",16972,17339,12991,4348,8554,5,3869,3886,2717,1169,2.324208725,1838,1329,776,451,0,451,0,210,0,0.042128603,empty,mBC-0716-2
"G7,E3",1632844,1755594,1176740,578854,837155,2,460983,461725,368401,93324,3.947548326,245489,85916,55858,31086,9,31077,1,3493,0,0.001866332,mm10,mBC-0716-2
"G7,E4",16153,16418,12467,3951,7958,1,3545,3551,2464,1087,2.266789328,1606,1206,709,450,0,450,0,195,0,0.031111111,empty,mBC-0716-2
"G7,E5",23071,23122,17784,5338,11319,26,4937,4973,3542,1431,2.475192173,2281,2574,1575,921,0,921,0,352,0,0.008686211,empty,mBC-0716-2
"G7,E6",13808,14446,10444,4002,7028,12,3204,3226,2195,1031,2.12900097,1600,3434,2135,1294,0,1294,0,389,0,0.027047913,empty,mBC-0716-2
"G7,E7",14450,14823,11060,3763,7247,9,3338,3363,2346,1017,2.306784661,1614,2228,1365,795,1,794,1,257,0,0.010075567,empty,mBC-0716-2
"G7,E8",18411,18611,14179,4432,9045,0,3978,3991,2758,1233,2.236820762,1805,2665,1590,930,0,930,0,286,0,0.047311828,empty,mBC-0716-2
"G7,E9",9147,9246,6945,2301,4558,0,2053,2061,1399,662,2.113293051,941,3329,1208,697,0,697,0,253,0,0.058823529,empty,mBC-0716-2
"G7,E10",755479,846251,528770,317481,415604,0,242880,243231,194609,48622,4.002488585,137215,52820,34811,19813,1,19812,1,2358,0,0.00090854,mm10,mBC-0716-2
"G7,E11",9595,9718,7346,2372,4919,7,2225,2239,1516,723,2.096818811,1043,1103,640,388,0,388,0,193,0,0.007731959,empty,mBC-0716-2
"G7,E12",640087,703045,464535,238510,346227,2,188554,188857,149912,38945,3.849325973,102112,26091,14533,8148,5,8143,2,1569,0,0.01338573,mm10,mBC-0716-2
"G7,F1",843069,885069,638332,246737,424117,8,197821,198170,166225,31945,5.203474722,99357,108729,70235,38990,18,38972,2,3482,0,0.00138561,mm10,mBC-0716-2
"G7,F2",23346,24091,17739,6352,11713,1,5403,5415,3746,1669,2.244457759,2636,2917,1785,1084,0,1084,0,408,0,0.053505535,empty,mBC-0716-2
"G7,F3",16697,17575,12544,5031,8606,3,4127,4138,2843,1295,2.195366795,2090,4693,1917,1168,2,1166,1,407,0,0.02915952,empty,mBC-0716-2
"G7,F4",16244,16391,12321,4070,8042,32,3578,3624,2558,1066,2.399624765,1661,565,327,205,0,205,0,75,0,0.073170732,empty,mBC-0716-2
"G7,F5",25957,26762,19806,6956,12822,11,5823,5855,4168,1687,2.470657973,2758,2742,1646,1013,0,1013,0,370,0,0.010858835,empty,mBC-0716-2
"G7,F6",23456,24402,17904,6498,11611,1,5347,5364,3733,1631,2.28877989,2535,2502,1554,927,0,927,0,323,0,0.047464941,empty,mBC-0716-2
"G7,F7",27076,28582,20831,7751,13859,3,6383,6398,4601,1797,2.560378408,3127,1459,901,518,1,517,1,198,0,0.030947776,empty,mBC-0716-2
"G7,F8",23234,24153,17617,6536,11586,15,5305,5335,3782,1553,2.435286542,2573,361,233,145,0,145,0,97,0,0.013793103,empty,mBC-0716-2
"G7,F9",15885,15947,12180,3767,7701,0,3380,3383,2376,1007,2.359483615,1496,10167,3043,1882,3,1879,1,557,0,0.026077701,empty,mBC-0716-2
"G7,F10",1596881,1769715,1082501,687214,831499,1,511973,512690,429718,82972,5.179072458,286125,85364,49444,27524,12,27512,1,2952,0,0.007051468,mm10,mBC-0716-2
"G7,F11",11653,11846,8983,2863,5788,0,2558,2571,1780,791,2.250316056,1188,1038,630,398,0,398,0,198,0,0.007537688,empty,mBC-0716-2
"G7,F12",15074,15429,11156,4273,7423,0,3385,3395,2312,1083,2.134810711,1680,848,300,192,0,192,0,98,0,0.026041667,empty,mBC-0716-2
"G7,G1",10976,11211,8351,2860,5508,23,2492,2522,1742,780,2.233333333,1191,1511,960,588,0,588,0,202,0,0.017006803,empty,mBC-0716-2
"G7,G2",1259201,1355897,903382,452515,642551,40,356455,357049,261768,95281,2.747326329,189181,29563,19684,11078,5,11073,1,1689,0,0.002528673,mm10,mBC-0716-2
"G7,G3",20509,21033,15681,5352,10248,2,4719,4732,3214,1518,2.117259552,2208,1809,1100,713,0,713,0,277,0,0.060308555,empty,mBC-0716-2
"G7,G4",1375639,1499452,974384,525068,706355,28,398641,399321,313285,86036,3.641324562,218237,1102,716,435,1,434,1,155,0,0,empty,mBC-0716-2
"G7,G5",1012730,1076056,752153,323903,508534,0,249502,249948,218452,31496,6.935864872,127670,120841,78592,43623,27,43596,1,3765,0,0.001284522,mm10,mBC-0716-2
"G7,G6",26033,26477,19987,6490,12642,36,5552,5605,3930,1675,2.346268657,2552,236,139,90,0,90,0,68,0,0,empty,mBC-0716-2
"G7,G7",21355,22043,16680,5363,10695,23,4742,4777,3396,1381,2.459087618,2236,2289,1433,877,0,877,0,326,0,0.049030787,empty,mBC-0716-2
"G7,G8",15202,15970,11502,4468,7929,0,3756,3766,2561,1205,2.125311203,1919,2067,1355,830,1,829,1,296,0,0.028950543,empty,mBC-0716-2
"G7,G9",11044,11581,8409,3172,5651,0,2726,2729,1883,846,2.225768322,1318,1618,798,506,0,506,0,225,0,0.079051383,empty,mBC-0716-2
"G7,G10",13991,14105,10823,3282,6917,0,2976,2980,2084,896,2.325892857,1356,1290,770,463,0,463,0,224,0,0.032397408,empty,mBC-0716-2
"G7,G11",12841,13085,9652,3433,6460,20,2961,2991,2107,884,2.383484163,1469,614,392,248,0,248,0,105,0,0.040322581,empty,mBC-0716-2
"G7,G12",787189,883676,554313,329363,440094,2,254780,255117,197342,57775,3.415698832,143760,75847,45985,25897,13,25884,2,2740,0,0.034577345,mm10,mBC-0716-2
"G7,H1",21642,22133,16493,5640,10771,46,4785,4837,3428,1409,2.432931157,2310,976,582,359,0,359,0,158,0,0.002785515,empty,mBC-0716-2
"G7,H2",25308,26113,19226,6887,12567,7,5789,5806,4041,1765,2.289518414,2839,2298,1358,829,0,829,0,330,0,0.051869723,empty,mBC-0716-2
"G7,H3",888699,978808,637817,340991,473737,1,262376,262807,213711,49096,4.352920808,144375,52238,31273,17407,5,17402,2,2225,0,0.00258591,mm10,mBC-0716-2
"G7,H4",142704,145011,90099,54912,70993,5,42363,42427,27604,14823,1.862241112,24032,411,227,145,0,145,0,80,0,0,empty,mBC-0716-2
"G7,H5",18037,18832,13653,5179,9094,4,4226,4247,2956,1291,2.289697909,2102,1993,1205,718,0,718,0,280,0,0.025069638,empty,mBC-0716-2
"G7,H6",14861,15240,11188,4052,7586,4,3509,3517,2472,1045,2.365550239,1698,1728,1070,660,0,660,0,245,0,0.021212121,empty,mBC-0716-2
"G7,H7",17277,17697,13069,4628,8753,0,3985,3993,2789,1204,2.316445183,2020,2021,1144,680,1,679,1,259,0,0.014727541,empty,mBC-0716-2
"G7,H8",14303,14606,10719,3887,7053,10,3243,3258,2301,957,2.404388715,1569,11382,4150,2516,2,2514,1,680,0,0.179395386,empty,mBC-0716-2
"G7,H9",16631,17019,12651,4368,8331,5,3767,3777,2663,1114,2.39048474,1812,1155,636,422,0,422,0,236,0,0.002369668,empty,mBC-0716-2
"G7,H10",15704,16403,11735,4668,7999,35,3722,3759,2631,1128,2.332446809,1896,1649,797,516,0,516,0,256,0,0.073643411,empty,mBC-0716-2
"G7,H11",17127,17959,12854,5105,8740,12,4173,4196,2897,1299,2.230177059,2123,255,135,102,0,102,0,71,0,0.019607843,empty,mBC-0716-2
"G7,H12",6323,6573,4759,1814,3195,14,1456,1472,1006,466,2.158798283,700,1189,486,294,0,294,0,116,0,0.027210884,empty,mBC-0716-2
"G8,A1",14147,14377,10663,3714,7168,0,3302,3307,2308,999,2.31031031,1585,920,554,350,2,348,1,146,0,0.00862069,empty,mBC-0716-2
"G8,A2",19171,19295,14698,4597,9361,0,4125,4139,2923,1216,2.403782895,1971,995,591,358,1,357,1,169,0,0.053221289,empty,mBC-0716-2
"G8,A3",17241,17809,13106,4703,8593,0,3972,3980,2842,1138,2.497363796,1921,2712,1049,680,0,680,0,263,0,0.057352941,empty,mBC-0716-2
"G8,A4",1321717,1469441,921476,547965,689814,1,407118,407791,303044,104747,2.893104337,229746,18284,11357,6475,6,6469,3,1211,0,0.001545834,mm10,mBC-0716-2
"G8,A5",18295,19135,14048,5087,9376,1,4423,4428,3111,1317,2.362186788,2122,1342,813,517,0,517,0,197,0,0.106382979,empty,mBC-0716-2
"G8,A6",35000,38435,24926,13509,19358,0,10733,10743,8581,2162,3.969010176,5851,21050,6589,4090,6,4084,3,932,0,0.132468168,empty,mBC-0716-2
"G8,A7",17065,17544,12946,4598,8542,0,3895,3908,2732,1176,2.323129252,1900,932,561,331,0,331,0,140,0,0.018126888,empty,mBC-0716-2
"G8,A8",11515,12097,8590,3507,5808,0,2701,2706,1940,766,2.532637076,1342,1216,708,441,0,441,0,195,0,0.088435374,empty,mBC-0716-2
"G8,A9",20108,20217,15453,4764,9662,1,4214,4217,2966,1251,2.370903277,1965,1114,678,407,0,407,0,184,0,0.017199017,empty,mBC-0716-2
"G8,A10",16172,16228,12250,3978,7895,0,3639,3653,2550,1103,2.3118767,1684,332,216,136,0,136,0,80,0,0,empty,mBC-0716-2
"G8,A11",18930,19234,14489,4745,9365,0,4129,4147,2830,1317,2.148823083,1952,1810,904,552,1,551,1,219,0,0.050816697,empty,mBC-0716-2
"G8,A12",22074,22501,16875,5626,10705,0,4754,4766,3303,1463,2.257689679,2254,2356,1323,768,0,768,0,253,0,0.057291667,empty,mBC-0716-2
"G8,B1",20590,20862,15665,5197,10207,34,4584,4629,3160,1469,2.151123213,2209,1020,625,335,0,335,0,154,0,0.092537313,empty,mBC-0716-2
"G8,B2",21655,22223,16553,5670,10498,0,4779,4789,3291,1498,2.196929239,2247,497,272,163,0,163,0,79,0,0.012269939,empty,mBC-0716-2
"G8,B3",19774,19995,15288,4707,9620,2,4223,4230,2933,1297,2.261372398,1906,1979,846,547,0,547,0,205,0,0.047531993,empty,mBC-0716-2
"G8,B4",17641,18209,13629,4580,8876,1,4026,4032,2894,1138,2.543057996,1919,995,605,340,0,340,0,145,0,0.082352941,empty,mBC-0716-2
"G8,B5",500599,268277,191398,76879,172977,3,82715,83304,62247,21057,2.956119105,44548,5718,2770,1611,1,1610,1,538,0,0.013664596,mm10,mBC-0716-2
"G8,B6",12922,13504,9691,3813,6628,18,3112,3135,2182,953,2.289611752,1558,876,510,298,0,298,0,152,0,0.016778523,empty,mBC-0716-2
"G8,B7",17395,18054,13672,4382,8783,0,3918,3929,2753,1176,2.340986395,1773,714,450,274,0,274,0,135,0,0.02919708,empty,mBC-0716-2
"G8,B8",14213,14844,10908,3936,7164,0,3251,3264,2295,969,2.368421053,1517,977,616,377,1,376,1,167,0,0.018617021,empty,mBC-0716-2
"G8,B9",16421,16891,12365,4526,7980,2,3583,3593,2522,1071,2.35480859,1731,2295,680,427,0,427,0,173,0,0.025761124,empty,mBC-0716-2
"G8,B10",17891,18259,13391,4868,8900,0,4167,4184,2933,1251,2.34452438,2001,3425,1105,667,2,665,1,228,0,0.02406015,empty,mBC-0716-2
"G8,B11",17343,17797,13120,4677,8556,1,3967,3979,2747,1232,2.229707792,1902,161,99,66,0,66,0,49,0,0,empty,mBC-0716-2
"G8,B12",19263,20106,14638,5468,9774,1,4420,4434,3139,1295,2.423938224,2184,1029,579,348,0,348,0,166,0,0.025862069,empty,mBC-0716-2
"G8,C1",23803,23673,18454,5219,11384,8,4821,4848,3378,1470,2.297959184,2132,3353,1043,647,0,647,0,213,0,0.035548686,empty,mBC-0716-2
"G8,C2",19174,19499,14525,4974,9327,34,4253,4303,2941,1362,2.159324523,2046,1350,810,445,0,445,0,173,0,0.020224719,empty,mBC-0716-2
"G8,C3",21101,21567,16104,5463,10372,0,4731,4753,3292,1461,2.253251198,2279,518,288,174,0,174,0,97,0,0,empty,mBC-0716-2
"G8,C4",17878,18080,13624,4456,8806,0,3915,3916,2790,1126,2.477797513,1882,903,502,315,0,315,0,140,0,0.057142857,empty,mBC-0716-2
"G8,C5",17398,17907,13068,4839,8562,0,3966,3967,2789,1178,2.367572156,1926,946,550,354,0,354,0,161,0,0.059322034,empty,mBC-0716-2
"G8,C6",17236,17366,12879,4487,8656,3,3910,3918,2763,1155,2.392207792,1854,1101,673,419,0,419,0,183,0,0.040572792,empty,mBC-0716-2
"G8,C7",17001,17704,12870,4834,8559,3,4011,4023,2761,1262,2.187797147,2004,404,258,150,0,150,0,75,0,0,empty,mBC-0716-2
"G8,C8",2257895,2446644,1588456,858188,1147566,1,658648,659569,546991,112578,4.858773473,359076,232628,149622,84667,32,84635,4,5343,0,0.000897974,mm10,mBC-0716-2
"G8,C9",13789,14341,10277,4064,6883,0,3310,3312,2293,1019,2.250245339,1609,843,488,272,0,272,0,110,0,0.084558824,empty,mBC-0716-2
"G8,C10",14934,15141,11434,3707,7356,0,3328,3335,2348,987,2.378926039,1513,1975,809,484,0,484,0,194,0,0.04338843,empty,mBC-0716-2
"G8,C11",899270,976946,656361,320585,471056,0,255785,256184,204318,51866,3.939343693,135870,32334,21258,11919,5,11914,1,1849,0,0.002182307,mm10,mBC-0716-2
"G8,C12",20608,21213,15510,5703,10319,0,4746,4760,3372,1388,2.429394813,2376,1039,599,337,1,336,1,145,0,0.053571429,empty,mBC-0716-2
"G8,D1",11654,12130,8683,3447,5977,2,2847,2856,1944,912,2.131578947,1474,517,252,155,0,155,0,82,0,0.038709677,empty,mBC-0716-2
"G8,D2",25645,26358,19841,6517,12683,1,5547,5557,3968,1589,2.49716803,2597,2008,1279,798,0,798,0,314,0,0.062656642,empty,mBC-0716-2
"G8,D3",14760,15425,11007,4418,7391,10,3550,3571,2474,1097,2.255241568,1795,2934,1162,684,0,684,0,242,0,0.052631579,empty,mBC-0716-2
"G8,D4",16151,16478,12248,4230,7990,0,3689,3701,2569,1132,2.269434629,1728,1688,923,586,0,586,0,258,0,0.068259386,empty,mBC-0716-2
"G8,D5",14109,14766,10701,4065,7108,0,3319,3322,2346,976,2.403688525,1654,969,621,360,1,359,1,141,0,0.005571031,empty,mBC-0716-2
"G8,D6",12835,13343,9661,3682,6557,0,3082,3092,2153,939,2.29286475,1544,1089,636,431,0,431,0,176,0,0.106728538,empty,mBC-0716-2
"G8,D7",13477,13810,10183,3627,6748,12,3058,3078,2093,985,2.124873096,1479,1060,563,346,0,346,0,152,0,0.069364162,empty,mBC-0716-2
"G8,D8",16928,17863,12888,4975,8527,8,4063,4079,2858,1221,2.340704341,1989,788,487,293,0,293,0,146,0,0.088737201,empty,mBC-0716-2
"G8,D9",4825,4988,3563,1425,2516,2,1229,1231,881,350,2.517142857,607,1182,698,432,0,432,0,202,0,0.055555556,empty,mBC-0716-2
"G8,D10",16337,16421,12001,4420,7295,19,3414,3446,2418,1028,2.352140078,1632,1836,729,426,0,426,0,205,0,0.082159624,empty,mBC-0716-2
"G8,D11",863770,965848,609686,356162,466824,2,269112,269541,190858,78683,2.425657385,152799,70796,47276,26709,14,26695,1,2861,0,0.000861585,mm10,mBC-0716-2
"G8,D12",21578,22297,16519,5778,10640,6,4817,4836,3355,1481,2.265361242,2290,1960,1205,702,1,701,1,238,0,0.045649073,empty,mBC-0716-2
"G8,E1",22773,23145,17588,5557,11217,4,4917,4933,3418,1515,2.256105611,2275,1253,756,466,1,465,1,204,0,0.051612903,empty,mBC-0716-2
"G8,E2",16695,17112,12667,4445,8352,0,3728,3735,2528,1207,2.094449047,1746,1181,645,419,0,419,0,177,0,0.031026253,empty,mBC-0716-2
"G8,E3",13437,14189,10457,3732,6827,7,3094,3105,2174,931,2.335123523,1470,1062,651,420,0,420,0,190,0,0.073809524,empty,mBC-0716-2
"G8,E4",16538,17120,12619,4501,8264,25,3793,3827,2701,1126,2.398756661,1836,836,473,291,0,291,0,152,0,0.017182131,empty,mBC-0716-2
"G8,E5",26062,26391,20086,6305,12835,2,5755,5776,3989,1787,2.232232792,2731,1339,866,507,0,507,0,224,0,0.059171598,empty,mBC-0716-2
"G8,E6",14453,14802,11150,3652,7032,0,3095,3098,2195,903,2.430786268,1440,1416,919,579,0,579,0,238,0,0.056994819,empty,mBC-0716-2
"G8,E7",2572612,2844336,1786512,1057824,1331272,10,800614,801803,666488,135315,4.925455419,447019,163256,104608,59022,27,58995,1,4648,0,0.001457751,mm10,mBC-0716-2
"G8,E8",18743,18901,14386,4515,9188,7,3989,4016,2807,1209,2.321753515,1874,1333,764,427,0,427,0,180,0,0.058548009,empty,mBC-0716-2
"G8,E9",9081,9236,6939,2297,4576,0,2123,2127,1487,640,2.3234375,994,793,451,247,0,247,0,114,0,0.085020243,empty,mBC-0716-2
"G8,E10",13959,14577,10622,3955,6990,0,3212,3224,2239,985,2.273096447,1560,1035,616,383,0,383,0,155,0,0.09921671,empty,mBC-0716-2
"G8,E11",9394,9670,7167,2503,4797,8,2201,2214,1501,713,2.105189341,1058,861,506,305,0,305,0,143,0,0.06557377,empty,mBC-0716-2
"G8,E12",15226,16160,11426,4734,7839,6,3646,3663,2544,1119,2.273458445,1827,948,552,311,0,311,0,126,0,0.022508039,empty,mBC-0716-2
"G8,F1",1917375,2135223,1354288,780935,1004830,8,583306,584207,397047,187160,2.121430861,334426,129928,85369,47529,10,47519,1,3919,0,0.000631326,mm10,mBC-0716-2
"G8,F2",24935,25695,18796,6899,12327,9,5690,5709,3996,1713,2.332749562,2824,5410,2512,1586,0,1586,0,480,0,0.180958386,empty,mBC-0716-2
"G8,F3",17234,17964,13003,4961,8915,0,4259,4270,2967,1303,2.277052955,2122,1916,1011,619,2,617,1,278,0,0.055105348,empty,mBC-0716-2
"G8,F4",16102,16564,12378,4186,8234,23,3653,3684,2538,1146,2.214659686,1729,333,167,120,0,120,0,73,0,0.008333333,empty,mBC-0716-2
"G8,F5",26667,27787,20206,7581,13266,1,6141,6153,4456,1697,2.625810253,3080,1596,886,582,0,582,0,263,0,0.032646048,empty,mBC-0716-2
"G8,F6",29582,30847,22524,8323,14715,7,6864,6889,4937,1952,2.52920082,3413,6847,2440,1417,1,1416,1,448,0,0.016242938,empty,mBC-0716-2
"G8,F7",21850,22190,16650,5540,10741,16,4840,4868,3444,1424,2.418539326,2202,3465,1246,766,0,766,0,267,0,0.061357702,empty,mBC-0716-2
"G8,F8",23658,24596,18015,6581,11939,0,5539,5554,3891,1663,2.339747444,2713,312,182,118,0,118,0,69,0,0.016949153,empty,mBC-0716-2
"G8,F9",588006,587575,447502,140073,288378,5,125745,125978,101329,24649,4.110876709,59817,12484,6785,3869,3,3866,1,1050,0,0.007759959,mm10,mBC-0716-2
"G8,F10",1218519,1279050,912332,366718,600550,0,293181,293738,252126,41612,6.058973373,147307,89405,53196,29746,16,29730,3,3138,0,0.005785402,mm10,mBC-0716-2
"G8,F11",13012,13079,9860,3219,6372,0,2889,2897,1990,907,2.194046307,1388,897,555,305,0,305,0,159,0,0.045901639,empty,mBC-0716-2
"G8,F12",15441,16132,11740,4392,7672,0,3516,3521,2467,1054,2.340607211,1737,135,66,53,0,53,0,41,0,0,empty,mBC-0716-2
"G8,G1",11130,11567,8487,3080,5573,3,2557,2567,1780,787,2.261753494,1260,3666,1550,925,0,925,0,283,0,0.148108108,empty,mBC-0716-2
"G8,G2",22549,23059,17189,5870,10965,0,4893,4903,3450,1453,2.374397798,2297,636,373,234,1,233,1,122,0,0.064377682,empty,mBC-0716-2
"G8,G3",935923,1021186,671225,349961,486570,2,255423,255805,220354,35451,6.215734394,138475,204137,129355,72874,35,72839,3,5007,0,0.001798487,mm10,mBC-0716-2
"G8,G4",30389,31180,23328,7852,14956,1,6765,6789,4727,2062,2.29243453,3208,148,96,69,0,69,0,46,0,0,empty,mBC-0716-2
"G8,G5",14596,14955,11062,3893,7147,6,3261,3284,2280,1004,2.270916335,1536,4008,1377,854,1,853,1,332,0,0.009378664,empty,mBC-0716-2
"G8,G6",26326,27362,20169,7193,13019,59,5776,5850,4155,1695,2.451327434,2839,155,103,71,0,71,0,51,0,0,empty,mBC-0716-2
"G8,G7",21525,22026,16725,5301,10674,0,4597,4602,3307,1295,2.553667954,2132,1368,751,466,0,466,0,225,0,0.051502146,empty,mBC-0716-2
"G8,G8",15835,16554,11854,4700,7939,13,3712,3725,2558,1167,2.191945159,1846,1203,758,447,0,447,0,196,0,0.029082774,empty,mBC-0716-2
"G8,G9",11196,11636,8506,3130,5647,0,2654,2657,1887,770,2.450649351,1288,5917,2327,1425,0,1425,0,413,0,0.187368421,empty,mBC-0716-2
"G8,G10",14712,15104,11114,3990,7339,10,3328,3344,2291,1053,2.175688509,1594,1408,946,565,0,565,0,235,0,0.024778761,empty,mBC-0716-2
"G8,G11",12953,13145,9866,3279,6331,0,2933,2937,2063,874,2.360411899,1354,551,357,226,0,226,0,100,0,0.039823009,empty,mBC-0716-2
"G8,G12",12194,12564,9169,3395,6121,0,2806,2810,1921,889,2.160854893,1338,1294,675,366,0,366,0,139,0,0.095628415,empty,mBC-0716-2
"G8,H1",22027,22533,16886,5647,10826,0,4854,4861,3468,1393,2.489590811,2265,702,401,237,0,237,0,115,0,0.025316456,empty,mBC-0716-2
"G8,H2",27460,28292,20938,7354,13665,0,6227,6242,4410,1832,2.40720524,2982,1949,1224,737,1,736,1,278,0,0.012228261,empty,mBC-0716-2
"G8,H3",22216,22615,16511,6104,10996,114,4930,5059,3609,1450,2.488965517,2514,1455,838,501,0,501,0,208,0,0.067864271,empty,mBC-0716-2
"G8,H4",14192,14850,10705,4145,7282,0,3397,3405,2369,1036,2.286679537,1707,184,119,87,0,87,0,67,0,0.011494253,empty,mBC-0716-2
"G8,H5",2125969,2385079,1472313,912766,1110659,9,667638,668590,517052,151538,3.412028666,380093,137439,91922,51378,17,51361,2,4370,0,0.000506221,mm10,mBC-0716-2
"G8,H6",14317,14612,10731,3881,7243,0,3372,3382,2396,986,2.430020284,1658,1361,840,503,0,503,0,199,0,0.027833002,empty,mBC-0716-2
"G8,H7",17773,18293,13383,4910,8939,1,4089,4100,2819,1281,2.200624512,2003,4054,1394,909,0,909,0,335,0,0.01980198,empty,mBC-0716-2
"G8,H8",14322,14626,10772,3854,6977,24,3218,3247,2315,932,2.483905579,1544,2123,1063,607,0,607,0,251,0,0.039538715,empty,mBC-0716-2
"G8,H9",17248,17739,13060,4679,8626,14,3943,3962,2853,1109,2.572587917,1889,1130,689,436,0,436,0,209,0,0.002293578,empty,mBC-0716-2
"G8,H10",15229,16014,11449,4565,7711,0,3610,3621,2488,1133,2.195939982,1838,3657,1336,798,1,797,1,318,0,0.020075282,empty,mBC-0716-2
"G8,H11",17925,18704,13474,5230,9048,0,4290,4305,2954,1351,2.186528497,2125,188,92,64,0,64,0,43,0,0,empty,mBC-0716-2
"G8,H12",6208,6260,4627,1633,3126,0,1484,1486,1044,442,2.36199095,717,592,349,195,0,195,0,90,0,0.097435897,empty,mBC-0716-2
"G9,A1",13351,13774,10259,3515,6943,0,3175,3182,2246,936,2.39957265,1510,1289,726,454,1,453,1,214,0,0.030905077,empty,mBC-0716-2
"G9,A2",749214,786052,536700,249352,380252,18,199869,200186,170944,29242,5.845838178,104914,81398,47843,27895,12,27883,3,3242,0,0.006850052,mm10,mBC-0716-2
"G9,A3",900760,1041892,589129,452763,504642,1,324008,324419,268282,56137,4.779058375,192342,48930,31137,18181,11,18170,2,2396,0,0.001155751,mm10,mBC-0716-2
"G9,A4",22724,23289,17443,5846,11000,122,4740,4876,3423,1453,2.355815554,2275,827,458,313,0,313,0,174,0,0.044728435,empty,mBC-0716-2
"G9,A5",1061339,1150374,734007,416367,555846,2,334219,334668,272315,62353,4.367311918,182542,23223,14512,8585,4,8581,1,1717,0,0.012003263,mm10,mBC-0716-2
"G9,A6",13132,14041,9961,4080,6866,0,3289,3293,2338,955,2.448167539,1652,1659,969,638,0,638,0,308,0,0.045454545,empty,mBC-0716-2
"G9,A7",16177,16656,12286,4370,8079,0,3770,3775,2647,1128,2.346631206,1833,1405,829,532,0,532,0,216,0,0.056390977,empty,mBC-0716-2
"G9,A8",11076,11682,8424,3258,5662,0,2665,2669,1859,810,2.295061728,1292,1769,899,591,0,591,0,285,0,0.040609137,empty,mBC-0716-2
"G9,A9",887900,899766,661776,237990,431070,1,207217,207577,163920,43657,3.754724328,101355,37923,19112,11175,3,11172,2,2153,0,0.025152166,mm10,mBC-0716-2
"G9,A10",16191,16500,12177,4323,7974,0,3673,3681,2498,1183,2.111580727,1740,629,330,234,0,234,0,147,0,0.008547009,empty,mBC-0716-2
"G9,A11",18213,18449,13922,4527,9001,43,3988,4038,2823,1215,2.32345679,1855,1506,956,554,0,554,0,237,0,0.036101083,empty,mBC-0716-2
"G9,A12",21728,22153,16585,5568,10532,0,4630,4641,3313,1328,2.494728916,2113,2558,1650,1000,2,998,1,330,0,0.058116232,empty,mBC-0716-2
"G9,B1",19651,20179,14989,5190,9874,1,4532,4549,3261,1288,2.531832298,2156,1485,899,573,0,573,0,237,0,0.027923211,empty,mBC-0716-2
"G9,B2",21463,22094,16311,5783,10813,1,4903,4921,3464,1457,2.377487989,2450,509,300,201,1,200,1,111,0,0,empty,mBC-0716-2
"G9,B3",820733,920462,581587,338875,448172,32,256812,257178,214253,42925,4.991333722,143440,73022,45129,25762,9,25753,2,3007,0,0.001087252,mm10,mBC-0716-2
"G9,B4",17181,17624,12995,4629,8651,0,4023,4041,2724,1317,2.06833713,1942,3991,1463,954,0,954,0,345,0,0.080712788,empty,mBC-0716-2
"G9,B5",459770,233530,167474,66056,151067,5,69092,69746,45199,24547,1.841324805,38610,3309,1944,1165,0,1165,0,414,0,0.00944206,mm10,mBC-0716-2
"G9,B6",12264,12803,9261,3542,6423,0,3070,3075,2140,935,2.288770053,1507,1290,782,506,1,505,1,246,0,0.025742574,empty,mBC-0716-2
"G9,B7",16899,17509,13064,4445,8581,16,3874,3898,2749,1149,2.392515231,1861,971,590,373,0,373,0,170,0,0.040214477,empty,mBC-0716-2
"G9,B8",13929,14139,10637,3502,6879,1,3098,3100,2097,1003,2.090727817,1473,1323,789,506,1,505,1,246,0,0.027722772,empty,mBC-0716-2
"G9,B9",15934,16759,12327,4432,8018,0,3639,3645,2536,1109,2.286744815,1729,831,462,324,0,324,0,169,0,0.046296296,empty,mBC-0716-2
"G9,B10",16547,16697,12257,4440,8186,1,3769,3783,2646,1137,2.327176781,1788,837,403,256,0,256,0,118,0,0.10546875,empty,mBC-0716-2
"G9,B11",26283,27623,18903,8720,13245,2,7085,7096,4038,3058,1.320470896,3642,328,168,133,0,133,0,91,0,0.015037594,empty,mBC-0716-2
"G9,B12",18662,18838,14258,4580,9383,0,4255,4262,3079,1183,2.602704987,2007,1353,830,509,0,509,0,212,0,0.086444008,empty,mBC-0716-2
"G9,C1",23484,23707,18100,5607,11448,0,4882,4900,3438,1462,2.351573187,2356,790,479,321,0,321,0,159,0,0.043613707,empty,mBC-0716-2
"G9,C2",17793,18609,13357,5252,8987,0,4190,4201,2872,1329,2.161023326,2035,1462,880,543,0,543,0,227,0,0.057090239,empty,mBC-0716-2
"G9,C3",1075573,1233691,728675,505016,589848,28,365541,366107,281182,84925,3.310944951,212824,39885,25546,14543,0,14543,0,2009,0,0.000687616,mm10,mBC-0716-2
"G9,C4",17103,17437,13092,4345,8695,3,3936,3951,2792,1159,2.408973253,1860,1570,919,565,0,565,0,222,0,0.054867257,empty,mBC-0716-2
"G9,C5",18369,19116,13725,5391,9364,4,4420,4428,3161,1267,2.494869771,2229,5592,2218,1394,1,1393,1,446,0,0.097631012,empty,mBC-0716-2
"G9,C6",1413596,1520873,1009592,511281,755169,1,416301,416858,337010,79848,4.220644224,226947,75886,44377,26128,10,26118,2,3131,0,0.001608086,mm10,mBC-0716-2
"G9,C7",17003,18106,12712,5394,8640,0,4098,4109,2914,1195,2.438493724,2038,553,335,240,1,239,1,118,0,0.016736402,empty,mBC-0716-2
"G9,C8",777488,857630,541049,316581,421794,24,244771,245111,138565,106546,1.300518086,143923,6369,3579,2123,0,2123,0,680,0,0.005652379,mm10,mBC-0716-2
"G9,C9",13220,13869,10103,3766,6830,27,3237,3272,2341,931,2.514500537,1585,1283,771,464,1,463,1,205,0,0.041036717,empty,mBC-0716-2
"G9,C10",13980,14516,10754,3762,7091,20,3222,3248,2254,994,2.267605634,1505,1221,754,475,0,475,0,217,0,0.063157895,empty,mBC-0716-2
"G9,C11",12295,12905,9193,3712,6340,11,3000,3019,2060,959,2.148070907,1522,1072,643,417,0,417,0,187,0,0.050359712,empty,mBC-0716-2
"G9,C12",20348,20946,15301,5645,10067,0,4578,4594,3192,1402,2.276747504,2186,1406,858,496,0,496,0,190,0,0.056451613,empty,mBC-0716-2
"G9,D1",10908,11213,8111,3102,5552,0,2616,2620,1798,822,2.187347932,1294,629,370,224,0,224,0,119,0,0.013392857,empty,mBC-0716-2
"G9,D2",978911,1023752,749446,274306,488676,13,227008,227445,189553,37892,5.002454344,111156,137206,79395,45914,22,45892,3,4172,0,0.006188442,mm10,mBC-0716-2
"G9,D3",12977,13581,9889,3692,6884,0,3269,3275,2219,1056,2.101325758,1669,1494,848,549,0,549,0,299,0,0.04007286,empty,mBC-0716-2
"G9,D4",14782,14934,11233,3701,7354,15,3324,3343,2375,968,2.453512397,1560,1589,942,610,1,609,1,333,0,0.022988506,empty,mBC-0716-2
"G9,D5",546429,574015,389765,184250,285613,0,152784,153039,118702,34337,3.456970615,81061,8133,4520,2618,1,2617,1,782,0,0.012609859,mm10,mBC-0716-2
"G9,D6",641073,704133,466125,238008,346732,5,189998,190285,142295,47990,2.965096895,103024,50842,31587,18074,10,18064,3,2629,0,0.007030558,mm10,mBC-0716-2
"G9,D7",12797,13215,9459,3756,6345,19,2974,2997,2096,901,2.326304107,1489,1740,1024,640,0,640,0,256,0,0.04375,empty,mBC-0716-2
"G9,D8",16336,17159,12260,4899,8385,22,4038,4068,2895,1173,2.468030691,2048,1089,592,378,0,378,0,195,0,0.029100529,empty,mBC-0716-2
"G9,D9",4569,4766,3300,1466,2419,4,1205,1212,874,338,2.585798817,621,1719,958,637,0,637,0,312,0,0.023547881,empty,mBC-0716-2
"G9,D10",16406,17283,12280,5003,8296,0,4001,4013,2782,1231,2.259951259,2021,951,552,353,1,352,1,154,0,0.034090909,empty,mBC-0716-2
"G9,D11",13414,13924,10104,3820,6674,6,3090,3106,2133,973,2.192189106,1483,1669,1060,648,1,647,1,285,0,0.026275116,empty,mBC-0716-2
"G9,D12",20853,21530,15961,5569,10350,19,4659,4688,3304,1384,2.387283237,2285,2643,1586,991,0,991,0,342,0,0.036326942,empty,mBC-0716-2
"G9,E1",1166297,1240100,850921,389179,589424,1,311600,312141,236519,75622,3.127648039,163825,42071,27023,15360,7,15353,1,2315,0,0.000977008,mm10,mBC-0716-2
"G9,E2",16045,16237,12502,3735,7886,37,3463,3510,2519,991,2.541876892,1589,1690,1019,617,0,617,0,287,0,0.034035656,empty,mBC-0716-2
"G9,E3",791167,857572,572311,285261,413855,10,222137,222555,186763,35792,5.218009611,118825,126669,76910,44700,25,44675,5,4046,0,0.003178511,mm10,mBC-0716-2
"G9,E4",16300,16564,12395,4169,8002,1,3681,3695,2604,1091,2.3868011,1759,1330,757,486,0,486,0,256,0,0.030864198,empty,mBC-0716-2
"G9,E5",22408,22857,17149,5708,11007,7,4950,4982,3474,1508,2.303713528,2394,5084,1875,1152,1,1151,1,453,0,0.042571677,empty,mBC-0716-2
"G9,E6",924945,1032842,617402,415440,493817,16,305939,306428,225898,80530,2.805140941,177388,81570,52869,30104,15,30089,3,3114,0,0.000864103,mm10,mBC-0716-2
"G9,E7",13933,14081,10515,3566,6867,28,3098,3131,2159,972,2.221193416,1454,1331,785,489,0,489,0,225,0,0.032719836,empty,mBC-0716-2
"G9,E8",837833,889737,598684,291053,435291,17,240331,240681,183154,57527,3.183791959,128245,12120,7422,4309,3,4306,2,1047,0,0.012772875,mm10,mBC-0716-2
"G9,E9",611770,652897,459619,193278,319173,0,161485,161723,104529,57194,1.827621779,83074,36794,23587,13506,5,13501,1,1839,0,0.001629509,mm10,mBC-0716-2
"G9,E10",78811,82881,56057,26824,39784,0,21181,21219,15275,5944,2.569818304,11182,7418,4728,2659,0,2659,0,638,0,0.006393381,empty,mBC-0716-2
"G9,E11",9085,9424,6994,2430,4584,1,2067,2071,1419,652,2.176380368,971,1209,680,448,0,448,0,205,0,0.011160714,empty,mBC-0716-2
"G9,E12",630747,694574,441217,253357,345712,40,202594,202867,144908,57959,2.500181163,114250,7356,3813,2217,2,2215,2,691,0,0.006772009,mm10,mBC-0716-2
"G9,F1",18936,19589,14482,5107,9485,0,4327,4335,3055,1280,2.38671875,2116,1698,1046,609,0,609,0,264,0,0.036124795,empty,mBC-0716-2
"G9,F2",23960,25036,17843,7193,12258,23,5782,5819,4132,1687,2.449318317,2880,9475,3950,2494,3,2491,2,717,0,0.160176636,empty,mBC-0716-2
"G9,F3",16138,16790,12112,4678,8212,0,3937,3941,2793,1148,2.432926829,1897,3982,1669,1068,0,1068,0,430,0,0.079588015,empty,mBC-0716-2
"G9,F4",15707,16069,11828,4241,7985,23,3563,3596,2496,1100,2.269090909,1775,588,358,231,0,231,0,117,0,0,empty,mBC-0716-2
"G9,F5",682109,722837,507832,215005,352848,17,174235,174546,144005,30541,4.715137029,90015,92022,59451,34522,18,34504,1,3390,0,0.000492696,mm10,mBC-0716-2
"G9,F6",1889658,2094707,1290513,804194,990160,3,594081,594874,487976,106898,4.564874928,336247,298373,194014,112423,51,112372,2,6073,0,0.000943295,mm10,mBC-0716-2
"G9,F7",21347,21898,16587,5311,10683,1,4822,4833,3347,1486,2.252355316,2200,991,573,372,0,372,0,191,0,0.01344086,empty,mBC-0716-2
"G9,F8",23829,24620,17889,6731,12023,0,5513,5524,3954,1570,2.518471338,2670,888,454,290,0,290,0,165,0,0.010344828,empty,mBC-0716-2
"G9,F9",15179,15996,11483,4513,7645,17,3485,3506,2482,1024,2.423828125,1724,1553,929,584,0,584,0,253,0,0.046232877,empty,mBC-0716-2
"G9,F10",21208,21447,16604,4843,10562,0,4551,4567,3212,1355,2.370479705,2104,1515,899,527,0,527,0,231,0,0.009487666,empty,mBC-0716-2
"G9,F11",11893,12250,9159,3091,6008,12,2684,2706,1926,780,2.469230769,1300,1150,758,499,0,499,0,222,0,0.016032064,empty,mBC-0716-2
"G9,F12",15169,15719,11426,4293,7506,0,3472,3476,2408,1068,2.254681648,1741,276,149,113,0,113,0,78,0,0,empty,mBC-0716-2
"G9,G1",10510,10849,8008,2841,5378,5,2357,2365,1663,702,2.368945869,1128,1738,1080,643,0,643,0,234,0,0.023328149,empty,mBC-0716-2
"G9,G2",21828,22461,16548,5913,10993,0,4999,5002,3513,1489,2.359301545,2357,1070,637,432,0,432,0,250,0,0.034722222,empty,mBC-0716-2
"G9,G3",1124370,1192021,815394,376627,564593,2,295357,295819,252949,42870,5.900373221,154943,117307,74430,43283,20,43263,5,3933,0,0.003051106,mm10,mBC-0716-2
"G9,G4",983701,1018829,752240,266589,485897,11,222147,222540,170778,51762,3.299292918,110169,672,392,254,0,254,0,126,0,0,empty,mBC-0716-2
"G9,G5",976606,1110596,646571,464025,528218,1,333910,334337,269187,65150,4.13180353,194435,121838,72264,42031,21,42010,4,3963,0,0.003618186,mm10,mBC-0716-2
"G9,G6",25461,25905,19408,6497,12539,2,5658,5667,4020,1647,2.440801457,2634,217,135,105,0,105,0,86,0,0,empty,mBC-0716-2
"G9,G7",20802,21035,15959,5076,10427,0,4662,4674,3319,1355,2.449446494,2165,2843,1570,974,0,974,0,403,0,0.056468172,empty,mBC-0716-2
"G9,G8",15063,15772,11423,4349,7642,2,3610,3621,2441,1180,2.068644068,1786,1665,1018,663,0,663,0,309,0,0.036199095,empty,mBC-0716-2
"G9,G9",10756,10954,8187,2767,5408,1,2503,2508,1801,707,2.54738331,1185,1702,899,587,0,587,0,282,0,0.039182283,empty,mBC-0716-2
"G9,G10",14664,15071,10891,4180,7274,0,3358,3372,2397,975,2.458461538,1648,11188,3591,2289,3,2286,2,689,0,0.059492563,empty,mBC-0716-2
"G9,G11",740246,793325,540710,252615,385597,0,200477,200779,152309,48470,3.142335465,106703,48947,32563,18783,10,18773,2,2344,0,0.000958824,mm10,mBC-0716-2
"G9,G12",11351,11917,8517,3400,5923,5,2839,2854,1981,873,2.269186712,1456,6904,2268,1401,1,1400,1,431,0,0.019285714,empty,mBC-0716-2
"G9,H1",730044,777834,528611,249223,380753,0,203537,203796,150410,53386,2.817405312,108324,11576,7426,4310,2,4308,2,978,0,0.002321263,mm10,mBC-0716-2
"G9,H2",25477,26170,19729,6441,12478,0,5631,5646,3904,1742,2.241102181,2632,6917,2854,1847,1,1846,1,546,0,0.219393283,empty,mBC-0716-2
"G9,H3",19871,20455,15200,5255,9985,27,4602,4648,3341,1307,2.556235654,2179,2458,1083,702,0,702,0,317,0,0.044159544,empty,mBC-0716-2
"G9,H4",13676,14133,10282,3851,6967,16,3248,3268,2300,968,2.376033058,1582,344,198,131,0,131,0,97,0,0.007633588,empty,mBC-0716-2
"G9,H5",934470,1087145,620120,467025,521503,3,331029,331444,259541,71903,3.609599043,195401,141221,90938,52109,21,52088,3,4182,0,0.000364767,mm10,mBC-0716-2
"G9,H6",13817,14121,10473,3648,6896,24,3114,3141,2157,984,2.192073171,1507,1674,1008,623,0,623,0,275,0,0.020866774,empty,mBC-0716-2
"G9,H7",16575,16918,12443,4475,8249,6,3803,3823,2652,1171,2.264730999,1860,1494,936,595,0,595,0,272,0,0.072268908,empty,mBC-0716-2
"G9,H8",1537637,1756773,1001632,755141,839786,3,545022,545729,431207,114522,3.765276541,320786,234644,152438,88609,30,88579,3,5367,0,0.000925727,mm10,mBC-0716-2
"G9,H9",15618,15844,11798,4046,7707,6,3466,3484,2507,977,2.566018424,1635,1622,981,666,0,666,0,338,0,0.01951952,empty,mBC-0716-2
"G9,H10",15125,15593,11266,4327,7749,35,3649,3684,2576,1108,2.324909747,1834,1622,946,635,0,635,0,326,0,0.026771654,empty,mBC-0716-2
"G9,H11",17013,17549,12848,4701,8638,4,4003,4012,2800,1212,2.310231023,1974,393,212,137,3,134,1,87,0,0.052238806,empty,mBC-0716-2
"G9,H12",6162,6440,4592,1848,3111,11,1465,1479,1043,436,2.392201835,744,763,434,284,0,284,0,127,0,0.080985915,empty,mBC-0716-2
"G10,A1",15063,15279,11231,4048,7590,0,3557,3565,2501,1064,2.35056391,1690,1231,771,467,0,467,0,217,0,0.025695931,empty,mBC-0716-2
"G10,A2",19856,19931,15109,4822,9723,2,4326,4336,3007,1329,2.262603461,2035,2019,1009,643,2,641,1,258,0,0.070202808,empty,mBC-0716-2
"G10,A3",17103,17424,13162,4262,8472,0,3872,3878,2787,1091,2.554537122,1766,969,603,373,0,373,0,203,0,0.021447721,empty,mBC-0716-2
"G10,A4",1142281,1201694,850284,351410,560711,1,282457,282954,244081,38873,6.278933964,142306,24347,15138,8380,2,8378,1,1448,0,0.002984006,mm10,mBC-0716-2
"G10,A5",1750359,1880247,1253610,626637,899404,19,506705,507475,349050,158425,2.20325075,272013,35376,20201,11560,7,11553,3,1921,0,0.003808535,mm10,mBC-0716-2
"G10,A6",628953,687859,436611,251248,337179,13,199028,199321,161116,38205,4.217144353,109856,20715,13177,7385,1,7384,1,1440,0,0.004739978,mm10,mBC-0716-2
"G10,A7",18460,19358,14079,5279,9233,33,4251,4295,2979,1316,2.263677812,2084,1388,874,535,0,535,0,226,0,0.020560748,empty,mBC-0716-2
"G10,A8",605601,696030,409487,286543,340822,0,211671,212001,168201,43800,3.840205479,122572,54604,35992,20157,14,20143,2,2520,0,0.003226927,mm10,mBC-0716-2
"G10,A9",20716,21194,15908,5286,10065,0,4438,4444,3199,1245,2.569477912,2046,1328,782,488,0,488,0,247,0,0.020491803,empty,mBC-0716-2
"G10,A10",16703,17200,12731,4469,8355,0,3889,3895,2736,1159,2.360655738,1846,679,311,206,0,206,0,120,0,0.033980583,empty,mBC-0716-2
"G10,A11",19588,19882,15007,4875,9691,20,4326,4362,3075,1287,2.389277389,2050,3337,1312,732,0,732,0,291,0,0.027322404,empty,mBC-0716-2
"G10,A12",731223,773910,552407,221503,369197,10,179809,180173,146584,33589,4.364047754,90606,118345,76497,42337,22,42315,5,3638,0,0.002670448,mm10,mBC-0716-2
"G10,B1",21145,21355,16284,5071,10362,1,4585,4601,3293,1308,2.517584098,2089,1323,832,468,0,468,0,186,0,0.08974359,empty,mBC-0716-2
"G10,B2",1192874,1275005,859645,415360,605352,2,326912,327381,273402,53979,5.06496971,173178,13213,8544,4700,0,4700,0,957,0,0.003404255,mm10,mBC-0716-2
"G10,B3",2500513,2781450,1771264,1010186,1305346,18,762943,764073,646158,117915,5.479862613,422724,234999,146800,81877,36,81841,2,5377,0,0.003225767,mm10,mBC-0716-2
"G10,B4",17990,18683,13674,5009,8993,38,4070,4112,2857,1255,2.276494024,1955,1224,742,453,1,452,1,199,0,0.112831858,empty,mBC-0716-2
"G10,B5",9161,5382,3782,1600,3485,6,1673,1691,1176,515,2.283495146,932,765,424,278,0,278,0,152,0,0.003597122,empty,mBC-0716-2
"G10,B6",2702002,2942615,1908359,1034256,1383560,5,806354,807525,638922,168603,3.789505525,445895,35240,21952,12465,6,12459,1,2333,0,0.004093426,mm10,mBC-0716-2
"G10,B7",1924323,2063361,1405503,657858,968659,2,516689,517535,427472,90063,4.746366432,271156,128703,81537,44948,16,44932,3,3942,0,0.00117956,mm10,mBC-0716-2
"G10,B8",14922,15429,11413,4016,7458,1,3395,3407,2380,1027,2.317429406,1597,1146,709,459,0,459,0,242,0,0.02832244,empty,mBC-0716-2
"G10,B9",18094,18494,13721,4773,8857,19,4045,4068,2817,1251,2.251798561,1922,797,500,306,0,306,0,138,0,0.091503268,empty,mBC-0716-2
"G10,B10",17380,17576,13022,4554,8814,2,4016,4031,2747,1284,2.1394081,1910,704,356,218,0,218,0,104,0,0.050458716,empty,mBC-0716-2
"G10,B11",17765,18348,13527,4821,8672,20,4002,4029,2807,1222,2.29705401,1893,264,140,104,0,104,0,78,0,0,empty,mBC-0716-2
"G10,B12",19969,20461,15257,5204,9964,16,4546,4566,3271,1295,2.525868726,2162,1278,774,453,0,453,0,211,0,0.028697572,empty,mBC-0716-2
"G10,C1",25152,25565,19461,6104,12107,20,5129,5168,3591,1577,2.277108434,2383,731,443,288,0,288,0,160,0,0.024305556,empty,mBC-0716-2
"G10,C2",19749,20356,15006,5350,9598,36,4322,4370,3012,1358,2.217967599,2085,1422,833,502,0,502,0,206,0,0.057768924,empty,mBC-0716-2
"G10,C3",897057,984777,651562,333215,471122,1,254115,254452,211107,43345,4.870388741,137221,45009,28288,15478,11,15467,2,2030,0,0.001163768,mm10,mBC-0716-2
"G10,C4",24487,25434,18543,6891,12239,0,5619,5626,4012,1614,2.48574969,2740,1501,823,488,0,488,0,203,0,0.06352459,empty,mBC-0716-2
"G10,C5",639438,667522,490449,177073,325433,0,150750,151015,116390,34625,3.361444043,74881,13196,8707,4908,1,4907,1,1017,0,0.003260648,mm10,mBC-0716-2
"G10,C6",18043,18206,13517,4689,9074,5,4240,4254,2985,1269,2.352245863,1962,4818,1694,1083,1,1082,1,394,0,0.026802218,empty,mBC-0716-2
"G10,C7",504692,512852,382797,130055,254178,14,114478,114719,88517,26202,3.378253568,55831,6290,3913,2280,0,2280,0,585,0,0.005701754,mm10,mBC-0716-2
"G10,C8",15846,16389,12109,4280,8013,0,3742,3748,2592,1156,2.242214533,1784,1632,879,544,1,543,1,245,0,0.020257827,empty,mBC-0716-2
"G10,C9",14101,14767,10774,3993,7136,0,3354,3356,2387,969,2.463364293,1661,6593,2162,1250,2,1248,1,406,0,0.032051282,empty,mBC-0716-2
"G10,C10",15062,15608,11420,4188,7545,0,3445,3455,2375,1080,2.199074074,1706,1021,593,391,0,391,0,197,0,0.051150895,empty,mBC-0716-2
"G10,C11",12796,13389,9673,3716,6422,2,3011,3018,2151,867,2.480968858,1451,1002,629,374,0,374,0,187,0,0.042780749,empty,mBC-0716-2
"G10,C12",22522,23066,16885,6181,10816,0,4962,4970,3545,1425,2.487719298,2340,1351,799,457,0,457,0,168,0,0.013129103,empty,mBC-0716-2
"G10,D1",611394,636718,452322,184396,313767,0,154859,155114,128157,26957,4.754126943,79040,19946,12396,6901,0,6901,0,1226,0,0.002463411,mm10,mBC-0716-2
"G10,D2",23167,23375,18115,5260,11327,0,4856,4877,3457,1420,2.434507042,2100,2806,1699,1048,0,1048,0,408,0,0.03148855,empty,mBC-0716-2
"G10,D3",14930,15632,11155,4477,7717,0,3703,3706,2607,1099,2.372156506,1870,1348,837,530,0,530,0,249,0,0.028301887,empty,mBC-0716-2
"G10,D4",1015003,1099089,738715,360374,523870,0,277420,277854,230192,47662,4.829675633,148148,102080,67080,36985,26,36959,1,3486,0,0.001623421,mm10,mBC-0716-2
"G10,D5",733478,778943,545660,233283,377474,0,187641,187912,151713,36199,4.191082627,96406,61741,39417,22427,12,22415,1,2603,0,0.002186036,mm10,mBC-0716-2
"G10,D6",13423,14207,9994,4213,6945,0,3337,3344,2327,1017,2.288102262,1692,1288,705,453,0,453,0,244,0,0.022075055,empty,mBC-0716-2
"G10,D7",13915,14256,10517,3739,6855,13,3150,3171,2222,949,2.341412013,1519,1580,961,575,1,574,1,249,0,0.087108014,empty,mBC-0716-2
"G10,D8",17136,17699,12934,4765,8574,0,4007,4015,2833,1182,2.39678511,1969,937,540,319,0,319,0,147,0,0.018808777,empty,mBC-0716-2
"G10,D9",5158,5397,3733,1664,2777,5,1346,1355,964,391,2.465473146,726,4757,1908,1167,0,1167,0,469,0,0.037703513,empty,mBC-0716-2
"G10,D10",15645,15820,11401,4419,7489,0,3540,3549,2468,1081,2.28307123,1732,23786,6700,3983,4,3979,1,939,0,0.117617492,empty,mBC-0716-2
"G10,D11",14227,14404,10802,3602,7069,31,3167,3201,2259,942,2.398089172,1508,1836,1043,687,1,686,1,285,0,0.013119534,empty,mBC-0716-2
"G10,D12",22208,23163,17128,6035,11012,0,5055,5060,3580,1480,2.418918919,2437,2357,1406,860,1,859,1,291,0,0.038416764,empty,mBC-0716-2
"G10,E1",23672,23960,18217,5743,11531,0,5189,5192,3751,1441,2.603053435,2397,1749,1042,630,0,630,0,277,0,0.052380952,empty,mBC-0716-2
"G10,E2",17337,17763,13039,4724,8538,4,3911,3928,2781,1147,2.424585876,1884,4670,2565,1710,0,1710,0,753,0,0.032748538,empty,mBC-0716-2
"G10,E3",536526,573618,387133,186485,279455,5,145427,145671,79364,66307,1.196917369,82151,15703,7899,4501,5,4496,2,1184,0,0.026467972,mm10,mBC-0716-2
"G10,E4",16843,17414,12844,4570,8504,0,3833,3841,2715,1126,2.411190053,1858,1269,735,449,0,449,0,216,0,0.020044543,empty,mBC-0716-2
"G10,E5",1127597,1238838,804680,434158,592359,9,329962,330491,250692,79799,3.141543127,180656,35487,21749,12059,2,12057,2,1864,0,0.00389815,mm10,mBC-0716-2
"G10,E6",725929,788146,519941,268205,377614,18,203178,203531,172671,30860,5.595301361,110042,138616,87611,47745,31,47714,1,4112,0,0.004191642,mm10,mBC-0716-2
"G10,E7",1021788,1098868,730257,368611,521702,0,286485,286917,214051,72866,2.937597782,154290,79091,49927,28045,11,28034,2,2913,0,0.001248484,mm10,mBC-0716-2
"G10,E8",19690,20036,14946,5090,9470,0,4230,4240,2968,1272,2.333333333,2000,18134,5086,3005,3,3002,1,833,0,0.032644903,empty,mBC-0716-2
"G10,E9",9472,9638,7186,2452,4822,0,2233,2239,1575,664,2.371987952,1069,950,572,346,0,346,0,156,0,0.069364162,empty,mBC-0716-2
"G10,E10",14480,14708,11103,3605,7051,17,3234,3257,2296,961,2.38917794,1477,2703,1131,692,1,691,1,269,0,0.005788712,empty,mBC-0716-2
"G10,E11",10068,10436,7631,2805,5046,0,2350,2350,1624,726,2.236914601,1097,1048,659,389,0,389,0,175,0,0.023136247,empty,mBC-0716-2
"G10,E12",16080,16229,12057,4172,8038,10,3769,3781,2621,1160,2.259482759,1810,1204,677,415,0,415,0,184,0,0.045783133,empty,mBC-0716-2
"G10,F1",19251,20003,14841,5162,9800,0,4474,4486,3145,1341,2.345264728,2156,1676,990,646,0,646,0,279,0,0.034055728,empty,mBC-0716-2
"G10,F2",25605,26643,19365,7278,12850,0,6179,6189,4368,1821,2.398682043,3036,3516,1922,1217,0,1217,0,490,0,0.04272802,empty,mBC-0716-2
"G10,F3",17594,18327,13461,4866,8937,0,4271,4276,2956,1320,2.239393939,2037,1968,1210,710,0,710,0,301,0,0.01971831,empty,mBC-0716-2
"G10,F4",16463,16613,12442,4171,8322,1,3705,3714,2594,1120,2.316071429,1746,429,278,180,0,180,0,105,0,0.011111111,empty,mBC-0716-2
"G10,F5",26220,26517,19977,6540,12736,18,5776,5804,4105,1699,2.416127134,2623,2004,1135,729,0,729,0,347,0,0.056241427,empty,mBC-0716-2
"G10,F6",24870,25435,18829,6606,12060,0,5518,5536,3904,1632,2.392156863,2651,3703,1776,1079,1,1078,1,397,0,0.025046382,empty,mBC-0716-2
"G10,F7",22014,22658,16839,5819,11071,0,5027,5042,3620,1422,2.545710267,2378,961,530,359,1,358,1,195,0,0.027932961,empty,mBC-0716-2
"G10,F8",24625,25483,18672,6811,12319,0,5658,5675,4010,1665,2.408408408,2748,367,249,174,0,174,0,111,0,0.011494253,empty,mBC-0716-2
"G10,F9",16583,17057,12656,4401,8140,0,3733,3745,2524,1221,2.067158067,1698,2776,1533,940,0,940,0,388,0,0.061702128,empty,mBC-0716-2
"G10,F10",22934,23190,17694,5496,11362,25,4882,4934,3459,1475,2.345084746,2249,1598,1026,572,0,572,0,243,0,0.075174825,empty,mBC-0716-2
"G10,F11",12067,12519,9296,3223,6176,6,2791,2799,2011,788,2.552030457,1377,1061,654,411,0,411,0,196,0,0.01459854,empty,mBC-0716-2
"G10,F12",16117,16536,12195,4341,8039,0,3794,3802,2629,1173,2.241261722,1865,178,104,68,0,68,0,53,0,0.014705882,empty,mBC-0716-2
"G10,G1",11175,11249,8575,2674,5541,0,2512,2522,1762,760,2.318421053,1117,1892,1323,729,2,727,1,237,0,0.008253095,empty,mBC-0716-2
"G10,G2",873588,938766,649409,289357,450829,0,230737,231125,191638,39487,4.85319219,120370,20210,12985,7134,3,7131,1,1216,0,0.000841397,mm10,mBC-0716-2
"G10,G3",21827,22449,16595,5854,10835,0,4880,4895,3437,1458,2.35733882,2364,2332,1449,923,0,923,0,377,0,0.056338028,empty,mBC-0716-2
"G10,G4",1157935,1249413,824564,424849,595798,3,341100,341621,254557,87064,2.923791693,184509,783,404,256,1,255,1,105,0,0.007843137,empty,mBC-0716-2
"G10,G5",15154,15787,11319,4468,7725,0,3691,3694,2609,1085,2.404608295,1830,1456,890,600,0,600,0,294,0,0.03,empty,mBC-0716-2
"G10,G6",26198,26679,19966,6713,12872,17,5726,5764,4087,1677,2.437090042,2675,251,161,122,0,122,0,93,0,0.032786885,empty,mBC-0716-2
"G10,G7",22705,23335,17461,5874,11153,0,4917,4919,3497,1422,2.459212377,2258,2309,1289,818,0,818,0,359,0,0.034229829,empty,mBC-0716-2
"G10,G8",16174,16812,12231,4581,8140,46,3805,3855,2694,1161,2.320413437,1867,3281,1401,889,0,889,0,334,0,0.051743532,empty,mBC-0716-2
"G10,G9",11587,12126,8802,3324,5845,0,2703,2709,1898,811,2.340320592,1300,1543,998,629,1,628,1,272,0,0.02866242,empty,mBC-0716-2
"G10,G10",15130,15578,11695,3883,7557,1,3382,3387,2399,988,2.428137652,1599,1380,852,530,0,530,0,248,0,0.032075472,empty,mBC-0716-2
"G10,G11",13407,13760,10184,3576,6626,0,2975,2977,2052,925,2.218378378,1390,883,511,319,0,319,0,150,0,0,empty,mBC-0716-2
"G10,G12",12388,12812,9394,3418,6203,0,2893,2893,2029,864,2.34837963,1378,1093,646,408,0,408,0,192,0,0.049019608,empty,mBC-0716-2
"G10,H1",22758,23436,17368,6068,11334,2,5184,5194,3729,1465,2.545392491,2483,1250,832,494,0,494,0,210,0,0.020242915,empty,mBC-0716-2
"G10,H2",30308,31610,23104,8506,15190,15,7020,7045,5002,2043,2.448360255,3423,10794,3772,2285,1,2284,1,684,0,0.07267951,empty,mBC-0716-2
"G10,H3",7659207,8097755,5516789,2580966,3415660,1,2040011,2043289,1672199,371090,4.506181789,1075923,339116,211922,117078,57,117021,3,6815,0,0.005178558,mm10,mBC-0716-2
"G10,H4",14524,15053,11052,4001,7335,16,3366,3389,2364,1025,2.306341463,1641,330,199,141,0,141,0,108,0,0.007092199,empty,mBC-0716-2
"G10,H5",20264,20758,15123,5635,9958,0,4754,4764,3354,1410,2.378723404,2321,6247,2544,1565,1,1564,1,447,0,0.17455243,empty,mBC-0716-2
"G10,H6",16191,16802,12272,4530,8170,0,3830,3840,2717,1123,2.419412289,1860,2280,1168,703,2,701,1,270,0,0.027104137,empty,mBC-0716-2
"G10,H7",1073596,1179332,741794,437538,566534,3,333947,334433,266641,67792,3.933222209,185840,48068,31665,17868,6,17862,1,2233,0,0.001847497,mm10,mBC-0716-2
"G10,H8",833368,909978,582590,327388,436653,2,251520,251965,200124,51841,3.8603422,138929,24944,15543,8907,3,8904,1,1596,0,0.004267745,mm10,mBC-0716-2
"G10,H9",971522,1044080,703532,340548,499005,22,265876,266280,206892,59388,3.483734088,141742,84607,54170,30492,12,30480,2,3084,0,0.000524934,mm10,mBC-0716-2
"G10,H10",15978,16676,11760,4916,8127,0,3845,3860,2629,1231,2.135662063,1926,1551,985,635,0,635,0,307,0,0.037795276,empty,mBC-0716-2
"G10,H11",17648,17994,13190,4804,8835,0,4138,4152,2926,1226,2.386623165,2029,604,272,177,0,177,0,79,0,0.028248588,empty,mBC-0716-2
"G10,H12",6575,6868,5034,1834,3318,0,1519,1525,1046,479,2.183716075,734,707,409,265,0,265,0,117,0,0.049056604,empty,mBC-0716-2
"G11,A1",14133,14779,10674,4105,7168,56,3311,3377,2319,1058,2.191871456,1710,998,542,319,0,319,0,127,0,0.065830721,empty,mBC-0716-2
"G11,A2",18307,18102,13990,4112,8960,0,3884,3892,2763,1129,2.447298494,1794,906,541,297,0,297,0,106,0,0.067340067,empty,mBC-0716-2
"G11,A3",16141,16664,12376,4288,8015,0,3758,3760,2605,1155,2.255411255,1764,843,533,313,0,313,0,100,0,0.083067093,empty,mBC-0716-2
"G11,A4",22207,22593,17100,5493,10871,5,4887,4907,3477,1430,2.431468531,2294,430,222,150,0,150,0,83,0,0,empty,mBC-0716-2
"G11,A5",17480,17909,13175,4734,8687,1,4012,4022,2821,1201,2.348875937,1915,4196,1560,898,0,898,0,310,0,0.055679287,empty,mBC-0716-2
"G11,A6",531911,561803,390959,170844,275306,2,141311,141560,113875,27685,4.113238216,72880,28132,15417,8872,3,8869,1,1731,0,0.024241741,mm10,mBC-0716-2
"G11,A7",16392,16834,12549,4285,8103,0,3703,3714,2584,1130,2.286725664,1785,1008,562,339,0,339,0,126,0,0.050147493,empty,mBC-0716-2
"G11,A8",11219,11204,8547,2657,5587,2,2529,2535,1792,743,2.411843876,1115,1278,773,449,0,449,0,161,0,0.064587973,empty,mBC-0716-2
"G11,A9",18990,19794,14582,5212,9449,32,4169,4218,3011,1207,2.494614747,2059,1050,653,386,0,386,0,144,0,0.031088083,empty,mBC-0716-2
"G11,A10",15967,16289,12212,4077,7874,1,3498,3508,2467,1041,2.369836695,1661,351,197,108,0,108,0,56,0,0.027777778,empty,mBC-0716-2
"G11,A11",18083,18280,13802,4478,8826,1,3935,3948,2718,1230,2.209756098,1803,1063,603,350,0,350,0,134,0,0.105714286,empty,mBC-0716-2
"G11,A12",21056,21338,16054,5284,10223,0,4552,4564,3152,1412,2.232294618,2129,2203,1205,725,1,724,1,232,0,0.055248619,empty,mBC-0716-2
"G11,B1",21242,21413,15983,5430,10141,0,4646,4653,3289,1364,2.411290323,2241,8939,3274,1992,1,1991,1,470,0,0.183324962,empty,mBC-0716-2
"G11,B2",21207,21561,16411,5150,10252,1,4553,4563,3152,1411,2.233876683,2077,412,251,142,0,142,0,65,0,0.098591549,empty,mBC-0716-2
"G11,B3",19629,20683,14949,5734,9818,0,4581,4591,3189,1402,2.274607703,2267,890,495,296,0,296,0,124,0,0.118243243,empty,mBC-0716-2
"G11,B4",16924,17301,13040,4261,8375,0,3831,3846,2717,1129,2.406554473,1789,1009,571,314,0,314,0,126,0,0.073248408,empty,mBC-0716-2
"G11,B5",1064100,586649,393579,193070,376048,6,194053,195457,146169,49288,2.965610291,110516,34876,21489,12236,1,12235,1,2014,0,0.010706988,mm10,mBC-0716-2
"G11,B6",12279,12685,9177,3508,6333,1,3019,3021,2120,901,2.352941176,1474,1135,717,430,0,430,0,127,0,0.109302326,empty,mBC-0716-2
"G11,B7",17139,17984,13095,4889,8659,17,3913,3940,2818,1122,2.511586453,1971,953,563,330,0,330,0,119,0,0.06969697,empty,mBC-0716-2
"G11,B8",13666,14025,10342,3683,6875,0,3130,3133,2184,949,2.301369863,1491,933,597,366,0,366,0,157,0,0.06284153,empty,mBC-0716-2
"G11,B9",15783,16418,11933,4485,7742,25,3537,3571,2491,1080,2.306481481,1723,3529,1199,715,0,715,0,231,0,0.048951049,empty,mBC-0716-2
"G11,B10",17075,17418,12633,4785,8559,13,4018,4041,2767,1274,2.171899529,1969,1129,480,308,0,308,0,133,0,0.058441558,empty,mBC-0716-2
"G11,B11",16380,16485,12574,3911,7944,28,3589,3620,2540,1080,2.351851852,1659,185,113,77,0,77,0,35,0,0,empty,mBC-0716-2
"G11,B12",18474,19195,14287,4908,9276,22,4174,4200,2942,1258,2.33863275,1987,1265,748,441,0,441,0,141,0,0.113378685,empty,mBC-0716-2
"G11,C1",23696,24142,18265,5877,11273,4,4824,4834,3379,1455,2.32233677,2257,503,317,202,0,202,0,76,0,0.183168317,empty,mBC-0716-2
"G11,C2",17796,18324,13636,4688,8842,2,4101,4108,2866,1242,2.307568438,1905,1462,856,526,0,526,0,169,0,0.089353612,empty,mBC-0716-2
"G11,C3",1123926,1186349,830363,355986,555780,23,273197,273716,242478,31238,7.762276714,140553,58997,36553,20529,6,20523,1,2516,0,0.003508259,mm10,mBC-0716-2
"G11,C4",1158950,1236080,802828,433252,591379,1,344666,345162,278754,66408,4.197596675,186945,16794,10220,5896,1,5895,1,1215,0,0.005428329,mm10,mBC-0716-2
"G11,C5",17208,17752,12917,4835,8567,7,4017,4028,2871,1157,2.481417459,1971,1045,577,351,0,351,0,138,0,0.03988604,empty,mBC-0716-2
"G11,C6",16985,17519,12792,4727,8774,12,4134,4152,2934,1218,2.408866995,2038,1161,696,433,0,433,0,169,0,0.066974596,empty,mBC-0716-2
"G11,C7",16323,16657,12380,4277,8165,0,3768,3774,2602,1172,2.220136519,1782,294,169,105,0,105,0,54,0,0.066666667,empty,mBC-0716-2
"G11,C8",15174,16156,11621,4535,7746,7,3573,3594,2440,1154,2.114384749,1779,1480,843,491,0,491,0,186,0,0.048879837,empty,mBC-0716-2
"G11,C9",1089412,1187538,772482,415056,561275,4,317915,318393,249812,68581,3.642583223,173316,41017,26864,15185,6,15179,1,2071,0,0.001054088,mm10,mBC-0716-2
"G11,C10",14111,14627,10795,3832,7152,6,3329,3342,2325,1017,2.286135693,1602,804,507,314,0,314,0,132,0,0.044585987,empty,mBC-0716-2
"G11,C11",12270,12921,9235,3686,6228,0,2948,2953,1994,959,2.079249218,1470,931,570,354,0,354,0,135,0,0.028248588,empty,mBC-0716-2
"G11,C12",20510,20646,15217,5429,9992,1,4554,4569,3160,1409,2.242725337,2185,1214,679,386,0,386,0,139,0,0.064766839,empty,mBC-0716-2
"G11,D1",11046,11131,8389,2742,5530,6,2525,2547,1801,746,2.414209115,1170,838,349,217,0,217,0,99,0,0.032258065,empty,mBC-0716-2
"G11,D2",21748,22021,16716,5305,10806,2,4798,4808,3361,1447,2.322736697,2202,2156,1298,760,0,760,0,266,0,0.042105263,empty,mBC-0716-2
"G11,D3",627926,690093,442846,247247,341637,0,196553,196816,156181,40635,3.84350929,109288,7362,4741,2667,0,2667,0,667,0,0.005624297,mm10,mBC-0716-2
"G11,D4",684958,703857,507391,196466,343476,5,169943,170234,137316,32918,4.171456346,85255,6985,4423,2575,1,2574,1,726,0,0.007381507,mm10,mBC-0716-2
"G11,D5",15560,15869,11711,4158,7665,13,3453,3479,2484,995,2.496482412,1673,1751,757,455,0,455,0,158,0,0.079120879,empty,mBC-0716-2
"G11,D6",12351,13086,9333,3753,6325,0,3046,3048,2170,878,2.471526196,1507,1124,729,412,0,412,0,158,0,0.067961165,empty,mBC-0716-2
"G11,D7",42273,47386,32129,15257,22895,0,12460,12477,9321,3156,2.953422053,6455,6054,3062,1779,0,1779,0,456,0,0.024732996,empty,mBC-0716-2
"G11,D8",710537,780785,518139,262646,379791,1,202938,203277,159329,43948,3.625398198,109633,52218,34285,19185,5,19180,1,2346,0,0.001303441,mm10,mBC-0716-2
"G11,D9",4393,4551,3274,1277,2312,1,1117,1120,810,310,2.612903226,557,1494,844,523,2,521,1,192,0,0.046065259,empty,mBC-0716-2
"G11,D10",13648,14289,10457,3832,6908,0,3284,3291,2300,991,2.320887992,1584,647,376,234,0,234,0,84,0,0.034188034,empty,mBC-0716-2
"G11,D11",13314,13716,10097,3619,6669,6,3005,3016,2127,889,2.392575928,1492,1214,767,433,0,433,0,174,0,0.032332564,empty,mBC-0716-2
"G11,D12",21043,21949,15964,5985,10421,0,4884,4888,3317,1571,2.111394017,2449,2414,1408,827,0,827,0,248,0,0.07376058,empty,mBC-0716-2
"G11,E1",22652,22761,17241,5520,10879,45,4708,4764,3333,1431,2.329140461,2157,1250,755,440,0,440,0,164,0,0.090909091,empty,mBC-0716-2
"G11,E2",16702,17245,12669,4576,8165,3,3763,3773,2651,1122,2.362745098,1759,1302,728,463,0,463,0,160,0,0.095032397,empty,mBC-0716-2
"G11,E3",12528,12728,9748,2980,6338,3,2783,2799,1978,821,2.409257004,1260,1286,742,439,0,439,0,159,0,0.022779043,empty,mBC-0716-2
"G11,E4",15525,16053,11933,4120,7774,12,3529,3554,2481,1073,2.31220876,1697,1127,615,360,0,360,0,132,0,0.027777778,empty,mBC-0716-2
"G11,E5",21633,22002,16708,5294,10583,22,4717,4748,3353,1395,2.403584229,2236,1106,654,417,1,416,1,156,0,0.108173077,empty,mBC-0716-2
"G11,E6",13299,13829,10270,3559,6787,18,3025,3046,2029,1017,1.995083579,1466,1480,864,546,0,546,0,191,0,0.042124542,empty,mBC-0716-2
"G11,E7",14315,14681,11044,3637,7098,3,3250,3259,2258,1001,2.255744256,1517,1117,622,367,0,367,0,134,0,0.054495913,empty,mBC-0716-2
"G11,E8",18004,18207,13914,4293,8937,0,3990,4004,2860,1144,2.5,1863,2978,1320,732,1,731,1,235,0,0.020519836,empty,mBC-0716-2
"G11,E9",8846,9151,6655,2496,4497,0,2061,2066,1448,618,2.343042071,1019,1020,667,392,0,392,0,125,0,0.058673469,empty,mBC-0716-2
"G11,E10",13408,13858,10251,3607,6672,1,3045,3048,2107,941,2.239107333,1405,1075,539,322,0,322,0,134,0,0.086956522,empty,mBC-0716-2
"G11,E11",9385,9672,7188,2484,4783,0,2129,2138,1461,677,2.158050222,1026,5588,1914,1118,0,1118,0,279,0,0.237030411,empty,mBC-0716-2
"G11,E12",14981,15208,11523,3685,7480,0,3458,3469,2381,1088,2.188419118,1622,955,536,304,0,304,0,117,0,0.072368421,empty,mBC-0716-2
"G11,F1",18698,19630,14330,5300,9493,0,4337,4352,3012,1340,2.247761194,2141,1347,811,480,1,479,1,175,0,0.035490605,empty,mBC-0716-2
"G11,F2",25374,26312,19418,6894,12783,0,5924,5937,4169,1768,2.358031674,2834,2473,1451,836,0,836,0,320,0,0.029904306,empty,mBC-0716-2
"G11,F3",543027,572804,386137,186667,284834,15,153730,153978,120452,33526,3.592793653,83128,10941,6672,3786,1,3785,1,1010,0,0.024570674,mm10,mBC-0716-2
"G11,F4",659706,674506,495371,179135,332854,1,155495,155783,116796,38987,2.99576782,77235,7381,4796,2669,2,2667,1,597,0,0.001874766,mm10,mBC-0716-2
"G11,F5",858217,904553,639682,264871,431840,1,210186,210548,179478,31070,5.776569038,107583,96226,62130,34964,6,34958,2,3387,0,0.00188798,mm10,mBC-0716-2
"G11,F6",23470,24075,17670,6405,11494,4,5248,5265,3652,1613,2.264104154,2551,1517,830,510,0,510,0,192,0,0.082352941,empty,mBC-0716-2
"G11,F7",20900,21589,16100,5489,10527,0,4727,4744,3337,1407,2.371712864,2188,834,495,271,0,271,0,111,0,0.051660517,empty,mBC-0716-2
"G11,F8",22921,23262,17389,5873,11344,0,5163,5175,3628,1547,2.345184228,2424,191,107,76,0,76,0,44,0,0.157894737,empty,mBC-0716-2
"G11,F9",14864,15326,11388,3938,7492,6,3398,3416,2376,1040,2.284615385,1652,1388,841,493,0,493,0,165,0,0.034482759,empty,mBC-0716-2
"G11,F10",22262,22913,17199,5714,10758,6,4715,4732,3300,1432,2.304469274,2172,1169,656,411,2,409,1,162,0,0.029339853,empty,mBC-0716-2
"G11,F11",11547,11820,8981,2839,5753,0,2458,2462,1712,750,2.282666667,1102,868,514,301,0,301,0,117,0,0.03654485,empty,mBC-0716-2
"G11,F12",14625,15311,11085,4226,7175,3,3314,3321,2291,1030,2.224271845,1607,174,108,57,0,57,0,37,0,0.157894737,empty,mBC-0716-2
"G11,G1",10539,10798,8024,2774,5228,0,2308,2319,1585,734,2.159400545,1072,1615,992,605,0,605,0,203,0,0.056198347,empty,mBC-0716-2
"G11,G2",22368,22859,17125,5734,11136,0,5019,5030,3513,1517,2.315754779,2406,1038,407,268,0,268,0,130,0,0.003731343,empty,mBC-0716-2
"G11,G3",22062,22998,16934,6064,11008,1,5115,5126,3709,1417,2.617501764,2467,4351,1866,1081,0,1081,0,339,0,0.037002775,empty,mBC-0716-2
"G11,G4",1034274,1080144,780272,299872,512653,4,244549,244976,206499,38477,5.36681654,122011,1257,687,351,0,351,0,130,0,0.002849003,empty,mBC-0716-2
"G11,G5",13787,13999,10467,3532,6683,0,2927,2931,2120,811,2.61405672,1323,972,578,353,0,353,0,142,0,0.045325779,empty,mBC-0716-2
"G11,G6",25099,25703,19285,6418,12112,0,5277,5304,3747,1557,2.40655106,2416,165,110,66,0,66,0,43,0,0,empty,mBC-0716-2
"G11,G7",20720,21571,15966,5605,10387,0,4653,4659,3264,1395,2.339784946,2198,3412,1343,860,2,858,2,275,0,0.108391608,empty,mBC-0716-2
"G11,G8",15281,15776,11665,4111,7491,0,3581,3589,2456,1133,2.167696381,1685,1223,742,431,0,431,0,157,0,0.05800464,empty,mBC-0716-2
"G11,G9",10678,11145,8145,3000,5436,0,2498,2506,1757,749,2.345794393,1236,1132,647,369,0,369,0,157,0,0.032520325,empty,mBC-0716-2
"G11,G10",14118,14489,10758,3731,7023,21,3177,3205,2279,926,2.46112311,1493,1498,763,481,0,481,0,190,0,0.051975052,empty,mBC-0716-2
"G11,G11",12528,12608,9506,3102,6110,6,2682,2694,1888,806,2.342431762,1244,531,287,177,1,176,1,88,0,0,empty,mBC-0716-2
"G11,G12",1699484,1779051,1269587,509464,848982,0,424229,424990,341050,83940,4.063021206,215070,145880,92110,51847,26,51821,7,4407,0,0.003048957,mm10,mBC-0716-2
"G11,H1",22907,23693,17586,6107,11338,18,5211,5233,3727,1506,2.474767596,2484,754,425,268,0,268,0,118,0,0.037313433,empty,mBC-0716-2
"G11,H2",25586,26578,19607,6971,12520,0,5685,5698,4010,1688,2.375592417,2698,1751,1048,610,0,610,0,223,0,0.042622951,empty,mBC-0716-2
"G11,H3",20142,20947,15275,5672,10190,0,4754,4758,3395,1363,2.490829054,2311,1255,781,434,0,434,0,160,0,0.050691244,empty,mBC-0716-2
"G11,H4",14185,14424,10340,4084,6865,1,3173,3187,2137,1050,2.035238095,1562,774,243,154,0,154,0,73,0,0.058441558,empty,mBC-0716-2
"G11,H5",17791,18248,13544,4704,8778,0,4032,4041,2852,1189,2.398654331,1908,1378,810,450,0,450,0,149,0,0.066666667,empty,mBC-0716-2
"G11,H6",14710,15205,11247,3958,7464,0,3464,3468,2424,1044,2.32183908,1730,1900,862,512,0,512,0,199,0,0.013671875,empty,mBC-0716-2
"G11,H7",17177,17329,12825,4504,8485,0,3835,3848,2660,1188,2.239057239,1848,2761,1183,645,0,645,0,226,0,0.051162791,empty,mBC-0716-2
"G11,H8",13490,14013,10225,3788,6741,31,3159,3196,2257,939,2.403620873,1490,1412,851,503,0,503,0,197,0,0.021868787,empty,mBC-0716-2
"G11,H9",15500,16190,11730,4460,7819,1,3588,3596,2524,1072,2.354477612,1708,1018,584,352,0,352,0,151,0,0.022727273,empty,mBC-0716-2
"G11,H10",14985,15610,11426,4184,7549,21,3502,3536,2524,1012,2.494071146,1755,900,486,314,0,314,0,155,0,0.02866242,empty,mBC-0716-2
"G11,H11",1483758,1645166,1036812,608354,791912,5,464621,465288,363368,101920,3.56522763,262712,3482,1997,1130,0,1130,0,301,0,0.007964602,mm10,mBC-0716-2
"G11,H12",6234,6414,4613,1801,3153,16,1472,1491,1070,421,2.541567696,744,433,261,152,0,152,0,66,0,0.085526316,empty,mBC-0716-2
"G12,A1",14394,15263,10950,4313,7418,0,3540,3545,2470,1075,2.297674419,1757,1004,590,363,0,363,0,144,0,0.055096419,empty,mBC-0716-2
"G12,A2",949710,1025230,671960,353270,489204,1,273133,273564,231824,41740,5.554000958,146938,81692,53450,30280,14,30266,1,3104,0,0.001255534,mm10,mBC-0716-2
"G12,A3",17342,18195,13253,4942,8917,0,4221,4233,3001,1232,2.435876623,2048,1045,569,364,0,364,0,160,0,0.032967033,empty,mBC-0716-2
"G12,A4",22426,22888,17318,5570,10963,0,4933,4943,3473,1470,2.362585034,2266,752,410,247,0,247,0,106,0,0.076923077,empty,mBC-0716-2
"G12,A5",630645,678328,467186,211142,334208,2,176046,176336,133121,43215,3.080435034,92780,10119,6076,3570,0,3570,0,838,0,0.008123249,mm10,mBC-0716-2
"G12,A6",13180,13649,10183,3466,6602,0,3036,3044,2084,960,2.170833333,1434,1461,852,523,0,523,0,228,0,0.070745698,empty,mBC-0716-2
"G12,A7",16822,17386,12967,4419,8387,0,3828,3836,2689,1147,2.344376635,1785,1036,609,416,0,416,0,174,0,0.038461538,empty,mBC-0716-2
"G12,A8",11217,11609,8527,3082,5746,1,2604,2605,1835,770,2.383116883,1253,1195,726,418,0,418,0,180,0,0.076555024,empty,mBC-0716-2
"G12,A9",19300,19786,14942,4844,9356,22,4140,4169,2985,1184,2.521114865,1874,1242,737,472,1,471,1,220,0,0.04670913,empty,mBC-0716-2
"G12,A10",16446,17076,12455,4621,8245,0,3807,3815,2695,1120,2.40625,1854,413,253,151,0,151,0,90,0,0.013245033,empty,mBC-0716-2
"G12,A11",18315,18923,13971,4952,9265,0,4257,4263,2965,1298,2.284283513,2017,1301,731,462,0,462,0,185,0,0.067099567,empty,mBC-0716-2
"G12,A12",22372,23215,17134,6081,10920,4,4903,4912,3445,1467,2.348329925,2335,13783,4481,2641,2,2639,2,702,0,0.034482759,empty,mBC-0716-2
"G12,B1",584897,604489,443870,160619,294807,0,138228,138467,105596,32871,3.212436494,68577,8289,5345,3047,3,3044,1,705,0,0.002956636,mm10,mBC-0716-2
"G12,B2",1011553,1105125,722755,382370,530289,0,304499,304926,218488,86438,2.527684583,166132,9514,5872,3331,0,3331,0,808,0,0.001801261,mm10,mBC-0716-2
"G12,B3",18999,19462,14616,4846,9459,0,4266,4275,3007,1268,2.371451104,2045,1004,571,376,0,376,0,164,0,0.007978723,empty,mBC-0716-2
"G12,B4",17655,18252,13591,4661,8771,0,3920,3926,2758,1168,2.36130137,1922,1167,697,448,0,448,0,153,0,0.008928571,empty,mBC-0716-2
"G12,B5",9516,5494,3769,1725,3488,0,1730,1742,1205,537,2.243947858,926,793,463,277,1,276,1,120,0,0.025362319,empty,mBC-0716-2
"G12,B6",1322042,1454316,950900,503416,697367,1,384280,384865,322462,62403,5.167411823,210180,146313,88857,50251,25,50226,2,4335,0,0.00075658,mm10,mBC-0716-2
"G12,B7",17658,18225,13478,4747,8697,14,3867,3891,2759,1132,2.437279152,1852,1194,746,423,0,423,0,154,0,0.04964539,empty,mBC-0716-2
"G12,B8",13923,14150,10609,3541,6932,0,3105,3109,2196,913,2.405257393,1435,1093,651,393,0,393,0,187,0,0.050890585,empty,mBC-0716-2
"G12,B9",16253,16966,12500,4466,8072,0,3659,3673,2537,1136,2.233274648,1801,646,356,228,0,228,0,116,0,0.004385965,empty,mBC-0716-2
"G12,B10",16917,17356,12565,4791,8603,2,3988,4001,2756,1245,2.213654618,1977,600,346,192,0,192,0,90,0,0.015625,empty,mBC-0716-2
"G12,B11",16508,17370,12543,4827,8359,2,3918,3927,2723,1204,2.261627907,1957,191,120,82,0,82,0,61,0,0,empty,mBC-0716-2
"G12,B12",18930,19533,14471,5062,9437,0,4264,4271,3006,1265,2.376284585,2022,1215,695,406,0,406,0,170,0,0.044334975,empty,mBC-0716-2
"G12,C1",24020,24514,18562,5952,11520,0,4892,4905,3385,1520,2.226973684,2259,819,501,304,0,304,0,127,0,0.026315789,empty,mBC-0716-2
"G12,C2",18602,19591,13928,5663,9373,11,4396,4417,3019,1398,2.159513591,2268,1347,801,476,0,476,0,181,0,0.113445378,empty,mBC-0716-2
"G12,C3",20748,21536,15646,5890,10308,8,4849,4869,3415,1454,2.34869326,2389,479,259,160,0,160,0,72,0,0.025,empty,mBC-0716-2
"G12,C4",17864,18265,13663,4602,8905,0,4000,4009,2803,1206,2.324212272,1883,1081,681,399,1,398,1,143,0,0.050251256,empty,mBC-0716-2
"G12,C5",19303,20411,14339,6072,9752,0,4732,4744,3300,1444,2.28531856,2462,1589,797,454,1,453,1,204,0,0.011037528,empty,mBC-0716-2
"G12,C6",17141,17500,12859,4641,8780,0,4003,4004,2800,1204,2.325581395,1928,2979,1124,688,2,686,2,258,0,0.069970845,empty,mBC-0716-2
"G12,C7",17559,18079,13443,4636,8665,4,3919,3937,2747,1190,2.308403361,1848,440,267,171,1,170,1,80,0,0.082352941,empty,mBC-0716-2
"G12,C8",28995,30876,22254,8622,14670,20,7048,7075,4682,2393,1.956539908,3504,2282,1413,860,0,860,0,261,0,0.019767442,empty,mBC-0716-2
"G12,C9",13352,13865,10161,3704,6664,0,3100,3105,2196,909,2.415841584,1517,752,437,297,0,297,0,139,0,0.023569024,empty,mBC-0716-2
"G12,C10",14598,15026,11120,3906,7365,0,3318,3325,2324,1001,2.321678322,1596,1437,838,500,0,500,0,187,0,0.082,empty,mBC-0716-2
"G12,C11",12258,12903,9371,3532,6303,0,3006,3006,2087,919,2.270946681,1452,744,470,279,0,279,0,136,0,0.043010753,empty,mBC-0716-2
"G12,C12",20386,20913,15669,5244,10060,0,4575,4585,3261,1324,2.462990937,2125,1767,759,446,0,446,0,181,0,0.056053812,empty,mBC-0716-2
"G12,D1",12155,12522,9094,3428,6161,23,2925,2966,2040,926,2.203023758,1455,537,340,186,1,185,1,98,0,0.005405405,empty,mBC-0716-2
"G12,D2",23521,24607,17844,6763,11665,0,5275,5287,3638,1649,2.206185567,2574,43007,12455,7440,10,7430,3,1565,0,0.022072678,empty,mBC-0716-2
"G12,D3",14289,15158,10688,4470,7222,3,3487,3499,2395,1104,2.169384058,1754,1387,771,479,0,479,0,207,0,0.008350731,empty,mBC-0716-2
"G12,D4",14982,15738,11452,4286,7682,17,3556,3579,2520,1059,2.379603399,1795,1171,679,426,0,426,0,218,0,0.037558685,empty,mBC-0716-2
"G12,D5",14094,14705,10726,3979,7232,6,3388,3395,2382,1013,2.351431392,1660,1026,542,341,0,341,0,163,0,0.026392962,empty,mBC-0716-2
"G12,D6",12702,13591,9531,4060,6537,16,3152,3176,2132,1044,2.042145594,1678,1294,703,449,0,449,0,192,0,0.031180401,empty,mBC-0716-2
"G12,D7",13362,13877,10140,3737,6620,12,3043,3065,2099,966,2.172877847,1490,1407,821,474,0,474,0,190,0,0.082278481,empty,mBC-0716-2
"G12,D8",16544,17666,12399,5267,8651,0,4226,4232,2937,1295,2.267953668,2177,893,495,318,0,318,0,160,0,0.031446541,empty,mBC-0716-2
"G12,D9",5243,5297,3809,1488,2733,0,1345,1347,967,380,2.544736842,689,2221,1069,644,1,643,1,275,0,0.035769829,empty,mBC-0716-2
"G12,D10",14068,14602,10658,3944,7037,0,3316,3333,2292,1041,2.201729107,1615,1375,625,337,0,337,0,126,0,0.065281899,empty,mBC-0716-2
"G12,D11",2712155,2946322,1920958,1025364,1373853,2,804457,805638,634567,171071,3.709377978,437006,198615,126706,71123,26,71097,4,5075,0,0.003333474,mm10,mBC-0716-2
"G12,D12",21200,22039,16080,5959,10463,0,4897,4906,3426,1480,2.314864865,2388,5308,2255,1349,1,1348,1,416,0,0.053412463,empty,mBC-0716-2
"G12,E1",22621,23115,17139,5976,10999,4,4901,4924,3506,1418,2.472496474,2348,1603,896,571,0,571,0,237,0,0.036777583,empty,mBC-0716-2
"G12,E2",1642925,1744187,1185317,558870,824898,1,438290,438960,352172,86788,4.057842098,231532,192819,125634,69473,28,69445,2,4832,0,0.001022392,mm10,mBC-0716-2
"G12,E3",14906,15107,11621,3486,7359,0,3155,3161,2225,936,2.377136752,1398,1641,976,575,0,575,0,260,0,0.017391304,empty,mBC-0716-2
"G12,E4",16510,16832,12691,4141,8029,0,3625,3641,2548,1093,2.331198536,1704,1306,738,437,0,437,0,175,0,0.025171625,empty,mBC-0716-2
"G12,E5",22999,23250,17545,5705,11077,1,4932,4948,3523,1425,2.472280702,2255,10437,3281,2014,0,2014,0,556,0,0.081926514,empty,mBC-0716-2
"G12,E6",14176,14829,10869,3960,7136,6,3244,3252,2274,978,2.325153374,1546,1367,765,455,0,455,0,225,0,0.050549451,empty,mBC-0716-2
"G12,E7",14377,14659,10920,3739,7148,0,3227,3238,2236,1002,2.231536926,1603,2429,1138,672,0,672,0,261,0,0.03422619,empty,mBC-0716-2
"G12,E8",18803,19156,14435,4721,9221,0,4090,4097,2833,1264,2.241297468,1904,1474,862,534,1,533,1,224,0,0.009380863,empty,mBC-0716-2
"G12,E9",9590,9822,7170,2652,4718,42,2101,2144,1473,671,2.195230999,1038,1103,647,411,1,410,1,159,0,0.029268293,empty,mBC-0716-2
"G12,E10",13319,13821,10185,3636,6800,0,3104,3108,2154,954,2.257861635,1494,1088,634,391,0,391,0,173,0,0.058823529,empty,mBC-0716-2
"G12,E11",9431,9895,7093,2802,4796,1,2212,2219,1529,690,2.215942029,1065,876,551,315,0,315,0,146,0,0.019047619,empty,mBC-0716-2
"G12,E12",16203,16575,12069,4506,8115,57,3676,3750,2610,1140,2.289473684,1886,15313,4853,2958,2,2956,2,718,0,0.184709066,empty,mBC-0716-2
"G12,F1",1061877,1208167,710728,497439,581236,1,369591,370126,248321,121805,2.038676573,219010,21258,13557,7617,7,7610,3,1445,0,0.006044678,mm10,mBC-0716-2
"G12,F2",23834,24392,18081,6311,11922,0,5465,5476,3838,1638,2.343101343,2632,6244,2403,1435,1,1434,1,511,0,0.021617852,empty,mBC-0716-2
"G12,F3",16454,17337,12508,4829,8424,0,4062,4066,2804,1262,2.221870048,1995,1558,948,570,0,570,0,251,0,0.015789474,empty,mBC-0716-2
"G12,F4",16158,16365,12231,4134,8097,0,3607,3611,2512,1099,2.285714286,1683,1391,486,290,0,290,0,120,0,0.04137931,empty,mBC-0716-2
"G12,F5",25977,26700,19753,6947,12839,19,5823,5854,4138,1716,2.411421911,2779,3087,1217,706,1,705,1,298,0,0.05106383,empty,mBC-0716-2
"G12,F6",23519,23911,18041,5870,11584,1,5254,5266,3706,1560,2.375641026,2467,2062,1162,683,0,683,0,272,0,0.057101025,empty,mBC-0716-2
"G12,F7",21270,21788,16257,5531,10661,12,4823,4844,3394,1450,2.340689655,2274,901,502,304,1,303,1,134,0,0.04620462,empty,mBC-0716-2
"G12,F8",24293,25605,18466,7139,12422,16,5803,5832,4135,1697,2.436652917,2907,636,290,195,0,195,0,112,0,0.015384615,empty,mBC-0716-2
"G12,F9",15695,16028,11813,4215,7803,7,3565,3577,2471,1106,2.234177215,1682,1220,706,447,0,447,0,170,0,0.131991051,empty,mBC-0716-2
"G12,F10",21574,22029,16384,5645,10901,0,4841,4852,3402,1450,2.346206897,2373,1284,798,493,0,493,0,183,0,0.034482759,empty,mBC-0716-2
"G12,F11",187848,205084,134522,70562,99382,0,54391,54479,39212,15267,2.568415537,29541,25589,16996,9441,1,9440,1,1306,0,0.003177966,mm10,mBC-0716-2
"G12,F12",702404,758914,513241,245673,363872,0,188409,188706,163875,24831,6.599613386,100798,4778,3075,1733,1,1732,1,451,0,0,mm10,mBC-0716-2
"G12,G1",10649,10838,8440,2398,5256,8,2193,2205,1544,661,2.335854766,943,1624,1048,615,0,615,0,217,0,0.043902439,empty,mBC-0716-2
"G12,G2",22086,22694,16996,5698,10831,16,4826,4845,3424,1421,2.409570725,2273,637,400,254,0,254,0,127,0,0,empty,mBC-0716-2
"G12,G3",20383,20878,15529,5349,10125,0,4697,4704,3256,1448,2.248618785,2224,2054,1271,777,0,777,0,293,0,0.033462033,empty,mBC-0716-2
"G12,G4",29519,29863,22378,7485,14217,21,6184,6226,4375,1851,2.36358725,2997,190,97,63,0,63,0,44,0,0.031746032,empty,mBC-0716-2
"G12,G5",14383,14813,10990,3823,7312,0,3413,3416,2418,998,2.422845691,1621,1240,725,442,0,442,0,187,0,0.058823529,empty,mBC-0716-2
"G12,G6",25310,25617,19409,6208,12356,18,5488,5517,3956,1561,2.534272902,2534,250,163,122,0,122,0,72,0,0.057377049,empty,mBC-0716-2
"G12,G7",21462,22206,16291,5915,10690,0,4856,4872,3512,1360,2.582352941,2301,1643,990,604,1,603,1,255,0,0.021558872,empty,mBC-0716-2
"G12,G8",15373,16221,11538,4683,7787,3,3728,3734,2650,1084,2.444649446,1870,1234,747,468,0,468,0,208,0,0.032051282,empty,mBC-0716-2
"G12,G9",11669,11952,8843,3109,5798,0,2682,2685,1903,782,2.433503836,1298,1244,749,482,0,482,0,213,0,0.085062241,empty,mBC-0716-2
"G12,G10",2782301,3110476,1944973,1165503,1458371,8,877243,878517,726001,152516,4.760162868,491510,213874,134462,75503,29,75474,3,5373,0,0.002040438,mm10,mBC-0716-2
"G12,G11",13041,13312,9888,3424,6461,0,2961,2969,2081,888,2.343468468,1390,621,354,227,0,227,0,128,0,0,empty,mBC-0716-2
"G12,G12",11863,12207,8952,3255,5930,0,2785,2795,2000,795,2.51572327,1330,928,555,331,1,330,1,134,0,0.103030303,empty,mBC-0716-2
"G12,H1",22114,22756,16796,5960,10915,0,4921,4930,3519,1411,2.493975904,2429,898,520,306,0,306,0,141,0,0.04248366,empty,mBC-0716-2
"G12,H2",29869,31022,22608,8414,15082,14,7178,7214,5219,1995,2.6160401,3582,1837,1148,724,1,723,1,269,0,0.045643154,empty,mBC-0716-2
"G12,H3",20990,21233,15978,5255,10250,3,4767,4776,3390,1386,2.445887446,2174,1842,967,567,0,567,0,233,0,0.0335097,empty,mBC-0716-2
"G12,H4",14497,14993,10811,4182,7168,7,3405,3419,2404,1015,2.368472906,1682,187,106,72,0,72,0,50,0,0,empty,mBC-0716-2
"G12,H5",18335,19414,13836,5578,9230,14,4347,4367,3112,1255,2.479681275,2230,1322,752,488,0,488,0,214,0,0.045081967,empty,mBC-0716-2
"G12,H6",1509554,1665662,1030127,635535,804050,0,489998,490635,389947,100688,3.872824964,277220,69049,42224,23794,7,23787,1,3048,0,0.002480346,mm10,mBC-0716-2
"G12,H7",17394,18320,13079,5241,9010,13,4178,4196,3049,1147,2.658238884,2110,1198,760,443,0,443,0,194,0,0.031602709,empty,mBC-0716-2
"G12,H8",14144,14658,10781,3877,7031,6,3231,3245,2236,1009,2.2160555,1562,4508,1784,1062,0,1062,0,372,0,0.02165725,empty,mBC-0716-2
"G12,H9",653407,700771,473644,227127,341973,1,179315,179587,136849,42738,3.202045018,96337,40253,25546,14462,6,14456,1,2098,0,0.005534034,mm10,mBC-0716-2
"G12,H10",14987,15399,11271,4128,7461,19,3439,3463,2430,1033,2.352371733,1716,1307,794,494,0,494,0,234,0,0.004048583,empty,mBC-0716-2
"G12,H11",17401,18316,13172,5144,8952,0,4256,4267,2913,1354,2.15140325,2117,153,89,66,0,66,0,54,0,0,empty,mBC-0716-2
"G12,H12",6386,6630,4726,1904,3262,0,1581,1585,1095,490,2.234693878,796,649,377,240,0,240,0,100,0,0.058333333,empty,mBC-0716-2
"H1,A1",21521,22622,16017,6605,10958,0,5208,5219,3590,1629,2.203806016,2676,10893,3326,1972,2,1970,1,524,0,0.021827411,empty,mBC-0716-2
"H1,A2",1193030,1281391,840025,441366,606399,8,346020,346553,247620,98933,2.502906007,189104,21999,12952,7581,6,7575,2,1440,0,0.013069307,mm10,mBC-0716-2
"H1,A3",22123,22735,16761,5974,10728,19,5022,5057,3521,1536,2.292317708,2426,4508,1532,921,0,921,0,316,0,0.066232356,empty,mBC-0716-2
"H1,A4",1305875,1431954,951559,480395,670510,4,369559,370165,302459,67706,4.467240717,198430,15104,8352,4652,3,4649,1,1002,0,0.006453001,mm10,mBC-0716-2
"H1,A5",2218811,2459003,1611419,847584,1154158,35,653547,654526,514231,140295,3.665355145,357348,119735,72240,40590,13,40577,3,3861,0,0.001330803,mm10,mBC-0716-2
"H1,A6",1298634,1420273,866858,553415,674929,16,413512,414124,314442,99682,3.154451155,235376,55047,35707,20176,7,20169,1,2700,0,0.003123606,mm10,mBC-0716-2
"H1,A7",1175213,1282700,837519,445181,606838,85,334553,335149,287552,47597,6.041389163,180912,88696,57863,32457,13,32444,2,3119,0,0.001171249,mm10,mBC-0716-2
"H1,A8",1045355,1084885,799904,284981,531131,2,237489,237962,168938,69024,2.447525498,124719,42817,23991,13614,4,13610,1,2393,0,0.005878031,mm10,mBC-0716-2
"H1,A9",27878,28682,21322,7360,13532,28,6177,6216,4459,1757,2.537848606,2939,1471,876,544,0,544,0,214,0,0.055147059,empty,mBC-0716-2
"H1,A10",21661,22603,16612,5991,10703,13,4873,4901,3422,1479,2.31372549,2366,436,270,177,0,177,0,101,0,0.016949153,empty,mBC-0716-2
"H1,A11",690955,744975,515396,229579,361505,0,186820,187088,127376,59712,2.133172562,97239,16701,10754,6180,3,6177,1,1154,0,0.00372349,mm10,mBC-0716-2
"H1,A12",26621,27385,20441,6944,12977,7,5834,5866,4107,1759,2.334849346,2761,2249,1348,777,1,776,1,244,0,0.047680412,empty,mBC-0716-2
"H1,B1",23282,23833,17612,6221,11279,0,5075,5086,3517,1569,2.241555131,2375,1001,608,355,0,355,0,163,0,0.033802817,empty,mBC-0716-2
"H1,B2",22834,23941,17318,6623,11387,22,5197,5228,3651,1577,2.315155358,2553,473,269,164,0,164,0,65,0,0.079268293,empty,mBC-0716-2
"H1,B3",24843,25355,18730,6625,12107,0,5567,5582,3997,1585,2.521766562,2695,4802,2020,1203,2,1201,1,353,0,0.194837635,empty,mBC-0716-2
"H1,B4",19737,20710,15152,5558,9847,4,4465,4481,3100,1381,2.244750181,2165,1084,651,390,0,390,0,148,0,0.023076923,empty,mBC-0716-2
"H1,B5",13190,8137,5717,2420,5118,19,2420,2453,1742,711,2.450070323,1354,974,473,284,0,284,0,119,0,0.080985915,empty,mBC-0716-2
"H1,B6",16959,17865,12773,5092,8453,0,4042,4050,2875,1175,2.446808511,1993,1016,583,352,0,352,0,162,0,0.03125,empty,mBC-0716-2
"H1,B7",19846,20245,15138,5107,9782,10,4395,4422,3139,1283,2.446609509,2025,907,483,278,0,278,0,136,0,0.050359712,empty,mBC-0716-2
"H1,B8",17051,17575,12929,4646,8442,4,3898,3912,2775,1137,2.440633245,1862,7073,2391,1492,1,1491,1,509,0,0.039570758,empty,mBC-0716-2
"H1,B9",1076778,1161427,792191,369236,548925,20,290024,290525,238358,52167,4.569133744,152188,18274,11498,6620,5,6615,1,1152,0,0.001360544,mm10,mBC-0716-2
"H1,B10",21455,22060,16047,6013,10815,0,5074,5080,3472,1608,2.15920398,2459,492,285,163,0,163,0,81,0,0.042944785,empty,mBC-0716-2
"H1,B11",28221,30187,21358,8829,14459,3,6974,7000,5027,1973,2.547896604,3592,249,155,93,1,92,1,57,0,0,empty,mBC-0716-2
"H1,B12",23332,23969,17747,6222,11718,0,5294,5304,3770,1534,2.457627119,2538,1161,669,398,0,398,0,149,0,0.060301508,empty,mBC-0716-2
"H1,C1",25018,25353,19449,5904,12181,0,5286,5303,3726,1577,2.362714014,2419,569,319,210,0,210,0,98,0,0.004761905,empty,mBC-0716-2
"H1,C2",24579,25648,18674,6974,11930,0,5474,5482,3817,1665,2.292492492,2593,1518,976,591,0,591,0,175,0,0.060913706,empty,mBC-0716-2
"H1,C3",23904,24760,18083,6677,11683,25,5432,5465,3797,1668,2.276378897,2657,674,378,213,0,213,0,98,0,0.107981221,empty,mBC-0716-2
"H1,C4",24467,25064,18581,6483,11874,0,5342,5361,3767,1594,2.363237139,2557,2927,996,595,1,594,1,202,0,0.107744108,empty,mBC-0716-2
"H1,C5",20669,21613,15495,6118,10383,0,4880,4893,3415,1478,2.310554804,2475,1519,912,551,0,551,0,200,0,0.065335753,empty,mBC-0716-2
"H1,C6",1107355,1214537,784648,429889,596356,5,335643,336124,276533,59591,4.640516185,185087,69774,45579,26016,20,25996,1,2897,0,0.00211571,mm10,mBC-0716-2
"H1,C7",21044,22040,15912,6128,10360,0,4950,4966,3388,1578,2.147021546,2406,372,217,139,0,139,0,74,0,0.021582734,empty,mBC-0716-2
"H1,C8",20312,20924,15478,5446,9972,30,4542,4588,3193,1395,2.288888889,2191,1395,830,494,0,494,0,205,0,0.038461538,empty,mBC-0716-2
"H1,C9",16851,17499,12817,4682,8414,1,3940,3946,2778,1168,2.378424658,1918,1098,544,299,0,299,0,129,0,0.013377926,empty,mBC-0716-2
"H1,C10",17539,18154,13311,4843,8702,0,3995,4011,2806,1205,2.328630705,1874,4348,1424,852,0,852,0,279,0,0.023474178,empty,mBC-0716-2
"H1,C11",642393,693777,468316,225461,342529,31,184519,184819,148724,36095,4.120349079,99247,23654,10390,5934,7,5927,2,1338,0,0.023789438,mm10,mBC-0716-2
"H1,C12",25783,26809,19408,7401,12643,9,5808,5830,4082,1748,2.335240275,2862,1069,670,381,0,381,0,159,0,0.047244094,empty,mBC-0716-2
"H1,D1",20477,21749,15391,6358,10198,1,4947,4955,3536,1419,2.491895701,2394,4845,1515,901,1,900,1,298,0,0.01,empty,mBC-0716-2
"H1,D2",25164,26093,19429,6664,12695,1,5706,5726,4041,1685,2.398219585,2664,2468,1466,927,0,927,0,329,0,0.045307443,empty,mBC-0716-2
"H1,D3",19095,19710,14200,5510,9435,0,4518,4527,3169,1358,2.333578792,2201,5528,1985,1247,2,1245,1,395,0,0.16064257,empty,mBC-0716-2
"H1,D4",18539,19386,14005,5381,9346,1,4192,4202,3045,1157,2.631806396,2091,1266,791,490,0,490,0,224,0,0.048979592,empty,mBC-0716-2
"H1,D5",18529,19286,14081,5205,9286,0,4322,4337,3046,1291,2.359411309,2098,2609,1022,667,0,667,0,249,0,0.065967016,empty,mBC-0716-2
"H1,D6",16433,17030,12347,4683,8122,0,3742,3747,2645,1102,2.400181488,1818,1112,622,394,0,394,0,180,0,0.030456853,empty,mBC-0716-2
"H1,D7",18065,18732,13605,5127,9050,1,4310,4325,2946,1379,2.136330674,2151,1400,806,481,0,481,0,187,0,0.058212058,empty,mBC-0716-2
"H1,D8",20877,21541,15822,5719,10410,1,4913,4920,3458,1462,2.365253078,2395,961,512,307,0,307,0,136,0,0.022801303,empty,mBC-0716-2
"H1,D9",10785,11154,8111,3043,5581,0,2684,2692,1976,716,2.759776536,1325,1554,918,534,1,533,1,231,0,0.061913696,empty,mBC-0716-2
"H1,D10",1141083,1224199,840761,383438,576050,0,295165,295636,253411,42225,6.001444642,153825,54404,35242,20021,10,20011,1,2452,0,0.000699615,mm10,mBC-0716-2
"H1,D11",16568,17507,12636,4871,8385,83,3853,3946,2763,1183,2.335587489,1935,1571,955,587,0,587,0,235,0,0.042589438,empty,mBC-0716-2
"H1,D12",25039,26044,19221,6823,12256,85,5526,5626,3993,1633,2.445192897,2589,1568,926,536,1,535,1,220,0,0.041121495,empty,mBC-0716-2
"H1,E1",28992,29335,21985,7350,13708,0,6110,6116,4284,1832,2.338427948,2817,35999,10456,6123,6,6117,1,1339,0,0.020271375,empty,mBC-0716-2
"H1,E2",22635,23524,16956,6568,11081,10,5099,5119,3609,1510,2.390066225,2459,3804,1505,923,0,923,0,316,0,0.126760563,empty,mBC-0716-2
"H1,E3",14471,14812,11057,3755,7294,2,3257,3264,2284,980,2.330612245,1560,1184,706,414,0,414,0,193,0,0.007246377,empty,mBC-0716-2
"H1,E4",19317,19885,14760,5125,9555,0,4377,4386,3099,1287,2.407925408,2133,1003,560,351,0,351,0,177,0,0.051282051,empty,mBC-0716-2
"H1,E5",24995,25903,19159,6744,12421,0,5603,5609,3984,1625,2.451692308,2725,1255,797,508,0,508,0,203,0,0.072834646,empty,mBC-0716-2
"H1,E6",19275,19903,14618,5285,9599,27,4415,4454,3113,1341,2.321401939,2203,1388,838,520,0,520,0,229,0,0.057692308,empty,mBC-0716-2
"H1,E7",19254,20099,14565,5534,9678,14,4507,4526,3192,1334,2.392803598,2227,1075,582,359,0,359,0,156,0,0.077994429,empty,mBC-0716-2
"H1,E8",21779,22173,16730,5443,10723,1,4743,4759,3417,1342,2.546199702,2232,1839,929,551,0,551,0,225,0,0.074410163,empty,mBC-0716-2
"H1,E9",14529,15214,10983,4231,7188,43,3329,3381,2296,1085,2.116129032,1697,1014,614,353,1,352,1,133,0,0.048295455,empty,mBC-0716-2
"H1,E10",1163840,1344489,793113,551376,640299,4,395379,395918,336020,59898,5.609870113,228798,88058,57702,32254,17,32237,2,3366,0,0.001364891,mm10,mBC-0716-2
"H1,E11",13054,13691,9909,3782,6573,0,3058,3063,2132,931,2.290010741,1509,1038,622,376,0,376,0,159,0,0.021276596,empty,mBC-0716-2
"H1,E12",20894,21151,15888,5263,10342,6,4690,4703,3283,1420,2.311971831,2194,834,486,282,0,282,0,122,0,0.014184397,empty,mBC-0716-2
"H1,F1",22248,23132,16913,6219,10992,3,5048,5061,3475,1586,2.191046658,2476,1553,900,546,0,546,0,230,0,0.027472527,empty,mBC-0716-2
"H1,F2",30107,30948,22455,8493,14639,5,6895,6923,4814,2109,2.282598388,3402,23528,7697,4538,5,4533,4,1082,0,0.102139863,empty,mBC-0716-2
"H1,F3",1108875,1230003,803836,426167,585541,7,321602,322150,251035,71115,3.529986641,175764,102429,67061,37741,25,37716,1,3524,0,0.001193128,mm10,mBC-0716-2
"H1,F4",23630,24198,18158,6040,11628,2,5237,5248,3680,1568,2.346938776,2460,297,147,100,0,100,0,54,0,0.14,empty,mBC-0716-2
"H1,F5",31217,32179,23741,8438,15306,0,6936,6961,4925,2036,2.418958743,3369,2924,1295,835,0,835,0,304,0,0.158083832,empty,mBC-0716-2
"H1,F6",32807,33406,25001,8405,15723,20,7087,7133,5052,2081,2.427679,3300,2319,1202,697,0,697,0,262,0,0.081779053,empty,mBC-0716-2
"H1,F7",24960,25850,19064,6786,12424,9,5686,5704,4046,1658,2.440289505,2726,796,459,265,0,265,0,113,0,0.022641509,empty,mBC-0716-2
"H1,F8",1068863,1120737,811944,308793,530356,10,252324,252792,203160,49632,4.093326886,125597,5853,3811,2229,3,2226,1,528,0,0.000898473,mm10,mBC-0716-2
"H1,F9",19149,19680,14681,4999,9366,4,4195,4206,2934,1272,2.306603774,2004,1417,803,498,0,498,0,216,0,0.02811245,empty,mBC-0716-2
"H1,F10",24067,24590,18631,5959,11644,1,5054,5069,3554,1515,2.345874587,2266,652,361,227,0,227,0,128,0,0.022026432,empty,mBC-0716-2
"H1,F11",14610,14802,10931,3871,7129,11,3211,3226,2238,988,2.265182186,1487,1953,852,500,0,500,0,194,0,0.15,empty,mBC-0716-2
"H1,F12",1243972,1430725,843087,587638,666920,3,418814,419421,358605,60816,5.896556827,241528,3894,2427,1307,1,1306,1,371,0,0,mm10,mBC-0716-2
"H1,G1",11763,12067,9149,2918,5974,0,2662,2670,1872,798,2.345864662,1246,2941,1361,783,1,782,1,252,0,0.039641944,empty,mBC-0716-2
"H1,G2",25533,26320,19290,7030,12385,0,5684,5706,4069,1637,2.485644472,2689,543,349,197,0,197,0,111,0,0.005076142,empty,mBC-0716-2
"H1,G3",26075,26723,19877,6846,12757,0,5825,5844,4141,1703,2.431591309,2782,3181,1464,874,0,874,0,325,0,0.038901602,empty,mBC-0716-2
"H1,G4",34882,36235,26804,9431,17030,84,7465,7567,5460,2107,2.591362126,3596,236,112,74,0,74,0,50,0,0,empty,mBC-0716-2
"H1,G5",17124,18013,13021,4992,8668,0,3981,4001,2835,1166,2.431389365,2017,1168,673,435,0,435,0,202,0,0.055172414,empty,mBC-0716-2
"H1,G6",1462504,1740554,943329,797225,822386,0,558364,559013,433134,125879,3.440875762,337264,2784,1709,974,0,974,0,292,0,0.004106776,empty,mBC-0716-2
"H1,G7",24423,24971,18966,6005,12010,11,5444,5464,3896,1568,2.484693878,2564,1662,966,587,0,587,0,239,0,0.063032368,empty,mBC-0716-2
"H1,G8",19207,19883,14484,5399,9712,0,4555,4563,3191,1372,2.325801749,2231,1821,929,559,0,559,0,229,0,0.032200358,empty,mBC-0716-2
"H1,G9",13450,13943,10290,3653,6691,5,3112,3129,2283,846,2.69858156,1481,1152,621,393,0,393,0,184,0,0.053435115,empty,mBC-0716-2
"H1,G10",16684,17202,12654,4548,8418,1,3895,3906,2736,1170,2.338461538,1929,1212,763,455,0,455,0,212,0,0.017582418,empty,mBC-0716-2
"H1,G11",15581,15974,11893,4081,7611,1,3404,3418,2370,1048,2.261450382,1571,500,301,194,0,194,0,93,0,0.010309278,empty,mBC-0716-2
"H1,G12",15485,15861,11829,4032,7678,0,3529,3539,2509,1030,2.43592233,1644,1885,897,575,0,575,0,203,0,0.093913043,empty,mBC-0716-2
"H1,H1",26421,27006,20184,6822,12763,0,5712,5733,4081,1652,2.470338983,2747,3301,1204,692,0,692,0,236,0,0.046242775,empty,mBC-0716-2
"H1,H2",1401177,1506503,1029359,477144,700866,4,364246,364914,317370,47544,6.675290257,191944,88515,57239,32322,17,32305,2,3126,0,0.000959604,mm10,mBC-0716-2
"H1,H3",1365073,1468336,1000212,468124,681268,64,355253,355908,299146,56762,5.270180755,187427,114139,66392,37352,20,37332,5,3662,0,0.001633987,mm10,mBC-0716-2
"H1,H4",1173376,1333395,805120,528275,630409,34,384634,385148,297609,87539,3.399730406,221672,2671,1614,978,0,978,0,283,0,0,empty,mBC-0716-2
"H1,H5",22624,23837,17165,6672,11402,14,5314,5340,3806,1534,2.481095176,2666,2341,1009,632,1,631,1,224,0,0.049128368,empty,mBC-0716-2
"H1,H6",21947,23163,16697,6466,11004,0,5071,5094,3541,1553,2.280103026,2523,1497,859,517,1,516,1,207,0,0.048449612,empty,mBC-0716-2
"H1,H7",23622,24096,17409,6687,11367,0,5265,5274,3718,1556,2.389460154,2610,13802,4681,2852,1,2851,1,713,0,0.122062434,empty,mBC-0716-2
"H1,H8",19017,19751,14326,5425,9560,0,4473,4496,3135,1361,2.303453343,2207,13387,4033,2426,2,2424,1,651,0,0.059818482,empty,mBC-0716-2
"H1,H9",23982,24578,18187,6391,11743,25,5313,5347,3839,1508,2.545755968,2599,2243,974,586,0,586,0,256,0,0.049488055,empty,mBC-0716-2
"H1,H10",21272,22053,16123,5930,10471,0,4865,4873,3389,1484,2.283692722,2396,1064,629,413,0,413,0,203,0,0.041162228,empty,mBC-0716-2
"H1,H11",22629,23583,17194,6389,11253,0,5157,5165,3622,1543,2.347375243,2547,357,177,129,0,129,0,62,0,0.054263566,empty,mBC-0716-2
"H1,H12",8638,8992,6503,2489,4316,0,2029,2032,1466,566,2.590106007,1002,542,307,174,0,174,0,87,0,0.045977011,empty,mBC-0716-2
"H2,A1",15548,16425,11873,4552,8062,12,3688,3708,2569,1139,2.25548727,1841,1156,680,422,0,422,0,187,0,0.026066351,empty,mBC-0716-2
"H2,A2",20525,20899,15708,5191,10258,0,4549,4567,3180,1387,2.292718097,2170,1185,693,402,0,402,0,176,0,0.069651741,empty,mBC-0716-2
"H2,A3",17213,17793,12843,4950,8655,0,4028,4039,2831,1208,2.343543046,2012,870,522,312,0,312,0,168,0,0.041666667,empty,mBC-0716-2
"H2,A4",21164,21736,16277,5459,10718,0,4786,4796,3445,1351,2.54996299,2312,1551,584,401,0,401,0,152,0,0.039900249,empty,mBC-0716-2
"H2,A5",18007,18984,13771,5213,9205,0,4304,4307,2932,1375,2.132363636,2086,1536,903,558,0,558,0,255,0,0.023297491,empty,mBC-0716-2
"H2,A6",13368,13753,10015,3738,6803,0,3094,3102,2181,921,2.368078176,1487,1290,790,506,0,506,0,212,0,0.06916996,empty,mBC-0716-2
"H2,A7",19330,19944,14350,5594,9697,1,4559,4572,3227,1345,2.399256506,2250,7385,2613,1607,1,1606,1,459,0,0.03362391,empty,mBC-0716-2
"H2,A8",1042905,1101220,767908,333312,541685,30,277693,278210,221261,56949,3.885248205,144605,118253,75343,42277,22,42255,2,3853,0,0.001538279,mm10,mBC-0716-2
"H2,A9",20994,21530,16223,5307,10353,5,4506,4533,3206,1327,2.415975885,2112,1215,696,432,0,432,0,204,0,0.009259259,empty,mBC-0716-2
"H2,A10",543496,571171,398434,172737,284865,3,144392,144626,109582,35044,3.126983221,75253,4703,2332,1392,1,1391,1,473,0,0.048885694,mm10,mBC-0716-2
"H2,A11",20031,20407,15267,5140,9978,9,4482,4500,3125,1375,2.272727273,2089,2468,1188,685,0,685,0,227,0,0.166423358,empty,mBC-0716-2
"H2,A12",21984,22401,17062,5339,10683,1,4712,4727,3297,1430,2.305594406,2142,2402,1404,815,0,815,0,266,0,0.087116564,empty,mBC-0716-2
"H2,B1",20100,20543,15424,5119,9832,6,4419,4445,3104,1341,2.314690529,2074,1207,719,433,0,433,0,164,0,0.060046189,empty,mBC-0716-2
"H2,B2",19766,20695,15211,5484,10019,7,4458,4474,3072,1402,2.191155492,2224,444,242,143,0,143,0,71,0,0.013986014,empty,mBC-0716-2
"H2,B3",19257,19684,14308,5376,9521,0,4407,4414,3066,1348,2.274480712,2185,6958,2370,1353,0,1353,0,414,0,0.107908352,empty,mBC-0716-2
"H2,B4",16668,17138,12883,4255,8331,1,3815,3820,2646,1174,2.253833049,1788,1125,638,403,0,403,0,145,0,0.084367246,empty,mBC-0716-2
"H2,B5",14970,11597,7818,3779,6759,0,3481,3500,2609,891,2.928170595,1916,658,379,255,0,255,0,108,0,0.137254902,empty,mBC-0716-2
"H2,B6",13705,14485,10411,4074,7080,0,3373,3390,2332,1058,2.20415879,1725,1378,781,455,0,455,0,189,0,0.057142857,empty,mBC-0716-2
"H2,B7",17062,16885,12861,4024,8304,0,3673,3673,2622,1051,2.494766889,1655,11230,3383,2002,2,2000,1,518,0,0.1085,empty,mBC-0716-2
"H2,B8",14763,15523,11331,4192,7571,3,3413,3425,2434,991,2.456104945,1648,1242,741,458,0,458,0,201,0,0.024017467,empty,mBC-0716-2
"H2,B9",15280,15880,11786,4094,7608,16,3388,3414,2373,1041,2.279538905,1629,6099,1792,1077,2,1075,2,362,0,0.052093023,empty,mBC-0716-2
"H2,B10",1595388,1646368,1101239,545129,822811,9,444948,446148,358008,88140,4.061810756,241669,46345,27461,15190,8,15182,1,2222,0,0.001844289,mm10,mBC-0716-2
"H2,B11",16863,17297,13026,4271,8272,1,3718,3724,2593,1131,2.292661362,1741,259,152,113,0,113,0,68,0,0.061946903,empty,mBC-0716-2
"H2,B12",18960,19909,14510,5399,9757,1,4400,4409,3149,1260,2.499206349,2128,1300,819,469,0,469,0,167,0,0.070362473,empty,mBC-0716-2
"H2,C1",22455,22662,17229,5433,10999,0,4793,4808,3392,1416,2.395480226,2231,4895,1484,940,0,940,0,325,0,0.055319149,empty,mBC-0716-2
"H2,C2",19529,19737,14608,5129,9495,1,4352,4369,3084,1285,2.4,2095,4019,1569,960,0,960,0,324,0,0.072916667,empty,mBC-0716-2
"H2,C3",20585,21483,15497,5986,10239,27,4698,4732,3249,1483,2.1908294,2347,682,373,219,0,219,0,95,0,0.02283105,empty,mBC-0716-2
"H2,C4",19155,19757,14261,5496,9435,1,4272,4289,2956,1333,2.217554389,2140,6270,1698,1023,2,1021,2,329,0,0.035259549,empty,mBC-0716-2
"H2,C5",17190,18032,12929,5103,8826,0,4174,4182,2950,1232,2.394480519,2090,1087,662,409,0,409,0,178,0,0.075794621,empty,mBC-0716-2
"H2,C6",17588,17935,13309,4626,9112,9,4258,4274,3098,1176,2.634353741,2079,1373,817,461,0,461,0,192,0,0.062906725,empty,mBC-0716-2
"H2,C7",16989,17628,12931,4697,8687,1,4001,4015,2828,1187,2.382476832,1967,1184,449,293,0,293,0,123,0,0.020477816,empty,mBC-0716-2
"H2,C8",17574,17175,12427,4748,8331,5,3941,3951,2686,1265,2.123320158,1939,10971,3706,2238,1,2237,1,636,0,0.073312472,empty,mBC-0716-2
"H2,C9",13755,14049,10389,3660,6742,12,3013,3031,2157,874,2.467963387,1449,835,466,281,0,281,0,137,0,0.039145907,empty,mBC-0716-2
"H2,C10",848532,923869,586046,337823,454625,50,270463,270885,207581,63304,3.279113484,151026,5698,3576,1902,1,1901,1,579,0,0.014203051,mm10,mBC-0716-2
"H2,C11",11938,12469,9132,3337,5994,11,2711,2730,1892,838,2.257756563,1248,911,561,327,0,327,0,152,0,0.03058104,empty,mBC-0716-2
"H2,C12",20809,21245,15678,5567,10260,2,4658,4676,3348,1328,2.521084337,2213,1016,577,328,1,327,1,134,0,0.03058104,empty,mBC-0716-2
"H2,D1",12622,13079,9455,3624,6451,2,3114,3120,2192,928,2.362068966,1498,1285,524,297,0,297,0,127,0,0.02020202,empty,mBC-0716-2
"H2,D2",1713561,1842065,1240824,601241,885240,35,483926,484799,401533,83266,4.822292412,255776,208043,135429,74554,29,74525,2,5260,0,0.001502851,mm10,mBC-0716-2
"H2,D3",14366,15082,10842,4240,7440,15,3521,3544,2509,1035,2.424154589,1772,1151,684,383,1,382,1,181,0,0.041884817,empty,mBC-0716-2
"H2,D4",15036,15444,11567,3877,7488,6,3415,3430,2451,979,2.503575077,1566,1287,791,512,0,512,0,248,0,0.0234375,empty,mBC-0716-2
"H2,D5",14376,14873,10692,4181,7256,0,3402,3414,2354,1060,2.220754717,1694,1087,643,406,0,406,0,175,0,0.007389163,empty,mBC-0716-2
"H2,D6",13323,14187,10009,4178,6925,0,3369,3374,2375,999,2.377377377,1667,1200,744,446,0,446,0,188,0,0.065022422,empty,mBC-0716-2
"H2,D7",14172,14532,10715,3817,7051,0,3281,3294,2276,1018,2.235756385,1614,17388,4274,2588,0,2588,0,627,0,0.049459042,empty,mBC-0716-2
"H2,D8",1093684,1272944,720774,552170,617458,0,400618,401084,323709,77375,4.183638126,238033,43639,27923,15522,8,15514,1,2057,0,0.001160242,mm10,mBC-0716-2
"H2,D9",6076,6220,4460,1760,3208,9,1502,1513,1061,452,2.347345133,772,1410,755,492,0,492,0,263,0,0.008130081,empty,mBC-0716-2
"H2,D10",14028,14670,10497,4173,7223,33,3357,3398,2432,966,2.517598344,1673,728,438,258,0,258,0,111,0,0.015503876,empty,mBC-0716-2
"H2,D11",14156,14609,10859,3750,7013,4,3235,3244,2329,915,2.545355191,1542,1480,956,573,0,573,0,245,0,0.045375218,empty,mBC-0716-2
"H2,D12",20548,21386,15705,5681,10121,7,4620,4633,3240,1393,2.325915291,2211,2300,1352,778,1,777,1,249,0,0.084942085,empty,mBC-0716-2
"H2,E1",22524,22921,17287,5634,11141,3,4914,4932,3469,1463,2.371155161,2306,1672,934,588,0,588,0,250,0,0.047619048,empty,mBC-0716-2
"H2,E2",17896,18579,13621,4958,9096,0,4162,4173,2895,1278,2.265258216,2017,1417,846,489,0,489,0,204,0,0.040899796,empty,mBC-0716-2
"H2,E3",865296,990626,577186,413440,481804,12,306369,306814,254823,51991,4.901290608,177813,110128,65464,36741,15,36726,1,3637,0,0.032892229,mm10,mBC-0716-2
"H2,E4",1052720,1133085,781523,351562,539349,32,278011,278458,216993,61465,3.530350606,144829,120032,63080,36009,19,35990,5,3803,0,0.02578494,mm10,mBC-0716-2
"H2,E5",21646,22340,16719,5621,10975,4,4932,4953,3502,1451,2.413507926,2271,1407,823,506,2,504,1,236,0,0.033730159,empty,mBC-0716-2
"H2,E6",14693,15360,11069,4291,7401,16,3363,3394,2393,1001,2.390609391,1768,1564,910,547,1,546,1,240,0,0.04029304,empty,mBC-0716-2
"H2,E7",14702,15362,11089,4273,7419,26,3410,3447,2385,1062,2.245762712,1727,2054,871,511,0,511,0,200,0,0.039138943,empty,mBC-0716-2
"H2,E8",779558,833510,559760,273750,411223,0,228716,229045,176241,52804,3.337644875,121407,10884,6956,3921,2,3919,1,911,0,0.006124011,mm10,mBC-0716-2
"H2,E9",10046,10519,7662,2857,5132,19,2352,2379,1648,731,2.254445964,1198,1175,711,402,1,401,1,168,0,0.074812968,empty,mBC-0716-2
"H2,E10",2097724,2377329,1428234,949095,1133260,2,717777,718724,520345,198379,2.622984288,412564,174539,100972,56399,22,56377,6,4584,0,0.008496373,mm10,mBC-0716-2
"H2,E11",9935,10486,7553,2933,5153,0,2430,2443,1707,736,2.319293478,1199,1061,664,376,1,375,1,161,0,0.042666667,empty,mBC-0716-2
"H2,E12",568963,604553,401212,203341,303418,6,169114,169372,132831,36541,3.635122192,91668,6587,3891,2156,0,2156,0,643,0,0.012523191,mm10,mBC-0716-2
"H2,F1",18874,19239,14419,4820,9440,0,4249,4258,3026,1232,2.456168831,2037,1377,813,492,0,492,0,201,0,0.056910569,empty,mBC-0716-2
"H2,F2",24462,25163,18191,6972,12132,0,5815,5823,4114,1709,2.407255705,2836,8791,3551,2241,1,2240,1,597,0,0.216964286,empty,mBC-0716-2
"H2,F3",16981,17817,12789,5028,8876,0,4289,4292,3008,1284,2.342679128,2189,2189,1179,709,0,709,0,283,0,0.023977433,empty,mBC-0716-2
"H2,F4",18240,18459,13945,4514,9149,4,4115,4134,2867,1267,2.262825572,1943,522,318,188,0,188,0,88,0,0.015957447,empty,mBC-0716-2
"H2,F5",25110,25619,19258,6361,12452,1,5564,5576,3912,1664,2.350961538,2653,1864,1120,708,0,708,0,283,0,0.035310734,empty,mBC-0716-2
"H2,F6",1060800,1146314,765228,381086,549608,8,297272,297748,237165,60583,3.914712048,160001,94370,55442,31006,10,30996,2,3297,0,0.002355143,mm10,mBC-0716-2
"H2,F7",20812,21499,15769,5730,10443,13,4724,4742,3339,1403,2.379900214,2330,776,495,280,0,280,0,131,0,0.057142857,empty,mBC-0716-2
"H2,F8",23415,24403,17874,6529,11819,23,5412,5442,3872,1570,2.466242038,2658,339,219,135,0,135,0,84,0,0.007407407,empty,mBC-0716-2
"H2,F9",14973,15430,11463,3967,7604,7,3467,3481,2489,992,2.509072581,1644,1582,917,509,0,509,0,201,0,0.027504912,empty,mBC-0716-2
"H2,F10",21011,21150,16246,4904,10313,0,4553,4567,3229,1338,2.413303438,2055,1332,765,470,1,469,1,177,0,0.068230277,empty,mBC-0716-2
"H2,F11",11596,11943,8902,3041,5792,7,2574,2583,1838,745,2.467114094,1223,951,565,357,1,356,1,163,0,0.061797753,empty,mBC-0716-2
"H2,F12",14776,15085,11195,3890,7270,0,3307,3318,2335,983,2.375381485,1585,193,117,80,0,80,0,50,0,0,empty,mBC-0716-2
"H2,G1",10059,10396,7750,2646,5231,1,2373,2379,1676,703,2.384068279,1125,4493,1868,1092,1,1091,1,317,0,0.036663611,empty,mBC-0716-2
"H2,G2",21298,21865,16041,5824,10608,0,4746,4748,3326,1422,2.338959212,2294,961,438,307,0,307,0,158,0,0.022801303,empty,mBC-0716-2
"H2,G3",20711,21270,15784,5486,10335,0,4700,4711,3269,1442,2.266990291,2225,2423,1277,812,1,811,1,305,0,0.044389642,empty,mBC-0716-2
"H2,G4",28346,28594,21846,6748,13971,4,6075,6089,4387,1702,2.577555817,2742,178,108,69,0,69,0,45,0,0,empty,mBC-0716-2
"H2,G5",14044,14622,10589,4033,7096,0,3259,3262,2246,1016,2.210629921,1581,1272,764,484,0,484,0,203,0,0.030991736,empty,mBC-0716-2
"H2,G6",996355,1102046,686010,416036,535738,2,324967,325390,240517,84873,2.833845864,181517,1881,1073,629,0,629,0,244,0,0.009538951,empty,mBC-0716-2
"H2,G7",20317,20907,15677,5230,10145,0,4521,4534,3189,1345,2.371003717,2125,2076,1195,727,1,726,1,241,0,0.073002755,empty,mBC-0716-2
"H2,G8",904648,938357,696755,241602,448250,0,208815,209185,150614,58571,2.571477352,102746,65886,42053,23558,7,23551,2,2771,0,0.002972273,mm10,mBC-0716-2
"H2,G9",11352,11761,8518,3243,5813,0,2810,2811,1983,828,2.394927536,1391,17572,5006,2969,4,2965,2,767,0,0.049578415,empty,mBC-0716-2
"H2,G10",14263,14876,10933,3943,7126,20,3259,3281,2349,932,2.520386266,1502,1425,853,524,0,524,0,225,0,0.066793893,empty,mBC-0716-2
"H2,G11",13749,14110,10329,3781,6827,1,3163,3169,2288,881,2.597048808,1499,2709,987,590,0,590,0,201,0,0.108474576,empty,mBC-0716-2
"H2,G12",12409,12860,9421,3439,6437,74,2909,2988,2106,882,2.387755102,1442,1084,639,363,0,363,0,132,0,0.066115702,empty,mBC-0716-2
"H2,H1",21796,22481,16770,5711,10883,1,4956,4975,3486,1489,2.34116857,2323,1021,581,354,0,354,0,152,0,0.028248588,empty,mBC-0716-2
"H2,H2",29481,30082,21914,8168,14738,0,6921,6927,4901,2026,2.41905232,3338,11152,3674,2180,1,2179,1,712,0,0.030289123,empty,mBC-0716-2
"H2,H3",23054,23923,17749,6174,11677,0,5434,5446,3788,1658,2.284680338,2674,2081,1127,624,1,623,1,255,0,0.009630819,empty,mBC-0716-2
"H2,H4",15066,15535,11317,4218,7751,2,3603,3612,2557,1055,2.423696682,1783,210,137,102,0,102,0,67,0,0,empty,mBC-0716-2
"H2,H5",18814,19439,14226,5213,9368,20,4277,4306,2975,1331,2.235161533,2101,1034,623,378,0,378,0,164,0,0.031746032,empty,mBC-0716-2
"H2,H6",16095,16686,12003,4683,7984,17,3602,3632,2550,1082,2.356746765,1795,1424,824,527,0,527,0,228,0,0.022770398,empty,mBC-0716-2
"H2,H7",17724,18224,13465,4759,9078,0,4180,4185,2935,1250,2.348,1993,1454,890,551,0,551,0,229,0,0.038112523,empty,mBC-0716-2
"H2,H8",14761,15130,11124,4006,7421,29,3432,3470,2452,1018,2.408644401,1698,2075,1134,705,0,705,0,268,0,0.063829787,empty,mBC-0716-2
"H2,H9",924252,986823,666659,320164,481608,14,261219,261603,186540,75063,2.485112505,140961,9441,5352,3170,5,3165,1,813,0,0.010110585,mm10,mBC-0716-2
"H2,H10",15397,15736,11725,4011,7629,0,3468,3474,2412,1062,2.271186441,1632,1225,680,432,0,432,0,221,0,0.06712963,empty,mBC-0716-2
"H2,H11",887350,983478,614132,369346,481968,9,289280,289670,210710,78960,2.668566363,163683,680,433,258,0,258,0,112,0,0,empty,mBC-0716-2
"H2,H12",6579,6758,4832,1926,3387,2,1629,1638,1136,502,2.262948207,858,649,378,226,0,226,0,90,0,0.097345133,empty,mBC-0716-2
"H3,A1",17907,18268,13545,4723,8966,19,4102,4123,2869,1254,2.287878788,1963,1893,766,464,0,464,0,188,0,0.019396552,empty,mBC-0716-2
"H3,A2",745345,761880,570703,191177,369372,1,168186,168553,134460,34093,3.943918106,81493,21896,10188,5928,2,5926,1,1264,0,0.015524806,mm10,mBC-0716-2
"H3,A3",18653,19271,14086,5185,9267,0,4368,4376,3052,1324,2.305135952,2069,1053,611,377,0,377,0,176,0,0.047745358,empty,mBC-0716-2
"H3,A4",23857,24643,18365,6278,11681,30,5128,5168,3563,1605,2.219937695,2446,1150,545,342,0,342,0,166,0,0.005847953,empty,mBC-0716-2
"H3,A5",19888,20415,15200,5215,9835,0,4495,4505,3149,1356,2.322271386,2156,1533,937,568,2,566,2,244,0,0.056537102,empty,mBC-0716-2
"H3,A6",842121,965972,569194,396778,467711,2,292794,293206,214104,79102,2.706682511,169629,60204,39894,22160,7,22153,1,2554,0,0.000812531,mm10,mBC-0716-2
"H3,A7",18057,18692,13806,4886,9247,3,4321,4327,2930,1397,2.097351467,2030,1325,740,442,0,442,0,163,0,0.047511312,empty,mBC-0716-2
"H3,A8",11758,12404,8901,3503,6148,0,2905,2906,2048,858,2.386946387,1428,1592,954,560,0,560,0,221,0,0.083928571,empty,mBC-0716-2
"H3,A9",22741,23169,17347,5822,11027,0,4798,4803,3443,1360,2.531617647,2284,1291,793,485,0,485,0,218,0,0.028865979,empty,mBC-0716-2
"H3,A10",20037,20902,15392,5510,9962,0,4633,4644,3271,1373,2.382374363,2231,613,327,205,0,205,0,113,0,0.034146341,empty,mBC-0716-2
"H3,A11",22391,22227,16676,5551,10554,27,4763,4797,3318,1479,2.243407708,2243,10820,3423,2069,3,2066,1,603,0,0.124878993,empty,mBC-0716-2
"H3,A12",23308,23958,18019,5939,11404,10,5038,5061,3614,1447,2.497581202,2375,2538,1533,919,0,919,0,296,0,0.072905332,empty,mBC-0716-2
"H3,B1",21371,21913,16468,5445,10463,0,4761,4773,3444,1329,2.591422122,2228,1132,694,397,0,397,0,170,0,0.01511335,empty,mBC-0716-2
"H3,B2",21110,21827,16054,5773,10543,0,4701,4714,3377,1337,2.525804039,2226,450,249,152,1,151,1,73,0,0,empty,mBC-0716-2
"H3,B3",22470,23355,16973,6382,11311,9,5227,5248,3714,1534,2.421121252,2540,1310,770,444,0,444,0,173,0,0.04954955,empty,mBC-0716-2
"H3,B4",18165,18914,13903,5011,9186,26,4227,4256,3060,1196,2.558528428,2022,1059,652,406,1,405,1,159,0,0.032098765,empty,mBC-0716-2
"H3,B5",10381,5927,4343,1584,3776,3,1767,1784,1237,547,2.26142596,915,990,619,347,0,347,0,128,0,0.103746398,empty,mBC-0716-2
"H3,B6",15045,15775,11415,4360,7578,1,3616,3620,2576,1044,2.46743295,1783,1194,703,401,0,401,0,174,0,0.014962594,empty,mBC-0716-2
"H3,B7",18576,18681,13894,4787,9001,12,4029,4053,2865,1188,2.411616162,1925,1098,679,370,0,370,0,159,0,0.016216216,empty,mBC-0716-2
"H3,B8",14637,15314,11080,4234,7463,0,3502,3507,2501,1006,2.486083499,1697,1057,665,405,0,405,0,196,0,0.019753086,empty,mBC-0716-2
"H3,B9",16504,17063,12753,4310,8140,3,3649,3663,2580,1083,2.382271468,1686,711,401,265,0,265,0,131,0,0.041509434,empty,mBC-0716-2
"H3,B10",19552,19879,14613,5266,9850,13,4532,4553,3084,1469,2.099387338,2276,485,261,174,0,174,0,88,0,0.017241379,empty,mBC-0716-2
"H3,B11",757229,793760,548281,245479,385911,29,205470,205830,163979,41851,3.918162051,106737,789,434,258,1,257,1,115,0,0.031128405,empty,mBC-0716-2
"H3,B12",20592,21461,15566,5895,10415,0,4831,4836,3438,1398,2.459227468,2380,1207,672,399,0,399,0,170,0,0.032581454,empty,mBC-0716-2
"H3,C1",24497,25083,18830,6253,12015,4,5327,5340,3847,1493,2.576691226,2513,634,367,243,0,243,0,136,0,0.057613169,empty,mBC-0716-2
"H3,C2",21893,22896,16682,6214,10861,8,4990,5003,3483,1520,2.291447368,2448,1590,925,504,0,504,0,196,0,0.011904762,empty,mBC-0716-2
"H3,C3",997778,1111693,701155,410538,535809,1,311676,312164,258822,53342,4.85212403,173488,21141,11369,6353,4,6349,1,1312,0,0.005512679,mm10,mBC-0716-2
"H3,C4",20841,20860,16127,4733,10188,0,4450,4463,3060,1403,2.181040627,2047,1347,841,454,0,454,0,173,0,0.04185022,empty,mBC-0716-2
"H3,C5",18758,19062,14300,4762,9144,0,4080,4087,2876,1211,2.37489678,1902,1390,779,478,1,477,1,212,0,0.027253669,empty,mBC-0716-2
"H3,C6",19285,19602,14365,5237,9820,0,4628,4639,3292,1347,2.443949517,2249,1299,792,478,0,478,0,203,0,0.012552301,empty,mBC-0716-2
"H3,C7",2468087,2739071,1725902,1013169,1273493,18,759489,760620,624209,136411,4.575943289,422766,31051,18691,10612,2,10610,1,1710,0,0.003770028,mm10,mBC-0716-2
"H3,C8",18026,18757,13486,5271,9009,38,4076,4123,2808,1315,2.135361217,2054,12310,3833,2296,3,2293,1,656,0,0.034888792,empty,mBC-0716-2
"H3,C9",14826,15096,11310,3786,7289,0,3224,3229,2244,985,2.278172589,1516,1125,699,382,0,382,0,166,0,0.052356021,empty,mBC-0716-2
"H3,C10",15866,16508,12136,4372,7955,9,3619,3638,2523,1115,2.262780269,1765,1442,755,467,0,467,0,181,0,0.164882227,empty,mBC-0716-2
"H3,C11",12404,13271,9432,3839,6455,10,3045,3064,2104,960,2.191666667,1494,928,580,361,0,361,0,164,0,0.063711911,empty,mBC-0716-2
"H3,C12",22458,22988,16833,6155,11201,35,5168,5214,3707,1507,2.459854015,2562,1167,549,337,0,337,0,134,0,0.068249258,empty,mBC-0716-2
"H3,D1",13889,14532,10389,4143,7151,2,3446,3454,2412,1042,2.314779271,1719,638,344,220,0,220,0,100,0,0.013636364,empty,mBC-0716-2
"H3,D2",1779621,1883036,1321866,561170,894682,8,460181,460967,371687,89280,4.163160842,235719,237262,144852,80153,27,80126,1,5382,0,0.003594339,mm10,mBC-0716-2
"H3,D3",15689,16190,11936,4254,7939,0,3829,3832,2634,1198,2.198664441,1828,896,546,329,0,329,0,173,0,0.021276596,empty,mBC-0716-2
"H3,D4",1987926,2221266,1415453,805813,1054856,4,611587,612597,489912,122685,3.993251009,339434,135500,86406,48754,14,48740,1,4178,0,0.001333607,mm10,mBC-0716-2
"H3,D5",16592,17470,12730,4740,8379,37,3892,3945,2712,1233,2.199513382,1941,1121,634,395,0,395,0,169,0,0.058227848,empty,mBC-0716-2
"H3,D6",14584,15131,10887,4244,7416,1,3511,3519,2421,1098,2.204918033,1796,1280,746,470,0,470,0,184,0,0.104255319,empty,mBC-0716-2
"H3,D7",15898,16722,12038,4684,7986,0,3771,3776,2637,1139,2.315188762,1861,1597,974,601,0,601,0,214,0,0.023294509,empty,mBC-0716-2
"H3,D8",18071,18943,13638,5305,9100,24,4241,4277,3020,1257,2.402545744,2117,1038,671,399,0,399,0,167,0,0.007518797,empty,mBC-0716-2
"H3,D9",456587,483266,337672,145594,237984,6,116350,116525,100378,16147,6.216510807,60455,140404,84653,47582,14,47568,2,3970,0,0.013223175,mm10,mBC-0716-2
"H3,D10",16552,17533,12522,5011,8433,104,3927,4034,2820,1214,2.322899506,1999,890,472,288,0,288,0,114,0,0.090277778,empty,mBC-0716-2
"H3,D11",14674,14871,11241,3630,7215,4,3233,3242,2301,941,2.445270988,1508,1418,845,512,0,512,0,224,0,0.037109375,empty,mBC-0716-2
"H3,D12",22963,23532,17446,6086,11306,3,5242,5250,3686,1564,2.356777494,2485,1997,1245,767,0,767,0,265,0,0.046936115,empty,mBC-0716-2
"H3,E1",24880,25235,18859,6376,12090,0,5408,5420,3875,1545,2.508090615,2577,5226,2147,1257,0,1257,0,420,0,0.042163882,empty,mBC-0716-2
"H3,E2",18983,19143,14394,4749,9314,20,4135,4166,2907,1259,2.308975377,1923,1291,729,425,1,424,1,180,0,0.044811321,empty,mBC-0716-2
"H3,E3",13890,14143,10679,3464,6943,5,3137,3149,2251,898,2.506681514,1455,1646,1038,640,0,640,0,272,0,0.040625,empty,mBC-0716-2
"H3,E4",17624,18099,13491,4608,8717,0,4017,4036,2870,1166,2.461406518,1973,1473,848,528,1,527,1,200,0,0.034155598,empty,mBC-0716-2
"H3,E5",35103,36323,27133,9190,17612,0,7868,7892,5858,2034,2.880039331,3788,2352,1388,826,1,825,1,291,0,0.007272727,empty,mBC-0716-2
"H3,E6",1058968,1175859,740827,435032,558677,1,326583,327078,234206,92872,2.521814971,183800,81062,52867,30020,11,30009,1,3005,0,0.000966377,mm10,mBC-0716-2
"H3,E7",16230,16586,12446,4140,8033,0,3675,3679,2615,1064,2.457706767,1735,1466,830,508,0,508,0,209,0,0.025590551,empty,mBC-0716-2
"H3,E8",20276,21082,15528,5554,10078,28,4526,4565,3194,1371,2.32968636,2231,1903,1130,699,1,698,1,270,0,0.065902579,empty,mBC-0716-2
"H3,E9",11288,11731,8598,3133,5731,0,2595,2603,1800,803,2.241594022,1312,995,577,357,0,357,0,148,0,0.025210084,empty,mBC-0716-2
"H3,E10",14741,15385,11326,4059,7321,1,3321,3332,2308,1024,2.25390625,1576,1201,717,431,0,431,0,177,0,0.013921114,empty,mBC-0716-2
"H3,E11",11106,11013,8295,2718,5574,54,2552,2617,1790,827,2.164449819,1224,2757,1114,684,1,683,1,231,0,0.048316252,empty,mBC-0716-2
"H3,E12",19163,20130,14481,5649,9693,0,4611,4614,3194,1420,2.249295775,2254,1046,625,378,0,378,0,158,0,0.047619048,empty,mBC-0716-2
"H3,F1",19685,19997,14944,5053,9806,33,4441,4485,3222,1263,2.551068884,2133,2109,1145,701,0,701,0,275,0,0.068473609,empty,mBC-0716-2
"H3,F2",2008544,2210440,1454227,756213,1043026,2,582606,583499,454877,128622,3.536541183,317232,239889,157208,88892,27,88865,4,5308,0,0.001215327,mm10,mBC-0716-2
"H3,F3",1949469,2081842,1415422,666420,980452,7,521294,522139,432704,89435,4.838195337,276618,197420,114777,64077,31,64046,4,5085,0,0.003278893,mm10,mBC-0716-2
"H3,F4",19424,19714,14750,4964,9766,0,4434,4452,3095,1357,2.280766396,2083,425,257,142,0,142,0,83,0,0.056338028,empty,mBC-0716-2
"H3,F5",28179,28816,21513,7303,13828,0,6260,6268,4365,1903,2.293746716,2981,2051,1075,685,0,685,0,317,0,0.03649635,empty,mBC-0716-2
"H3,F6",27542,28541,20813,7728,13824,0,6558,6574,4549,2025,2.246419753,3240,2158,1309,822,1,821,1,298,0,0.037758831,empty,mBC-0716-2
"H3,F7",29088,30877,21790,9087,14908,11,7380,7412,5189,2223,2.334233018,3750,699,432,265,0,265,0,132,0,0.064150943,empty,mBC-0716-2
"H3,F8",26187,26736,19962,6774,13068,3,6015,6027,4199,1828,2.297045952,2878,392,226,155,0,155,0,100,0,0.006451613,empty,mBC-0716-2
"H3,F9",16877,17215,12871,4344,8410,19,3766,3788,2590,1198,2.161936561,1814,1487,863,480,0,480,0,197,0,0.04375,empty,mBC-0716-2
"H3,F10",22226,22372,17151,5221,10980,0,4734,4746,3306,1440,2.295833333,2165,1400,790,487,2,485,1,204,0,0.024742268,empty,mBC-0716-2
"H3,F11",12460,12916,9563,3353,6372,0,2852,2858,1960,898,2.182628062,1396,970,490,314,0,314,0,173,0,0.035031847,empty,mBC-0716-2
"H3,F12",16102,16958,12218,4740,8053,0,3755,3765,2553,1212,2.106435644,1899,153,93,68,0,68,0,47,0,0.014705882,empty,mBC-0716-2
"H3,G1",11302,11993,8801,3192,5729,28,2580,2617,1765,852,2.071596244,1251,1700,1054,656,1,655,1,236,0,0.010687023,empty,mBC-0716-2
"H3,G2",23577,24237,18050,6187,11516,3,5154,5165,3607,1558,2.315147625,2404,845,520,347,0,347,0,172,0,0.054755043,empty,mBC-0716-2
"H3,G3",22197,22799,16914,5885,11105,0,5033,5039,3569,1470,2.427891156,2469,3190,1479,883,0,883,0,363,0,0.038505096,empty,mBC-0716-2
"H3,G4",32477,32890,25076,7814,15685,74,6772,6869,4880,1989,2.453494218,3110,165,106,74,0,74,0,53,0,0,empty,mBC-0716-2
"H3,G5",831107,886220,617344,268876,427246,54,214704,215090,175911,39179,4.48993083,111137,57731,37802,21409,10,21399,1,2541,0,0.001869246,mm10,mBC-0716-2
"H3,G6",27229,27726,20639,7087,13254,1,5914,5925,4219,1706,2.473036342,2796,511,240,170,0,170,0,78,0,0,empty,mBC-0716-2
"H3,G7",22452,22920,17413,5507,11095,12,4953,4971,3439,1532,2.244778068,2289,1688,988,596,0,596,0,268,0,0.052013423,empty,mBC-0716-2
"H3,G8",17375,18144,13196,4948,8837,20,4179,4211,2949,1262,2.336767036,2030,1613,974,657,2,655,1,284,0,0.036641221,empty,mBC-0716-2
"H3,G9",650379,684518,496438,188080,334053,4,160368,160673,124158,36515,3.400191702,79992,24927,15783,8946,5,8941,2,1591,0,0.006822503,mm10,mBC-0716-2
"H3,G10",791327,817527,600427,217100,397721,16,187909,188328,140666,47662,2.951323906,92847,17730,10874,6111,1,6110,1,1212,0,0.004746318,mm10,mBC-0716-2
"H3,G11",14238,14619,11037,3582,7000,0,3093,3096,2168,928,2.336206897,1452,630,410,240,0,240,0,117,0,0.008333333,empty,mBC-0716-2
"H3,G12",13163,13554,10056,3498,6629,0,3068,3069,2143,926,2.31425486,1450,1120,636,398,0,398,0,168,0,0.057788945,empty,mBC-0716-2
"H3,H1",23575,24021,18092,5929,11688,0,5259,5278,3745,1533,2.442922374,2413,957,516,322,0,322,0,147,0,0.037267081,empty,mBC-0716-2
"H3,H2",41022,43791,30531,13260,20824,0,10486,10513,7527,2986,2.520763563,5303,2285,1454,863,0,863,0,331,0,0.01622248,empty,mBC-0716-2
"H3,H3",24651,25604,18768,6836,12143,22,5539,5572,3937,1635,2.40795107,2672,1867,1060,600,0,600,0,251,0,0.036666667,empty,mBC-0716-2
"H3,H4",17129,17475,12993,4482,8490,0,3888,3902,2667,1235,2.15951417,1871,265,152,101,0,101,0,69,0,0.01980198,empty,mBC-0716-2
"H3,H5",23587,24999,17800,7199,11838,20,5625,5659,4043,1616,2.501856436,2813,1377,747,445,0,445,0,209,0,0.011235955,empty,mBC-0716-2
"H3,H6",19575,20492,14840,5652,9837,0,4592,4613,3190,1423,2.241742797,2247,1842,1055,621,0,621,0,231,0,0.043478261,empty,mBC-0716-2
"H3,H7",18912,19527,14244,5283,9564,0,4438,4449,3146,1303,2.414428243,2148,1467,874,553,0,553,0,243,0,0.03074141,empty,mBC-0716-2
"H3,H8",16843,17338,12830,4508,8401,0,3765,3770,2640,1130,2.336283186,1804,1691,1016,634,0,634,0,259,0,0.034700315,empty,mBC-0716-2
"H3,H9",19240,19389,14502,4887,9380,22,4214,4242,2947,1295,2.275675676,1992,1440,857,553,0,553,0,258,0,0.009041591,empty,mBC-0716-2
"H3,H10",18331,18609,13895,4714,8991,2,4095,4107,2839,1268,2.238958991,1995,1254,731,499,0,499,0,232,0,0.006012024,empty,mBC-0716-2
"H3,H11",31183,29802,21238,8564,14418,0,6847,6857,5006,1851,2.704484063,3505,261,149,109,1,108,1,69,0,0.074074074,empty,mBC-0716-2
"H3,H12",7285,7459,5361,2098,3624,18,1699,1719,1195,524,2.280534351,853,686,429,263,0,263,0,110,0,0.045627376,empty,mBC-0716-2
"H4,A1",18211,19001,13829,5172,9298,0,4373,4391,3100,1291,2.401239349,2160,1171,602,353,0,353,0,130,0,0.036827195,empty,mBC-0716-2
"H4,A2",22963,23596,17654,5942,11279,1,5090,5104,3620,1484,2.4393531,2368,726,422,269,0,269,0,126,0,0.040892193,empty,mBC-0716-2
"H4,A3",19813,20772,15126,5646,9899,44,4561,4617,3304,1313,2.516374714,2304,753,376,227,0,227,0,97,0,0.101321586,empty,mBC-0716-2
"H4,A4",21782,22205,16717,5488,10661,3,4718,4739,3338,1401,2.382583869,2251,393,241,147,1,146,1,75,0,0.068493151,empty,mBC-0716-2
"H4,A5",19337,20181,14844,5337,9964,4,4706,4720,3360,1360,2.470588235,2261,876,551,339,0,339,0,159,0,0.014749263,empty,mBC-0716-2
"H4,A6",15323,15966,11642,4324,7707,14,3584,3607,2539,1068,2.377340824,1738,968,581,379,0,379,0,153,0,0.09762533,empty,mBC-0716-2
"H4,A7",676602,695873,511774,184099,340033,3,159320,159607,130864,28743,4.552899836,77963,12995,7469,4339,4,4335,1,979,0,0.001153403,mm10,mBC-0716-2
"H4,A8",11683,12023,8827,3196,5901,0,2709,2714,1931,783,2.466155811,1288,1211,635,360,0,360,0,152,0,0.066666667,empty,mBC-0716-2
"H4,A9",1241643,1309063,905840,403223,614581,1,324252,324720,262239,62481,4.197099918,167742,35652,23070,13206,3,13203,1,1988,0,0.001060365,mm10,mBC-0716-2
"H4,A10",19787,20193,14925,5268,9724,55,4399,4467,3175,1292,2.457430341,2184,249,161,112,0,112,0,56,0,0.026785714,empty,mBC-0716-2
"H4,A11",21790,22649,16528,6121,10966,23,5071,5106,3553,1553,2.287830006,2475,2301,927,538,1,537,1,200,0,0.052141527,empty,mBC-0716-2
"H4,A12",22690,23069,17253,5816,10857,1,4830,4844,3383,1461,2.315537303,2256,1608,959,543,0,543,0,174,0,0.064456722,empty,mBC-0716-2
"H4,B1",722745,768981,552258,216723,371948,1,174755,175047,151473,23574,6.425426317,88228,51364,33477,18706,8,18698,3,2364,0,0.001871858,mm10,mBC-0716-2
"H4,B2",749278,781567,555354,226213,380766,1,189862,190191,130678,59513,2.195789155,97330,6499,4133,2364,1,2363,1,584,0,0.002962336,mm10,mBC-0716-2
"H4,B3",20144,20468,15387,5081,9848,7,4380,4392,3075,1317,2.334851936,2053,3439,1170,682,1,681,1,246,0,0.007342144,empty,mBC-0716-2
"H4,B4",17401,18362,13354,5008,8731,0,3999,4006,2787,1219,2.286300246,1888,773,443,270,0,270,0,127,0,0.051851852,empty,mBC-0716-2
"H4,B5",14553,10020,7340,2680,6055,13,2790,2814,2073,741,2.79757085,1468,406,259,152,0,152,0,81,0,0,empty,mBC-0716-2
"H4,B6",14416,14942,10939,4003,7353,0,3508,3519,2450,1069,2.291861553,1735,741,467,268,0,268,0,123,0,0.067164179,empty,mBC-0716-2
"H4,B7",17059,17394,12951,4443,8630,62,3932,3999,2831,1168,2.42380137,1892,734,429,245,0,245,0,103,0,0.081632653,empty,mBC-0716-2
"H4,B8",13931,14021,10545,3476,6742,3,3060,3078,2144,934,2.295503212,1426,3663,1199,743,0,743,0,287,0,0.014804845,empty,mBC-0716-2
"H4,B9",15976,16524,12135,4389,7867,34,3575,3622,2567,1055,2.433175355,1799,660,346,223,0,223,0,93,0,0.067264574,empty,mBC-0716-2
"H4,B10",18612,19027,13898,5129,9461,1,4283,4292,3008,1284,2.342679128,2080,333,160,93,1,92,1,52,0,0.02173913,empty,mBC-0716-2
"H4,B11",18314,19174,13954,5220,9094,32,4189,4228,2949,1279,2.305707584,2069,203,105,64,0,64,0,37,0,0.046875,empty,mBC-0716-2
"H4,B12",19829,20562,15001,5561,9851,24,4510,4544,3280,1264,2.594936709,2145,852,544,311,0,311,0,128,0,0.048231511,empty,mBC-0716-2
"H4,C1",22335,22825,17261,5564,10832,23,4721,4751,3379,1372,2.462827988,2171,875,312,206,0,206,0,90,0,0.033980583,empty,mBC-0716-2
"H4,C2",1148293,1256007,794974,461033,598506,3,358184,358716,289527,69189,4.184581364,198016,19904,10027,5599,4,5595,2,1229,0,0.013404826,mm10,mBC-0716-2
"H4,C3",1075181,1219184,758566,460618,582565,0,337726,338213,262878,75335,3.489453773,191178,21163,14079,7936,2,7934,1,1364,0,0.002394757,mm10,mBC-0716-2
"H4,C4",324744,297727,284249,13478,147306,6,16461,16606,11796,4810,2.452390852,4843,4903,2681,1479,1,1478,1,484,0,0.01082544,empty,mBC-0716-2
"H4,C5",19920,21115,15026,6089,10207,0,5046,5059,3612,1447,2.496199032,2574,549,345,224,0,224,0,120,0,0.053571429,empty,mBC-0716-2
"H4,C6",19277,20085,14495,5590,9920,0,4599,4613,3153,1460,2.159589041,2240,759,425,266,0,266,0,120,0,0.045112782,empty,mBC-0716-2
"H4,C7",2059919,2301377,1452244,849133,1076667,1,631041,631887,513824,118063,4.35211709,350940,24489,15901,8976,3,8973,1,1535,0,0.0012259,mm10,mBC-0716-2
"H4,C8",17594,18081,13003,5078,8746,4,4106,4122,2871,1251,2.294964029,2106,1175,648,361,0,361,0,152,0,0.041551247,empty,mBC-0716-2
"H4,C9",529201,545659,402409,143250,267595,3,122379,122612,93543,29069,3.217964154,60113,13582,8075,4790,1,4789,1,991,0,0.006473168,mm10,mBC-0716-2
"H4,C10",14892,15361,11500,3861,7408,0,3405,3414,2361,1053,2.242165242,1577,659,438,244,0,244,0,120,0,0.024590164,empty,mBC-0716-2
"H4,C11",670041,743471,484962,258509,364503,1,200520,200814,152228,48586,3.133165933,109962,45150,27548,15650,11,15639,2,2195,0,0.002493766,mm10,mBC-0716-2
"H4,C12",46959,50158,35679,14479,23734,17,11016,11063,8926,2137,4.176883482,5594,3582,2259,1290,2,1288,1,338,0,0.017857143,empty,mBC-0716-2
"H4,D1",15244,15786,11514,4272,7670,21,3534,3563,2534,1029,2.462585034,1743,331,157,100,0,100,0,53,0,0.03,empty,mBC-0716-2
"H4,D2",21946,22761,16833,5928,11036,26,4905,4951,3562,1389,2.564434845,2310,7483,2518,1529,1,1528,1,478,0,0.092931937,empty,mBC-0716-2
"H4,D3",1779602,2115008,1180953,934055,1020480,18,675354,676142,506957,169185,2.996465408,407402,40567,24956,14127,6,14121,2,2060,0,0.007010835,mm10,mBC-0716-2
"H4,D4",16516,17292,12526,4766,8232,17,3802,3825,2721,1104,2.464673913,1879,875,546,317,0,317,0,166,0,0.028391167,empty,mBC-0716-2
"H4,D5",16115,16992,12198,4794,8193,0,3773,3790,2688,1102,2.439201452,1872,675,386,219,0,219,0,99,0,0.04109589,empty,mBC-0716-2
"H4,D6",14611,15717,11022,4695,7598,4,3638,3645,2506,1139,2.200175593,1859,828,475,286,0,286,0,109,0,0.083916084,empty,mBC-0716-2
"H4,D7",15576,16263,11758,4505,7864,1,3684,3693,2601,1092,2.381868132,1826,863,513,293,0,293,0,133,0,0.023890785,empty,mBC-0716-2
"H4,D8",18054,18911,13463,5448,9088,63,4292,4366,3009,1357,2.217391304,2159,1939,830,509,0,509,0,187,0,0.025540275,empty,mBC-0716-2
"H4,D9",1061950,1212255,723386,488869,590835,2,359816,360277,284789,75488,3.77263936,208492,134502,86752,48275,14,48261,1,4242,0,0.001388285,mm10,mBC-0716-2
"H4,D10",15257,16233,11480,4753,7791,3,3743,3757,2607,1150,2.266956522,1885,486,290,172,0,172,0,68,0,0.145348837,empty,mBC-0716-2
"H4,D11",15035,15905,11450,4455,7550,0,3530,3541,2487,1054,2.359582543,1736,1062,673,419,1,418,1,152,0,0.06937799,empty,mBC-0716-2
"H4,D12",22075,22713,16654,6059,10912,12,4832,4858,3336,1522,2.191852825,2349,1403,841,513,0,513,0,195,0,0.054580897,empty,mBC-0716-2
"H4,E1",24063,24457,18485,5972,11850,25,5396,5427,3806,1621,2.347933374,2460,1092,604,381,1,380,1,160,0,0.052631579,empty,mBC-0716-2
"H4,E2",19474,20139,14976,5163,9817,1,4489,4499,3173,1326,2.392911011,2112,1158,606,341,0,341,0,142,0,0.029325513,empty,mBC-0716-2
"H4,E3",13156,13300,10139,3161,6520,0,2835,2852,1970,882,2.233560091,1313,1043,657,389,0,389,0,165,0,0.035989717,empty,mBC-0716-2
"H4,E4",16814,17617,12857,4760,8336,27,3784,3821,2719,1102,2.467332123,1868,842,486,310,0,310,0,126,0,0.032258065,empty,mBC-0716-2
"H4,E5",21185,22027,16135,5892,10608,3,4810,4827,3389,1438,2.35674548,2319,951,620,372,0,372,0,171,0,0.01344086,empty,mBC-0716-2
"H4,E6",17828,18557,13767,4790,8813,12,4018,4046,2843,1203,2.36325852,1921,998,611,378,0,378,0,160,0,0.026455026,empty,mBC-0716-2
"H4,E7",15589,15948,11832,4116,7584,1,3306,3316,2306,1010,2.283168317,1547,723,437,258,0,258,0,111,0,0.019379845,empty,mBC-0716-2
"H4,E8",19098,19503,14808,4695,9543,9,4263,4275,2975,1300,2.288461538,1954,1300,694,439,0,439,0,159,0,0.08428246,empty,mBC-0716-2
"H4,E9",510358,536920,382505,154415,263178,1,128369,128593,88131,40462,2.17811774,66900,6330,4049,2319,0,2319,0,603,0,0.010780509,mm10,mBC-0716-2
"H4,E10",13590,14200,10344,3856,6926,0,3223,3229,2222,1007,2.206554121,1582,611,362,236,0,236,0,114,0,0.008474576,empty,mBC-0716-2
"H4,E11",12551,12630,9059,3571,6109,1,2918,2927,2085,842,2.476247031,1418,17316,5179,3121,4,3117,3,744,0,0.128328521,empty,mBC-0716-2
"H4,E12",20516,21667,15404,6263,10675,5,5254,5269,3710,1559,2.379730597,2638,706,409,255,0,255,0,103,0,0.074509804,empty,mBC-0716-2
"H4,F1",21357,22035,16093,5942,10870,0,5040,5045,3592,1453,2.472126635,2491,1119,656,385,0,385,0,155,0,0.07012987,empty,mBC-0716-2
"H4,F2",25853,27054,19521,7533,13104,0,6191,6207,4349,1858,2.340688913,3072,1662,1021,629,1,628,1,267,0,0.071656051,empty,mBC-0716-2
"H4,F3",18552,19562,14023,5539,9485,21,4511,4542,3203,1339,2.392083645,2276,1081,644,414,0,414,0,191,0,0.02173913,empty,mBC-0716-2
"H4,F4",21011,20921,15570,5351,10158,1,4692,4709,3355,1354,2.477843427,2254,243,119,83,0,83,0,41,0,0,empty,mBC-0716-2
"H4,F5",27291,28070,20538,7532,13421,0,6087,6096,4285,1811,2.36609608,3008,926,604,386,0,386,0,191,0,0.020725389,empty,mBC-0716-2
"H4,F6",27703,28700,20964,7736,13758,18,6420,6459,4519,1940,2.329381443,3068,1330,803,465,0,465,0,187,0,0.060215054,empty,mBC-0716-2
"H4,F7",22165,22515,16566,5949,10864,18,4979,5006,3533,1473,2.398506449,2434,3243,1068,654,0,654,0,209,0,0.143730887,empty,mBC-0716-2
"H4,F8",752798,803719,571167,232552,389576,19,184640,184975,161493,23482,6.87731028,94126,6118,3906,2247,0,2247,0,525,0,0,mm10,mBC-0716-2
"H4,F9",16048,16548,12293,4255,8005,0,3590,3597,2505,1092,2.293956044,1714,980,606,374,0,374,0,143,0,0.07486631,empty,mBC-0716-2
"H4,F10",20897,21227,16252,4975,10431,25,4473,4507,3149,1358,2.318851252,2037,1451,650,393,0,393,0,157,0,0.055979644,empty,mBC-0716-2
"H4,F11",12791,13082,9756,3326,6427,0,2872,2880,2005,875,2.291428571,1393,2313,909,538,0,538,0,183,0,0.247211896,empty,mBC-0716-2
"H4,F12",15741,16154,12114,4040,7773,0,3572,3575,2440,1135,2.149779736,1659,118,60,36,0,36,0,25,0,0,empty,mBC-0716-2
"H4,G1",10202,10619,7864,2755,5278,3,2361,2366,1637,729,2.245541838,1136,1175,668,352,0,352,0,142,0,0.008522727,empty,mBC-0716-2
"H4,G2",994105,1079152,717390,361762,519986,27,287012,287436,247038,40398,6.115104708,152948,15685,10004,5662,5,5657,2,1068,0,0.003888987,mm10,mBC-0716-2
"H4,G3",21567,22136,16345,5791,10771,0,4987,5001,3531,1470,2.402040816,2436,1207,786,478,1,477,1,191,0,0.004192872,empty,mBC-0716-2
"H4,G4",31112,31539,23889,7650,15193,2,6733,6744,4825,1919,2.51433038,3088,102,68,48,0,48,0,36,0,0,empty,mBC-0716-2
"H4,G5",16494,17265,12506,4759,8269,26,3803,3833,2787,1046,2.664435946,1864,662,338,203,1,202,1,110,0,0.02970297,empty,mBC-0716-2
"H4,G6",25507,25690,19830,5860,12422,0,5458,5468,3897,1571,2.480585614,2439,87,58,46,0,46,0,31,0,0,empty,mBC-0716-2
"H4,G7",20704,21287,15933,5354,10401,0,4692,4699,3384,1315,2.57338403,2214,2705,1121,719,0,719,0,250,0,0.063977747,empty,mBC-0716-2
"H4,G8",16770,17332,12526,4806,8304,0,3964,3971,2798,1173,2.385336743,1884,3789,1328,799,1,798,1,287,0,0.073934837,empty,mBC-0716-2
"H4,G9",13463,14318,10261,4057,6876,0,3318,3328,2423,905,2.677348066,1608,761,437,282,0,282,0,127,0,0.010638298,empty,mBC-0716-2
"H4,G10",957478,1067257,693265,373992,514718,12,283199,283623,235190,48433,4.855986621,155193,85781,56225,32969,10,32959,3,3028,0,0.001850784,mm10,mBC-0716-2
"H4,G11",13288,13723,10212,3511,6503,5,2883,2898,2055,843,2.43772242,1325,1607,581,357,0,357,0,132,0,0.011204482,empty,mBC-0716-2
"H4,G12",13272,13943,10101,3842,6756,0,3123,3128,2193,935,2.345454545,1557,769,489,293,0,293,0,121,0,0.017064846,empty,mBC-0716-2
"H4,H1",22933,23641,17534,6107,11418,11,5236,5259,3780,1479,2.555780933,2515,538,287,179,0,179,0,84,0,0.05027933,empty,mBC-0716-2
"H4,H2",26100,27098,19922,7176,12900,3,5911,5923,4088,1835,2.227792916,2871,1163,745,471,0,471,0,205,0,0.067940552,empty,mBC-0716-2
"H4,H3",24742,25464,18822,6642,12229,1,5675,5695,4016,1679,2.39189994,2725,1035,594,358,1,357,1,157,0,0.025210084,empty,mBC-0716-2
"H4,H4",18174,18821,13853,4968,9044,38,4220,4269,3027,1242,2.437198068,2009,146,81,60,0,60,0,40,0,0,empty,mBC-0716-2
"H4,H5",20259,20930,15433,5497,9925,0,4583,4593,3223,1370,2.352554745,2187,4790,1643,1044,1,1043,1,339,0,0.046979866,empty,mBC-0716-2
"H4,H6",19107,20236,14580,5656,9702,0,4589,4592,3224,1368,2.356725146,2278,1038,653,371,0,371,0,148,0,0.016172507,empty,mBC-0716-2
"H4,H7",19250,19912,14600,5312,9748,20,4474,4503,3121,1382,2.258321274,2186,834,482,313,0,313,0,133,0,0.003194888,empty,mBC-0716-2
"H4,H8",814529,880862,595478,285384,423785,0,223513,223822,184392,39430,4.676439259,119345,52265,34306,19265,6,19259,1,2463,0,0.001350018,mm10,mBC-0716-2
"H4,H9",19938,20374,15072,5302,9908,4,4530,4548,3217,1331,2.416979715,2219,824,488,318,0,318,0,148,0,0.059748428,empty,mBC-0716-2
"H4,H10",18760,19509,14072,5437,9408,24,4309,4335,3015,1320,2.284090909,2137,850,486,295,0,295,0,140,0,0.020338983,empty,mBC-0716-2
"H4,H11",20112,21359,15232,6127,10361,7,4924,4950,3452,1498,2.304405874,2502,120,77,52,0,52,0,39,0,0,empty,mBC-0716-2
"H4,H12",7902,8464,5841,2623,3996,131,1778,1911,1356,555,2.443243243,996,397,259,166,0,166,0,76,0,0.054216867,empty,mBC-0716-2
"H5,A1",17526,18132,13259,4873,8959,0,4170,4181,2856,1325,2.155471698,1962,1362,788,476,0,476,0,188,0,0.069327731,empty,mBC-0716-2
"H5,A2",23572,24029,18209,5820,11336,0,4993,5010,3512,1498,2.344459279,2277,1496,876,545,0,545,0,227,0,0.031192661,empty,mBC-0716-2
"H5,A3",1373916,1569731,925488,644243,745674,2,471985,472658,381517,91141,4.186008492,272008,40868,26059,14404,3,14401,1,2065,0,0.000624957,mm10,mBC-0716-2
"H5,A4",23614,24067,18259,5808,11638,2,5115,5127,3630,1497,2.424849699,2385,762,379,256,0,256,0,128,0,0.08203125,empty,mBC-0716-2
"H5,A5",21025,21698,15809,5889,10485,11,4931,4944,3482,1462,2.381668947,2369,6195,2248,1386,1,1385,1,461,0,0.058483755,empty,mBC-0716-2
"H5,A6",16007,16767,12136,4631,8010,0,3790,3797,2581,1216,2.122532895,1846,1692,972,583,0,583,0,262,0,0.015437393,empty,mBC-0716-2
"H5,A7",18841,19494,14286,5208,9513,1,4379,4389,3025,1364,2.217741935,2107,1483,848,509,0,509,0,221,0,0.053045187,empty,mBC-0716-2
"H5,A8",12961,13591,9817,3774,6608,0,3062,3063,2158,905,2.384530387,1496,1729,1077,670,2,668,1,251,0,0.028443114,empty,mBC-0716-2
"H5,A9",22953,23018,17695,5323,11077,0,4847,4863,3421,1442,2.372399445,2214,1507,926,555,0,555,0,244,0,0.036036036,empty,mBC-0716-2
"H5,A10",18790,19412,14314,5098,9446,13,4358,4379,3112,1267,2.456195738,2020,419,238,156,0,156,0,93,0,0,empty,mBC-0716-2
"H5,A11",22501,23120,17440,5680,11087,32,4912,4960,3516,1444,2.434903047,2301,1153,588,374,0,374,0,189,0,0.018716578,empty,mBC-0716-2
"H5,A12",24226,24574,18718,5856,11738,11,5241,5258,3794,1464,2.591530055,2414,3008,1676,1015,1,1014,1,346,0,0.07495069,empty,mBC-0716-2
"H5,B1",24913,24823,17628,7195,11112,25,5212,5249,3724,1525,2.441967213,2481,8805,3592,2267,1,2266,1,507,0,0.336716681,empty,mBC-0716-2
"H5,B2",23094,23568,17523,6045,11407,19,5028,5057,3553,1504,2.362367021,2425,544,320,190,0,190,0,87,0,0.010526316,empty,mBC-0716-2
"H5,B3",20755,21787,16149,5638,10517,11,4854,4880,3397,1483,2.290627107,2272,1359,790,480,0,480,0,190,0,0.05625,empty,mBC-0716-2
"H5,B4",18520,19133,14069,5064,9340,2,4344,4350,3088,1262,2.446909667,2080,1048,605,387,0,387,0,176,0,0.064599483,empty,mBC-0716-2
"H5,B5",469379,251637,184225,67412,160038,2,69444,70071,51655,18416,2.804897915,37036,15357,8759,5093,3,5090,2,1080,0,0.006876228,mm10,mBC-0716-2
"H5,B6",1856001,2170263,1235192,935071,1046545,14,688183,689115,499191,189924,2.628372402,411305,66330,39863,22476,15,22461,2,2917,0,0.006544677,mm10,mBC-0716-2
"H5,B7",2137441,2291288,1561576,729712,1078290,1,584734,585672,442431,143241,3.088717616,310091,64591,41180,23193,13,23180,1,2740,0,0.000560828,mm10,mBC-0716-2
"H5,B8",15136,15366,11638,3728,7615,0,3343,3347,2367,980,2.415306122,1589,5294,1829,1168,1,1167,1,415,0,0.036846615,empty,mBC-0716-2
"H5,B9",17022,17396,12965,4431,8368,33,3835,3874,2701,1173,2.302642796,1800,1360,610,369,2,367,1,158,0,0.059945504,empty,mBC-0716-2
"H5,B10",753444,792769,517516,275253,398764,0,218587,219269,180570,38699,4.666012042,119256,23227,14884,8249,2,8247,1,1342,0,0.002667637,mm10,mBC-0716-2
"H5,B11",18756,19644,14424,5220,9416,0,4347,4356,3018,1338,2.255605381,2116,352,192,127,0,127,0,71,0,0.015748031,empty,mBC-0716-2
"H5,B12",20866,21505,15931,5574,10522,0,4751,4766,3334,1432,2.328212291,2294,1513,860,497,1,496,1,189,0,0.040322581,empty,mBC-0716-2
"H5,C1",1686955,1871744,1171343,700401,872576,2,524736,525516,391487,134029,2.920912638,290533,47575,28991,16259,3,16256,1,2283,0,0.004121555,mm10,mBC-0716-2
"H5,C2",22707,23827,17296,6531,11390,0,5174,5184,3637,1547,2.351001939,2595,1780,1108,641,0,641,0,253,0,0.018720749,empty,mBC-0716-2
"H5,C3",22741,23703,17194,6509,11350,0,5303,5310,3628,1682,2.156956005,2609,707,382,226,0,226,0,100,0,0.030973451,empty,mBC-0716-2
"H5,C4",22040,22466,16706,5760,10870,0,4876,4888,3414,1474,2.31614654,2354,29454,6594,3950,5,3945,1,843,0,0.094803549,empty,mBC-0716-2
"H5,C5",21157,22117,16002,6115,10705,11,5012,5043,3567,1476,2.416666667,2461,1365,853,507,0,507,0,226,0,0.031558185,empty,mBC-0716-2
"H5,C6",19256,19469,14517,4952,9848,1,4558,4567,3253,1314,2.47564688,2202,1311,798,522,0,522,0,200,0,0.055555556,empty,mBC-0716-2
"H5,C7",18960,19831,14380,5451,9628,7,4540,4566,3201,1365,2.345054945,2230,587,358,219,0,219,0,97,0,0.050228311,empty,mBC-0716-2
"H5,C8",947586,1029025,684056,344969,498825,15,265977,266389,224242,42147,5.320473581,142686,122061,79487,43997,14,43983,1,3678,0,0.000909442,mm10,mBC-0716-2
"H5,C9",1227551,1363617,839145,524472,651097,1,396244,396741,334374,62367,5.361393044,223154,73853,46261,25720,17,25703,4,2908,0,0.00221764,mm10,mBC-0716-2
"H5,C10",15582,16061,12041,4020,7899,4,3594,3603,2489,1114,2.234290844,1666,1404,814,477,0,477,0,183,0,0.05870021,empty,mBC-0716-2
"H5,C11",13030,13668,9717,3951,6700,14,3115,3136,2167,969,2.236326109,1580,1254,720,428,0,428,0,194,0,0.049065421,empty,mBC-0716-2
"H5,C12",22882,23497,17224,6273,11290,19,5187,5228,3632,1596,2.275689223,2530,1950,848,498,0,498,0,198,0,0.034136546,empty,mBC-0716-2
"H5,D1",14676,14936,11059,3877,7467,2,3548,3561,2509,1052,2.384980989,1718,746,434,263,0,263,0,130,0,0,empty,mBC-0716-2
"H5,D2",23365,23992,18048,5944,11739,5,5210,5229,3698,1531,2.415414762,2456,2876,1695,1020,1,1019,1,365,0,0.031403337,empty,mBC-0716-2
"H5,D3",16194,16557,12352,4205,8220,0,3893,3900,2716,1184,2.293918919,1833,1087,676,427,0,427,0,213,0,0.06323185,empty,mBC-0716-2
"H5,D4",17113,17651,13048,4603,8689,0,4077,4093,2870,1223,2.346688471,1958,10380,3435,2074,0,2074,0,609,0,0.040019286,empty,mBC-0716-2
"H5,D5",16756,17242,12752,4490,8329,0,3799,3814,2651,1163,2.279449699,1794,1163,683,406,0,406,0,165,0,0.036945813,empty,mBC-0716-2
"H5,D6",770379,876867,542292,334575,428923,2,250831,251209,194134,57075,3.401384144,142948,90934,45290,25700,13,25687,3,3278,0,0.030599136,mm10,mBC-0716-2
"H5,D7",15537,16142,11805,4337,7832,0,3665,3669,2543,1126,2.258436945,1767,1584,900,504,1,503,1,219,0,0.02584493,empty,mBC-0716-2
"H5,D8",18783,19682,14222,5460,9578,0,4456,4464,3110,1354,2.29689808,2254,1003,648,395,1,394,1,153,0,0.015228426,empty,mBC-0716-2
"H5,D9",7296,7719,5509,2210,3915,0,1845,1847,1292,555,2.327927928,922,1873,1080,648,0,648,0,284,0,0.050925926,empty,mBC-0716-2
"H5,D10",16236,17231,12263,4968,8290,0,3946,3947,2758,1189,2.319596299,1977,867,490,282,0,282,0,134,0,0.109929078,empty,mBC-0716-2
"H5,D11",16697,17325,12723,4602,8396,1,3850,3852,2662,1190,2.23697479,1881,1866,1205,679,1,678,1,245,0,0.076696165,empty,mBC-0716-2
"H5,D12",1013600,1138460,716868,421592,549141,28,314092,314540,263635,50905,5.178960809,176056,146815,92573,52063,26,52037,2,4072,0,0.000768684,mm10,mBC-0716-2
"H5,E1",907380,935859,679213,256646,453148,6,218865,219211,172455,46756,3.688403627,109301,28929,16386,9491,7,9484,1,1727,0,0.011914804,mm10,mBC-0716-2
"H5,E2",19054,19057,14488,4569,9378,3,4156,4176,2926,1250,2.3408,1923,1446,805,514,0,514,0,219,0,0.042801556,empty,mBC-0716-2
"H5,E3",13917,14224,10645,3579,6993,4,3096,3112,2140,972,2.201646091,1436,7318,2767,1639,1,1638,1,479,0,0.156288156,empty,mBC-0716-2
"H5,E4",943832,1032417,683377,349040,498027,30,272140,272601,231176,41425,5.58059143,146705,59006,39405,22385,11,22374,1,2563,0,0.002592295,mm10,mBC-0716-2
"H5,E5",23106,23442,17789,5653,11463,1,5086,5098,3563,1535,2.321172638,2335,4293,1650,983,1,982,1,376,0,0.028513238,empty,mBC-0716-2
"H5,E6",16678,17024,12584,4440,8346,1,3736,3748,2531,1217,2.079704191,1808,1604,939,585,0,585,0,259,0,0.022222222,empty,mBC-0716-2
"H5,E7",16166,16731,12382,4349,7960,9,3604,3618,2496,1122,2.22459893,1705,1130,638,418,1,417,1,194,0,0.033573141,empty,mBC-0716-2
"H5,E8",20687,21191,16050,5141,10139,1,4443,4460,3084,1376,2.24127907,2045,1934,1109,637,0,637,0,271,0,0.053375196,empty,mBC-0716-2
"H5,E9",451337,470094,344717,125377,233018,0,107086,107258,85481,21777,3.925288148,53006,27081,17154,9586,4,9582,1,1615,0,0.003026508,mm10,mBC-0716-2
"H5,E10",15045,15574,11491,4083,7600,9,3443,3458,2362,1096,2.155109489,1676,1602,985,585,0,585,0,222,0,0.071794872,empty,mBC-0716-2
"H5,E11",11152,11341,8519,2822,5706,17,2537,2557,1757,800,2.19625,1183,1133,599,384,0,384,0,160,0,0.0234375,empty,mBC-0716-2
"H5,E12",18591,19432,13979,5453,9541,2,4506,4512,3087,1425,2.166315789,2205,1082,612,386,0,386,0,164,0,0.056994819,empty,mBC-0716-2
"H5,F1",1179247,1264607,858006,406601,601858,2,320314,320830,273093,47737,5.720782621,169177,70649,45976,25293,14,25279,3,2819,0,0.001384548,mm10,mBC-0716-2
"H5,F2",26670,27872,20271,7601,13376,0,6279,6295,4473,1822,2.454994512,3134,2913,1644,1049,0,1049,0,402,0,0.066730219,empty,mBC-0716-2
"H5,F3",19059,19623,14330,5293,9583,0,4499,4508,3231,1277,2.530148786,2178,5137,2085,1306,1,1305,1,451,0,0.049808429,empty,mBC-0716-2
"H5,F4",20227,20589,15334,5255,10058,26,4557,4600,3248,1352,2.402366864,2186,510,336,222,0,222,0,100,0,0,empty,mBC-0716-2
"H5,F5",1996081,2126375,1451683,674692,998498,3,529157,530071,447996,82075,5.458373439,278585,178216,116718,65393,26,65367,3,4831,0,0.000917894,mm10,mBC-0716-2
"H5,F6",34282,36149,26142,10007,17113,1,7981,8006,5857,2149,2.725453699,3903,6287,2966,1693,0,1693,0,500,0,0.015357354,empty,mBC-0716-2
"H5,F7",22812,23306,17558,5748,11349,0,5073,5091,3590,1501,2.391738841,2300,885,514,317,0,317,0,151,0,0,empty,mBC-0716-2
"H5,F8",838938,895163,620797,274366,438938,24,229875,230251,179270,50981,3.516408074,120142,1170,750,440,1,439,1,190,0,0,empty,mBC-0716-2
"H5,F9",17590,18154,13547,4607,8751,33,3820,3866,2695,1171,2.301451751,1873,1631,935,578,1,577,1,229,0,0.08492201,empty,mBC-0716-2
"H5,F10",26121,27123,20147,6976,12986,0,5796,5811,4158,1653,2.515426497,2742,1341,740,457,0,457,0,223,0,0.048140044,empty,mBC-0716-2
"H5,F11",1104558,1187029,811201,375828,567585,5,298938,299452,246621,52831,4.668111525,157164,75730,48507,26976,11,26965,2,2948,0,0.000778787,mm10,mBC-0716-2
"H5,F12",17296,18162,13062,5100,8572,0,4119,4129,2902,1227,2.365118174,2021,195,123,84,0,84,0,54,0,0.011904762,empty,mBC-0716-2
"H5,G1",11595,11935,8924,3011,5880,1,2615,2617,1841,776,2.37242268,1234,2107,1245,727,0,727,0,237,0,0.041265475,empty,mBC-0716-2
"H5,G2",24192,24935,18444,6491,11893,5,5453,5468,3905,1563,2.498400512,2573,740,446,284,0,284,0,167,0,0.003521127,empty,mBC-0716-2
"H5,G3",26575,27894,20117,7777,13374,0,6219,6227,4524,1703,2.65648855,3098,1984,1225,764,0,764,0,314,0,0.036649215,empty,mBC-0716-2
"H5,G4",32264,32844,24941,7903,15870,12,6920,6948,4976,1972,2.523326572,3219,189,125,85,0,85,0,63,0,0,empty,mBC-0716-2
"H5,G5",16407,17431,12397,5034,8400,0,3944,3954,2777,1177,2.359388275,2013,1248,746,489,0,489,0,248,0,0.032719836,empty,mBC-0716-2
"H5,G6",28271,28476,21871,6605,13762,0,6172,6181,4391,1790,2.453072626,2786,217,135,78,0,78,0,61,0,0,empty,mBC-0716-2
"H5,G7",22558,23224,17477,5747,11320,1,5051,5063,3541,1522,2.326544021,2350,2163,1318,793,0,793,0,318,0,0.054224464,empty,mBC-0716-2
"H5,G8",17673,18459,13387,5072,9020,6,4301,4326,2991,1335,2.240449438,2149,2044,1266,763,1,762,1,316,0,0.06167979,empty,mBC-0716-2
"H5,G9",12219,12827,9447,3380,6289,0,2960,2962,2097,865,2.424277457,1430,5460,1793,1086,2,1084,1,407,0,0.009225092,empty,mBC-0716-2
"H5,G10",15883,16281,12048,4233,7910,0,3616,3627,2502,1125,2.224,1735,2803,1310,784,1,783,1,324,0,0.029374202,empty,mBC-0716-2
"H5,G11",14153,14576,10803,3773,7156,0,3257,3261,2252,1009,2.231912785,1578,853,516,320,0,320,0,135,0,0.0375,empty,mBC-0716-2
"H5,G12",13576,13421,10349,3072,6668,0,2938,2945,2053,892,2.301569507,1300,1192,664,431,0,431,0,163,0,0.048723898,empty,mBC-0716-2
"H5,H1",24640,25428,18741,6687,12252,35,5605,5655,4018,1637,2.454489921,2702,915,524,334,0,334,0,157,0,0.077844311,empty,mBC-0716-2
"H5,H2",33026,34072,25209,8863,16335,1,7386,7393,5147,2246,2.291629564,3546,2711,1694,997,0,997,0,365,0,0.033099298,empty,mBC-0716-2
"H5,H3",907462,973075,666371,306704,471127,0,254305,254683,200233,54450,3.677373737,134306,18935,9667,5516,5,5511,3,1181,0,0.026311014,mm10,mBC-0716-2
"H5,H4",17860,18050,13620,4430,8674,0,3946,3954,2779,1175,2.365106383,1850,229,148,105,0,105,0,72,0,0,empty,mBC-0716-2
"H5,H5",1033669,1095767,785687,310080,516365,22,243099,243498,211664,31834,6.648991644,122405,112921,71970,40475,20,40455,1,3650,0,0.000815721,mm10,mBC-0716-2
"H5,H6",18159,18394,13890,4504,8983,0,4087,4099,2908,1191,2.441645676,1909,1702,1074,607,0,607,0,232,0,0.039538715,empty,mBC-0716-2
"H5,H7",1087095,1266133,706385,559748,616536,4,407366,407933,332998,74935,4.443824648,242548,85533,53419,29615,14,29601,1,3119,0,0.001047262,mm10,mBC-0716-2
"H5,H8",738658,810471,525063,285408,395042,19,218561,218875,188598,30277,6.229084784,120164,104945,66712,37564,23,37541,2,3458,0,0.001065502,mm10,mBC-0716-2
"H5,H9",19485,20109,14951,5158,9798,0,4478,4486,3174,1312,2.419207317,2118,1489,872,567,0,567,0,270,0,0.017636684,empty,mBC-0716-2
"H5,H10",18100,19022,13777,5245,9099,2,4219,4227,2904,1323,2.195011338,2080,3870,1577,942,1,941,1,372,0,0.021253985,empty,mBC-0716-2
"H5,H11",20174,21037,15025,6012,10302,0,4858,4867,3404,1463,2.326725906,2507,433,176,120,0,120,0,87,0,0.016666667,empty,mBC-0716-2
"H5,H12",7400,7825,5483,2342,3833,5,1824,1831,1311,520,2.521153846,956,718,418,268,0,268,0,115,0,0.063432836,empty,mBC-0716-2
"H6,A1",19744,19959,15014,4945,9645,0,4461,4469,3048,1421,2.144968332,2082,4607,1800,1100,0,1100,0,352,0,0.06,empty,mBC-0716-2
"H6,A2",24448,24307,18729,5578,11641,5,4959,4978,3515,1463,2.402597403,2231,4240,1713,976,1,975,1,350,0,0.012307692,empty,mBC-0716-2
"H6,A3",20409,21108,15503,5605,10197,5,4738,4754,3352,1402,2.390870185,2295,1096,626,379,0,379,0,173,0,0.063324538,empty,mBC-0716-2
"H6,A4",24304,24915,18812,6103,11728,0,5058,5071,3601,1470,2.449659864,2349,665,383,252,0,252,0,145,0,0.003968254,empty,mBC-0716-2
"H6,A5",1107193,1284472,738662,545810,619343,34,395662,396119,309632,86487,3.580098743,233850,101761,60468,33902,18,33884,2,3394,0,0.00481053,mm10,mBC-0716-2
"H6,A6",897196,994393,632455,361938,475307,2,266005,266373,235268,31105,7.563671435,146537,103933,68932,38299,24,38275,3,3416,0,0.000862182,mm10,mBC-0716-2
"H6,A7",19166,19559,14666,4893,9410,0,4299,4311,2966,1345,2.205204461,2050,1558,888,557,1,556,1,206,0,0.142086331,empty,mBC-0716-2
"H6,A8",13029,13674,9811,3863,6598,10,3161,3173,2240,933,2.400857449,1522,2213,1045,684,1,683,1,301,0,0.014641288,empty,mBC-0716-2
"H6,A9",23152,23118,17760,5358,11061,63,4825,4899,3426,1473,2.32586558,2212,1520,981,613,0,613,0,277,0,0.021207178,empty,mBC-0716-2
"H6,A10",1067119,1286890,681942,604948,618915,7,419480,419960,268029,151931,1.764149515,261221,9675,5925,3268,1,3267,1,756,0,0.006427916,mm10,mBC-0716-2
"H6,A11",22958,23076,17424,5652,11274,0,5058,5068,3591,1477,2.431279621,2353,1285,715,426,1,425,1,205,0,0.035294118,empty,mBC-0716-2
"H6,A12",24733,25099,19038,6061,11865,1,5244,5258,3785,1473,2.569585879,2411,4234,2019,1210,0,1210,0,381,0,0.058677686,empty,mBC-0716-2
"H6,B1",21936,22111,16552,5559,10920,0,4926,4936,3533,1403,2.518175339,2371,1327,774,444,0,444,0,198,0,0.065315315,empty,mBC-0716-2
"H6,B2",22171,22548,16956,5592,10926,0,4955,4963,3401,1562,2.177336748,2369,588,338,213,0,213,0,109,0,0.070422535,empty,mBC-0716-2
"H6,B3",933360,995182,704713,290469,474792,5,228088,228514,191618,36896,5.193462706,117058,77661,49787,27449,16,27433,5,2967,0,0.000911311,mm10,mBC-0716-2
"H6,B4",18625,19132,14304,4828,9317,2,4116,4127,2855,1272,2.244496855,1979,1148,673,372,0,372,0,156,0,0.051075269,empty,mBC-0716-2
"H6,B5",15033,10874,7562,3312,6383,12,3184,3207,2364,843,2.804270463,1722,899,530,326,0,326,0,143,0,0.009202454,empty,mBC-0716-2
"H6,B6",15118,15949,11374,4575,7698,14,3626,3649,2575,1074,2.397579143,1864,1149,641,396,0,396,0,201,0,0.017676768,empty,mBC-0716-2
"H6,B7",21872,22659,16808,5851,11038,0,4956,4970,3536,1434,2.465829847,2409,2634,1153,658,0,658,0,255,0,0.050151976,empty,mBC-0716-2
"H6,B8",15702,16340,11974,4366,7937,0,3649,3664,2573,1091,2.358386801,1778,1517,914,561,0,561,0,254,0,0.060606061,empty,mBC-0716-2
"H6,B9",16999,17743,12995,4748,8532,0,3966,3972,2737,1235,2.216194332,1934,685,397,261,0,261,0,130,0,0.019157088,empty,mBC-0716-2
"H6,B10",1370767,1348217,962592,385625,662977,7,326335,327748,256808,70940,3.620073301,167869,27744,16731,9208,1,9207,1,1539,0,0.002063647,mm10,mBC-0716-2
"H6,B11",19384,19960,14829,5131,9411,0,4324,4333,3016,1317,2.290053151,2083,344,205,133,0,133,0,77,0,0,empty,mBC-0716-2
"H6,B12",22455,22872,16689,6183,10994,0,5114,5129,3654,1475,2.477288136,2511,14072,4323,2581,3,2578,1,674,0,0.081458495,empty,mBC-0716-2
"H6,C1",1193806,1265348,888866,376482,594815,0,300878,301402,254331,47071,5.403135689,153076,37392,24810,13917,8,13909,1,1922,0,0.001941189,mm10,mBC-0716-2
"H6,C2",22965,23668,17461,6207,11294,0,5238,5242,3766,1476,2.551490515,2549,1536,946,578,0,578,0,211,0,0.07266436,empty,mBC-0716-2
"H6,C3",23860,24095,17598,6497,11543,0,5344,5360,3694,1666,2.217286915,2600,4930,1631,962,0,962,0,301,0,0.041580042,empty,mBC-0716-2
"H6,C4",22287,22646,17074,5572,10873,0,4804,4812,3358,1454,2.309491059,2189,1318,748,470,0,470,0,187,0,0.063829787,empty,mBC-0716-2
"H6,C5",21208,22032,15981,6051,10717,15,4956,4983,3428,1555,2.204501608,2472,1265,766,489,0,489,0,227,0,0.006134969,empty,mBC-0716-2
"H6,C6",1148762,1275929,806278,469651,622944,0,360496,361018,264419,96599,2.737285065,203767,60858,39301,21679,12,21667,3,2609,0,0.002030738,mm10,mBC-0716-2
"H6,C7",2382975,2643023,1634486,1008537,1224900,0,746243,747289,560035,187254,2.990777233,423589,18815,10424,5930,3,5927,2,1186,0,0.027332546,mm10,mBC-0716-2
"H6,C8",18909,18999,14290,4709,9281,6,4192,4209,2862,1347,2.124721604,1997,1769,1055,629,0,629,0,250,0,0.077901431,empty,mBC-0716-2
"H6,C9",15996,16686,12131,4555,7996,35,3763,3810,2700,1110,2.432432432,1841,881,524,318,0,318,0,144,0,0.094339623,empty,mBC-0716-2
"H6,C10",810895,871623,584436,287187,423892,1,236744,237091,171579,65512,2.619046892,125353,18847,8507,4771,4,4767,1,1096,0,0.028529473,mm10,mBC-0716-2
"H6,C11",13201,14117,9806,4311,6715,12,3238,3259,2249,1010,2.226732673,1679,1589,783,470,1,469,1,189,0,0.019189765,empty,mBC-0716-2
"H6,C12",23593,23887,17492,6395,11737,2,5473,5492,3806,1686,2.257413998,2688,1297,758,442,0,442,0,184,0,0.00678733,empty,mBC-0716-2
"H6,D1",15614,15970,11834,4136,7827,29,3602,3639,2533,1106,2.290235081,1740,635,310,187,0,187,0,104,0,0.064171123,empty,mBC-0716-2
"H6,D2",1066430,1175611,766605,409006,563637,35,311727,312250,265736,46514,5.713032635,168597,164523,107793,59632,19,59613,3,4379,0,0.001912335,mm10,mBC-0716-2
"H6,D3",17121,17921,12912,5009,8652,0,4121,4132,2878,1254,2.295055821,2036,1282,797,478,0,478,0,215,0,0.035564854,empty,mBC-0716-2
"H6,D4",3348970,3711711,2368619,1343092,1702887,10,1003386,1004912,824674,180238,4.575472431,557910,283301,176763,97792,39,97753,4,5669,0,0.001309423,mm10,mBC-0716-2
"H6,D5",19839,20993,14967,6026,9909,0,4683,4696,3190,1506,2.118193891,2374,1343,713,445,0,445,0,193,0,0.056179775,empty,mBC-0716-2
"H6,D6",500362,516365,371388,144977,255024,1,123666,123874,94482,29392,3.214548176,62534,8370,5432,3008,0,3008,0,849,0,0.006981383,mm10,mBC-0716-2
"H6,D7",21661,23143,16274,6869,10993,0,5638,5651,3957,1694,2.335891381,2818,1784,1121,646,0,646,0,246,0,0.009287926,empty,mBC-0716-2
"H6,D8",20013,20936,15019,5917,10020,0,4786,4805,3398,1407,2.41506752,2362,1176,689,416,0,416,0,196,0,0.045673077,empty,mBC-0716-2
"H6,D9",373140,367572,283709,83863,182583,0,76735,76866,59027,17839,3.308873816,36132,21133,13257,7387,2,7385,1,1475,0,0.003791469,mm10,mBC-0716-2
"H6,D10",17657,18695,13167,5528,9032,0,4383,4387,3070,1317,2.331055429,2239,11199,3369,2028,1,2027,1,571,0,0.022200296,empty,mBC-0716-2
"H6,D11",16187,16478,12067,4411,7990,0,3630,3635,2564,1071,2.394024276,1734,5122,2063,1257,0,1257,0,418,0,0.019093079,empty,mBC-0716-2
"H6,D12",24946,25694,19108,6586,12111,0,5448,5468,3856,1612,2.392059553,2578,5740,2214,1287,1,1286,1,426,0,0.056765163,empty,mBC-0716-2
"H6,E1",1220170,1331722,862486,469236,630482,22,352224,352823,301512,51311,5.876166904,193277,125210,78997,43709,15,43694,2,3685,0,0.002403076,mm10,mBC-0716-2
"H6,E2",1023407,1079086,764403,314683,512134,7,248719,249185,213851,35334,6.052272599,126256,125461,78079,42623,16,42607,1,3752,0,0.001666393,mm10,mBC-0716-2
"H6,E3",13896,14444,10624,3820,7165,0,3263,3267,2250,1017,2.212389381,1606,9256,2952,1786,2,1784,1,591,0,0.04764574,empty,mBC-0716-2
"H6,E4",18348,18832,14106,4726,8935,1,4058,4077,2878,1199,2.400333611,1893,1313,832,500,0,500,0,214,0,0.018,empty,mBC-0716-2
"H6,E5",2265937,2515437,1599732,915705,1184506,3,697153,698259,559955,138304,4.048725995,386741,109527,70261,38879,32,38847,2,3703,0,0.001879167,mm10,mBC-0716-2
"H6,E6",17617,18062,13375,4687,8751,0,3936,3943,2818,1125,2.504888889,1900,1748,1077,647,2,645,1,282,0,0.03255814,empty,mBC-0716-2
"H6,E7",1200301,1376278,790526,585752,655692,8,433026,433627,298522,135105,2.209555531,253702,23048,14733,8285,2,8283,1,1498,0,0.002656042,mm10,mBC-0716-2
"H6,E8",21159,21424,16265,5159,10422,1,4557,4568,3220,1348,2.388724036,2084,2059,1087,630,0,630,0,269,0,0.033333333,empty,mBC-0716-2
"H6,E9",12292,12653,9159,3494,6098,0,2819,2827,1991,836,2.381578947,1415,930,532,304,0,304,0,127,0,0.032894737,empty,mBC-0716-2
"H6,E10",15627,16420,11886,4534,7976,3,3769,3782,2605,1177,2.213254036,1909,1525,979,584,1,583,1,243,0,0.037735849,empty,mBC-0716-2
"H6,E11",11976,12116,8967,3149,6072,0,2867,2872,1979,893,2.21612542,1403,1274,779,433,0,433,0,200,0,0,empty,mBC-0716-2
"H6,E12",19332,20081,14668,5413,9912,3,4625,4635,3163,1472,2.148777174,2272,1342,819,464,0,464,0,179,0,0.015086207,empty,mBC-0716-2
"H6,F1",21064,21395,16104,5291,10372,18,4540,4574,3212,1362,2.358296623,2125,1812,1128,684,0,684,0,267,0,0.054093567,empty,mBC-0716-2
"H6,F2",27186,28459,20580,7879,13665,0,6474,6490,4525,1965,2.302798982,3228,2832,1659,1060,0,1060,0,438,0,0.029245283,empty,mBC-0716-2
"H6,F3",22698,23808,17071,6737,11432,0,5426,5435,3898,1537,2.536109304,2685,2137,1242,760,0,760,0,328,0,0.025,empty,mBC-0716-2
"H6,F4",21385,21766,16255,5511,10659,0,4854,4870,3476,1394,2.493543759,2335,514,303,199,0,199,0,97,0,0.015075377,empty,mBC-0716-2
"H6,F5",28975,29745,21960,7785,14156,33,6544,6588,4611,1977,2.3323217,3164,1992,1204,725,0,725,0,352,0,0.031724138,empty,mBC-0716-2
"H6,F6",29598,30705,22431,8274,14426,19,6574,6615,4760,1855,2.566037736,3198,13957,4498,2681,3,2678,3,713,0,0.061986557,empty,mBC-0716-2
"H6,F7",24034,24791,18303,6488,11960,5,5495,5509,3920,1589,2.466960352,2583,990,535,333,0,333,0,171,0,0.042042042,empty,mBC-0716-2
"H6,F8",26093,26879,19660,7219,12953,0,5875,5888,4078,1810,2.253038674,2858,502,327,212,0,212,0,131,0,0.004716981,empty,mBC-0716-2
"H6,F9",17652,18181,13410,4771,8705,0,3955,3963,2761,1202,2.297004992,1891,2329,1168,711,0,711,0,259,0,0.073136428,empty,mBC-0716-2
"H6,F10",22901,23060,17539,5521,11176,19,4854,4887,3570,1317,2.71070615,2257,1284,769,454,0,454,0,194,0,0.022026432,empty,mBC-0716-2
"H6,F11",13514,14100,10276,3824,6851,10,3127,3146,2233,913,2.445783133,1525,1064,656,429,0,429,0,208,0,0.032634033,empty,mBC-0716-2
"H6,F12",17028,17401,12719,4682,8365,0,3893,3908,2826,1082,2.611829945,1876,742,261,165,2,163,1,81,0,0.024539877,empty,mBC-0716-2
"H6,G1",11531,11639,8828,2811,5650,0,2514,2520,1740,780,2.230769231,1152,7314,2554,1508,3,1505,1,445,0,0.037209302,empty,mBC-0716-2
"H6,G2",25192,26230,18964,7266,12347,18,5640,5674,3988,1686,2.365361803,2739,1205,613,402,2,400,1,190,0,0.065,empty,mBC-0716-2
"H6,G3",24378,24715,18320,6395,11998,0,5483,5502,3795,1707,2.223198594,2569,3448,1553,964,0,964,0,395,0,0.060165975,empty,mBC-0716-2
"H6,G4",33176,33695,25557,8138,16096,0,7124,7142,5177,1965,2.634605598,3279,235,163,112,0,112,0,86,0,0.008928571,empty,mBC-0716-2
"H6,G5",17414,18037,13123,4914,8608,0,4081,4095,2914,1181,2.467400508,1958,3718,1595,1011,0,1011,0,402,0,0.087042532,empty,mBC-0716-2
"H6,G6",29458,30785,22487,8298,14720,7,6654,6681,4721,1960,2.408673469,3207,380,255,150,0,150,0,102,0,0,empty,mBC-0716-2
"H6,G7",23084,23384,17506,5878,11340,0,5098,5109,3655,1454,2.513755158,2302,2047,1229,736,1,735,1,299,0,0.048979592,empty,mBC-0716-2
"H6,G8",17985,18553,13542,5011,8895,0,4264,4274,3000,1274,2.354788069,2095,2338,1220,734,1,733,1,313,0,0.039563438,empty,mBC-0716-2
"H6,G9",948989,1030073,705586,324487,490711,1,250126,250564,179691,70873,2.535394297,132832,180840,118412,65223,30,65193,3,4352,0,0.001043057,mm10,mBC-0716-2
"H6,G10",16047,16660,12205,4455,7983,7,3601,3617,2519,1098,2.29417122,1712,1679,981,605,0,605,0,268,0,0.029752066,empty,mBC-0716-2
"H6,G11",14512,15091,11121,3970,7229,0,3269,3283,2280,1003,2.273180459,1529,697,365,234,0,234,0,133,0,0.017094017,empty,mBC-0716-2
"H6,G12",13683,14131,10367,3764,6889,0,3220,3229,2254,975,2.311794872,1546,1258,778,441,0,441,0,184,0,0.079365079,empty,mBC-0716-2
"H6,H1",25476,26327,19447,6880,12666,16,5737,5759,4050,1709,2.369806905,2714,1154,667,392,0,392,0,179,0,0.053571429,empty,mBC-0716-2
"H6,H2",28337,28962,21430,7532,13820,31,6248,6294,4429,1865,2.374798928,2981,2005,1305,783,0,783,0,346,0,0.022988506,empty,mBC-0716-2
"H6,H3",25893,26493,19659,6834,12766,0,5841,5856,4103,1753,2.340559042,2810,1857,1117,673,0,673,0,285,0,0.052005944,empty,mBC-0716-2
"H6,H4",18722,19274,14111,5163,9413,0,4299,4306,3084,1222,2.523731588,2058,312,172,111,0,111,0,76,0,0.009009009,empty,mBC-0716-2
"H6,H5",1034548,1108103,773831,334272,525343,5,262458,262956,207307,55649,3.725260112,136576,86197,54009,30306,15,30291,4,3102,0,0.001683668,mm10,mBC-0716-2
"H6,H6",19200,19993,14568,5425,9736,1,4621,4636,3352,1284,2.6105919,2272,3489,1598,928,0,928,0,335,0,0.021551724,empty,mBC-0716-2
"H6,H7",1614686,1740588,1167753,572835,833559,11,453189,453953,368211,85742,4.294406475,243094,117144,73427,40758,14,40744,3,3789,0,0.000908109,mm10,mBC-0716-2
"H6,H8",679758,710465,503283,207182,344082,18,172296,172671,140008,32663,4.286440315,87497,28301,16590,9516,3,9513,1,1714,0,0.006412278,mm10,mBC-0716-2
"H6,H9",20855,21470,15609,5861,10419,19,4802,4832,3421,1411,2.424521616,2406,1700,1000,641,0,641,0,308,0,0.046801872,empty,mBC-0716-2
"H6,H10",18890,19528,14167,5361,9404,0,4395,4409,3039,1370,2.218248175,2148,1453,873,561,0,561,0,261,0,0.062388592,empty,mBC-0716-2
"H6,H11",20633,21426,15718,5708,10196,23,4692,4726,3292,1434,2.29567643,2275,186,102,70,0,70,0,56,0,0,empty,mBC-0716-2
"H6,H12",7931,8276,5879,2397,3940,11,1860,1878,1278,600,2.13,958,636,381,209,0,209,0,87,0,0.04784689,empty,mBC-0716-2
"H7,A1",16965,17370,12852,4518,8472,24,3917,3951,2762,1189,2.322960471,1896,1143,609,385,0,385,0,182,0,0.05974026,empty,mBC-0716-2
"H7,A2",20675,20946,15626,5320,9976,0,4392,4408,3094,1314,2.354642314,2060,3299,1401,857,0,857,0,289,0,0.197199533,empty,mBC-0716-2
"H7,A3",18255,18839,13748,5091,8995,7,4161,4180,2900,1280,2.265625,1965,3685,1331,762,0,762,0,277,0,0.023622047,empty,mBC-0716-2
"H7,A4",22175,22601,17160,5441,10870,34,4698,4744,3351,1393,2.405599426,2172,678,390,234,0,234,0,127,0,0.051282051,empty,mBC-0716-2
"H7,A5",841774,922937,610281,312656,449862,1,246195,246595,178770,67825,2.635753778,133541,51077,32691,18280,7,18273,2,2387,0,0.001094511,mm10,mBC-0716-2
"H7,A6",13484,13898,10319,3579,6800,18,3139,3164,2140,1024,2.08984375,1546,1487,858,594,1,593,1,267,0,0.033726813,empty,mBC-0716-2
"H7,A7",17304,17873,13126,4747,8602,37,3843,3893,2700,1193,2.263202012,1866,1216,669,411,0,411,0,180,0,0.03892944,empty,mBC-0716-2
"H7,A8",11325,11668,8636,3032,5579,0,2598,2603,1775,828,2.143719807,1260,1321,654,400,0,400,0,192,0,0.0375,empty,mBC-0716-2
"H7,A9",21590,22158,16388,5770,10624,2,4906,4920,3552,1368,2.596491228,2344,1495,861,519,0,519,0,212,0,0.082851638,empty,mBC-0716-2
"H7,A10",16832,17071,12904,4167,8195,3,3640,3646,2556,1090,2.344954128,1716,418,249,174,0,174,0,102,0,0,empty,mBC-0716-2
"H7,A11",882015,944917,639744,305173,455103,0,238606,238990,202072,36918,5.473535945,126519,64139,39397,21783,7,21776,1,2675,0,0.0047759,mm10,mBC-0716-2
"H7,A12",22249,22673,17056,5617,10754,0,4738,4745,3294,1451,2.270158511,2230,2200,1287,771,1,770,1,265,0,0.057142857,empty,mBC-0716-2
"H7,B1",20073,21235,15264,5971,10056,0,4596,4610,3227,1383,2.333333333,2287,984,625,372,0,372,0,172,0,0.029569892,empty,mBC-0716-2
"H7,B2",20380,20473,15547,4926,9918,21,4361,4390,3047,1343,2.268801191,2007,985,368,212,1,211,1,104,0,0.075829384,empty,mBC-0716-2
"H7,B3",18887,19360,14612,4748,9359,0,4194,4198,2864,1334,2.146926537,1986,1056,612,367,0,367,0,176,0,0.046321526,empty,mBC-0716-2
"H7,B4",17684,18244,13702,4542,8764,3,3843,3856,2703,1153,2.344319167,1832,985,590,361,0,361,0,151,0,0.027700831,empty,mBC-0716-2
"H7,B5",36058,34708,23211,11497,18451,0,9860,9888,7890,1998,3.948948949,5337,733,406,245,0,245,0,107,0,0.028571429,empty,mBC-0716-2
"H7,B6",820433,915445,576647,338798,441951,0,252361,252768,213792,38976,5.485221675,141481,120887,80538,44365,15,44350,2,3822,0,0.000721533,mm10,mBC-0716-2
"H7,B7",1030353,1054156,782158,271998,500502,30,241408,241893,166974,74919,2.228727025,119455,11562,5942,3266,2,3264,2,858,0,0.005208333,mm10,mBC-0716-2
"H7,B8",14013,14343,10739,3604,6913,4,3074,3085,2147,938,2.28891258,1424,1248,651,430,0,430,0,206,0,0.018604651,empty,mBC-0716-2
"H7,B9",15680,16293,12054,4239,7723,6,3496,3517,2340,1177,1.988105353,1718,646,360,199,0,199,0,116,0,0,empty,mBC-0716-2
"H7,B10",17786,18271,13288,4983,8833,0,4145,4164,2812,1352,2.079881657,2010,644,390,235,0,235,0,99,0,0.034042553,empty,mBC-0716-2
"H7,B11",1924389,2054892,1428120,626772,953434,48,502626,503527,362124,141403,2.560935765,262338,8046,5190,3035,1,3034,1,690,0,0.000329598,mm10,mBC-0716-2
"H7,B12",19050,19651,14595,5056,9497,0,4354,4362,3068,1294,2.370942813,2083,1645,782,437,0,437,0,184,0,0.070938215,empty,mBC-0716-2
"H7,C1",25430,25629,19803,5826,12245,13,5182,5203,3695,1508,2.450265252,2316,1360,593,356,1,355,1,146,0,0.045070423,empty,mBC-0716-2
"H7,C2",677121,729744,490480,239264,359222,16,195634,195934,149364,46570,3.207300837,104842,17738,7476,4210,8,4202,2,1035,0,0.018562589,mm10,mBC-0716-2
"H7,C3",22680,23742,17064,6678,11267,1,5210,5236,3673,1563,2.34996801,2602,599,328,197,0,197,0,107,0,0.015228426,empty,mBC-0716-2
"H7,C4",22678,23553,17266,6287,11246,0,5054,5074,3506,1568,2.235969388,2508,1290,784,465,0,465,0,194,0,0.021505376,empty,mBC-0716-2
"H7,C5",17252,18097,13091,5006,8733,0,4120,4126,2880,1246,2.311396469,2062,1165,735,426,1,425,1,200,0,0.018823529,empty,mBC-0716-2
"H7,C6",18300,18569,13881,4688,9376,16,4358,4384,3063,1321,2.318697956,2094,3611,1283,818,1,817,1,284,0,0.028151775,empty,mBC-0716-2
"H7,C7",17852,18741,13367,5374,9019,22,4370,4397,3136,1261,2.486915147,2229,690,335,209,0,209,0,97,0,0.052631579,empty,mBC-0716-2
"H7,C8",16274,16936,12400,4536,8113,3,3730,3740,2539,1201,2.114071607,1831,1433,836,489,0,489,0,209,0,0.026584867,empty,mBC-0716-2
"H7,C9",3667821,3983816,2630691,1353125,1816419,2,1049966,1051540,862792,188748,4.57113188,564936,240169,153583,84827,42,84785,7,5531,0,0.001332783,mm10,mBC-0716-2
"H7,C10",14778,14976,11275,3701,7372,6,3309,3321,2304,1017,2.265486726,1608,1209,654,410,0,410,0,201,0,0.017073171,empty,mBC-0716-2
"H7,C11",12447,12997,9554,3443,6304,6,2948,2964,2010,954,2.106918239,1438,913,549,340,1,339,1,155,0,0,empty,mBC-0716-2
"H7,C12",21202,21809,15950,5859,10338,29,4718,4760,3353,1407,2.383084577,2257,1080,669,403,1,402,1,161,0,0.017412935,empty,mBC-0716-2
"H7,D1",12466,12701,9488,3213,6266,0,2886,2896,2010,886,2.268623025,1348,1478,614,374,1,373,1,154,0,0.034852547,empty,mBC-0716-2
"H7,D2",659514,665399,509101,156298,325347,12,140829,141159,103179,37980,2.716666667,66875,19297,12619,7130,7,7123,1,1388,0,0.006598343,mm10,mBC-0716-2
"H7,D3",14455,15390,10804,4586,7452,0,3577,3591,2451,1140,2.15,1860,1163,741,428,0,428,0,202,0,0.01635514,empty,mBC-0716-2
"H7,D4",15238,15762,11650,4112,7534,0,3433,3440,2360,1080,2.185185185,1605,1240,736,460,0,460,0,238,0,0.023913043,empty,mBC-0716-2
"H7,D5",14529,15054,10963,4091,7247,0,3306,3311,2345,966,2.427536232,1624,1016,562,326,0,326,0,162,0,0.070552147,empty,mBC-0716-2
"H7,D6",13382,14034,10114,3920,6839,59,3217,3280,2239,1041,2.150816523,1620,1172,665,410,0,410,0,200,0,0.063414634,empty,mBC-0716-2
"H7,D7",14020,14536,10751,3785,6978,7,3216,3226,2243,983,2.281790437,1541,1375,819,494,0,494,0,195,0,0.032388664,empty,mBC-0716-2
"H7,D8",16421,16813,12453,4360,8229,0,3764,3778,2616,1162,2.251290878,1755,1011,574,337,0,337,0,128,0,0.044510386,empty,mBC-0716-2
"H7,D9",637598,708920,438636,270284,352865,0,205641,205950,163924,42026,3.900537762,117701,153698,97327,54079,18,54061,5,4399,0,0.001997743,mm10,mBC-0716-2
"H7,D10",17405,18184,13148,5036,8783,3,4210,4216,2973,1243,2.391794047,2066,4887,1426,841,1,840,1,274,0,0.027380952,empty,mBC-0716-2
"H7,D11",13857,14595,10607,3988,7104,0,3342,3346,2298,1048,2.192748092,1658,1448,854,521,0,521,0,240,0,0.076775432,empty,mBC-0716-2
"H7,D12",20745,21456,15940,5516,10434,0,4855,4874,3403,1471,2.31339225,2299,2021,1267,745,2,743,1,280,0,0.01884253,empty,mBC-0716-2
"H7,E1",22868,22943,17588,5355,11000,6,4802,4825,3350,1475,2.271186441,2178,1566,933,557,0,557,0,242,0,0.093357271,empty,mBC-0716-2
"H7,E2",17506,17473,13407,4066,8522,5,3714,3727,2640,1087,2.428702852,1649,1408,780,461,0,461,0,190,0,0.062906725,empty,mBC-0716-2
"H7,E3",981376,1010382,748609,261773,491358,0,229431,229831,175130,54701,3.201586808,112323,33477,19423,11125,4,11121,1,2000,0,0.012678716,mm10,mBC-0716-2
"H7,E4",16002,16281,12410,3871,7745,0,3403,3413,2413,1000,2.413,1514,1312,737,437,1,436,1,201,0,0.036697248,empty,mBC-0716-2
"H7,E5",679264,684816,525977,158839,332803,1,143130,143461,101932,41529,2.454477594,67420,17655,11018,6240,4,6236,1,1257,0,0.007857601,mm10,mBC-0716-2
"H7,E6",3473736,3916233,2363166,1553067,1830454,4,1162363,1163931,885470,278461,3.17987079,666838,269449,173576,96130,39,96091,3,5970,0,0.00104068,mm10,mBC-0716-2
"H7,E7",14424,14918,11020,3898,7228,1,3210,3223,2177,1046,2.08126195,1577,1109,662,397,0,397,0,188,0,0.017632242,empty,mBC-0716-2
"H7,E8",19251,19604,14821,4783,9398,0,4071,4087,2845,1242,2.290660225,1904,11725,3487,2069,3,2066,2,575,0,0.036302033,empty,mBC-0716-2
"H7,E9",10185,10656,7719,2937,5193,0,2445,2449,1689,760,2.222368421,1222,908,551,307,0,307,0,126,0,0.087947883,empty,mBC-0716-2
"H7,E10",13765,14164,10425,3739,6855,4,3183,3191,2216,975,2.272820513,1548,1117,694,433,0,433,0,188,0,0.069284065,empty,mBC-0716-2
"H7,E11",10171,10688,7778,2910,5120,1,2367,2372,1662,710,2.34084507,1152,955,557,346,0,346,0,159,0,0.031791908,empty,mBC-0716-2
"H7,E12",17360,17827,13079,4748,8843,0,4102,4112,2865,1247,2.297514034,2041,4980,1656,1008,3,1005,2,319,0,0.056716418,empty,mBC-0716-2
"H7,F1",19635,20153,15204,4949,9652,4,4361,4380,3078,1302,2.3640553,2009,1796,1141,691,0,691,0,270,0,0.041968162,empty,mBC-0716-2
"H7,F2",608328,629772,457648,172124,310629,1,147446,147671,111841,35830,3.121434552,74693,28427,15814,9131,4,9127,1,1668,0,0.007231292,mm10,mBC-0716-2
"H7,F3",17111,17934,12895,5039,8705,0,4138,4149,2876,1273,2.259230165,2014,1722,994,598,0,598,0,273,0,0.071906355,empty,mBC-0716-2
"H7,F4",17727,18056,13536,4520,8748,1,3921,3933,2750,1183,2.324598478,1834,445,266,177,0,177,0,80,0,0.028248588,empty,mBC-0716-2
"H7,F5",26131,27486,19890,7596,13172,11,6102,6140,4295,1845,2.327913279,3009,1853,1132,711,0,711,0,315,0,0.007032349,empty,mBC-0716-2
"H7,F6",25284,25942,19115,6827,12372,7,5670,5686,3991,1695,2.354572271,2765,3280,1659,980,1,979,1,353,0,0.057201226,empty,mBC-0716-2
"H7,F7",24407,25115,18590,6525,12303,28,5577,5618,3978,1640,2.425609756,2727,985,615,389,0,389,0,167,0,0.051413882,empty,mBC-0716-2
"H7,F8",23632,24347,18077,6270,11697,6,5320,5339,3765,1574,2.391994917,2585,475,252,176,0,176,0,104,0,0.011363636,empty,mBC-0716-2
"H7,F9",15260,15990,11813,4177,7687,3,3461,3476,2433,1043,2.332694151,1612,1408,845,522,1,521,1,188,0,0.09596929,empty,mBC-0716-2
"H7,F10",1233864,1327732,864748,462984,634106,0,369310,369788,265502,104286,2.545902614,200342,10668,6698,3755,3,3752,1,860,0,0.00293177,mm10,mBC-0716-2
"H7,F11",11799,12310,8918,3392,5982,0,2678,2686,1898,788,2.408629442,1304,1526,821,491,0,491,0,211,0,0.057026477,empty,mBC-0716-2
"H7,F12",14823,15388,11240,4148,7326,0,3372,3375,2381,994,2.395372233,1634,238,131,77,0,77,0,47,0,0.012987013,empty,mBC-0716-2
"H7,G1",502057,539116,381876,157240,265132,0,128173,128430,98180,30250,3.245619835,65168,89453,56459,31941,16,31925,3,3110,0,0.001973375,mm10,mBC-0716-2
"H7,G2",22799,23329,17400,5929,11227,0,5022,5028,3597,1431,2.513626834,2341,1639,756,478,0,478,0,204,0,0.062761506,empty,mBC-0716-2
"H7,G3",21039,21569,15925,5644,10223,0,4655,4665,3236,1429,2.264520644,2158,1850,1154,697,0,697,0,281,0,0.06312769,empty,mBC-0716-2
"H7,G4",1012034,1053040,752905,300135,504886,24,253776,254269,189026,65243,2.897261009,128852,427,217,128,0,128,0,68,0,0.0546875,empty,mBC-0716-2
"H7,G5",1028136,1113292,732682,380610,527538,4,288275,288752,249184,39568,6.297614234,155794,69587,44383,24861,11,24850,1,2832,0,0.002937626,mm10,mBC-0716-2
"H7,G6",2515384,2757964,1777965,979999,1274196,4,733281,734459,611177,123282,4.957552603,401606,14144,8773,4989,2,4987,2,1039,0,0.006617205,mm10,mBC-0716-2
"H7,G7",21691,22407,16716,5691,10708,0,4809,4823,3410,1413,2.413305025,2255,2356,1200,722,2,720,2,291,0,0.036111111,empty,mBC-0716-2
"H7,G8",15595,16554,11833,4721,7938,0,3728,3735,2590,1145,2.262008734,1824,1379,897,558,0,558,0,240,0,0.016129032,empty,mBC-0716-2
"H7,G9",11264,11309,8748,2561,5668,0,2525,2527,1783,744,2.396505376,1147,2069,966,599,1,598,1,264,0,0.070234114,empty,mBC-0716-2
"H7,G10",14533,14979,11113,3866,7225,0,3185,3199,2219,980,2.264285714,1514,1250,750,487,0,487,0,225,0,0.04312115,empty,mBC-0716-2
"H7,G11",12980,13570,9908,3662,6551,10,2992,3012,2097,915,2.291803279,1482,626,387,242,1,241,1,95,0,0.058091286,empty,mBC-0716-2
"H7,G12",12351,12329,9212,3117,6134,2,2780,2788,1942,846,2.295508274,1310,1105,690,393,0,393,0,162,0,0.076335878,empty,mBC-0716-2
"H7,H1",1907123,2069290,1386729,682561,974073,3,534978,535830,439567,96263,4.566313121,285622,87249,55397,30380,10,30370,1,3307,0,0.002239052,mm10,mBC-0716-2
"H7,H2",1150213,1228387,842882,385505,581534,38,298709,299219,258714,40505,6.387211455,156385,128755,80905,45303,29,45274,6,3873,0,0.001413615,mm10,mBC-0716-2
"H7,H3",31868,33270,24034,9236,15907,1,7711,7724,5520,2204,2.504537205,3793,1886,1045,607,0,607,0,244,0,0.034596376,empty,mBC-0716-2
"H7,H4",2453609,2687510,1715121,972389,1262935,3,755721,756753,557774,198979,2.803180235,419481,5883,3685,2061,0,2061,0,568,0,0.002911208,mm10,mBC-0716-2
"H7,H5",18641,19523,14362,5161,9257,5,4299,4316,3082,1234,2.497568882,2062,1267,765,457,0,457,0,201,0,0.041575492,empty,mBC-0716-2
"H7,H6",15415,16005,11701,4304,7813,0,3616,3626,2538,1088,2.332720588,1784,1204,728,502,0,502,0,222,0,0.015936255,empty,mBC-0716-2
"H7,H7",18280,18747,13837,4910,9133,3,4148,4163,2941,1222,2.406710311,1957,2718,1229,753,0,753,0,272,0,0.047808765,empty,mBC-0716-2
"H7,H8",14535,15045,10881,4164,7245,3,3322,3335,2341,994,2.355130785,1662,1716,997,601,1,600,1,255,0,0.065,empty,mBC-0716-2
"H7,H9",738003,776553,534189,242364,381019,1,200155,200411,146787,53624,2.737337759,106682,10766,5231,3087,1,3086,1,835,0,0.061244329,mm10,mBC-0716-2
"H7,H10",16320,16835,12299,4536,8217,22,3783,3809,2712,1097,2.472196901,1848,1091,674,432,0,432,0,229,0,0.009259259,empty,mBC-0716-2
"H7,H11",18095,18768,13392,5376,8977,0,4256,4269,2996,1273,2.353495679,2115,1120,336,223,0,223,0,121,0,0.040358744,empty,mBC-0716-2
"H7,H12",6542,6779,4856,1923,3342,0,1530,1534,1102,432,2.550925926,767,469,275,165,0,165,0,77,0,0.103030303,empty,mBC-0716-2
"H8,A1",13868,14737,10417,4320,7394,29,3521,3560,2517,1043,2.413231064,1822,806,422,274,0,274,0,130,0,0.098540146,empty,mBC-0716-2
"H8,A2",18080,18372,13927,4445,8833,0,3933,3939,2713,1226,2.212887439,1841,929,494,327,0,327,0,154,0,0.073394495,empty,mBC-0716-2
"H8,A3",16061,16738,12216,4522,8121,0,3809,3822,2683,1139,2.355575066,1863,979,634,385,0,385,0,141,0,0.028571429,empty,mBC-0716-2
"H8,A4",21926,22483,16911,5572,10857,0,4849,4862,3418,1444,2.367036011,2334,417,250,188,0,188,0,104,0,0.053191489,empty,mBC-0716-2
"H8,A5",17185,18114,13033,5081,8843,1,4171,4182,2963,1219,2.430680886,2082,1789,905,532,1,531,1,219,0,0.054613936,empty,mBC-0716-2
"H8,A6",562529,592276,405944,186332,289638,0,152790,153045,113478,39567,2.867996057,80400,18456,11355,6540,5,6535,1,1282,0,0.008263198,mm10,mBC-0716-2
"H8,A7",16188,16945,12199,4746,8160,1,3789,3795,2621,1174,2.23253833,1840,794,481,315,1,314,1,151,0,0.050955414,empty,mBC-0716-2
"H8,A8",11578,11963,8648,3315,5790,21,2725,2748,1940,808,2.400990099,1338,3110,1209,768,0,768,0,279,0,0.072916667,empty,mBC-0716-2
"H8,A9",18860,19753,14427,5326,9237,6,4157,4176,2914,1262,2.309033281,1992,3843,1516,928,1,927,1,329,0,0.05609493,empty,mBC-0716-2
"H8,A10",15526,15921,11774,4147,7765,2,3555,3567,2552,1015,2.514285714,1700,354,196,127,0,127,0,78,0,0.015748031,empty,mBC-0716-2
"H8,A11",18049,18850,13513,5337,9093,8,4131,4146,2856,1290,2.213953488,2082,1104,634,358,2,356,1,168,0,0.04494382,empty,mBC-0716-2
"H8,A12",20646,20973,16043,4930,10043,4,4301,4314,3074,1240,2.479032258,2016,4110,1662,982,0,982,0,283,0,0.060081466,empty,mBC-0716-2
"H8,B1",19946,20356,15136,5220,9829,6,4428,4445,3124,1321,2.364875095,2139,2086,891,542,0,542,0,192,0,0.075645756,empty,mBC-0716-2
"H8,B2",20999,21817,16013,5804,10545,0,4795,4808,3289,1519,2.16524029,2310,798,382,213,0,213,0,103,0,0.004694836,empty,mBC-0716-2
"H8,B3",20273,21163,15350,5813,10203,0,4815,4824,3401,1423,2.390021082,2346,974,572,333,0,333,0,146,0,0.018018018,empty,mBC-0716-2
"H8,B4",16611,17088,12713,4375,8330,1,3751,3759,2635,1124,2.34430605,1774,952,565,333,0,333,0,130,0,0.009009009,empty,mBC-0716-2
"H8,B5",11692,8278,5654,2624,4853,3,2416,2433,1787,646,2.76625387,1325,3998,1328,794,1,793,1,258,0,0.047919294,empty,mBC-0716-2
"H8,B6",12658,13322,9555,3767,6533,12,3086,3101,2127,974,2.183778234,1506,977,589,385,1,384,1,162,0,0.09375,empty,mBC-0716-2
"H8,B7",16925,17498,12877,4621,8452,6,3758,3771,2689,1082,2.485212569,1826,1115,547,330,0,330,0,146,0,0.027272727,empty,mBC-0716-2
"H8,B8",13919,14712,10602,4110,7055,0,3303,3303,2273,1030,2.206796117,1626,975,599,368,0,368,0,179,0,0.043478261,empty,mBC-0716-2
"H8,B9",15355,16085,11730,4355,7630,25,3428,3464,2400,1064,2.255639098,1654,687,421,257,0,257,0,129,0,0.089494163,empty,mBC-0716-2
"H8,B10",702639,726078,481876,244202,364133,11,193368,194119,166410,27709,6.00562994,104221,36744,23516,13286,4,13282,1,1771,0,0.001355218,mm10,mBC-0716-2
"H8,B11",964249,1050088,683077,367011,498566,1,278407,278835,236430,42405,5.575521755,151668,3980,2519,1448,0,1448,0,377,0,0.003453039,mm10,mBC-0716-2
"H8,B12",19058,19807,14513,5294,9611,4,4393,4405,3122,1283,2.433359314,2152,1138,618,350,2,348,1,164,0,0.005747126,empty,mBC-0716-2
"H8,C1",23514,23693,18384,5309,11267,35,4689,4739,3388,1351,2.507772021,2088,632,415,253,0,253,0,105,0,0.019762846,empty,mBC-0716-2
"H8,C2",1171672,1296209,781836,514373,614745,22,379205,379831,311383,68448,4.549190626,215634,75476,48415,26749,18,26731,1,3068,0,0.002094946,mm10,mBC-0716-2
"H8,C3",26171,27063,19760,7303,13109,0,6276,6286,4512,1774,2.543404735,3035,515,267,185,0,185,0,92,0,0.005405405,empty,mBC-0716-2
"H8,C4",37208,40435,28880,11555,19611,11,9613,9638,6985,2653,2.632868451,4897,3812,2472,1368,1,1367,1,317,0,0.015362107,empty,mBC-0716-2
"H8,C5",17767,18536,13209,5327,8982,0,4225,4234,3000,1234,2.431118314,2078,2685,1121,714,3,711,2,263,0,0.095639944,empty,mBC-0716-2
"H8,C6",16874,17653,12648,5005,8859,24,4130,4161,2978,1183,2.517328825,2106,2314,971,587,0,587,0,222,0,0.044293015,empty,mBC-0716-2
"H8,C7",16140,16714,12207,4507,8158,1,3840,3850,2723,1127,2.416149068,1845,300,184,120,0,120,0,68,0,0.05,empty,mBC-0716-2
"H8,C8",15320,15891,11661,4230,7813,11,3603,3627,2506,1121,2.235504014,1746,1168,633,378,0,378,0,168,0,0.047619048,empty,mBC-0716-2
"H8,C9",12889,13210,9749,3461,6390,21,2922,2951,2068,883,2.342015855,1431,753,475,280,0,280,0,131,0,0.075,empty,mBC-0716-2
"H8,C10",13684,13808,10422,3386,6771,0,3060,3062,2090,972,2.150205761,1418,3953,1264,755,0,755,0,261,0,0.046357616,empty,mBC-0716-2
"H8,C11",13057,13441,9995,3446,6452,45,2944,2994,2017,977,2.064483112,1448,633,366,219,0,219,0,94,0,0.0456621,empty,mBC-0716-2
"H8,C12",1031870,1195006,678782,516224,572070,0,373820,374361,268520,105841,2.537013067,224546,8828,5465,3099,1,3098,1,742,0,0.005164622,mm10,mBC-0716-2
"H8,D1",11200,11708,8368,3340,5781,0,2762,2774,1861,913,2.038335159,1404,516,255,154,0,154,0,75,0,0.006493506,empty,mBC-0716-2
"H8,D2",22665,23080,17423,5657,11091,29,4845,4880,3421,1459,2.344756683,2273,3076,1448,852,0,852,0,350,0,0.026995305,empty,mBC-0716-2
"H8,D3",1259504,1369705,914063,455642,662958,0,353868,354386,280157,74229,3.774225707,192213,144070,93112,52245,19,52226,2,4218,0,0.000478689,mm10,mBC-0716-2
"H8,D4",15904,16624,12010,4614,8163,0,3856,3863,2678,1185,2.259915612,1948,1174,727,456,0,456,0,227,0,0.059210526,empty,mBC-0716-2
"H8,D5",809464,909006,544116,364890,443171,2,275051,275450,223133,52317,4.265019019,157164,16959,10323,5752,0,5752,0,1164,0,0.005910987,mm10,mBC-0716-2
"H8,D6",12413,12724,9266,3458,6187,0,2908,2914,1993,921,2.163952226,1423,1122,686,449,0,449,0,183,0,0.071269488,empty,mBC-0716-2
"H8,D7",13000,13530,9693,3837,6511,21,3104,3129,2111,1018,2.07367387,1557,1153,678,425,0,425,0,166,0,0.028235294,empty,mBC-0716-2
"H8,D8",15689,15888,11772,4116,7869,66,3635,3711,2613,1098,2.379781421,1773,811,505,287,0,287,0,124,0,0.024390244,empty,mBC-0716-2
"H8,D9",4577,4862,3366,1496,2429,0,1219,1222,882,340,2.594117647,634,1420,766,475,0,475,0,228,0,0.023157895,empty,mBC-0716-2
"H8,D10",14940,15384,11246,4138,7489,0,3528,3544,2459,1085,2.266359447,1711,615,360,197,0,197,0,74,0,0.086294416,empty,mBC-0716-2
"H8,D11",13804,14352,10531,3821,6935,0,3188,3203,2238,965,2.319170984,1526,1282,722,449,0,449,0,194,0,0.006681514,empty,mBC-0716-2
"H8,D12",1199959,1214906,904371,310535,584370,2,265939,266438,208807,57631,3.623171557,131930,4525,2207,1305,0,1305,0,542,0,0.020689655,mm10,mBC-0716-2
"H8,E1",22010,22108,16798,5310,10748,11,4768,4789,3261,1528,2.134162304,2184,1274,687,428,0,428,0,217,0,0.065420561,empty,mBC-0716-2
"H8,E2",1333712,1436321,966301,470020,690659,2,368995,369565,288669,80896,3.56839646,198137,171570,105950,59313,27,59286,2,4661,0,0.001804811,mm10,mBC-0716-2
"H8,E3",12347,12438,9510,2928,6207,8,2741,2751,1950,801,2.434456929,1249,1134,627,416,0,416,0,197,0,0.040865385,empty,mBC-0716-2
"H8,E4",15832,16363,11982,4381,7736,0,3494,3502,2486,1016,2.446850394,1668,1448,674,427,0,427,0,181,0,0.007025761,empty,mBC-0716-2
"H8,E5",23872,24459,18478,5981,11756,4,5297,5312,3771,1541,2.447112265,2451,1297,768,489,0,489,0,224,0,0.044989775,empty,mBC-0716-2
"H8,E6",13206,13475,9915,3560,6583,1,3040,3052,2132,920,2.317391304,1451,1195,678,428,0,428,0,192,0,0.044392523,empty,mBC-0716-2
"H8,E7",534418,549288,385352,163936,269630,7,138312,138531,112268,26263,4.274759167,71074,5784,3657,2073,1,2072,1,633,0,0.001447876,mm10,mBC-0716-2
"H8,E8",17859,18367,13752,4615,8995,2,3997,4007,2824,1183,2.38715131,1923,1295,748,454,0,454,0,182,0,0.028634361,empty,mBC-0716-2
"H8,E9",8752,8870,6508,2362,4319,0,1960,1968,1428,540,2.644444444,906,871,508,305,0,305,0,129,0,0.032786885,empty,mBC-0716-2
"H8,E10",13317,13519,10155,3364,6651,17,2993,3021,2073,948,2.186708861,1368,999,603,370,0,370,0,154,0,0.064864865,empty,mBC-0716-2
"H8,E11",8852,9175,6767,2408,4420,4,1980,1986,1372,614,2.234527687,897,988,602,354,0,354,0,151,0,0,empty,mBC-0716-2
"H8,E12",15067,16045,11444,4601,7785,0,3664,3675,2596,1079,2.405931418,1851,1113,640,405,0,405,0,149,0,0.017283951,empty,mBC-0716-2
"H8,F1",575486,582106,424972,157134,284437,10,137298,137576,106101,31475,3.37096108,68274,6340,3952,2168,0,2168,0,677,0,0.007841328,mm10,mBC-0716-2
"H8,F2",2567498,2717024,1873230,843794,1265283,19,687924,689106,537459,151647,3.544145285,363939,126583,75969,43083,16,43067,2,4286,0,0.013746024,mm10,mBC-0716-2
"H8,F3",828960,930729,577917,352812,450378,10,261760,262139,203393,58746,3.462244238,147905,98243,64363,36744,8,36736,1,3395,0,0.001116071,mm10,mBC-0716-2
"H8,F4",698400,760650,485032,275618,379224,2,215466,215782,173945,41837,4.15768339,120242,16749,10172,5794,2,5792,1,994,0,0.002244475,mm10,mBC-0716-2
"H8,F5",24592,25143,18749,6394,12190,0,5478,5490,3903,1587,2.459357278,2641,3824,1575,935,1,934,1,363,0,0.070663812,empty,mBC-0716-2
"H8,F6",959945,1059233,661152,398081,507962,5,294130,294565,247444,47121,5.25124679,164981,166834,109981,60674,24,60650,1,4385,0,0.001566364,mm10,mBC-0716-2
"H8,F7",20418,21221,15676,5545,10369,32,4750,4786,3304,1482,2.229419703,2201,1502,673,423,0,423,0,166,0,0.070921986,empty,mBC-0716-2
"H8,F8",1241724,1293556,919988,373568,623905,1,308666,309187,252972,56215,4.50008005,157440,11227,6619,3759,1,3758,1,837,0,0.000266099,mm10,mBC-0716-2
"H8,F9",14880,15167,11340,3827,7356,0,3216,3227,2197,1030,2.133009709,1481,1150,675,382,1,381,1,147,0,0.034120735,empty,mBC-0716-2
"H8,F10",1290575,1368812,951566,417246,639449,3,327991,328537,262205,66332,3.952918652,170113,60187,37935,20791,9,20782,2,2513,0,0.002405928,mm10,mBC-0716-2
"H8,F11",691146,743331,510085,233246,360419,0,184654,184960,150520,34440,4.370499419,97402,68523,41080,23446,16,23430,2,2739,0,0.002134016,mm10,mBC-0716-2
"H8,F12",14788,15783,11311,4472,7417,68,3411,3489,2495,994,2.510060362,1703,131,79,59,0,59,0,35,0,0,empty,mBC-0716-2
"H8,G1",10628,11063,8340,2723,5306,21,2317,2342,1634,708,2.307909605,1080,1816,929,578,0,578,0,208,0,0.105536332,empty,mBC-0716-2
"H8,G2",22121,22416,16859,5557,10817,1,4826,4833,3423,1410,2.427659574,2260,1154,465,293,1,292,1,161,0,0.003424658,empty,mBC-0716-2
"H8,G3",21059,21587,15961,5626,10344,0,4746,4753,3341,1412,2.366147309,2220,1992,1125,639,0,639,0,250,0,0.031298905,empty,mBC-0716-2
"H8,G4",28983,29831,22066,7765,14398,19,6393,6434,4484,1950,2.299487179,3116,146,92,64,0,64,0,49,0,0,empty,mBC-0716-2
"H8,G5",13912,14357,10669,3688,6981,0,3122,3127,2160,967,2.233712513,1498,1274,729,443,1,442,1,189,0,0.020361991,empty,mBC-0716-2
"H8,G6",24735,25166,19211,5955,12120,0,5184,5195,3710,1485,2.498316498,2446,201,110,76,0,76,0,49,0,0,empty,mBC-0716-2
"H8,G7",1029022,1141649,708414,433235,553400,2,337355,337853,238430,99423,2.398137252,190235,16851,8537,4764,3,4761,1,1098,0,0.010922075,mm10,mBC-0716-2
"H8,G8",14551,15471,10995,4476,7548,0,3556,3567,2455,1112,2.207733813,1844,1173,746,449,0,449,0,201,0,0.046770601,empty,mBC-0716-2
"H8,G9",10997,11315,8340,2975,5498,1,2522,2528,1767,761,2.321944809,1163,1035,605,362,0,362,0,181,0,0.082872928,empty,mBC-0716-2
"H8,G10",13842,14586,10563,4023,6981,3,3219,3231,2263,968,2.337809917,1570,1011,636,405,0,405,0,193,0,0.034567901,empty,mBC-0716-2
"H8,G11",12734,13209,9701,3508,6318,11,2866,2880,1988,892,2.228699552,1356,880,460,273,0,273,0,130,0,0.029304029,empty,mBC-0716-2
"H8,G12",943923,1030730,660274,370456,501159,1,287601,287987,224168,63819,3.512558956,157873,81573,52988,29616,13,29603,1,3055,0,0.000810729,mm10,mBC-0716-2
"H8,H1",829422,876151,589544,286607,425422,23,234544,234880,183307,51573,3.554321059,125240,3807,2367,1314,0,1314,0,416,0,0.01369863,mm10,mBC-0716-2
"H8,H2",24630,25347,18763,6584,12178,7,5508,5520,3872,1648,2.349514563,2632,1685,954,539,1,538,1,255,0,0.022304833,empty,mBC-0716-2
"H8,H3",20484,21330,15724,5606,10373,1,4724,4731,3331,1400,2.379285714,2285,1174,671,389,0,389,0,182,0,0.051413882,empty,mBC-0716-2
"H8,H4",696032,738564,505829,232735,357965,3,184372,184669,152782,31887,4.791356979,96903,4608,2689,1560,0,1560,0,430,0,0.002564103,mm10,mBC-0716-2
"H8,H5",18326,18470,13805,4665,8872,1,4054,4067,2878,1189,2.420521447,1902,1193,730,439,0,439,0,191,0,0.027334852,empty,mBC-0716-2
"H8,H6",14084,14407,10732,3675,7050,0,3266,3273,2325,948,2.452531646,1546,1222,769,480,1,479,1,198,0,0.033402923,empty,mBC-0716-2
"H8,H7",16774,17380,12542,4838,8516,3,3989,3998,2815,1183,2.379543533,2012,1309,734,456,0,456,0,193,0,0.032894737,empty,mBC-0716-2
"H8,H8",13353,13719,10246,3473,6763,1,3067,3072,2161,911,2.372118551,1467,1287,716,448,1,447,1,205,0,0.033557047,empty,mBC-0716-2
"H8,H9",15604,15729,11669,4060,7672,11,3428,3451,2461,990,2.485858586,1631,2557,1103,665,0,665,0,253,0,0.034586466,empty,mBC-0716-2
"H8,H10",14276,14548,10618,3930,7113,6,3290,3298,2319,979,2.368743616,1624,2960,1415,831,1,830,1,327,0,0.03373494,empty,mBC-0716-2
"H8,H11",17087,17880,12895,4985,8578,50,3970,4033,2780,1253,2.21867518,1997,197,125,90,0,90,0,54,0,0.044444444,empty,mBC-0716-2
"H8,H12",6065,6315,4610,1705,3044,0,1417,1421,1012,409,2.474327628,684,616,364,230,0,230,0,106,0,0.060869565,empty,mBC-0716-2
"H9,A1",15566,16074,11701,4373,8021,0,3758,3774,2620,1154,2.270363951,1903,1043,624,389,0,389,0,165,0,0.017994859,empty,mBC-0716-2
"H9,A2",20131,20412,15405,5007,9938,0,4324,4332,3044,1288,2.363354037,1984,1032,661,372,0,372,0,163,0,0.043010753,empty,mBC-0716-2
"H9,A3",17634,18364,13389,4975,8981,2,4213,4225,3046,1179,2.583545377,2092,771,453,280,0,280,0,150,0,0.010714286,empty,mBC-0716-2
"H9,A4",23497,23862,18101,5761,11359,4,5030,5036,3554,1482,2.398110661,2308,2553,920,587,0,587,0,210,0,0.212947189,empty,mBC-0716-2
"H9,A5",939519,1026295,669068,357227,495304,3,271407,271872,228037,43835,5.202167218,148672,121177,74951,41672,22,41650,3,3772,0,0.005642257,mm10,mBC-0716-2
"H9,A6",14065,14754,10376,4378,7191,0,3368,3372,2344,1028,2.280155642,1749,6206,2089,1267,1,1266,1,437,0,0.037124803,empty,mBC-0716-2
"H9,A7",17314,17941,13145,4796,8635,0,3949,3952,2713,1239,2.189669088,1897,3018,1064,659,2,657,1,263,0,0.0456621,empty,mBC-0716-2
"H9,A8",543033,611672,378722,232950,301880,10,177447,177682,147522,30160,4.891312997,99441,133545,72866,41021,21,41000,6,3925,0,0.032097561,mm10,mBC-0716-2
"H9,A9",1367455,1462830,972816,490014,685959,10,376762,377384,315468,61916,5.095096582,201163,56285,36377,20558,6,20552,2,2539,0,0.005692877,mm10,mBC-0716-2
"H9,A10",1070109,1234389,705574,528815,592457,16,382883,383418,280746,102672,2.734396914,225238,16006,10103,5561,2,5559,2,1053,0,0.000179888,mm10,mBC-0716-2
"H9,A11",19536,19856,14906,4950,9704,0,4341,4346,3089,1257,2.457438345,2017,1017,585,377,0,377,0,164,0,0.018567639,empty,mBC-0716-2
"H9,A12",22021,22617,16958,5659,10880,9,4780,4793,3422,1371,2.49598833,2203,2227,1383,796,0,796,0,248,0,0.092964824,empty,mBC-0716-2
"H9,B1",20971,21172,15963,5209,10202,9,4535,4553,3163,1390,2.275539568,2159,1150,749,420,0,420,0,162,0,0.054761905,empty,mBC-0716-2
"H9,B2",1082639,1192920,734760,458160,581670,0,349146,349627,232707,116920,1.990309613,200643,6928,4263,2452,1,2451,1,611,0,0.003263974,mm10,mBC-0716-2
"H9,B3",1106416,1194476,805543,388933,569435,18,303569,304053,252241,51812,4.868389562,160883,79247,51557,29252,10,29242,2,2990,0,0.002051843,mm10,mBC-0716-2
"H9,B4",18365,18914,13986,4928,9011,32,4001,4041,2884,1157,2.492653414,1939,7425,2509,1440,2,1438,1,424,0,0.004867872,empty,mBC-0716-2
"H9,B5",10897,7128,4835,2293,4414,0,2143,2155,1503,652,2.305214724,1182,671,344,210,0,210,0,113,0,0.114285714,empty,mBC-0716-2
"H9,B6",13682,13932,10089,3843,6900,0,3274,3285,2260,1025,2.204878049,1592,998,622,376,0,376,0,155,0,0.085106383,empty,mBC-0716-2
"H9,B7",18444,19066,14061,5005,9127,7,4029,4048,2820,1228,2.296416938,1944,953,593,371,0,371,0,144,0,0.035040431,empty,mBC-0716-2
"H9,B8",13994,14575,10744,3831,7124,30,3165,3202,2209,993,2.224572004,1501,1089,554,332,0,332,0,183,0,0.024096386,empty,mBC-0716-2
"H9,B9",16407,16826,12689,4137,8162,0,3600,3615,2464,1151,2.140747176,1687,1440,573,365,0,365,0,162,0,0.024657534,empty,mBC-0716-2
"H9,B10",17579,17525,12934,4591,8897,0,4040,4056,2862,1194,2.396984925,1933,980,447,261,0,261,0,112,0,0.084291188,empty,mBC-0716-2
"H9,B11",17215,17652,12923,4729,8457,17,3841,3872,2649,1223,2.165985282,1898,184,125,86,0,86,0,60,0,0.034883721,empty,mBC-0716-2
"H9,B12",19606,20297,14840,5457,10141,0,4747,4772,3343,1429,2.339398181,2356,1222,688,373,0,373,0,163,0,0.061662198,empty,mBC-0716-2
"H9,C1",23729,24590,18495,6095,11713,0,5029,5039,3623,1416,2.558615819,2328,525,285,164,0,164,0,102,0,0.018292683,empty,mBC-0716-2
"H9,C2",20084,20230,15198,5032,9652,29,4293,4341,3023,1318,2.293626707,2008,1574,942,524,0,524,0,191,0,0.049618321,empty,mBC-0716-2
"H9,C3",21681,22222,16393,5829,10717,0,5012,5024,3459,1565,2.210223642,2379,1002,480,284,0,284,0,112,0,0.049295775,empty,mBC-0716-2
"H9,C4",18923,19264,14574,4690,9297,0,4138,4151,2910,1241,2.344883159,1908,1208,684,406,0,406,0,157,0,0.0591133,empty,mBC-0716-2
"H9,C5",17492,18250,13286,4964,8857,0,4106,4113,2875,1238,2.322294023,2072,901,502,271,0,271,0,154,0,0.066420664,empty,mBC-0716-2
"H9,C6",17775,18565,13381,5184,9292,0,4360,4362,3046,1316,2.314589666,2169,1189,715,441,0,441,0,202,0,0.058956916,empty,mBC-0716-2
"H9,C7",17563,18261,13161,5100,8905,0,4180,4186,2872,1314,2.185692542,2069,3679,1193,731,2,729,2,266,0,0.042524005,empty,mBC-0716-2
"H9,C8",16693,17290,12591,4699,8324,12,3839,3856,2665,1191,2.237615449,1850,3177,1306,738,0,738,0,249,0,0.050135501,empty,mBC-0716-2
"H9,C9",13990,14431,10540,3891,6951,7,3334,3347,2308,1039,2.221366699,1547,753,448,263,0,263,0,123,0,0.034220532,empty,mBC-0716-2
"H9,C10",14793,14914,11345,3569,7471,8,3356,3367,2422,945,2.562962963,1515,762,420,266,0,266,0,139,0,0,empty,mBC-0716-2
"H9,C11",12958,13455,9711,3744,6541,0,3078,3088,2188,900,2.431111111,1552,3265,1205,729,0,729,0,216,0,0.181069959,empty,mBC-0716-2
"H9,C12",1138741,1223026,822181,400845,575830,5,309873,310392,264033,46359,5.695398952,164689,82656,49652,27598,16,27582,3,3097,0,0.003045464,mm10,mBC-0716-2
"H9,D1",799207,934938,525432,409506,459656,1,298886,299250,196370,102880,1.908728616,179759,14461,9242,5202,3,5199,2,1002,0,0.000769379,mm10,mBC-0716-2
"H9,D2",23021,23178,17778,5400,11333,16,4897,4934,3539,1395,2.536917563,2270,2219,1383,825,0,825,0,336,0,0.052121212,empty,mBC-0716-2
"H9,D3",14694,15581,11179,4402,7597,0,3612,3628,2557,1071,2.387488329,1801,881,499,322,0,322,0,145,0,0.027950311,empty,mBC-0716-2
"H9,D4",564299,591446,426882,164564,293003,0,141117,141358,110546,30812,3.587758016,71049,24646,14541,8421,3,8418,2,1539,0,0.010453789,mm10,mBC-0716-2
"H9,D5",15268,15575,11533,4042,7705,30,3454,3501,2481,1020,2.432352941,1696,943,590,354,0,354,0,137,0,0.04519774,empty,mBC-0716-2
"H9,D6",13723,14400,10437,3963,6852,0,3273,3276,2263,1013,2.233958539,1628,9695,3031,1847,0,1847,0,531,0,0.0146183,empty,mBC-0716-2
"H9,D7",15716,16339,11622,4717,7873,2,3843,3856,2396,1460,1.64109589,1891,10752,3778,2279,1,2278,1,660,0,0.025899912,empty,mBC-0716-2
"H9,D8",955208,1011159,715479,295680,481905,38,233917,234390,197689,36701,5.386474483,118566,71595,44811,25144,10,25134,3,2723,0,0.006604599,mm10,mBC-0716-2
"H9,D9",5889,6012,4475,1537,3004,1,1427,1429,1040,389,2.673521851,681,1630,884,550,0,550,0,239,0,0.021818182,empty,mBC-0716-2
"H9,D10",17243,18206,12876,5330,8735,1,4278,4295,3030,1265,2.395256917,2148,647,389,249,0,249,0,115,0,0.060240964,empty,mBC-0716-2
"H9,D11",14844,15258,11110,4148,7398,1,3476,3486,2460,1026,2.397660819,1719,11571,3708,2289,2,2287,2,606,0,0.148666375,empty,mBC-0716-2
"H9,D12",22216,22949,16919,6030,10989,0,5013,5021,3435,1586,2.165825977,2348,2265,1336,785,1,784,1,260,0,0.06505102,empty,mBC-0716-2
"H9,E1",1159160,1207190,882902,324288,568130,1,262082,262644,196975,65669,2.999512708,130131,79764,49564,28221,10,28211,1,3137,0,0.001346992,mm10,mBC-0716-2
"H9,E2",16997,17212,12890,4322,8462,5,3725,3736,2696,1040,2.592307692,1785,1252,654,413,1,412,1,178,0,0.053398058,empty,mBC-0716-2
"H9,E3",13369,13440,10207,3233,6729,3,2993,3002,2119,883,2.399773499,1377,1296,744,441,1,440,1,195,0,0.025,empty,mBC-0716-2
"H9,E4",16427,16781,12468,4313,8134,11,3709,3730,2505,1225,2.044897959,1771,1056,599,388,0,388,0,173,0,0.051546392,empty,mBC-0716-2
"H9,E5",23065,23711,17883,5828,11433,0,5090,5101,3606,1495,2.412040134,2391,1226,738,450,0,450,0,204,0,0.022222222,empty,mBC-0716-2
"H9,E6",15128,15194,11321,3873,7453,0,3271,3282,2294,988,2.321862348,1597,1427,833,530,0,530,0,223,0,0.083018868,empty,mBC-0716-2
"H9,E7",14789,15004,11200,3804,7159,0,3261,3267,2303,964,2.389004149,1525,1045,657,389,1,388,1,175,0,0.067010309,empty,mBC-0716-2
"H9,E8",19443,19395,14750,4645,9429,1,4226,4237,2947,1290,2.284496124,1963,8962,3388,2061,7,2054,2,529,0,0.208860759,empty,mBC-0716-2
"H9,E9",10138,10325,7540,2785,5010,0,2308,2310,1670,640,2.609375,1125,959,559,361,0,361,0,135,0,0.049861496,empty,mBC-0716-2
"H9,E10",881633,969319,640076,329243,467421,17,249794,250211,206916,43295,4.77921238,135021,105365,69593,38666,16,38650,2,3618,0,0.000491591,mm10,mBC-0716-2
"H9,E11",9963,10248,7520,2728,5052,0,2353,2356,1643,713,2.304347826,1118,1081,677,427,1,426,1,164,0,0.068075117,empty,mBC-0716-2
"H9,E12",16714,16976,12525,4451,8399,0,3914,3920,2683,1237,2.168957154,1871,6562,2198,1376,0,1376,0,452,0,0.021075581,empty,mBC-0716-2
"H9,F1",20004,20837,15348,5489,9836,8,4406,4423,3065,1358,2.256995582,2068,1348,779,486,1,485,1,203,0,0.030927835,empty,mBC-0716-2
"H9,F2",25018,26002,18966,7036,12683,2,5959,5978,4193,1785,2.349019608,2944,2687,1689,1026,1,1025,1,378,0,0.028292683,empty,mBC-0716-2
"H9,F3",18298,18323,13699,4624,9013,0,4283,4289,3036,1253,2.422984836,2029,20935,6439,3895,6,3889,1,963,0,0.078169195,empty,mBC-0716-2
"H9,F4",16994,17243,12940,4303,8469,5,3855,3866,2726,1140,2.39122807,1856,1446,496,266,0,266,0,137,0,0.003759398,empty,mBC-0716-2
"H9,F5",27042,27663,20441,7222,13373,0,6186,6201,4308,1893,2.275752773,3023,1702,1012,622,0,622,0,260,0,0.012861736,empty,mBC-0716-2
"H9,F6",24806,25947,18574,7373,12545,0,5894,5909,4130,1779,2.321528949,2928,2070,1275,756,2,754,1,264,0,0.051724138,empty,mBC-0716-2
"H9,F7",23097,23682,17564,6118,11452,19,5162,5192,3734,1458,2.561042524,2438,645,360,238,0,238,0,118,0,0.084033613,empty,mBC-0716-2
"H9,F8",24674,25042,18722,6320,12204,0,5568,5589,3978,1611,2.469273743,2674,2023,672,416,0,416,0,182,0,0.0625,empty,mBC-0716-2
"H9,F9",15889,16026,12075,3951,7908,26,3543,3578,2504,1074,2.331471136,1664,1383,866,479,1,478,1,175,0,0.043933054,empty,mBC-0716-2
"H9,F10",22269,22560,17180,5380,10805,19,4664,4700,3285,1415,2.32155477,2102,2009,905,586,1,585,1,218,0,0.07008547,empty,mBC-0716-2
"H9,F11",12083,12482,9155,3327,6125,0,2795,2805,1947,858,2.269230769,1334,888,533,311,0,311,0,143,0,0.028938907,empty,mBC-0716-2
"H9,F12",15316,15768,11600,4168,7618,0,3530,3535,2468,1067,2.313027179,1718,178,116,82,0,82,0,60,0,0,empty,mBC-0716-2
"H9,G1",11457,11863,8882,2981,5848,0,2641,2647,1843,804,2.292288557,1258,1657,1079,612,0,612,0,191,0,0.024509804,empty,mBC-0716-2
"H9,G2",23322,23617,17626,5991,11611,12,5187,5205,3673,1532,2.397519582,2547,1047,550,352,1,351,1,161,0,0.088319088,empty,mBC-0716-2
"H9,G3",21531,21981,16220,5761,10630,2,4849,4867,3354,1513,2.216787839,2300,1782,967,577,1,576,1,255,0,0.043402778,empty,mBC-0716-2
"H9,G4",31141,31267,23842,7425,15123,8,6673,6691,4712,1979,2.381000505,3130,159,112,84,0,84,0,58,0,0,empty,mBC-0716-2
"H9,G5",14998,15261,11329,3932,7319,29,3229,3277,2231,1046,2.132887189,1514,1070,606,368,0,368,0,173,0,0.04076087,empty,mBC-0716-2
"H9,G6",1142675,1229431,836109,393322,584349,18,306725,307228,247873,59355,4.176109848,161348,6916,4476,2524,0,2524,0,615,0,0,mm10,mBC-0716-2
"H9,G7",991913,1054682,735736,318946,506652,2,254970,255416,213352,42064,5.072080639,130820,118320,76142,43654,15,43639,3,3722,0,0.000939527,mm10,mBC-0716-2
"H9,G8",15625,16081,11878,4203,7779,0,3577,3585,2451,1134,2.161375661,1706,1959,984,608,2,606,2,248,0,0.041254125,empty,mBC-0716-2
"H9,G9",11637,11726,8909,2817,5802,0,2717,2717,1892,825,2.293333333,1251,1177,739,435,1,434,1,215,0,0.050691244,empty,mBC-0716-2
"H9,G10",14961,14994,11314,3680,7270,22,3207,3233,2289,944,2.424788136,1468,1438,929,542,0,542,0,207,0,0.018450185,empty,mBC-0716-2
"H9,G11",612140,643332,450372,192960,317342,9,164516,164783,125803,38980,3.227373012,84530,10661,5935,3359,0,3359,0,776,0,0.077106282,mm10,mBC-0716-2
"H9,G12",12198,12852,9262,3590,6248,0,2860,2863,1984,879,2.257110353,1388,984,512,304,0,304,0,144,0,0.082236842,empty,mBC-0716-2
"H9,H1",22650,23095,17343,5752,11368,7,5249,5274,3718,1556,2.389460154,2481,745,460,285,0,285,0,135,0,0.01754386,empty,mBC-0716-2
"H9,H2",1011067,1108554,699580,408974,537574,2,320127,320593,245314,75279,3.258730855,180242,6322,4022,2294,2,2292,1,746,0,0.008289703,mm10,mBC-0716-2
"H9,H3",21988,22738,16535,6203,10937,8,5107,5125,3639,1486,2.448855989,2449,1268,725,452,0,452,0,213,0,0.019911504,empty,mBC-0716-2
"H9,H4",15585,16013,11598,4415,7766,6,3622,3635,2596,1039,2.498556304,1756,443,187,118,0,118,0,69,0,0.025423729,empty,mBC-0716-2
"H9,H5",1330124,1517705,873229,644476,717456,1,468236,468859,352066,116793,3.014444359,274757,50470,32052,18460,12,18448,2,2318,0,0.001626193,mm10,mBC-0716-2
"H9,H6",15210,15672,11494,4178,7748,19,3658,3683,2632,1051,2.504281637,1794,1632,889,558,0,558,0,239,0,0.010752688,empty,mBC-0716-2
"H9,H7",18514,19162,13955,5207,9323,0,4458,4464,3195,1269,2.517730496,2169,1169,688,406,0,406,0,202,0,0.009852217,empty,mBC-0716-2
"H9,H8",15556,15681,11576,4105,7746,55,3555,3623,2483,1140,2.178070175,1770,16340,4997,3049,2,3047,1,901,0,0.027239908,empty,mBC-0716-2
"H9,H9",17830,18440,13543,4897,8820,1,4047,4060,2874,1186,2.423271501,1982,1236,777,484,0,484,0,230,0,0.033057851,empty,mBC-0716-2
"H9,H10",16521,17018,12502,4516,8192,17,3695,3717,2618,1099,2.382165605,1793,1124,689,449,0,449,0,225,0,0.037861915,empty,mBC-0716-2
"H9,H11",18077,18671,13550,5121,9022,2,4126,4139,2845,1294,2.198608964,2021,237,93,66,0,66,0,47,0,0.03030303,empty,mBC-0716-2
"H9,H12",6554,6900,4871,2029,3394,0,1594,1606,1104,502,2.199203187,799,659,386,248,0,248,0,97,0,0.036290323,empty,mBC-0716-2
"H10,A1",13587,14113,10196,3917,7089,0,3390,3406,2402,1004,2.392430279,1686,1722,843,517,1,516,1,204,0,0.085271318,empty,mBC-0716-2
"H10,A2",19561,19803,14971,4832,9463,0,4227,4230,2879,1351,2.131014064,1979,1248,778,481,0,481,0,198,0,0.051975052,empty,mBC-0716-2
"H10,A3",16214,16647,12137,4510,8059,0,3656,3659,2597,1062,2.445386064,1747,982,643,427,0,427,0,178,0,0.023419204,empty,mBC-0716-2
"H10,A4",1426097,1481876,1089425,392451,703942,1,333391,333970,281715,52255,5.391158741,162704,36809,23538,13460,8,13452,2,2024,0,0.004460303,mm10,mBC-0716-2
"H10,A5",1364826,1515655,950617,565038,736446,23,438368,439012,283374,155638,1.820725016,250439,54955,35094,19903,5,19898,1,2520,0,0.002211278,mm10,mBC-0716-2
"H10,A6",775913,793160,585625,207535,382044,1,178577,178955,121750,57205,2.128310462,87860,28594,12063,7042,7,7035,2,1528,0,0.038379531,mm10,mBC-0716-2
"H10,A7",19503,20389,14935,5454,9985,27,4663,4698,3356,1342,2.500745156,2252,1381,801,457,0,457,0,179,0,0.035010941,empty,mBC-0716-2
"H10,A8",10960,11265,8284,2981,5524,0,2528,2531,1800,731,2.462380301,1172,1461,900,551,0,551,0,241,0,0.014519056,empty,mBC-0716-2
"H10,A9",18990,19332,14721,4611,9277,3,4108,4119,2895,1224,2.365196078,1860,1248,767,438,0,438,0,205,0,0.00456621,empty,mBC-0716-2
"H10,A10",15554,15779,11903,3876,7694,4,3433,3448,2435,1013,2.403751234,1620,1338,499,329,0,329,0,148,0,0.082066869,empty,mBC-0716-2
"H10,A11",17247,17685,13078,4607,8551,1,3793,3802,2618,1184,2.211148649,1838,1211,700,435,0,435,0,179,0,0.048275862,empty,mBC-0716-2
"H10,A12",20525,21095,15695,5400,10103,9,4441,4453,3148,1305,2.412260536,2141,2405,1410,803,0,803,0,258,0,0.061021171,empty,mBC-0716-2
"H10,B1",20416,20620,15483,5137,10130,53,4428,4494,3132,1362,2.299559471,2058,1528,866,506,0,506,0,226,0,0.013833992,empty,mBC-0716-2
"H10,B2",893792,963361,642133,321228,467980,14,254235,254549,187173,67376,2.77803669,137001,15941,10302,5801,3,5798,1,1087,0,0.000689893,mm10,mBC-0716-2
"H10,B3",21727,21813,16022,5791,10465,52,4680,4736,3348,1388,2.412103746,2249,27070,8716,5425,11,5414,3,1154,0,0.109530846,empty,mBC-0716-2
"H10,B4",16774,17416,12737,4679,8359,6,3735,3744,2681,1063,2.522107244,1848,2228,930,591,0,591,0,204,0,0.187817259,empty,mBC-0716-2
"H10,B5",9303,5545,3797,1748,3520,8,1692,1715,1183,532,2.223684211,991,33157,9046,5482,7,5475,1,1162,0,0.094429224,empty,mBC-0716-2
"H10,B6",13226,13988,9987,4001,6701,0,3250,3257,2289,968,2.364669421,1600,1172,747,455,1,454,1,172,0,0.013215859,empty,mBC-0716-2
"H10,B7",17273,17575,13213,4362,8634,3,3867,3877,2700,1177,2.293967715,1823,1422,789,445,0,445,0,170,0,0.024719101,empty,mBC-0716-2
"H10,B8",14150,14383,10839,3544,6982,0,3218,3223,2268,955,2.37486911,1449,1277,787,477,0,477,0,203,0,0.062893082,empty,mBC-0716-2
"H10,B9",709479,751023,520443,230580,363242,1,190424,190718,140735,49983,2.815657323,100527,4448,2654,1487,3,1484,1,425,0,0.01819407,mm10,mBC-0716-2
"H10,B10",16924,16782,12394,4388,8594,0,3908,3932,2666,1266,2.105845182,1933,535,263,172,0,172,0,92,0,0.005813953,empty,mBC-0716-2
"H10,B11",16270,16831,12531,4300,7992,0,3615,3617,2500,1117,2.238137869,1723,198,128,92,0,92,0,65,0,0,empty,mBC-0716-2
"H10,B12",18390,18934,13842,5092,9345,0,4336,4346,3015,1331,2.265214125,2134,1731,859,485,1,484,1,170,0,0.07231405,empty,mBC-0716-2
"H10,C1",23697,24288,18490,5798,11350,0,4859,4867,3439,1428,2.408263305,2214,719,461,280,0,280,0,122,0,0.071428571,empty,mBC-0716-2
"H10,C2",18293,18840,13567,5273,9075,30,4259,4302,2987,1315,2.27148289,2109,1843,1197,667,0,667,0,216,0,0.056971514,empty,mBC-0716-2
"H10,C3",1038234,1206684,695793,510891,585775,1,376393,376933,227635,149298,1.524702273,229278,4464,2437,1336,0,1336,0,405,0,0.02245509,mm10,mBC-0716-2
"H10,C4",1182439,1258835,819320,439515,602883,1,349719,350202,266152,84050,3.166591315,188603,43939,28279,16645,8,16637,1,2272,0,0.004928773,mm10,mBC-0716-2
"H10,C5",18664,19426,14153,5273,9351,0,4380,4386,3203,1183,2.707523246,2142,1469,782,463,0,463,0,192,0,0.028077754,empty,mBC-0716-2
"H10,C6",16949,17217,12675,4542,8705,7,4007,4027,2855,1172,2.436006826,1986,1349,862,524,0,524,0,229,0,0.026717557,empty,mBC-0716-2
"H10,C7",16617,17117,12632,4485,8332,22,3916,3946,2728,1218,2.239737274,1901,465,256,157,0,157,0,91,0,0.031847134,empty,mBC-0716-2
"H10,C8",14841,15457,11169,4288,7455,0,3431,3444,2378,1066,2.230769231,1646,1338,835,506,1,505,1,201,0,0.027722772,empty,mBC-0716-2
"H10,C9",12801,13340,9626,3714,6469,0,3101,3106,2146,960,2.235416667,1544,835,558,322,0,322,0,146,0,0.046583851,empty,mBC-0716-2
"H10,C10",14048,14863,10819,4044,7007,16,3162,3188,2188,1000,2.188,1532,1074,644,389,0,389,0,168,0,0.084832905,empty,mBC-0716-2
"H10,C11",728188,779822,531158,248664,378945,1,196544,196841,166641,30200,5.517913907,103644,93030,60825,34146,14,34132,1,3225,0,0.005830306,mm10,mBC-0716-2
"H10,C12",20477,21107,15387,5720,10015,18,4639,4667,3300,1367,2.414045355,2314,981,602,356,0,356,0,151,0,0.047752809,empty,mBC-0716-2
"H10,D1",11045,11180,8189,2991,5529,9,2490,2506,1734,772,2.24611399,1173,623,367,226,0,226,0,93,0,0.146017699,empty,mBC-0716-2
"H10,D2",2069343,2311794,1416604,895190,1098971,4,682395,683317,500091,183226,2.729367011,386199,125810,83025,46699,31,46668,4,4085,0,0.000728551,mm10,mBC-0716-2
"H10,D3",595291,632213,440500,191713,311197,11,153747,154017,133497,20520,6.505701754,80202,83352,53717,29763,15,29748,1,2968,0,0.001714401,mm10,mBC-0716-2
"H10,D4",14329,14719,10984,3735,7239,15,3293,3318,2326,992,2.344758065,1560,1367,754,469,0,469,0,226,0,0.02771855,empty,mBC-0716-2
"H10,D5",13893,14367,10570,3797,7092,3,3251,3266,2286,980,2.332653061,1600,1211,771,423,1,422,1,155,0,0.08056872,empty,mBC-0716-2
"H10,D6",528051,564669,372921,191748,280861,18,155807,156031,120276,35755,3.363893162,85426,6708,4333,2396,1,2395,1,702,0,0.002922756,mm10,mBC-0716-2
"H10,D7",13212,13375,9981,3394,6639,0,3043,3047,2178,869,2.506329114,1438,1268,757,506,0,506,0,185,0,0.043478261,empty,mBC-0716-2
"H10,D8",15852,16090,11923,4167,7821,9,3597,3609,2492,1117,2.230975828,1680,3215,1205,696,2,694,1,255,0,0.097982709,empty,mBC-0716-2
"H10,D9",4650,5008,3381,1627,2475,1,1202,1207,858,349,2.458452722,633,1510,848,503,0,503,0,234,0,0.03777336,empty,mBC-0716-2
"H10,D10",14610,15136,10725,4411,7306,24,3436,3466,2437,1029,2.368318756,1730,737,476,280,0,280,0,112,0,0.089285714,empty,mBC-0716-2
"H10,D11",1517945,1663905,1066278,597627,800327,1,467851,468532,381596,86936,4.389389896,257109,142303,89721,49987,24,49963,1,4336,0,0.0010808,mm10,mBC-0716-2
"H10,D12",639429,669792,471690,198102,329690,18,170857,171101,134475,36626,3.671572107,87577,14537,8739,4962,3,4959,1,1015,0,0.01532567,mm10,mBC-0716-2
"H10,E1",21191,21801,16101,5700,10690,1,4792,4809,3326,1483,2.24275118,2360,1532,872,567,0,567,0,251,0,0.052910053,empty,mBC-0716-2
"H10,E2",16133,16526,12345,4181,8178,1,3760,3768,2618,1150,2.276521739,1763,1412,857,511,1,510,1,188,0,0.07254902,empty,mBC-0716-2
"H10,E3",12818,13054,9872,3182,6448,2,2854,2860,2008,852,2.356807512,1301,1452,883,500,0,500,0,218,0,0.024,empty,mBC-0716-2
"H10,E4",1194666,1343028,802027,541001,634537,0,397016,397540,317529,80011,3.968566822,226584,88595,54330,30259,10,30249,2,3214,0,0.005421667,mm10,mBC-0716-2
"H10,E5",23808,24455,18291,6164,11605,0,5130,5138,3620,1518,2.384716733,2342,2273,1101,699,0,699,0,303,0,0.027181688,empty,mBC-0716-2
"H10,E6",678476,713764,499912,213852,342666,5,167621,167935,145727,22208,6.561914625,86396,191648,119646,65365,35,65330,4,4727,0,0.002663401,mm10,mBC-0716-2
"H10,E7",14412,14601,11030,3571,7157,1,3211,3223,2230,993,2.24572004,1481,1244,780,447,0,447,0,184,0,0.020134228,empty,mBC-0716-2
"H10,E8",18040,18346,13752,4594,8889,21,3971,3996,2825,1171,2.412467976,1828,1739,1070,646,0,646,0,257,0,0.063467492,empty,mBC-0716-2
"H10,E9",8888,9256,6619,2637,4474,16,2055,2073,1443,630,2.29047619,1017,2072,956,591,0,591,0,193,0,0.052453469,empty,mBC-0716-2
"H10,E10",13361,13799,10173,3626,6697,1,3108,3117,2125,992,2.142137097,1476,1289,774,474,0,474,0,199,0,0.033755274,empty,mBC-0716-2
"H10,E11",9150,9362,6962,2400,4546,1,2020,2027,1375,652,2.108895706,957,1050,641,409,0,409,0,160,0,0.036674817,empty,mBC-0716-2
"H10,E12",14405,15021,10964,4057,7448,0,3461,3471,2411,1060,2.274528302,1701,1034,607,371,0,371,0,161,0,0.04851752,empty,mBC-0716-2
"H10,F1",19229,19555,14782,4773,9645,0,4342,4351,3049,1302,2.341781874,2039,1561,906,537,0,537,0,231,0,0.03538175,empty,mBC-0716-2
"H10,F2",23972,24872,17993,6879,12016,0,5611,5617,3854,1763,2.186046512,2728,2766,1693,1016,0,1016,0,371,0,0.032480315,empty,mBC-0716-2
"H10,F3",847012,879314,647958,231356,427119,13,208564,208937,164601,44336,3.712581198,103824,73738,48129,27222,14,27208,1,2834,0,0.003454866,mm10,mBC-0716-2
"H10,F4",15800,15815,11790,4025,7819,1,3506,3515,2427,1088,2.230698529,1659,620,352,211,0,211,0,95,0,0,empty,mBC-0716-2
"H10,F5",25041,25661,18942,6719,12292,1,5674,5686,3984,1702,2.340775558,2672,6000,2375,1525,1,1524,1,519,0,0.024934383,empty,mBC-0716-2
"H10,F6",22923,23377,17442,5935,11237,4,5077,5089,3539,1550,2.283225806,2421,2103,1283,769,0,769,0,262,0,0.075422627,empty,mBC-0716-2
"H10,F7",20402,20979,15706,5273,10327,0,4707,4714,3374,1340,2.517910448,2196,709,417,241,1,240,1,117,0,0.033333333,empty,mBC-0716-2
"H10,F8",22736,23311,17305,6006,11370,8,5153,5174,3686,1488,2.477150538,2453,453,249,163,0,163,0,93,0,0.061349693,empty,mBC-0716-2
"H10,F9",14944,15105,11514,3591,7326,0,3240,3251,2256,995,2.267336683,1451,1591,942,622,0,622,0,203,0,0.056270096,empty,mBC-0716-2
"H10,F10",21729,21824,16750,5074,10704,0,4631,4643,3356,1287,2.607614608,2146,6684,2328,1417,0,1417,0,434,0,0.022582922,empty,mBC-0716-2
"H10,F11",753514,782353,560368,221985,379535,0,187259,187580,152331,35249,4.321569406,94298,25151,14404,8285,4,8281,1,1545,0,0.006883227,mm10,mBC-0716-2
"H10,F12",1520390,1635953,1128932,507021,766541,3,390019,390677,316745,73932,4.284274739,203475,16679,9504,5315,5,5310,3,1028,0,0.003578154,mm10,mBC-0716-2
"H10,G1",10641,10827,8124,2703,5267,5,2399,2410,1643,767,2.142112125,1121,1567,886,531,0,531,0,200,0,0.039548023,empty,mBC-0716-2
"H10,G2",990764,1071130,715879,355251,514842,15,274718,275131,227634,47497,4.792597427,147198,30573,20122,11363,3,11360,1,1688,0,0.001760563,mm10,mBC-0716-2
"H10,G3",20429,20642,15398,5244,9921,4,4521,4530,3163,1367,2.313825896,2115,2106,1348,805,0,805,0,282,0,0.022360248,empty,mBC-0716-2
"H10,G4",29400,30031,22275,7756,14801,4,6630,6641,4637,2004,2.313872255,3172,172,102,79,0,79,0,57,0,0.088607595,empty,mBC-0716-2
"H10,G5",13215,13606,10066,3540,6583,0,3016,3022,2102,920,2.284782609,1426,1422,856,502,0,502,0,195,0,0.089641434,empty,mBC-0716-2
"H10,G6",24890,25031,19212,5819,11967,1,5227,5239,3640,1599,2.276422764,2385,771,276,174,1,173,1,93,0,0.040462428,empty,mBC-0716-2
"H10,G7",22235,21951,16404,5547,10578,0,4762,4768,3423,1345,2.544981413,2220,29364,8072,4824,5,4819,2,1121,0,0.112056443,empty,mBC-0716-2
"H10,G8",14845,15362,11239,4123,7514,1,3515,3526,2462,1064,2.313909774,1682,1480,918,549,1,548,1,225,0,0.018248175,empty,mBC-0716-2
"H10,G9",10960,11417,8366,3051,5538,9,2526,2543,1764,779,2.264441592,1195,4689,1813,1080,0,1080,0,390,0,0.019444444,empty,mBC-0716-2
"H10,G10",14169,14503,10823,3680,7044,7,3145,3160,2127,1033,2.059051307,1543,1345,819,520,0,520,0,225,0,0.034615385,empty,mBC-0716-2
"H10,G11",12178,12508,9251,3257,6151,0,2788,2793,1984,809,2.452410383,1348,668,401,261,0,261,0,108,0,0.011494253,empty,mBC-0716-2
"H10,G12",11666,12286,8875,3411,6119,0,2916,2919,2006,913,2.197152245,1453,1078,715,401,1,400,1,140,0,0.1025,empty,mBC-0716-2
"H10,H1",21277,22361,16230,6131,10821,4,4976,4986,3480,1506,2.310756972,2431,814,468,281,0,281,0,146,0,0.035587189,empty,mBC-0716-2
"H10,H2",25859,26298,19683,6615,12676,1,5781,5793,3978,1815,2.191735537,2753,2040,1274,789,0,789,0,302,0,0.007604563,empty,mBC-0716-2
"H10,H3",20650,21108,15447,5661,10235,10,4769,4790,3331,1459,2.283070596,2340,8778,2923,1774,1,1773,1,533,0,0.093062606,empty,mBC-0716-2
"H10,H4",13685,13814,10313,3501,6772,0,3169,3173,2257,916,2.463973799,1483,416,177,128,0,128,0,84,0,0,empty,mBC-0716-2
"H10,H5",18144,18683,13582,5101,9055,14,4217,4237,2873,1364,2.106304985,2057,1483,969,570,0,570,0,214,0,0.015789474,empty,mBC-0716-2
"H10,H6",14830,15186,11085,4101,7463,1,3401,3412,2419,993,2.436052367,1634,1477,860,530,1,529,1,209,0,0.034026465,empty,mBC-0716-2
"H10,H7",16864,17098,12854,4244,8345,29,3697,3730,2634,1096,2.403284672,1730,1482,873,541,0,541,0,223,0,0.012939002,empty,mBC-0716-2
"H10,H8",14464,15017,10805,4212,7259,1,3382,3393,2353,1040,2.2625,1713,1465,832,514,0,514,0,248,0,0.029182879,empty,mBC-0716-2
"H10,H9",16847,17158,12628,4530,8425,0,3889,3895,2771,1124,2.465302491,1865,1361,784,492,0,492,0,238,0,0.006097561,empty,mBC-0716-2
"H10,H10",14317,14486,10656,3830,7050,0,3254,3259,2290,969,2.363261094,1512,1647,890,557,0,557,0,246,0,0.030520646,empty,mBC-0716-2
"H10,H11",490119,514559,350746,163813,255823,2,136352,136545,108958,27587,3.949613949,72768,305,163,115,0,115,0,67,0,0,empty,mBC-0716-2
"H10,H12",6088,6342,4683,1659,3075,9,1415,1428,1027,401,2.561097257,691,572,332,205,2,203,1,101,0,0.024630542,empty,mBC-0716-2
"H11,A1",1359632,1470662,979005,491657,722992,1,390118,390690,311703,78987,3.946256979,209235,129205,83688,45939,16,45923,1,4073,0,0.001001677,mm10,mBC-0716-2
"H11,A2",19401,19678,14887,4791,9666,34,4262,4298,3089,1209,2.555004136,2014,1063,641,398,0,398,0,187,0,0.057788945,empty,mBC-0716-2
"H11,A3",16932,17450,12848,4602,8557,15,3956,3980,2798,1182,2.367174281,1930,953,543,339,0,339,0,147,0,0.056047198,empty,mBC-0716-2
"H11,A4",1974953,2117031,1452464,664567,994938,14,533345,534190,444651,89539,4.966003641,277410,49329,29185,16427,9,16418,1,2335,0,0.00146181,mm10,mBC-0716-2
"H11,A5",17249,17702,13190,4512,8865,0,4014,4027,2765,1262,2.190966719,1890,1614,992,610,0,610,0,270,0,0.009836066,empty,mBC-0716-2
"H11,A6",17592,18308,13054,5254,9408,2,4580,4590,3374,1216,2.774671053,2297,1440,856,506,0,506,0,246,0,0.049407115,empty,mBC-0716-2
"H11,A7",15755,16064,11891,4173,8009,0,3688,3705,2551,1154,2.210571924,1802,9234,2740,1660,2,1658,2,465,0,0.124849216,empty,mBC-0716-2
"H11,A8",257994,266571,193061,73510,136568,0,65421,65559,48801,16758,2.912101683,33028,15357,9220,5205,2,5203,1,1064,0,0.005573707,mm10,mBC-0716-2
"H11,A9",19634,19925,14985,4940,9698,0,4357,4369,3123,1246,2.506420546,2044,1182,688,436,0,436,0,205,0,0.020642202,empty,mBC-0716-2
"H11,A10",16324,16919,12355,4564,8308,1,3822,3835,2676,1159,2.308886972,1886,875,387,238,0,238,0,123,0,0.012605042,empty,mBC-0716-2
"H11,A11",18362,18747,13969,4778,9404,0,4198,4205,2922,1283,2.277474669,2008,1206,695,456,0,456,0,198,0,0.01754386,empty,mBC-0716-2
"H11,A12",20708,21222,15815,5407,10428,1,4633,4644,3248,1396,2.326647564,2249,2169,1255,749,0,749,0,271,0,0.032042724,empty,mBC-0716-2
"H11,B1",19773,20225,15200,5025,9847,7,4473,4487,3123,1364,2.289589443,2135,939,544,347,0,347,0,172,0,0.066282421,empty,mBC-0716-2
"H11,B2",19650,20161,14838,5323,10004,0,4604,4612,3155,1457,2.165408373,2325,700,417,251,0,251,0,101,0,0.175298805,empty,mBC-0716-2
"H11,B3",19385,20157,14811,5346,9938,20,4566,4592,3248,1344,2.416666667,2252,982,574,367,0,367,0,185,0,0.068119891,empty,mBC-0716-2
"H11,B4",1216740,1391111,815135,575976,669929,0,423260,423772,333455,90317,3.69205133,246388,83178,47633,26446,17,26429,1,3081,0,0.002345908,mm10,mBC-0716-2
"H11,B5",1739217,987258,626473,360785,636243,22,354898,357151,278488,78663,3.540266707,207881,119548,76781,42723,20,42703,1,3893,0,0.001170878,mm10,mBC-0716-2
"H11,B6",13142,13870,9746,4124,6829,3,3307,3331,2299,1032,2.227713178,1715,1225,799,460,0,460,0,190,0,0.043478261,empty,mBC-0716-2
"H11,B7",16432,17277,12605,4672,8384,34,3797,3834,2655,1179,2.251908397,1855,848,529,332,0,332,0,148,0,0.036144578,empty,mBC-0716-2
"H11,B8",1478425,1568439,1076167,492272,757855,0,402834,403496,331114,72382,4.574535105,210806,61252,39124,21724,8,21716,1,2798,0,0.001980107,mm10,mBC-0716-2
"H11,B9",941561,1082861,627481,455380,524425,35,334983,335475,241613,93862,2.574130106,196066,45595,23197,13084,9,13075,4,1989,0,0.006806883,mm10,mBC-0716-2
"H11,B10",17735,17368,12455,4913,8696,0,4166,4189,2912,1277,2.280344558,2029,12519,3921,2413,3,2410,1,695,0,0.074688797,empty,mBC-0716-2
"H11,B11",16108,16778,12139,4639,8313,0,3996,4009,2815,1194,2.357621441,2015,246,132,97,0,97,0,72,0,0,empty,mBC-0716-2
"H11,B12",18251,18511,13868,4643,9281,23,4259,4287,3051,1236,2.468446602,1996,1263,775,480,0,480,0,193,0,0.014583333,empty,mBC-0716-2
"H11,C1",22267,22666,17301,5365,10822,8,4660,4682,3371,1311,2.571319603,2130,753,508,298,0,298,0,130,0,0.134228188,empty,mBC-0716-2
"H11,C2",775853,877513,529474,348039,431260,1,258595,258938,204075,54863,3.71972003,149367,106963,68616,38611,14,38597,1,3410,0,0.000699536,mm10,mBC-0716-2
"H11,C3",784887,856632,560696,295936,420308,11,232590,232959,180753,52206,3.462303184,126493,25056,15603,8627,7,8620,3,1463,0,0.001508121,mm10,mBC-0716-2
"H11,C4",17323,17598,13259,4339,8686,0,3860,3871,2660,1211,2.196531792,1796,1061,658,403,0,403,0,183,0,0.009925558,empty,mBC-0716-2
"H11,C5",16679,16900,12486,4414,8458,1,4000,4009,2724,1285,2.119844358,1904,1269,784,466,1,465,1,207,0,0.075268817,empty,mBC-0716-2
"H11,C6",17233,17674,12764,4910,8954,19,4154,4182,2985,1197,2.493734336,2093,10160,3348,2022,0,2022,0,569,0,0.108803165,empty,mBC-0716-2
"H11,C7",15873,16333,12008,4325,8165,0,3767,3769,2589,1180,2.194067797,1826,346,207,148,0,148,0,99,0,0.074324324,empty,mBC-0716-2
"H11,C8",15551,15843,11830,4013,7805,0,3526,3535,2403,1132,2.122791519,1659,1398,831,488,0,488,0,219,0,0.028688525,empty,mBC-0716-2
"H11,C9",13858,14318,10361,3957,7045,2,3284,3300,2271,1029,2.206997085,1585,1014,612,388,0,388,0,161,0,0.051546392,empty,mBC-0716-2
"H11,C10",14098,14776,10831,3945,7284,0,3388,3404,2349,1055,2.226540284,1621,816,446,280,0,280,0,142,0,0.042857143,empty,mBC-0716-2
"H11,C11",11860,12473,9114,3359,6107,10,2891,2907,2040,867,2.352941176,1408,4009,1378,832,0,832,0,299,0,0.0625,empty,mBC-0716-2
"H11,C12",20238,20821,15093,5728,10309,0,4860,4867,3423,1444,2.370498615,2443,1638,744,430,0,430,0,161,0,0.055813953,empty,mBC-0716-2
"H11,D1",12341,12803,9316,3487,6415,11,3048,3069,2168,901,2.406215316,1517,665,373,230,0,230,0,106,0,0.02173913,empty,mBC-0716-2
"H11,D2",664536,680996,500614,180382,337571,3,162689,163004,117536,45468,2.585026832,79997,31710,14022,8170,7,8163,2,1651,0,0.043121401,mm10,mBC-0716-2
"H11,D3",13553,14388,10088,4300,7252,0,3466,3474,2426,1048,2.314885496,1725,1144,692,421,1,420,1,210,0,0.064285714,empty,mBC-0716-2
"H11,D4",14858,15324,11464,3860,7601,0,3414,3424,2437,987,2.469098278,1601,1329,808,494,1,493,1,246,0,0.014198783,empty,mBC-0716-2
"H11,D5",14976,15811,11273,4538,7782,0,3637,3645,2589,1056,2.451704545,1840,2917,1181,712,2,710,1,256,0,0.077464789,empty,mBC-0716-2
"H11,D6",13142,13786,9895,3891,6756,2,3266,3271,2313,958,2.41440501,1589,2777,1143,721,1,720,1,286,0,0.119444444,empty,mBC-0716-2
"H11,D7",21029,22120,15388,6732,10877,0,5452,5464,3900,1564,2.493606138,2853,1595,1009,593,0,593,0,226,0,0.02698145,empty,mBC-0716-2
"H11,D8",16431,17164,12345,4819,8466,0,4049,4054,2779,1275,2.179607843,1987,908,575,355,0,355,0,164,0,0.076056338,empty,mBC-0716-2
"H11,D9",5739,5892,4197,1695,3065,14,1468,1482,1033,449,2.300668151,734,1978,1096,700,0,700,0,310,0,0.02,empty,mBC-0716-2
"H11,D10",13155,13756,10067,3689,6763,4,3099,3110,2218,892,2.486547085,1472,587,317,214,0,214,0,116,0,0.060747664,empty,mBC-0716-2
"H11,D11",13372,13516,10234,3282,6773,1,3074,3077,2107,970,2.172164948,1434,3117,1336,830,0,830,0,327,0,0.043373494,empty,mBC-0716-2
"H11,D12",20016,20775,15069,5706,10041,10,4671,4686,3299,1387,2.37851478,2297,1983,1208,728,1,727,1,252,0,0.078404402,empty,mBC-0716-2
"H11,E1",21868,21966,16675,5291,10759,1,4740,4748,3301,1447,2.281271596,2179,1492,895,520,0,520,0,232,0,0.044230769,empty,mBC-0716-2
"H11,E2",852605,912938,599005,313933,445944,1,254534,254923,212193,42730,4.965902176,136189,87890,53541,29923,14,29909,2,3244,0,0.002206694,mm10,mBC-0716-2
"H11,E3",11829,12305,8968,3337,6038,3,2725,2733,1902,831,2.288808664,1310,1567,909,566,0,566,0,256,0,0.024734982,empty,mBC-0716-2
"H11,E4",15676,16236,11961,4275,7874,0,3603,3615,2534,1081,2.344125809,1760,1138,734,475,0,475,0,210,0,0.050526316,empty,mBC-0716-2
"H11,E5",687529,684014,518651,165363,335785,0,151079,151385,118819,32566,3.648559848,71899,17750,7217,4057,3,4054,1,1058,0,0.024420326,mm10,mBC-0716-2
"H11,E6",14510,14592,10845,3747,7186,3,3196,3212,2292,920,2.491304348,1555,2335,1059,657,0,657,0,289,0,0.03500761,empty,mBC-0716-2
"H11,E7",13803,14045,10332,3713,7026,0,3251,3255,2289,966,2.369565217,1633,1158,677,430,0,430,0,196,0,0.046511628,empty,mBC-0716-2
"H11,E8",2407517,2621526,1732696,888830,1252394,10,712476,713559,596270,117289,5.083767446,382078,254055,168292,93676,35,93641,4,5746,0,0.001730011,mm10,mBC-0716-2
"H11,E9",9484,9806,7074,2732,4812,0,2198,2206,1516,690,2.197101449,1116,2588,1108,660,0,660,0,237,0,0.093939394,empty,mBC-0716-2
"H11,E10",12899,13509,9678,3831,6760,0,3141,3150,2159,991,2.178607467,1603,1200,742,453,0,453,0,189,0,0.022075055,empty,mBC-0716-2
"H11,E11",1256491,1390145,878810,511335,686879,8,403918,404489,315662,88827,3.553671744,225172,121206,77795,43648,22,43626,3,4024,0,0.000825196,mm10,mBC-0716-2
"H11,E12",618856,625255,454445,170810,313009,18,152771,153041,124897,28144,4.437784252,75858,7787,4289,2348,0,2348,0,725,0,0.011499148,mm10,mBC-0716-2
"H11,F1",18565,18880,13997,4883,9345,18,4198,4234,2965,1269,2.336485422,1991,4778,1789,1125,1,1124,1,408,0,0.075622776,empty,mBC-0716-2
"H11,F2",25059,25929,19033,6896,12648,0,5874,5881,4051,1830,2.213661202,2821,3820,1912,1179,0,1179,0,484,0,0.022052587,empty,mBC-0716-2
"H11,F3",16658,17067,12575,4492,8720,0,4129,4142,2897,1245,2.326907631,2014,1861,1077,659,0,659,0,303,0,0.018209408,empty,mBC-0716-2
"H11,F4",16533,16857,12240,4617,8399,0,3838,3857,2690,1167,2.305055698,1914,484,305,185,0,185,0,87,0,0.07027027,empty,mBC-0716-2
"H11,F5",25884,26747,19472,7275,13070,14,6025,6059,4328,1731,2.50028885,3003,1881,1121,720,0,720,0,309,0,0.033333333,empty,mBC-0716-2
"H11,F6",24219,24830,18295,6535,12136,1,5604,5614,3919,1695,2.312094395,2736,1830,1092,659,1,658,1,275,0,0.072948328,empty,mBC-0716-2
"H11,F7",899164,990975,632528,358447,487952,0,284756,285151,213832,71319,2.998247311,157103,23381,14366,7947,5,7942,1,1381,0,0.002770083,mm10,mBC-0716-2
"H11,F8",1847817,1983976,1350112,633864,945928,22,503490,504424,410712,93712,4.382704456,265209,20236,13423,7422,9,7413,2,1326,0,0.000539593,mm10,mBC-0716-2
"H11,F9",14665,14987,11065,3922,7554,0,3477,3491,2423,1068,2.268726592,1691,6989,2600,1621,0,1621,0,466,0,0.090684762,empty,mBC-0716-2
"H11,F10",20451,20627,15814,4813,10227,8,4425,4442,3143,1299,2.419553503,2006,1332,826,481,0,481,0,198,0,0.074844075,empty,mBC-0716-2
"H11,F11",10922,11306,8379,2927,5645,7,2546,2557,1787,770,2.320779221,1208,893,540,322,1,321,1,169,0,0.074766355,empty,mBC-0716-2
"H11,F12",14025,14830,10691,4139,7149,6,3342,3352,2423,929,2.60818084,1645,175,99,69,0,69,0,47,0,0,empty,mBC-0716-2
"H11,G1",571326,616770,410607,206163,306919,3,171549,171817,121207,50610,2.394921952,92166,14059,8490,4762,1,4761,1,1018,0,0.005881117,mm10,mBC-0716-2
"H11,G2",978836,1083485,687390,396095,529047,3,303175,303591,214894,88697,2.422787693,170970,12298,7860,4359,1,4358,1,916,0,0.000458926,mm10,mBC-0716-2
"H11,G3",20218,20738,15000,5738,10166,0,4649,4652,3230,1422,2.271448664,2262,14322,4489,2714,3,2711,1,755,0,0.041682036,empty,mBC-0716-2
"H11,G4",30707,32329,23669,8660,15766,1,7248,7268,5091,2177,2.338539274,3621,161,104,82,0,82,0,56,0,0.012195122,empty,mBC-0716-2
"H11,G5",13621,13909,10370,3539,6895,1,3127,3130,2160,970,2.226804124,1487,1279,765,499,0,499,0,237,0,0.03006012,empty,mBC-0716-2
"H11,G6",24283,24635,18647,5988,12011,0,5264,5276,3718,1558,2.386392811,2428,233,152,90,0,90,0,57,0,0.011111111,empty,mBC-0716-2
"H11,G7",20298,21237,15430,5807,10385,25,4678,4716,3321,1395,2.380645161,2302,1558,943,531,0,531,0,226,0,0.048964218,empty,mBC-0716-2
"H11,G8",15191,15671,11469,4202,7630,0,3565,3574,2492,1082,2.303142329,1700,1281,770,487,0,487,0,225,0,0.04312115,empty,mBC-0716-2
"H11,G9",10592,10848,7987,2861,5393,0,2525,2531,1836,695,2.641726619,1165,1102,673,436,0,436,0,212,0,0.025229358,empty,mBC-0716-2
"H11,G10",14285,14709,10907,3802,7209,27,3331,3368,2293,1075,2.133023256,1630,1361,821,509,1,508,1,240,0,0.013779528,empty,mBC-0716-2
"H11,G11",12140,12627,9177,3450,6269,3,2941,2946,2086,860,2.425581395,1441,3269,1112,682,0,682,0,219,0,0.061583578,empty,mBC-0716-2
"H11,G12",11549,12237,8770,3467,6066,4,2876,2889,1981,908,2.181718062,1407,1187,628,342,0,342,0,156,0,0.052631579,empty,mBC-0716-2
"H11,H1",21789,22608,16528,6080,10950,0,5016,5030,3536,1494,2.366800535,2421,1227,690,385,0,385,0,165,0,0.044155844,empty,mBC-0716-2
"H11,H2",1137519,1260379,799935,460444,606286,0,345658,346178,295013,51165,5.765914199,191143,166487,109192,60483,26,60457,1,4469,0,0.000827034,mm10,mBC-0716-2
"H11,H3",20942,21797,15964,5833,10625,0,4915,4923,3528,1395,2.529032258,2337,1372,796,530,0,530,0,245,0,0.018867925,empty,mBC-0716-2
"H11,H4",14482,15029,10934,4095,7426,4,3520,3528,2496,1032,2.418604651,1707,368,151,99,0,99,0,76,0,0,empty,mBC-0716-2
"H11,H5",18335,18708,13618,5090,9071,1,4209,4226,2990,1236,2.419093851,2121,10939,3481,2083,2,2081,2,592,0,0.061028352,empty,mBC-0716-2
"H11,H6",14543,14944,10846,4098,7532,4,3522,3531,2518,1013,2.485686081,1702,3076,1343,812,0,812,0,300,0,0.068965517,empty,mBC-0716-2
"H11,H7",17272,17617,12971,4646,8728,32,4009,4050,2845,1205,2.360995851,1933,1555,938,547,1,546,1,239,0,0.036630037,empty,mBC-0716-2
"H11,H8",13953,14638,10405,4233,7226,13,3431,3456,2445,1011,2.418397626,1741,2569,1280,837,0,837,0,334,0,0.03823178,empty,mBC-0716-2
"H11,H9",17117,17395,12826,4569,8695,0,3938,3942,2855,1087,2.62649494,1896,7449,2397,1476,1,1475,1,488,0,0.074576271,empty,mBC-0716-2
"H11,H10",15298,16031,11570,4461,7879,0,3678,3691,2584,1107,2.334236676,1831,1548,876,570,0,570,0,263,0,0.070175439,empty,mBC-0716-2
"H11,H11",16841,17505,12710,4795,8749,1,4171,4179,2921,1258,2.321939587,2108,278,150,101,0,101,0,80,0,0,empty,mBC-0716-2
"H11,H12",6501,6802,4929,1873,3353,31,1600,1631,1152,479,2.405010438,816,530,349,216,0,216,0,101,0,0.00462963,empty,mBC-0716-2
"H12,A1",8756,8858,6603,2255,5319,0,2483,2488,1761,727,2.422283356,1192,6723,2149,1288,2,1286,2,391,0,0.073094868,empty,mBC-0716-2
"H12,A2",401067,411955,298310,113645,234286,0,114132,114293,90038,24255,3.712141826,56927,5533,3628,2037,0,2037,0,578,0,0.008836524,mm10,mBC-0716-2
"H12,A3",563900,625913,400971,224942,350367,0,196979,197228,155310,41918,3.705090892,109405,36857,22409,12473,2,12471,1,1906,0,0.000962232,mm10,mBC-0716-2
"H12,A4",14195,14750,10952,3798,8590,7,3882,3899,2727,1172,2.326791809,1837,1348,483,318,2,316,1,147,0,0.018987342,empty,mBC-0716-2
"H12,A5",11425,11736,8720,3016,6834,0,3143,3154,2196,958,2.292275574,1477,1869,977,619,0,619,0,261,0,0.022617124,empty,mBC-0716-2
"H12,A6",490322,566017,335085,230932,326334,9,196366,196560,159508,37052,4.304976789,113910,126553,72465,40375,15,40360,1,3863,0,0.004608523,mm10,mBC-0716-2
"H12,A7",10290,10592,7781,2811,6289,3,2903,2908,1976,932,2.120171674,1414,928,562,346,0,346,0,155,0,0.040462428,empty,mBC-0716-2
"H12,A8",7000,7203,5334,1869,4309,0,2006,2008,1375,633,2.172195893,970,1022,580,378,0,378,0,195,0,0.005291005,empty,mBC-0716-2
"H12,A9",11803,12030,9111,2919,7067,12,3066,3094,2156,938,2.298507463,1482,6853,2189,1323,2,1321,1,444,0,0.025738077,empty,mBC-0716-2
"H12,A10",10076,10225,7587,2638,6016,22,2751,2777,1941,836,2.321770335,1341,351,221,140,0,140,0,72,0,0.014285714,empty,mBC-0716-2
"H12,A11",516375,548832,377973,170859,318615,26,161192,161515,130726,30789,4.24586703,85032,58306,37587,20962,5,20957,1,2421,0,0.000668035,mm10,mBC-0716-2
"H12,A12",14712,15297,11365,3932,8449,30,3832,3868,2824,1044,2.704980843,1862,6257,2412,1398,2,1396,1,413,0,0.040830946,empty,mBC-0716-2
"H12,B1",1258192,1396338,883412,512926,796516,0,463770,464311,393373,70938,5.54530717,257761,117631,74879,42431,15,42416,3,3770,0,0.001650321,mm10,mBC-0716-2
"H12,B2",13467,13912,10223,3689,7996,0,3628,3641,2534,1107,2.289069557,1735,370,210,129,0,129,0,74,0,0.023255814,empty,mBC-0716-2
"H12,B3",12527,13014,9644,3370,7637,0,3518,3527,2491,1036,2.404440154,1705,951,551,370,0,370,0,169,0,0.062162162,empty,mBC-0716-2
"H12,B4",11226,11804,8500,3304,6828,0,3100,3100,2142,958,2.235908142,1537,1002,579,341,2,339,1,151,0,0.07079646,empty,mBC-0716-2
"H12,B5",439336,272197,155163,117034,197374,4,125721,126360,96670,29690,3.255978444,77959,5428,2652,1527,2,1525,1,482,0,0.011147541,mm10,mBC-0716-2
"H12,B6",425126,460973,303832,157141,273666,2,152406,152596,112976,39620,2.851489147,83508,14545,8051,4651,0,4651,0,1054,0,0.009030316,mm10,mBC-0716-2
"H12,B7",660768,764201,444931,319270,430479,8,274885,275248,231788,43460,5.333364013,161150,53931,32011,18100,10,18090,2,2260,0,0.016970702,mm10,mBC-0716-2
"H12,B8",9027,9216,6829,2387,5528,52,2493,2548,1794,754,2.379310345,1231,4404,1618,971,1,970,1,372,0,0.022680412,empty,mBC-0716-2
"H12,B9",10066,10293,7714,2579,5925,0,2691,2691,1896,795,2.38490566,1282,1762,645,396,0,396,0,186,0,0.017676768,empty,mBC-0716-2
"H12,B10",400639,424901,272127,152774,247983,2,137482,137800,114214,23586,4.84244891,76622,1463,737,425,0,425,0,224,0,0.025882353,empty,mBC-0716-2
"H12,B11",10382,10619,7879,2740,6125,0,2738,2745,1922,823,2.335358445,1341,272,165,101,0,101,0,65,0,0.00990099,empty,mBC-0716-2
"H12,B12",11503,11876,8914,2962,7098,1,3278,3285,2301,984,2.338414634,1547,1192,712,404,0,404,0,166,0,0.024752475,empty,mBC-0716-2
"H12,C1",15668,15674,12144,3530,8923,44,3833,3886,2738,1148,2.385017422,1787,529,345,208,0,208,0,92,0,0.067307692,empty,mBC-0716-2
"H12,C2",11888,12217,8873,3344,7067,0,3267,3273,2306,967,2.384694933,1570,1350,807,476,0,476,0,179,0,0.023109244,empty,mBC-0716-2
"H12,C3",13192,13663,10101,3562,7893,3,3725,3737,2571,1166,2.204974271,1779,459,236,141,0,141,0,78,0,0,empty,mBC-0716-2
"H12,C4",11536,11852,8892,2960,6869,25,3077,3106,2170,936,2.318376068,1461,703,428,274,0,274,0,123,0,0.025547445,empty,mBC-0716-2
"H12,C5",15342,16199,11288,4911,9158,0,4612,4617,3299,1318,2.503034901,2391,3020,1087,667,8,659,2,263,0,0.039453718,empty,mBC-0716-2
"H12,C6",641123,704558,438123,266435,420951,17,246151,246514,203473,43041,4.72742269,138389,67210,44223,25124,9,25115,1,2773,0,0.000836154,mm10,mBC-0716-2
"H12,C7",10933,11525,8299,3226,6563,0,3111,3114,2144,970,2.210309278,1466,374,238,144,0,144,0,89,0,0,empty,mBC-0716-2
"H12,C8",490968,517766,361678,156088,304944,22,157421,157624,117404,40220,2.919045251,81534,10433,6486,3680,2,3678,1,845,0,0.008428494,mm10,mBC-0716-2
"H12,C9",8447,8778,6334,2444,5162,0,2495,2503,1806,697,2.591104735,1247,718,449,284,0,284,0,132,0,0.052816901,empty,mBC-0716-2
"H12,C10",9028,9276,6757,2519,5485,0,2603,2608,1844,764,2.413612565,1233,5468,1849,1071,0,1071,0,350,0,0.080298786,empty,mBC-0716-2
"H12,C11",8125,8547,6089,2458,4899,30,2344,2380,1668,712,2.342696629,1193,813,518,291,0,291,0,127,0,0.037800687,empty,mBC-0716-2
"H12,C12",12959,13159,9900,3259,7696,19,3500,3530,2538,992,2.558467742,1660,927,542,326,0,326,0,125,0,0.104294479,empty,mBC-0716-2
"H12,D1",7198,7410,5268,2142,4466,1,2136,2142,1509,633,2.383886256,1082,507,244,162,1,161,1,95,0,0.037267081,empty,mBC-0716-2
"H12,D2",471583,500706,355774,144932,295530,9,143988,144223,109822,34401,3.192407197,73303,18257,9825,5368,2,5366,1,1314,0,0.01546776,mm10,mBC-0716-2
"H12,D3",8981,9146,6704,2442,5354,0,2464,2470,1734,736,2.355978261,1187,1223,704,425,0,425,0,195,0,0.063529412,empty,mBC-0716-2
"H12,D4",1126346,1218865,813309,405556,701341,1,377538,378042,310702,67340,4.613929314,202635,83819,54197,30606,15,30591,3,3140,0,0.001830604,mm10,mBC-0716-2
"H12,D5",8487,8746,6532,2214,5157,3,2416,2422,1718,704,2.440340909,1150,734,402,276,0,276,0,139,0,0.010869565,empty,mBC-0716-2
"H12,D6",8031,8232,5988,2244,4825,2,2218,2220,1522,698,2.180515759,1065,1149,610,404,0,404,0,184,0,0.042079208,empty,mBC-0716-2
"H12,D7",8299,8448,6196,2252,4963,30,2276,2317,1619,698,2.319484241,1137,1000,564,367,1,366,1,170,0,0.049180328,empty,mBC-0716-2
"H12,D8",10021,10434,7635,2799,6218,0,2947,2952,2004,948,2.113924051,1426,792,526,321,0,321,0,160,0,0.049844237,empty,mBC-0716-2
"H12,D9",2906,2958,2228,730,1752,0,828,828,581,247,2.352226721,388,1326,787,515,0,515,0,255,0,0.036893204,empty,mBC-0716-2
"H12,D10",9290,9490,7020,2470,5682,0,2716,2721,1929,792,2.435606061,1301,1170,465,267,0,267,0,113,0,0.059925094,empty,mBC-0716-2
"H12,D11",8835,9014,6810,2204,5369,19,2443,2464,1766,698,2.53008596,1131,1304,808,504,0,504,0,231,0,0.015873016,empty,mBC-0716-2
"H12,D12",647759,673435,481204,192231,380126,38,187384,187716,146681,41035,3.574533934,95000,29344,18644,10601,5,10596,2,1812,0,0.005756889,mm10,mBC-0716-2
"H12,E1",17892,18193,13631,4562,9502,1,4278,4283,2993,1290,2.320155039,2053,1337,825,527,0,527,0,248,0,0.058823529,empty,mBC-0716-2
"H12,E2",1040933,1086190,753692,332498,624176,28,328382,328937,266068,62869,4.232101672,169656,135594,88229,48439,19,48420,2,3957,0,0.000970673,mm10,mBC-0716-2
"H12,E3",9008,9058,6818,2240,5405,0,2397,2400,1707,693,2.463203463,1154,1544,950,553,0,553,0,240,0,0.021699819,empty,mBC-0716-2
"H12,E4",10554,11102,8090,3012,6285,0,2891,2898,2010,888,2.263513514,1463,1003,540,346,0,346,0,178,0,0.046242775,empty,mBC-0716-2
"H12,E5",351476,350049,271151,78898,207832,0,89413,89591,73910,15681,4.713347363,41293,5910,3035,1768,0,1768,0,609,0,0.016968326,mm10,mBC-0716-2
"H12,E6",710888,786409,475591,310818,441707,2,271572,271922,218071,53851,4.049525543,154542,88105,54736,30464,13,30451,4,3162,0,0.001083708,mm10,mBC-0716-2
"H12,E7",428432,466874,304408,162466,272553,1,154682,154918,114508,40410,2.833655036,84708,16467,10598,6020,0,6020,0,1162,0,0.006478405,mm10,mBC-0716-2
"H12,E8",11497,11834,8806,3028,6899,1,3068,3070,2175,895,2.430167598,1462,1378,831,514,0,514,0,206,0,0.081712062,empty,mBC-0716-2
"H12,E9",458603,486868,319774,167094,284387,8,159615,159844,130181,29663,4.388666015,85705,75107,49113,27185,15,27170,2,2853,0,0.00062569,mm10,mBC-0716-2
"H12,E10",422923,457599,316324,141275,259641,2,129876,130052,109256,20796,5.253702635,68074,74403,49471,27316,10,27306,2,3052,0,0.000585952,mm10,mBC-0716-2
"H12,E11",7312,7414,5659,1755,4008,0,1762,1767,1204,563,2.138543517,812,801,472,296,0,296,0,142,0,0.037162162,empty,mBC-0716-2
"H12,E12",418517,461737,282836,178901,274601,0,167907,168130,132788,35342,3.757229359,95556,4215,2668,1566,0,1566,0,505,0,0.005108557,mm10,mBC-0716-2
"H12,F1",12264,12397,9339,3058,7250,0,3294,3300,2303,997,2.309929789,1534,1541,907,565,1,564,1,225,0,0.033687943,empty,mBC-0716-2
"H12,F2",14689,15103,11159,3944,8868,0,4007,4014,2821,1193,2.364626991,1927,4527,1878,1140,1,1139,1,408,0,0.049165935,empty,mBC-0716-2
"H12,F3",341577,347106,254253,92853,199197,8,93863,94009,74276,19733,3.764050068,46689,8128,4984,2815,0,2815,0,815,0,0.010301954,mm10,mBC-0716-2
"H12,F4",10073,10195,7643,2552,5995,0,2678,2681,1859,822,2.261557178,1225,600,337,215,0,215,0,98,0,0.046511628,empty,mBC-0716-2
"H12,F5",445438,475285,329673,145612,279449,1,144002,144201,110596,33605,3.291057878,75348,17593,11365,6457,1,6456,1,1243,0,0.002013631,mm10,mBC-0716-2
"H12,F6",14939,15742,11291,4451,9007,0,4206,4215,2965,1250,2.372,2075,1755,1049,626,0,626,0,254,0,0.060702875,empty,mBC-0716-2
"H12,F7",13649,14136,10342,3794,8321,0,3861,3873,2711,1162,2.333046472,1876,3119,1187,693,0,693,0,251,0,0.027417027,empty,mBC-0716-2
"H12,F8",779775,871995,535591,336404,500175,16,301611,301954,245248,56706,4.32490389,170083,5346,3170,1815,0,1815,0,459,0,0.011570248,mm10,mBC-0716-2
"H12,F9",9826,10121,7498,2623,5858,0,2679,2685,1878,807,2.327137546,1296,3249,1278,750,0,750,0,259,0,0.028,empty,mBC-0716-2
"H12,F10",14051,14201,10772,3429,8356,21,3724,3753,2642,1111,2.378037804,1736,1014,610,399,1,398,1,181,0,0.027638191,empty,mBC-0716-2
"H12,F11",608313,665938,429851,236087,387182,2,221836,222118,150684,71434,2.109415684,122216,37130,24186,13945,4,13941,2,2041,0,0.00086077,mm10,mBC-0716-2
"H12,F12",9611,10013,7259,2754,5662,0,2624,2630,1852,778,2.380462725,1280,171,111,67,0,67,0,39,0,0,empty,mBC-0716-2
"H12,G1",7028,7164,5498,1666,4214,0,1871,1875,1297,578,2.243944637,819,1481,922,560,0,560,0,188,0,0.035714286,empty,mBC-0716-2
"H12,G2",14111,14315,10783,3532,8363,7,3788,3799,2719,1080,2.517592593,1797,1185,492,324,0,324,0,163,0,0.012345679,empty,mBC-0716-2
"H12,G3",497141,547070,355958,191112,318646,21,176146,176433,108871,67562,1.611423581,100892,13317,8533,4765,4,4761,3,1055,0,0.002310439,mm10,mBC-0716-2
"H12,G4",19627,19973,15332,4641,11409,30,4988,5027,3602,1425,2.527719298,2343,148,100,63,0,63,0,47,0,0,empty,mBC-0716-2
"H12,G5",8587,8900,6512,2388,5286,4,2435,2441,1706,735,2.321088435,1186,3824,1477,933,0,933,0,332,0,0.100750268,empty,mBC-0716-2
"H12,G6",18774,19039,14418,4621,10387,3,4523,4532,3172,1360,2.332352941,2083,554,243,152,0,152,0,98,0,0.026315789,empty,mBC-0716-2
"H12,G7",12858,13536,9900,3636,7988,0,3706,3710,2648,1062,2.493408663,1819,1698,883,597,1,596,1,243,0,0.041946309,empty,mBC-0716-2
"H12,G8",9823,10130,7466,2664,5847,0,2684,2691,1841,850,2.165882353,1292,2587,1116,706,0,706,0,282,0,0.090651558,empty,mBC-0716-2
"H12,G9",7467,7590,5616,1974,4428,0,2037,2039,1424,615,2.315447154,958,1103,684,441,0,441,0,214,0,0.006802721,empty,mBC-0716-2
"H12,G10",8937,9262,6934,2328,5433,7,2468,2475,1717,758,2.265171504,1141,1148,693,437,0,437,0,200,0,0.018306636,empty,mBC-0716-2
"H12,G11",8513,8731,6583,2148,4996,0,2229,2235,1622,613,2.646003263,1040,534,362,227,0,227,0,98,0,0,empty,mBC-0716-2
"H12,G12",7284,7453,5538,1915,4459,0,2104,2111,1500,611,2.454991817,1000,835,501,314,0,314,0,135,0,0.066878981,empty,mBC-0716-2
"H12,H1",527850,589701,374775,214926,343940,0,196007,196266,133434,62832,2.123663102,110978,14372,9153,4969,3,4966,1,965,0,0.002215062,mm10,mBC-0716-2
"H12,H2",15543,16181,11949,4232,9499,1,4419,4430,3115,1315,2.368821293,2142,2654,1307,767,0,767,0,285,0,0.050847458,empty,mBC-0716-2
"H12,H3",871518,940398,634580,305818,545362,2,290914,291316,213236,78080,2.730993852,156980,69145,44392,24631,8,24623,2,2780,0,0.00150266,mm10,mBC-0716-2
"H12,H4",10240,10624,7798,2826,5788,0,2634,2640,1819,821,2.215590743,1282,198,125,100,0,100,0,76,0,0.01,empty,mBC-0716-2
"H12,H5",640357,701018,450342,250676,402368,1,229865,230159,189191,40968,4.618018942,127222,46580,29763,16358,8,16350,2,2205,0,0.001100917,mm10,mBC-0716-2
"H12,H6",8793,8905,6692,2213,5407,0,2461,2465,1728,737,2.344640434,1181,1132,647,391,0,391,0,197,0,0.015345269,empty,mBC-0716-2
"H12,H7",10904,11212,8186,3026,6630,0,3070,3077,2102,975,2.155897436,1492,2365,1125,690,1,689,1,246,0,0.039187228,empty,mBC-0716-2
"H12,H8",12445,12796,9350,3446,7646,21,3719,3748,2794,954,2.928721174,1873,1217,755,476,0,476,0,210,0,0.081932773,empty,mBC-0716-2
"H12,H9",9982,10108,7597,2511,5988,0,2736,2743,1945,798,2.437343358,1312,1294,708,458,0,458,0,219,0,0.054585153,empty,mBC-0716-2
"H12,H10",9205,9364,6819,2545,5523,0,2551,2553,1811,742,2.440700809,1256,2321,869,565,0,565,0,278,0,0.024778761,empty,mBC-0716-2
"H12,H11",454611,503392,325206,178186,296451,1,164816,165040,133086,31954,4.164924579,91410,1673,1064,590,0,590,0,195,0,0.003389831,empty,mBC-0716-2
"H12,H12",400201,454333,274535,179798,267691,1,161146,161363,121146,40217,3.012308228,93553,47546,30861,17383,5,17378,1,2243,0,0.00028772,mm10,mBC-0716-2
"A1,A1",6203,6657,4442,2215,3947,0,2128,2133,1514,619,2.445880452,1166,1659,1172,316,0,316,0,65,0,0,empty,mBC-0814-1
"A1,A2",6148,6761,4419,2342,4039,0,2192,2199,1559,640,2.4359375,1192,1426,1006,316,0,316,0,92,0,0.006329114,empty,mBC-0814-1
"A1,A3",5287,5662,3786,1876,3320,0,1861,1861,1342,519,2.585741811,985,1124,776,204,0,204,0,47,0,0.004901961,empty,mBC-0814-1
"A1,A4",5910,6349,4257,2092,3639,0,1948,1948,1312,636,2.062893082,1014,713,526,174,0,174,0,37,0,0.057471264,empty,mBC-0814-1
"A1,A5",435535,510974,290333,220641,306214,4,193032,193278,161319,31959,5.047686098,116447,182213,129324,36199,15,36184,1,2201,0,0.000165819,mm10,mBC-0814-1
"A1,A6",4456,4677,3207,1470,2770,0,1468,1468,1043,425,2.454117647,754,1585,1031,298,0,298,0,67,0,0,empty,mBC-0814-1
"A1,A7",6235,6816,4427,2389,3986,0,2241,2244,1561,683,2.285505124,1228,2063,1222,343,1,342,1,80,0,0,empty,mBC-0814-1
"A1,A8",2576,2746,1810,936,1677,0,941,943,694,249,2.787148594,505,1534,1057,369,3,366,1,76,0,0.073770492,empty,mBC-0814-1
"A1,A9",7219,7642,5211,2431,4416,0,2303,2307,1658,649,2.554699538,1159,1928,1309,383,0,383,0,75,0,0,empty,mBC-0814-1
"A1,A10",4073,4398,2880,1518,2601,0,1437,1441,1014,427,2.37470726,753,227,172,74,0,74,0,15,0,0,empty,mBC-0814-1
"A1,A11",421030,481121,281810,199311,286156,0,175349,175540,139560,35980,3.878821568,103865,185507,135375,38374,23,38351,2,2296,0,0.000912623,mm10,mBC-0814-1
"A1,A12",5304,5843,3719,2124,3421,0,1932,1937,1417,520,2.725,1077,2732,1998,638,1,637,1,168,0,0,empty,mBC-0814-1
"A1,B1",5180,5512,3680,1832,3287,0,1798,1800,1277,523,2.4416826,984,1366,974,313,1,312,1,74,0,0,empty,mBC-0814-1
"A1,B2",5102,5513,3532,1981,3309,0,1821,1824,1331,493,2.69979716,1004,740,529,167,0,167,0,39,0,0,empty,mBC-0814-1
"A1,B3",289058,347406,184638,162768,210621,2,140586,140746,114333,26413,4.328663915,89003,26239,17206,4371,3,4368,1,762,0,0,mm10,mBC-0814-1
"A1,B4",4765,5193,3417,1776,3153,0,1765,1765,1258,507,2.481262327,966,1429,1046,344,0,344,0,64,0,0.002906977,empty,mBC-0814-1
"A1,B5",4676,3379,2009,1370,2402,0,1428,1431,1062,369,2.87804878,871,1085,794,197,0,197,0,50,0,0,empty,mBC-0814-1
"A1,B6",4699,5434,3300,2134,3133,0,1745,1746,1255,491,2.556008147,991,1421,1041,262,0,262,0,53,0,0,empty,mBC-0814-1
"A1,B7",5538,6003,4008,1995,3537,0,1898,1907,1341,566,2.369257951,1029,1255,848,269,0,269,0,60,0,0,empty,mBC-0814-1
"A1,B8",4641,4508,2997,1511,2614,0,1360,1363,976,387,2.521963824,739,5083,2529,745,1,744,1,111,0,0.002688172,empty,mBC-0814-1
"A1,B9",5407,5909,3876,2033,3537,3,1925,1929,1382,547,2.526508227,1038,868,659,234,1,233,1,66,0,0.004291845,empty,mBC-0814-1
"A1,B10",5079,5573,3497,2076,3297,0,1848,1852,1319,533,2.47467167,1028,438,265,84,0,84,0,22,0,0,empty,mBC-0814-1
"A1,B11",992883,1153317,661117,492200,675816,2,430966,431439,343992,87447,3.933719853,259430,16257,11096,3074,1,3073,1,387,0,0.000325415,mm10,mBC-0814-1
"A1,B12",5931,6468,4233,2235,3822,0,2140,2147,1535,612,2.508169935,1173,955,620,183,0,183,0,60,0,0,empty,mBC-0814-1
"A1,C1",5910,6148,4348,1800,3648,1,1831,1834,1328,506,2.624505929,949,1140,767,263,2,261,1,50,0,0.030651341,empty,mBC-0814-1
"A1,C2",5888,6386,4179,2207,3696,0,2027,2033,1468,565,2.598230088,1108,2255,1696,491,0,491,0,105,0,0,empty,mBC-0814-1
"A1,C3",6083,6541,4433,2108,3857,0,2025,2026,1475,551,2.676950998,1058,842,585,175,0,175,0,45,0,0,empty,mBC-0814-1
"A1,C4",5932,6272,4262,2010,3738,0,1983,1987,1418,569,2.492091388,1073,5162,1868,544,0,544,0,90,0,0.044117647,empty,mBC-0814-1
"A1,C5",8109,8556,5804,2752,5124,0,2794,2798,2000,798,2.506265664,1480,1925,1355,406,0,406,0,95,0,0,empty,mBC-0814-1
"A1,C6",5829,6202,4222,1980,3657,0,1947,1951,1345,606,2.219471947,1005,1827,1331,372,1,371,1,77,0,0,empty,mBC-0814-1
"A1,C7",7526,8290,5384,2906,4910,0,2734,2735,1943,792,2.453282828,1532,689,362,94,0,94,0,19,0,0,empty,mBC-0814-1
"A1,C8",544067,603138,376087,227051,358366,1,212051,212328,170945,41383,4.130802503,120962,59524,40829,11264,6,11258,1,1070,0,0.004441286,mm10,mBC-0814-1
"A1,C9",5008,5295,3571,1724,3130,0,1669,1669,1214,455,2.668131868,871,1367,933,282,0,282,0,57,0,0,empty,mBC-0814-1
"A1,C10",6039,6645,4297,2348,3834,0,2131,2134,1597,537,2.973929236,1149,1165,790,240,0,240,0,40,0,0,empty,mBC-0814-1
"A1,C11",5157,5747,3719,2028,3330,0,1881,1883,1338,545,2.455045872,1045,1471,915,285,0,285,0,73,0,0,empty,mBC-0814-1
"A1,C12",8914,9444,6318,3126,5549,0,3000,3005,2138,867,2.465974625,1581,1778,1072,358,0,358,0,73,0,0,empty,mBC-0814-1
"A1,D1",5272,5722,3664,2058,3417,0,1902,1909,1356,553,2.452079566,1048,16568,4887,1446,0,1446,0,164,0,0.015905947,empty,mBC-0814-1
"A1,D2",5333,5594,3812,1782,3301,7,1736,1744,1283,461,2.78308026,921,1732,1306,357,0,357,0,71,0,0.140056022,empty,mBC-0814-1
"A1,D3",11621,12745,8401,4344,7497,0,4139,4151,2930,1221,2.3996724,2235,1958,1381,473,0,473,0,102,0,0.063424947,empty,mBC-0814-1
"A1,D4",5742,6387,4107,2280,3790,0,2079,2082,1487,595,2.499159664,1123,1419,1016,315,1,314,1,80,0,0.060509554,empty,mBC-0814-1
"A1,D5",389787,461962,255719,206243,276902,0,175153,175322,137797,37525,3.672138574,107397,305221,213550,59677,39,59638,3,3031,0,0.000570106,mm10,mBC-0814-1
"A1,D6",5380,6030,3843,2187,3543,0,2002,2006,1480,526,2.813688213,1103,1714,1210,386,0,386,0,72,0,0,empty,mBC-0814-1
"A1,D7",7023,7509,5019,2490,4285,2,2272,2275,1738,537,3.236499069,1229,2893,1926,621,0,621,0,113,0,0.001610306,empty,mBC-0814-1
"A1,D8",5539,5958,3885,2073,3511,0,1983,1989,1436,553,2.596745027,1086,8423,2490,840,2,838,2,98,0,0.155131265,empty,mBC-0814-1
"A1,D9",4001,4333,2827,1506,2591,4,1427,1431,1020,411,2.481751825,776,8888,3273,1009,0,1009,0,114,0,0.093161546,empty,mBC-0814-1
"A1,D10",4283,4561,3066,1495,2736,0,1488,1492,1071,421,2.543942993,791,1012,663,182,0,182,0,56,0,0.054945055,empty,mBC-0814-1
"A1,D11",4650,5042,3394,1648,3061,0,1681,1681,1206,475,2.538947368,913,8598,3179,967,1,966,1,152,0,0.022774327,empty,mBC-0814-1
"A1,D12",7003,7694,4976,2718,4550,0,2557,2561,1813,748,2.423796791,1424,2866,2001,613,0,613,0,126,0,0.014681892,empty,mBC-0814-1
"A1,E1",756999,852142,515930,336212,494913,1,297408,297805,246703,51102,4.827658409,172044,238656,166841,45865,21,45844,3,2640,0,0.000698019,mm10,mBC-0814-1
"A1,E2",4207,4660,2953,1707,2702,0,1513,1514,1128,386,2.922279793,830,15276,5043,1685,1,1684,1,171,0,0.168646081,empty,mBC-0814-1
"A1,E3",3699,3811,2666,1145,2244,0,1148,1150,858,292,2.938356164,565,1824,1325,432,0,432,0,79,0,0.043981481,empty,mBC-0814-1
"A1,E4",3531,3870,2561,1309,2213,0,1251,1252,914,338,2.704142012,651,7106,2598,812,2,810,2,116,0,0.032098765,empty,mBC-0814-1
"A1,E5",3904,4137,2903,1234,2467,0,1281,1281,945,336,2.8125,636,1056,707,179,2,177,1,39,0,0,empty,mBC-0814-1
"A1,E6",4808,5077,3502,1575,2992,0,1560,1562,1123,439,2.55808656,829,1315,857,258,0,258,0,63,0,0,empty,mBC-0814-1
"A1,E7",4753,5187,3336,1851,2981,0,1555,1556,1135,421,2.695961995,844,1302,935,258,0,258,0,50,0,0,empty,mBC-0814-1
"A1,E8",5210,5472,3860,1612,3244,0,1700,1702,1199,503,2.383697813,866,1903,1424,421,0,421,0,82,0,0.021377672,empty,mBC-0814-1
"A1,E9",3782,4085,2679,1406,2477,1,1376,1377,994,383,2.595300261,749,1457,962,327,1,326,1,70,0,0,empty,mBC-0814-1
"A1,E10",4438,4977,3167,1810,2915,0,1631,1631,1151,480,2.397916667,907,1684,1196,356,0,356,0,91,0,0,empty,mBC-0814-1
"A1,E11",4782,5139,3416,1723,2966,0,1597,1600,1139,461,2.470715835,872,2077,1563,398,0,398,0,72,0,0,empty,mBC-0814-1
"A1,E12",421651,502792,279623,223169,301018,0,191506,191657,161443,30214,5.343317667,116904,210191,149382,42075,27,42048,5,2383,0,0.00030917,mm10,mBC-0814-1
"A1,F1",598857,679367,407012,272355,401455,1,248547,248807,183807,65000,2.8278,145068,51704,35905,10212,8,10204,1,971,0,0.00127401,mm10,mBC-0814-1
"A1,F2",7146,7582,5166,2416,4391,0,2408,2417,1764,653,2.701378254,1213,2650,1856,568,0,568,0,127,0,0.003521127,empty,mBC-0814-1
"A1,F3",5373,6007,3911,2096,3530,0,1902,1903,1396,507,2.753451677,1039,1964,1346,422,0,422,0,79,0,0,empty,mBC-0814-1
"A1,F4",6182,6507,4366,2141,3892,1,2114,2115,1503,612,2.455882353,1125,2084,654,220,0,220,0,37,0,0.063636364,empty,mBC-0814-1
"A1,F5",5816,6056,4251,1805,3556,0,1850,1853,1298,555,2.338738739,945,1215,895,291,1,290,1,64,0,0,empty,mBC-0814-1
"A1,F6",5884,6306,4252,2054,3709,0,2011,2015,1444,571,2.528896673,1072,1639,1174,367,0,367,0,95,0,0.010899183,empty,mBC-0814-1
"A1,F7",4860,5202,3600,1602,3153,0,1683,1685,1229,456,2.695175439,853,477,366,129,0,129,0,33,0,0.139534884,empty,mBC-0814-1
"A1,F8",6612,7108,4778,2330,4251,0,2319,2321,1669,652,2.559815951,1234,389,302,68,0,68,0,14,0,0,empty,mBC-0814-1
"A1,F9",5960,6349,4291,2058,3703,0,1957,1962,1408,554,2.541516245,1054,1949,1391,408,0,408,0,92,0,0.041666667,empty,mBC-0814-1
"A1,F10",6924,7595,5117,2478,4416,0,2325,2331,1633,698,2.339541547,1223,1733,1189,384,0,384,0,83,0,0.0078125,empty,mBC-0814-1
"A1,F11",5033,5645,3619,2026,3276,0,1812,1812,1291,521,2.477927063,1017,1313,936,290,0,290,0,59,0,0,empty,mBC-0814-1
"A1,F12",5159,5645,3653,1992,3275,0,1852,1852,1340,512,2.6171875,990,319,197,45,0,45,0,9,0,0,empty,mBC-0814-1
"A1,G1",8418,9098,6033,3065,5341,3,2851,2865,2062,803,2.567870486,1526,12821,4780,1441,3,1438,2,191,0,0.053546592,empty,mBC-0814-1
"A1,G2",539763,609075,361768,247307,362999,1,225061,225282,175906,49376,3.562581011,132983,8072,5624,1533,2,1531,1,223,0,0.000653168,mm10,mBC-0814-1
"A1,G3",5497,5828,3976,1852,3539,0,1883,1886,1342,544,2.466911765,996,1672,1159,402,0,402,0,105,0,0,empty,mBC-0814-1
"A1,G4",5851,6281,4319,1962,3611,4,1934,1947,1382,565,2.446017699,995,1,0,0,0,0,0,0,0,0,empty,mBC-0814-1
"A1,G5",4924,5178,3580,1598,3081,0,1669,1669,1187,482,2.462655602,835,1704,1210,388,0,388,0,74,0,0.038659794,empty,mBC-0814-1
"A1,G6",9233,9931,6643,3288,5902,1,3144,3147,2223,924,2.405844156,1663,273,202,47,0,47,0,12,0,0,empty,mBC-0814-1
"A1,G7",6023,6479,4344,2135,3990,0,2175,2178,1610,568,2.834507042,1159,3678,2370,647,0,647,0,111,0,0,empty,mBC-0814-1
"A1,G8",8253,9167,5836,3331,5362,0,2985,2994,2090,904,2.311946903,1627,5484,3387,1058,0,1058,0,184,0,0.040642722,empty,mBC-0814-1
"A1,G9",6276,6738,4543,2195,4035,0,2159,2164,1542,622,2.479099678,1157,2764,1935,544,1,543,1,139,0,0,empty,mBC-0814-1
"A1,G10",10448,11223,7521,3702,6637,0,3520,3525,2587,938,2.757995736,1883,10382,4542,1325,2,1323,2,208,0,0.025699169,empty,mBC-0814-1
"A1,G11",11926,12937,8501,4436,7627,0,4328,4329,2827,1502,1.882157124,2321,4619,1982,580,1,579,1,112,0,0,empty,mBC-0814-1
"A1,G12",1119210,1238562,773025,465537,734631,2,437383,437926,332257,105669,3.14431858,250337,132388,93329,25910,21,25889,4,1944,0,0.004635173,mm10,mBC-0814-1
"A1,H1",5085,5466,3581,1885,3204,0,1752,1752,1239,513,2.415204678,936,845,583,211,0,211,0,46,0,0,empty,mBC-0814-1
"A1,H2",599037,714746,395603,319143,422384,1,272108,272424,223610,48814,4.580857951,166713,230206,165256,45546,28,45518,3,2638,0,0.000417417,mm10,mBC-0814-1
"A1,H3",6244,6742,4387,2355,3949,0,2168,2178,1532,646,2.371517028,1195,1536,920,328,0,328,0,97,0,0,empty,mBC-0814-1
"A1,H4",350176,402452,232968,169484,240622,1,149952,150097,125957,24140,5.217771334,91093,2894,1362,355,0,355,0,78,0,0,empty,mBC-0814-1
"A1,H5",7187,7799,5134,2665,4477,1,2415,2418,1677,741,2.263157895,1283,1803,1311,403,0,403,0,83,0,0,empty,mBC-0814-1
"A1,H6",676513,783341,445628,337713,459723,1,294008,294284,239440,54844,4.365837649,175788,179445,129706,36550,28,36522,2,2087,0,0.000109523,mm10,mBC-0814-1
"A1,H7",532554,584518,363484,221034,349687,1,207405,207665,163805,43860,3.734724122,119194,45425,31429,8620,3,8617,1,868,0,0.008587676,mm10,mBC-0814-1
"A1,H8",5033,5565,3549,2016,3253,0,1821,1825,1337,488,2.739754098,998,2411,1653,511,0,511,0,113,0,0.019569472,empty,mBC-0814-1
"A1,H9",6460,6910,4508,2402,4076,0,2219,2221,1579,642,2.459501558,1210,1472,991,278,1,277,1,54,0,0,empty,mBC-0814-1
"A1,H10",3854,4100,2770,1330,2407,0,1331,1333,951,382,2.489528796,682,660,437,164,0,164,0,42,0,0.067073171,empty,mBC-0814-1
"A1,H11",4431,4566,3182,1384,2772,0,1538,1540,1109,431,2.573085847,779,42,24,12,0,12,0,10,0,0,empty,mBC-0814-1
"A1,H12",3498,3915,2477,1438,2323,0,1307,1309,930,379,2.453825858,705,1670,1013,285,0,285,0,67,0,0,empty,mBC-0814-1
"A2,A1",6036,6469,4297,2172,3858,0,2099,2104,1451,653,2.222052067,1115,1715,1168,355,0,355,0,81,0,0.025352113,empty,mBC-0814-1
"A2,A2",463322,539016,300764,238252,320024,3,206423,206675,166948,39727,4.202381252,125091,197710,142787,40737,24,40713,2,2378,0,0.000442119,mm10,mBC-0814-1
"A2,A3",5227,5667,3746,1921,3392,0,1845,1846,1288,558,2.308243728,1004,9413,3344,930,2,928,1,129,0,0.016163793,empty,mBC-0814-1
"A2,A4",6442,6827,4637,2190,3960,1,2082,2083,1458,625,2.3328,1086,550,392,123,0,123,0,35,0,0.016260163,empty,mBC-0814-1
"A2,A5",5281,5542,3802,1740,3321,0,1818,1822,1301,521,2.497120921,936,1779,1256,308,0,308,0,64,0,0,empty,mBC-0814-1
"A2,A6",4097,4495,2953,1542,2674,0,1474,1475,1026,449,2.285077951,798,2047,1465,368,0,368,0,82,0,0.016304348,empty,mBC-0814-1
"A2,A7",443531,528910,289736,239174,315674,0,198989,199172,170398,28774,5.921943421,122499,315540,221632,60758,49,60709,4,2967,0,0.003063796,mm10,mBC-0814-1
"A2,A8",2534,2814,1733,1081,1713,0,953,956,680,276,2.463768116,532,1388,933,305,0,305,0,84,0,0,empty,mBC-0814-1
"A2,A9",6989,7655,5075,2580,4423,0,2375,2375,1702,673,2.52897474,1238,1966,1417,452,1,451,1,85,0,0,empty,mBC-0814-1
"A2,A10",3885,4275,2804,1471,2568,0,1435,1435,1005,430,2.337209302,774,237,158,65,1,64,1,21,0,0,empty,mBC-0814-1
"A2,A11",300068,343915,198403,145512,207157,0,130036,130167,104177,25990,4.008349365,77694,112989,82531,22298,12,22286,1,1638,0,0.000673068,mm10,mBC-0814-1
"A2,A12",5341,5947,3767,2180,3527,0,1974,1979,1436,543,2.644567219,1086,24462,8163,2498,4,2494,1,348,0,0.097433841,empty,mBC-0814-1
"A2,B1",5257,5608,3815,1793,3330,0,1821,1823,1288,535,2.407476636,921,18625,5466,1712,2,1710,1,192,0,0.070760234,empty,mBC-0814-1
"A2,B2",5479,5864,3776,2088,3420,0,1861,1864,1338,526,2.543726236,1039,20967,5791,1731,2,1729,1,172,0,0.017929439,empty,mBC-0814-1
"A2,B3",4287,4737,2999,1738,2831,3,1577,1582,1102,480,2.295833333,881,1634,1001,336,2,334,1,71,0,0.01497006,empty,mBC-0814-1
"A2,B4",4905,5337,3497,1840,3152,0,1717,1718,1226,492,2.491869919,921,3902,1559,457,3,454,1,95,0,0.061674009,empty,mBC-0814-1
"A2,B5",4131,2684,1795,889,1922,0,1070,1073,807,266,3.033834586,593,999,659,167,0,167,0,57,0,0,empty,mBC-0814-1
"A2,B6",4590,4914,3262,1652,3002,0,1684,1687,1203,484,2.48553719,889,1744,1206,355,0,355,0,80,0,0,empty,mBC-0814-1
"A2,B7",5424,5810,4002,1808,3408,0,1799,1802,1253,549,2.282331512,928,12742,4173,1287,0,1287,0,137,0,0.000777001,empty,mBC-0814-1
"A2,B8",4771,5221,3508,1713,2927,0,1507,1512,1054,458,2.301310044,788,1438,1023,321,0,321,0,78,0,0,empty,mBC-0814-1
"A2,B9",454312,533691,304347,229344,315695,0,195824,196053,160834,35219,4.566682756,117832,158543,113116,30595,19,30576,2,2032,0,0.000490581,mm10,mBC-0814-1
"A2,B10",4817,5034,3342,1692,3072,1,1636,1642,1132,510,2.219607843,903,6106,1835,613,1,612,1,87,0,0.088235294,empty,mBC-0814-1
"A2,B11",7017,7724,5048,2676,4463,0,2452,2454,1705,749,2.276368491,1314,146,91,28,0,28,0,12,0,0,empty,mBC-0814-1
"A2,B12",5719,6232,4066,2166,3741,0,2071,2072,1464,608,2.407894737,1105,1170,792,242,0,242,0,69,0,0.008264463,empty,mBC-0814-1
"A2,C1",6355,6730,4639,2091,3938,0,2066,2073,1555,518,3.001930502,1087,1267,920,265,0,265,0,68,0,0,empty,mBC-0814-1
"A2,C2",5974,6439,4269,2170,3785,0,2092,2098,1569,529,2.965973535,1120,2414,1704,500,0,500,0,120,0,0.004,empty,mBC-0814-1
"A2,C3",6474,7003,4725,2278,4089,1,2225,2228,1598,630,2.536507937,1170,593,411,158,0,158,0,36,0,0.101265823,empty,mBC-0814-1
"A2,C4",5865,6297,4246,2051,3823,0,2065,2068,1524,544,2.801470588,1110,1505,1056,318,0,318,0,90,0,0.028301887,empty,mBC-0814-1
"A2,C5",7698,8175,5527,2648,4783,0,2579,2583,1872,711,2.632911392,1339,2053,1517,391,0,391,0,99,0,0,empty,mBC-0814-1
"A2,C6",6943,7610,4877,2733,4605,0,2594,2596,1893,703,2.692745377,1389,1737,1257,383,0,383,0,100,0,0.018276762,empty,mBC-0814-1
"A2,C7",7522,8076,5376,2700,4812,0,2664,2664,1892,772,2.450777202,1390,2268,955,321,0,321,0,42,0,0.112149533,empty,mBC-0814-1
"A2,C8",5772,5966,4211,1755,3586,0,1834,1835,1326,509,2.605108055,897,2096,1456,455,0,455,0,92,0,0.002197802,empty,mBC-0814-1
"A2,C9",4955,5144,3551,1593,3002,0,1621,1626,1162,464,2.504310345,827,1437,963,287,0,287,0,81,0,0,empty,mBC-0814-1
"A2,C10",701205,814028,476156,337872,474985,2,293094,293456,250138,43318,5.774458655,173403,168560,119545,33034,26,33008,3,2100,0,0.000605914,mm10,mBC-0814-1
"A2,C11",413616,484209,272733,211476,291533,0,188535,188732,152187,36545,4.164372691,114605,33040,20356,5696,7,5689,3,626,0,0.002812445,mm10,mBC-0814-1
"A2,C12",9067,10063,6531,3532,5751,0,3197,3205,2259,946,2.38794926,1730,2945,1911,545,2,543,1,115,0,0,empty,mBC-0814-1
"A2,D1",4959,5630,3567,2063,3331,0,1848,1849,1367,482,2.836099585,1003,868,538,203,0,203,0,60,0,0,empty,mBC-0814-1
"A2,D2",795439,900296,553396,346900,521503,0,308503,308873,263858,45015,5.861557259,176195,247827,184379,51481,35,51446,3,2732,0,0.000524822,mm10,mBC-0814-1
"A2,D3",11704,12639,8449,4190,7364,0,3970,3978,2849,1129,2.523472099,2112,3342,2404,673,1,672,1,133,0,0,empty,mBC-0814-1
"A2,D4",5403,6087,3811,2276,3555,0,2033,2035,1452,583,2.490566038,1138,1280,868,279,0,279,0,75,0,0,empty,mBC-0814-1
"A2,D5",5393,5693,3851,1842,3495,0,1916,1916,1414,502,2.816733068,1001,3190,2250,688,1,687,1,149,0,0.001455604,empty,mBC-0814-1
"A2,D6",5414,5902,3907,1995,3427,0,1874,1875,1357,518,2.61969112,1017,1865,1394,368,0,368,0,68,0,0.046195652,empty,mBC-0814-1
"A2,D7",6742,7197,4868,2329,4241,0,2257,2260,1611,649,2.482280431,1193,2635,1838,560,0,560,0,126,0,0,empty,mBC-0814-1
"A2,D8",5368,5885,3795,2090,3375,0,1859,1865,1355,510,2.656862745,988,1011,578,182,0,182,0,42,0,0.005494505,empty,mBC-0814-1
"A2,D9",3370,3601,2342,1259,2186,0,1245,1246,874,372,2.349462366,675,2170,1496,373,0,373,0,70,0,0.080428954,empty,mBC-0814-1
"A2,D10",658372,761690,444457,317233,446713,1,277329,277699,224873,52826,4.256862151,164195,182844,127517,36761,30,36731,3,2280,0,0.000925649,mm10,mBC-0814-1
"A2,D11",634259,723694,426648,297046,423490,0,260497,260793,222115,38678,5.742670252,152243,305734,219863,58646,31,58615,9,3063,0,0.000238847,mm10,mBC-0814-1
"A2,D12",663952,757191,444601,312590,442601,1,267624,267992,229597,38395,5.97986717,157361,593058,424683,117369,72,117297,4,4385,0,0.000468895,mm10,mBC-0814-1
"A2,E1",5372,5690,3863,1827,3352,0,1790,1791,1246,545,2.286238532,920,2204,1502,403,0,403,0,82,0,0,empty,mBC-0814-1
"A2,E2",459605,543722,303021,240701,324444,0,209241,209449,151367,58082,2.606091388,127966,158780,110648,30769,18,30751,1,2153,0,0.000747943,mm10,mBC-0814-1
"A2,E3",3785,4064,2696,1368,2391,0,1308,1311,944,367,2.572207084,712,1843,1390,356,0,356,0,73,0,0,empty,mBC-0814-1
"A2,E4",3577,3833,2515,1318,2258,0,1268,1271,893,378,2.362433862,681,1827,1247,371,0,371,0,81,0,0.016172507,empty,mBC-0814-1
"A2,E5",3993,4269,2904,1365,2472,0,1278,1279,896,383,2.339425587,684,1247,879,261,0,261,0,61,0,0.072796935,empty,mBC-0814-1
"A2,E6",4757,5000,3407,1593,2888,0,1516,1524,1099,425,2.585882353,770,2051,1547,389,0,389,0,82,0,0.030848329,empty,mBC-0814-1
"A2,E7",5097,5534,3636,1898,3217,0,1729,1729,1228,501,2.451097804,923,1839,1385,386,0,386,0,69,0,0.059585492,empty,mBC-0814-1
"A2,E8",5002,5327,3619,1708,3141,0,1640,1644,1174,470,2.49787234,869,2230,1601,467,0,467,0,83,0,0.004282655,empty,mBC-0814-1
"A2,E9",3908,4256,2840,1416,2427,0,1357,1361,988,373,2.648793566,702,1537,1123,358,0,358,0,82,0,0,empty,mBC-0814-1
"A2,E10",4665,5333,3352,1981,3067,0,1717,1720,1227,493,2.488843813,965,2355,1579,491,0,491,0,106,0,0,empty,mBC-0814-1
"A2,E11",4584,4854,3242,1612,2925,0,1577,1577,1158,419,2.76372315,847,2111,1435,386,0,386,0,97,0,0.007772021,empty,mBC-0814-1
"A2,E12",4345,4935,3086,1849,3002,0,1742,1742,1304,438,2.97716895,968,1105,802,270,1,269,1,53,0,0,empty,mBC-0814-1
"A2,F1",5050,5530,3641,1889,3286,0,1796,1802,1272,530,2.4,982,1929,1311,392,0,392,0,86,0,0,empty,mBC-0814-1
"A2,F2",7045,7519,5025,2494,4487,0,2438,2443,1793,650,2.758461538,1293,2367,1651,526,0,526,0,124,0,0.030418251,empty,mBC-0814-1
"A2,F3",5727,6199,4080,2119,3650,0,2005,2010,1482,528,2.806818182,1067,1933,1369,413,0,413,0,93,0,0,empty,mBC-0814-1
"A2,F4",5941,6277,4164,2113,3731,3,2029,2037,1494,543,2.751381215,1098,704,430,133,0,133,0,33,0,0,empty,mBC-0814-1
"A2,F5",5733,6076,4109,1967,3544,0,1936,1936,1427,509,2.803536346,1003,1737,1274,357,0,357,0,81,0,0.036414566,empty,mBC-0814-1
"A2,F6",5944,6477,4262,2215,3783,0,2102,2105,1595,510,3.12745098,1106,9873,3706,1144,3,1141,2,183,0,0.038562664,empty,mBC-0814-1
"A2,F7",5140,5483,3742,1741,3169,0,1692,1696,1265,431,2.935034803,838,5985,2226,709,2,707,1,103,0,0.03960396,empty,mBC-0814-1
"A2,F8",637442,737124,426986,310138,433585,3,270962,271271,236574,34697,6.818284001,160629,24039,17233,5009,6,5003,1,555,0,0.0009994,mm10,mBC-0814-1
"A2,F9",6275,6454,4384,2070,3770,0,1977,1980,1391,589,2.361629881,1052,10518,3845,1177,1,1176,1,149,0,0.023809524,empty,mBC-0814-1
"A2,F10",753031,855311,513085,342226,500329,0,305188,305549,255325,50224,5.083724912,177656,152261,108772,30354,25,30329,3,1887,0,0.001055096,mm10,mBC-0814-1
"A2,F11",4915,5138,3622,1516,3023,0,1615,1618,1175,443,2.652370203,802,1626,1120,363,1,362,1,70,0,0,empty,mBC-0814-1
"A2,F12",5613,5952,4002,1950,3517,0,1923,1926,1407,519,2.710982659,1047,70,44,20,0,20,0,15,0,0,empty,mBC-0814-1
"A2,G1",669894,763181,449302,313879,447869,0,276539,276896,221560,55336,4.003903426,162877,329587,239030,66598,54,66544,4,3226,0,9.01659E-05,mm10,mBC-0814-1
"A2,G2",500034,587506,330550,256956,349800,0,221005,221203,193910,27293,7.104752134,132920,53035,38214,10651,7,10644,1,987,0,0,mm10,mBC-0814-1
"A2,G3",5568,5919,3986,1933,3560,0,1979,1984,1493,491,3.040733198,1065,2762,2019,625,1,624,1,124,0,0.001602564,empty,mBC-0814-1
"A2,G4",5664,6172,4037,2135,3610,0,1948,1952,1431,521,2.746641075,1070,91,6,5,0,5,0,2,0,0,empty,mBC-0814-1
"A2,G5",5262,5616,3749,1867,3257,0,1786,1790,1269,521,2.435700576,944,6635,2524,742,1,741,1,104,0,0.033738192,empty,mBC-0814-1
"A2,G6",9602,10176,6892,3284,5872,0,3085,3086,2201,885,2.48700565,1598,292,256,81,0,81,0,19,0,0,empty,mBC-0814-1
"A2,G7",5911,6417,4285,2132,3813,0,2031,2040,1472,568,2.591549296,1081,2550,1717,549,0,549,0,128,0,0,empty,mBC-0814-1
"A2,G8",8470,8928,5925,3003,5422,0,3018,3024,2125,899,2.363737486,1632,3441,2289,752,0,752,0,175,0,0.045212766,empty,mBC-0814-1
"A2,G9",6334,6968,4483,2485,4155,0,2322,2328,1646,682,2.413489736,1292,4421,3067,865,0,865,0,169,0,0.002312139,empty,mBC-0814-1
"A2,G10",10315,11240,7356,3884,6596,0,3581,3590,2643,947,2.790918691,1919,3929,2764,797,0,797,0,199,0,0.001254705,empty,mBC-0814-1
"A2,G11",9956,10704,7249,3455,6317,0,3378,3382,2401,981,2.447502548,1764,2974,1574,512,0,512,0,118,0,0,empty,mBC-0814-1
"A2,G12",5187,5685,3746,1939,3447,0,1895,1895,1383,512,2.701171875,1062,2410,1686,530,0,530,0,120,0,0,empty,mBC-0814-1
"A2,H1",5032,5475,3540,1935,3222,0,1820,1824,1293,531,2.435028249,975,825,607,179,0,179,0,53,0,0.089385475,empty,mBC-0814-1
"A2,H2",9376,10069,6597,3472,5943,0,3324,3327,2366,961,2.46201873,1799,3400,2464,789,1,788,1,195,0,0.003807107,empty,mBC-0814-1
"A2,H3",6281,6822,4476,2346,4014,0,2209,2214,1595,619,2.576736672,1180,2560,1889,602,0,602,0,128,0,0.00166113,empty,mBC-0814-1
"A2,H4",6279,7042,4421,2621,4114,0,2321,2326,1651,675,2.445925926,1271,133,44,29,0,29,0,17,0,0,empty,mBC-0814-1
"A2,H5",7325,7857,5257,2600,4624,0,2516,2521,1759,762,2.30839895,1317,2142,1498,452,0,452,0,83,0,0,empty,mBC-0814-1
"A2,H6",1147412,1320404,771191,549213,773380,1,486332,486909,377247,109662,3.440088636,289182,439030,307404,85552,45,85507,5,3785,0,0.002186955,mm10,mBC-0814-1
"A2,H7",5842,6385,4129,2256,3784,0,2134,2134,1512,622,2.430868167,1136,2010,1392,449,0,449,0,80,0,0.035634744,empty,mBC-0814-1
"A2,H8",4889,5202,3494,1708,3099,0,1692,1693,1217,476,2.556722689,890,2442,1817,503,1,502,1,111,0,0.035856574,empty,mBC-0814-1
"A2,H9",6029,6561,4336,2225,3954,0,2231,2231,1618,613,2.639477977,1213,1676,1206,357,0,357,0,67,0,0,empty,mBC-0814-1
"A2,H10",4180,4589,2965,1624,2608,0,1436,1439,1014,425,2.385882353,795,1131,804,219,1,218,1,58,0,0.004587156,empty,mBC-0814-1
"A2,H11",4346,4845,3039,1806,2856,0,1629,1629,1171,458,2.556768559,912,81,61,28,0,28,0,12,0,0,empty,mBC-0814-1
"A2,H12",3303,3734,2329,1405,2309,0,1356,1358,989,369,2.680216802,775,1218,799,250,1,249,1,69,0,0.004016064,empty,mBC-0814-1
"A3,A1",6846,7287,4644,2643,4271,0,2387,2388,1706,682,2.501466276,1323,1434,1089,354,1,353,1,66,0,0,empty,mBC-0814-1
"A3,A2",6666,7240,4723,2517,4336,0,2338,2349,1724,625,2.7584,1274,1608,1107,383,1,382,1,88,0,0.020942408,empty,mBC-0814-1
"A3,A3",5215,5632,3729,1903,3300,0,1822,1824,1296,528,2.454545455,967,1083,706,202,0,202,0,57,0,0,empty,mBC-0814-1
"A3,A4",5779,6067,4362,1705,3495,0,1755,1759,1264,495,2.553535354,849,677,509,145,0,145,0,27,0,0.055172414,empty,mBC-0814-1
"A3,A5",5502,6070,3935,2135,3584,1,1933,1941,1428,513,2.783625731,1066,1495,1053,301,0,301,0,57,0,0.03986711,empty,mBC-0814-1
"A3,A6",4559,4878,3203,1675,2778,0,1551,1553,1084,469,2.31130064,829,1638,1094,323,1,322,1,52,0,0.00621118,empty,mBC-0814-1
"A3,A7",6183,6936,4459,2477,4037,0,2227,2232,1529,703,2.174964438,1203,1592,1203,359,0,359,0,73,0,0,empty,mBC-0814-1
"A3,A8",2636,2941,1846,1095,1768,2,1013,1016,667,349,1.911174785,584,1493,1110,346,2,344,1,73,0,0,empty,mBC-0814-1
"A3,A9",7449,7887,5357,2530,4598,0,2465,2473,1811,662,2.735649547,1290,1698,1284,365,0,365,0,69,0,0,empty,mBC-0814-1
"A3,A10",4331,4706,3001,1705,2772,0,1579,1579,1139,440,2.588636364,848,248,203,42,0,42,0,13,0,0,empty,mBC-0814-1
"A3,A11",5763,6232,4115,2117,3744,0,2045,2049,1513,536,2.822761194,1111,2034,1410,398,1,397,1,89,0,0.012594458,empty,mBC-0814-1
"A3,A12",464864,518850,312056,206794,305925,1,187719,187946,144767,43179,3.352717756,109707,79096,57077,16058,12,16046,2,1460,0,0.00074785,mm10,mBC-0814-1
"A3,B1",5773,6247,4166,2081,3688,0,1917,1922,1382,540,2.559259259,1052,1134,806,227,0,227,0,59,0,0,empty,mBC-0814-1
"A3,B2",5142,5492,3609,1883,3295,0,1765,1769,1221,548,2.22810219,981,605,391,118,0,118,0,27,0,0,empty,mBC-0814-1
"A3,B3",4766,5263,3427,1836,3190,0,1807,1809,1312,497,2.639839034,992,872,608,203,1,202,1,40,0,0.004950495,empty,mBC-0814-1
"A3,B4",5059,5544,3667,1877,3335,1,1829,1841,1289,552,2.335144928,963,877,623,215,0,215,0,48,0,0.08372093,empty,mBC-0814-1
"A3,B5",4165,2766,1743,1023,1992,0,1112,1116,813,303,2.683168317,627,1200,896,272,0,272,0,44,0,0,empty,mBC-0814-1
"A3,B6",945788,1108303,634348,473955,655520,1,419205,419684,328115,91569,3.583254158,252458,200390,143629,41643,20,41623,2,2647,0,0.000360378,mm10,mBC-0814-1
"A3,B7",5441,6072,3899,2173,3577,0,2030,2032,1464,568,2.577464789,1111,867,548,171,0,171,0,47,0,0.005847953,empty,mBC-0814-1
"A3,B8",4145,4394,3013,1381,2592,0,1363,1364,969,395,2.453164557,726,888,649,137,0,137,0,31,0,0,empty,mBC-0814-1
"A3,B9",5661,6211,3933,2278,3604,0,2065,2067,1509,558,2.704301075,1165,568,414,156,0,156,0,38,0,0,empty,mBC-0814-1
"A3,B10",5062,5441,3517,1924,3281,0,1841,1843,1306,537,2.432029795,983,840,459,150,0,150,0,34,0,0,empty,mBC-0814-1
"A3,B11",7669,8404,5475,2929,4850,0,2700,2702,1904,798,2.385964912,1492,262,211,52,0,52,0,9,0,0,empty,mBC-0814-1
"A3,B12",5750,6321,4006,2315,3748,1,2143,2145,1515,630,2.404761905,1182,921,489,175,1,174,1,43,0,0,empty,mBC-0814-1
"A3,C1",5990,6573,4370,2203,3903,0,2094,2102,1574,528,2.981060606,1111,679,530,171,0,171,0,43,0,0,empty,mBC-0814-1
"A3,C2",5857,6530,4056,2474,3750,0,2086,2086,1477,609,2.425287356,1171,1110,712,257,0,257,0,69,0,0,empty,mBC-0814-1
"A3,C3",8176,9124,5787,3337,5398,0,3026,3028,2183,845,2.583431953,1707,656,498,166,0,166,0,33,0,0.006024096,empty,mBC-0814-1
"A3,C4",6438,7023,4595,2428,4073,0,2165,2174,1612,562,2.868327402,1179,1314,877,277,0,277,0,69,0,0.003610108,empty,mBC-0814-1
"A3,C5",10831,12054,7436,4618,7093,0,4157,4157,3108,1049,2.962821735,2363,1497,1003,323,0,323,0,75,0,0.024767802,empty,mBC-0814-1
"A3,C6",5883,6216,4332,1884,3737,0,2023,2025,1483,542,2.736162362,1014,2371,1387,341,0,341,0,60,0,0.014662757,empty,mBC-0814-1
"A3,C7",7424,8010,5300,2710,4600,1,2472,2476,1833,643,2.850699844,1314,496,344,103,0,103,0,22,0,0,empty,mBC-0814-1
"A3,C8",6556,7121,4710,2411,4091,2,2234,2236,1590,646,2.46130031,1185,2184,1303,352,0,352,0,67,0,0.03125,empty,mBC-0814-1
"A3,C9",5252,5819,3721,2098,3390,0,1901,1907,1342,565,2.375221239,1032,810,572,193,0,193,0,41,0,0.041450777,empty,mBC-0814-1
"A3,C10",5860,6277,4323,1954,3544,0,1814,1818,1310,508,2.578740157,930,1056,800,248,0,248,0,48,0,0,empty,mBC-0814-1
"A3,C11",5127,5805,3682,2123,3364,0,1855,1856,1353,503,2.689860835,1027,1530,1193,351,0,351,0,58,0,0,empty,mBC-0814-1
"A3,C12",9393,10019,6651,3368,5956,2,3243,3247,2325,922,2.521691974,1770,7338,2940,932,3,929,1,126,0,0.119483315,empty,mBC-0814-1
"A3,D1",5326,5799,3725,2074,3434,0,1860,1860,1354,506,2.675889328,1044,755,510,178,0,178,0,37,0,0,empty,mBC-0814-1
"A3,D2",5339,5559,3967,1592,3358,0,1732,1737,1255,482,2.60373444,868,2183,1629,493,0,493,0,86,0,0,empty,mBC-0814-1
"A3,D3",1308853,1602120,827202,774918,936986,1,642604,643314,483498,159816,3.025341643,405473,308993,216968,61052,35,61017,4,2957,0,0.000721111,mm10,mBC-0814-1
"A3,D4",5630,5995,3965,2030,3559,0,1976,1976,1415,561,2.52228164,1079,1189,808,242,0,242,0,68,0,0,empty,mBC-0814-1
"A3,D5",5878,6727,4021,2706,3990,0,2338,2338,1729,609,2.83908046,1356,1890,1354,411,1,410,1,83,0,0.036585366,empty,mBC-0814-1
"A3,D6",570003,690807,378307,312500,407020,2,264149,264424,200236,64188,3.119523899,163174,167819,122665,34648,26,34622,2,2158,0,8.66501E-05,mm10,mBC-0814-1
"A3,D7",6923,7588,4979,2609,4442,0,2419,2423,1753,670,2.61641791,1283,2331,1692,562,0,562,0,103,0,0.016014235,empty,mBC-0814-1
"A3,D8",5320,5913,3857,2056,3366,2,1815,1822,1298,524,2.477099237,965,1017,701,204,0,204,0,36,0,0,empty,mBC-0814-1
"A3,D9",3535,3953,2481,1472,2324,2,1294,1297,929,368,2.524456522,753,1187,637,190,0,190,0,48,0,0.010526316,empty,mBC-0814-1
"A3,D10",5015,5637,3610,2027,3338,0,1911,1917,1403,514,2.729571984,1051,766,536,172,0,172,0,43,0,0,empty,mBC-0814-1
"A3,D11",4818,5154,3474,1680,3085,4,1615,1625,1188,437,2.718535469,868,1564,1080,314,0,314,0,90,0,0,empty,mBC-0814-1
"A3,D12",7241,7707,5172,2535,4494,0,2427,2433,1699,734,2.314713896,1269,2840,1907,563,0,563,0,94,0,0,empty,mBC-0814-1
"A3,E1",5471,5802,3928,1874,3430,0,1834,1839,1380,459,3.006535948,955,1387,1018,332,0,332,0,67,0,0.021084337,empty,mBC-0814-1
"A3,E2",7281,8597,5191,3406,4924,0,2959,2961,2014,947,2.126715945,1651,8652,3260,955,2,953,1,119,0,0.016789087,empty,mBC-0814-1
"A3,E3",3668,3939,2643,1296,2315,1,1231,1234,862,372,2.317204301,656,1030,689,214,0,214,0,56,0,0,empty,mBC-0814-1
"A3,E4",3627,3924,2513,1411,2315,0,1259,1263,891,372,2.39516129,700,58550,15874,5287,14,5273,1,466,0,0.065238005,empty,mBC-0814-1
"A3,E5",4414,4817,3262,1555,2862,0,1516,1518,1109,409,2.711491443,819,1131,854,270,0,270,0,41,0,0,empty,mBC-0814-1
"A3,E6",5387,5869,3807,2062,3327,4,1749,1756,1299,457,2.842450766,955,1529,1071,279,0,279,0,57,0,0,empty,mBC-0814-1
"A3,E7",4656,4932,3330,1602,2903,0,1525,1527,1082,445,2.431460674,806,1491,947,264,0,264,0,55,0,0.022727273,empty,mBC-0814-1
"A3,E8",464354,530557,312294,218263,317752,0,200040,200248,158240,42008,3.766901543,117649,27005,19037,5375,3,5372,1,596,0,0.002047655,mm10,mBC-0814-1
"A3,E9",4114,4397,2976,1421,2627,0,1461,1464,1065,399,2.669172932,788,1119,832,289,1,288,1,64,0,0,empty,mBC-0814-1
"A3,E10",390506,471912,255311,216601,284874,1,187690,187883,143376,44507,3.221425843,116953,186021,139132,38885,19,38866,1,2254,0,0.000102918,mm10,mBC-0814-1
"A3,E11",4996,5275,3649,1626,3118,0,1641,1647,1206,441,2.734693878,841,1432,1023,333,1,332,1,70,0,0,empty,mBC-0814-1
"A3,E12",450561,532025,299204,232821,318676,0,203373,203598,157655,45943,3.431534728,123314,134295,85005,24179,15,24164,4,1777,0,0.001779507,mm10,mBC-0814-1
"A3,F1",5074,5392,3618,1774,3174,0,1750,1755,1248,507,2.461538462,913,1779,1207,367,0,367,0,68,0,0,empty,mBC-0814-1
"A3,F2",791077,909084,533797,375287,528218,0,328425,328817,254862,73955,3.446176729,193972,178656,127913,36850,18,36832,3,2265,0,0.000950261,mm10,mBC-0814-1
"A3,F3",5892,6300,4173,2127,3646,0,1953,1959,1419,540,2.627777778,1034,2167,1737,482,1,481,1,74,0,0,empty,mBC-0814-1
"A3,F4",6569,7037,4348,2689,4104,1,2321,2325,1658,667,2.485757121,1321,426,267,73,0,73,0,23,0,0,empty,mBC-0814-1
"A3,F5",5903,6247,4236,2011,3729,0,2017,2019,1431,588,2.433673469,1051,3195,1362,418,0,418,0,60,0,0.0215311,empty,mBC-0814-1
"A3,F6",6258,6831,4482,2349,4036,0,2191,2195,1575,620,2.540322581,1214,1999,1312,421,0,421,0,92,0,0.002375297,empty,mBC-0814-1
"A3,F7",4695,5009,3468,1541,3035,0,1608,1608,1143,465,2.458064516,800,840,538,147,0,147,0,38,0,0,empty,mBC-0814-1
"A3,F8",6875,7471,4912,2559,4383,0,2401,2405,1686,719,2.344923505,1246,231,167,54,0,54,0,13,0,0,empty,mBC-0814-1
"A3,F9",6189,6546,4554,1992,3860,0,2051,2054,1457,597,2.440536013,1068,2006,1326,380,0,380,0,74,0,0.015789474,empty,mBC-0814-1
"A3,F10",6953,7600,4936,2664,4470,4,2375,2383,1730,653,2.649310873,1282,1554,1118,345,1,344,1,75,0,0.023255814,empty,mBC-0814-1
"A3,F11",5054,5493,3655,1838,3182,0,1712,1718,1227,491,2.49898167,924,1611,1090,290,0,290,0,61,0,0.003448276,empty,mBC-0814-1
"A3,F12",69231,92425,42454,49971,55200,0,40481,40525,21391,19134,1.117957562,27112,488,268,76,0,76,0,18,0,0,empty,mBC-0814-1
"A3,G1",8502,9250,6132,3118,5471,0,3037,3038,2217,821,2.700365408,1619,2947,2083,636,0,636,0,122,0,0.047169811,empty,mBC-0814-1
"A3,G2",6647,7165,4681,2484,4207,0,2284,2285,1597,688,2.32122093,1218,538,351,122,0,122,0,27,0,0,empty,mBC-0814-1
"A3,G3",541020,643780,352722,291058,380482,0,246585,246817,171476,75341,2.27599846,151748,177498,115199,32596,30,32566,5,2148,0,0.002088067,mm10,mBC-0814-1
"A3,G4",5922,6368,4337,2031,3700,0,1905,1906,1357,549,2.471766849,992,30,24,8,0,8,0,1,0,0,empty,mBC-0814-1
"A3,G5",5382,5816,3797,2019,3507,2,1948,1950,1419,531,2.672316384,1089,1105,810,282,0,282,0,61,0,0,empty,mBC-0814-1
"A3,G6",9778,10465,7135,3330,6182,0,3335,3340,2386,954,2.501048218,1756,223,187,61,0,61,0,11,0,0,empty,mBC-0814-1
"A3,G7",6497,6905,4577,2328,4113,2,2251,2256,1596,660,2.418181818,1202,1796,1266,322,0,322,0,70,0,0,empty,mBC-0814-1
"A3,G8",9007,9871,6372,3499,5837,0,3307,3316,2324,992,2.342741935,1830,9861,3979,1275,0,1275,0,189,0,0.021176471,empty,mBC-0814-1
"A3,G9",6625,7173,4715,2458,4288,0,2364,2366,1716,650,2.64,1285,2780,1949,563,1,562,1,127,0,0.017793594,empty,mBC-0814-1
"A3,G10",10728,11482,7766,3716,6732,0,3589,3594,2596,998,2.601202405,1862,10955,4907,1407,3,1404,2,210,0,0.045584046,empty,mBC-0814-1
"A3,G11",10437,11411,7609,3802,6591,2,3556,3562,2594,968,2.679752066,1860,1219,906,226,0,226,0,58,0,0,empty,mBC-0814-1
"A3,G12",5446,5962,3890,2072,3545,0,1954,1959,1400,559,2.504472272,1096,1740,1307,353,0,353,0,81,0,0,empty,mBC-0814-1
"A3,H1",5146,5513,3713,1800,3285,0,1779,1787,1246,541,2.303142329,980,1043,729,221,0,221,0,46,0,0.067873303,empty,mBC-0814-1
"A3,H2",8673,9573,6128,3445,5631,0,3152,3158,2241,917,2.443838604,1744,2370,1713,528,0,528,0,113,0,0,empty,mBC-0814-1
"A3,H3",6367,6968,4448,2520,4154,0,2321,2327,1723,604,2.852649007,1292,1843,1326,399,1,398,1,77,0,0,empty,mBC-0814-1
"A3,H4",6507,6816,4720,2096,4053,0,2194,2199,1593,606,2.628712871,1163,37,31,15,0,15,0,4,0,0,empty,mBC-0814-1
"A3,H5",7444,8164,5254,2910,4650,0,2564,2569,1841,728,2.528846154,1416,2015,1394,354,0,354,0,72,0,0,empty,mBC-0814-1
"A3,H6",7412,8143,5296,2847,4769,0,2657,2659,1934,725,2.667586207,1432,2288,1660,417,0,417,0,88,0,0.040767386,empty,mBC-0814-1
"A3,H7",6100,6544,4383,2161,3952,0,2136,2140,1523,617,2.468395462,1148,1409,941,267,0,267,0,48,0,0,empty,mBC-0814-1
"A3,H8",5137,5470,3669,1801,3215,0,1774,1775,1298,477,2.721174004,916,1888,1354,421,0,421,0,84,0,0,empty,mBC-0814-1
"A3,H9",5953,6434,4281,2153,3839,0,2046,2047,1442,605,2.383471074,1121,854,615,192,0,192,0,44,0,0,empty,mBC-0814-1
"A3,H10",4100,4515,2902,1613,2599,0,1477,1477,1074,403,2.665012407,776,1104,811,189,1,188,1,41,0,0,empty,mBC-0814-1
"A3,H11",4691,5177,3330,1847,3140,0,1766,1769,1244,525,2.36952381,990,32,24,11,0,11,0,4,0,0.636363636,empty,mBC-0814-1
"A3,H12",3712,3938,2658,1280,2403,0,1311,1312,946,366,2.584699454,703,2448,1121,287,0,287,0,59,0,0.017421603,empty,mBC-0814-1
"A4,A1",1004929,1130734,682619,448115,664476,1,407291,407722,339611,68111,4.986140271,237330,181775,125638,35404,31,35373,3,2403,0,0.000424052,mm10,mBC-0814-1
"A4,A2",4951,5277,3511,1766,3028,0,1619,1619,1105,514,2.149805447,842,1742,1247,403,0,403,0,90,0,0.00248139,empty,mBC-0814-1
"A4,A3",4766,5200,3437,1763,3035,0,1692,1693,1190,503,2.365805169,926,1329,979,285,1,284,1,55,0,0,empty,mBC-0814-1
"A4,A4",5598,6035,4002,2033,3423,0,1800,1802,1302,500,2.604,945,435,296,80,0,80,0,22,0,0,empty,mBC-0814-1
"A4,A5",5027,5442,3581,1861,3190,1,1748,1751,1296,455,2.848351648,943,1130,734,212,0,212,0,50,0,0.08490566,empty,mBC-0814-1
"A4,A6",3612,3873,2611,1262,2276,1,1188,1192,819,373,2.195710456,626,1139,725,239,0,239,0,62,0,0,empty,mBC-0814-1
"A4,A7",5313,5963,3790,2173,3453,0,1841,1842,1295,547,2.367458867,1020,2121,1413,454,2,452,1,83,0,0,empty,mBC-0814-1
"A4,A8",187167,223172,122246,100926,134580,1,86730,86832,68216,18616,3.664374731,53639,272478,200482,55115,38,55077,1,2923,0,0.000925976,mm10,mBC-0814-1
"A4,A9",6686,7262,4710,2552,4182,4,2261,2267,1671,596,2.803691275,1243,1997,1481,377,0,377,0,64,0,0.023872679,empty,mBC-0814-1
"A4,A10",317422,373867,206933,166934,222976,0,143446,143651,114549,29102,3.936121229,87690,13706,9087,2547,1,2546,1,296,0,0.002749411,mm10,mBC-0814-1
"A4,A11",4186,4355,2973,1382,2605,0,1432,1436,1031,405,2.545679012,751,10864,3999,1189,2,1187,1,160,0,0.059814659,empty,mBC-0814-1
"A4,A12",3452,3760,2429,1331,2177,0,1209,1211,865,346,2.5,667,3412,2418,744,0,744,0,182,0,0,empty,mBC-0814-1
"A4,B1",4508,4893,3276,1617,2813,1,1501,1502,1131,371,3.04851752,788,2448,1541,447,0,447,0,75,0,0.049217002,empty,mBC-0814-1
"A4,B2",4743,4872,3243,1629,2894,0,1593,1594,1128,466,2.420600858,818,1593,592,200,0,200,0,38,0,0.13,empty,mBC-0814-1
"A4,B3",3659,3902,2584,1318,2319,0,1306,1306,947,359,2.637883008,683,1319,783,238,0,238,0,59,0,0.050420168,empty,mBC-0814-1
"A4,B4",4156,4360,2949,1411,2549,0,1381,1384,972,412,2.359223301,723,1324,884,259,0,259,0,55,0,0,empty,mBC-0814-1
"A4,B5",3494,2289,1434,855,1639,0,944,951,697,254,2.744094488,553,945,540,213,0,213,0,60,0,0,empty,mBC-0814-1
"A4,B6",3991,4485,2834,1651,2566,0,1444,1446,1040,406,2.561576355,796,6159,2255,700,0,700,0,89,0,0.072857143,empty,mBC-0814-1
"A4,B7",5108,5336,3710,1626,3192,1,1631,1636,1182,454,2.603524229,835,768,524,175,0,175,0,36,0,0,empty,mBC-0814-1
"A4,B8",4098,4317,2998,1319,2477,0,1257,1263,868,395,2.197468354,656,1933,1178,331,0,331,0,63,0,0.018126888,empty,mBC-0814-1
"A4,B9",4734,5060,3439,1621,2997,0,1615,1617,1172,445,2.633707865,864,4144,1686,541,0,541,0,90,0,0.059149723,empty,mBC-0814-1
"A4,B10",4116,4272,2901,1371,2603,0,1394,1404,1000,404,2.475247525,776,550,463,99,0,99,0,30,0,0,empty,mBC-0814-1
"A4,B11",547242,632355,357720,274635,367641,0,234589,234850,186044,48806,3.811908372,141101,30594,22293,6360,4,6356,1,597,0,0,mm10,mBC-0814-1
"A4,B12",1525339,1785276,1007986,777290,1034679,1,661850,662618,546544,116074,4.708582456,399902,592423,426044,116043,79,115964,2,4586,0,0.000112104,mm10,mBC-0814-1
"A4,C1",5539,5663,4039,1624,3302,15,1694,1714,1195,519,2.302504817,821,826,597,221,0,221,0,40,0,0,empty,mBC-0814-1
"A4,C2",5036,5347,3575,1772,3139,0,1657,1662,1185,477,2.48427673,858,1853,1257,371,0,371,0,81,0,0,empty,mBC-0814-1
"A4,C3",5845,6225,4272,1953,3528,0,1874,1874,1348,526,2.562737643,945,1273,642,158,1,157,1,30,0,0.082802548,empty,mBC-0814-1
"A4,C4",499987,567089,334898,232191,334312,1,204145,204405,167208,37197,4.495201226,120067,227963,165473,47128,26,47102,3,2497,0,0.000934143,mm10,mBC-0814-1
"A4,C5",7884,8428,5451,2977,4954,0,2722,2725,2035,690,2.949275362,1511,10733,3751,1296,0,1296,0,172,0,0.030864198,empty,mBC-0814-1
"A4,C6",6493,7107,4610,2497,4161,0,2346,2348,1770,578,3.062283737,1277,1673,1225,353,0,353,0,77,0,0,empty,mBC-0814-1
"A4,C7",7140,7541,5224,2317,4358,0,2284,2289,1669,620,2.691935484,1161,517,344,89,0,89,0,22,0,0,empty,mBC-0814-1
"A4,C8",5210,5505,3691,1814,3178,0,1654,1660,1174,486,2.41563786,834,1937,1342,424,0,424,0,76,0,0,empty,mBC-0814-1
"A4,C9",4596,4949,3237,1712,2881,0,1567,1569,1140,429,2.657342657,857,6986,2733,838,3,835,2,103,0,0,empty,mBC-0814-1
"A4,C10",5624,5972,4057,1915,3485,0,1833,1834,1319,515,2.561165049,943,1522,1042,317,0,317,0,67,0,0.05362776,empty,mBC-0814-1
"A4,C11",4773,5116,3335,1781,3022,1,1666,1668,1201,467,2.571734475,906,7814,2901,866,1,865,1,114,0,0.068208092,empty,mBC-0814-1
"A4,C12",7845,8494,5617,2877,4933,0,2712,2719,1947,772,2.522020725,1483,2199,1632,460,0,460,0,87,0,0,empty,mBC-0814-1
"A4,D1",4107,4236,2992,1244,2477,0,1296,1297,930,367,2.534059946,650,874,636,177,0,177,0,32,0,0,empty,mBC-0814-1
"A4,D2",5477,5778,4018,1760,3319,0,1734,1738,1254,484,2.590909091,923,1593,1145,343,0,343,0,69,0,0,empty,mBC-0814-1
"A4,D3",1120169,1292758,743245,549513,752119,1,474251,474771,401196,73575,5.452884811,283598,324490,235826,64851,38,64813,2,3330,0,9.2574E-05,mm10,mBC-0814-1
"A4,D4",4537,5046,3177,1869,2871,0,1631,1635,1135,500,2.27,899,1708,1287,340,1,339,1,62,0,0,empty,mBC-0814-1
"A4,D5",3886,4109,2717,1392,2420,0,1341,1341,979,362,2.70441989,696,2366,1712,491,0,491,0,82,0,0,empty,mBC-0814-1
"A4,D6",5061,5531,3594,1937,3135,0,1727,1731,1243,488,2.547131148,954,6154,2441,709,2,707,1,103,0,0,empty,mBC-0814-1
"A4,D7",5556,5973,3966,2007,3495,0,1896,1898,1376,522,2.636015326,1039,2661,1801,535,0,535,0,111,0,0.03364486,empty,mBC-0814-1
"A4,D8",4645,4960,3445,1515,2927,0,1578,1579,1193,386,3.090673575,779,5024,1698,479,2,477,1,70,0,0.012578616,empty,mBC-0814-1
"A4,D9",2824,3162,2002,1160,1800,0,1036,1039,678,361,1.878116343,564,1344,957,258,0,258,0,45,0,0.031007752,empty,mBC-0814-1
"A4,D10",511527,602217,335521,266696,352813,1,226110,226363,184485,41878,4.405296337,137329,126987,92369,26195,17,26178,2,1799,0,3.82E-05,mm10,mBC-0814-1
"A4,D11",3756,3965,2690,1275,2311,2,1218,1225,900,325,2.769230769,624,2263,1645,484,0,484,0,114,0,0,empty,mBC-0814-1
"A4,D12",419501,466512,282771,183741,277089,0,170027,170203,115882,54321,2.133281788,99997,37531,22663,6208,4,6204,2,700,0,0.014829142,mm10,mBC-0814-1
"A4,E1",4807,5014,3432,1582,2973,0,1562,1562,1106,456,2.425438596,797,3699,1645,499,0,499,0,82,0,0.03006012,empty,mBC-0814-1
"A4,E2",3515,3780,2566,1214,2212,0,1129,1133,828,305,2.714754098,589,1315,924,259,1,258,1,55,0,0,empty,mBC-0814-1
"A4,E3",3666,3836,2648,1188,2267,0,1178,1182,846,336,2.517857143,615,1565,1061,359,2,357,1,74,0,0.072829132,empty,mBC-0814-1
"A4,E4",3108,3285,2254,1031,1968,0,1044,1044,764,280,2.728571429,531,851,590,205,0,205,0,49,0,0,empty,mBC-0814-1
"A4,E5",3725,4136,2654,1482,2361,0,1241,1243,886,357,2.481792717,700,952,636,220,0,220,0,44,0,0,empty,mBC-0814-1
"A4,E6",4535,4888,3354,1534,2749,0,1450,1453,1011,442,2.287330317,765,1034,628,197,0,197,0,65,0,0.035532995,empty,mBC-0814-1
"A4,E7",4492,4686,3234,1452,2670,1,1417,1418,1001,417,2.400479616,734,9364,3456,1032,0,1032,0,127,0,0.031976744,empty,mBC-0814-1
"A4,E8",563273,636205,376165,260040,372873,0,230960,231247,180989,50258,3.601197819,135471,192962,140220,38066,28,38038,2,2403,0,0.001183027,mm10,mBC-0814-1
"A4,E9",2833,2980,2029,951,1754,0,942,944,681,263,2.589353612,485,1566,1067,326,0,326,0,73,0,0,empty,mBC-0814-1
"A4,E10",4146,4654,2958,1696,2709,0,1529,1532,1087,445,2.442696629,865,1440,992,295,0,295,0,72,0,0.003389831,empty,mBC-0814-1
"A4,E11",4006,4305,2923,1382,2520,0,1361,1367,975,392,2.487244898,702,2163,1691,437,0,437,0,80,0,0.00228833,empty,mBC-0814-1
"A4,E12",3769,4057,2682,1375,2435,0,1318,1321,912,409,2.229828851,697,1302,899,214,0,214,0,49,0,0,empty,mBC-0814-1
"A4,F1",4590,5027,3272,1755,2897,0,1593,1593,1135,458,2.478165939,890,1766,1147,380,0,380,0,73,0,0.042105263,empty,mBC-0814-1
"A4,F2",6522,6872,4783,2089,3960,0,2088,2089,1461,628,2.326433121,1053,2363,1698,473,0,473,0,104,0,0.029598309,empty,mBC-0814-1
"A4,F3",4990,5412,3612,1800,3170,0,1693,1693,1199,494,2.427125506,950,1735,1250,399,2,397,1,79,0,0.035264484,empty,mBC-0814-1
"A4,F4",5246,5379,3639,1740,3192,0,1695,1704,1254,450,2.786666667,898,590,447,92,0,92,0,28,0,0,empty,mBC-0814-1
"A4,F5",5044,5544,3620,1924,3124,0,1655,1657,1215,442,2.748868778,886,1093,741,213,1,212,1,56,0,0,empty,mBC-0814-1
"A4,F6",4765,5416,3332,2084,3038,0,1659,1660,1199,461,2.600867679,922,1718,1044,334,1,333,1,84,0,0.03003003,empty,mBC-0814-1
"A4,F7",4330,4678,3069,1609,2775,0,1470,1472,1052,420,2.504761905,806,598,357,133,0,133,0,39,0,0,empty,mBC-0814-1
"A4,F8",6032,6392,4441,1951,3656,0,1894,1899,1395,504,2.767857143,960,436,246,109,0,109,0,18,0,0,empty,mBC-0814-1
"A4,F9",5498,5776,3987,1789,3382,0,1826,1828,1349,479,2.816283925,937,1670,1157,342,0,342,0,84,0,0,empty,mBC-0814-1
"A4,F10",710134,808142,483243,324899,470840,1,286126,286442,221501,64941,3.410803653,167334,134630,99614,27268,14,27254,3,1858,0,0.000110076,mm10,mBC-0814-1
"A4,F11",4374,4764,3055,1709,2724,0,1467,1469,1069,400,2.6725,805,1374,960,291,0,291,0,59,0,0,empty,mBC-0814-1
"A4,F12",4917,5059,3482,1577,2932,0,1574,1574,1100,474,2.320675105,775,511,154,70,0,70,0,18,0,0.057142857,empty,mBC-0814-1
"A4,G1",7470,7951,5367,2584,4608,1,2427,2431,1696,735,2.307482993,1287,9313,3783,1239,1,1238,1,193,0,0.011308562,empty,mBC-0814-1
"A4,G2",5557,5890,3989,1901,3468,0,1864,1867,1335,532,2.509398496,959,400,269,77,0,77,0,20,0,0,empty,mBC-0814-1
"A4,G3",5316,5786,3802,1984,3311,2,1803,1806,1294,512,2.52734375,1017,3366,2052,592,1,591,1,106,0,0.074450085,empty,mBC-0814-1
"A4,G4",5467,5705,3859,1846,3331,0,1756,1758,1236,522,2.367816092,951,586,206,53,0,53,0,13,0,0.264150943,empty,mBC-0814-1
"A4,G5",4606,4919,3267,1652,2867,0,1500,1502,1044,458,2.279475983,765,1186,795,187,0,187,0,54,0,0,empty,mBC-0814-1
"A4,G6",8793,9450,6361,3089,5521,2,2925,2930,2138,792,2.699494949,1503,290,190,53,0,53,0,16,0,0,empty,mBC-0814-1
"A4,G7",5197,5430,3743,1687,3177,0,1709,1710,1193,517,2.30754352,872,2859,1837,522,0,522,0,110,0,0.001915709,empty,mBC-0814-1
"A4,G8",6766,7427,4777,2650,4372,0,2448,2452,1749,703,2.487908962,1352,3791,2757,793,1,792,1,151,0,0.056818182,empty,mBC-0814-1
"A4,G9",5046,5458,3590,1868,3147,0,1744,1747,1212,535,2.265420561,942,3116,2256,678,0,678,0,121,0,0.001474926,empty,mBC-0814-1
"A4,G10",8796,9216,6355,2861,5373,0,2826,2837,2002,835,2.39760479,1463,2893,1918,557,0,557,0,144,0,0,empty,mBC-0814-1
"A4,G11",9136,9716,6591,3125,5667,0,3023,3028,2207,821,2.68818514,1586,1408,1043,350,0,350,0,77,0,0.042857143,empty,mBC-0814-1
"A4,G12",4845,5166,3378,1788,3106,5,1685,1692,1196,496,2.411290323,965,2496,1780,561,0,561,0,115,0,0,empty,mBC-0814-1
"A4,H1",4600,4933,3272,1661,2896,0,1619,1621,1161,460,2.523913043,858,5454,1783,570,0,570,0,81,0,0.09122807,empty,mBC-0814-1
"A4,H2",7983,8716,5695,3021,5076,0,2803,2804,1961,843,2.326215896,1555,3296,2424,726,0,726,0,150,0,0.00137741,empty,mBC-0814-1
"A4,H3",5070,5311,3704,1607,3183,0,1725,1729,1234,495,2.492929293,883,1829,1300,363,0,363,0,68,0,0,empty,mBC-0814-1
"A4,H4",5357,5707,3807,1900,3296,0,1800,1805,1296,509,2.546168959,950,36,17,14,0,14,0,12,0,0,empty,mBC-0814-1
"A4,H5",6815,7346,4846,2500,4263,0,2344,2353,1669,684,2.44005848,1295,1525,1043,337,0,337,0,62,0,0,empty,mBC-0814-1
"A4,H6",6314,6506,4354,2152,3820,0,2073,2077,1486,591,2.514382403,1101,2310,1733,436,0,436,0,86,0,0.002293578,empty,mBC-0814-1
"A4,H7",5183,5424,3709,1715,3200,0,1670,1672,1209,463,2.611231102,875,1770,1365,323,0,323,0,60,0,0.015479876,empty,mBC-0814-1
"A4,H8",4303,4641,3090,1551,2643,0,1435,1439,1046,393,2.661577608,756,1861,1406,369,0,369,0,78,0,0.010840108,empty,mBC-0814-1
"A4,H9",4653,4879,3348,1531,2860,0,1507,1511,1098,413,2.658595642,796,1119,779,238,0,238,0,50,0,0,empty,mBC-0814-1
"A4,H10",3483,3849,2459,1390,2205,0,1241,1241,884,357,2.476190476,702,846,562,207,0,207,0,52,0,0.09178744,empty,mBC-0814-1
"A4,H11",3717,4039,2670,1369,2406,1,1296,1300,925,375,2.466666667,726,69,24,12,0,12,0,9,0,0,empty,mBC-0814-1
"A4,H12",2445,2568,1724,844,1489,0,839,839,598,241,2.481327801,456,2029,1153,350,0,350,0,75,0,0.02,empty,mBC-0814-1
"A5,A1",5331,5747,3813,1934,3418,0,1874,1878,1325,553,2.3960217,967,1441,1028,287,0,287,0,75,0,0,empty,mBC-0814-1
"A5,A2",5049,5441,3633,1808,3247,1,1787,1790,1321,469,2.81663113,979,1465,1019,325,1,324,1,106,0,0.012345679,empty,mBC-0814-1
"A5,A3",4434,4710,3226,1484,2727,0,1484,1485,1040,445,2.337078652,776,1249,827,254,1,253,1,63,0,0,empty,mBC-0814-1
"A5,A4",537516,608670,366824,241846,360804,0,221115,221359,172240,49119,3.506586046,129062,17087,11809,3474,0,3474,0,395,0,0.002590674,mm10,mBC-0814-1
"A5,A5",4449,4838,3181,1657,2958,0,1635,1637,1174,463,2.535637149,905,1183,833,266,0,266,0,60,0,0.037593985,empty,mBC-0814-1
"A5,A6",3604,3989,2506,1483,2322,0,1306,1308,927,381,2.433070866,745,1231,793,263,0,263,0,67,0,0.015209125,empty,mBC-0814-1
"A5,A7",515692,604273,340421,263852,360769,0,230876,231107,176599,54508,3.239873046,139966,149706,109059,30935,20,30915,2,1975,0,3.23468E-05,mm10,mBC-0814-1
"A5,A8",1966,2131,1415,716,1274,0,695,695,485,210,2.30952381,351,3265,1681,556,2,554,1,100,0,0.036101083,empty,mBC-0814-1
"A5,A9",6013,6623,4275,2348,3848,0,2084,2085,1521,564,2.696808511,1169,1613,1070,288,1,287,1,54,0,0,empty,mBC-0814-1
"A5,A10",3354,3706,2347,1359,2164,0,1184,1184,819,365,2.243835616,663,196,140,61,0,61,0,21,0,0,empty,mBC-0814-1
"A5,A11",4324,4604,3094,1510,2815,0,1509,1512,1110,402,2.76119403,803,1468,998,363,0,363,0,96,0,0.038567493,empty,mBC-0814-1
"A5,A12",232075,255135,153855,101280,152332,1,91078,91175,76719,14456,5.307069729,52946,356880,267583,80550,38,80512,3,3125,0,0.000111785,mm10,mBC-0814-1
"A5,B1",4256,4459,3163,1296,2644,5,1404,1413,1032,381,2.708661417,688,2292,1167,395,0,395,0,86,0,0.005063291,empty,mBC-0814-1
"A5,B2",519878,594130,336882,257248,356062,0,223910,224119,171454,52665,3.25555872,135758,47073,32111,9500,4,9496,1,861,0,0,mm10,mBC-0814-1
"A5,B3",4135,4384,2891,1493,2737,0,1564,1566,1119,447,2.503355705,834,950,681,226,0,226,0,50,0,0,empty,mBC-0814-1
"A5,B4",3826,4344,2742,1602,2600,0,1443,1444,1029,415,2.479518072,811,998,659,217,0,217,0,62,0,0.046082949,empty,mBC-0814-1
"A5,B5",3356,2306,1478,828,1603,0,886,889,619,270,2.292592593,473,868,590,192,0,192,0,56,0,0,empty,mBC-0814-1
"A5,B6",3620,3974,2503,1471,2324,1,1313,1317,917,400,2.2925,719,1020,698,197,0,197,0,46,0,0.055837563,empty,mBC-0814-1
"A5,B7",577500,666465,393362,273103,395299,3,241770,242029,204556,37473,5.458756972,142382,154524,108402,30039,17,30022,4,1998,0,3.33089E-05,mm10,mBC-0814-1
"A5,B8",3436,3745,2506,1239,2202,0,1161,1163,845,318,2.657232704,606,1032,765,279,0,279,0,57,0,0.003584229,empty,mBC-0814-1
"A5,B9",5394,6066,3831,2235,3566,0,2023,2026,1283,743,1.726783311,1091,2339,1278,368,0,368,0,107,0,0.048913043,empty,mBC-0814-1
"A5,B10",3822,4011,2686,1325,2449,0,1426,1432,1000,432,2.314814815,748,805,497,161,0,161,0,29,0,0,empty,mBC-0814-1
"A5,B11",555573,596104,385032,211072,350539,0,200742,200970,157455,43515,3.618407446,111606,1539,1056,336,0,336,0,59,0,0,empty,mBC-0814-1
"A5,B12",424309,503855,279831,224024,302222,2,192172,192388,157807,34581,4.563401868,117537,186486,131162,36209,18,36191,2,2199,0,0.000773673,mm10,mBC-0814-1
"A5,C1",5252,5553,3700,1853,3316,0,1756,1760,1220,540,2.259259259,914,1824,1074,274,1,273,1,55,0,0.021978022,empty,mBC-0814-1
"A5,C2",5049,5514,3610,1904,3273,0,1802,1804,1302,502,2.593625498,996,4842,1987,650,2,648,1,129,0,0.020061728,empty,mBC-0814-1
"A5,C3",505590,551459,358810,192649,327508,1,185460,185713,119451,66262,1.802707434,104188,12919,5939,1710,1,1709,1,242,0,0.033352838,mm10,mBC-0814-1
"A5,C4",4830,5068,3434,1634,3100,0,1656,1660,1208,452,2.672566372,871,999,709,245,0,245,0,90,0,0.06122449,empty,mBC-0814-1
"A5,C5",6689,7121,4839,2282,4171,0,2194,2198,1606,592,2.712837838,1125,1706,1161,344,0,344,0,92,0,0.002906977,empty,mBC-0814-1
"A5,C6",5133,5693,3557,2136,3480,0,1932,1932,1414,518,2.72972973,1101,1073,626,238,0,238,0,74,0,0,empty,mBC-0814-1
"A5,C7",6401,7200,4639,2561,4230,0,2305,2307,1641,666,2.463963964,1253,649,461,141,0,141,0,32,0,0,empty,mBC-0814-1
"A5,C8",5150,5308,3724,1584,3188,0,1640,1643,1181,462,2.556277056,837,1533,1090,326,0,326,0,84,0,0,empty,mBC-0814-1
"A5,C9",4361,4672,3071,1601,2763,1,1543,1544,1133,411,2.756690998,806,1067,774,229,0,229,0,44,0,0,empty,mBC-0814-1
"A5,C10",5530,5835,3846,1989,3349,0,1790,1793,1250,543,2.302025783,943,15597,5511,1792,0,1792,0,156,0,0.169084821,empty,mBC-0814-1
"A5,C11",4401,4838,3097,1741,2846,0,1674,1675,1156,519,2.227360308,899,1415,1012,391,0,391,0,82,0,0,empty,mBC-0814-1
"A5,C12",7775,8249,5473,2776,4905,0,2696,2697,1946,751,2.591211718,1450,2106,1392,384,0,384,0,89,0,0,empty,mBC-0814-1
"A5,D1",4216,4665,3005,1660,2651,0,1456,1459,1062,397,2.675062972,752,1065,491,144,0,144,0,28,0,0,empty,mBC-0814-1
"A5,D2",4648,4711,3422,1289,2860,0,1413,1423,1007,416,2.420673077,677,1761,1333,462,0,462,0,86,0,0,empty,mBC-0814-1
"A5,D3",10155,11272,7217,4055,6617,3,3640,3647,2582,1065,2.424413146,2022,6223,2609,871,1,870,1,143,0,0.002298851,empty,mBC-0814-1
"A5,D4",714832,854477,464593,389884,515355,2,342196,342485,235517,106968,2.201751926,211734,184965,124385,35607,19,35588,1,2365,0,0.002304147,mm10,mBC-0814-1
"A5,D5",394624,448453,261964,186489,269646,0,164396,164594,132745,31849,4.167948758,97616,391400,278476,78752,37,78715,5,3616,0,0.000584387,mm10,mBC-0814-1
"A5,D6",4737,5140,3359,1781,3064,0,1687,1689,1225,464,2.640086207,930,1162,734,237,1,236,1,61,0,0,empty,mBC-0814-1
"A5,D7",5514,5978,3939,2039,3546,0,1924,1924,1395,529,2.63705104,1056,2143,1505,485,0,485,0,110,0,0.002061856,empty,mBC-0814-1
"A5,D8",347312,380130,226895,153235,224770,1,135589,135797,112272,23525,4.772454835,78869,97968,71517,20172,16,20156,3,1494,0,9.9226E-05,mm10,mBC-0814-1
"A5,D9",3075,3350,2176,1174,1930,0,1123,1124,794,330,2.406060606,580,1169,669,207,0,207,0,56,0,0,empty,mBC-0814-1
"A5,D10",3549,3844,2475,1369,2229,0,1221,1224,916,308,2.974025974,642,805,435,151,0,151,0,36,0,0,empty,mBC-0814-1
"A5,D11",3972,4413,2855,1558,2571,0,1406,1407,990,417,2.374100719,770,2062,1558,446,2,444,1,137,0,0,empty,mBC-0814-1
"A5,D12",5923,6459,4186,2273,3757,0,2088,2092,1480,612,2.418300654,1115,3259,2394,636,2,634,1,118,0,0.014195584,empty,mBC-0814-1
"A5,E1",4714,4949,3393,1556,2996,0,1597,1601,1136,465,2.443010753,828,1351,1007,316,0,316,0,63,0,0.034810127,empty,mBC-0814-1
"A5,E2",3414,3728,2446,1282,2214,3,1178,1188,844,344,2.453488372,618,1313,1035,250,0,250,0,75,0,0,empty,mBC-0814-1
"A5,E3",339871,392406,229546,162860,232335,1,143271,143458,117203,26255,4.4640259,84031,181648,132052,37900,25,37875,2,2299,0,2.64026E-05,mm10,mBC-0814-1
"A5,E4",2947,3220,2140,1080,1824,0,996,1001,723,278,2.600719424,509,686,438,158,0,158,0,49,0,0.025316456,empty,mBC-0814-1
"A5,E5",3573,3955,2556,1399,2321,0,1249,1254,931,323,2.882352941,689,2414,1158,331,0,331,0,66,0,0,empty,mBC-0814-1
"A5,E6",4061,4239,2871,1368,2526,0,1324,1325,945,380,2.486842105,730,1071,669,220,0,220,0,61,0,0,empty,mBC-0814-1
"A5,E7",3880,4101,2790,1311,2470,0,1296,1303,937,366,2.56010929,692,985,514,152,1,151,1,47,0,0,empty,mBC-0814-1
"A5,E8",4331,4619,3150,1469,2717,0,1430,1433,1061,372,2.852150538,745,1428,980,303,0,303,0,73,0,0,empty,mBC-0814-1
"A5,E9",3234,3421,2357,1064,1988,0,1073,1077,771,306,2.519607843,521,1259,789,257,0,257,0,76,0,0.062256809,empty,mBC-0814-1
"A5,E10",3958,4386,2840,1546,2603,0,1476,1477,1023,454,2.253303965,782,1497,1078,370,0,370,0,92,0,0,empty,mBC-0814-1
"A5,E11",317323,364351,211775,152576,220356,0,135702,135853,117835,18018,6.53984904,80825,221324,157679,45089,26,45063,3,2418,0,0.000332867,mm10,mBC-0814-1
"A5,E12",729468,852514,486368,366146,507890,1,317764,318147,263389,54758,4.810055152,191104,417617,301975,86060,42,86018,5,3737,0,0.000139506,mm10,mBC-0814-1
"A5,F1",4363,4630,3158,1472,2688,0,1425,1425,1012,413,2.450363196,753,1326,886,269,0,269,0,71,0,0,empty,mBC-0814-1
"A5,F2",6562,7081,4655,2426,4230,0,2340,2344,1736,608,2.855263158,1220,1988,1287,390,0,390,0,111,0,0,empty,mBC-0814-1
"A5,F3",363500,406621,255524,151097,243703,1,141709,141875,106517,35358,3.012528989,80824,52149,36645,10970,6,10964,2,1110,0,0.000273623,mm10,mBC-0814-1
"A5,F4",482888,542387,325126,217261,326199,0,198482,198711,161164,37547,4.29232695,116069,55131,39577,11228,2,11226,1,1024,0,0.000178158,mm10,mBC-0814-1
"A5,F5",4845,5232,3406,1826,3078,0,1663,1666,1222,444,2.752252252,927,1270,875,224,0,224,0,66,0,0,empty,mBC-0814-1
"A5,F6",4963,5294,3339,1955,3141,0,1787,1789,1304,485,2.688659794,979,1700,1222,379,0,379,0,113,0,0.002638522,empty,mBC-0814-1
"A5,F7",609989,712793,407517,305276,424042,0,266871,267131,222888,44243,5.037813891,160139,71500,50326,15035,8,15027,2,1177,0,0,mm10,mBC-0814-1
"A5,F8",5774,6290,4135,2155,3650,0,1990,1998,1419,579,2.450777202,1084,262,204,62,0,62,0,15,0,0,empty,mBC-0814-1
"A5,F9",5050,5600,3567,2033,3231,3,1767,1770,1224,546,2.241758242,979,4888,2180,692,2,690,1,105,0,0.188405797,empty,mBC-0814-1
"A5,F10",6235,6700,4543,2157,3923,0,2076,2079,1483,596,2.488255034,1080,1406,1064,316,0,316,0,84,0,0,empty,mBC-0814-1
"A5,F11",4050,4261,2834,1427,2514,0,1335,1339,958,381,2.514435696,711,1073,678,224,1,223,1,56,0,0.040358744,empty,mBC-0814-1
"A5,F12",4662,5224,3222,2002,3065,0,1774,1774,1285,489,2.627811861,1027,129,105,32,0,32,0,6,0,0,empty,mBC-0814-1
"A5,G1",6959,7253,4873,2380,4329,0,2290,2293,1647,646,2.549535604,1203,9719,4273,1386,1,1385,1,207,0,0.040433213,empty,mBC-0814-1
"A5,G2",5191,5438,3692,1746,3274,0,1794,1796,1256,540,2.325925926,932,326,192,79,0,79,0,16,0,0,empty,mBC-0814-1
"A5,G3",4894,5169,3457,1712,3095,0,1696,1700,1213,487,2.490759754,921,2435,1704,500,0,500,0,119,0,0,empty,mBC-0814-1
"A5,G4",5303,5848,3821,2027,3535,0,1909,1916,1328,588,2.258503401,1085,3,2,1,0,1,0,1,0,0,empty,mBC-0814-1
"A5,G5",4325,4882,3068,1814,2868,1,1611,1614,1138,476,2.390756303,901,1375,796,256,0,256,0,76,0,0.01171875,empty,mBC-0814-1
"A5,G6",8239,8647,5961,2686,5102,0,2710,2713,1904,809,2.353522868,1410,327,257,88,0,88,0,14,0,0,empty,mBC-0814-1
"A5,G7",5148,5626,3761,1865,3334,0,1793,1793,1293,500,2.586,933,2170,1434,517,1,516,1,106,0,0.019379845,empty,mBC-0814-1
"A5,G8",6814,7580,4776,2804,4510,0,2571,2573,1828,745,2.453691275,1457,3758,2464,758,0,758,0,156,0,0,empty,mBC-0814-1
"A5,G9",4938,5289,3567,1722,3191,0,1702,1711,1254,457,2.743982495,902,2380,1714,511,1,510,1,143,0,0,empty,mBC-0814-1
"A5,G10",8367,9082,6075,3007,5365,0,2895,2899,2121,778,2.72622108,1500,3475,2367,810,0,810,0,170,0,0,empty,mBC-0814-1
"A5,G11",8662,9458,6141,3317,5582,0,3000,3008,2208,800,2.76,1666,3357,1435,507,0,507,0,99,0,0.029585799,empty,mBC-0814-1
"A5,G12",4184,4464,2950,1514,2751,0,1507,1513,1109,404,2.745049505,850,2221,1569,525,0,525,0,102,0,0,empty,mBC-0814-1
"A5,H1",4169,4530,2947,1583,2689,0,1462,1465,1052,413,2.547215496,790,729,541,166,0,166,0,53,0,0.006024096,empty,mBC-0814-1
"A5,H2",7763,8310,5588,2722,4862,0,2692,2698,1960,738,2.655826558,1392,3000,2155,688,0,688,0,156,0,0,empty,mBC-0814-1
"A5,H3",5259,5739,3722,2017,3399,3,1889,1896,1372,524,2.618320611,1038,1692,1241,353,1,352,1,92,0,0,empty,mBC-0814-1
"A5,H4",574556,674225,373479,300746,395233,0,256204,256463,214551,41912,5.11908284,155672,5944,3944,1164,0,1164,0,145,0,0,mm10,mBC-0814-1
"A5,H5",6214,6698,4515,2183,3903,1,2082,2083,1489,594,2.506734007,1104,1752,1287,355,1,354,1,64,0,0.02259887,empty,mBC-0814-1
"A5,H6",5962,6429,4323,2106,3776,1,2032,2038,1470,568,2.588028169,1069,4572,2430,769,1,768,1,145,0,0.016927083,empty,mBC-0814-1
"A5,H7",4809,5217,3396,1821,3178,0,1793,1795,1258,537,2.34264432,953,2654,1481,462,2,460,1,85,0,0.032608696,empty,mBC-0814-1
"A5,H8",307986,338062,209248,128814,203499,1,121022,121158,98949,22209,4.455355937,69803,15952,11389,3342,2,3340,1,484,0,0.000299401,mm10,mBC-0814-1
"A5,H9",4695,4960,3339,1621,2934,0,1608,1610,1136,474,2.396624473,838,1224,917,300,0,300,0,60,0,0,empty,mBC-0814-1
"A5,H10",3368,3637,2466,1171,2163,0,1222,1225,900,325,2.769230769,646,697,504,179,0,179,0,50,0,0,empty,mBC-0814-1
"A5,H11",3554,3815,2526,1289,2267,0,1248,1251,919,332,2.768072289,680,178,158,29,0,29,0,7,0,0,empty,mBC-0814-1
"A5,H12",2587,2891,1786,1105,1751,0,1012,1013,750,263,2.851711027,602,940,680,202,0,202,0,61,0,0,empty,mBC-0814-1
"A6,A1",5260,5546,3850,1696,3242,0,1766,1769,1335,434,3.076036866,860,1054,768,212,0,212,0,57,0,0,empty,mBC-0814-1
"A6,A2",5429,5679,3861,1818,3352,0,1826,1826,1365,461,2.960954447,966,6321,2448,799,0,799,0,136,0,0.11514393,empty,mBC-0814-1
"A6,A3",4779,5153,3305,1848,2929,0,1624,1628,1164,464,2.50862069,890,15848,4924,1588,5,1583,2,168,0,0.124447252,empty,mBC-0814-1
"A6,A4",5260,5704,3833,1871,3282,5,1726,1734,1245,489,2.54601227,942,6229,1433,471,0,471,0,59,0,0,empty,mBC-0814-1
"A6,A5",4569,4723,3286,1437,2784,0,1466,1466,1012,454,2.22907489,737,1272,717,214,0,214,0,48,0,0,empty,mBC-0814-1
"A6,A6",3788,3950,2703,1247,2280,0,1249,1253,880,373,2.35924933,626,1080,796,236,0,236,0,56,0,0,empty,mBC-0814-1
"A6,A7",5481,5826,3861,1965,3433,0,1889,1894,1319,575,2.293913043,998,1742,1155,340,0,340,0,76,0,0,empty,mBC-0814-1
"A6,A8",2222,2418,1593,825,1392,0,791,794,561,233,2.407725322,407,1377,982,288,0,288,0,75,0,0.003472222,empty,mBC-0814-1
"A6,A9",6524,6898,4697,2201,3937,0,2091,2095,1486,609,2.440065681,1108,1252,733,276,0,276,0,57,0,0,empty,mBC-0814-1
"A6,A10",3732,4072,2749,1323,2281,0,1244,1244,903,341,2.648093842,643,246,141,34,0,34,0,11,0,0,empty,mBC-0814-1
"A6,A11",4826,5250,3469,1781,3038,0,1620,1623,1109,514,2.157587549,876,2007,1216,393,0,393,0,91,0,0,empty,mBC-0814-1
"A6,A12",4025,4439,2918,1521,2582,0,1430,1437,1060,377,2.811671088,823,2781,1983,661,0,661,0,148,0,0,empty,mBC-0814-1
"A6,B1",4793,5161,3429,1732,2943,0,1560,1560,1071,489,2.190184049,869,1050,740,227,0,227,0,62,0,0,empty,mBC-0814-1
"A6,B2",4456,4820,3083,1737,2804,0,1513,1517,1085,432,2.511574074,854,274,183,64,0,64,0,26,0,0.296875,empty,mBC-0814-1
"A6,B3",4021,4311,2752,1559,2518,0,1397,1397,980,417,2.350119904,776,4967,1834,548,1,547,1,88,0,0.036563071,empty,mBC-0814-1
"A6,B4",4183,4453,3018,1435,2666,0,1454,1454,1043,411,2.537712895,760,1027,728,212,0,212,0,61,0,0,empty,mBC-0814-1
"A6,B5",3561,2197,1467,730,1580,0,835,839,604,235,2.570212766,491,829,588,188,0,188,0,62,0,0,empty,mBC-0814-1
"A6,B6",3945,4322,2839,1483,2538,0,1399,1399,979,420,2.330952381,751,1108,685,191,0,191,0,41,0,0,empty,mBC-0814-1
"A6,B7",745997,850967,507873,343094,490223,2,300954,301361,223380,77981,2.864543927,176341,69307,50545,14017,12,14005,2,1175,0,0.001499464,mm10,mBC-0814-1
"A6,B8",3681,4040,2671,1369,2246,0,1169,1169,837,332,2.521084337,600,898,691,207,1,206,1,57,0,0,empty,mBC-0814-1
"A6,B9",4541,4901,3217,1684,2854,1,1566,1574,1114,460,2.42173913,834,813,537,146,0,146,0,53,0,0,empty,mBC-0814-1
"A6,B10",4329,4532,3019,1513,2601,3,1407,1411,959,452,2.121681416,716,903,264,83,0,83,0,22,0,0,empty,mBC-0814-1
"A6,B11",6346,6928,4614,2314,3981,0,2128,2129,1519,610,2.490163934,1129,95,74,39,0,39,0,7,0,0,empty,mBC-0814-1
"A6,B12",5201,5685,3739,1946,3275,0,1821,1834,1341,493,2.720081136,958,1172,791,243,0,243,0,55,0,0,empty,mBC-0814-1
"A6,C1",5222,5715,3771,1944,3281,0,1747,1749,1226,523,2.34416826,928,774,514,154,0,154,0,37,0,0,empty,mBC-0814-1
"A6,C2",565538,665002,377903,287099,385131,0,242719,242982,202093,40889,4.942478417,146312,245470,173613,48545,33,48512,1,2657,0,0,mm10,mBC-0814-1
"A6,C3",570523,675556,381995,293561,392543,0,249192,249463,197832,51631,3.831651527,150671,42132,30562,8805,7,8798,2,814,0,0.000227324,mm10,mBC-0814-1
"A6,C4",4920,5111,3528,1583,2968,0,1552,1552,1078,474,2.274261603,804,1337,952,286,0,286,0,64,0,0.003496503,empty,mBC-0814-1
"A6,C5",8733,9347,6133,3214,5466,0,3068,3076,2216,860,2.576744186,1691,1063,759,233,0,233,0,67,0,0,empty,mBC-0814-1
"A6,C6",5077,5284,3726,1558,3142,0,1666,1666,1233,433,2.847575058,847,1375,909,251,0,251,0,63,0,0.003984064,empty,mBC-0814-1
"A6,C7",6799,7156,4904,2252,4129,0,2175,2176,1530,646,2.368421053,1122,190,118,27,0,27,0,12,0,0,empty,mBC-0814-1
"A6,C8",5228,5487,3780,1707,3202,0,1675,1675,1236,439,2.815489749,908,1790,1285,426,0,426,0,83,0,0.002347418,empty,mBC-0814-1
"A6,C9",4546,5221,3286,1935,2876,0,1566,1570,1122,448,2.504464286,894,1082,736,221,0,221,0,47,0,0.085972851,empty,mBC-0814-1
"A6,C10",5378,5628,3851,1777,3198,0,1658,1661,1158,503,2.302186879,872,706,475,168,0,168,0,48,0,0,empty,mBC-0814-1
"A6,C11",4444,5013,3147,1866,2873,0,1606,1607,1160,447,2.5950783,892,3885,1570,479,0,479,0,80,0,0,empty,mBC-0814-1
"A6,C12",8517,9251,6080,3171,5094,0,2762,2765,1938,827,2.343409915,1509,1411,997,257,0,257,0,58,0,0,empty,mBC-0814-1
"A6,D1",4399,4666,3188,1478,2729,0,1455,1457,1063,394,2.697969543,743,357,219,93,0,93,0,32,0,0.161290323,empty,mBC-0814-1
"A6,D2",4838,5088,3578,1510,2905,0,1492,1498,1085,413,2.627118644,778,1168,881,250,0,250,0,70,0,0.08,empty,mBC-0814-1
"A6,D3",630064,740546,406095,334451,435393,2,295754,296122,172888,123234,1.402924518,181949,28091,14011,3811,4,3807,1,494,0,0.024691358,mm10,mBC-0814-1
"A6,D4",495679,580964,329090,251874,340164,3,214755,214985,177620,37365,4.753646461,129705,185646,126090,36374,19,36355,2,2230,0,8.25196E-05,mm10,mBC-0814-1
"A6,D5",370202,434550,239831,194719,255930,0,163091,163264,139995,23269,6.016373716,99725,174329,124912,34685,22,34663,2,2153,0,0.000317341,mm10,mBC-0814-1
"A6,D6",523087,634485,340357,294128,369483,0,245969,246271,186354,59917,3.110202447,152527,87290,59854,16928,16,16912,3,1432,0,0.000118259,mm10,mBC-0814-1
"A6,D7",5934,6190,4211,1979,3675,0,1934,1940,1419,521,2.723608445,1016,5346,2047,687,1,686,1,103,0,0.014577259,empty,mBC-0814-1
"A6,D8",4640,4948,3245,1703,2865,0,1579,1582,1164,418,2.784688995,834,2135,962,292,0,292,0,58,0,0,empty,mBC-0814-1
"A6,D9",3362,3552,2411,1141,2028,0,1095,1098,786,312,2.519230769,567,1268,904,255,0,255,0,43,0,0,empty,mBC-0814-1
"A6,D10",4257,4580,2965,1615,2667,0,1451,1453,1035,418,2.476076555,808,468,297,99,0,99,0,38,0,0,empty,mBC-0814-1
"A6,D11",3903,4228,2770,1458,2483,0,1365,1365,958,407,2.353808354,737,1387,979,357,0,357,0,109,0,0,empty,mBC-0814-1
"A6,D12",6213,6709,4384,2325,3905,3,2212,2215,1586,629,2.521462639,1207,3101,2218,642,1,641,1,116,0,0,empty,mBC-0814-1
"A6,E1",4900,5090,3570,1520,3006,0,1561,1561,1094,467,2.34261242,826,615,405,168,0,168,0,46,0,0,empty,mBC-0814-1
"A6,E2",3524,3895,2523,1372,2206,0,1187,1187,856,331,2.586102719,633,669,482,144,0,144,0,55,0,0.020833333,empty,mBC-0814-1
"A6,E3",3425,3685,2469,1216,2098,0,1091,1091,766,325,2.356923077,591,1039,652,243,0,243,0,55,0,0,empty,mBC-0814-1
"A6,E4",3224,3398,2372,1026,1948,0,1036,1037,730,307,2.377850163,528,768,636,176,0,176,0,43,0,0,empty,mBC-0814-1
"A6,E5",340094,379475,231283,148192,224825,1,136331,136518,108350,28168,3.846563476,79058,9285,5871,1659,0,1659,0,255,0,0,mm10,mBC-0814-1
"A6,E6",4237,4584,3127,1457,2657,2,1454,1458,1080,378,2.857142857,749,1010,722,225,0,225,0,62,0,0,empty,mBC-0814-1
"A6,E7",4170,4196,3047,1149,2450,0,1284,1286,887,399,2.223057644,605,1154,739,235,0,235,0,62,0,0.021276596,empty,mBC-0814-1
"A6,E8",4377,4620,3222,1398,2657,0,1376,1377,1005,372,2.701612903,711,1621,1246,351,1,350,1,76,0,0,empty,mBC-0814-1
"A6,E9",982723,1123256,656863,466393,644905,1,402822,403366,309638,93728,3.303580574,237829,370299,267224,75604,44,75560,3,3522,0,0.000105876,mm10,mBC-0814-1
"A6,E10",607871,695848,414359,281489,401956,1,241482,241819,199008,42811,4.648524912,141242,257755,188130,52322,21,52301,2,2830,0,0,mm10,mBC-0814-1
"A6,E11",399678,470485,264925,205560,278297,0,175387,175582,142373,33209,4.287181186,106205,248009,178978,50397,25,50372,1,2740,0,0.000337489,mm10,mBC-0814-1
"A6,E12",4052,4298,2900,1398,2526,0,1381,1384,968,416,2.326923077,706,980,685,229,0,229,0,53,0,0,empty,mBC-0814-1
"A6,F1",4695,5202,3457,1745,2934,0,1545,1547,1143,404,2.829207921,812,1122,748,250,0,250,0,60,0,0,empty,mBC-0814-1
"A6,F2",6425,6984,4602,2382,4127,0,2234,2236,1585,651,2.434715822,1210,1215,772,265,0,265,0,94,0,0.00754717,empty,mBC-0814-1
"A6,F3",5119,5625,3726,1899,3173,0,1769,1771,1242,529,2.347826087,952,1646,1219,384,0,384,0,82,0,0,empty,mBC-0814-1
"A6,F4",5366,5643,3757,1886,3323,0,1788,1796,1270,526,2.414448669,930,275,83,37,0,37,0,15,0,0,empty,mBC-0814-1
"A6,F5",4932,5224,3480,1744,2998,7,1585,1594,1178,416,2.831730769,847,988,739,217,0,217,0,47,0,0.032258065,empty,mBC-0814-1
"A6,F6",4818,5166,3346,1820,2960,0,1644,1649,1145,504,2.271825397,887,1333,967,318,0,318,0,80,0,0,empty,mBC-0814-1
"A6,F7",729832,849606,489266,360340,492722,0,309127,309495,238964,70531,3.388070494,185011,84639,61932,17569,11,17558,3,1324,0,5.69541E-05,mm10,mBC-0814-1
"A6,F8",685385,793944,453987,339957,458777,2,289575,289903,229796,60107,3.823115444,172806,11138,7702,2307,4,2303,1,292,0,0.000434216,mm10,mBC-0814-1
"A6,F9",5333,5480,3954,1526,3150,0,1606,1606,1161,445,2.608988764,791,1772,1341,434,0,434,0,90,0,0.002304147,empty,mBC-0814-1
"A6,F10",673168,783753,455894,327859,451993,1,277114,277470,231028,46442,4.9745489,164123,229284,165603,46082,29,46053,1,2609,0,0.002106269,mm10,mBC-0814-1
"A6,F11",4098,4401,2988,1413,2573,0,1333,1334,952,382,2.492146597,717,2387,1037,314,0,314,0,73,0,0,empty,mBC-0814-1
"A6,F12",4907,5389,3426,1963,2970,0,1629,1634,1163,471,2.469214437,908,126,104,34,0,34,0,10,0,0,empty,mBC-0814-1
"A6,G1",7683,8482,5513,2969,4804,0,2581,2585,1808,777,2.326898327,1346,2739,1908,612,0,612,0,137,0,0.001633987,empty,mBC-0814-1
"A6,G2",5662,6036,4121,1915,3408,0,1768,1770,1205,565,2.132743363,910,567,389,119,0,119,0,18,0,0,empty,mBC-0814-1
"A6,G3",349232,417786,223223,194563,241182,2,160645,160827,103378,57449,1.799474316,99221,97737,67936,19518,12,19506,1,1478,0,0.00082026,mm10,mBC-0814-1
"A6,G4",5283,5790,3777,2013,3346,0,1787,1791,1255,536,2.34141791,973,49,18,5,0,5,0,1,0,0,empty,mBC-0814-1
"A6,G5",4389,4715,3113,1602,2741,0,1505,1507,1076,431,2.496519722,829,1369,947,253,1,252,1,41,0,0,empty,mBC-0814-1
"A6,G6",8394,8921,6149,2772,5234,0,2766,2770,1932,838,2.30548926,1420,197,59,26,1,25,1,17,0,0,empty,mBC-0814-1
"A6,G7",5357,5776,3798,1978,3363,0,1768,1772,1273,499,2.551102204,985,1848,1401,411,0,411,0,89,0,0.01946472,empty,mBC-0814-1
"A6,G8",7409,7954,5330,2624,4571,5,2511,2519,1797,722,2.488919668,1340,2717,1617,513,1,512,1,121,0,0.00390625,empty,mBC-0814-1
"A6,G9",5259,5779,3819,1960,3312,0,1783,1791,1263,528,2.392045455,932,1883,1202,353,0,353,0,101,0,0,empty,mBC-0814-1
"A6,G10",8853,9413,6377,3036,5447,0,2942,2944,2118,826,2.564164649,1545,2771,1855,519,0,519,0,152,0,0.009633911,empty,mBC-0814-1
"A6,G11",8876,9515,6575,2940,5490,0,2849,2853,2032,821,2.475030451,1487,2294,1334,405,0,405,0,72,0,0.066666667,empty,mBC-0814-1
"A6,G12",4800,5334,3416,1918,3077,0,1712,1712,1212,500,2.424,955,2629,1171,398,0,398,0,82,0,0.010050251,empty,mBC-0814-1
"A6,H1",4264,4591,3035,1556,2692,1,1438,1441,997,444,2.245495495,749,646,419,142,0,142,0,41,0,0,empty,mBC-0814-1
"A6,H2",8107,8724,5773,2951,5011,0,2722,2726,1952,774,2.521963824,1485,2235,1462,473,0,473,0,122,0,0.00422833,empty,mBC-0814-1
"A6,H3",5466,5976,3859,2117,3482,0,1909,1909,1350,559,2.415026834,1039,1074,794,226,0,226,0,62,0,0.004424779,empty,mBC-0814-1
"A6,H4",5403,5766,3853,1913,3284,0,1775,1775,1246,529,2.355387524,930,104,84,39,0,39,0,12,0,0,empty,mBC-0814-1
"A6,H5",6394,6985,4735,2250,3990,0,2109,2117,1458,659,2.212443096,1106,2043,1623,419,0,419,0,66,0,0,empty,mBC-0814-1
"A6,H6",6628,7166,4799,2367,4043,0,2195,2199,1527,672,2.272321429,1158,2310,1571,481,0,481,0,115,0,0.014553015,empty,mBC-0814-1
"A6,H7",5241,5631,3812,1819,3369,0,1792,1794,1258,536,2.347014925,953,1241,848,269,0,269,0,57,0,0,empty,mBC-0814-1
"A6,H8",16796,19016,11613,7403,11383,0,6854,6856,5106,1750,2.917714286,3928,1488,1055,318,0,318,0,77,0,0.031446541,empty,mBC-0814-1
"A6,H9",5007,5295,3523,1772,3134,0,1692,1693,1184,509,2.326129666,927,1194,883,259,0,259,0,54,0,0,empty,mBC-0814-1
"A6,H10",3427,3839,2456,1383,2196,0,1185,1192,831,361,2.301939058,672,931,568,157,1,156,1,46,0,0,empty,mBC-0814-1
"A6,H11",3963,4340,2840,1500,2515,0,1375,1376,1004,372,2.698924731,750,122,104,26,0,26,0,8,0,0,empty,mBC-0814-1
"A6,H12",2836,3180,1979,1201,1863,0,1056,1059,765,294,2.602040816,591,697,472,145,0,145,0,56,0,0,empty,mBC-0814-1
"A7,A1",6449,7214,4348,2866,4214,0,2443,2448,1584,864,1.833333333,1437,43137,12639,4077,10,4067,4,422,0,0.055569216,empty,mBC-0814-1
"A7,A2",503714,574663,337361,237302,338103,1,207409,207655,170913,36742,4.651706494,122268,134862,98096,28746,16,28730,1,1977,0,0.00010442,mm10,mBC-0814-1
"A7,A3",1426836,1661895,953931,707964,970058,2,622788,623445,489557,133888,3.656466599,373421,313304,213895,60689,40,60649,2,3395,0,0.000857393,mm10,mBC-0814-1
"A7,A4",5845,6225,4202,2023,3660,0,1936,1936,1390,546,2.545787546,1031,716,515,120,0,120,0,34,0,0.008333333,empty,mBC-0814-1
"A7,A5",4954,5295,3694,1601,3197,0,1718,1718,1241,477,2.601677149,890,1229,882,265,0,265,0,59,0,0.018867925,empty,mBC-0814-1
"A7,A6",3953,4052,2824,1228,2454,0,1309,1309,942,367,2.566757493,674,1358,896,224,1,223,1,53,0,0,empty,mBC-0814-1
"A7,A7",6549,6392,4238,2154,3799,2,2080,2089,1481,608,2.435855263,1082,4885,2296,704,1,703,1,103,0,0.059743954,empty,mBC-0814-1
"A7,A8",2484,2639,1716,923,1563,0,837,837,548,289,1.896193772,435,1189,810,259,1,258,1,81,0,0,empty,mBC-0814-1
"A7,A9",6826,7366,4880,2486,4342,0,2328,2332,1660,672,2.470238095,1262,7975,2709,845,0,845,0,113,0,0.101775148,empty,mBC-0814-1
"A7,A10",3725,4198,2652,1546,2489,0,1394,1394,996,398,2.502512563,792,324,153,69,0,69,0,18,0,0,empty,mBC-0814-1
"A7,A11",5139,5520,3708,1812,3337,0,1852,1855,1319,536,2.460820896,987,5735,2408,774,1,773,1,136,0,0.050452781,empty,mBC-0814-1
"A7,A12",4811,5191,3450,1741,3141,0,1732,1734,1264,470,2.689361702,904,3081,2101,668,0,668,0,194,0,0,empty,mBC-0814-1
"A7,B1",5012,5541,3546,1995,3296,0,1802,1809,1294,515,2.512621359,1006,1312,904,293,0,293,0,77,0,0.081911263,empty,mBC-0814-1
"A7,B2",6177,6690,4154,2536,4021,0,2331,2338,1673,665,2.515789474,1324,394,200,79,0,79,0,31,0,0.151898734,empty,mBC-0814-1
"A7,B3",4335,4936,3033,1903,2895,0,1651,1654,1166,488,2.389344262,947,684,473,150,0,150,0,48,0,0,empty,mBC-0814-1
"A7,B4",4573,4950,3286,1664,2840,0,1500,1503,1055,448,2.354910714,792,2935,1191,380,0,380,0,80,0,0.005263158,empty,mBC-0814-1
"A7,B5",4571,3316,1998,1318,2279,0,1306,1309,952,357,2.666666667,772,949,578,171,0,171,0,57,0,0,empty,mBC-0814-1
"A7,B6",4311,4627,3159,1468,2690,0,1412,1416,1038,378,2.746031746,720,1357,1005,276,1,275,1,50,0,0,empty,mBC-0814-1
"A7,B7",5211,5594,3753,1841,3395,0,1863,1867,1403,464,3.023706897,1013,1056,684,175,0,175,0,49,0,0.011428571,empty,mBC-0814-1
"A7,B8",3985,4366,2840,1526,2604,1,1453,1460,1029,431,2.387470998,797,10038,3341,1091,3,1088,2,119,0,0.160845588,empty,mBC-0814-1
"A7,B9",5179,5484,3674,1810,3286,0,1778,1781,1285,496,2.590725806,964,1128,872,238,0,238,0,72,0,0,empty,mBC-0814-1
"A7,B10",4518,4857,3214,1643,2889,0,1574,1578,1112,466,2.386266094,842,408,320,106,1,105,1,27,0,0,empty,mBC-0814-1
"A7,B11",987450,1146671,656264,490407,669072,1,424456,424907,346015,78892,4.385932667,254945,33297,20388,5864,5,5859,2,620,0,0,mm10,mBC-0814-1
"A7,B12",365625,414426,245519,168907,250675,0,154814,154980,124758,30222,4.128052412,92126,12890,8554,2479,4,2475,2,340,0,0.00040404,mm10,mBC-0814-1
"A7,C1",1259063,1441709,838837,602872,834751,3,529045,529649,426762,102887,4.147870965,313701,143432,99568,28387,20,28367,1,1999,0,0.000669792,mm10,mBC-0814-1
"A7,C2",5705,6020,4133,1887,3536,0,1919,1925,1407,518,2.716216216,972,1636,1206,424,0,424,0,102,0,0.033018868,empty,mBC-0814-1
"A7,C3",5916,6293,4187,2106,3801,0,2106,2115,1537,578,2.65916955,1118,367,169,73,0,73,0,32,0,0,empty,mBC-0814-1
"A7,C4",541167,606793,366543,240250,358258,0,214576,214856,185411,29445,6.29685855,124279,182929,131367,36187,24,36163,4,2357,0,0.000580704,mm10,mBC-0814-1
"A7,C5",7525,7910,5321,2589,4579,0,2451,2457,1797,660,2.722727273,1282,1012,634,229,0,229,0,74,0,0,empty,mBC-0814-1
"A7,C6",5480,5944,3856,2088,3600,0,1975,1978,1444,534,2.70411985,1121,1139,807,300,0,300,0,88,0,0,empty,mBC-0814-1
"A7,C7",6922,7349,4944,2405,4268,0,2283,2284,1688,596,2.832214765,1186,279,197,66,0,66,0,17,0,0.015151515,empty,mBC-0814-1
"A7,C8",5830,6218,4145,2073,3673,1,1962,1965,1378,587,2.347529813,1026,1314,872,286,0,286,0,74,0,0.013986014,empty,mBC-0814-1
"A7,C9",4727,5192,3293,1899,3009,0,1649,1656,1185,471,2.515923567,957,1261,800,265,1,264,1,62,0,0,empty,mBC-0814-1
"A7,C10",5996,6471,4270,2201,3667,0,1970,1974,1404,570,2.463157895,1018,1144,879,279,0,279,0,60,0,0,empty,mBC-0814-1
"A7,C11",4674,5226,3347,1879,3061,0,1690,1694,1237,457,2.70678337,938,1087,741,228,0,228,0,59,0,0,empty,mBC-0814-1
"A7,C12",8459,9203,6016,3187,5345,0,2937,2942,2105,837,2.514934289,1560,2181,1510,399,0,399,0,79,0,0,empty,mBC-0814-1
"A7,D1",4946,5329,3542,1787,3188,1,1714,1718,1237,481,2.571725572,918,824,497,149,0,149,0,37,0,0,empty,mBC-0814-1
"A7,D2",5381,5652,3992,1660,3324,0,1701,1702,1248,454,2.748898678,810,1718,1292,354,0,354,0,89,0,0,empty,mBC-0814-1
"A7,D3",11134,12002,8011,3991,7112,0,3897,3906,2835,1071,2.647058824,2066,3638,2195,693,0,693,0,130,0,0.024531025,empty,mBC-0814-1
"A7,D4",439116,499161,290319,208842,298949,0,189807,189998,145528,44470,3.272498313,113594,29535,21161,6041,4,6037,2,687,0,0.000993871,mm10,mBC-0814-1
"A7,D5",5011,5577,3403,2174,3353,0,1920,1922,1384,538,2.572490706,1100,9771,4654,1450,2,1448,1,184,0,0.261740331,empty,mBC-0814-1
"A7,D6",5014,5414,3654,1760,3185,0,1704,1708,1243,465,2.67311828,910,1397,989,274,0,274,0,59,0,0,empty,mBC-0814-1
"A7,D7",6307,6668,4505,2163,3907,0,2053,2059,1475,584,2.525684932,1067,41942,12795,3911,6,3905,3,403,0,0.041997439,empty,mBC-0814-1
"A7,D8",5295,5773,3698,2075,3428,0,1860,1864,1367,497,2.750503018,1047,1138,760,244,0,244,0,50,0,0,empty,mBC-0814-1
"A7,D9",3190,3382,2326,1056,2001,0,1106,1109,790,319,2.476489028,564,826,546,170,0,170,0,46,0,0,empty,mBC-0814-1
"A7,D10",4002,4417,2790,1627,2569,0,1439,1439,1074,365,2.942465753,775,749,496,160,0,160,0,51,0,0,empty,mBC-0814-1
"A7,D11",4336,4632,3027,1605,2720,0,1474,1476,1062,414,2.565217391,779,1762,1268,402,0,402,0,119,0,0,empty,mBC-0814-1
"A7,D12",438055,515032,285552,229480,307546,2,198392,198608,153512,45096,3.404115664,121557,213521,149457,41985,22,41963,4,2429,0,0.000691085,mm10,mBC-0814-1
"A7,E1",5137,5498,3686,1812,3160,0,1631,1631,1125,506,2.223320158,872,1515,965,339,0,339,0,77,0,0.020648968,empty,mBC-0814-1
"A7,E2",3888,4081,2769,1312,2414,0,1304,1304,921,383,2.404699739,689,1119,648,278,0,278,0,76,0,0.107913669,empty,mBC-0814-1
"A7,E3",3611,4031,2659,1372,2365,0,1278,1281,909,372,2.443548387,676,1470,1096,368,1,367,1,83,0,0,empty,mBC-0814-1
"A7,E4",3400,3834,2374,1460,2236,7,1309,1318,950,368,2.581521739,728,914,636,176,0,176,0,58,0,0.011363636,empty,mBC-0814-1
"A7,E5",3798,4005,2806,1199,2391,1,1280,1287,912,375,2.432,633,859,604,180,0,180,0,49,0,0.011111111,empty,mBC-0814-1
"A7,E6",474829,552466,320441,232025,325913,0,207562,207788,159205,48583,3.27696931,123981,54508,38872,11038,7,11031,1,1061,0,0,mm10,mBC-0814-1
"A7,E7",4504,4698,3316,1382,2827,0,1505,1507,1081,426,2.537558685,759,1471,1045,311,0,311,0,62,0,0.038585209,empty,mBC-0814-1
"A7,E8",4749,5046,3372,1674,2897,0,1565,1570,1144,426,2.685446009,816,2037,1435,402,0,402,0,74,0,0,empty,mBC-0814-1
"A7,E9",3577,3772,2548,1224,2196,0,1192,1196,894,302,2.960264901,592,1256,880,291,0,291,0,78,0,0.041237113,empty,mBC-0814-1
"A7,E10",4146,4591,3006,1585,2734,0,1514,1519,1093,426,2.5657277,816,2163,1586,445,0,445,0,95,0,0.002247191,empty,mBC-0814-1
"A7,E11",4332,4703,3157,1546,2771,0,1502,1502,1080,422,2.559241706,783,1142,759,301,0,301,0,85,0,0,empty,mBC-0814-1
"A7,E12",465612,536977,310201,226776,320026,1,199918,200137,169517,30620,5.536152841,119117,145890,105809,30119,16,30103,1,1949,0,0.001229113,mm10,mBC-0814-1
"A7,F1",614590,704687,412325,292362,413108,0,255936,256273,209272,47001,4.452501011,151306,254993,178665,49728,35,49693,6,2662,0,0.0003421,mm10,mBC-0814-1
"A7,F2",6791,7412,4884,2528,4276,1,2324,2325,1648,677,2.434268833,1240,1641,1116,414,0,414,0,105,0,0.036231884,empty,mBC-0814-1
"A7,F3",7186,8101,4986,3115,4795,0,2755,2759,1930,829,2.328106152,1605,4744,2589,735,2,733,2,129,0,0.013642565,empty,mBC-0814-1
"A7,F4",5627,6047,4085,1962,3617,0,1957,1959,1417,542,2.614391144,1027,890,572,199,0,199,0,41,0,0,empty,mBC-0814-1
"A7,F5",5469,6006,3984,2022,3564,0,1912,1917,1404,513,2.736842105,1041,1183,806,258,0,258,0,65,0,0,empty,mBC-0814-1
"A7,F6",5240,5735,3710,2025,3382,0,1860,1861,1325,536,2.472014925,1013,1740,1274,415,0,415,0,111,0,0,empty,mBC-0814-1
"A7,F7",4723,4982,3394,1588,2995,0,1603,1605,1131,474,2.386075949,841,401,280,107,0,107,0,42,0,0,empty,mBC-0814-1
"A7,F8",6923,7489,4878,2611,4452,0,2503,2504,1899,605,3.138842975,1357,171,122,42,0,42,0,12,0,0,empty,mBC-0814-1
"A7,F9",5721,6340,4193,2147,3661,0,1965,1968,1435,533,2.692307692,1033,1511,985,325,0,325,0,75,0,0,empty,mBC-0814-1
"A7,F10",6723,7102,4981,2121,4188,0,2223,2226,1587,639,2.483568075,1110,1701,1221,349,0,349,0,91,0,0,empty,mBC-0814-1
"A7,F11",4577,4936,3282,1654,2881,0,1572,1574,1122,452,2.482300885,828,2134,1154,324,0,324,0,65,0,0.00308642,empty,mBC-0814-1
"A7,F12",5066,5278,3615,1663,3161,0,1714,1716,1223,493,2.480730223,888,85,47,19,0,19,0,11,0,0,empty,mBC-0814-1
"A7,G1",7609,8153,5509,2644,4865,0,2620,2625,1904,721,2.640776699,1355,3429,2426,774,1,773,1,182,0,0.021992238,empty,mBC-0814-1
"A7,G2",6088,6400,4299,2101,3736,0,1984,1989,1430,559,2.558139535,1033,314,210,69,0,69,0,16,0,0.15942029,empty,mBC-0814-1
"A7,G3",555457,641529,366941,274588,380075,1,243496,243796,191630,52166,3.673465476,146612,59849,41450,11961,11,11950,1,1148,0,0,mm10,mBC-0814-1
"A7,G4",558529,629138,383438,245700,372749,1,225425,225689,180604,45085,4.005855606,131269,531,380,74,0,74,0,16,0,0,empty,mBC-0814-1
"A7,G5",4786,5352,3392,1960,3102,0,1738,1738,1222,516,2.368217054,944,1141,826,244,0,244,0,72,0,0,empty,mBC-0814-1
"A7,G6",697644,775537,481499,294038,454813,1,271471,271817,220408,51409,4.287342683,154768,4435,2983,901,1,900,1,153,0,0.006666667,empty,mBC-0814-1
"A7,G7",5682,6194,4046,2148,3737,0,2057,2059,1488,571,2.605954466,1128,1773,1170,434,1,433,1,105,0,0,empty,mBC-0814-1
"A7,G8",388787,465009,254742,210267,277313,0,177403,177580,143786,33794,4.254778955,109643,241851,170338,47917,23,47894,4,2725,0,0.000459348,mm10,mBC-0814-1
"A7,G9",6044,6461,4289,2172,3771,0,2079,2080,1539,541,2.844731978,1104,2441,1521,519,0,519,0,149,0,0.003853565,empty,mBC-0814-1
"A7,G10",9679,10494,6926,3568,6148,0,3304,3306,2378,928,2.5625,1796,2548,1807,618,1,617,1,147,0,0.001620746,empty,mBC-0814-1
"A7,G11",9822,10593,7000,3593,6128,0,3330,3337,2422,915,2.646994536,1729,23519,7763,2402,3,2399,1,240,0,0.134222593,empty,mBC-0814-1
"A7,G12",4798,5116,3332,1784,3092,0,1719,1721,1271,450,2.824444444,917,1526,1051,352,1,351,1,90,0,0.014245014,empty,mBC-0814-1
"A7,H1",4976,5446,3555,1891,3164,0,1759,1761,1240,521,2.380038388,952,789,512,189,0,189,0,52,0,0,empty,mBC-0814-1
"A7,H2",523238,623476,345441,278035,368592,1,236663,236903,161457,75446,2.140033932,145198,251579,185054,51981,27,51954,1,2686,0,0.000481195,mm10,mBC-0814-1
"A7,H3",2013521,2341183,1333675,1007508,1347111,0,874629,875652,697420,178232,3.912989811,527039,715936,475281,133066,89,132977,9,4865,0,0.000864811,mm10,mBC-0814-1
"A7,H4",5911,6396,4135,2261,3821,0,2136,2143,1522,621,2.450885668,1151,315,192,60,0,60,0,20,0,0,empty,mBC-0814-1
"A7,H5",6986,7678,4913,2765,4438,0,2446,2453,1772,681,2.6020558,1329,1784,1185,387,0,387,0,83,0,0.025839793,empty,mBC-0814-1
"A7,H6",7280,7807,5182,2625,4546,0,2524,2528,1819,709,2.565585331,1338,1696,1234,427,0,427,0,104,0,0.004683841,empty,mBC-0814-1
"A7,H7",5594,6078,3999,2079,3621,0,2007,2009,1429,580,2.463793103,1082,2056,1461,399,0,399,0,78,0,0.002506266,empty,mBC-0814-1
"A7,H8",421060,481696,281971,199725,283686,0,173302,173501,146820,26681,5.502792249,103067,112142,77130,21603,14,21589,1,1925,0,0.002315994,mm10,mBC-0814-1
"A7,H9",484679,562635,322457,240178,333080,1,207242,207458,166523,40935,4.067985831,124981,177756,129009,36308,24,36284,2,2193,0,0.000358285,mm10,mBC-0814-1
"A7,H10",4242,4791,3007,1784,2793,0,1612,1612,1209,403,3,873,789,556,190,0,190,0,50,0,0,empty,mBC-0814-1
"A7,H11",475620,558658,315939,242719,331032,2,208900,209159,164157,45002,3.64777121,126333,6343,4495,1312,0,1312,0,170,0,0,mm10,mBC-0814-1
"A7,H12",3071,3510,2125,1385,2104,0,1235,1237,890,347,2.564841499,727,1228,815,270,0,270,0,67,0,0.022222222,empty,mBC-0814-1
"A8,A1",5865,6425,4103,2322,3831,0,2113,2117,1487,630,2.36031746,1177,2116,1579,459,2,457,1,70,0,0.002188184,empty,mBC-0814-1
"A8,A2",5004,5341,3645,1696,3165,4,1663,1667,1192,475,2.509473684,866,1151,803,226,0,226,0,71,0,0.004424779,empty,mBC-0814-1
"A8,A3",4884,5435,3403,2032,3124,0,1734,1734,1236,498,2.481927711,973,1063,763,226,0,226,0,47,0,0,empty,mBC-0814-1
"A8,A4",6003,6416,4365,2051,3713,0,1947,1956,1394,562,2.480427046,984,633,489,117,0,117,0,17,0,0,empty,mBC-0814-1
"A8,A5",5009,5218,3623,1595,3104,0,1636,1638,1152,486,2.37037037,848,2042,1442,322,0,322,0,61,0,0,empty,mBC-0814-1
"A8,A6",4164,4475,3060,1415,2620,0,1403,1407,983,424,2.318396226,727,1779,1308,333,1,332,1,68,0,0.009036145,empty,mBC-0814-1
"A8,A7",5465,5935,3876,2059,3606,0,1944,1945,1364,581,2.34767642,1059,2011,1333,424,0,424,0,81,0,0,empty,mBC-0814-1
"A8,A8",2200,2437,1555,882,1503,0,876,881,590,291,2.027491409,508,1270,905,281,0,281,0,80,0,0.035587189,empty,mBC-0814-1
"A8,A9",7044,7601,5085,2516,4488,0,2405,2412,1714,698,2.455587393,1304,12186,4357,1345,3,1342,3,153,0,0.056631893,empty,mBC-0814-1
"A8,A10",3314,3668,2377,1291,2217,0,1227,1230,885,345,2.565217391,701,262,200,66,0,66,0,19,0,0,empty,mBC-0814-1
"A8,A11",4920,5185,3430,1755,3054,0,1597,1598,1144,454,2.519823789,864,7433,3288,966,0,966,0,147,0,0.056935818,empty,mBC-0814-1
"A8,A12",3573,3724,2624,1100,2156,0,1124,1124,821,303,2.709570957,518,3023,2077,664,0,664,0,173,0,0,empty,mBC-0814-1
"A8,B1",5001,5261,3597,1664,3112,0,1634,1640,1173,467,2.511777302,836,1945,1195,352,0,352,0,80,0,0,empty,mBC-0814-1
"A8,B2",512909,594470,334701,259769,356120,0,225014,225265,191550,33715,5.681447427,136530,49070,35320,9638,8,9630,2,902,0,0.000311526,mm10,mBC-0814-1
"A8,B3",368213,444300,239176,205124,268885,1,176013,176219,140835,35384,3.980188786,109521,123087,87293,25027,17,25010,3,1731,0,3.9984E-05,mm10,mBC-0814-1
"A8,B4",4113,4390,2973,1417,2602,0,1404,1405,997,408,2.443627451,725,3444,1845,458,0,458,0,76,0,0.024017467,empty,mBC-0814-1
"A8,B5",4244,3068,1865,1203,2113,0,1223,1230,923,307,3.006514658,709,1191,791,205,0,205,0,48,0,0,empty,mBC-0814-1
"A8,B6",4007,4451,2835,1616,2613,0,1448,1452,979,473,2.069767442,797,1411,930,314,0,314,0,51,0,0.063694268,empty,mBC-0814-1
"A8,B7",5662,6046,4025,2021,3546,1,1924,1927,1369,558,2.453405018,1042,7369,2879,916,0,916,0,122,0,0.006550218,empty,mBC-0814-1
"A8,B8",3801,4059,2721,1338,2348,0,1257,1257,882,375,2.352,665,1030,745,237,0,237,0,49,0,0,empty,mBC-0814-1
"A8,B9",4715,4933,3403,1530,2999,0,1588,1590,1108,482,2.298755187,832,970,779,244,0,244,0,66,0,0,empty,mBC-0814-1
"A8,B10",179635,205968,117407,88561,125917,1,78074,78233,64244,13989,4.592465509,46726,34421,23066,6420,16,6404,2,646,0,0.001405372,mm10,mBC-0814-1
"A8,B11",6740,7011,4785,2226,4167,0,2171,2172,1490,682,2.184750733,1131,315,203,59,0,59,0,14,0,0,empty,mBC-0814-1
"A8,B12",5662,6287,4086,2201,3755,0,2100,2102,1504,598,2.515050167,1118,2902,1709,442,1,441,1,68,0,0,empty,mBC-0814-1
"A8,C1",6187,6507,4524,1983,3748,0,1890,1898,1324,574,2.306620209,927,877,574,162,0,162,0,43,0,0,empty,mBC-0814-1
"A8,C2",5450,5643,3942,1701,3212,0,1687,1687,1220,467,2.6124197,816,1720,1306,382,0,382,0,94,0,0,empty,mBC-0814-1
"A8,C3",5938,6494,4247,2247,3883,0,2076,2078,1524,554,2.750902527,1115,522,322,90,0,90,0,27,0,0,empty,mBC-0814-1
"A8,C4",490763,549922,331896,218026,330530,0,203062,203279,157385,45894,3.429315379,118752,22110,15619,4474,0,4474,0,566,0,0.00245865,mm10,mBC-0814-1
"A8,C5",7742,8342,5438,2904,4913,0,2692,2694,1963,731,2.685362517,1414,1504,1052,323,1,322,1,82,0,0,empty,mBC-0814-1
"A8,C6",533200,618230,354714,263516,372921,5,231331,231605,191307,40298,4.747307559,138923,232941,171554,48179,19,48160,3,2712,0,0.000539867,mm10,mBC-0814-1
"A8,C7",7526,8029,5519,2510,4806,0,2562,2566,1810,756,2.394179894,1345,688,437,144,0,144,0,25,0,0,empty,mBC-0814-1
"A8,C8",5824,6062,4160,1902,3545,0,1841,1845,1340,505,2.653465347,948,11168,3982,1294,3,1291,2,134,0,0.056545314,empty,mBC-0814-1
"A8,C9",4718,4914,3346,1568,2833,0,1527,1529,1076,453,2.375275938,808,796,507,168,0,168,0,43,0,0,empty,mBC-0814-1
"A8,C10",6193,6479,4565,1914,3768,0,1965,1969,1388,581,2.388984509,992,1509,1037,320,0,320,0,59,0,0,empty,mBC-0814-1
"A8,C11",4795,5196,3489,1707,3076,2,1635,1637,1128,509,2.21611002,865,1895,1354,419,1,418,1,69,0,0,empty,mBC-0814-1
"A8,C12",8378,8885,5922,2963,5266,0,2897,2903,2097,806,2.601736973,1518,1959,1313,385,0,385,0,76,0,0.012987013,empty,mBC-0814-1
"A8,D1",4479,4771,3186,1585,2854,0,1506,1512,1049,463,2.265658747,800,454,300,80,0,80,0,26,0,0,empty,mBC-0814-1
"A8,D2",5587,5716,4094,1622,3453,0,1714,1717,1231,486,2.532921811,864,1529,903,314,2,312,1,79,0,0,empty,mBC-0814-1
"A8,D3",642591,742388,428390,313998,440834,1,277832,278151,215747,62404,3.457262355,165875,141309,99394,28293,16,28277,2,1867,0,0.000176822,mm10,mBC-0814-1
"A8,D4",5625,6004,4060,1944,3591,0,1935,1939,1392,547,2.544789762,1022,1473,999,337,0,337,0,73,0,0.014836795,empty,mBC-0814-1
"A8,D5",4315,4746,3072,1674,2752,0,1477,1479,1038,441,2.353741497,818,8694,3445,992,0,992,0,158,0,0.077620968,empty,mBC-0814-1
"A8,D6",5495,5983,3961,2022,3477,0,1885,1887,1410,477,2.955974843,985,1298,906,258,0,258,0,61,0,0.058139535,empty,mBC-0814-1
"A8,D7",6163,6502,4486,2016,3825,0,2049,2054,1526,528,2.890151515,1066,2546,1715,464,0,464,0,87,0,0.012931034,empty,mBC-0814-1
"A8,D8",5287,5755,3675,2080,3388,0,1859,1865,1294,571,2.26619965,1040,7888,3243,1054,2,1052,1,114,0,0.198669202,empty,mBC-0814-1
"A8,D9",3294,3535,2394,1141,2098,0,1145,1147,818,329,2.486322188,592,1645,1082,307,0,307,0,50,0,0,empty,mBC-0814-1
"A8,D10",4009,4273,2898,1375,2563,0,1403,1405,1035,370,2.797297297,755,2227,946,262,1,261,1,51,0,0.007662835,empty,mBC-0814-1
"A8,D11",4302,4560,3111,1449,2667,0,1410,1412,1020,392,2.602040816,729,2913,2181,648,1,647,1,121,0,0.060278207,empty,mBC-0814-1
"A8,D12",6697,7428,4736,2692,4311,0,2392,2401,1709,692,2.469653179,1300,3597,2457,723,0,723,0,126,0,0,empty,mBC-0814-1
"A8,E1",468112,522752,313894,208858,312430,2,189396,189614,150444,39170,3.840796528,110684,112781,81358,22740,5,22735,2,1688,0,0.000791731,mm10,mBC-0814-1
"A8,E2",3822,4061,2768,1293,2330,0,1235,1235,912,323,2.823529412,611,1242,816,225,0,225,0,52,0,0.004444444,empty,mBC-0814-1
"A8,E3",452637,540007,297994,242013,322827,2,209288,209498,155446,54052,2.875860283,128085,144669,102056,28959,25,28934,3,2104,0,0.000898597,mm10,mBC-0814-1
"A8,E4",3368,3693,2413,1280,2125,0,1183,1184,866,318,2.72327044,649,1422,1010,301,0,301,0,51,0,0,empty,mBC-0814-1
"A8,E5",4079,4426,2966,1460,2622,0,1365,1370,968,402,2.407960199,730,4774,1423,396,0,396,0,57,0,0.017676768,empty,mBC-0814-1
"A8,E6",4812,5283,3492,1791,3046,0,1601,1601,1172,429,2.731934732,864,1261,872,247,0,247,0,65,0,0,empty,mBC-0814-1
"A8,E7",4761,5076,3465,1611,2968,0,1543,1544,1130,414,2.729468599,802,1847,949,300,0,300,0,53,0,0,empty,mBC-0814-1
"A8,E8",5288,5363,3737,1626,3165,0,1610,1614,1175,439,2.676537585,833,2230,1460,434,0,434,0,85,0,0.01843318,empty,mBC-0814-1
"A8,E9",3116,3312,2194,1118,1951,0,1064,1064,783,281,2.786476868,569,1845,1327,313,0,313,0,63,0,0,empty,mBC-0814-1
"A8,E10",418586,496095,280194,215901,297049,1,189970,190145,149826,40319,3.716014782,114744,167540,123503,35715,16,35699,3,2132,0,0.000448192,mm10,mBC-0814-1
"A8,E11",4374,4635,3232,1403,2760,7,1422,1430,1032,398,2.592964824,729,1378,990,277,0,277,0,79,0,0.010830325,empty,mBC-0814-1
"A8,E12",625565,736781,395371,341410,445427,0,308463,308753,166364,142389,1.168376771,192006,19944,11139,3040,3,3037,1,396,0,0.008890352,mm10,mBC-0814-1
"A8,F1",4804,5354,3388,1966,3134,0,1691,1694,1210,484,2.5,959,1777,1244,360,0,360,0,85,0,0,empty,mBC-0814-1
"A8,F2",6672,7120,4861,2259,4288,0,2264,2264,1656,608,2.723684211,1200,2470,1824,504,0,504,0,98,0,0.025793651,empty,mBC-0814-1
"A8,F3",5567,6015,3983,2032,3560,3,1947,1956,1408,548,2.569343066,1054,3923,1838,607,1,606,1,102,0,0.062706271,empty,mBC-0814-1
"A8,F4",5532,5829,3898,1931,3527,0,1842,1842,1282,560,2.289285714,994,525,370,118,0,118,0,33,0,0,empty,mBC-0814-1
"A8,F5",5426,5741,3885,1856,3378,0,1814,1818,1392,426,3.267605634,944,1337,996,295,0,295,0,61,0,0.020338983,empty,mBC-0814-1
"A8,F6",5072,5499,3742,1757,3191,0,1690,1695,1219,476,2.56092437,883,2063,1394,440,0,440,0,109,0,0.002272727,empty,mBC-0814-1
"A8,F7",4946,5393,3593,1800,3082,0,1643,1643,1174,469,2.503198294,856,650,436,174,0,174,0,44,0,0,empty,mBC-0814-1
"A8,F8",6497,6663,4645,2018,3951,0,2068,2074,1473,601,2.450915141,1039,124,93,36,0,36,0,15,0,0,empty,mBC-0814-1
"A8,F9",6010,6302,4426,1876,3669,1,1886,1891,1326,565,2.346902655,921,2186,1502,402,0,402,0,84,0,0.02238806,empty,mBC-0814-1
"A8,F10",724491,840104,490898,349206,493533,2,303815,304167,243148,61019,3.984791622,179595,232105,167400,45286,28,45258,3,2695,0,0.000132573,mm10,mBC-0814-1
"A8,F11",4647,5040,3506,1534,2879,1,1492,1495,1077,418,2.576555024,748,1454,947,280,0,280,0,58,0,0.028571429,empty,mBC-0814-1
"A8,F12",5036,5311,3632,1679,3137,0,1709,1716,1190,526,2.262357414,883,122,107,31,0,31,0,8,0,0,empty,mBC-0814-1
"A8,G1",7507,8063,5504,2559,4746,0,2542,2552,1773,779,2.275994865,1337,3556,2501,707,1,706,1,150,0,0.025495751,empty,mBC-0814-1
"A8,G2",5869,6294,4293,2001,3668,0,1911,1911,1398,513,2.725146199,958,499,370,132,0,132,0,22,0,0,empty,mBC-0814-1
"A8,G3",5290,5464,3831,1633,3161,0,1695,1695,1218,477,2.553459119,819,2378,1701,531,1,530,1,105,0,0,empty,mBC-0814-1
"A8,G4",5490,5822,3998,1824,3417,2,1798,1800,1261,539,2.339517625,945,2,0,0,0,0,0,0,0,0,empty,mBC-0814-1
"A8,G5",4543,4945,3245,1700,2954,0,1600,1600,1160,440,2.636363636,836,1474,1038,267,0,267,0,67,0,0,empty,mBC-0814-1
"A8,G6",9170,9955,6519,3436,5842,1,3105,3108,2163,945,2.288888889,1729,906,421,111,1,110,1,20,0,0.190909091,empty,mBC-0814-1
"A8,G7",474503,546466,317312,229154,329007,1,205407,205643,157150,48493,3.240673912,122186,277876,200041,56476,32,56444,2,2757,0,1.77167E-05,mm10,mBC-0814-1
"A8,G8",7407,8007,5231,2776,4718,0,2605,2607,1851,756,2.448412698,1434,19547,7024,2078,3,2075,1,265,0,0.02939759,empty,mBC-0814-1
"A8,G9",5393,5727,3856,1871,3387,3,1861,1864,1333,531,2.510357815,956,3085,2156,595,0,595,0,132,0,0,empty,mBC-0814-1
"A8,G10",464406,528160,312788,215372,316895,1,193256,193507,155165,38342,4.046867665,113398,160126,116908,33928,27,33901,2,2181,0,0.000943925,mm10,mBC-0814-1
"A8,G11",9690,10132,6976,3156,5948,0,3130,3134,2267,867,2.614763552,1584,3339,2057,585,0,585,0,108,0,0,empty,mBC-0814-1
"A8,G12",5005,5354,3595,1759,3211,0,1735,1737,1242,495,2.509090909,936,1889,1352,402,0,402,0,96,0,0,empty,mBC-0814-1
"A8,H1",4777,5183,3386,1797,3033,0,1661,1662,1178,484,2.433884298,893,1322,940,269,0,269,0,47,0,0,empty,mBC-0814-1
"A8,H2",9845,10779,7007,3772,6430,0,3537,3547,2533,1014,2.498027613,1959,3551,2411,718,0,718,0,161,0,0.006963788,empty,mBC-0814-1
"A8,H3",5292,5719,3814,1905,3295,0,1799,1801,1304,497,2.623742455,958,2314,1470,435,0,435,0,89,0,0.002298851,empty,mBC-0814-1
"A8,H4",5695,6254,4117,2137,3597,0,1947,1949,1410,539,2.615955473,1017,172,135,45,0,45,0,16,0,0,empty,mBC-0814-1
"A8,H5",7214,7807,5200,2607,4501,0,2410,2418,1717,701,2.44935806,1272,1925,1381,401,0,401,0,75,0,0.049875312,empty,mBC-0814-1
"A8,H6",6882,7349,4941,2408,4242,0,2236,2240,1621,619,2.618739903,1145,2829,2012,643,0,643,0,110,0,0.032659409,empty,mBC-0814-1
"A8,H7",5588,5910,4034,1876,3521,0,1910,1911,1344,567,2.37037037,976,1499,951,283,0,283,0,66,0,0.014134276,empty,mBC-0814-1
"A8,H8",4879,5292,3420,1872,3047,0,1713,1714,1246,468,2.662393162,951,3596,1981,658,0,658,0,113,0,0.054711246,empty,mBC-0814-1
"A8,H9",387947,436607,256216,180391,260430,1,160523,160682,132153,28529,4.632233867,94940,122062,88287,25195,13,25182,2,1714,0,3.97109E-05,mm10,mBC-0814-1
"A8,H10",3662,3967,2556,1411,2334,0,1265,1267,930,337,2.759643917,690,1183,780,277,0,277,0,50,0,0,empty,mBC-0814-1
"A8,H11",4029,4178,2908,1270,2456,0,1342,1344,940,404,2.326732673,669,51,41,21,0,21,0,8,0,0,empty,mBC-0814-1
"A8,H12",2559,2704,1730,974,1668,0,904,904,633,271,2.335793358,513,61479,16419,5227,16,5211,3,392,0,0.085780081,empty,mBC-0814-1
"A9,A1",5720,5905,4141,1764,3587,0,1923,1928,1400,528,2.651515152,952,10405,3141,924,2,922,1,110,0,0.00867679,empty,mBC-0814-1
"A9,A2",4929,5203,3619,1584,3131,0,1656,1658,1178,480,2.454166667,825,1305,901,238,0,238,0,61,0,0.029411765,empty,mBC-0814-1
"A9,A3",4967,5488,3552,1936,3115,0,1732,1741,1248,493,2.531440162,936,1665,1171,302,0,302,0,57,0,0.049668874,empty,mBC-0814-1
"A9,A4",551026,598915,387440,211475,350858,1,201912,202167,146468,55699,2.629634284,112759,4995,3264,979,1,978,1,150,0,0.013292434,empty,mBC-0814-1
"A9,A5",4887,5073,3518,1555,2981,0,1572,1573,1114,459,2.427015251,801,2328,1523,441,0,441,0,60,0,0.027210884,empty,mBC-0814-1
"A9,A6",4118,4330,2962,1368,2459,0,1305,1306,922,384,2.401041667,666,1724,1184,338,0,338,0,64,0,0.00887574,empty,mBC-0814-1
"A9,A7",5632,6308,4118,2190,3766,0,2089,2092,1504,588,2.557823129,1150,1613,1115,329,0,329,0,72,0,0,empty,mBC-0814-1
"A9,A8",2371,2699,1598,1101,1602,3,931,938,686,252,2.722222222,536,1682,1161,360,0,360,0,67,0,0,empty,mBC-0814-1
"A9,A9",7643,8489,5475,3014,4765,0,2629,2634,1856,778,2.385604113,1413,1695,1165,301,0,301,0,52,0,0,empty,mBC-0814-1
"A9,A10",3726,4089,2581,1508,2342,2,1311,1317,944,373,2.530831099,744,3011,760,254,1,253,1,42,0,0,empty,mBC-0814-1
"A9,A11",362568,418004,240627,177377,249052,1,155699,155893,126789,29104,4.35641149,93041,109283,78087,21620,11,21609,3,1571,0,0.000971817,mm10,mBC-0814-1
"A9,A12",3697,3882,2632,1250,2320,0,1264,1266,962,304,3.164473684,655,3098,2138,626,0,626,0,142,0,0,empty,mBC-0814-1
"A9,B1",448041,516063,300047,216016,305204,1,188550,188755,158204,30551,5.178357501,112182,157553,112893,32997,26,32971,4,1908,0,0.000636923,mm10,mBC-0814-1
"A9,B2",4856,5155,3447,1708,3032,1,1620,1621,1165,456,2.554824561,879,490,329,76,1,75,1,19,0,0,empty,mBC-0814-1
"A9,B3",4006,4252,2871,1381,2592,0,1431,1433,1025,408,2.512254902,730,1290,972,292,1,291,1,37,0,0.048109966,empty,mBC-0814-1
"A9,B4",4483,4748,3242,1506,2827,0,1516,1520,1059,461,2.297180043,812,1208,787,275,0,275,0,54,0,0,empty,mBC-0814-1
"A9,B5",3921,2619,1746,873,1812,0,977,983,723,260,2.780769231,541,906,597,173,0,173,0,43,0,0.005780347,empty,mBC-0814-1
"A9,B6",4093,4522,2993,1529,2631,1,1428,1436,1005,431,2.331786543,770,1036,634,212,0,212,0,49,0,0,empty,mBC-0814-1
"A9,B7",5349,5742,3755,1987,3327,0,1788,1794,1254,540,2.322222222,968,964,674,170,0,170,0,47,0,0.023529412,empty,mBC-0814-1
"A9,B8",4110,4456,2972,1484,2580,0,1369,1374,986,388,2.541237113,746,1363,904,246,0,246,0,56,0,0.085365854,empty,mBC-0814-1
"A9,B9",390707,462657,257353,205304,271977,0,172960,173131,144529,28602,5.053108174,105378,50369,36178,10050,8,10042,1,1045,0,9.95818E-05,mm10,mBC-0814-1
"A9,B10",4588,4842,3259,1583,2912,0,1538,1542,1064,478,2.225941423,825,469,314,112,0,112,0,24,0,0,empty,mBC-0814-1
"A9,B11",6644,7325,4793,2532,4244,0,2336,2338,1690,648,2.608024691,1263,133,63,20,0,20,0,7,0,0,empty,mBC-0814-1
"A9,B12",5477,5823,3925,1898,3441,0,1855,1859,1364,495,2.755555556,996,1524,1005,270,0,270,0,56,0,0.077777778,empty,mBC-0814-1
"A9,C1",7204,7898,5049,2849,4561,0,2559,2562,1508,1054,1.430740038,1426,4438,1714,512,0,512,0,67,0,0.087890625,empty,mBC-0814-1
"A9,C2",5431,5681,3876,1805,3326,0,1766,1773,1306,467,2.796573876,940,1526,992,331,1,330,1,75,0,0,empty,mBC-0814-1
"A9,C3",6012,6546,4278,2268,3817,6,2052,2060,1500,560,2.678571429,1123,574,326,97,0,97,0,22,0,0.175257732,empty,mBC-0814-1
"A9,C4",572140,638535,388124,250411,374783,2,225447,225697,176296,49401,3.568672699,129908,160781,117445,33224,22,33202,3,2083,0,0.000301187,mm10,mBC-0814-1
"A9,C5",7355,7860,5214,2646,4557,0,2497,2503,1805,698,2.585959885,1339,9988,3224,1102,3,1099,3,136,0,0.020928116,empty,mBC-0814-1
"A9,C6",5753,6211,4115,2096,3686,1,2024,2031,1436,595,2.413445378,1042,1298,968,316,0,316,0,71,0,0,empty,mBC-0814-1
"A9,C7",7626,8168,5476,2692,4722,6,2467,2477,1812,665,2.72481203,1276,496,405,121,0,121,0,25,0,0,empty,mBC-0814-1
"A9,C8",5752,6213,4100,2113,3600,0,1918,1920,1347,573,2.35078534,1031,2244,1493,460,0,460,0,72,0,0.034782609,empty,mBC-0814-1
"A9,C9",4851,5238,3475,1763,3012,0,1664,1665,1175,490,2.397959184,873,1231,798,236,0,236,0,56,0,0.063559322,empty,mBC-0814-1
"A9,C10",5797,6374,4134,2240,3639,1,1966,1969,1441,528,2.729166667,1033,1818,1020,283,0,283,0,45,0,0.201413428,empty,mBC-0814-1
"A9,C11",5082,5524,3643,1881,3116,0,1712,1714,1216,498,2.441767068,868,5886,2047,564,1,563,1,76,0,0.001776199,empty,mBC-0814-1
"A9,C12",8349,9070,5937,3133,5244,0,2849,2850,2063,787,2.621346887,1536,2596,1456,485,1,484,1,87,0,0.020661157,empty,mBC-0814-1
"A9,D1",4355,4549,3090,1459,2661,0,1409,1412,998,414,2.410628019,720,621,450,99,0,99,0,27,0,0,empty,mBC-0814-1
"A9,D2",5611,5983,4122,1861,3479,0,1796,1799,1264,535,2.362616822,949,1708,1239,341,1,340,1,75,0,0.023529412,empty,mBC-0814-1
"A9,D3",10750,11383,7802,3581,6709,0,3513,3521,2565,956,2.683054393,1798,2803,2112,586,0,586,0,102,0,0.042662116,empty,mBC-0814-1
"A9,D4",771793,910596,507513,403083,542108,0,352735,353097,284109,68988,4.118237954,214852,191172,137793,38014,24,37990,4,2491,0,0.000816004,mm10,mBC-0814-1
"A9,D5",4438,4915,3094,1821,2880,0,1588,1592,1114,478,2.330543933,917,2021,1463,370,0,370,0,81,0,0,empty,mBC-0814-1
"A9,D6",5143,5515,3715,1800,3237,0,1736,1736,1192,544,2.191176471,924,1240,874,278,0,278,0,44,0,0,empty,mBC-0814-1
"A9,D7",189235,212929,133249,79680,124928,0,73465,73575,58162,15413,3.773567767,41806,23235,15613,4345,2,4343,1,550,0,0.007368179,mm10,mBC-0814-1
"A9,D8",715618,832572,472623,359949,484743,0,308993,309315,250534,58781,4.262159541,185594,103758,72211,20218,11,20207,3,1539,0,0.000148463,mm10,mBC-0814-1
"A9,D9",2944,3121,2153,968,1861,0,1015,1015,729,286,2.548951049,535,1919,1239,387,0,387,0,67,0,0,empty,mBC-0814-1
"A9,D10",3852,4193,2680,1513,2465,0,1363,1367,997,370,2.694594595,742,885,566,182,1,181,1,35,0,0.022099448,empty,mBC-0814-1
"A9,D11",1564887,1750311,1074190,676121,1010020,1,619696,620423,477836,142587,3.351189099,356210,395367,277596,77755,51,77704,2,3802,0,0.002470915,mm10,mBC-0814-1
"A9,D12",6656,7065,4724,2341,4117,0,2238,2238,1490,748,1.99197861,1206,3276,2455,766,0,766,0,115,0,0.014360313,empty,mBC-0814-1
"A9,E1",477194,551706,316208,235498,326793,0,209398,209612,150960,58652,2.573825275,125984,76997,42412,11854,11,11843,2,1149,0,0.018491936,mm10,mBC-0814-1
"A9,E2",378254,443138,253055,190083,262890,0,164960,165126,139623,25503,5.474767674,99173,162477,114845,31637,17,31620,2,2045,0,0.00056926,mm10,mBC-0814-1
"A9,E3",3693,3947,2684,1263,2365,2,1246,1249,916,333,2.750750751,639,1145,731,251,0,251,0,54,0,0,empty,mBC-0814-1
"A9,E4",3124,3319,2281,1038,2001,1,1109,1111,831,280,2.967857143,557,1147,765,231,0,231,0,53,0,0.008658009,empty,mBC-0814-1
"A9,E5",3916,4255,2892,1363,2456,0,1301,1302,971,331,2.933534743,665,905,658,164,0,164,0,37,0,0.042682927,empty,mBC-0814-1
"A9,E6",4656,4952,3414,1538,2822,0,1492,1492,1131,361,3.132963989,783,1357,904,236,0,236,0,60,0,0,empty,mBC-0814-1
"A9,E7",4851,5005,3521,1484,2816,0,1425,1427,1007,420,2.397619048,699,1456,1017,262,0,262,0,49,0,0,empty,mBC-0814-1
"A9,E8",4825,5073,3496,1577,2983,0,1561,1568,1100,468,2.35042735,820,2203,1568,415,0,415,0,80,0,0.036144578,empty,mBC-0814-1
"A9,E9",3349,3527,2361,1166,2111,0,1102,1102,756,346,2.184971098,629,1189,793,226,0,226,0,48,0,0,empty,mBC-0814-1
"A9,E10",4163,4607,3005,1602,2683,0,1450,1453,1047,406,2.578817734,796,1852,1327,356,0,356,0,86,0,0,empty,mBC-0814-1
"A9,E11",6430,6750,4726,2024,3917,0,2079,2080,1266,814,1.555282555,1006,8207,6399,1853,0,1853,0,205,0,0.001618996,empty,mBC-0814-1
"A9,E12",3922,4232,2837,1395,2492,0,1391,1391,958,433,2.212471132,710,1189,884,276,1,275,1,42,0,0.003636364,empty,mBC-0814-1
"A9,F1",4829,5067,3383,1684,2940,4,1586,1595,1151,444,2.592342342,813,1669,1203,341,0,341,0,66,0,0,empty,mBC-0814-1
"A9,F2",7032,7483,5026,2457,4300,0,2302,2307,1649,658,2.506079027,1195,2074,1406,431,0,431,0,95,0,0,empty,mBC-0814-1
"A9,F3",5244,5681,3774,1907,3251,0,1748,1757,1251,506,2.472332016,943,1337,867,295,0,295,0,69,0,0.027118644,empty,mBC-0814-1
"A9,F4",617498,705207,413985,291222,415968,8,256497,256815,218452,38363,5.694340901,150861,73916,48558,13109,10,13099,2,1210,0,0.001297809,mm10,mBC-0814-1
"A9,F5",5346,5892,3820,2072,3421,0,1908,1911,1377,534,2.578651685,1063,1469,1100,304,0,304,0,57,0,0,empty,mBC-0814-1
"A9,F6",5014,5506,3616,1890,3239,0,1795,1800,1243,557,2.231597846,951,2425,1769,497,0,497,0,92,0,0.002012072,empty,mBC-0814-1
"A9,F7",4462,4884,3220,1664,2878,0,1589,1591,1154,437,2.640732265,826,689,540,173,0,173,0,37,0,0,empty,mBC-0814-1
"A9,F8",6229,6676,4455,2221,3895,0,2067,2070,1491,579,2.575129534,1081,216,158,60,0,60,0,11,0,0,empty,mBC-0814-1
"A9,F9",5744,6072,4193,1879,3498,1,1836,1838,1314,524,2.507633588,931,1986,1433,454,0,454,0,79,0,0.002202643,empty,mBC-0814-1
"A9,F10",578840,666632,387874,278758,394212,0,250706,251017,195943,55074,3.557813124,149383,13735,9642,2594,2,2592,1,355,0,0,mm10,mBC-0814-1
"A9,F11",4253,4494,3032,1462,2628,0,1361,1361,977,384,2.544270833,699,1539,1132,359,0,359,0,77,0,0,empty,mBC-0814-1
"A9,F12",5109,5616,3585,2031,3190,0,1808,1811,1303,508,2.56496063,1011,146,116,32,0,32,0,13,0,0,empty,mBC-0814-1
"A9,G1",8007,8502,5848,2654,4990,0,2689,2693,1858,835,2.225149701,1399,3631,2650,720,0,720,0,136,0,0.001388889,empty,mBC-0814-1
"A9,G2",453624,529912,299278,230634,312976,0,198208,198432,154481,43951,3.514846079,119711,71174,47054,12824,9,12815,2,1199,0,0.002731174,mm10,mBC-0814-1
"A9,G3",5153,5512,3687,1825,3225,1,1790,1792,1279,513,2.493177388,970,2134,1534,441,0,441,0,97,0,0,empty,mBC-0814-1
"A9,G4",5380,5668,3898,1770,3278,0,1726,1734,1217,517,2.353965184,915,12,4,3,0,3,0,3,0,0,empty,mBC-0814-1
"A9,G5",390176,447186,256851,190335,266940,2,170227,170426,136187,34239,3.977540232,102561,14940,10113,2708,2,2706,1,386,0,0.000369549,mm10,mBC-0814-1
"A9,G6",9044,9819,6513,3306,5626,0,3014,3020,2179,841,2.590963139,1587,188,167,51,0,51,0,8,0,0,empty,mBC-0814-1
"A9,G7",5707,5907,4189,1718,3474,0,1784,1785,1272,513,2.479532164,874,23138,7629,2337,3,2334,1,282,0,0.041559554,empty,mBC-0814-1
"A9,G8",7113,7618,4989,2629,4465,0,2446,2462,1742,720,2.419444444,1338,3347,2285,644,0,644,0,133,0,0.00310559,empty,mBC-0814-1
"A9,G9",5321,5608,3804,1804,3293,0,1756,1756,1233,523,2.357552581,892,2471,1770,555,0,555,0,120,0,0.003603604,empty,mBC-0814-1
"A9,G10",9090,9616,6534,3082,5676,0,3027,3030,2104,926,2.272138229,1586,3255,2400,718,0,718,0,147,0,0.022284123,empty,mBC-0814-1
"A9,G11",510634,589026,342928,246098,347465,1,218090,218379,152172,66207,2.298427659,129816,33780,23317,6574,3,6571,1,689,0,0,mm10,mBC-0814-1
"A9,G12",4763,5136,3370,1766,3020,0,1685,1687,1196,491,2.435845214,905,2528,1887,491,0,491,0,92,0,0.00407332,empty,mBC-0814-1
"A9,H1",4671,5073,3344,1729,2928,0,1576,1578,1134,444,2.554054054,840,843,652,160,0,160,0,47,0,0,empty,mBC-0814-1
"A9,H2",9749,10499,6960,3539,6161,5,3364,3381,2446,935,2.616042781,1799,6861,3356,1059,2,1057,1,159,0,0.023651845,empty,mBC-0814-1
"A9,H3",5904,6217,4134,2083,3589,0,1931,1934,1381,553,2.497287523,1013,14442,4083,1294,1,1293,1,159,0,0.057231245,empty,mBC-0814-1
"A9,H4",5460,5868,3908,1960,3425,0,1829,1835,1292,543,2.379373849,980,72,46,22,0,22,0,9,0,0,empty,mBC-0814-1
"A9,H5",7298,7774,5243,2531,4300,0,2255,2261,1579,682,2.315249267,1206,2162,1379,430,0,430,0,72,0,0,empty,mBC-0814-1
"A9,H6",7282,7607,5166,2441,4432,0,2437,2437,1744,693,2.516594517,1233,32507,10545,3325,3,3322,1,325,0,0.092414208,empty,mBC-0814-1
"A9,H7",5529,5864,3917,1947,3467,0,1859,1863,1315,548,2.399635036,1003,1629,1060,284,0,284,0,55,0,0,empty,mBC-0814-1
"A9,H8",4662,4949,3323,1626,2825,0,1524,1527,1088,439,2.478359909,815,1440,1004,342,0,342,0,94,0,0.01754386,empty,mBC-0814-1
"A9,H9",6283,6641,4399,2242,4008,0,2183,2183,1572,611,2.572831424,1230,1758,1232,377,0,377,0,61,0,0.058355438,empty,mBC-0814-1
"A9,H10",3727,4114,2734,1380,2342,0,1270,1272,891,381,2.338582677,646,932,670,205,0,205,0,45,0,0,empty,mBC-0814-1
"A9,H11",3845,4229,2670,1559,2548,0,1397,1403,1018,385,2.644155844,801,19,12,5,0,5,0,5,0,0,empty,mBC-0814-1
"A9,H12",2682,3078,1825,1253,1767,0,985,989,688,301,2.285714286,591,1501,997,327,0,327,0,68,0,0.006116208,empty,mBC-0814-1
"A10,A1",1257794,1453455,845324,608131,849914,2,530769,531385,443647,87738,5.056497755,314805,509387,318964,91012,66,90946,7,3872,0,0.002430013,mm10,mBC-0814-1
"A10,A2",4615,4639,3346,1293,2781,0,1465,1470,1053,417,2.525179856,717,1628,1131,407,0,407,0,120,0,0.022113022,empty,mBC-0814-1
"A10,A3",4465,4825,3058,1767,2878,0,1601,1604,1125,479,2.348643006,909,1720,1281,302,0,302,0,61,0,0.039735099,empty,mBC-0814-1
"A10,A4",5753,6161,4213,1948,3615,1,1866,1871,1358,513,2.647173489,992,541,357,104,0,104,0,27,0,0,empty,mBC-0814-1
"A10,A5",4781,5200,3348,1852,3063,0,1668,1676,1195,481,2.484407484,871,4872,2414,681,0,681,0,101,0,0.057268722,empty,mBC-0814-1
"A10,A6",3769,4088,2648,1440,2386,0,1290,1292,937,355,2.63943662,717,1847,1404,386,0,386,0,75,0,0.051813472,empty,mBC-0814-1
"A10,A7",5558,5679,3947,1732,3392,0,1831,1833,1328,505,2.62970297,917,1942,1392,433,0,433,0,109,0,0.004618938,empty,mBC-0814-1
"A10,A8",205583,247397,134495,112902,149917,0,96719,96814,79559,17255,4.610779484,59890,194661,140686,39623,30,39593,3,2284,0,0.00025257,mm10,mBC-0814-1
"A10,A9",7170,7641,5182,2459,4445,0,2353,2358,1755,603,2.910447761,1214,1791,1247,336,0,336,0,70,0,0.005952381,empty,mBC-0814-1
"A10,A10",3313,3575,2355,1220,2123,1,1148,1149,812,337,2.409495549,581,5239,1295,439,0,439,0,60,0,0,empty,mBC-0814-1
"A10,A11",4505,4639,3282,1357,2751,0,1495,1496,1067,429,2.487179487,702,2621,1935,567,1,566,1,117,0,0.012367491,empty,mBC-0814-1
"A10,A12",3439,3553,2442,1111,2176,0,1158,1158,857,301,2.84717608,597,3436,2456,812,0,812,0,228,0,0,empty,mBC-0814-1
"A10,B1",4843,5348,3451,1897,3008,0,1649,1652,1156,496,2.330645161,849,2704,1304,419,0,419,0,95,0,0.014319809,empty,mBC-0814-1
"A10,B2",4806,5105,3374,1731,3043,0,1641,1644,1144,500,2.288,914,426,208,71,0,71,0,33,0,0,empty,mBC-0814-1
"A10,B3",3813,4008,2722,1286,2399,0,1340,1346,964,382,2.523560209,686,1981,1365,372,0,372,0,63,0,0,empty,mBC-0814-1
"A10,B4",4169,4409,2874,1535,2649,0,1452,1456,1042,414,2.516908213,772,34414,9953,3126,6,3120,3,307,0,0.065384615,empty,mBC-0814-1
"A10,B5",3636,2438,1514,924,1720,3,960,965,675,290,2.327586207,571,957,662,202,0,202,0,52,0,0,empty,mBC-0814-1
"A10,B6",3983,4385,2809,1576,2565,4,1437,1445,1023,422,2.424170616,815,1357,889,299,0,299,0,66,0,0.046822742,empty,mBC-0814-1
"A10,B7",5135,5451,3665,1786,3236,0,1694,1696,1234,462,2.670995671,895,1334,937,290,1,289,1,62,0,0,empty,mBC-0814-1
"A10,B8",3868,4085,2783,1302,2424,0,1275,1275,896,379,2.364116095,682,1344,965,334,0,334,0,69,0,0.002994012,empty,mBC-0814-1
"A10,B9",4547,4865,3246,1619,2921,0,1588,1591,1101,490,2.246938776,878,7110,2086,659,0,659,0,112,0,0.001517451,empty,mBC-0814-1
"A10,B10",4159,4220,2909,1311,2583,0,1318,1321,979,342,2.862573099,703,569,429,129,0,129,0,23,0,0,empty,mBC-0814-1
"A10,B11",6408,6912,4506,2406,4018,0,2179,2181,1556,625,2.4896,1190,90,61,19,0,19,0,10,0,0,empty,mBC-0814-1
"A10,B12",5263,5692,3798,1894,3399,0,1879,1883,1364,519,2.628131021,1004,4872,1871,520,2,518,1,96,0,0.011583012,empty,mBC-0814-1
"A10,C1",632688,727367,424490,302877,424227,0,259543,259842,213590,46252,4.617962466,153043,136557,97528,27040,16,27024,2,1969,0,3.70041E-05,mm10,mBC-0814-1
"A10,C2",5405,5661,3883,1778,3335,0,1745,1747,1298,449,2.890868597,915,1907,1296,428,1,427,1,110,0,0,empty,mBC-0814-1
"A10,C3",7268,7925,5246,2679,4756,0,2682,2691,2009,682,2.945747801,1405,1101,751,208,0,208,0,53,0,0.091346154,empty,mBC-0814-1
"A10,C4",4811,5010,3500,1510,2999,0,1588,1591,1143,448,2.551339286,824,1310,834,278,0,278,0,70,0,0,empty,mBC-0814-1
"A10,C5",7723,8095,5469,2626,4790,0,2646,2652,1919,733,2.618008186,1382,6146,2747,813,1,812,1,145,0,0,empty,mBC-0814-1
"A10,C6",5152,5433,3676,1757,3264,0,1741,1743,1264,479,2.638830898,924,1999,1472,461,0,461,0,96,0,0,empty,mBC-0814-1
"A10,C7",747442,850148,497698,352450,495865,2,315812,316150,239981,76169,3.150638711,185903,9022,6169,1759,0,1759,0,245,0,0,mm10,mBC-0814-1
"A10,C8",9951,11543,6596,4947,6852,0,4279,4284,2428,1856,1.308189655,2581,13341,4992,1499,1,1498,1,202,0,0.037383178,empty,mBC-0814-1
"A10,C9",4544,4923,3245,1678,2887,0,1571,1571,1113,458,2.430131004,834,1460,1023,256,0,256,0,73,0,0,empty,mBC-0814-1
"A10,C10",5573,6096,3963,2133,3596,0,1983,1989,1435,554,2.590252708,1069,1506,980,321,1,320,1,72,0,0,empty,mBC-0814-1
"A10,C11",7982,8560,5385,3175,5115,0,3027,3029,1994,1035,1.926570048,1638,3879,2259,623,0,623,0,126,0,0.097913323,empty,mBC-0814-1
"A10,C12",1017513,1188862,671395,517467,699232,1,458420,458868,335312,123556,2.713846353,278527,89298,63071,17878,4,17874,2,1458,0,0.001174891,mm10,mBC-0814-1
"A10,D1",4044,4371,2822,1549,2560,4,1397,1403,1045,358,2.918994413,767,819,534,165,2,163,1,42,0,0,empty,mBC-0814-1
"A10,D2",5485,5827,3968,1859,3450,0,1838,1838,1270,568,2.235915493,963,10294,3689,1091,1,1090,1,163,0,0.062385321,empty,mBC-0814-1
"A10,D3",515248,584335,348148,236187,345990,1,209544,209832,161149,48683,3.310169874,122733,38134,17283,4614,8,4606,2,623,0,0.008250109,mm10,mBC-0814-1
"A10,D4",4579,4998,3248,1750,2889,0,1584,1585,1095,490,2.234693878,869,1754,1317,382,0,382,0,87,0,0,empty,mBC-0814-1
"A10,D5",3774,4088,2535,1553,2510,3,1407,1410,1018,392,2.596938776,793,1945,1385,379,0,379,0,98,0,0.029023747,empty,mBC-0814-1
"A10,D6",4944,5470,3569,1901,3152,0,1721,1723,1197,526,2.275665399,919,1878,1251,334,0,334,0,80,0,0,empty,mBC-0814-1
"A10,D7",5553,5692,3945,1747,3348,0,1729,1733,1221,512,2.384765625,857,2348,1609,490,0,490,0,113,0,0,empty,mBC-0814-1
"A10,D8",4904,5296,3416,1880,3141,0,1768,1768,1346,422,3.18957346,947,3720,1327,476,0,476,0,90,0,0.052521008,empty,mBC-0814-1
"A10,D9",3043,3332,2140,1192,1934,0,1070,1070,761,309,2.462783172,602,1736,1187,312,1,311,1,64,0,0,empty,mBC-0814-1
"A10,D10",4046,4523,2884,1639,2672,0,1524,1529,1104,425,2.597647059,838,788,540,199,0,199,0,56,0,0,empty,mBC-0814-1
"A10,D11",277643,324003,186768,137235,191083,1,117564,117710,99833,17877,5.584438105,69997,201154,143158,38906,17,38889,1,2263,0,0.000514284,mm10,mBC-0814-1
"A10,D12",6134,6725,4294,2431,3926,0,2178,2180,1590,590,2.694915254,1227,23138,8595,2464,3,2461,1,253,0,0.032100772,empty,mBC-0814-1
"A10,E1",4879,5231,3636,1595,3068,0,1605,1608,1107,501,2.209580838,810,2935,1964,530,1,529,1,97,0,0.075614367,empty,mBC-0814-1
"A10,E2",3648,3717,2615,1102,2153,1,1129,1130,745,385,1.935064935,572,1485,1132,336,1,335,1,80,0,0,empty,mBC-0814-1
"A10,E3",3580,3864,2563,1301,2224,0,1170,1170,870,300,2.9,616,1568,970,270,2,268,1,65,0,0,empty,mBC-0814-1
"A10,E4",3158,3479,2250,1229,2066,1,1129,1133,780,353,2.209631728,615,1211,837,239,0,239,0,63,0,0.025104603,empty,mBC-0814-1
"A10,E5",3988,4158,2873,1285,2470,0,1293,1295,965,330,2.924242424,686,1083,813,253,0,253,0,56,0,0,empty,mBC-0814-1
"A10,E6",472774,517558,329728,187830,304762,0,177713,177902,135074,42828,3.153871299,100627,22033,15687,4141,1,4140,1,560,0,0,mm10,mBC-0814-1
"A10,E7",4511,4818,3262,1556,2831,0,1530,1530,1053,477,2.20754717,802,2115,1383,417,0,417,0,76,0,0.057553957,empty,mBC-0814-1
"A10,E8",4770,5163,3406,1757,2988,0,1601,1601,1173,428,2.740654206,861,2101,1454,445,1,444,1,89,0,0,empty,mBC-0814-1
"A10,E9",308773,350205,207026,143179,209497,0,130479,130603,96724,33879,2.854983913,77586,45845,30925,9139,4,9135,2,917,0,0.002298851,mm10,mBC-0814-1
"A10,E10",4154,4507,3006,1501,2609,0,1430,1432,1053,379,2.778364116,737,1745,1211,382,0,382,0,99,0,0,empty,mBC-0814-1
"A10,E11",4002,4133,2907,1226,2518,0,1300,1300,913,387,2.359173127,651,1654,1189,384,0,384,0,99,0,0,empty,mBC-0814-1
"A10,E12",4914,5316,3555,1761,3183,0,1705,1705,1211,494,2.451417004,916,1604,1059,335,0,335,0,94,0,0.005970149,empty,mBC-0814-1
"A10,F1",4608,4910,3318,1592,2898,0,1532,1533,1105,428,2.581775701,813,1715,1300,398,0,398,0,84,0,0.012562814,empty,mBC-0814-1
"A10,F2",689182,795326,464720,330606,466186,1,288527,288862,229309,59553,3.850502913,171204,205062,148159,41784,37,41747,3,2469,0,0.000191631,mm10,mBC-0814-1
"A10,F3",5068,5449,3575,1874,3234,3,1768,1774,1239,535,2.31588785,987,2513,1732,485,0,485,0,93,0,0.018556701,empty,mBC-0814-1
"A10,F4",5170,5399,3642,1757,3156,2,1694,1701,1195,506,2.361660079,867,990,783,189,0,189,0,44,0,0,empty,mBC-0814-1
"A10,F5",5271,5620,3783,1837,3272,0,1726,1729,1187,542,2.1900369,908,1721,1185,381,0,381,0,94,0,0,empty,mBC-0814-1
"A10,F6",4631,4909,3258,1651,2922,0,1616,1620,1112,508,2.188976378,864,2235,1519,498,0,498,0,116,0,0.020080321,empty,mBC-0814-1
"A10,F7",4574,4903,3396,1507,2936,0,1585,1585,1085,500,2.17,797,835,592,183,0,183,0,40,0,0,empty,mBC-0814-1
"A10,F8",5992,6276,4431,1845,3688,1,1928,1933,1401,532,2.633458647,984,233,181,55,0,55,0,16,0,0,empty,mBC-0814-1
"A10,F9",5568,6095,4056,2039,3511,0,1846,1849,1301,548,2.374087591,973,2397,1743,513,0,513,0,95,0,0.023391813,empty,mBC-0814-1
"A10,F10",6463,6806,4675,2131,3989,0,2055,2059,1483,576,2.574652778,1039,1901,1327,386,0,386,0,97,0,0,empty,mBC-0814-1
"A10,F11",486437,551248,323969,227279,326988,3,202319,202510,162000,40510,3.999012589,119716,197348,146595,41667,23,41644,1,2301,0,0.00031217,mm10,mBC-0814-1
"A10,F12",4697,5002,3294,1708,2926,0,1593,1593,1127,466,2.418454936,837,100,81,16,0,16,0,12,0,0,empty,mBC-0814-1
"A10,G1",7284,7665,5263,2402,4585,0,2429,2436,1775,661,2.685325265,1258,3879,2751,859,2,857,1,170,0,0.001166861,empty,mBC-0814-1
"A10,G2",5732,6172,4113,2059,3526,0,1838,1842,1300,542,2.398523985,945,602,395,101,0,101,0,25,0,0,empty,mBC-0814-1
"A10,G3",5195,5498,3721,1777,3182,0,1723,1729,1209,520,2.325,877,2559,1812,542,0,542,0,126,0,0.014760148,empty,mBC-0814-1
"A10,G4",5272,5590,3826,1764,3246,0,1631,1635,1125,510,2.205882353,828,4,1,1,0,1,0,1,0,0,empty,mBC-0814-1
"A10,G5",4838,5253,3391,1862,3006,0,1586,1589,1109,480,2.310416667,901,7475,2840,936,0,936,0,124,0,0.023504274,empty,mBC-0814-1
"A10,G6",577965,656609,396354,260255,386396,0,231368,231641,189681,41960,4.520519542,134721,8555,5832,1631,0,1631,0,216,0,0,mm10,mBC-0814-1
"A10,G7",5255,5657,3811,1846,3427,0,1821,1824,1321,503,2.626242545,970,2356,1602,518,0,518,0,114,0,0,empty,mBC-0814-1
"A10,G8",430771,497444,283730,213714,294929,0,183511,183737,155889,27848,5.597852629,110413,246646,169013,48356,32,48324,2,2782,0,0.001614105,mm10,mBC-0814-1
"A10,G9",5168,5454,3673,1781,3184,0,1683,1683,1166,517,2.255319149,882,2713,1977,606,0,606,0,154,0,0.001650165,empty,mBC-0814-1
"A10,G10",1202058,1375023,808735,566288,805131,1,501541,502110,395022,107088,3.688760645,296146,510713,365675,102738,61,102677,7,4151,0,0.00013635,mm10,mBC-0814-1
"A10,G11",9826,10282,6866,3416,6002,0,3172,3176,2199,977,2.250767656,1754,20204,6587,1988,3,1985,1,227,0,0.020654912,empty,mBC-0814-1
"A10,G12",4538,4988,3151,1837,2946,0,1643,1646,1231,415,2.96626506,875,2627,1792,562,0,562,0,117,0,0.005338078,empty,mBC-0814-1
"A10,H1",4490,4762,3186,1576,2763,2,1513,1516,1062,454,2.339207048,797,1373,985,337,1,336,1,73,0,0.035714286,empty,mBC-0814-1
"A10,H2",8241,9111,5772,3339,5312,0,2978,2986,2190,796,2.751256281,1674,4553,3098,944,0,944,0,198,0,0.023305085,empty,mBC-0814-1
"A10,H3",5168,5600,3741,1859,3232,0,1737,1738,1220,518,2.355212355,921,2333,1640,505,0,505,0,102,0,0.00990099,empty,mBC-0814-1
"A10,H4",5321,5718,3805,1913,3414,0,1859,1862,1296,566,2.28975265,1017,78,52,15,0,15,0,11,0,0,empty,mBC-0814-1
"A10,H5",637043,753070,429109,323961,440539,1,278764,279090,211932,67158,3.155722326,167919,191911,140605,39881,20,39861,2,2402,0,0.00017561,mm10,mBC-0814-1
"A10,H6",5953,6440,4277,2163,3784,0,2036,2036,1442,594,2.427609428,1094,2941,2036,636,0,636,0,133,0,0.007861635,empty,mBC-0814-1
"A10,H7",5355,5599,3804,1795,3290,2,1701,1707,1246,461,2.702819957,873,2270,1559,396,0,396,0,72,0,0.002525253,empty,mBC-0814-1
"A10,H8",464636,530230,315087,215143,311700,0,187104,187303,161262,26041,6.192619331,110139,302652,210102,59298,42,59256,3,3208,0,0.000219387,mm10,mBC-0814-1
"A10,H9",4934,5145,3414,1731,3094,0,1675,1678,1216,462,2.632034632,884,1611,1128,336,1,335,1,69,0,0.023880597,empty,mBC-0814-1
"A10,H10",3296,3491,2422,1069,2061,0,1110,1112,782,330,2.36969697,535,784,504,183,0,183,0,43,0,0,empty,mBC-0814-1
"A10,H11",3735,4095,2641,1454,2473,1,1423,1424,1003,421,2.382422803,786,46,40,24,0,24,0,12,0,0.25,empty,mBC-0814-1
"A10,H12",2179,2466,1534,932,1439,0,835,835,600,235,2.553191489,456,1686,1250,391,0,391,0,88,0,0,empty,mBC-0814-1
"A11,A1",5950,6328,4273,2055,3801,0,2096,2099,1510,589,2.563667233,1107,1232,815,277,0,277,0,57,0,0,empty,mBC-0814-1
"A11,A2",5611,5990,4061,1929,3519,0,1878,1878,1417,461,3.073752711,984,1296,869,343,0,343,0,96,0,0.052478134,empty,mBC-0814-1
"A11,A3",5185,5536,3754,1782,3278,0,1765,1771,1259,512,2.458984375,928,1540,1093,316,0,316,0,51,0,0,empty,mBC-0814-1
"A11,A4",5751,5975,4204,1771,3505,0,1837,1839,1309,530,2.469811321,902,431,224,79,0,79,0,25,0,0,empty,mBC-0814-1
"A11,A5",4899,5362,3512,1850,3188,0,1739,1741,1242,499,2.488977956,945,5970,1942,623,1,622,1,83,0,0.011254019,empty,mBC-0814-1
"A11,A6",4093,4318,2897,1421,2513,0,1387,1390,943,447,2.109619687,688,3434,1561,454,0,454,0,61,0,0.145374449,empty,mBC-0814-1
"A11,A7",538871,629237,348771,280466,372176,0,241430,241703,185346,56357,3.288784002,146673,132341,90920,25313,22,25291,3,1845,0,0.001462971,mm10,mBC-0814-1
"A11,A8",2358,2469,1713,756,1502,0,816,818,609,209,2.913875598,404,1356,926,274,0,274,0,59,0,0,empty,mBC-0814-1
"A11,A9",6684,7016,4803,2213,4172,0,2215,2219,1510,709,2.129760226,1136,1457,1025,342,1,341,1,57,0,0.011730205,empty,mBC-0814-1
"A11,A10",3764,4097,2656,1441,2440,2,1330,1333,903,430,2.1,719,750,418,148,0,148,0,18,0,0,empty,mBC-0814-1
"A11,A11",411409,463464,280850,182614,277791,0,170575,170774,127959,42815,2.988648838,98943,24314,16229,4539,0,4539,0,519,0,0.00616876,mm10,mBC-0814-1
"A11,A12",4082,4436,2956,1480,2577,1,1403,1404,998,406,2.458128079,731,3197,2312,687,0,687,0,154,0,0,empty,mBC-0814-1
"A11,B1",4946,5363,3516,1847,3154,0,1669,1676,1202,474,2.535864979,895,1551,1170,366,0,366,0,81,0,0.027322404,empty,mBC-0814-1
"A11,B2",5063,5253,3597,1656,3119,0,1636,1649,1178,471,2.501061571,838,819,507,133,0,133,0,34,0,0,empty,mBC-0814-1
"A11,B3",5137,5495,3607,1888,3253,1,1850,1852,1417,435,3.257471264,969,13120,3888,1204,4,1200,2,129,0,0.134166667,empty,mBC-0814-1
"A11,B4",4454,4804,3244,1560,2845,0,1518,1521,1082,439,2.464692483,798,1347,883,262,0,262,0,59,0,0,empty,mBC-0814-1
"A11,B5",4114,2705,1692,1013,1954,0,1137,1146,810,336,2.410714286,686,720,554,161,0,161,0,46,0,0,empty,mBC-0814-1
"A11,B6",4425,4721,3095,1626,2729,0,1452,1452,1024,428,2.392523364,790,13768,4245,1245,1,1244,1,143,0,0.074758842,empty,mBC-0814-1
"A11,B7",635874,763282,412506,350776,449418,1,295134,295431,247317,48114,5.140229455,181604,184100,132064,37010,22,36988,1,2265,0,0.000432573,mm10,mBC-0814-1
"A11,B8",4061,4393,2938,1455,2553,0,1396,1396,1013,383,2.644908616,752,997,705,221,0,221,0,47,0,0.036199095,empty,mBC-0814-1
"A11,B9",4669,4893,3341,1552,2974,0,1546,1550,1093,457,2.391684902,807,677,509,176,0,176,0,44,0,0,empty,mBC-0814-1
"A11,B10",4597,4822,3191,1631,2928,0,1634,1636,1175,461,2.548806941,870,600,422,91,0,91,0,22,0,0.010989011,empty,mBC-0814-1
"A11,B11",8127,8956,5673,3283,5203,1,2901,2905,2096,809,2.590852905,1653,168,120,42,0,42,0,7,0,0,empty,mBC-0814-1
"A11,B12",5667,6271,3971,2300,3681,0,2089,2094,1420,674,2.106824926,1151,1022,735,201,0,201,0,52,0,0,empty,mBC-0814-1
"A11,C1",5804,6201,4103,2098,3556,0,1878,1880,1298,582,2.23024055,999,830,624,190,0,190,0,40,0,0,empty,mBC-0814-1
"A11,C2",5887,6178,4200,1978,3520,0,1877,1880,1344,536,2.507462687,976,1725,1242,402,0,402,0,81,0,0.077114428,empty,mBC-0814-1
"A11,C3",649600,749987,439726,310261,436158,1,267671,268024,225572,42452,5.313577688,157964,134909,83863,24278,22,24256,2,1670,0,0.000700858,mm10,mBC-0814-1
"A11,C4",520811,592730,350415,242315,351804,1,217241,217477,164191,53286,3.081315918,128054,106166,76694,21871,10,21861,1,1727,0,0,mm10,mBC-0814-1
"A11,C5",7383,7894,5306,2588,4654,0,2506,2510,1796,714,2.515406162,1332,1633,1272,412,0,412,0,83,0,0,empty,mBC-0814-1
"A11,C6",5720,6084,4067,2017,3672,0,1924,1924,1438,486,2.958847737,1019,1173,886,240,0,240,0,58,0,0,empty,mBC-0814-1
"A11,C7",7505,8071,5458,2613,4796,0,2560,2563,1818,745,2.440268456,1360,297,199,59,0,59,0,21,0,0,empty,mBC-0814-1
"A11,C8",5705,5969,4225,1744,3521,0,1848,1855,1287,568,2.26584507,934,1852,1329,291,2,289,1,64,0,0,empty,mBC-0814-1
"A11,C9",4958,5469,3514,1955,3163,0,1771,1771,1250,521,2.399232246,972,19795,5884,1818,3,1815,1,196,0,0.049586777,empty,mBC-0814-1
"A11,C10",6145,6769,4522,2247,3834,0,2067,2070,1536,534,2.876404494,1087,1656,1264,338,0,338,0,55,0,0,empty,mBC-0814-1
"A11,C11",5098,5457,3643,1814,3120,0,1682,1684,1201,483,2.486542443,856,1183,897,237,0,237,0,45,0,0.021097046,empty,mBC-0814-1
"A11,C12",8525,9109,6003,3106,5226,0,2791,2796,2020,776,2.603092784,1465,1825,1283,377,0,377,0,66,0,0,empty,mBC-0814-1
"A11,D1",4594,4882,3327,1555,2831,0,1521,1523,1087,436,2.493119266,770,3603,1021,298,0,298,0,44,0,0.077181208,empty,mBC-0814-1
"A11,D2",5414,5642,4004,1638,3320,1,1692,1698,1231,467,2.635974304,834,1260,766,233,0,233,0,64,0,0.004291845,empty,mBC-0814-1
"A11,D3",11629,12254,8353,3901,7242,0,3848,3859,2761,1098,2.514571949,2009,13126,4524,1455,1,1454,1,189,0,0.013755158,empty,mBC-0814-1
"A11,D4",4867,5402,3471,1931,3226,0,1790,1791,1307,484,2.700413223,980,2267,1158,375,0,375,0,64,0,0.010666667,empty,mBC-0814-1
"A11,D5",5032,5509,3566,1943,3283,0,1845,1846,1281,565,2.267256637,1013,1769,1137,331,0,331,0,82,0,0.009063444,empty,mBC-0814-1
"A11,D6",5122,5491,3751,1740,3194,0,1698,1698,1243,455,2.731868132,906,915,650,218,0,218,0,42,0,0,empty,mBC-0814-1
"A11,D7",588165,671145,398198,272947,392561,3,239034,239312,195826,43486,4.503196431,140429,315801,207224,59440,34,59406,4,3022,0,0.008887991,mm10,mBC-0814-1
"A11,D8",5171,5547,3676,1871,3179,0,1729,1731,1284,447,2.872483221,901,2667,1064,312,0,312,0,58,0,0.009615385,empty,mBC-0814-1
"A11,D9",3336,3669,2416,1253,2107,0,1143,1144,800,344,2.325581395,616,1230,829,260,0,260,0,51,0,0,empty,mBC-0814-1
"A11,D10",3993,4124,2872,1252,2452,0,1385,1387,1036,351,2.951566952,688,660,467,152,0,152,0,42,0,0,empty,mBC-0814-1
"A11,D11",5146,5496,3617,1879,3197,0,1773,1777,1175,602,1.951827243,965,8965,3170,968,1,967,1,160,0,0,empty,mBC-0814-1
"A11,D12",6732,7190,4854,2336,4212,11,2240,2260,1582,678,2.333333333,1185,3832,2670,756,0,756,0,128,0,0.013227513,empty,mBC-0814-1
"A11,E1",5454,5733,4020,1713,3246,0,1623,1624,1152,472,2.440677966,791,1669,1093,371,0,371,0,81,0,0,empty,mBC-0814-1
"A11,E2",3756,3988,2777,1211,2356,0,1272,1272,930,342,2.719298246,635,1074,748,213,0,213,0,47,0,0,empty,mBC-0814-1
"A11,E3",3750,3968,2660,1308,2273,0,1208,1210,898,312,2.878205128,613,892,699,171,0,171,0,38,0,0,empty,mBC-0814-1
"A11,E4",3325,3544,2332,1212,2102,1,1159,1163,806,357,2.257703081,643,3320,1208,376,4,372,2,60,0,0.086021505,empty,mBC-0814-1
"A11,E5",3893,4027,2818,1209,2410,2,1231,1234,906,328,2.762195122,639,1097,829,203,0,203,0,41,0,0.103448276,empty,mBC-0814-1
"A11,E6",4830,5316,3518,1798,2942,5,1585,1594,1138,456,2.495614035,819,900,610,179,0,179,0,38,0,0,empty,mBC-0814-1
"A11,E7",4542,4755,3323,1432,2768,0,1421,1424,1008,416,2.423076923,722,984,632,188,0,188,0,48,0,0.063829787,empty,mBC-0814-1
"A11,E8",563051,602922,387434,215488,355401,1,205590,205839,166858,38981,4.280495626,114673,22279,14454,3812,4,3808,1,527,0,0.004201681,mm10,mBC-0814-1
"A11,E9",3506,3730,2507,1223,2180,0,1154,1154,865,289,2.993079585,603,1619,1179,335,1,334,1,64,0,0.005988024,empty,mBC-0814-1
"A11,E10",4320,4659,3007,1652,2769,0,1537,1539,1094,445,2.458426966,847,1650,1177,329,0,329,0,74,0,0,empty,mBC-0814-1
"A11,E11",4386,4880,3205,1675,2913,0,1563,1565,1156,409,2.826405868,833,1523,1156,332,0,332,0,66,0,0,empty,mBC-0814-1
"A11,E12",4218,4651,3020,1631,2651,0,1467,1469,1061,408,2.600490196,755,1026,677,189,1,188,1,49,0,0,empty,mBC-0814-1
"A11,F1",4908,5248,3509,1739,3054,10,1591,1605,1092,513,2.128654971,858,1218,793,267,0,267,0,58,0,0,empty,mBC-0814-1
"A11,F2",7703,8107,5352,2755,4671,0,2527,2534,1840,694,2.65129683,1390,5635,2897,854,0,854,0,136,0,0.022248244,empty,mBC-0814-1
"A11,F3",655377,769617,431051,338566,450410,0,288973,289295,234537,54758,4.283154973,175000,273231,188489,53276,33,53243,4,2828,0,0.000694927,mm10,mBC-0814-1
"A11,F4",5784,6212,4137,2075,3611,1,1932,1937,1428,509,2.805500982,1033,453,344,83,0,83,0,19,0,0.048192771,empty,mBC-0814-1
"A11,F5",5161,5649,3695,1954,3316,0,1767,1767,1275,492,2.591463415,965,1431,972,309,0,309,0,53,0,0,empty,mBC-0814-1
"A11,F6",5721,6374,4055,2319,3695,0,2066,2067,1472,595,2.47394958,1171,1925,1506,450,0,450,0,90,0,0.048888889,empty,mBC-0814-1
"A11,F7",5037,5394,3757,1637,3183,0,1719,1729,1244,485,2.564948454,887,514,379,104,0,104,0,33,0,0,empty,mBC-0814-1
"A11,F8",6517,6724,4612,2112,4012,3,2147,2154,1517,637,2.381475667,1088,200,130,53,0,53,0,17,0,0,empty,mBC-0814-1
"A11,F9",5885,6240,4302,1938,3619,0,1867,1868,1341,527,2.54459203,984,1930,1311,372,0,372,0,75,0,0,empty,mBC-0814-1
"A11,F10",6527,6867,4857,2010,4111,0,2136,2138,1493,645,2.314728682,1064,1440,1138,283,0,283,0,56,0,0,empty,mBC-0814-1
"A11,F11",4490,4855,3279,1576,2848,0,1552,1553,1045,508,2.057086614,796,1361,972,304,0,304,0,59,0,0.019736842,empty,mBC-0814-1
"A11,F12",534218,629989,353179,276810,368105,0,230332,230565,193630,36935,5.242452958,140136,26069,18234,4837,3,4834,1,558,0,0,mm10,mBC-0814-1
"A11,G1",696439,792917,473510,319407,462031,0,282184,282545,227442,55103,4.127579261,164892,250475,179301,50750,25,50725,3,2709,0,1.97141E-05,mm10,mBC-0814-1
"A11,G2",5953,6172,4256,1916,3754,0,1982,1986,1430,556,2.571942446,1051,587,343,62,0,62,0,14,0,0,empty,mBC-0814-1
"A11,G3",5425,5709,3832,1877,3396,0,1856,1858,1307,551,2.372050817,986,2567,1927,601,0,601,0,111,0,0,empty,mBC-0814-1
"A11,G4",5638,6153,4100,2053,3558,0,1902,1907,1346,561,2.399286988,1030,17,15,4,0,4,0,2,0,0,empty,mBC-0814-1
"A11,G5",4920,5328,3547,1781,3110,0,1697,1704,1186,518,2.28957529,926,1596,1025,321,0,321,0,67,0,0.07788162,empty,mBC-0814-1
"A11,G6",566402,628185,388011,240174,370548,0,221961,222236,180056,42180,4.268752963,127642,2769,1767,477,0,477,0,95,0,0,empty,mBC-0814-1
"A11,G7",5868,6296,4211,2085,3641,1,1943,1945,1432,513,2.791423002,1046,2251,1607,430,0,430,0,95,0,0.03255814,empty,mBC-0814-1
"A11,G8",7836,8437,5448,2989,5071,0,2839,2844,2014,830,2.426506024,1532,2750,1987,615,0,615,0,128,0,0.003252033,empty,mBC-0814-1
"A11,G9",5509,5981,3955,2026,3542,0,1980,1987,1403,584,2.40239726,1050,4021,2363,722,1,721,1,152,0,0.056865465,empty,mBC-0814-1
"A11,G10",733812,834363,491586,342777,489164,8,303219,303558,238935,64623,3.69736781,178750,273129,193605,54361,29,54332,3,2837,0,0.000846647,mm10,mBC-0814-1
"A11,G11",9743,10727,7122,3605,6178,0,3319,3319,2355,964,2.442946058,1753,1982,1155,335,0,335,0,87,0,0,empty,mBC-0814-1
"A11,G12",5015,5197,3540,1657,3032,0,1646,1652,1250,402,3.109452736,847,2315,1553,495,0,495,0,83,0,0.004040404,empty,mBC-0814-1
"A11,H1",4602,5008,3308,1700,3048,0,1683,1685,1191,494,2.410931174,922,980,718,207,0,207,0,38,0,0,empty,mBC-0814-1
"A11,H2",8504,9051,6199,2852,5311,0,2907,2914,2107,807,2.610904585,1520,2771,1959,643,0,643,0,131,0,0.00777605,empty,mBC-0814-1
"A11,H3",5651,6208,4054,2154,3666,0,2084,2086,1493,593,2.517706577,1125,2267,1626,412,0,412,0,70,0,0,empty,mBC-0814-1
"A11,H4",5529,6077,3947,2130,3468,0,1897,1900,1405,495,2.838383838,1059,111,60,23,0,23,0,13,0,0.130434783,empty,mBC-0814-1
"A11,H5",7202,7944,5130,2814,4494,0,2471,2475,1705,770,2.214285714,1335,1703,1195,266,0,266,0,53,0,0,empty,mBC-0814-1
"A11,H6",7120,7488,5107,2381,4412,0,2402,2406,1703,703,2.422475107,1245,2473,1765,456,0,456,0,83,0,0,empty,mBC-0814-1
"A11,H7",5848,6218,4202,2016,3705,0,1964,1964,1403,561,2.500891266,1073,3546,1673,515,1,514,1,77,0,0.029182879,empty,mBC-0814-1
"A11,H8",4745,5046,3373,1673,3043,0,1653,1655,1185,470,2.521276596,910,4436,1822,558,2,556,2,100,0,0.001798561,empty,mBC-0814-1
"A11,H9",5416,5848,3952,1896,3336,0,1753,1758,1285,473,2.716701903,940,1331,887,231,0,231,0,44,0,0.004329004,empty,mBC-0814-1
"A11,H10",3702,3943,2700,1243,2301,0,1223,1225,858,367,2.337874659,615,769,559,178,0,178,0,40,0,0.033707865,empty,mBC-0814-1
"A11,H11",4097,4380,2928,1452,2606,7,1462,1472,1062,410,2.590243902,792,73,44,15,0,15,0,5,0,0,empty,mBC-0814-1
"A11,H12",2896,3110,1975,1135,1849,0,1032,1035,748,287,2.606271777,601,3939,1743,498,0,498,0,87,0,0,empty,mBC-0814-1
"A12,A1",6558,7036,4681,2355,4064,0,2209,2215,1581,634,2.493690852,1188,1300,913,252,0,252,0,67,0,0,empty,mBC-0814-1
"A12,A2",6716,7275,4740,2535,4320,0,2343,2344,1697,647,2.622874807,1260,1607,1051,404,0,404,0,101,0,0.051980198,empty,mBC-0814-1
"A12,A3",5513,6023,3937,2086,3475,0,1885,1887,1350,537,2.51396648,1021,1508,1068,337,0,337,0,60,0,0,empty,mBC-0814-1
"A12,A4",6066,6544,4462,2082,3776,1,2031,2040,1468,572,2.566433566,1079,732,506,149,0,149,0,28,0,0,empty,mBC-0814-1
"A12,A5",5466,5920,3980,1940,3531,0,1935,1942,1394,548,2.54379562,983,1597,1230,333,0,333,0,59,0,0.033033033,empty,mBC-0814-1
"A12,A6",420219,494463,279439,215024,291755,0,181392,181568,157124,24444,6.427916871,109576,215910,156423,44862,36,44826,4,2532,0,0.000513095,mm10,mBC-0814-1
"A12,A7",6601,7466,4649,2817,4429,0,2524,2529,1796,733,2.450204638,1412,1947,1296,368,0,368,0,92,0,0,empty,mBC-0814-1
"A12,A8",2845,3180,1987,1193,1841,0,1033,1033,745,288,2.586805556,574,1739,1209,363,0,363,0,76,0,0,empty,mBC-0814-1
"A12,A9",431038,523206,282094,241112,312360,0,210461,210668,152970,57698,2.651218413,130674,24771,17110,4893,0,4893,0,595,0,0.003883098,mm10,mBC-0814-1
"A12,A10",5125,5654,3621,2033,3409,0,1920,1920,1331,589,2.259762309,1039,435,308,103,0,103,0,19,0,0,empty,mBC-0814-1
"A12,A11",5654,6059,4058,2001,3719,0,2040,2040,1478,562,2.629893238,1087,1790,1271,412,2,410,1,92,0,0,empty,mBC-0814-1
"A12,A12",5598,6141,3974,2167,3589,0,1971,1974,1407,567,2.481481481,1057,6655,3316,1046,1,1045,1,191,0,0.048803828,empty,mBC-0814-1
"A12,B1",5427,5730,3878,1852,3409,0,1844,1847,1339,508,2.635826772,981,1838,1304,345,0,345,0,70,0,0,empty,mBC-0814-1
"A12,B2",5403,5778,3870,1908,3444,0,1849,1849,1310,539,2.430426716,997,296,181,75,0,75,0,22,0,0,empty,mBC-0814-1
"A12,B3",592164,673615,402400,271215,396433,0,239397,239643,179793,59850,3.00406015,140121,121753,83247,23307,18,23289,6,1736,0,4.29387E-05,mm10,mBC-0814-1
"A12,B4",5264,5907,3667,2240,3391,0,1897,1899,1348,551,2.44646098,1057,1180,813,262,0,262,0,52,0,0.041984733,empty,mBC-0814-1
"A12,B5",1260070,870229,491182,379047,618388,7,389540,391123,314189,76934,4.083877089,242196,265467,183480,51202,28,51174,2,2911,0,0.000508071,mm10,mBC-0814-1
"A12,B6",4972,5385,3555,1830,3178,0,1748,1749,1257,492,2.554878049,964,1323,843,245,0,245,0,46,0,0,empty,mBC-0814-1
"A12,B7",501698,587630,337446,250184,348881,2,218559,218804,180507,38297,4.713345693,131751,101823,70302,19989,15,19974,3,1441,0,0.001401822,mm10,mBC-0814-1
"A12,B8",4546,4859,3291,1568,2968,0,1584,1587,1167,420,2.778571429,868,1033,754,246,0,246,0,50,0,0,empty,mBC-0814-1
"A12,B9",548896,632614,370931,261683,370408,0,225388,225639,189019,36620,5.161632987,133417,69022,50255,14075,9,14066,3,1252,0,7.10934E-05,mm10,mBC-0814-1
"A12,B10",5036,5337,3547,1790,3354,0,1813,1819,1284,535,2.4,993,352,228,92,0,92,0,20,0,0,empty,mBC-0814-1
"A12,B11",7728,8183,5546,2637,4751,4,2538,2546,1819,727,2.502063274,1359,284,194,53,0,53,0,8,0,0,empty,mBC-0814-1
"A12,B12",6269,6859,4510,2349,4089,0,2245,2248,1593,655,2.432061069,1202,1332,954,280,0,280,0,56,0,0.021428571,empty,mBC-0814-1
"A12,C1",6425,7253,4651,2602,4217,7,2242,2257,1599,658,2.430091185,1245,692,560,157,1,156,1,32,0,0,empty,mBC-0814-1
"A12,C2",6102,6655,4324,2331,3893,0,2159,2160,1518,642,2.364485981,1188,1644,1149,310,0,310,0,87,0,0,empty,mBC-0814-1
"A12,C3",6729,7353,4888,2465,4371,0,2398,2401,1769,632,2.799050633,1299,646,455,154,0,154,0,43,0,0,empty,mBC-0814-1
"A12,C4",6304,6813,4496,2317,4048,0,2188,2196,1560,636,2.452830189,1179,1526,1084,343,0,343,0,85,0,0,empty,mBC-0814-1
"A12,C5",8312,8874,6107,2767,5223,0,2753,2755,2044,711,2.874824191,1420,2070,1458,488,2,486,1,99,0,0,empty,mBC-0814-1
"A12,C6",6275,6744,4375,2369,3991,1,2207,2218,1617,601,2.690515807,1194,1448,843,236,0,236,0,58,0,0,empty,mBC-0814-1
"A12,C7",7788,8418,5683,2735,4910,0,2568,2569,1887,682,2.76686217,1335,485,398,107,0,107,0,12,0,0,empty,mBC-0814-1
"A12,C8",6227,6551,4504,2047,3886,0,2020,2026,1408,618,2.278317152,1090,2038,1365,376,0,376,0,90,0,0.005319149,empty,mBC-0814-1
"A12,C9",6115,6679,4384,2295,3883,0,2154,2157,1587,570,2.784210526,1191,1272,1045,307,0,307,0,48,0,0,empty,mBC-0814-1
"A12,C10",6025,6498,4350,2148,3829,6,2074,2084,1436,648,2.216049383,1111,1266,969,234,0,234,0,59,0,0.02991453,empty,mBC-0814-1
"A12,C11",5285,5775,3766,2009,3378,4,1847,1852,1343,509,2.638506876,993,1184,737,192,0,192,0,52,0,0,empty,mBC-0814-1
"A12,C12",9861,10585,6905,3680,6098,1,3396,3404,2368,1036,2.285714286,1813,1772,1244,398,0,398,0,75,0,0.030150754,empty,mBC-0814-1
"A12,D1",5285,5618,3735,1883,3438,0,1872,1874,1328,546,2.432234432,1034,287,216,81,0,81,0,23,0,0,empty,mBC-0814-1
"A12,D2",5523,5891,4047,1844,3501,1,1827,1832,1335,497,2.6861167,944,2815,1726,448,0,448,0,77,0,0.002232143,empty,mBC-0814-1
"A12,D3",12864,13879,9332,4547,8172,0,4380,4394,3166,1228,2.578175896,2348,2793,1899,639,0,639,0,109,0,0.07198748,empty,mBC-0814-1
"A12,D4",17365,19693,10401,9292,11782,4,7803,7814,5217,2597,2.008856373,4933,6756,2417,712,0,712,0,123,0,0.012640449,empty,mBC-0814-1
"A12,D5",5984,6657,4180,2477,3906,0,2245,2245,1671,574,2.911149826,1249,1795,1194,434,0,434,0,109,0,0,empty,mBC-0814-1
"A12,D6",5613,6272,3954,2318,3553,0,1963,1966,1414,552,2.561594203,1067,1082,717,214,0,214,0,59,0,0.03271028,empty,mBC-0814-1
"A12,D7",7068,7539,5012,2527,4385,0,2374,2376,1744,632,2.759493671,1222,5430,2535,789,0,789,0,132,0,0.002534854,empty,mBC-0814-1
"A12,D8",5630,6112,4070,2042,3551,0,1922,1923,1378,545,2.528440367,1017,855,569,187,1,186,1,40,0,0,empty,mBC-0814-1
"A12,D9",3835,4280,2690,1590,2441,0,1347,1355,961,394,2.439086294,745,1642,1106,311,0,311,0,59,0,0,empty,mBC-0814-1
"A12,D10",4412,4725,3189,1536,2809,0,1558,1561,1173,388,3.023195876,814,695,529,159,0,159,0,40,0,0,empty,mBC-0814-1
"A12,D11",5158,5662,3764,1898,3405,0,1859,1859,1360,499,2.725450902,987,8986,3637,1056,1,1055,1,159,0,0.011374408,empty,mBC-0814-1
"A12,D12",689619,800558,461090,339468,469270,0,295423,295744,251678,44066,5.711387464,176663,249194,179230,50010,25,49985,4,2841,0,2.0006E-05,mm10,mBC-0814-1
"A12,E1",5799,6162,4234,1928,3688,0,1970,1972,1398,574,2.43554007,1051,1646,1206,353,0,353,0,86,0,0.02266289,empty,mBC-0814-1
"A12,E2",4320,4610,3089,1521,2707,0,1461,1461,1047,414,2.528985507,789,1349,904,223,1,222,1,54,0,0,empty,mBC-0814-1
"A12,E3",3734,3839,2721,1118,2293,0,1197,1197,856,341,2.51026393,595,1524,1055,332,0,332,0,73,0,0,empty,mBC-0814-1
"A12,E4",3573,4046,2540,1506,2362,0,1323,1324,939,385,2.438961039,742,965,657,198,0,198,0,49,0,0,empty,mBC-0814-1
"A12,E5",1260471,1372508,889081,483427,799647,1,463650,464232,328383,135849,2.417264757,258861,108640,56663,15861,17,15844,1,1505,0,0.008836152,mm10,mBC-0814-1
"A12,E6",5305,5945,3785,2160,3347,0,1831,1840,1356,484,2.801652893,1023,1026,627,223,0,223,0,49,0,0,empty,mBC-0814-1
"A12,E7",5839,6359,4237,2122,3664,0,1957,1957,1446,511,2.829745597,1003,1706,1161,298,0,298,0,51,0,0,empty,mBC-0814-1
"A12,E8",5439,5746,3880,1866,3342,0,1776,1778,1300,478,2.719665272,951,1845,1237,356,0,356,0,87,0,0.002808989,empty,mBC-0814-1
"A12,E9",4145,4472,2942,1530,2607,0,1432,1432,1025,407,2.518427518,785,1333,879,256,0,256,0,64,0,0,empty,mBC-0814-1
"A12,E10",4596,4893,3304,1589,2929,0,1602,1604,1163,441,2.637188209,810,2009,1461,459,2,457,1,84,0,0,empty,mBC-0814-1
"A12,E11",5305,5799,3840,1959,3368,0,1765,1767,1296,471,2.751592357,951,1860,1431,383,0,383,0,79,0,0.018276762,empty,mBC-0814-1
"A12,E12",4899,5157,3519,1638,3066,1,1640,1645,1191,454,2.623348018,864,1219,937,290,0,290,0,63,0,0.024137931,empty,mBC-0814-1
"A12,F1",5205,5431,3731,1700,3237,0,1748,1752,1222,530,2.305660377,880,4495,1717,600,0,600,0,89,0,0.033333333,empty,mBC-0814-1
"A12,F2",7323,8049,5237,2812,4665,0,2543,2545,1811,734,2.467302452,1355,1826,1346,414,0,414,0,103,0,0,empty,mBC-0814-1
"A12,F3",6176,6807,4407,2400,3945,0,2182,2185,1576,609,2.587848933,1188,2009,1372,407,0,407,0,89,0,0.027027027,empty,mBC-0814-1
"A12,F4",6261,6846,4460,2386,3993,0,2111,2115,1500,615,2.43902439,1155,444,312,96,0,96,0,29,0,0,empty,mBC-0814-1
"A12,F5",5842,6185,4241,1944,3589,0,1912,1916,1379,537,2.567970205,984,3006,1561,465,1,464,1,66,0,0.075431034,empty,mBC-0814-1
"A12,F6",6230,6692,4507,2185,3879,0,2074,2080,1529,551,2.774954628,1088,1993,1263,354,0,354,0,100,0,0,empty,mBC-0814-1
"A12,F7",5200,5638,3812,1826,3255,0,1666,1670,1203,467,2.576017131,841,736,555,148,0,148,0,36,0,0,empty,mBC-0814-1
"A12,F8",7173,7683,5140,2543,4545,3,2457,2462,1760,702,2.507122507,1322,184,149,46,0,46,0,14,0,0.02173913,empty,mBC-0814-1
"A12,F9",6577,6877,4711,2166,4097,8,2173,2191,1558,633,2.461295419,1144,1979,1410,430,0,430,0,89,0,0,empty,mBC-0814-1
"A12,F10",7187,7652,5227,2425,4500,0,2345,2347,1677,670,2.502985075,1221,1482,1073,323,0,323,0,69,0,0,empty,mBC-0814-1
"A12,F11",5309,5665,3740,1925,3392,0,1808,1818,1274,544,2.341911765,1012,1455,1046,316,0,316,0,52,0,0,empty,mBC-0814-1
"A12,F12",5592,6096,3916,2180,3570,0,2000,2005,1409,596,2.36409396,1077,248,183,30,0,30,0,16,0,0,empty,mBC-0814-1
"A12,G1",8482,9241,6123,3118,5509,0,2929,2932,2108,824,2.558252427,1557,2379,1647,545,1,544,1,120,0,0.001838235,empty,mBC-0814-1
"A12,G2",6662,7475,4700,2775,4382,0,2457,2461,1782,679,2.624447717,1426,449,293,86,0,86,0,23,0,0,empty,mBC-0814-1
"A12,G3",6076,6687,4280,2407,3858,0,2156,2156,1562,594,2.62962963,1189,2562,1770,551,2,549,1,115,0,0.014571949,empty,mBC-0814-1
"A12,G4",5907,6384,4217,2167,3719,1,2008,2010,1414,596,2.372483221,1094,6,4,2,0,2,0,1,0,0,empty,mBC-0814-1
"A12,G5",5563,6060,3934,2126,3496,0,1918,1928,1367,561,2.436720143,1043,4129,1676,501,0,501,0,87,0,0.063872255,empty,mBC-0814-1
"A12,G6",682023,777470,463653,313817,453086,0,272414,272727,239356,33371,7.17257499,159273,20329,14463,4271,1,4270,1,468,0,0.006791569,mm10,mBC-0814-1
"A12,G7",41184,53592,24457,29135,32108,3,23519,23556,11183,12373,0.90382284,15742,6146,3401,755,0,755,0,136,0,0.010596026,empty,mBC-0814-1
"A12,G8",9020,9941,6437,3504,5914,3,3321,3328,2420,908,2.665198238,1815,2827,1974,608,0,608,0,131,0,0.026315789,empty,mBC-0814-1
"A12,G9",6842,7484,4869,2615,4466,0,2500,2502,1754,748,2.344919786,1360,3026,2203,667,0,667,0,132,0,0.013493253,empty,mBC-0814-1
"A12,G10",2777436,3141683,1890617,1251066,1772877,3,1110028,1111386,920181,191205,4.812536283,645450,949633,663249,189126,117,189009,9,5693,0,0.000968208,mm10,mBC-0814-1
"A12,G11",10803,11424,7784,3640,6688,0,3569,3574,2566,1008,2.545634921,1866,1865,978,331,0,331,0,80,0,0.072507553,empty,mBC-0814-1
"A12,G12",5783,6469,4110,2359,3785,3,2104,2107,1563,544,2.873161765,1163,2446,1561,479,0,479,0,100,0,0,empty,mBC-0814-1
"A12,H1",5560,6259,3858,2401,3721,0,2111,2113,1534,579,2.649395509,1203,776,450,152,0,152,0,43,0,0,empty,mBC-0814-1
"A12,H2",10640,11722,7580,4142,7002,0,3931,3931,2797,1134,2.4664903,2120,3333,2249,700,0,700,0,149,0,0.05,empty,mBC-0814-1
"A12,H3",6644,7234,4774,2460,4362,0,2407,2409,1701,708,2.402542373,1292,7571,2775,902,2,900,2,136,0,0.06,empty,mBC-0814-1
"A12,H4",6504,7160,4635,2525,4153,0,2261,2262,1611,651,2.474654378,1200,42,18,9,0,9,0,7,0,0,empty,mBC-0814-1
"A12,H5",7440,8037,5377,2660,4662,0,2513,2517,1815,702,2.585470085,1354,1895,1345,391,0,391,0,72,0,0.043478261,empty,mBC-0814-1
"A12,H6",7604,8089,5426,2663,4653,0,2542,2544,1825,719,2.538247566,1309,4822,2343,689,0,689,0,143,0,0.043541364,empty,mBC-0814-1
"A12,H7",510041,576727,347838,228889,345065,1,212416,212656,167065,45591,3.664429383,124297,19352,13746,3822,0,3822,0,438,0,0.005232862,mm10,mBC-0814-1
"A12,H8",5303,5874,3794,2080,3370,0,1906,1907,1408,499,2.821643287,1027,1959,1432,450,0,450,0,88,0,0,empty,mBC-0814-1
"A12,H9",513000,584494,342325,242169,345695,0,217288,217568,172825,44743,3.862615381,129373,15994,11494,3126,1,3125,1,420,0,0,mm10,mBC-0814-1
"A12,H10",4459,4872,3167,1705,2788,0,1554,1554,1142,412,2.77184466,851,954,540,194,0,194,0,60,0,0,empty,mBC-0814-1
"A12,H11",439355,528316,280005,248311,316205,1,215736,215952,167325,48627,3.440989574,134903,459,298,118,0,118,0,24,0,0,empty,mBC-0814-1
"A12,H12",3688,4087,2591,1496,2476,0,1398,1398,1052,346,3.040462428,796,668,407,147,0,147,0,49,0,0,empty,mBC-0814-1
"B1,A1",5789,6267,4206,2061,3624,0,1967,1971,1389,582,2.386597938,1039,3800,2064,570,1,569,1,96,0,0.035149385,empty,mBC-0814-1
"B1,A2",470232,532748,316015,216733,312338,0,189044,189262,159861,29401,5.437264039,110539,301700,216881,63700,37,63663,1,3075,0,0.000125662,mm10,mBC-0814-1
"B1,A3",4936,5451,3420,2031,3171,0,1786,1790,1310,480,2.729166667,985,917,683,222,0,222,0,39,0,0.022522523,empty,mBC-0814-1
"B1,A4",5950,6314,4326,1988,3588,0,1843,1843,1298,545,2.381651376,959,519,262,79,0,79,0,21,0,0,empty,mBC-0814-1
"B1,A5",5639,6097,4019,2078,3543,0,1881,1884,1329,555,2.394594595,1018,2147,1625,441,0,441,0,72,0,0,empty,mBC-0814-1
"B1,A6",3909,4129,2754,1375,2476,1,1328,1335,932,403,2.312655087,703,1696,990,249,0,249,0,60,0,0,empty,mBC-0814-1
"B1,A7",5526,6263,3916,2347,3640,1,2004,2012,1408,604,2.331125828,1137,1190,795,241,1,240,1,77,0,0.004166667,empty,mBC-0814-1
"B1,A8",201386,241299,129553,111746,146119,0,95372,95468,79301,16167,4.905115358,59288,130834,90458,24921,17,24904,3,1849,0,0,mm10,mBC-0814-1
"B1,A9",7544,8238,5342,2896,4896,0,2701,2706,1978,728,2.717032967,1471,1728,1136,292,0,292,0,59,0,0.003424658,empty,mBC-0814-1
"B1,A10",3676,3953,2673,1280,2361,1,1285,1288,905,383,2.362924282,700,192,163,44,0,44,0,12,0,0,empty,mBC-0814-1
"B1,A11",5013,5436,3557,1879,3197,1,1750,1755,1256,499,2.517034068,972,12254,4541,1402,0,1402,0,178,0,0.047788873,empty,mBC-0814-1
"B1,A12",4154,4367,2970,1397,2567,0,1378,1378,980,398,2.462311558,713,2801,1985,660,0,660,0,155,0,0,empty,mBC-0814-1
"B1,B1",4938,5367,3501,1866,3140,1,1706,1711,1142,569,2.007029877,936,1508,964,304,1,303,1,83,0,0,empty,mBC-0814-1
"B1,B2",4890,5105,3415,1690,2977,3,1543,1552,1102,450,2.448888889,813,3177,776,269,0,269,0,48,0,0.066914498,empty,mBC-0814-1
"B1,B3",4027,4423,2843,1580,2549,0,1435,1435,1015,420,2.416666667,793,1567,1069,305,0,305,0,52,0,0,empty,mBC-0814-1
"B1,B4",4475,4963,3131,1832,2919,4,1675,1680,1182,498,2.373493976,921,1144,796,244,0,244,0,55,0,0,empty,mBC-0814-1
"B1,B5",345336,242331,136460,105871,173493,1,108854,109235,88017,21218,4.148223207,67545,136603,87783,24264,12,24252,3,1624,0,0.002061686,mm10,mBC-0814-1
"B1,B6",90108,97513,61142,36371,58221,0,33773,33817,26574,7243,3.668921718,19133,13936,9097,2618,0,2618,0,353,0,0.001145913,empty,mBC-0814-1
"B1,B7",5037,5459,3633,1826,3188,0,1746,1748,1246,502,2.482071713,918,900,641,178,0,178,0,61,0,0,empty,mBC-0814-1
"B1,B8",3796,4102,2796,1306,2338,0,1222,1222,897,325,2.76,630,1090,777,204,0,204,0,46,0,0,empty,mBC-0814-1
"B1,B9",4727,5020,3425,1595,2993,0,1581,1581,1150,431,2.668213457,814,642,426,164,0,164,0,47,0,0.054878049,empty,mBC-0814-1
"B1,B10",4562,4826,3197,1629,2918,0,1612,1617,1150,467,2.462526767,889,562,307,102,0,102,0,24,0,0.029411765,empty,mBC-0814-1
"B1,B11",9521,10415,6763,3652,6097,0,3462,3468,2608,860,3.03255814,1854,52,28,17,0,17,0,6,0,0,empty,mBC-0814-1
"B1,B12",5427,5753,3770,1983,3423,0,1913,1913,1351,562,2.403914591,1033,938,671,190,0,190,0,45,0,0.026315789,empty,mBC-0814-1
"B1,C1",5624,6089,4063,2026,3442,3,1869,1877,1369,508,2.69488189,959,1039,773,205,0,205,0,37,0,0,empty,mBC-0814-1
"B1,C2",5180,5636,3821,1815,3175,0,1681,1681,1174,507,2.315581854,831,2252,1615,415,1,414,1,93,0,0.019323671,empty,mBC-0814-1
"B1,C3",5846,6283,4230,2053,3676,3,1952,1967,1416,551,2.569872958,1060,699,496,141,0,141,0,33,0,0,empty,mBC-0814-1
"B1,C4",5422,5764,3871,1893,3372,0,1754,1766,1307,459,2.847494553,940,1124,770,273,0,273,0,78,0,0.003663004,empty,mBC-0814-1
"B1,C5",7297,7941,5300,2641,4611,0,2454,2460,1787,673,2.655274889,1314,2482,1397,400,0,400,0,87,0,0.11,empty,mBC-0814-1
"B1,C6",688173,770321,462856,307465,457617,1,275627,275958,213840,62118,3.44248044,159382,231243,162612,45670,21,45649,2,2497,0,0.002365879,mm10,mBC-0814-1
"B1,C7",7489,8035,5346,2689,4772,1,2570,2576,1877,699,2.685264664,1358,228,128,56,0,56,0,19,0,0,empty,mBC-0814-1
"B1,C8",5706,6135,4092,2043,3634,0,1900,1903,1328,575,2.309565217,1046,2327,1745,436,0,436,0,87,0,0,empty,mBC-0814-1
"B1,C9",553340,633196,373872,259324,371424,1,226959,227221,197456,29765,6.633831682,133770,231021,163056,45612,24,45588,2,2465,0,2.19356E-05,mm10,mBC-0814-1
"B1,C10",5912,6459,4340,2119,3625,0,1865,1869,1318,551,2.392014519,986,994,740,236,0,236,0,51,0,0.004237288,empty,mBC-0814-1
"B1,C11",425489,493363,282878,210485,294067,2,186879,187092,140263,46829,2.995216639,113076,42058,28703,8486,6,8480,1,833,0,0.001415094,mm10,mBC-0814-1
"B1,C12",8418,9078,6077,3001,5200,0,2775,2777,1971,806,2.445409429,1471,2540,1737,516,1,515,1,99,0,0.011650485,empty,mBC-0814-1
"B1,D1",496156,553347,333128,220219,327300,0,201958,202196,150963,51233,2.94659692,117677,23445,16402,4571,9,4562,2,510,0,0.000876808,mm10,mBC-0814-1
"B1,D2",5257,5707,3915,1792,3332,1,1739,1742,1269,473,2.682875264,912,1859,1275,359,0,359,0,93,0,0,empty,mBC-0814-1
"B1,D3",10891,11735,7742,3993,6860,0,3712,3719,2588,1131,2.288240495,1979,1651,1111,338,0,338,0,62,0,0,empty,mBC-0814-1
"B1,D4",5070,5482,3681,1801,3168,0,1758,1758,1257,501,2.508982036,933,1169,727,223,0,223,0,66,0,0,empty,mBC-0814-1
"B1,D5",4836,5070,3415,1655,3019,3,1629,1632,1142,490,2.330612245,846,1635,1106,336,1,335,1,101,0,0.002985075,empty,mBC-0814-1
"B1,D6",4971,5367,3553,1814,3088,0,1625,1632,1143,489,2.337423313,854,1441,974,303,0,303,0,58,0,0,empty,mBC-0814-1
"B1,D7",5991,6300,4327,1973,3614,0,1885,1890,1339,551,2.430127042,975,1925,1271,417,1,416,1,94,0,0.033653846,empty,mBC-0814-1
"B1,D8",5306,5674,3706,1968,3273,0,1817,1818,1303,515,2.530097087,1009,1102,772,228,0,228,0,46,0,0.074561404,empty,mBC-0814-1
"B1,D9",3433,3637,2435,1202,2160,0,1205,1207,868,339,2.560471976,647,1364,1026,310,0,310,0,47,0,0.080645161,empty,mBC-0814-1
"B1,D10",436900,525145,287031,238114,311209,0,202190,202428,165673,36755,4.507495579,124959,77912,54476,15388,9,15379,3,1326,0,0.000455166,mm10,mBC-0814-1
"B1,D11",4168,4446,2959,1487,2653,0,1391,1396,1032,364,2.835164835,747,1637,1180,354,0,354,0,102,0,0,empty,mBC-0814-1
"B1,D12",6996,7600,4927,2673,4356,0,2419,2421,1701,720,2.3625,1309,34971,11912,3631,6,3625,2,373,0,0.145655172,empty,mBC-0814-1
"B1,E1",4966,5326,3484,1842,3117,0,1656,1657,1165,492,2.367886179,889,3058,1357,385,0,385,0,79,0,0.01038961,empty,mBC-0814-1
"B1,E2",3685,3945,2640,1305,2313,0,1239,1242,872,370,2.356756757,660,1180,738,230,0,230,0,66,0,0,empty,mBC-0814-1
"B1,E3",3607,3898,2598,1300,2304,0,1220,1225,846,379,2.232189974,661,1418,999,297,0,297,0,64,0,0,empty,mBC-0814-1
"B1,E4",3060,3296,2239,1057,1954,0,1072,1072,795,277,2.870036101,565,1252,652,214,0,214,0,54,0,0.014018692,empty,mBC-0814-1
"B1,E5",3689,4006,2687,1319,2317,0,1219,1220,920,300,3.066666667,647,740,479,153,0,153,0,31,0,0.006535948,empty,mBC-0814-1
"B1,E6",4629,5169,3311,1858,2930,0,1599,1606,1095,511,2.142857143,886,1572,1250,387,0,387,0,65,0,0.033591731,empty,mBC-0814-1
"B1,E7",4590,4945,3327,1618,2823,0,1499,1503,1054,449,2.347438753,775,2009,1365,439,0,439,0,77,0,0,empty,mBC-0814-1
"B1,E8",4485,4701,3249,1452,2824,0,1460,1465,1055,410,2.573170732,760,2547,1899,539,0,539,0,84,0,0,empty,mBC-0814-1
"B1,E9",3343,3452,2391,1061,1966,0,1034,1039,727,312,2.330128205,523,1551,962,256,0,256,0,47,0,0.0078125,empty,mBC-0814-1
"B1,E10",575461,666362,373085,293277,399187,0,263186,263516,175426,88090,1.991440572,160660,54240,18940,5643,8,5635,4,632,0,0.040993789,mm10,mBC-0814-1
"B1,E11",4414,4832,3208,1624,2817,0,1529,1535,1116,419,2.663484487,822,1975,1518,432,0,432,0,88,0,0.002314815,empty,mBC-0814-1
"B1,E12",3860,4061,2784,1277,2453,0,1337,1339,937,402,2.330845771,677,1124,784,239,0,239,0,62,0,0.066945607,empty,mBC-0814-1
"B1,F1",5091,5223,3555,1668,2975,0,1578,1578,1122,456,2.460526316,801,13298,4528,1471,2,1469,2,193,0,0.06943499,empty,mBC-0814-1
"B1,F2",6468,6959,4606,2353,4093,0,2176,2181,1520,661,2.299546142,1179,2662,1715,515,0,515,0,106,0,0,empty,mBC-0814-1
"B1,F3",5324,5774,3831,1943,3388,0,1891,1896,1380,516,2.674418605,999,1878,1346,422,4,418,1,94,0,0,empty,mBC-0814-1
"B1,F4",5562,6087,3906,2181,3465,0,1848,1851,1355,496,2.731854839,1034,536,298,59,1,58,1,16,0,0.017241379,empty,mBC-0814-1
"B1,F5",641529,742162,431908,310254,433483,0,269779,270135,225808,44327,5.094141268,160061,131538,95073,27311,15,27296,2,1813,0,0.000805979,mm10,mBC-0814-1
"B1,F6",5040,5508,3587,1921,3190,4,1723,1733,1236,497,2.486921529,929,1847,1355,393,2,391,1,90,0,0.010230179,empty,mBC-0814-1
"B1,F7",529331,600583,362288,238295,358440,1,219051,219308,172700,46608,3.705372468,127844,21668,14915,4357,7,4350,2,519,0,0.004137931,mm10,mBC-0814-1
"B1,F8",6637,7069,4737,2332,4179,0,2272,2272,1679,593,2.831365936,1205,117,36,21,0,21,0,15,0,0,empty,mBC-0814-1
"B1,F9",5653,5836,4101,1735,3378,0,1797,1801,1289,512,2.517578125,910,1815,1296,372,0,372,0,81,0,0,empty,mBC-0814-1
"B1,F10",6322,6663,4608,2055,3986,0,2095,2097,1529,568,2.691901408,1065,1591,1133,336,0,336,0,67,0,0,empty,mBC-0814-1
"B1,F11",4444,4768,3209,1559,2705,0,1426,1431,997,434,2.297235023,729,11190,4116,1335,0,1335,0,161,0,0.026217228,empty,mBC-0814-1
"B1,F12",4731,5170,3303,1867,3059,0,1709,1713,1187,526,2.256653992,940,32,25,6,0,6,0,4,0,0,empty,mBC-0814-1
"B1,G1",7827,8346,5661,2685,4911,0,2595,2599,1818,781,2.327784891,1376,16082,6565,2010,0,2010,0,233,0,0.146766169,empty,mBC-0814-1
"B1,G2",5769,6225,4112,2113,3610,0,1973,1976,1417,559,2.534883721,1036,565,384,114,1,113,1,25,0,0,empty,mBC-0814-1
"B1,G3",518461,591647,344558,247089,349345,1,221038,221271,157051,64220,2.445515416,131594,35573,24328,6918,8,6910,1,751,0,0.000144718,mm10,mBC-0814-1
"B1,G4",5626,5962,4104,1858,3405,0,1775,1781,1261,520,2.425,904,1,0,0,0,0,0,0,0,0,empty,mBC-0814-1
"B1,G5",384938,447301,257911,189390,268767,0,171100,171288,129262,42026,3.075762623,102905,14074,9506,2662,2,2660,1,386,0,0.005263158,mm10,mBC-0814-1
"B1,G6",8887,9302,6395,2907,5409,0,2837,2838,2025,813,2.490774908,1449,277,163,60,0,60,0,16,0,0,empty,mBC-0814-1
"B1,G7",5384,5926,3913,2013,3428,0,1866,1871,1315,556,2.365107914,983,3638,2264,570,0,570,0,105,0,0,empty,mBC-0814-1
"B1,G8",7711,8361,5368,2993,4842,0,2736,2740,1951,789,2.472750317,1484,3879,2675,789,1,788,1,152,0,0.040609137,empty,mBC-0814-1
"B1,G9",5455,5897,3858,2039,3496,0,1934,1934,1397,537,2.601489758,1038,2232,1457,460,1,459,1,99,0,0,empty,mBC-0814-1
"B1,G10",634440,726383,423523,302860,425118,2,260918,261188,229960,31228,7.363904189,154431,328992,241095,67478,43,67435,4,3121,0,2.96582E-05,mm10,mBC-0814-1
"B1,G11",9403,9971,6727,3244,5815,0,3094,3096,2234,862,2.591647332,1614,1408,1017,316,1,315,1,66,0,0,empty,mBC-0814-1
"B1,G12",4763,5275,3403,1872,3114,0,1736,1736,1276,460,2.773913043,938,1991,1325,405,0,405,0,95,0,0.002469136,empty,mBC-0814-1
"B1,H1",4643,5012,3384,1628,2920,0,1531,1539,1050,489,2.147239264,823,1153,757,244,0,244,0,52,0,0,empty,mBC-0814-1
"B1,H2",628883,743931,412662,331269,437837,1,282764,283122,227187,55935,4.061625101,172701,192031,125165,34937,22,34915,2,2218,0,0.012315624,mm10,mBC-0814-1
"B1,H3",5543,5877,3975,1902,3495,0,1929,1939,1388,551,2.519056261,1035,1553,975,327,0,327,0,68,0,0,empty,mBC-0814-1
"B1,H4",598928,703113,396957,306156,411187,1,262882,263164,216897,46267,4.68794173,158791,7223,4934,1279,0,1279,0,175,0,0,mm10,mBC-0814-1
"B1,H5",6907,7351,4978,2373,4293,0,2272,2279,1624,655,2.479389313,1182,1871,1249,387,0,387,0,64,0,0.041343669,empty,mBC-0814-1
"B1,H6",6366,6919,4653,2266,4089,0,2196,2199,1540,659,2.336874052,1164,2645,1903,589,0,589,0,91,0,0.032258065,empty,mBC-0814-1
"B1,H7",5529,5720,4017,1703,3295,0,1700,1704,1250,454,2.753303965,827,1579,1152,337,0,337,0,63,0,0,empty,mBC-0814-1
"B1,H8",4554,4944,3190,1754,2921,0,1620,1623,1186,437,2.71395881,893,1878,1286,414,1,413,1,85,0,0.014527845,empty,mBC-0814-1
"B1,H9",5577,5944,3977,1967,3554,0,1957,1962,1448,514,2.817120623,1034,1074,747,219,1,218,1,59,0,0,empty,mBC-0814-1
"B1,H10",3645,3892,2553,1339,2347,0,1261,1265,868,397,2.186397985,690,1141,632,239,0,239,0,61,0,0,empty,mBC-0814-1
"B1,H11",342020,403164,227370,175794,242378,0,155300,155446,118371,37075,3.192744437,94501,1236,906,260,0,260,0,45,0,0,empty,mBC-0814-1
"B1,H12",2820,3114,1912,1202,1807,0,1025,1025,723,302,2.394039735,578,1765,1108,302,2,300,1,64,0,0.01,empty,mBC-0814-1
"B2,A1",5755,6371,4094,2277,3714,0,2096,2099,1456,643,2.264385692,1162,1400,1014,335,0,335,0,57,0,0,empty,mBC-0814-1
"B2,A2",5377,5594,3913,1681,3309,0,1700,1700,1239,461,2.687635575,855,1765,1334,421,0,421,0,79,0,0.002375297,empty,mBC-0814-1
"B2,A3",4654,5090,3289,1801,2963,0,1647,1652,1163,489,2.378323108,886,1009,678,170,0,170,0,42,0,0,empty,mBC-0814-1
"B2,A4",5750,6124,4140,1984,3482,5,1813,1825,1289,536,2.404850746,941,262,179,58,0,58,0,15,0,0,empty,mBC-0814-1
"B2,A5",5110,5324,3676,1648,3082,0,1633,1640,1173,467,2.511777302,845,1098,748,226,1,225,1,54,0,0,empty,mBC-0814-1
"B2,A6",3770,3948,2710,1238,2349,0,1234,1238,920,318,2.893081761,624,1535,1139,335,0,335,0,58,0,0.005970149,empty,mBC-0814-1
"B2,A7",5683,6022,4146,1876,3558,0,1887,1889,1311,578,2.26816609,977,2241,1463,397,0,397,0,90,0,0.062972292,empty,mBC-0814-1
"B2,A8",2271,2406,1594,812,1415,0,811,811,541,270,2.003703704,425,1541,958,318,0,318,0,65,0,0,empty,mBC-0814-1
"B2,A9",6415,6700,4548,2152,3954,0,2103,2106,1465,641,2.28549142,1103,1873,1291,335,0,335,0,62,0,0,empty,mBC-0814-1
"B2,A10",3738,4202,2733,1469,2489,0,1322,1323,932,391,2.383631714,737,154,112,39,0,39,0,18,0,0.307692308,empty,mBC-0814-1
"B2,A11",4693,5123,3376,1747,3052,0,1606,1606,1141,465,2.453763441,852,2180,1386,406,1,405,1,93,0,0.002469136,empty,mBC-0814-1
"B2,A12",4352,4690,3115,1575,2784,0,1532,1532,1149,383,3,844,15136,5324,1610,2,1608,1,226,0,0.085820896,empty,mBC-0814-1
"B2,B1",4982,5177,3658,1519,3021,0,1579,1582,1111,471,2.35881104,782,2946,1485,397,0,397,0,83,0,0.002518892,empty,mBC-0814-1
"B2,B2",5174,5504,3624,1880,3251,0,1768,1769,1261,508,2.482283465,972,467,300,83,0,83,0,19,0,0,empty,mBC-0814-1
"B2,B3",4062,4360,2823,1537,2646,0,1487,1491,1057,434,2.435483871,808,1045,617,197,0,197,0,49,0,0.050761421,empty,mBC-0814-1
"B2,B4",4506,4765,3207,1558,2808,0,1525,1530,1129,401,2.815461347,780,3498,1476,424,0,424,0,80,0,0.033018868,empty,mBC-0814-1
"B2,B5",5407,4457,2787,1670,2990,0,1731,1735,1313,422,3.111374408,1005,918,556,166,0,166,0,46,0,0.006024096,empty,mBC-0814-1
"B2,B6",405695,459327,271935,187392,272763,2,168240,168434,134004,34430,3.892070868,99517,36260,25777,7105,3,7102,1,800,0,0,mm10,mBC-0814-1
"B2,B7",7694,7853,5056,2797,4735,0,2715,2717,2082,635,3.278740157,1478,1718,1154,304,0,304,0,59,0,0,empty,mBC-0814-1
"B2,B8",3922,4117,2847,1270,2460,0,1311,1311,972,339,2.867256637,667,2810,1143,349,0,349,0,59,0,0.040114613,empty,mBC-0814-1
"B2,B9",4898,5269,3485,1784,3012,0,1635,1637,1186,451,2.629711752,855,794,583,181,0,181,0,49,0,0,empty,mBC-0814-1
"B2,B10",481095,502751,316824,185927,306046,0,177151,177614,141919,35695,3.975878975,101083,4331,3042,811,0,811,0,123,0,0,empty,mBC-0814-1
"B2,B11",6826,7458,4896,2562,4298,0,2319,2325,1633,692,2.35982659,1268,384,316,63,0,63,0,13,0,0,empty,mBC-0814-1
"B2,B12",5489,5995,3943,2052,3530,0,1952,1954,1398,556,2.514388489,1075,3521,1566,484,0,484,0,78,0,0.05785124,empty,mBC-0814-1
"B2,C1",6000,6420,4369,2051,3702,0,1949,1956,1432,524,2.732824427,1001,2572,1216,371,1,370,1,55,0,0.016216216,empty,mBC-0814-1
"B2,C2",5463,5922,3860,2062,3451,0,1925,1928,1377,551,2.499092559,1030,2118,1509,407,0,407,0,85,0,0.004914005,empty,mBC-0814-1
"B2,C3",7351,7803,5161,2642,4672,0,2594,2603,1942,661,2.937972769,1340,653,511,155,0,155,0,34,0,0.006451613,empty,mBC-0814-1
"B2,C4",564098,641167,370666,270501,377060,0,235696,235933,191431,44502,4.301626893,139958,228010,162313,45280,35,45245,2,2559,0,0.000442038,mm10,mBC-0814-1
"B2,C5",7188,7774,5133,2641,4556,4,2523,2533,1828,705,2.592907801,1360,1046,703,170,1,169,1,48,0,0.035502959,empty,mBC-0814-1
"B2,C6",661210,744882,443997,300885,442531,2,267724,268041,234163,33878,6.911948757,156239,215000,158110,43810,27,43783,2,2487,0,0.000182719,mm10,mBC-0814-1
"B2,C7",7141,7645,5047,2598,4452,0,2422,2424,1775,649,2.734976888,1264,115,82,37,0,37,0,11,0,0,empty,mBC-0814-1
"B2,C8",5724,6017,4174,1843,3504,0,1866,1866,1346,520,2.588461538,953,1645,1149,300,0,300,0,67,0,0,empty,mBC-0814-1
"B2,C9",4675,4986,3386,1600,2986,0,1599,1605,1143,462,2.474025974,832,1037,675,178,0,178,0,44,0,0.011235955,empty,mBC-0814-1
"B2,C10",5801,6220,4154,2066,3618,0,1940,1940,1365,575,2.373913043,1033,1381,881,219,0,219,0,43,0,0.054794521,empty,mBC-0814-1
"B2,C11",4844,5303,3470,1833,3043,0,1663,1668,1158,510,2.270588235,904,1079,756,252,0,252,0,54,0,0,empty,mBC-0814-1
"B2,C12",8323,9148,5939,3209,5303,3,2949,2957,2129,828,2.571256039,1617,3062,1814,527,0,527,0,94,0,0.020872865,empty,mBC-0814-1
"B2,D1",4570,5093,3293,1800,2895,0,1612,1614,1146,468,2.448717949,865,751,538,189,0,189,0,33,0,0,empty,mBC-0814-1
"B2,D2",5246,5516,3955,1561,3221,0,1648,1650,1234,416,2.966346154,793,2230,1643,436,0,436,0,73,0,0.004587156,empty,mBC-0814-1
"B2,D3",11141,11686,7819,3867,6949,0,3807,3815,2670,1145,2.331877729,2048,1778,1294,396,0,396,0,85,0,0,empty,mBC-0814-1
"B2,D4",4708,5074,3284,1790,2978,0,1681,1681,1213,468,2.591880342,883,1586,1214,380,0,380,0,73,0,0,empty,mBC-0814-1
"B2,D5",384509,448214,249707,198507,267197,0,170135,170292,142849,27443,5.205298255,103884,143908,102344,27541,16,27525,2,1907,0,0.000980926,mm10,mBC-0814-1
"B2,D6",5114,5351,3574,1777,3145,0,1658,1663,1170,493,2.373225152,889,1482,1027,264,2,262,2,55,0,0,empty,mBC-0814-1
"B2,D7",6046,6556,4402,2154,3835,0,2083,2085,1491,594,2.51010101,1127,1733,1156,372,0,372,0,86,0,0.018817204,empty,mBC-0814-1
"B2,D8",12415,14615,8931,5684,8309,0,4795,4797,3824,973,3.930113052,2670,1887,1392,411,1,410,1,79,0,0,empty,mBC-0814-1
"B2,D9",3039,3194,2117,1077,1902,0,1037,1037,749,288,2.600694444,540,1358,949,294,0,294,0,47,0,0,empty,mBC-0814-1
"B2,D10",4409,5097,3062,2035,2969,0,1759,1764,1311,453,2.894039735,1010,795,542,153,0,153,0,43,0,0.013071895,empty,mBC-0814-1
"B2,D11",4213,4554,3004,1550,2684,0,1493,1493,1072,421,2.54631829,811,1470,989,304,1,303,1,81,0,0,empty,mBC-0814-1
"B2,D12",6316,6710,4460,2250,3889,1,2086,2097,1451,646,2.246130031,1087,3005,2034,478,1,477,1,84,0,0,empty,mBC-0814-1
"B2,E1",4950,5262,3535,1727,3106,0,1647,1650,1174,476,2.466386555,834,1719,1162,366,2,364,1,71,0,0.043956044,empty,mBC-0814-1
"B2,E2",470512,548676,312932,235744,323462,1,200162,200423,173365,27058,6.407162392,119984,344249,248475,67648,52,67596,5,3340,0,0.00054737,mm10,mBC-0814-1
"B2,E3",3503,3816,2497,1319,2253,0,1233,1234,868,366,2.371584699,681,1504,1001,325,0,325,0,70,0,0,empty,mBC-0814-1
"B2,E4",464608,547769,311710,236059,321927,0,204144,204383,141085,63298,2.228901387,123065,143735,100439,28158,14,28144,2,1889,0,0,mm10,mBC-0814-1
"B2,E5",3839,4245,2777,1468,2405,0,1267,1267,952,315,3.022222222,667,1164,882,233,0,233,0,44,0,0,empty,mBC-0814-1
"B2,E6",682493,778616,469768,308848,449665,2,273107,273454,209945,63509,3.305751941,159160,184507,135692,38102,26,38076,2,2222,0,0.000551529,mm10,mBC-0814-1
"B2,E7",4536,4707,3348,1359,2747,0,1385,1389,1004,385,2.607792208,703,1236,806,209,0,209,0,38,0,0,empty,mBC-0814-1
"B2,E8",4583,4836,3350,1486,2925,0,1501,1503,1109,394,2.814720812,783,1695,1337,327,0,327,0,62,0,0.04587156,empty,mBC-0814-1
"B2,E9",3422,3685,2454,1231,2174,0,1173,1179,820,359,2.284122563,616,1190,738,242,0,242,0,65,0,0,empty,mBC-0814-1
"B2,E10",4076,4430,2900,1530,2584,0,1436,1438,1035,403,2.568238213,783,1849,1022,336,0,336,0,80,0,0,empty,mBC-0814-1
"B2,E11",4256,4548,3051,1497,2682,0,1435,1438,1009,429,2.351981352,739,1684,1248,360,2,358,1,67,0,0,empty,mBC-0814-1
"B2,E12",4031,4310,2954,1356,2587,0,1352,1358,998,360,2.772222222,719,1046,781,238,1,237,1,55,0,0.012658228,empty,mBC-0814-1
"B2,F1",20661,25022,12942,12080,14658,0,9848,9862,6194,3668,1.68865867,6239,22852,7848,2464,3,2461,3,249,0,0.092238927,empty,mBC-0814-1
"B2,F2",695204,789452,465445,324007,460257,2,285429,285783,236279,49504,4.77292744,167478,186820,128913,35048,26,35022,2,2242,0,0.00959397,mm10,mBC-0814-1
"B2,F3",5154,5876,3691,2185,3357,3,1877,1880,1376,504,2.73015873,1053,1382,924,260,0,260,0,58,0,0,empty,mBC-0814-1
"B2,F4",5842,6211,4291,1920,3524,0,1881,1886,1376,510,2.698039216,930,540,320,116,0,116,0,36,0,0,empty,mBC-0814-1
"B2,F5",535965,602668,362018,240650,358042,0,220971,221264,179385,41879,4.283411734,129482,14391,9820,2761,1,2760,1,409,0,0.005434783,mm10,mBC-0814-1
"B2,F6",5115,5576,3608,1968,3252,0,1807,1807,1281,526,2.435361217,983,3097,2330,624,0,624,0,101,0,0.025641026,empty,mBC-0814-1
"B2,F7",996637,1109348,691195,418153,654785,1,390974,391421,296093,95328,3.106044394,224557,16067,9369,2502,3,2499,2,342,0,0,mm10,mBC-0814-1
"B2,F8",6333,6837,4580,2257,3881,0,2086,2086,1499,587,2.553662692,1088,124,89,34,0,34,0,11,0,0,empty,mBC-0814-1
"B2,F9",5511,5759,3994,1765,3341,0,1725,1728,1233,495,2.490909091,851,1823,1305,423,1,422,1,79,0,0,empty,mBC-0814-1
"B2,F10",6771,7320,4972,2348,4265,0,2269,2273,1636,637,2.568288854,1205,1590,1246,373,0,373,0,67,0,0,empty,mBC-0814-1
"B2,F11",4523,4816,3318,1498,2793,0,1462,1462,1049,413,2.539951574,700,1289,855,256,0,256,0,55,0,0,empty,mBC-0814-1
"B2,F12",416085,477692,284537,193155,282164,0,172078,172264,132422,39842,3.32367853,101683,4159,2321,701,0,701,0,113,0,0.007132668,empty,mBC-0814-1
"B2,G1",643980,736225,433297,302928,432872,1,268538,268878,214876,54002,3.979037813,158608,222057,160536,45121,24,45097,3,2501,0,6.65233E-05,mm10,mBC-0814-1
"B2,G2",5897,6262,4315,1947,3608,0,1914,1919,1392,527,2.641366224,966,533,397,138,0,138,0,20,0,0.007246377,empty,mBC-0814-1
"B2,G3",6316,7009,4420,2589,4028,2,2321,2323,1656,667,2.482758621,1294,1835,1310,378,0,378,0,79,0,0,empty,mBC-0814-1
"B2,G4",5278,5679,3885,1794,3306,0,1755,1761,1217,544,2.237132353,900,1,0,0,0,0,0,0,0,0,empty,mBC-0814-1
"B2,G5",4604,4866,3395,1471,2884,0,1556,1558,1142,416,2.745192308,773,1547,1065,336,1,335,1,60,0,0,empty,mBC-0814-1
"B2,G6",9174,9952,6698,3254,5710,0,3065,3073,2219,854,2.598360656,1605,328,233,64,0,64,0,14,0,0,empty,mBC-0814-1
"B2,G7",5713,5937,4076,1861,3512,1,1861,1864,1308,556,2.352517986,964,1799,1181,393,0,393,0,88,0,0.005089059,empty,mBC-0814-1
"B2,G8",7655,8279,5421,2858,4909,0,2676,2680,1883,797,2.362609787,1450,3778,2551,835,0,835,0,153,0,0.023952096,empty,mBC-0814-1
"B2,G9",5525,5955,3961,1994,3503,0,1947,1951,1416,535,2.646728972,1014,1814,1335,386,0,386,0,102,0,0,empty,mBC-0814-1
"B2,G10",9286,10051,6527,3524,5970,0,3255,3260,2364,896,2.638392857,1755,2868,2004,652,0,652,0,123,0,0.006134969,empty,mBC-0814-1
"B2,G11",456909,512200,311730,200470,304379,0,184477,184715,130940,53775,2.434960483,106865,38674,28336,7649,4,7645,1,803,0,0.001700458,mm10,mBC-0814-1
"B2,G12",4761,5025,3351,1674,3050,0,1682,1687,1202,485,2.478350515,873,2141,1511,511,2,509,1,95,0,0,empty,mBC-0814-1
"B2,H1",521939,617284,346442,270842,365285,0,234182,234400,177426,56974,3.114157335,142600,77699,56304,15267,8,15259,2,1266,0,0,mm10,mBC-0814-1
"B2,H2",494961,586118,329209,256909,343673,5,216407,216666,163883,52783,3.104844363,131332,145699,106717,29476,11,29465,2,2070,0,3.39386E-05,mm10,mBC-0814-1
"B2,H3",5814,6251,4157,2094,3606,0,1941,1941,1397,544,2.568014706,1025,1484,970,256,1,255,1,70,0,0.003921569,empty,mBC-0814-1
"B2,H4",5769,6212,4190,2022,3541,0,1886,1890,1358,532,2.552631579,970,45,33,16,0,16,0,6,0,0,empty,mBC-0814-1
"B2,H5",6748,7306,4840,2466,4280,0,2382,2391,1669,722,2.311634349,1275,2327,1688,483,0,483,0,93,0,0,empty,mBC-0814-1
"B2,H6",6981,7679,4984,2695,4340,0,2283,2283,1684,599,2.811352254,1238,4884,2198,601,0,601,0,97,0,0.046589018,empty,mBC-0814-1
"B2,H7",5353,5762,3890,1872,3397,0,1827,1829,1330,499,2.665330661,979,1422,1042,311,1,310,1,63,0,0,empty,mBC-0814-1
"B2,H8",4597,4983,3259,1724,3012,0,1641,1644,1153,491,2.348268839,913,2036,1497,421,0,421,0,94,0,0.002375297,empty,mBC-0814-1
"B2,H9",5506,5949,3961,1988,3478,0,1883,1887,1348,539,2.500927644,1047,1335,964,248,0,248,0,61,0,0,empty,mBC-0814-1
"B2,H10",4004,4308,2838,1470,2500,0,1376,1378,1017,361,2.817174515,744,5462,1773,571,0,571,0,74,0,0,empty,mBC-0814-1
"B2,H11",4189,4530,2904,1626,2644,0,1499,1500,1072,428,2.504672897,843,120,94,34,0,34,0,12,0,0,empty,mBC-0814-1
"B2,H12",3009,3434,2083,1351,2078,0,1221,1224,870,354,2.457627119,720,2377,1479,342,0,342,0,68,0,0,empty,mBC-0814-1
"B3,A1",4902,5528,3475,2053,3207,0,1765,1769,1230,539,2.282003711,1012,6037,2308,770,1,769,1,78,0,0.075422627,empty,mBC-0814-1
"B3,A2",5823,6234,4128,2106,3700,0,2034,2034,1573,461,3.412147505,1095,1106,778,230,0,230,0,59,0,0,empty,mBC-0814-1
"B3,A3",4201,4541,2900,1641,2685,0,1453,1460,1055,405,2.604938272,850,539,353,126,0,126,0,36,0,0.03968254,empty,mBC-0814-1
"B3,A4",4613,4926,3324,1602,2795,0,1441,1444,1044,400,2.61,750,402,295,68,0,68,0,18,0,0,empty,mBC-0814-1
"B3,A5",4389,4687,3163,1524,2777,0,1522,1525,1100,425,2.588235294,802,800,496,134,0,134,0,38,0,0.044776119,empty,mBC-0814-1
"B3,A6",3510,3710,2506,1204,2269,0,1248,1248,892,356,2.505617978,657,935,628,193,0,193,0,53,0,0,empty,mBC-0814-1
"B3,A7",5122,5371,3678,1693,3201,1,1729,1733,1246,487,2.558521561,885,1853,1241,320,0,320,0,67,0,0.05625,empty,mBC-0814-1
"B3,A8",1993,2167,1467,700,1249,0,672,672,452,220,2.054545455,341,4452,1752,566,0,566,0,99,0,0.164310954,empty,mBC-0814-1
"B3,A9",5872,6159,4149,2010,3616,0,1939,1942,1445,497,2.907444668,1013,1559,1148,365,0,365,0,69,0,0,empty,mBC-0814-1
"B3,A10",3382,3621,2376,1245,2116,5,1190,1200,868,332,2.614457831,654,191,134,51,0,51,0,11,0,0,empty,mBC-0814-1
"B3,A11",501308,578408,330721,247687,343815,2,216501,216734,169698,47036,3.607832299,129791,275427,192715,54183,39,54144,5,3030,0,0.000831117,mm10,mBC-0814-1
"B3,A12",700227,804222,463265,340957,470260,0,292816,293123,239286,53837,4.444638446,174651,729533,521924,145331,88,145243,3,4958,0,0.001184222,mm10,mBC-0814-1
"B3,B1",4175,4449,2949,1500,2683,0,1427,1427,1046,381,2.745406824,787,1998,1114,361,0,361,0,69,0,0,empty,mBC-0814-1
"B3,B2",4993,4976,3240,1736,2844,0,1592,1593,1161,432,2.6875,836,15683,4900,1597,0,1597,0,166,0,0.145272386,empty,mBC-0814-1
"B3,B3",3795,4233,2680,1553,2446,0,1378,1381,986,395,2.496202532,730,1768,1102,290,0,290,0,52,0,0.037931034,empty,mBC-0814-1
"B3,B4",3983,4365,2798,1567,2608,2,1458,1460,1044,416,2.509615385,813,741,561,180,0,180,0,42,0,0,empty,mBC-0814-1
"B3,B5",350616,235123,138447,96676,169103,0,102477,102847,79279,23568,3.363840801,62639,30335,21231,5791,1,5790,1,642,0,0.000518135,mm10,mBC-0814-1
"B3,B6",3894,4307,2752,1555,2484,0,1407,1410,1000,410,2.43902439,770,1247,814,257,0,257,0,48,0,0,empty,mBC-0814-1
"B3,B7",4320,4683,3062,1621,2738,0,1459,1464,1041,423,2.460992908,779,1042,819,244,0,244,0,42,0,0,empty,mBC-0814-1
"B3,B8",3270,3494,2349,1145,2011,0,1059,1061,748,313,2.389776358,536,881,662,236,1,235,1,36,0,0.068085106,empty,mBC-0814-1
"B3,B9",4418,4771,3086,1685,2862,0,1619,1622,1205,417,2.889688249,889,525,380,122,0,122,0,41,0,0.008196721,empty,mBC-0814-1
"B3,B10",386601,425889,246209,179680,261676,1,161127,161567,124394,37173,3.346353536,96308,34215,24758,7042,3,7039,1,691,0,0,mm10,mBC-0814-1
"B3,B11",5872,6371,4206,2165,3676,0,2008,2008,1429,579,2.468048359,1060,118,78,32,0,32,0,10,0,0,empty,mBC-0814-1
"B3,B12",4835,5394,3462,1932,3137,0,1753,1755,1226,529,2.31758034,962,746,492,164,0,164,0,46,0,0,empty,mBC-0814-1
"B3,C1",5015,5284,3583,1701,3171,0,1699,1701,1249,452,2.763274336,900,467,303,89,0,89,0,30,0,0,empty,mBC-0814-1
"B3,C2",4760,4929,3397,1532,2876,0,1526,1527,1106,421,2.627078385,786,1484,1072,326,0,326,0,68,0,0,empty,mBC-0814-1
"B3,C3",5186,5457,3721,1736,3215,4,1717,1725,1272,453,2.80794702,912,489,278,84,0,84,0,25,0,0,empty,mBC-0814-1
"B3,C4",4891,5259,3484,1775,3114,0,1653,1656,1178,478,2.464435146,893,2290,1272,327,1,326,1,69,0,0,empty,mBC-0814-1
"B3,C5",6516,7060,4680,2380,4098,0,2291,2300,1675,625,2.68,1218,1381,945,258,0,258,0,60,0,0,empty,mBC-0814-1
"B3,C6",4827,5060,3426,1634,3030,0,1616,1616,1159,457,2.536105033,844,986,644,219,0,219,0,47,0,0.00913242,empty,mBC-0814-1
"B3,C7",6058,6639,4322,2317,3817,0,2125,2125,1562,563,2.774422735,1155,240,168,58,0,58,0,14,0,0,empty,mBC-0814-1
"B3,C8",4859,5035,3574,1461,3050,0,1592,1596,1155,441,2.619047619,805,1403,926,265,0,265,0,54,0,0,empty,mBC-0814-1
"B3,C9",4132,4474,2885,1589,2587,0,1432,1434,1040,394,2.639593909,797,511,322,135,0,135,0,40,0,0,empty,mBC-0814-1
"B3,C10",5457,5784,3805,1979,3245,0,1736,1738,1277,461,2.770065076,925,37348,11074,3491,4,3487,1,314,0,0.033266418,empty,mBC-0814-1
"B3,C11",4018,4393,2879,1514,2516,0,1389,1390,985,405,2.432098765,732,1094,792,236,0,236,0,55,0,0.016949153,empty,mBC-0814-1
"B3,C12",7689,8363,5475,2888,4805,7,2655,2672,1895,777,2.438867439,1407,12697,4321,1368,3,1365,2,126,0,0.158241758,empty,mBC-0814-1
"B3,D1",4012,4297,2846,1451,2601,0,1420,1421,998,423,2.359338061,764,624,450,153,0,153,0,28,0,0,empty,mBC-0814-1
"B3,D2",4356,4692,3192,1500,2819,0,1491,1492,1058,434,2.437788018,777,1637,1152,304,0,304,0,80,0,0.072368421,empty,mBC-0814-1
"B3,D3",9807,10483,7109,3374,6216,0,3291,3301,2372,929,2.5532831,1742,2079,1457,402,0,402,0,89,0,0.009950249,empty,mBC-0814-1
"B3,D4",4231,4653,3088,1565,2752,0,1502,1508,1047,461,2.271149675,805,1201,885,284,0,284,0,63,0,0.017605634,empty,mBC-0814-1
"B3,D5",4511,4883,3170,1713,2846,0,1537,1537,1146,391,2.930946292,848,1910,1352,417,0,417,0,77,0,0.028776978,empty,mBC-0814-1
"B3,D6",4231,4818,3087,1731,2820,0,1576,1576,1149,427,2.690866511,861,1166,811,211,0,211,0,52,0,0.023696682,empty,mBC-0814-1
"B3,D7",5510,5755,3945,1810,3390,0,1847,1850,1344,506,2.656126482,962,2025,1428,404,0,404,0,82,0,0.004950495,empty,mBC-0814-1
"B3,D8",4371,4581,3143,1438,2669,0,1404,1406,1009,397,2.541561713,713,368,269,98,0,98,0,37,0,0.010204082,empty,mBC-0814-1
"B3,D9",2962,3196,2077,1119,1914,0,1047,1048,705,343,2.055393586,577,7991,2845,817,2,815,2,95,0,0.052760736,empty,mBC-0814-1
"B3,D10",3409,3561,2400,1161,2111,0,1132,1136,806,330,2.442424242,607,584,365,113,0,113,0,40,0,0,empty,mBC-0814-1
"B3,D11",3965,4156,2750,1406,2508,0,1410,1410,1049,361,2.905817175,731,11170,4139,1411,0,1411,0,152,0,0.184266478,empty,mBC-0814-1
"B3,D12",5813,6488,4205,2283,3763,0,2100,2105,1484,621,2.389694042,1148,2409,1703,537,0,537,0,103,0,0.011173184,empty,mBC-0814-1
"B3,E1",4424,4790,3153,1637,2897,0,1555,1560,1102,458,2.406113537,839,1813,1252,381,0,381,0,58,0,0,empty,mBC-0814-1
"B3,E2",3399,3812,2467,1345,2240,0,1241,1247,917,330,2.778787879,707,1116,681,228,0,228,0,49,0,0,empty,mBC-0814-1
"B3,E3",3139,3429,2240,1189,1961,1,1040,1041,772,269,2.869888476,561,1048,765,231,1,230,1,47,0,0,empty,mBC-0814-1
"B3,E4",311982,360007,212768,147239,215661,1,133903,134027,101350,32677,3.101569912,79705,17342,12426,3549,3,3546,2,441,0,0,mm10,mBC-0814-1
"B3,E5",3248,3500,2376,1124,2003,0,1069,1069,785,284,2.764084507,576,729,530,157,1,156,1,32,0,0,empty,mBC-0814-1
"B3,E6",344699,387301,239124,148177,227047,0,135070,135217,111946,23271,4.81053672,77188,48328,35165,9765,6,9759,1,963,0,0.00010247,mm10,mBC-0814-1
"B3,E7",3977,4267,2800,1467,2503,0,1286,1294,948,346,2.739884393,722,1225,858,255,0,255,0,59,0,0.050980392,empty,mBC-0814-1
"B3,E8",4340,4429,3181,1248,2534,0,1250,1252,896,356,2.516853933,599,1926,1300,358,0,358,0,63,0,0.002793296,empty,mBC-0814-1
"B3,E9",3199,3418,2264,1154,1991,0,1101,1103,779,324,2.404320988,586,1242,783,249,0,249,0,64,0,0,empty,mBC-0814-1
"B3,E10",3705,3911,2716,1195,2351,0,1234,1236,862,374,2.304812834,618,1267,851,273,0,273,0,64,0,0.058608059,empty,mBC-0814-1
"B3,E11",3929,4192,2823,1369,2439,5,1288,1294,953,341,2.794721408,672,1289,910,268,0,268,0,60,0,0,empty,mBC-0814-1
"B3,E12",3525,3813,2502,1311,2247,0,1229,1229,859,370,2.321621622,652,906,675,227,0,227,0,44,0,0,empty,mBC-0814-1
"B3,F1",4091,4278,2938,1340,2519,0,1310,1312,954,358,2.664804469,686,2699,1183,367,0,367,0,65,0,0,empty,mBC-0814-1
"B3,F2",5956,6314,4182,2132,3657,0,1956,1959,1433,526,2.724334601,1044,1762,1217,363,1,362,1,94,0,0.002762431,empty,mBC-0814-1
"B3,F3",4633,5087,3362,1725,2923,0,1580,1583,1187,396,2.997474747,822,1697,1116,333,0,333,0,64,0,0,empty,mBC-0814-1
"B3,F4",4790,5059,3395,1664,3071,0,1651,1652,1193,459,2.59912854,883,695,456,136,0,136,0,30,0,0.110294118,empty,mBC-0814-1
"B3,F5",485127,569915,323834,246081,336307,1,212046,212307,175830,36477,4.820297722,128063,117391,84656,23949,10,23939,2,1742,0,0.000459501,mm10,mBC-0814-1
"B3,F6",4752,5119,3366,1753,3015,0,1687,1694,1251,443,2.823927765,929,1654,1110,371,0,371,0,97,0,0.02425876,empty,mBC-0814-1
"B3,F7",3938,4033,2916,1117,2382,0,1199,1199,831,368,2.258152174,587,509,438,114,0,114,0,27,0,0.052631579,empty,mBC-0814-1
"B3,F8",5376,5861,3925,1936,3467,0,1872,1872,1355,517,2.620889749,986,89,30,16,0,16,0,7,0,0,empty,mBC-0814-1
"B3,F9",4773,5029,3502,1527,3011,1,1597,1601,1148,453,2.534216336,818,1554,1102,369,0,369,0,78,0,0,empty,mBC-0814-1
"B3,F10",5516,5953,3990,1963,3572,0,1914,1917,1341,576,2.328125,1044,906,653,233,0,233,0,52,0,0,empty,mBC-0814-1
"B3,F11",3957,4044,2918,1126,2369,1,1199,1203,841,362,2.32320442,567,1391,872,240,0,240,0,50,0,0,empty,mBC-0814-1
"B3,F12",4372,4641,3086,1555,2710,0,1497,1497,1093,404,2.705445545,784,155,116,35,0,35,0,9,0,0,empty,mBC-0814-1
"B3,G1",6755,7280,4901,2379,4236,0,2306,2308,1599,709,2.25528914,1227,2928,2145,608,0,608,0,135,0,0.023026316,empty,mBC-0814-1
"B3,G2",5215,5548,3825,1723,3198,7,1684,1693,1194,499,2.392785571,862,465,191,43,0,43,0,16,0,0,empty,mBC-0814-1
"B3,G3",5515,6029,3881,2148,3567,2,1989,1995,1449,546,2.653846154,1147,1456,1000,336,0,336,0,79,0,0,empty,mBC-0814-1
"B3,G4",4567,5024,3222,1802,2833,1,1511,1513,1068,445,2.4,831,4,0,0,0,0,0,0,0,0,empty,mBC-0814-1
"B3,G5",4117,4445,2897,1548,2560,0,1381,1382,959,423,2.26713948,750,1110,762,269,0,269,0,48,0,0,empty,mBC-0814-1
"B3,G6",7602,8185,5615,2570,4833,0,2545,2546,1881,665,2.828571429,1302,237,185,71,0,71,0,11,0,0,empty,mBC-0814-1
"B3,G7",6162,6834,4430,2404,4085,0,2331,2334,1760,574,3.066202091,1249,1692,1318,362,1,361,1,82,0,0.008310249,empty,mBC-0814-1
"B3,G8",7158,7564,4980,2584,4413,3,2433,2444,1740,704,2.471590909,1290,10070,3802,1315,0,1315,0,175,0,0.007604563,empty,mBC-0814-1
"B3,G9",5829,6460,4078,2382,3701,0,2095,2097,1516,581,2.60929432,1159,2221,1528,469,0,469,0,110,0,0.02771855,empty,mBC-0814-1
"B3,G10",8361,9204,5850,3354,5448,4,2961,2971,2167,804,2.695273632,1693,2645,1859,500,0,500,0,100,0,0,empty,mBC-0814-1
"B3,G11",8621,9101,6184,2917,5249,2,2724,2731,1967,764,2.57460733,1427,1090,847,243,1,242,1,52,0,0,empty,mBC-0814-1
"B3,G12",4284,4526,3037,1489,2753,0,1521,1524,1069,455,2.349450549,770,2162,1448,448,0,448,0,95,0,0,empty,mBC-0814-1
"B3,H1",4045,4457,2846,1611,2628,2,1437,1445,1026,419,2.448687351,820,699,487,173,0,173,0,41,0,0,empty,mBC-0814-1
"B3,H2",7165,7767,5061,2706,4519,0,2562,2565,1832,733,2.499317872,1369,3010,2158,676,0,676,0,146,0,0,empty,mBC-0814-1
"B3,H3",576397,656805,388224,268581,384022,1,237331,237603,203397,34206,5.946237502,139346,112696,82167,22731,17,22714,4,1613,0,4.40257E-05,mm10,mBC-0814-1
"B3,H4",5152,5530,3590,1940,3360,0,1886,1893,1436,457,3.142231947,1043,77,51,27,0,27,0,9,0,0,empty,mBC-0814-1
"B3,H5",6057,6502,4402,2100,3750,0,1986,1991,1382,609,2.269293924,1011,1597,1079,281,0,281,0,65,0,0,empty,mBC-0814-1
"B3,H6",5790,6174,4149,2025,3672,0,2055,2060,1430,630,2.26984127,1081,8549,3208,936,2,934,2,157,0,0.012847966,empty,mBC-0814-1
"B3,H7",4661,4899,3420,1479,2935,0,1552,1552,1132,420,2.695238095,798,698,433,118,0,118,0,39,0,0,empty,mBC-0814-1
"B3,H8",4014,4571,2805,1766,2629,3,1473,1477,1063,414,2.56763285,824,1477,958,301,0,301,0,61,0,0.059800664,empty,mBC-0814-1
"B3,H9",4509,4806,3219,1587,2852,0,1489,1494,1060,434,2.442396313,809,1253,902,252,0,252,0,49,0,0,empty,mBC-0814-1
"B3,H10",3289,3631,2339,1292,2025,0,1091,1091,796,295,2.698305085,577,9148,2880,979,1,978,1,102,0,0.162576687,empty,mBC-0814-1
"B3,H11",3748,4068,2696,1372,2399,0,1377,1377,966,411,2.350364964,728,25,9,6,0,6,0,2,0,0,empty,mBC-0814-1
"B3,H12",2704,2879,1840,1039,1749,0,989,991,696,295,2.359322034,515,1202,700,195,0,195,0,48,0,0,empty,mBC-0814-1
"B4,A1",5787,6380,4217,2163,3734,0,2079,2080,1493,587,2.543441227,1097,1258,760,254,0,254,0,70,0,0,empty,mBC-0814-1
"B4,A2",6284,6889,4470,2419,4094,0,2236,2241,1684,557,3.023339318,1254,2172,1412,365,0,365,0,101,0,0,empty,mBC-0814-1
"B4,A3",5023,5313,3622,1691,3128,0,1661,1662,1175,487,2.412731006,874,962,693,203,0,203,0,52,0,0.009852217,empty,mBC-0814-1
"B4,A4",5422,5738,3993,1745,3326,0,1740,1740,1261,479,2.63256785,873,600,386,133,0,133,0,30,0,0,empty,mBC-0814-1
"B4,A5",5216,5473,3642,1831,3172,0,1740,1742,1263,479,2.636743215,912,9894,3120,980,2,978,1,105,0,0.183026585,empty,mBC-0814-1
"B4,A6",4006,4588,2894,1694,2677,0,1500,1502,1039,463,2.244060475,824,1406,925,283,0,283,0,62,0,0,empty,mBC-0814-1
"B4,A7",5849,6183,4249,1934,3639,0,2007,2010,1466,544,2.694852941,1009,22163,6403,2121,2,2119,1,248,0,0.026899481,empty,mBC-0814-1
"B4,A8",2554,2767,1755,1012,1661,0,949,951,643,308,2.087662338,546,1789,1270,442,0,442,0,86,0,0.015837104,empty,mBC-0814-1
"B4,A9",6757,7216,4869,2347,4197,1,2251,2255,1629,626,2.602236422,1203,1779,1179,352,0,352,0,65,0,0.034090909,empty,mBC-0814-1
"B4,A10",426675,497983,279472,218511,293020,0,184853,185071,153940,31131,4.944910218,111887,35240,24681,6781,7,6774,2,754,0,0.00044287,mm10,mBC-0814-1
"B4,A11",5297,5763,3792,1971,3388,0,1828,1829,1310,519,2.524084778,1003,2074,1272,420,0,420,0,111,0,0.042857143,empty,mBC-0814-1
"B4,A12",5316,5704,3745,1959,3388,0,1887,1891,1427,464,3.075431034,1017,3238,2309,749,0,749,0,199,0,0.002670227,empty,mBC-0814-1
"B4,B1",419632,486819,278494,208325,290239,0,185707,185905,143600,42305,3.394397825,111977,30267,21254,6133,3,6130,2,648,0,0.001305057,mm10,mBC-0814-1
"B4,B2",4692,4876,3300,1576,2882,0,1539,1539,1102,437,2.52173913,808,446,338,113,0,113,0,32,0,0,empty,mBC-0814-1
"B4,B3",1337365,1522994,901316,621678,887305,3,557673,558317,441464,116853,3.777943228,329221,174113,125655,35416,15,35401,3,2440,0,0.000536708,mm10,mBC-0814-1
"B4,B4",4714,5175,3386,1789,3046,0,1652,1654,1195,459,2.603485839,897,1609,1166,368,1,367,1,90,0,0.008174387,empty,mBC-0814-1
"B4,B5",6006,5115,3104,2011,3350,0,1955,1962,1536,426,3.605633803,1132,1275,846,234,0,234,0,59,0,0,empty,mBC-0814-1
"B4,B6",4464,4754,3250,1504,2793,0,1487,1487,1048,439,2.387243736,754,1143,758,233,0,233,0,56,0,0,empty,mBC-0814-1
"B4,B7",5082,5482,3785,1697,3177,0,1663,1667,1217,450,2.704444444,836,4227,1652,470,0,470,0,81,0,0.017021277,empty,mBC-0814-1
"B4,B8",3757,4034,2695,1339,2391,0,1282,1286,929,357,2.602240896,711,4524,1964,563,1,562,1,83,0,0.044483986,empty,mBC-0814-1
"B4,B9",5022,5453,3480,1973,3234,0,1762,1765,1274,491,2.594704684,1016,494,328,162,0,162,0,63,0,0,empty,mBC-0814-1
"B4,B10",562038,602766,369840,232926,359657,2,208541,209085,172760,36325,4.7559532,119621,90459,66343,18242,15,18227,1,1341,0,0,mm10,mBC-0814-1
"B4,B11",7870,8687,5618,3069,4915,0,2660,2664,1986,678,2.92920354,1435,276,172,55,0,55,0,17,0,0,empty,mBC-0814-1
"B4,B12",5493,5899,3941,1958,3420,0,1858,1860,1390,470,2.957446809,971,1311,967,279,0,279,0,74,0,0,empty,mBC-0814-1
"B4,C1",11612,12368,8407,3961,6985,0,3858,3867,2289,1578,1.450570342,1940,6723,5219,1525,0,1525,0,176,0,0,empty,mBC-0814-1
"B4,C2",5660,6164,4019,2145,3622,0,1973,1978,1450,528,2.746212121,1070,1884,1293,415,0,415,0,100,0,0,empty,mBC-0814-1
"B4,C3",6051,6449,4403,2046,3716,6,1960,1970,1401,569,2.462214411,1015,600,357,130,0,130,0,34,0,0,empty,mBC-0814-1
"B4,C4",651153,761081,423101,337980,443056,0,284644,284959,222876,62083,3.589968268,172154,214847,156900,43867,27,43840,2,2461,0,0.000775547,mm10,mBC-0814-1
"B4,C5",7477,8005,5364,2641,4694,0,2540,2545,1829,716,2.554469274,1369,2957,1294,429,0,429,0,110,0,0,empty,mBC-0814-1
"B4,C6",5612,6041,3956,2085,3603,0,2013,2015,1423,592,2.403716216,1114,1707,1187,319,0,319,0,78,0,0.056426332,empty,mBC-0814-1
"B4,C7",6883,7422,4927,2495,4270,0,2254,2259,1649,610,2.703278689,1239,387,272,90,0,90,0,29,0,0,empty,mBC-0814-1
"B4,C8",5741,6186,4104,2082,3570,0,1956,1961,1402,559,2.508050089,1049,1737,1152,348,1,347,1,89,0,0,empty,mBC-0814-1
"B4,C9",4874,5194,3459,1735,3008,1,1635,1638,1188,450,2.64,872,3954,1372,488,1,487,1,91,0,0.067761807,empty,mBC-0814-1
"B4,C10",5792,6242,4166,2076,3564,0,1909,1909,1365,544,2.509191176,1001,4251,1574,607,0,607,0,95,0,0.024711697,empty,mBC-0814-1
"B4,C11",4591,5132,3208,1924,3002,6,1742,1756,1217,539,2.257884972,961,1321,868,270,0,270,0,77,0,0,empty,mBC-0814-1
"B4,C12",8598,9413,6067,3346,5407,0,2990,2991,2137,854,2.50234192,1625,2537,1769,518,0,518,0,92,0,0.001930502,empty,mBC-0814-1
"B4,D1",4819,5176,3341,1835,3076,0,1693,1697,1286,411,3.128953771,929,526,401,134,1,133,1,36,0,0,empty,mBC-0814-1
"B4,D2",4840,4958,3610,1348,2968,1,1496,1503,1094,409,2.674816626,708,2045,1510,410,1,409,1,93,0,0.002444988,empty,mBC-0814-1
"B4,D3",11430,12645,8127,4518,7365,0,4100,4105,2944,1161,2.535745047,2284,7148,2798,923,0,923,0,158,0,0.045503792,empty,mBC-0814-1
"B4,D4",5034,5478,3533,1945,3268,0,1823,1831,1283,548,2.341240876,1002,1669,1133,384,0,384,0,90,0,0,empty,mBC-0814-1
"B4,D5",626924,732118,413937,318181,434032,1,275402,275693,218560,57133,3.825459892,166855,434916,285143,80686,57,80629,5,3674,0,0.003646331,mm10,mBC-0814-1
"B4,D6",5013,5582,3653,1929,3264,1,1760,1762,1260,502,2.509960159,956,2004,1289,450,1,449,1,87,0,0,empty,mBC-0814-1
"B4,D7",503770,586777,334519,252258,342326,2,214448,214707,174541,40166,4.345491211,128693,437650,295827,81963,37,81926,6,3554,0,0.003234626,mm10,mBC-0814-1
"B4,D8",4872,5418,3519,1899,3165,0,1702,1702,1193,509,2.343811395,936,1013,693,227,0,227,0,64,0,0,empty,mBC-0814-1
"B4,D9",316424,371390,210996,160394,222096,0,141176,141346,106116,35230,3.012091967,86041,43864,29714,8557,7,8550,1,849,0,0,mm10,mBC-0814-1
"B4,D10",3944,3891,2782,1109,2397,0,1306,1306,951,355,2.678873239,639,2884,1178,396,1,395,1,79,0,0,empty,mBC-0814-1
"B4,D11",4562,4917,3221,1696,2899,0,1570,1572,1123,449,2.501113586,851,2567,1765,530,0,530,0,127,0,0.026415094,empty,mBC-0814-1
"B4,D12",6429,6857,4603,2254,4063,0,2184,2186,1536,650,2.363076923,1186,2550,1794,551,0,551,0,111,0,0,empty,mBC-0814-1
"B4,E1",5004,5208,3627,1581,3068,0,1591,1591,1148,443,2.591422122,792,1111,812,277,0,277,0,71,0,0.093862816,empty,mBC-0814-1
"B4,E2",3900,4212,2759,1453,2417,2,1286,1290,931,359,2.593314763,684,1351,924,236,0,236,0,63,0,0,empty,mBC-0814-1
"B4,E3",3488,3857,2583,1274,2147,0,1193,1194,868,326,2.662576687,597,1496,1002,310,0,310,0,65,0,0.064516129,empty,mBC-0814-1
"B4,E4",3086,3410,2242,1168,2034,0,1116,1118,779,339,2.297935103,620,970,659,211,0,211,0,54,0,0,empty,mBC-0814-1
"B4,E5",3646,3968,2606,1362,2273,0,1217,1221,855,366,2.336065574,633,3466,1440,413,0,413,0,55,0,0,empty,mBC-0814-1
"B4,E6",4620,5026,3382,1644,2841,0,1516,1516,1050,466,2.253218884,802,1616,1222,367,0,367,0,71,0,0,empty,mBC-0814-1
"B4,E7",4550,4952,3328,1624,2876,0,1532,1538,1096,442,2.479638009,811,1338,954,293,0,293,0,66,0,0,empty,mBC-0814-1
"B4,E8",575915,663022,387448,275574,387417,0,238744,239020,196891,42129,4.673526549,141246,325208,238285,65600,32,65568,6,3092,0,3.05027E-05,mm10,mBC-0814-1
"B4,E9",3952,4323,2729,1594,2527,1,1430,1438,1014,424,2.391509434,792,6140,2632,932,0,932,0,145,0,0.127682403,empty,mBC-0814-1
"B4,E10",4079,4528,2931,1597,2705,0,1490,1500,1077,423,2.546099291,835,1789,1325,429,0,429,0,94,0,0,empty,mBC-0814-1
"B4,E11",4597,5009,3381,1628,2921,0,1564,1566,1120,446,2.511210762,841,1834,1281,458,0,458,0,89,0,0,empty,mBC-0814-1
"B4,E12",466660,526878,320379,206499,310941,0,189498,189691,148834,40857,3.642802947,110124,39578,28411,7951,5,7946,1,828,0,0,mm10,mBC-0814-1
"B4,F1",4962,5302,3608,1694,3069,0,1579,1581,1151,430,2.676744186,825,1465,1045,322,0,322,0,68,0,0,empty,mBC-0814-1
"B4,F2",6605,7111,4738,2373,4149,0,2255,2257,1633,624,2.616987179,1205,1557,1162,423,0,423,0,117,0,0.004728132,empty,mBC-0814-1
"B4,F3",5393,5849,3829,2020,3434,0,1873,1876,1341,535,2.506542056,1015,1489,1077,338,0,338,0,102,0,0,empty,mBC-0814-1
"B4,F4",5618,5817,4071,1746,3470,0,1867,1878,1364,514,2.653696498,929,290,178,58,0,58,0,29,0,0,empty,mBC-0814-1
"B4,F5",5333,5767,3708,2059,3292,0,1839,1846,1338,508,2.633858268,996,1192,857,301,0,301,0,71,0,0,empty,mBC-0814-1
"B4,F6",5490,5856,3970,1886,3484,4,1965,1973,1401,572,2.449300699,1051,1855,1199,348,0,348,0,100,0,0.057471264,empty,mBC-0814-1
"B4,F7",4505,4804,3238,1566,2816,0,1519,1523,1107,416,2.661057692,790,647,457,132,0,132,0,37,0,0,empty,mBC-0814-1
"B4,F8",6520,6865,4670,2195,3994,0,2141,2150,1550,600,2.583333333,1107,163,120,45,0,45,0,20,0,0,empty,mBC-0814-1
"B4,F9",5797,6320,4245,2075,3633,0,1933,1937,1381,556,2.48381295,1049,1726,1260,350,0,350,0,89,0,0.031428571,empty,mBC-0814-1
"B4,F10",6344,6805,4612,2193,3961,0,2115,2117,1507,610,2.470491803,1099,1329,956,288,0,288,0,69,0,0,empty,mBC-0814-1
"B4,F11",495987,559691,338102,221589,328931,0,201047,201271,149422,51849,2.881868503,117116,47762,33007,9485,7,9478,3,905,0,0,mm10,mBC-0814-1
"B4,F12",5103,5540,3623,1917,3196,0,1758,1762,1277,485,2.632989691,989,49,32,7,0,7,0,7,0,0,empty,mBC-0814-1
"B4,G1",7762,8509,5459,3050,4897,0,2643,2651,1924,727,2.646492435,1421,3417,2523,690,1,689,1,163,0,0.013062409,empty,mBC-0814-1
"B4,G2",5805,6105,4148,1957,3586,3,1929,1932,1363,569,2.39543058,1012,409,313,82,0,82,0,27,0,0,empty,mBC-0814-1
"B4,G3",5459,6169,3948,2221,3606,0,2033,2040,1483,557,2.662477558,1106,2417,1748,556,0,556,0,122,0,0.03057554,empty,mBC-0814-1
"B4,G4",5408,5872,3933,1939,3338,0,1774,1775,1250,525,2.380952381,949,1,1,0,0,0,0,0,0,0,empty,mBC-0814-1
"B4,G5",4999,5601,3643,1958,3170,0,1741,1743,1223,520,2.351923077,947,1139,784,247,0,247,0,59,0,0.076923077,empty,mBC-0814-1
"B4,G6",9766,10249,7038,3211,6006,0,3187,3191,2372,819,2.896214896,1639,458,269,94,0,94,0,21,0,0,empty,mBC-0814-1
"B4,G7",5932,6451,4205,2246,3746,6,2020,2030,1456,574,2.536585366,1111,7619,3211,985,0,985,0,159,0,0.014213198,empty,mBC-0814-1
"B4,G8",8257,9083,5913,3170,5284,2,2954,2961,2099,862,2.435034803,1640,12316,4617,1511,2,1509,1,242,0,0.058979457,empty,mBC-0814-1
"B4,G9",6116,6625,4333,2292,3932,0,2201,2203,1584,619,2.558966074,1159,2709,1853,560,0,560,0,148,0,0.030357143,empty,mBC-0814-1
"B4,G10",614787,691840,414199,277641,405535,1,248040,248299,170349,77950,2.185362412,144616,140119,97271,26609,21,26588,2,2132,0,0.001542049,mm10,mBC-0814-1
"B4,G11",552454,621508,375836,245672,364649,1,222349,222640,168594,54046,3.119453799,129802,24550,16879,4545,5,4540,1,530,0,0,mm10,mBC-0814-1
"B4,G12",503202,567032,338569,228463,334771,1,198389,198628,172147,26481,6.50077414,117816,889431,581098,152990,107,152883,9,5387,0,0.000516735,mm10,mBC-0814-1
"B4,H1",4836,5265,3495,1770,3032,0,1662,1664,1157,507,2.282051282,895,1090,819,278,0,278,0,61,0,0.043165468,empty,mBC-0814-1
"B4,H2",685889,777306,466998,310308,450152,1,274831,275146,223750,51396,4.35345163,160381,221341,161368,45158,28,45130,2,2437,0,0.000132949,mm10,mBC-0814-1
"B4,H3",5987,6459,4295,2164,3825,0,2128,2132,1513,619,2.444264943,1130,1188,781,260,0,260,0,81,0,0.007692308,empty,mBC-0814-1
"B4,H4",6608,7047,4612,2435,4125,1,2290,2295,1643,652,2.51993865,1239,446,174,65,0,65,0,18,0,0,empty,mBC-0814-1
"B4,H5",6599,7072,4741,2331,4099,0,2239,2240,1556,684,2.274853801,1207,2301,1661,413,0,413,0,76,0,0,empty,mBC-0814-1
"B4,H6",7129,7746,5077,2669,4572,0,2486,2491,1811,680,2.663235294,1369,2335,1710,451,0,451,0,114,0,0,empty,mBC-0814-1
"B4,H7",5544,6018,3985,2033,3612,0,1941,1945,1408,537,2.621973929,1070,1374,934,293,0,293,0,79,0,0.003412969,empty,mBC-0814-1
"B4,H8",4791,5341,3357,1984,3126,0,1744,1748,1273,475,2.68,988,2958,1697,534,0,534,0,116,0,0.026217228,empty,mBC-0814-1
"B4,H9",5929,6570,4276,2294,3902,9,2135,2148,1539,609,2.527093596,1199,9151,2881,882,3,879,3,137,0,0.053469852,empty,mBC-0814-1
"B4,H10",555798,648638,374175,274463,375953,0,233626,233904,186888,47016,3.974987238,140141,175479,126964,36404,22,36382,2,2105,0,0.000219889,mm10,mBC-0814-1
"B4,H11",4296,4809,2975,1834,2792,0,1524,1528,1105,423,2.612293144,853,68,48,28,0,28,0,11,0,0,empty,mBC-0814-1
"B4,H12",3520,3876,2441,1435,2259,0,1255,1255,895,360,2.486111111,687,1757,1265,401,0,401,0,84,0,0.002493766,empty,mBC-0814-1
"B5,A1",676348,777859,453506,324353,454888,0,282173,282493,243167,39326,6.183364695,166549,143311,101147,28872,20,28852,3,2060,0,0.000346596,mm10,mBC-0814-1
"B5,A2",4686,4852,3386,1466,2855,0,1508,1512,1094,418,2.61722488,783,2304,1224,389,0,389,0,80,0,0.11311054,empty,mBC-0814-1
"B5,A3",4270,4543,3037,1506,2643,0,1461,1464,1024,440,2.327272727,786,510,260,76,0,76,0,30,0,0,empty,mBC-0814-1
"B5,A4",5299,5510,3977,1533,3208,0,1649,1651,1195,456,2.620614035,836,260,156,62,0,62,0,16,0,0,empty,mBC-0814-1
"B5,A5",4278,4630,3113,1517,2662,0,1452,1455,1010,445,2.269662921,776,1277,932,284,1,283,1,48,0,0,empty,mBC-0814-1
"B5,A6",3353,3494,2376,1118,2027,0,1106,1110,804,306,2.62745098,567,1778,1181,341,0,341,0,67,0,0,empty,mBC-0814-1
"B5,A7",426979,495413,282833,212580,294049,0,185077,185295,155008,30287,5.117971407,111336,107946,77419,21871,12,21859,3,1607,0,0.000182991,mm10,mBC-0814-1
"B5,A8",1967,2157,1408,749,1233,0,666,667,468,199,2.351758794,349,1469,890,288,0,288,0,64,0,0,empty,mBC-0814-1
"B5,A9",6025,6579,4354,2225,3785,0,2009,2011,1432,579,2.473229706,1058,1177,749,197,0,197,0,51,0,0,empty,mBC-0814-1
"B5,A10",3267,3531,2271,1260,2045,0,1140,1140,818,322,2.540372671,619,270,172,49,0,49,0,12,0,0,empty,mBC-0814-1
"B5,A11",4302,4771,3043,1728,2775,0,1517,1522,1072,450,2.382222222,852,1895,1322,378,0,378,0,86,0,0,empty,mBC-0814-1
"B5,A12",3611,3771,2592,1179,2182,1,1179,1186,880,306,2.875816993,615,2733,1779,588,0,588,0,159,0,0,empty,mBC-0814-1
"B5,B1",4202,4509,3007,1502,2729,0,1463,1471,1041,430,2.420930233,823,1256,848,303,0,303,0,74,0,0,empty,mBC-0814-1
"B5,B2",4451,4707,3139,1568,2789,0,1498,1505,1102,403,2.734491315,817,409,289,69,0,69,0,18,0,0,empty,mBC-0814-1
"B5,B3",3550,3826,2505,1321,2320,0,1331,1332,908,424,2.141509434,718,842,615,202,1,201,1,41,0,0,empty,mBC-0814-1
"B5,B4",3930,4238,2794,1444,2455,0,1356,1357,993,364,2.728021978,733,826,619,145,0,145,0,36,0,0,empty,mBC-0814-1
"B5,B5",3183,2138,1352,786,1524,0,833,836,592,244,2.426229508,471,1647,723,213,1,212,1,60,0,0.061320755,empty,mBC-0814-1
"B5,B6",3820,4201,2747,1454,2397,1,1293,1298,958,340,2.817647059,693,1184,808,263,0,263,0,53,0,0.068441065,empty,mBC-0814-1
"B5,B7",4981,5367,3586,1781,3087,0,1677,1681,1224,457,2.67833698,895,1033,744,229,0,229,0,46,0,0,empty,mBC-0814-1
"B5,B8",3358,3634,2436,1198,2135,0,1110,1115,752,363,2.071625344,568,3254,1464,465,0,465,0,71,0,0.034408602,empty,mBC-0814-1
"B5,B9",4293,4674,3009,1665,2686,0,1513,1517,1111,406,2.736453202,815,557,438,127,0,127,0,51,0,0,empty,mBC-0814-1
"B5,B10",3750,4051,2624,1427,2498,0,1380,1391,955,436,2.190366972,751,194,82,43,1,42,1,12,0,0.071428571,empty,mBC-0814-1
"B5,B11",5750,6102,4164,1938,3571,0,1899,1904,1349,555,2.430630631,992,35,23,13,0,13,0,8,0,0,empty,mBC-0814-1
"B5,B12",345560,389175,232139,157036,234716,1,145337,145479,116599,28880,4.037361496,85887,9763,6750,1890,4,1886,1,286,0,0,mm10,mBC-0814-1
"B5,C1",5168,5459,3701,1758,3099,0,1658,1660,1204,456,2.640350877,825,10688,2579,819,0,819,0,90,0,0.076923077,empty,mBC-0814-1
"B5,C2",4685,4986,3276,1710,2873,0,1536,1537,1089,448,2.430803571,860,927,675,243,2,241,1,75,0,0,empty,mBC-0814-1
"B5,C3",5170,5623,3762,1861,3277,0,1782,1786,1232,554,2.223826715,926,846,665,221,0,221,0,44,0,0.036199095,empty,mBC-0814-1
"B5,C4",498130,560571,335705,224866,330553,1,199307,199551,167481,32070,5.222357343,115952,253890,167262,47715,32,47683,3,2588,0,0.004068536,mm10,mBC-0814-1
"B5,C5",6882,7388,4860,2528,4300,0,2357,2357,1791,566,3.164310954,1301,1514,1118,298,0,298,0,76,0,0,empty,mBC-0814-1
"B5,C6",578542,655187,387187,268000,393721,2,246060,246390,195767,50623,3.867155246,145099,39573,26216,7739,8,7731,1,803,0,0.005562023,mm10,mBC-0814-1
"B5,C7",6170,6590,4419,2171,3760,0,2001,2001,1453,548,2.651459854,1028,411,296,107,0,107,0,16,0,0,empty,mBC-0814-1
"B5,C8",4967,5484,3514,1970,3179,0,1725,1725,1255,470,2.670212766,965,1422,1025,288,0,288,0,69,0,0,empty,mBC-0814-1
"B5,C9",3925,4267,2770,1497,2527,0,1387,1390,990,400,2.475,795,1141,859,221,0,221,0,48,0,0.018099548,empty,mBC-0814-1
"B5,C10",4908,5230,3602,1628,3044,0,1622,1622,1201,421,2.852731591,855,1173,839,260,0,260,0,49,0,0.011538462,empty,mBC-0814-1
"B5,C11",4211,4723,2973,1750,2794,0,1595,1601,1119,482,2.321576763,903,1354,1052,271,0,271,0,54,0,0.029520295,empty,mBC-0814-1
"B5,C12",7353,8140,5184,2956,4651,0,2537,2538,1846,692,2.667630058,1412,4826,2017,579,0,579,0,102,0,0.044905009,empty,mBC-0814-1
"B5,D1",443746,484095,300232,183863,288028,0,172899,173115,144305,28810,5.008851093,98697,8739,6401,1768,2,1766,1,257,0,0,mm10,mBC-0814-1
"B5,D2",4754,4973,3407,1566,2800,0,1442,1442,1041,401,2.596009975,726,1383,1050,329,0,329,0,59,0,0.045592705,empty,mBC-0814-1
"B5,D3",559857,640492,376270,264222,374327,1,225217,225516,198937,26579,7.484743595,132734,316130,223599,62543,44,62499,3,3066,0,0.000272004,mm10,mBC-0814-1
"B5,D4",4080,4383,2967,1416,2587,0,1431,1431,990,441,2.244897959,756,1264,814,219,0,219,0,59,0,0,empty,mBC-0814-1
"B5,D5",3905,4396,2716,1680,2548,0,1369,1369,956,413,2.314769976,776,1567,1054,337,0,337,0,92,0,0,empty,mBC-0814-1
"B5,D6",4409,4825,3175,1650,2765,0,1488,1490,1108,382,2.90052356,805,1152,778,206,0,206,0,42,0,0,empty,mBC-0814-1
"B5,D7",4999,5190,3642,1548,3084,1,1626,1627,1201,426,2.819248826,823,1945,1339,401,1,400,1,90,0,0,empty,mBC-0814-1
"B5,D8",549744,625523,369909,255614,367845,0,229502,229745,181972,47773,3.809097189,135223,35689,23347,6700,5,6695,2,693,0,0.024346527,mm10,mBC-0814-1
"B5,D9",2875,3110,2028,1082,1780,0,971,979,669,310,2.158064516,512,1412,962,308,0,308,0,55,0,0.022727273,empty,mBC-0814-1
"B5,D10",3427,3944,2420,1524,2290,0,1305,1307,944,363,2.600550964,728,572,396,124,0,124,0,32,0,0,empty,mBC-0814-1
"B5,D11",3899,4165,2833,1332,2455,1,1334,1336,974,362,2.690607735,693,1631,1134,328,0,328,0,87,0,0.00304878,empty,mBC-0814-1
"B5,D12",402544,461478,268532,192946,275846,1,174320,174522,132417,42105,3.144923406,104379,30916,20678,5997,4,5993,1,623,0,0.002669781,mm10,mBC-0814-1
"B5,E1",4419,4559,3144,1415,2589,0,1350,1352,931,421,2.211401425,671,1080,736,249,0,249,0,57,0,0.016064257,empty,mBC-0814-1
"B5,E2",3352,3649,2398,1251,2134,0,1172,1172,846,326,2.595092025,637,1633,1176,324,0,324,0,70,0,0,empty,mBC-0814-1
"B5,E3",3195,3456,2346,1110,1964,0,1029,1030,702,328,2.140243902,512,1002,716,230,0,230,0,61,0,0,empty,mBC-0814-1
"B5,E4",2644,2820,1876,944,1692,1,957,959,701,258,2.717054264,514,1165,837,241,0,241,0,55,0,0,empty,mBC-0814-1
"B5,E5",3251,3471,2309,1162,1958,3,1032,1039,736,303,2.429042904,519,848,584,164,0,164,0,45,0,0,empty,mBC-0814-1
"B5,E6",3829,4160,2782,1378,2416,6,1271,1279,925,354,2.61299435,642,1184,870,282,0,282,0,61,0,0,empty,mBC-0814-1
"B5,E7",4126,4491,2922,1569,2534,0,1391,1391,989,402,2.460199005,738,905,660,184,0,184,0,34,0,0.005434783,empty,mBC-0814-1
"B5,E8",4131,4368,2998,1370,2623,0,1372,1372,1010,362,2.790055249,707,1613,1119,324,1,323,1,64,0,0,empty,mBC-0814-1
"B5,E9",2757,2994,2009,985,1802,0,1009,1012,729,283,2.575971731,552,1468,1021,306,0,306,0,74,0,0,empty,mBC-0814-1
"B5,E10",3546,3682,2574,1108,2183,0,1169,1171,806,365,2.208219178,576,1193,756,239,0,239,0,78,0,0,empty,mBC-0814-1
"B5,E11",4013,4401,2854,1547,2555,0,1411,1412,1031,381,2.706036745,774,6332,2339,684,3,681,3,93,0,0.038179148,empty,mBC-0814-1
"B5,E12",3476,3804,2520,1284,2264,0,1229,1233,897,336,2.669642857,648,840,565,209,0,209,0,41,0,0,empty,mBC-0814-1
"B5,F1",4163,4432,3009,1423,2538,0,1330,1331,944,387,2.439276486,693,1285,895,319,0,319,0,68,0,0.053291536,empty,mBC-0814-1
"B5,F2",5618,6136,4076,2060,3536,0,1884,1887,1358,529,2.56710775,975,1757,1241,448,0,448,0,104,0,0,empty,mBC-0814-1
"B5,F3",27555,31310,19650,11660,18035,0,10173,10199,8160,2039,4.001961746,5721,14443,10181,2986,2,2984,1,411,0,0.000335121,empty,mBC-0814-1
"B5,F4",4984,5179,3490,1689,3083,0,1677,1682,1211,471,2.571125265,895,479,392,128,0,128,0,24,0,0,empty,mBC-0814-1
"B5,F5",663974,760173,447482,312691,442444,1,274797,275111,213859,61252,3.491461503,162419,133031,95770,27672,18,27654,3,1790,0,0.001482606,mm10,mBC-0814-1
"B5,F6",4682,5199,3325,1874,2928,0,1611,1614,1150,464,2.478448276,872,1629,1140,378,0,378,0,81,0,0.010582011,empty,mBC-0814-1
"B5,F7",4083,4259,2927,1332,2521,0,1343,1345,958,387,2.475452196,692,572,419,132,0,132,0,31,0,0,empty,mBC-0814-1
"B5,F8",5790,6287,4134,2153,3690,0,2007,2011,1399,612,2.285947712,1090,135,107,30,0,30,0,9,0,0,empty,mBC-0814-1
"B5,F9",5052,5243,3576,1667,3018,0,1624,1624,1204,420,2.866666667,813,1601,1079,389,0,389,0,81,0,0.002570694,empty,mBC-0814-1
"B5,F10",5660,6136,4063,2073,3633,0,1939,1939,1399,540,2.590740741,1047,1212,913,279,0,279,0,68,0,0,empty,mBC-0814-1
"B5,F11",3800,4090,2681,1409,2409,0,1326,1328,951,377,2.522546419,692,1654,1160,347,0,347,0,61,0,0.002881844,empty,mBC-0814-1
"B5,F12",4150,4431,2965,1466,2554,0,1409,1416,1006,410,2.453658537,722,172,135,42,0,42,0,10,0,0,empty,mBC-0814-1
"B5,G1",6520,7075,4634,2441,4111,0,2171,2176,1548,628,2.464968153,1183,2664,1895,562,0,562,0,135,0,0.035587189,empty,mBC-0814-1
"B5,G2",5211,5349,3753,1596,3100,0,1583,1589,1140,449,2.538975501,779,1766,732,225,1,224,1,39,0,0.013392857,empty,mBC-0814-1
"B5,G3",449919,527708,295611,232097,310037,0,193995,194183,160514,33669,4.76741216,117512,405132,291578,83498,48,83450,3,3684,0,5.99161E-05,mm10,mBC-0814-1
"B5,G4",4685,5048,3373,1675,2956,0,1553,1553,1079,474,2.276371308,811,19,8,3,0,3,0,2,0,0,empty,mBC-0814-1
"B5,G5",4133,4368,2983,1385,2521,1,1342,1345,960,385,2.493506494,682,5038,1800,609,0,609,0,98,0,0.003284072,empty,mBC-0814-1
"B5,G6",418850,465425,284671,180754,277123,0,167694,167868,135753,32115,4.227090145,97285,1056,756,234,0,234,0,39,0,0.017094017,empty,mBC-0814-1
"B5,G7",4928,5208,3569,1639,3171,0,1666,1668,1189,479,2.482254697,898,1958,1320,348,1,347,1,97,0,0.002881844,empty,mBC-0814-1
"B5,G8",804873,934918,531787,403131,550929,4,352956,353342,279113,74229,3.760161123,212965,314507,224736,64528,34,64494,1,3274,0,0.000573697,mm10,mBC-0814-1
"B5,G9",4745,5209,3337,1872,3107,0,1659,1659,1186,473,2.507399577,927,2246,1433,474,0,474,0,115,0,0,empty,mBC-0814-1
"B5,G10",606688,701806,399352,302454,413132,6,263606,263901,182524,81377,2.242943338,158827,148185,105916,29506,18,29488,1,2040,0,0.000135648,mm10,mBC-0814-1
"B5,G11",8134,8619,5972,2647,5053,0,2619,2622,1911,711,2.687763713,1359,1060,706,219,0,219,0,57,0,0,empty,mBC-0814-1
"B5,G12",4121,4423,2893,1530,2674,0,1488,1488,1070,418,2.559808612,808,1595,1179,368,0,368,0,87,0,0,empty,mBC-0814-1
"B5,H1",4176,4422,2903,1519,2599,0,1434,1436,1042,394,2.644670051,770,10980,3428,1021,1,1020,1,119,0,0.049019608,empty,mBC-0814-1
"B5,H2",7156,7790,5085,2705,4537,0,2474,2476,1709,767,2.228161669,1344,2145,1486,529,0,529,0,130,0,0.003780718,empty,mBC-0814-1
"B5,H3",4792,5421,3323,2098,3195,0,1790,1790,1280,510,2.509803922,1046,1507,824,295,1,294,1,68,0,0.068027211,empty,mBC-0814-1
"B5,H4",4800,5175,3507,1668,2994,0,1603,1605,1151,454,2.535242291,803,21,14,11,0,11,0,10,0,0,empty,mBC-0814-1
"B5,H5",6277,6895,4461,2434,3965,0,2215,2221,1542,679,2.270986745,1217,1709,1213,357,1,356,1,60,0,0,empty,mBC-0814-1
"B5,H6",5956,6375,4305,2070,3808,0,2061,2063,1481,582,2.54467354,1090,1508,1066,379,0,379,0,95,0,0,empty,mBC-0814-1
"B5,H7",4805,5071,3457,1614,2934,0,1545,1550,1091,459,2.376906318,784,2580,1258,420,1,419,1,67,0,0.028639618,empty,mBC-0814-1
"B5,H8",4020,4263,2863,1400,2476,4,1327,1332,974,358,2.720670391,693,1394,1014,341,0,341,0,75,0,0,empty,mBC-0814-1
"B5,H9",4608,5069,3311,1758,2858,0,1489,1489,1018,471,2.161358811,817,1234,855,267,0,267,0,53,0,0,empty,mBC-0814-1
"B5,H10",3137,3541,2186,1355,2014,2,1130,1134,821,313,2.623003195,650,2537,949,302,0,302,0,50,0,0.003311258,empty,mBC-0814-1
"B5,H11",3547,3926,2478,1448,2366,0,1342,1343,944,399,2.365914787,753,47,23,13,0,13,0,5,0,0,empty,mBC-0814-1
"B5,H12",2430,2654,1680,974,1626,0,960,965,676,289,2.339100346,528,1135,751,247,0,247,0,66,0,0,empty,mBC-0814-1
"B6,A1",413914,494222,271880,222342,295986,1,190312,190531,158367,32164,4.92373461,117066,107312,72800,20561,18,20543,2,1594,0,0.000778854,mm10,mBC-0814-1
"B6,A2",486010,526396,331058,195338,308673,1,179920,180159,144325,35834,4.027599487,101560,115237,83802,24740,9,24731,2,1734,0,0,mm10,mBC-0814-1
"B6,A3",3897,4274,2787,1487,2540,0,1386,1386,970,416,2.331730769,771,481,287,114,0,114,0,24,0,0,empty,mBC-0814-1
"B6,A4",4860,5124,3511,1613,2936,0,1570,1570,1123,447,2.512304251,813,472,315,99,0,99,0,15,0,0,empty,mBC-0814-1
"B6,A5",3795,3983,2698,1285,2378,0,1334,1339,919,420,2.188095238,692,980,657,198,0,198,0,36,0,0,empty,mBC-0814-1
"B6,A6",3090,3312,2322,990,1877,0,1010,1010,729,281,2.59430605,469,1099,720,218,0,218,0,41,0,0.004587156,empty,mBC-0814-1
"B6,A7",4474,4860,3198,1662,2774,0,1512,1512,1074,438,2.452054795,819,989,707,203,0,203,0,42,0,0,empty,mBC-0814-1
"B6,A8",1771,1947,1256,691,1187,0,693,693,481,212,2.268867925,375,1096,787,173,0,173,0,32,0,0,empty,mBC-0814-1
"B6,A9",5438,5707,3851,1856,3366,0,1810,1811,1299,512,2.537109375,981,842,560,191,0,191,0,44,0,0,empty,mBC-0814-1
"B6,A10",2777,3095,1940,1155,1837,2,1040,1042,701,341,2.055718475,593,86,65,24,0,24,0,6,0,0,empty,mBC-0814-1
"B6,A11",3637,3786,2663,1123,2232,0,1169,1171,831,340,2.444117647,589,1630,1195,362,0,362,0,66,0,0,empty,mBC-0814-1
"B6,A12",2977,3220,2102,1118,1879,0,1039,1039,768,271,2.833948339,583,2392,1765,587,1,586,1,124,0,0,empty,mBC-0814-1
"B6,B1",3656,4095,2589,1506,2366,0,1273,1273,865,408,2.120098039,699,700,489,183,0,183,0,39,0,0.027322404,empty,mBC-0814-1
"B6,B2",4102,4346,2899,1447,2525,0,1355,1356,943,413,2.283292978,752,269,221,61,0,61,0,16,0,0,empty,mBC-0814-1
"B6,B3",3094,3323,2157,1166,1975,0,1087,1087,765,322,2.375776398,577,701,532,140,0,140,0,38,0,0.035714286,empty,mBC-0814-1
"B6,B4",3441,3595,2511,1084,2198,0,1200,1202,901,301,2.993355482,600,1172,707,198,2,196,1,44,0,0.030612245,empty,mBC-0814-1
"B6,B5",2890,1964,1292,672,1355,6,725,736,537,199,2.698492462,439,1484,758,239,0,239,0,42,0,0.033472803,empty,mBC-0814-1
"B6,B6",3045,3239,2208,1031,1899,0,1061,1063,747,316,2.363924051,524,842,660,201,0,201,0,37,0,0.059701493,empty,mBC-0814-1
"B6,B7",4224,4574,3094,1480,2710,0,1462,1467,1035,432,2.395833333,773,623,444,143,1,142,1,33,0,0,empty,mBC-0814-1
"B6,B8",3110,3345,2302,1043,1951,0,1006,1010,727,283,2.568904594,525,679,487,122,0,122,0,36,0,0,empty,mBC-0814-1
"B6,B9",3720,4072,2721,1351,2335,0,1261,1266,905,361,2.506925208,663,493,374,118,0,118,0,35,0,0,empty,mBC-0814-1
"B6,B10",3508,3750,2472,1278,2249,0,1246,1247,866,381,2.272965879,642,307,196,69,0,69,0,18,0,0,empty,mBC-0814-1
"B6,B11",5812,6410,4177,2233,3667,0,1985,1992,1389,603,2.303482587,1056,86,69,24,0,24,0,7,0,0,empty,mBC-0814-1
"B6,B12",4276,4517,3013,1504,2726,0,1445,1445,1050,395,2.658227848,790,6735,2318,686,6,680,2,88,0,0.014705882,empty,mBC-0814-1
"B6,C1",4707,4864,3421,1443,2948,0,1518,1518,1102,416,2.649038462,759,408,288,88,0,88,0,17,0,0,empty,mBC-0814-1
"B6,C2",4587,4642,3232,1410,2699,0,1438,1441,1010,431,2.343387471,736,1001,656,188,0,188,0,54,0,0,empty,mBC-0814-1
"B6,C3",5050,5567,3621,1946,3188,3,1743,1747,1212,535,2.265420561,953,469,360,120,0,120,0,24,0,0,empty,mBC-0814-1
"B6,C4",3851,4075,2782,1293,2417,0,1234,1234,874,360,2.427777778,645,923,693,207,0,207,0,49,0,0,empty,mBC-0814-1
"B6,C5",5550,6016,4016,2000,3585,0,1917,1917,1358,559,2.429338104,1036,797,509,166,0,166,0,40,0,0,empty,mBC-0814-1
"B6,C6",4456,4821,3134,1687,2849,0,1588,1588,1152,436,2.642201835,840,1079,856,293,0,293,0,48,0,0.051194539,empty,mBC-0814-1
"B6,C7",5877,6496,4267,2229,3750,0,2025,2028,1395,633,2.203791469,1095,353,239,48,0,48,0,12,0,0,empty,mBC-0814-1
"B6,C8",4667,5018,3285,1733,2857,0,1540,1543,1126,417,2.700239808,810,1104,697,181,0,181,0,50,0,0.011049724,empty,mBC-0814-1
"B6,C9",3689,3891,2703,1188,2251,0,1203,1205,862,343,2.513119534,592,657,484,145,0,145,0,36,0,0,empty,mBC-0814-1
"B6,C10",4750,4974,3441,1533,2860,0,1516,1516,1108,408,2.715686275,758,862,649,205,0,205,0,30,0,0.141463415,empty,mBC-0814-1
"B6,C11",3897,4209,2768,1441,2466,0,1348,1355,957,398,2.404522613,707,1207,840,219,0,219,0,37,0,0,empty,mBC-0814-1
"B6,C12",6910,7374,4934,2440,4199,0,2243,2248,1595,653,2.442572741,1189,1154,888,261,0,261,0,60,0,0,empty,mBC-0814-1
"B6,D1",3474,3785,2430,1355,2228,0,1211,1216,874,342,2.555555556,676,561,444,135,0,135,0,21,0,0,empty,mBC-0814-1
"B6,D2",4754,4844,3269,1575,2776,0,1516,1516,1084,432,2.509259259,762,31997,9812,3206,4,3202,1,276,0,0.153029357,empty,mBC-0814-1
"B6,D3",8942,9460,6305,3155,5462,0,2928,2935,2039,896,2.275669643,1563,1858,1346,401,0,401,0,66,0,0,empty,mBC-0814-1
"B6,D4",3976,4281,2756,1525,2510,0,1391,1393,988,405,2.439506173,746,542,344,141,0,141,0,40,0,0,empty,mBC-0814-1
"B6,D5",4139,4459,2873,1586,2704,0,1506,1514,1167,347,3.363112392,858,1904,1262,361,0,361,0,80,0,0,empty,mBC-0814-1
"B6,D6",4133,4410,2962,1448,2628,0,1417,1420,1042,378,2.756613757,733,1052,731,208,0,208,0,32,0,0.115384615,empty,mBC-0814-1
"B6,D7",4634,4988,3277,1711,2864,0,1536,1541,1128,413,2.731234867,847,1833,1225,334,0,334,0,71,0,0,empty,mBC-0814-1
"B6,D8",3832,4106,2744,1362,2459,0,1326,1326,933,393,2.374045802,704,480,298,65,0,65,0,21,0,0,empty,mBC-0814-1
"B6,D9",2370,2615,1704,911,1579,0,861,864,591,273,2.164835165,468,810,574,163,0,163,0,30,0,0.036809816,empty,mBC-0814-1
"B6,D10",3010,3359,2199,1160,2005,0,1093,1093,795,298,2.667785235,613,547,417,121,0,121,0,27,0,0,empty,mBC-0814-1
"B6,D11",3397,3765,2430,1335,2213,0,1180,1180,891,289,3.083044983,643,1071,697,240,0,240,0,58,0,0,empty,mBC-0814-1
"B6,D12",5432,5712,3826,1886,3399,0,1830,1833,1238,595,2.080672269,987,1740,1303,340,0,340,0,62,0,0,empty,mBC-0814-1
"B6,E1",4412,4474,3044,1430,2639,0,1368,1369,991,378,2.621693122,723,11010,3453,1004,2,1002,2,106,0,0.082834331,empty,mBC-0814-1
"B6,E2",341053,396660,228523,168137,236031,1,145268,145458,115956,29502,3.930445394,86654,253197,183167,52075,49,52026,3,2699,0,5.76635E-05,mm10,mBC-0814-1
"B6,E3",2983,3214,2253,961,1918,0,990,991,720,271,2.656826568,523,508,355,104,0,104,0,33,0,0,empty,mBC-0814-1
"B6,E4",2729,2985,1908,1077,1664,0,956,958,697,261,2.670498084,503,795,592,181,0,181,0,26,0,0.049723757,empty,mBC-0814-1
"B6,E5",390740,442573,267055,175518,261099,0,161436,161620,126694,34926,3.627498139,93747,12250,8380,2415,0,2415,0,311,0,0,mm10,mBC-0814-1
"B6,E6",3830,4075,2717,1358,2328,0,1236,1238,893,345,2.588405797,661,1012,752,196,0,196,0,41,0,0,empty,mBC-0814-1
"B6,E7",3869,4132,2746,1386,2354,0,1230,1230,891,339,2.628318584,667,929,645,190,0,190,0,36,0,0,empty,mBC-0814-1
"B6,E8",4058,4220,3008,1212,2403,2,1177,1179,864,315,2.742857143,574,1697,1175,333,0,333,0,52,0,0,empty,mBC-0814-1
"B6,E9",2523,2831,1751,1080,1595,0,893,893,619,274,2.259124088,486,1172,811,257,0,257,0,41,0,0,empty,mBC-0814-1
"B6,E10",3274,3577,2366,1211,2085,0,1169,1170,837,333,2.513513514,604,1446,994,278,0,278,0,57,0,0,empty,mBC-0814-1
"B6,E11",3486,3634,2551,1083,2184,0,1121,1127,796,331,2.404833837,593,1219,843,219,0,219,0,47,0,0,empty,mBC-0814-1
"B6,E12",3187,3468,2158,1310,1977,0,1120,1121,786,335,2.346268657,603,9441,3472,1085,3,1082,1,115,0,0.176524954,empty,mBC-0814-1
"B6,F1",3767,3994,2707,1287,2384,0,1209,1211,858,353,2.430594901,629,1858,974,291,1,290,1,56,0,0.044827586,empty,mBC-0814-1
"B6,F2",5356,5640,3904,1736,3341,0,1749,1751,1274,477,2.670859539,893,1946,1320,379,0,379,0,65,0,0.047493404,empty,mBC-0814-1
"B6,F3",4068,4342,2910,1432,2557,1,1431,1433,1003,430,2.33255814,742,946,637,185,0,185,0,41,0,0,empty,mBC-0814-1
"B6,F4",4236,4462,3017,1445,2726,0,1457,1460,1049,411,2.552311436,794,187,120,22,0,22,0,13,0,0,empty,mBC-0814-1
"B6,F5",4439,4848,3254,1594,2766,0,1496,1502,1031,471,2.18895966,770,992,745,231,0,231,0,39,0,0,empty,mBC-0814-1
"B6,F6",3791,4131,2691,1440,2439,0,1295,1298,948,350,2.708571429,726,1092,775,253,0,253,0,56,0,0,empty,mBC-0814-1
"B6,F7",3775,4156,2762,1394,2397,0,1294,1297,908,389,2.334190231,658,574,329,75,0,75,0,20,0,0,empty,mBC-0814-1
"B6,F8",5817,6114,4235,1879,3569,0,1841,1848,1338,510,2.623529412,949,170,91,32,0,32,0,7,0,0,empty,mBC-0814-1
"B6,F9",4812,5161,3417,1744,2980,0,1641,1645,1156,489,2.36400818,894,1207,703,224,0,224,0,51,0,0.09375,empty,mBC-0814-1
"B6,F10",5568,5826,3995,1831,3359,0,1721,1724,1204,520,2.315384615,907,1043,687,192,0,192,0,47,0,0,empty,mBC-0814-1
"B6,F11",3479,3747,2491,1256,2229,0,1204,1210,882,328,2.68902439,647,1276,784,237,0,237,0,37,0,0.004219409,empty,mBC-0814-1
"B6,F12",4038,4305,2851,1454,2505,1,1370,1373,978,395,2.475949367,765,77,60,21,0,21,0,6,0,0,empty,mBC-0814-1
"B6,G1",151807,171074,91391,79683,102041,0,67616,67695,43989,23706,1.855606176,42079,31658,22823,6345,4,6341,1,607,0,0.001419334,mm10,mBC-0814-1
"B6,G2",4832,5193,3467,1726,2916,0,1523,1534,1068,466,2.291845494,785,283,136,55,0,55,0,14,0,0,empty,mBC-0814-1
"B6,G3",4116,4545,2922,1623,2583,0,1427,1427,1016,411,2.472019465,783,1399,933,315,0,315,0,70,0,0,empty,mBC-0814-1
"B6,G4",4683,4823,3323,1500,2835,0,1475,1482,1083,399,2.714285714,774,30,1,0,0,0,0,0,0,0,empty,mBC-0814-1
"B6,G5",3635,3867,2659,1208,2231,0,1185,1190,838,352,2.380681818,587,1028,674,177,0,177,0,42,0,0,empty,mBC-0814-1
"B6,G6",443582,513605,297211,216394,304365,1,192396,192608,130126,62482,2.082615793,115240,2772,1757,573,0,573,0,79,0,0,empty,mBC-0814-1
"B6,G7",4338,4667,3095,1572,2849,0,1538,1538,1097,441,2.487528345,885,8365,2709,828,2,826,1,102,0,0.11622276,empty,mBC-0814-1
"B6,G8",5683,6151,3986,2165,3587,0,1985,1985,1352,633,2.135860979,1093,2837,2003,557,1,556,1,95,0,0.001798561,empty,mBC-0814-1
"B6,G9",784689,922132,510511,411621,544917,2,355663,356063,279975,76088,3.679620965,217427,307891,220259,63168,34,63134,6,3234,0,0.000649412,mm10,mBC-0814-1
"B6,G10",7609,8190,5451,2739,4795,0,2519,2523,1813,710,2.553521127,1341,1690,1171,345,1,344,1,87,0,0.00872093,empty,mBC-0814-1
"B6,G11",7515,7864,5397,2467,4661,0,2473,2476,1722,754,2.283819629,1291,868,648,201,0,201,0,50,0,0,empty,mBC-0814-1
"B6,G12",3759,4184,2684,1500,2487,0,1346,1348,987,361,2.734072022,738,2371,1294,402,1,401,1,77,0,0.074812968,empty,mBC-0814-1
"B6,H1",3812,3988,2744,1244,2357,0,1265,1265,903,362,2.494475138,634,610,469,132,0,132,0,26,0,0.068181818,empty,mBC-0814-1
"B6,H2",10338,11040,7420,3620,6318,0,3350,3352,2394,958,2.498956159,1747,6003,4507,1294,0,1294,0,184,0,0.002318393,empty,mBC-0814-1
"B6,H3",482803,542405,322398,220007,319942,1,197321,197533,154178,43355,3.556175758,115781,71455,49640,13413,6,13407,1,1174,0,0.000447527,mm10,mBC-0814-1
"B6,H4",4320,4672,3040,1632,2712,0,1509,1514,1080,434,2.488479263,801,66,44,28,1,27,1,5,0,0,empty,mBC-0814-1
"B6,H5",5865,6368,4179,2189,3623,14,1959,1978,1412,566,2.494699647,1047,1468,1013,333,0,333,0,58,0,0,empty,mBC-0814-1
"B6,H6",5101,5482,3634,1848,3178,0,1722,1725,1229,496,2.477822581,897,4131,1921,573,0,573,0,101,0,0,empty,mBC-0814-1
"B6,H7",4353,4645,3057,1588,2818,5,1510,1515,1071,444,2.412162162,808,1214,826,229,0,229,0,41,0,0,empty,mBC-0814-1
"B6,H8",3579,3988,2511,1477,2342,0,1318,1320,944,376,2.510638298,722,1223,878,302,0,302,0,65,0,0,empty,mBC-0814-1
"B6,H9",3792,3931,2689,1242,2252,0,1172,1172,849,323,2.628482972,609,677,478,164,0,164,0,42,0,0,empty,mBC-0814-1
"B6,H10",2903,3141,2085,1056,1775,2,958,966,691,275,2.512727273,515,424,282,82,0,82,0,17,0,0,empty,mBC-0814-1
"B6,H11",314208,365215,208407,156808,218085,1,136545,136692,112718,23974,4.701676817,82134,2324,1631,491,0,491,0,67,0,0,empty,mBC-0814-1
"B6,H12",1925,1944,1372,572,1171,0,626,627,453,174,2.603448276,296,650,452,133,0,133,0,32,0,0,empty,mBC-0814-1
"B7,A1",5679,6204,4138,2066,3565,0,1975,1976,1420,556,2.553956835,1051,1325,939,251,0,251,0,50,0,0,empty,mBC-0814-1
"B7,A2",6101,6555,4368,2187,3738,0,1996,1998,1476,522,2.827586207,1079,1334,961,286,0,286,0,56,0,0,empty,mBC-0814-1
"B7,A3",5197,5723,3634,2089,3241,0,1767,1768,1295,473,2.737843552,1008,5379,1749,591,0,591,0,78,0,0.060913706,empty,mBC-0814-1
"B7,A4",5658,6071,3993,2078,3423,0,1848,1853,1335,518,2.577220077,1008,210,110,26,0,26,0,13,0,0,empty,mBC-0814-1
"B7,A5",5034,5307,3660,1647,3082,0,1634,1635,1208,427,2.829039813,849,1022,580,183,0,183,0,43,0,0.191256831,empty,mBC-0814-1
"B7,A6",4124,4453,2995,1458,2557,0,1386,1388,1006,382,2.633507853,734,1062,650,199,0,199,0,41,0,0.005025126,empty,mBC-0814-1
"B7,A7",5692,5981,4213,1768,3545,0,1912,1915,1333,582,2.290378007,971,1351,1038,300,1,299,1,69,0,0.003344482,empty,mBC-0814-1
"B7,A8",2364,2514,1633,881,1510,0,851,852,580,272,2.132352941,477,748,472,152,0,152,0,46,0,0,empty,mBC-0814-1
"B7,A9",6679,7124,4899,2225,3968,0,2059,2059,1463,596,2.454697987,1065,1434,1049,295,0,295,0,37,0,0,empty,mBC-0814-1
"B7,A10",3732,4105,2679,1426,2393,0,1324,1326,928,398,2.331658291,740,78,44,16,0,16,0,11,0,0,empty,mBC-0814-1
"B7,A11",5332,5646,3750,1896,3259,0,1746,1746,1239,507,2.443786982,942,24648,7810,2462,9,2453,3,280,0,0.038728088,empty,mBC-0814-1
"B7,A12",5021,5315,3560,1755,3055,0,1661,1663,1243,420,2.95952381,869,1800,1171,400,0,400,0,96,0,0.0025,empty,mBC-0814-1
"B7,B1",4776,5066,3408,1658,2980,0,1621,1623,1154,469,2.460554371,852,1246,821,238,0,238,0,48,0,0.058823529,empty,mBC-0814-1
"B7,B2",4743,5271,3243,2028,3069,0,1681,1684,1169,515,2.269902913,981,486,349,103,0,103,0,22,0,0,empty,mBC-0814-1
"B7,B3",4738,5004,3358,1646,2882,0,1594,1594,1187,407,2.916461916,826,959,519,163,0,163,0,48,0,0.061349693,empty,mBC-0814-1
"B7,B4",517108,609803,337528,272275,353486,1,228683,228936,171876,57060,3.012197687,140251,92990,66141,19447,9,19438,1,1470,0,0.001234695,mm10,mBC-0814-1
"B7,B5",3736,2585,1570,1015,1789,0,1021,1027,731,296,2.469594595,625,899,658,188,0,188,0,41,0,0,empty,mBC-0814-1
"B7,B6",4293,4644,3075,1569,2668,0,1474,1475,1068,407,2.624078624,789,627,384,147,0,147,0,32,0,0,empty,mBC-0814-1
"B7,B7",4957,5351,3622,1729,3032,0,1602,1602,1162,440,2.640909091,815,722,495,157,0,157,0,38,0,0,empty,mBC-0814-1
"B7,B8",3783,4092,2695,1397,2335,1,1246,1247,884,363,2.435261708,667,924,671,157,0,157,0,30,0,0,empty,mBC-0814-1
"B7,B9",5115,5757,3599,2158,3260,0,1803,1809,1310,499,2.625250501,1044,656,477,126,0,126,0,40,0,0,empty,mBC-0814-1
"B7,B10",4597,4851,3273,1578,2892,0,1545,1550,1097,453,2.421633554,814,769,621,124,0,124,0,26,0,0.008064516,empty,mBC-0814-1
"B7,B11",9752,10868,6846,4022,6241,0,3572,3580,2723,857,3.177362894,2018,78,47,16,0,16,0,7,0,0,empty,mBC-0814-1
"B7,B12",508585,604170,337652,266518,349370,1,220326,220579,179049,41530,4.31131712,134188,114166,79139,22091,13,22078,2,1665,0,0.000634115,mm10,mBC-0814-1
"B7,C1",5799,6256,4236,2020,3517,0,1863,1865,1321,544,2.428308824,984,574,381,117,0,117,0,28,0,0,empty,mBC-0814-1
"B7,C2",5465,5882,3997,1885,3406,0,1838,1842,1318,524,2.515267176,919,1225,838,267,0,267,0,69,0,0.071161049,empty,mBC-0814-1
"B7,C3",5978,6429,4221,2208,3695,0,1991,1993,1390,603,2.305140962,1091,513,389,105,2,103,1,22,0,0.145631068,empty,mBC-0814-1
"B7,C4",5549,5978,3986,1992,3447,0,1903,1906,1380,526,2.623574144,1017,1095,766,215,0,215,0,48,0,0,empty,mBC-0814-1
"B7,C5",7066,7576,5013,2563,4356,0,2305,2307,1689,618,2.733009709,1248,949,655,230,0,230,0,51,0,0,empty,mBC-0814-1
"B7,C6",5538,5869,3956,1913,3453,0,1870,1874,1382,492,2.808943089,961,993,702,248,0,248,0,49,0,0,empty,mBC-0814-1
"B7,C7",710791,832798,477995,354803,473187,1,298239,298574,228238,70336,3.244967015,178887,25889,18452,5253,4,5249,1,597,0,0,mm10,mBC-0814-1
"B7,C8",5847,6211,4268,1943,3597,0,1967,1968,1336,632,2.113924051,1006,1471,1076,297,1,296,1,51,0,0,empty,mBC-0814-1
"B7,C9",5520,6062,3918,2144,3461,0,1962,1962,1220,742,1.644204852,1103,5127,1702,493,3,490,2,76,0,0.008163265,empty,mBC-0814-1
"B7,C10",5586,6008,4063,1945,3367,0,1796,1796,1289,507,2.542406312,953,1007,651,179,0,179,0,43,0,0,empty,mBC-0814-1
"B7,C11",4974,5549,3527,2022,3095,0,1677,1682,1266,416,3.043269231,953,669,461,136,0,136,0,37,0,0,empty,mBC-0814-1
"B7,C12",8909,9741,6472,3269,5465,0,2993,2997,2177,820,2.654878049,1603,2120,1482,352,0,352,0,61,0,0,empty,mBC-0814-1
"B7,D1",4846,5182,3472,1710,3017,0,1624,1636,1176,460,2.556521739,875,447,331,113,0,113,0,23,0,0,empty,mBC-0814-1
"B7,D2",5064,5208,3780,1428,2988,0,1499,1499,1082,417,2.594724221,720,866,627,196,0,196,0,51,0,0,empty,mBC-0814-1
"B7,D3",11472,12537,8158,4379,7195,0,3944,3953,2718,1235,2.200809717,2195,1572,1073,301,0,301,0,60,0,0,empty,mBC-0814-1
"B7,D4",7000,7735,4936,2799,4493,0,2583,2590,1881,709,2.65303244,1453,721,525,173,0,173,0,41,0,0,empty,mBC-0814-1
"B7,D5",5258,5795,3739,2056,3264,0,1820,1823,1336,487,2.743326489,961,1539,1041,327,0,327,0,82,0,0.01529052,empty,mBC-0814-1
"B7,D6",4794,5167,3555,1612,2956,0,1571,1573,1145,428,2.675233645,814,1152,792,227,0,227,0,41,0,0.013215859,empty,mBC-0814-1
"B7,D7",6608,7220,4626,2594,4156,0,2303,2306,1485,821,1.808769793,1307,2139,1373,438,0,438,0,82,0,0,empty,mBC-0814-1
"B7,D8",5265,5729,3793,1936,3256,0,1759,1761,1237,524,2.360687023,957,1411,1055,237,0,237,0,34,0,0,empty,mBC-0814-1
"B7,D9",3495,3680,2449,1231,2113,0,1172,1178,865,313,2.763578275,634,1415,878,200,0,200,0,42,0,0,empty,mBC-0814-1
"B7,D10",4317,4770,3143,1627,2736,0,1500,1502,1057,445,2.375280899,814,465,242,89,2,87,1,30,0,0,empty,mBC-0814-1
"B7,D11",4591,4914,3270,1644,2838,0,1558,1560,1136,424,2.679245283,818,1465,1105,300,0,300,0,81,0,0.08,empty,mBC-0814-1
"B7,D12",6698,7296,4750,2546,4153,0,2261,2272,1569,703,2.231863442,1249,2361,1808,516,0,516,0,93,0,0.013565891,empty,mBC-0814-1
"B7,E1",5153,5313,3749,1564,3025,0,1575,1581,1090,491,2.219959267,793,1132,799,239,0,239,0,44,0,0.008368201,empty,mBC-0814-1
"B7,E2",3905,4181,2832,1349,2410,0,1267,1273,904,369,2.449864499,634,985,666,183,0,183,0,41,0,0.010928962,empty,mBC-0814-1
"B7,E3",3368,3615,2428,1187,2062,0,1067,1072,778,294,2.646258503,548,741,530,176,0,176,0,31,0,0.051136364,empty,mBC-0814-1
"B7,E4",3155,3428,2282,1146,1983,1,1056,1057,762,295,2.583050847,558,900,655,190,0,190,0,40,0,0.021052632,empty,mBC-0814-1
"B7,E5",3556,3793,2593,1200,2206,0,1184,1184,871,313,2.782747604,612,911,690,173,1,172,1,34,0,0,empty,mBC-0814-1
"B7,E6",4570,4703,3311,1392,2714,0,1427,1427,1053,374,2.815508021,715,1043,737,188,0,188,0,40,0,0,empty,mBC-0814-1
"B7,E7",4503,4935,3257,1678,2793,0,1500,1502,1080,422,2.559241706,820,725,558,165,0,165,0,43,0,0.006060606,empty,mBC-0814-1
"B7,E8",4684,4905,3462,1443,2905,2,1515,1518,1106,412,2.684466019,776,1284,869,294,0,294,0,57,0,0.010204082,empty,mBC-0814-1
"B7,E9",3670,3911,2603,1308,2188,0,1169,1169,833,336,2.479166667,608,1083,640,199,0,199,0,46,0,0,empty,mBC-0814-1
"B7,E10",4320,4676,3121,1555,2701,0,1471,1473,1021,452,2.258849558,796,1514,963,303,0,303,0,55,0,0,empty,mBC-0814-1
"B7,E11",4496,4868,3239,1629,2786,0,1524,1526,1084,442,2.452488688,800,1091,766,207,0,207,0,44,0,0,empty,mBC-0814-1
"B7,E12",4223,4638,3037,1601,2642,0,1446,1450,1065,385,2.766233766,755,1048,762,222,0,222,0,40,0,0,empty,mBC-0814-1
"B7,F1",726822,836809,491759,345050,473518,1,288142,288459,245017,43442,5.640094839,169009,287753,206644,55356,28,55328,1,3006,0,5.42221E-05,mm10,mBC-0814-1
"B7,F2",6559,7048,4655,2393,3995,0,2167,2167,1619,548,2.954379562,1175,1324,903,258,0,258,0,66,0,0,empty,mBC-0814-1
"B7,F3",5285,5764,3658,2106,3386,2,1866,1872,1385,487,2.843942505,1076,7476,2236,742,1,741,1,102,0,0,empty,mBC-0814-1
"B7,F4",5864,6436,4187,2249,3593,1,1895,1898,1397,501,2.788423154,1045,420,280,69,0,69,0,17,0,0,empty,mBC-0814-1
"B7,F5",5660,5920,4254,1666,3323,0,1746,1750,1190,560,2.125,859,875,630,192,0,192,0,41,0,0,empty,mBC-0814-1
"B7,F6",5412,5863,3883,1980,3362,0,1851,1854,1360,494,2.753036437,1001,1766,1309,409,0,409,0,78,0,0.014669927,empty,mBC-0814-1
"B7,F7",4509,4631,3248,1383,2780,0,1463,1466,1075,391,2.749360614,763,332,198,80,0,80,0,20,0,0,empty,mBC-0814-1
"B7,F8",554282,638949,369320,269629,368111,1,230027,230290,188417,41873,4.49972536,137498,8798,6307,1793,1,1792,1,215,0,0,mm10,mBC-0814-1
"B7,F9",5693,6094,4106,1988,3544,0,1883,1890,1389,501,2.77245509,1019,1260,877,278,0,278,0,67,0,0.025179856,empty,mBC-0814-1
"B7,F10",6387,6926,4670,2256,3961,6,2139,2145,1530,615,2.487804878,1138,1060,671,191,0,191,0,36,0,0,empty,mBC-0814-1
"B7,F11",396517,460262,260196,200066,268400,0,173988,174173,113725,60448,1.881369111,105417,10227,6633,1765,2,1763,2,310,0,0,mm10,mBC-0814-1
"B7,F12",5026,5373,3558,1815,3140,0,1751,1753,1289,464,2.778017241,968,84,60,19,0,19,0,3,0,0,empty,mBC-0814-1
"B7,G1",7697,8250,5492,2758,4668,0,2442,2456,1787,669,2.671150972,1282,2498,1832,601,0,601,0,111,0,0.001663894,empty,mBC-0814-1
"B7,G2",5823,6116,4151,1965,3595,0,1921,1923,1309,614,2.131921824,1016,465,350,62,0,62,0,16,0,0,empty,mBC-0814-1
"B7,G3",5479,6014,3709,2305,3452,0,1939,1943,1370,573,2.390924956,1135,20651,6109,1953,2,1951,1,187,0,0.153767299,empty,mBC-0814-1
"B7,G4",5359,5554,3894,1660,3192,0,1650,1652,1194,458,2.6069869,821,12,2,1,0,1,0,1,0,0,empty,mBC-0814-1
"B7,G5",5067,5350,3632,1718,3105,5,1710,1717,1216,501,2.427145709,899,1421,1075,324,0,324,0,47,0,0.021604938,empty,mBC-0814-1
"B7,G6",9169,10248,6527,3721,5761,0,3130,3139,2199,940,2.339361702,1773,158,107,31,0,31,0,6,0,0,empty,mBC-0814-1
"B7,G7",1139133,1276546,774678,501868,730510,4,445563,446133,354624,91509,3.875290955,258637,282790,207241,59500,38,59462,1,3204,0,0.000605429,mm10,mBC-0814-1
"B7,G8",393289,465962,257379,208583,272475,0,175707,175924,132926,42998,3.091446114,108254,110941,78457,22286,21,22265,4,1648,0,0.002739726,mm10,mBC-0814-1
"B7,G9",5814,6552,4139,2413,3685,0,2084,2088,1525,563,2.708703375,1138,1786,1306,327,2,325,1,74,0,0,empty,mBC-0814-1
"B7,G10",9449,9767,6681,3086,5760,0,3068,3068,2195,873,2.514318442,1596,3114,2196,714,0,714,0,127,0,0.023809524,empty,mBC-0814-1
"B7,G11",10083,10787,7325,3462,6061,0,3193,3197,2318,879,2.6370876,1642,4274,1428,470,1,469,1,70,0,0.0554371,empty,mBC-0814-1
"B7,G12",5087,5580,3546,2034,3154,0,1760,1762,1298,464,2.797413793,987,1484,1082,277,1,276,1,66,0,0,empty,mBC-0814-1
"B7,H1",4653,5056,3309,1747,2831,0,1535,1537,1102,435,2.533333333,809,825,523,81,0,81,0,22,0,0,empty,mBC-0814-1
"B7,H2",8584,9218,6228,2990,5319,0,2891,2899,2116,783,2.702426564,1525,2525,1744,544,0,544,0,108,0,0.007352941,empty,mBC-0814-1
"B7,H3",6239,6804,4522,2282,3824,0,2080,2085,1540,545,2.825688073,1125,1240,620,153,0,153,0,46,0,0,empty,mBC-0814-1
"B7,H4",515398,616864,338636,278228,354024,0,229135,229379,189694,39685,4.77999244,140911,7101,4900,1518,1,1517,1,205,0,0,mm10,mBC-0814-1
"B7,H5",6718,7069,4818,2251,4060,0,2169,2173,1561,612,2.550653595,1135,1163,781,286,1,285,1,55,0,0,empty,mBC-0814-1
"B7,H6",634354,725688,426476,299212,413928,0,253929,254275,206030,48245,4.270494352,150296,211476,154980,44396,23,44373,3,2559,0,0.000247898,mm10,mBC-0814-1
"B7,H7",5550,5832,3920,1912,3389,0,1845,1847,1332,515,2.586407767,980,861,631,172,0,172,0,34,0,0,empty,mBC-0814-1
"B7,H8",4633,5074,3279,1795,2920,0,1594,1594,1217,377,3.228116711,910,1380,910,273,0,273,0,55,0,0.065934066,empty,mBC-0814-1
"B7,H9",5366,5550,3857,1693,3143,0,1669,1673,1218,455,2.676923077,842,1586,1197,328,0,328,0,53,0,0,empty,mBC-0814-1
"B7,H10",3602,3916,2640,1276,2186,0,1188,1189,814,375,2.170666667,614,752,514,170,0,170,0,30,0,0,empty,mBC-0814-1
"B7,H11",4348,4762,3105,1657,2778,3,1547,1556,1121,435,2.577011494,847,111,90,40,0,40,0,7,0,0,empty,mBC-0814-1
"B7,H12",3252,3603,2315,1288,2060,0,1146,1146,838,308,2.720779221,623,1167,875,256,0,256,0,42,0,0,empty,mBC-0814-1
"B8,A1",6006,6603,4227,2376,3838,0,2159,2168,1487,681,2.183553598,1189,7500,2787,910,2,908,2,116,0,0.078193833,empty,mBC-0814-1
"B8,A2",5744,6027,4118,1909,3599,0,1913,1916,1415,501,2.824351297,1020,860,566,178,0,178,0,71,0,0,empty,mBC-0814-1
"B8,A3",4942,5442,3591,1851,3164,0,1735,1739,1234,505,2.443564356,945,695,474,144,0,144,0,47,0,0.076388889,empty,mBC-0814-1
"B8,A4",5477,5877,3977,1900,3447,0,1838,1838,1294,544,2.378676471,985,338,208,80,0,80,0,24,0,0.225,empty,mBC-0814-1
"B8,A5",5041,5084,3577,1507,3011,0,1558,1563,1103,460,2.397826087,772,1543,1095,306,0,306,0,58,0,0,empty,mBC-0814-1
"B8,A6",717198,837929,468982,368947,495565,0,323712,324039,258726,65313,3.961324698,196117,199891,128353,36542,31,36511,3,2501,0,0.017967188,mm10,mBC-0814-1
"B8,A7",5755,6181,4103,2078,3582,0,1885,1890,1331,559,2.381037567,972,4194,1563,485,0,485,0,89,0,0.002061856,empty,mBC-0814-1
"B8,A8",2303,2598,1623,975,1464,0,810,810,593,217,2.732718894,454,1574,1095,303,0,303,0,66,0,0,empty,mBC-0814-1
"B8,A9",6646,7017,4764,2253,4086,0,2157,2159,1547,612,2.527777778,1112,2114,1295,309,0,309,0,61,0,0.009708738,empty,mBC-0814-1
"B8,A10",3722,3954,2643,1311,2307,0,1264,1267,894,373,2.396782842,670,132,103,33,0,33,0,7,0,0,empty,mBC-0814-1
"B8,A11",5095,5495,3630,1865,3197,0,1748,1750,1297,453,2.863134658,916,1678,1047,302,0,302,0,75,0,0,empty,mBC-0814-1
"B8,A12",4557,5088,3272,1816,3062,0,1711,1712,1257,455,2.762637363,953,2891,1976,646,0,646,0,139,0,0.029411765,empty,mBC-0814-1
"B8,B1",450511,516251,302367,213884,305746,0,188879,189081,159521,29560,5.396515562,111693,106589,73159,21574,16,21558,3,1550,0,0.000463865,mm10,mBC-0814-1
"B8,B2",1077775,1275452,693544,581908,752884,2,496989,497572,380651,116921,3.255625593,306023,120803,70457,19833,21,19812,4,1540,0,0.004441752,mm10,mBC-0814-1
"B8,B3",4426,4927,3141,1786,2857,0,1644,1651,1164,487,2.390143737,900,1308,862,288,0,288,0,55,0,0.017361111,empty,mBC-0814-1
"B8,B4",4461,4848,3151,1697,2872,7,1558,1570,1125,445,2.528089888,875,827,538,181,0,181,0,53,0,0,empty,mBC-0814-1
"B8,B5",4564,3426,2120,1306,2399,0,1360,1367,986,381,2.587926509,816,5542,2249,678,2,676,2,100,0,0.035502959,empty,mBC-0814-1
"B8,B6",4382,4875,3095,1780,2851,0,1603,1608,1101,507,2.171597633,914,1169,704,219,0,219,0,55,0,0.01369863,empty,mBC-0814-1
"B8,B7",4987,5312,3524,1788,3114,0,1702,1709,1224,485,2.52371134,888,626,379,147,0,147,0,49,0,0,empty,mBC-0814-1
"B8,B8",4277,4782,3073,1709,2767,0,1535,1536,1113,423,2.631205674,846,643,377,122,0,122,0,33,0,0.073770492,empty,mBC-0814-1
"B8,B9",4993,5511,3479,2032,3268,0,1860,1864,1349,515,2.619417476,1047,851,639,136,0,136,0,38,0,0,empty,mBC-0814-1
"B8,B10",4267,4616,3006,1610,2800,0,1512,1513,1083,430,2.518604651,843,377,238,65,0,65,0,18,0,0,empty,mBC-0814-1
"B8,B11",6788,7236,4966,2270,4245,0,2284,2289,1686,603,2.7960199,1201,68,54,12,0,12,0,8,0,0.166666667,empty,mBC-0814-1
"B8,B12",5294,5994,3678,2316,3509,1,1947,1950,1408,542,2.597785978,1085,1517,1154,320,0,320,0,57,0,0,empty,mBC-0814-1
"B8,C1",5670,6002,4114,1888,3482,1,1783,1788,1283,505,2.540594059,933,910,611,166,0,166,0,34,0,0,empty,mBC-0814-1
"B8,C2",5529,6123,4049,2074,3512,0,1877,1879,1385,494,2.803643725,989,1589,1178,373,0,373,0,67,0,0.002680965,empty,mBC-0814-1
"B8,C3",7494,8287,5282,3005,4895,0,2736,2736,2079,657,3.164383562,1542,488,357,130,0,130,0,26,0,0,empty,mBC-0814-1
"B8,C4",5377,5508,3838,1670,3293,0,1703,1703,1252,451,2.776053215,892,4725,2027,540,0,540,0,78,0,0.011111111,empty,mBC-0814-1
"B8,C5",7663,8434,5451,2983,4857,0,2724,2724,1975,749,2.636849132,1449,2907,1388,445,1,444,1,95,0,0.031531532,empty,mBC-0814-1
"B8,C6",5375,5638,3880,1758,3365,0,1833,1836,1281,555,2.308108108,936,1025,690,215,0,215,0,47,0,0,empty,mBC-0814-1
"B8,C7",7323,8088,5255,2833,4717,0,2586,2589,1845,744,2.47983871,1430,503,407,68,0,68,0,18,0,0,empty,mBC-0814-1
"B8,C8",5759,6191,4210,1981,3594,0,1900,1902,1427,475,3.004210526,975,2012,1523,443,0,443,0,68,0,0,empty,mBC-0814-1
"B8,C9",4678,4994,3296,1698,2966,0,1603,1603,1156,447,2.586129754,838,1306,987,298,0,298,0,56,0,0,empty,mBC-0814-1
"B8,C10",696560,823061,455171,367890,480856,2,312959,313275,267082,46193,5.781871712,190036,124673,88180,24991,18,24973,2,1850,0,0.002082249,mm10,mBC-0814-1
"B8,C11",4880,5428,3392,2036,3139,0,1788,1791,1284,507,2.532544379,1011,1230,878,300,0,300,0,57,0,0,empty,mBC-0814-1
"B8,C12",8263,9097,5919,3178,5275,2,2873,2883,2071,812,2.550492611,1568,2066,1482,446,0,446,0,71,0,0.01793722,empty,mBC-0814-1
"B8,D1",4510,4958,3169,1789,2966,0,1662,1664,1205,459,2.625272331,936,453,341,92,0,92,0,24,0,0.076086957,empty,mBC-0814-1
"B8,D2",5165,5478,3814,1664,3178,0,1620,1623,1166,457,2.551422319,810,1563,1206,382,0,382,0,84,0,0,empty,mBC-0814-1
"B8,D3",495627,578921,328254,250667,347072,1,224242,224467,162679,61788,2.632857513,136974,15317,10606,3069,6,3063,1,377,0,0.001305909,mm10,mBC-0814-1
"B8,D4",4818,5145,3482,1663,3068,1,1677,1678,1233,445,2.770786517,885,1158,812,229,1,228,1,64,0,0,empty,mBC-0814-1
"B8,D5",4944,5391,3476,1915,3273,0,1810,1817,1311,506,2.590909091,1033,4766,2277,614,0,614,0,104,0,0.001628664,empty,mBC-0814-1
"B8,D6",5221,5734,3779,1955,3271,0,1802,1803,1332,471,2.828025478,953,1310,976,269,0,269,0,51,0,0,empty,mBC-0814-1
"B8,D7",6164,6642,4418,2224,3891,1,2098,2101,1529,572,2.673076923,1159,2094,1285,383,0,383,0,96,0,0,empty,mBC-0814-1
"B8,D8",4915,5390,3537,1853,3137,0,1709,1709,1205,504,2.390873016,897,9856,2873,871,0,871,0,107,0,0.107921929,empty,mBC-0814-1
"B8,D9",3416,3725,2437,1288,2167,0,1184,1186,851,335,2.540298507,633,1153,784,201,0,201,0,48,0,0,empty,mBC-0814-1
"B8,D10",3827,4345,2747,1598,2528,0,1461,1461,1056,405,2.607407407,787,932,636,199,1,198,1,41,0,0.075757576,empty,mBC-0814-1
"B8,D11",4373,4820,3116,1704,2852,0,1542,1546,1139,407,2.798525799,854,1946,1383,365,0,365,0,96,0,0.002739726,empty,mBC-0814-1
"B8,D12",6670,7194,4707,2487,4197,0,2315,2316,1656,660,2.509090909,1243,2950,2140,538,1,537,1,94,0,0,empty,mBC-0814-1
"B8,E1",486817,551718,328530,223188,327197,0,200205,200431,161867,38564,4.197360232,117297,157357,112105,31302,15,31287,3,2108,0,6.39243E-05,mm10,mBC-0814-1
"B8,E2",3807,4306,2717,1589,2466,0,1356,1356,979,377,2.596816976,769,1061,768,234,1,233,1,52,0,0,empty,mBC-0814-1
"B8,E3",3443,3692,2400,1292,2162,0,1178,1179,851,328,2.594512195,636,920,679,245,0,245,0,46,0,0,empty,mBC-0814-1
"B8,E4",3051,3277,2204,1073,1942,0,1074,1076,776,300,2.586666667,559,1375,1001,297,0,297,0,54,0,0.003367003,empty,mBC-0814-1
"B8,E5",3781,3891,2803,1088,2289,0,1161,1167,853,314,2.71656051,546,816,623,196,0,196,0,34,0,0,empty,mBC-0814-1
"B8,E6",4391,4853,3166,1687,2804,0,1490,1493,1076,417,2.580335731,831,4292,1418,467,1,466,1,67,0,0.090128755,empty,mBC-0814-1
"B8,E7",5809,6308,4219,2089,3633,0,1917,1918,1447,471,3.072186837,1009,1410,970,322,0,322,0,60,0,0,empty,mBC-0814-1
"B8,E8",4510,4962,3181,1781,2899,0,1526,1527,1049,478,2.194560669,825,2221,1639,489,0,489,0,83,0,0,empty,mBC-0814-1
"B8,E9",3514,3919,2516,1403,2268,0,1224,1226,891,335,2.659701493,684,1541,982,316,0,316,0,60,0,0.041139241,empty,mBC-0814-1
"B8,E10",4356,4835,3074,1761,2823,0,1555,1557,1113,444,2.506756757,850,1713,1109,349,0,349,0,82,0,0,empty,mBC-0814-1
"B8,E11",4506,4713,3238,1475,2787,3,1472,1475,1027,448,2.292410714,759,1256,835,273,0,273,0,59,0,0.014652015,empty,mBC-0814-1
"B8,E12",947064,1092918,633230,459688,645630,3,408768,409183,303158,106025,2.859306767,246410,91286,62030,17118,10,17108,2,1500,0,0.002104279,mm10,mBC-0814-1
"B8,F1",4607,4809,3322,1487,2864,0,1549,1551,1081,470,2.3,840,1477,1008,311,0,311,0,54,0,0,empty,mBC-0814-1
"B8,F2",649216,752901,437611,315290,440026,1,270254,270542,213181,57361,3.716479838,160302,379415,274991,77989,44,77945,3,3396,0,0.000513182,mm10,mBC-0814-1
"B8,F3",5098,5408,3722,1686,3248,0,1670,1672,1196,476,2.512605042,857,1360,975,294,0,294,0,64,0,0,empty,mBC-0814-1
"B8,F4",5704,6076,4031,2045,3600,2,1931,1937,1412,525,2.68952381,1026,670,444,141,1,140,1,23,0,0,empty,mBC-0814-1
"B8,F5",5096,5610,3603,2007,3238,1,1715,1722,1192,530,2.249056604,973,1096,813,243,0,243,0,57,0,0,empty,mBC-0814-1
"B8,F6",5449,6028,3826,2202,3506,0,1924,1926,1379,547,2.521023766,1113,2209,1267,412,1,411,1,84,0,0.01946472,empty,mBC-0814-1
"B8,F7",4471,4790,3236,1554,2825,0,1510,1514,1102,412,2.674757282,775,381,268,91,0,91,0,29,0,0,empty,mBC-0814-1
"B8,F8",6161,6723,4364,2359,3891,0,2114,2118,1498,620,2.416129032,1145,176,84,24,0,24,0,6,0,0,empty,mBC-0814-1
"B8,F9",6017,6278,4351,1927,3694,0,1952,1960,1415,545,2.596330275,978,2862,2107,675,0,675,0,106,0,0.007407407,empty,mBC-0814-1
"B8,F10",6431,6745,4683,2062,3889,0,1974,1981,1442,539,2.675324675,1023,970,642,203,0,203,0,63,0,0,empty,mBC-0814-1
"B8,F11",4575,4957,3326,1631,2914,0,1605,1608,1106,502,2.203187251,854,1301,863,266,1,265,1,59,0,0,empty,mBC-0814-1
"B8,F12",490491,581254,323893,257361,341253,0,217927,218172,178804,39368,4.54186141,133036,12185,8426,2349,5,2344,1,309,0,0,mm10,mBC-0814-1
"B8,G1",7777,8421,5518,2903,4975,0,2758,2758,1987,771,2.577172503,1447,10436,4217,1388,4,1384,1,193,0,0.10982659,empty,mBC-0814-1
"B8,G2",474807,563841,294991,268850,335228,0,227471,227653,181976,45677,3.983974429,142280,24079,16620,4713,2,4711,2,507,0,0.001698153,mm10,mBC-0814-1
"B8,G3",5208,5617,3707,1910,3289,0,1800,1800,1261,539,2.339517625,961,2296,1430,450,0,450,0,98,0,0,empty,mBC-0814-1
"B8,G4",5256,5591,3771,1820,3311,8,1772,1784,1314,470,2.795744681,944,96,36,12,0,12,0,5,0,0,empty,mBC-0814-1
"B8,G5",4809,5325,3475,1850,3065,1,1681,1689,1233,456,2.703947368,905,1032,703,232,0,232,0,54,0,0,empty,mBC-0814-1
"B8,G6",719746,836707,483917,352790,488829,1,303973,304324,241803,62521,3.867548504,181113,18744,11989,3437,0,3437,0,384,0,0.000290951,mm10,mBC-0814-1
"B8,G7",5594,5935,4045,1890,3525,0,1866,1868,1326,542,2.446494465,958,2700,1894,510,0,510,0,116,0,0,empty,mBC-0814-1
"B8,G8",7599,8286,5377,2909,4951,0,2770,2772,1967,805,2.443478261,1491,7552,2889,878,1,877,1,170,0,0.047890536,empty,mBC-0814-1
"B8,G9",5834,6246,3983,2263,3671,0,2093,2096,1548,548,2.824817518,1149,2768,1837,495,1,494,1,103,0,0.022267206,empty,mBC-0814-1
"B8,G10",9227,9746,6560,3186,5797,9,3099,3110,2235,875,2.554285714,1619,2832,1997,655,0,655,0,145,0,0.035114504,empty,mBC-0814-1
"B8,G11",9334,10008,6740,3268,5856,0,3073,3076,2279,797,2.859473024,1621,1146,758,258,0,258,0,59,0,0,empty,mBC-0814-1
"B8,G12",5081,5399,3592,1807,3247,6,1832,1845,1338,507,2.639053254,991,7880,2998,908,1,907,1,132,0,0.030871003,empty,mBC-0814-1
"B8,H1",4932,5369,3427,1942,3162,0,1753,1755,1215,540,2.25,974,3230,1438,399,0,399,0,63,0,0.012531328,empty,mBC-0814-1
"B8,H2",665513,773454,443653,329801,453959,0,285203,285530,236488,49042,4.822152441,171031,265774,192820,53295,34,53261,4,2772,0,0.000394285,mm10,mBC-0814-1
"B8,H3",5832,6293,4143,2150,3626,0,1983,1986,1462,524,2.790076336,1083,1548,1188,324,0,324,0,70,0,0,empty,mBC-0814-1
"B8,H4",5746,6299,4098,2201,3666,0,2010,2011,1395,616,2.26461039,1093,107,60,20,0,20,0,11,0,0,empty,mBC-0814-1
"B8,H5",6826,7343,4936,2407,4241,0,2286,2288,1654,634,2.608832808,1187,3325,1522,534,1,533,1,92,0,0.095684803,empty,mBC-0814-1
"B8,H6",6525,6941,4581,2360,4133,0,2225,2226,1530,696,2.198275862,1239,20653,6379,1985,2,1983,2,199,0,0.096318709,empty,mBC-0814-1
"B8,H7",565989,655191,376377,278814,389872,2,245746,246042,200199,45843,4.36705713,147747,111244,77009,21797,14,21783,4,1591,0,0.000229537,mm10,mBC-0814-1
"B8,H8",133349,152991,87506,65485,90329,0,57951,58012,37050,20962,1.767484019,34815,30431,20619,5617,6,5611,1,607,0,0.004455534,mm10,mBC-0814-1
"B8,H9",557368,633191,370217,262974,373470,1,234060,234320,173673,60647,2.863670091,139339,83827,60017,16891,12,16879,1,1326,0,0.000355471,mm10,mBC-0814-1
"B8,H10",3879,4346,2748,1598,2537,3,1398,1401,1037,364,2.848901099,823,938,678,251,0,251,0,58,0,0,empty,mBC-0814-1
"B8,H11",4231,4790,3077,1713,2812,0,1574,1575,1095,480,2.28125,864,12,9,7,0,7,0,5,0,0,empty,mBC-0814-1
"B8,H12",2970,3322,2069,1253,2000,0,1158,1158,839,319,2.630094044,652,989,663,205,0,205,0,56,0,0.019512195,empty,mBC-0814-1
"B9,A1",5394,5599,3922,1677,3299,0,1697,1697,1210,487,2.484599589,861,2433,1292,431,0,431,0,65,0,0.053364269,empty,mBC-0814-1
"B9,A2",1367288,1559557,904888,654669,905402,2,572878,573502,474298,99204,4.781037055,339846,411183,298748,84931,51,84880,5,3853,0,0.000412347,mm10,mBC-0814-1
"B9,A3",4522,4820,3351,1469,2822,0,1501,1503,1077,426,2.528169014,742,610,422,156,0,156,0,39,0,0,empty,mBC-0814-1
"B9,A4",5721,5911,4182,1729,3308,0,1663,1667,1172,495,2.367676768,822,3583,1049,298,1,297,1,44,0,0,empty,mBC-0814-1
"B9,A5",4645,5108,3310,1798,3019,0,1631,1633,1149,484,2.373966942,911,1085,766,225,0,225,0,50,0,0,empty,mBC-0814-1
"B9,A6",3933,4355,2682,1673,2537,0,1494,1496,1075,421,2.553444181,877,1114,675,201,0,201,0,45,0,0.044776119,empty,mBC-0814-1
"B9,A7",5219,5811,3719,2092,3463,1,1986,1992,1418,574,2.470383275,1096,2880,1573,379,0,379,0,78,0,0.005277045,empty,mBC-0814-1
"B9,A8",2064,2291,1478,813,1368,0,780,783,540,243,2.222222222,422,1093,746,258,0,258,0,62,0,0.023255814,empty,mBC-0814-1
"B9,A9",6233,6785,4538,2247,3967,0,2110,2110,1502,608,2.470394737,1107,1728,1236,357,0,357,0,60,0,0.019607843,empty,mBC-0814-1
"B9,A10",3447,3683,2436,1247,2151,0,1174,1174,842,332,2.536144578,605,248,172,56,0,56,0,18,0,0,empty,mBC-0814-1
"B9,A11",4566,5041,3236,1805,2979,0,1657,1658,1232,426,2.892018779,927,1504,986,308,0,308,0,70,0,0.003246753,empty,mBC-0814-1
"B9,A12",4282,4689,3099,1590,2809,0,1515,1519,1139,380,2.997368421,849,2152,1527,517,0,517,0,140,0,0,empty,mBC-0814-1
"B9,B1",4709,4976,3430,1546,2960,3,1580,1587,1117,470,2.376595745,802,1041,691,211,0,211,0,63,0,0,empty,mBC-0814-1
"B9,B2",4703,4960,3364,1596,2927,0,1541,1544,1163,381,3.052493438,783,420,303,81,0,81,0,20,0,0.012345679,empty,mBC-0814-1
"B9,B3",4270,4651,3054,1597,2866,0,1586,1589,1152,437,2.636155606,880,1051,715,199,0,199,0,36,0,0,empty,mBC-0814-1
"B9,B4",4206,4478,2981,1497,2640,0,1459,1459,1064,395,2.693670886,760,1044,744,251,0,251,0,53,0,0,empty,mBC-0814-1
"B9,B5",3647,2469,1492,977,1708,0,967,975,690,285,2.421052632,600,966,578,153,0,153,0,46,0,0,empty,mBC-0814-1
"B9,B6",3871,4195,2689,1506,2518,0,1422,1423,1044,379,2.754617414,796,4023,1713,551,0,551,0,70,0,0.103448276,empty,mBC-0814-1
"B9,B7",4937,5201,3559,1642,3056,0,1656,1658,1174,484,2.425619835,875,674,461,174,0,174,0,48,0,0,empty,mBC-0814-1
"B9,B8",3650,3864,2657,1207,2270,0,1187,1189,860,329,2.613981763,604,469,300,116,0,116,0,40,0,0,empty,mBC-0814-1
"B9,B9",4701,5317,3356,1961,3131,0,1734,1738,1226,512,2.39453125,979,670,397,143,0,143,0,45,0,0,empty,mBC-0814-1
"B9,B10",4263,4573,2993,1580,2734,0,1476,1478,1046,432,2.421296296,799,463,347,78,0,78,0,25,0,0,empty,mBC-0814-1
"B9,B11",6214,6848,4536,2312,3962,0,2154,2157,1541,616,2.501623377,1134,222,193,37,0,37,0,13,0,0,empty,mBC-0814-1
"B9,B12",5342,5809,3796,2013,3400,0,1900,1903,1339,564,2.374113475,999,1068,683,206,0,206,0,55,0,0,empty,mBC-0814-1
"B9,C1",5492,5705,3905,1800,3360,2,1781,1785,1262,523,2.413001912,897,447,296,99,0,99,0,37,0,0,empty,mBC-0814-1
"B9,C2",636579,740110,431184,308926,429650,0,263005,263338,220066,43272,5.085644297,155620,328951,229348,64592,48,64544,3,3099,0,9.29598E-05,mm10,mBC-0814-1
"B9,C3",758884,871643,516080,355563,504000,1,308328,308705,252503,56202,4.492776058,180475,69539,50042,14213,7,14206,1,1164,0,7.03928E-05,mm10,mBC-0814-1
"B9,C4",4889,5227,3553,1674,3099,0,1684,1687,1240,447,2.774049217,862,1744,922,288,1,287,1,68,0,0.020905923,empty,mBC-0814-1
"B9,C5",692829,803379,462555,340824,468674,2,293331,293665,250473,43192,5.799060011,174381,137596,91320,26362,15,26347,1,1852,0,0.01385357,mm10,mBC-0814-1
"B9,C6",6614,7288,4702,2586,4447,0,2499,2505,1857,648,2.865740741,1378,1000,709,181,0,181,0,47,0,0,empty,mBC-0814-1
"B9,C7",626449,738317,413181,325136,432752,0,279573,279868,215435,64433,3.343550665,170126,14803,10756,3216,3,3213,1,385,0,0,mm10,mBC-0814-1
"B9,C8",5452,5814,3891,1923,3454,0,1877,1879,1347,532,2.531954887,1002,2054,1379,411,0,411,0,67,0,0,empty,mBC-0814-1
"B9,C9",4453,4644,3156,1488,2838,0,1540,1545,1069,476,2.245798319,792,1286,996,291,1,290,1,54,0,0,empty,mBC-0814-1
"B9,C10",5530,5959,3875,2084,3441,0,1845,1857,1340,517,2.591876209,1014,3065,1351,410,1,409,1,55,0,0.107579462,empty,mBC-0814-1
"B9,C11",4452,5060,3108,1952,2892,0,1676,1678,1190,488,2.43852459,940,1303,841,242,0,242,0,51,0,0,empty,mBC-0814-1
"B9,C12",7957,8303,5709,2594,4925,0,2664,2669,1930,739,2.611637348,1344,1866,1355,419,1,418,1,73,0,0.007177033,empty,mBC-0814-1
"B9,D1",4248,4602,3029,1573,2737,1,1472,1473,1045,428,2.441588785,815,353,229,63,0,63,0,19,0,0,empty,mBC-0814-1
"B9,D2",4837,5048,3538,1510,2980,0,1576,1576,1120,456,2.456140351,822,1223,855,266,0,266,0,62,0,0,empty,mBC-0814-1
"B9,D3",10600,11601,7391,4210,6709,0,3736,3739,2654,1085,2.446082949,2083,11816,4047,1276,2,1274,1,128,0,0.09811617,empty,mBC-0814-1
"B9,D4",6249,7032,4321,2711,4211,0,2437,2443,1737,706,2.460339943,1384,999,774,224,0,224,0,41,0,0,empty,mBC-0814-1
"B9,D5",4441,4847,3166,1681,2881,0,1605,1607,1185,422,2.808056872,909,2134,1494,441,0,441,0,118,0,0.024943311,empty,mBC-0814-1
"B9,D6",963384,1063676,672128,391548,623801,2,366902,367310,299046,68264,4.380727763,207961,69597,48017,13650,13,13637,1,1210,0,0.004693114,mm10,mBC-0814-1
"B9,D7",5728,5934,4054,1880,3540,0,1864,1867,1366,501,2.726546906,954,1644,1010,294,1,293,1,77,0,0.006825939,empty,mBC-0814-1
"B9,D8",4495,4893,3206,1687,2896,0,1574,1575,1141,434,2.629032258,873,520,347,115,0,115,0,39,0,0,empty,mBC-0814-1
"B9,D9",2996,3332,2142,1190,1947,0,1050,1052,722,330,2.187878788,564,1012,691,217,0,217,0,48,0,0,empty,mBC-0814-1
"B9,D10",426205,498418,284274,214144,296325,1,185850,186050,156800,29250,5.360683761,112200,117263,82426,23275,20,23255,2,1691,0,0.001247044,mm10,mBC-0814-1
"B9,D11",4113,4399,2937,1462,2635,0,1473,1475,1064,411,2.588807786,769,1891,1404,438,0,438,0,115,0,0.002283105,empty,mBC-0814-1
"B9,D12",427018,516042,270166,245876,306385,1,203858,204049,165113,38936,4.240625642,128421,259387,187400,52732,36,52696,2,2819,0,0.000284652,mm10,mBC-0814-1
"B9,E1",4887,5244,3612,1632,3044,0,1613,1619,1198,421,2.845605701,819,1304,929,273,0,273,0,50,0,0,empty,mBC-0814-1
"B9,E2",432491,509899,275298,234601,304817,1,206092,206316,159339,46977,3.391851332,127394,12613,9181,2419,2,2417,1,355,0,0.005792305,mm10,mBC-0814-1
"B9,E3",3564,3887,2599,1288,2173,0,1157,1161,863,298,2.895973154,602,957,593,169,0,169,0,44,0,0,empty,mBC-0814-1
"B9,E4",440422,518966,293993,224973,306252,0,193529,193770,158314,35456,4.465083484,116443,182555,129511,36329,24,36305,2,2228,0,0.000991599,mm10,mBC-0814-1
"B9,E5",3665,3793,2732,1061,2208,0,1136,1136,811,325,2.495384615,556,526,383,107,0,107,0,28,0,0,empty,mBC-0814-1
"B9,E6",4429,4861,3150,1711,2771,6,1459,1467,1044,423,2.468085106,804,1374,1010,261,0,261,0,47,0,0,empty,mBC-0814-1
"B9,E7",4257,4623,3054,1569,2602,0,1388,1391,1020,371,2.749326146,724,1099,742,238,0,238,0,49,0,0.042016807,empty,mBC-0814-1
"B9,E8",4929,4871,3409,1462,2844,0,1486,1486,1066,420,2.538095238,732,49708,15140,4611,4,4607,3,436,0,0.132407206,empty,mBC-0814-1
"B9,E9",3173,3416,2232,1184,2061,0,1144,1144,822,322,2.552795031,635,1247,900,261,0,261,0,56,0,0.011494253,empty,mBC-0814-1
"B9,E10",4062,4256,2929,1327,2471,0,1298,1305,955,350,2.728571429,655,1132,718,211,0,211,0,52,0,0,empty,mBC-0814-1
"B9,E11",4364,4888,3186,1702,2741,0,1477,1477,1023,454,2.253303965,783,754,507,173,0,173,0,44,0,0.075144509,empty,mBC-0814-1
"B9,E12",3967,4323,2820,1503,2575,0,1417,1418,1018,400,2.545,783,491,350,135,0,135,0,31,0,0,empty,mBC-0814-1
"B9,F1",4590,5164,3229,1935,3023,0,1654,1663,1199,464,2.584051724,955,1213,885,261,1,260,1,54,0,0,empty,mBC-0814-1
"B9,F2",6945,7293,4968,2325,4334,1,2336,2341,1714,627,2.733652313,1232,1362,964,294,0,294,0,81,0,0,empty,mBC-0814-1
"B9,F3",375063,421631,256475,165156,254146,0,154611,154792,110304,44488,2.479410178,90405,17466,12083,3378,3,3375,1,502,0,0.006222222,mm10,mBC-0814-1
"B9,F4",5461,5672,3946,1726,3382,0,1809,1812,1317,495,2.660606061,948,498,363,124,0,124,0,38,0,0.080645161,empty,mBC-0814-1
"B9,F5",5104,5464,3662,1802,3255,1,1753,1759,1290,469,2.750533049,967,1031,660,203,0,203,0,54,0,0,empty,mBC-0814-1
"B9,F6",4870,5196,3500,1696,3030,0,1693,1696,1280,416,3.076923077,873,1217,795,281,0,281,0,69,0,0,empty,mBC-0814-1
"B9,F7",4473,4864,3263,1601,2903,0,1552,1554,1148,406,2.827586207,826,771,532,174,0,174,0,34,0,0,empty,mBC-0814-1
"B9,F8",735608,855175,490631,364544,498993,0,312496,312911,250460,62451,4.010504235,185819,24459,17021,4862,4,4858,1,501,0,0.00102923,mm10,mBC-0814-1
"B9,F9",5593,6050,3889,2161,3588,1,1983,1986,1446,540,2.677777778,1080,25143,7720,2490,2,2488,2,220,0,0.165192926,empty,mBC-0814-1
"B9,F10",6570,7013,4799,2214,4072,0,2141,2143,1501,642,2.338006231,1128,865,552,209,0,209,0,65,0,0,empty,mBC-0814-1
"B9,F11",3977,4256,2791,1465,2523,0,1300,1304,915,389,2.35218509,710,1603,1125,335,0,335,0,57,0,0,empty,mBC-0814-1
"B9,F12",4774,5393,3388,2005,3117,0,1772,1781,1273,508,2.505905512,1005,193,119,24,0,24,0,6,0,0,empty,mBC-0814-1
"B9,G1",7283,7906,5123,2783,4650,0,2575,2581,1815,766,2.369451697,1403,1630,1115,404,0,404,0,109,0,0,empty,mBC-0814-1
"B9,G2",5648,6260,4013,2247,3650,0,2010,2018,1408,610,2.308196721,1132,283,199,69,0,69,0,19,0,0,empty,mBC-0814-1
"B9,G3",5037,5542,3564,1978,3244,0,1797,1798,1294,504,2.567460317,990,2113,1513,446,2,444,1,90,0,0.112612613,empty,mBC-0814-1
"B9,G4",5241,5576,3828,1748,3156,0,1691,1693,1191,502,2.37250996,869,1,1,1,0,1,0,1,0,0,empty,mBC-0814-1
"B9,G5",4618,5069,3285,1784,2999,0,1650,1654,1198,456,2.627192982,897,913,594,221,0,221,0,51,0,0.049773756,empty,mBC-0814-1
"B9,G6",572518,609394,410612,198782,358751,0,194031,194311,133781,60530,2.210160251,105949,2648,1180,376,1,375,1,45,0,0,empty,mBC-0814-1
"B9,G7",963426,1101074,629613,471461,649545,6,412373,412824,291194,121630,2.394096851,246859,445707,318631,87662,56,87606,7,3931,0,0.000353857,mm10,mBC-0814-1
"B9,G8",6999,7610,4995,2615,4546,0,2551,2551,1788,763,2.343381389,1383,3407,2542,759,1,758,1,135,0,0,empty,mBC-0814-1
"B9,G9",5238,5567,3682,1885,3346,0,1854,1857,1318,539,2.445269017,986,6714,2753,875,4,871,1,145,0,0.076923077,empty,mBC-0814-1
"B9,G10",542116,613752,369012,244740,365115,1,225117,225390,177646,47744,3.720802614,131787,22799,16435,4720,1,4719,1,586,0,0,mm10,mBC-0814-1
"B9,G11",9078,9825,6496,3329,5657,0,3070,3078,2156,922,2.338394794,1622,1462,1172,370,0,370,0,73,0,0,empty,mBC-0814-1
"B9,G12",4615,5035,3352,1683,2967,0,1644,1647,1174,473,2.482029598,859,1641,1170,306,0,306,0,67,0,0,empty,mBC-0814-1
"B9,H1",4492,4794,3202,1592,2816,0,1493,1493,1073,420,2.554761905,821,820,393,140,0,140,0,42,0,0.05,empty,mBC-0814-1
"B9,H2",8051,8776,5731,3045,5130,0,2814,2820,1987,833,2.385354142,1515,2154,1402,494,0,494,0,128,0,0,empty,mBC-0814-1
"B9,H3",5401,6000,3720,2280,3592,0,2030,2033,1489,544,2.737132353,1157,9425,3392,1059,0,1059,0,124,0,0.178470255,empty,mBC-0814-1
"B9,H4",5462,5784,3898,1886,3359,0,1856,1858,1330,528,2.518939394,980,11,8,6,0,6,0,5,0,0,empty,mBC-0814-1
"B9,H5",6205,6862,4475,2387,3998,0,2138,2142,1505,637,2.362637363,1168,1625,1215,364,0,364,0,68,0,0,empty,mBC-0814-1
"B9,H6",6127,6721,4401,2320,3930,0,2163,2164,1510,654,2.308868502,1181,1683,1076,296,0,296,0,68,0,0.003378378,empty,mBC-0814-1
"B9,H7",5063,5532,3673,1859,3243,0,1767,1767,1297,470,2.759574468,894,682,478,157,0,157,0,51,0,0,empty,mBC-0814-1
"B9,H8",4429,4666,3151,1515,2765,0,1519,1521,1098,423,2.595744681,789,1363,917,303,0,303,0,60,0,0,empty,mBC-0814-1
"B9,H9",4598,5151,3285,1866,2936,0,1607,1611,1137,474,2.398734177,879,966,656,188,1,187,1,44,0,0,empty,mBC-0814-1
"B9,H10",3810,4240,2631,1609,2440,6,1359,1367,996,371,2.684636119,772,369,288,106,0,106,0,28,0,0,empty,mBC-0814-1
"B9,H11",3910,4248,2765,1483,2563,0,1440,1440,1025,415,2.469879518,776,152,98,40,0,40,0,8,0,0,empty,mBC-0814-1
"B9,H12",2666,2994,1880,1114,1773,0,1012,1016,709,307,2.309446254,561,1151,717,192,0,192,0,45,0,0,empty,mBC-0814-1
"B10,A1",5902,6427,4173,2254,3856,0,2137,2141,1543,598,2.580267559,1191,2255,1581,498,0,498,0,91,0,0,empty,mBC-0814-1
"B10,A2",5222,5637,3679,1958,3350,0,1827,1832,1309,523,2.502868069,1012,2277,1754,543,1,542,1,109,0,0.020295203,empty,mBC-0814-1
"B10,A3",4729,5250,3307,1943,3062,0,1682,1684,1202,482,2.493775934,964,838,511,167,0,167,0,41,0,0,empty,mBC-0814-1
"B10,A4",5638,6049,4172,1877,3498,0,1808,1815,1290,525,2.457142857,926,490,393,112,0,112,0,22,0,0,empty,mBC-0814-1
"B10,A5",5040,5231,3639,1592,3086,0,1658,1660,1189,471,2.524416136,860,1534,1019,303,0,303,0,65,0,0,empty,mBC-0814-1
"B10,A6",8767,9763,6064,3699,5813,0,3354,3354,2619,735,3.563265306,1888,7070,3561,1151,0,1151,0,125,0,0.053866203,empty,mBC-0814-1
"B10,A7",5609,6222,4061,2161,3678,0,1978,1985,1442,543,2.655616943,1071,1668,1102,276,0,276,0,75,0,0,empty,mBC-0814-1
"B10,A8",2251,2479,1597,882,1481,0,863,863,601,262,2.29389313,477,2366,1757,547,0,547,0,102,0,0.014625229,empty,mBC-0814-1
"B10,A9",6649,6945,4798,2147,4089,0,2146,2147,1487,660,2.253030303,1131,1469,950,290,0,290,0,64,0,0,empty,mBC-0814-1
"B10,A10",3480,3684,2481,1203,2210,0,1217,1218,846,372,2.274193548,664,360,219,82,1,81,1,16,0,0,empty,mBC-0814-1
"B10,A11",313036,359687,205912,153775,214175,1,132245,132367,114494,17873,6.405975494,78959,275939,190955,54112,39,54073,5,2872,0,0.000721247,mm10,mBC-0814-1
"B10,A12",3907,4378,2749,1629,2603,0,1485,1489,1032,457,2.258205689,830,4029,2774,833,0,833,0,190,0,0,empty,mBC-0814-1
"B10,B1",4778,5077,3301,1776,3013,0,1649,1651,1167,484,2.411157025,915,1723,1196,333,0,333,0,81,0,0,empty,mBC-0814-1
"B10,B2",577383,679667,382791,296876,402365,1,256390,256728,212075,44653,4.749400936,155085,56193,39311,11144,9,11135,2,1009,0,0,mm10,mBC-0814-1
"B10,B3",380549,444792,252196,192596,265804,0,167089,167257,135148,32109,4.209037964,100990,118967,84466,24252,10,24242,1,1871,0,0.000990017,mm10,mBC-0814-1
"B10,B4",4356,5015,3110,1905,2835,0,1581,1582,1159,423,2.739952719,884,2723,1445,458,0,458,0,81,0,0.074235808,empty,mBC-0814-1
"B10,B5",6270,5311,3075,2236,3473,0,2132,2139,1586,553,2.867992767,1306,691,336,132,0,132,0,42,0,0.113636364,empty,mBC-0814-1
"B10,B6",4212,4492,3018,1474,2622,0,1466,1466,1023,443,2.309255079,772,1854,1144,405,0,405,0,69,0,0,empty,mBC-0814-1
"B10,B7",5207,5708,3791,1917,3417,0,1862,1865,1332,533,2.499061914,994,1114,795,269,0,269,0,73,0,0.059479554,empty,mBC-0814-1
"B10,B8",3867,4107,2761,1346,2454,7,1336,1346,958,388,2.469072165,738,1263,851,264,0,264,0,65,0,0,empty,mBC-0814-1
"B10,B9",455645,529856,297827,232029,315474,2,206363,206615,160546,46069,3.48490308,125087,15270,10481,2856,2,2854,2,396,0,0.004204625,mm10,mBC-0814-1
"B10,B10",4573,4831,3192,1639,2900,0,1578,1580,1091,489,2.231083845,846,656,462,145,0,145,0,29,0,0.006896552,empty,mBC-0814-1
"B10,B11",8486,9237,6006,3231,5476,0,3023,3023,2220,803,2.764632628,1710,275,213,76,0,76,0,21,0,0,empty,mBC-0814-1
"B10,B12",5500,6148,3867,2281,3583,3,2068,2074,1473,601,2.450915141,1161,1430,1011,284,0,284,0,74,0,0,empty,mBC-0814-1
"B10,C1",5658,5850,4114,1736,3388,0,1797,1801,1257,544,2.310661765,900,916,718,202,0,202,0,44,0,0.014851485,empty,mBC-0814-1
"B10,C2",5421,5794,3840,1954,3417,4,1863,1870,1332,538,2.475836431,989,8132,3044,1006,0,1006,0,145,0,0.047713718,empty,mBC-0814-1
"B10,C3",5879,6230,4204,2026,3646,0,1998,2002,1427,575,2.48173913,1028,487,276,111,0,111,0,32,0,0,empty,mBC-0814-1
"B10,C4",471378,522285,317540,204745,312214,0,190817,191012,151910,39102,3.884967521,111286,14505,9950,2717,1,2716,1,447,0,0.004786451,mm10,mBC-0814-1
"B10,C5",758691,865413,510931,354482,503778,1,306663,307050,263983,43067,6.12958878,179581,323782,230335,67023,38,66985,8,3193,0,0.001015153,mm10,mBC-0814-1
"B10,C6",5517,5715,3980,1735,3453,0,1848,1855,1361,494,2.755060729,959,1229,889,267,0,267,0,69,0,0,empty,mBC-0814-1
"B10,C7",7404,8045,5331,2714,4661,3,2520,2526,1757,769,2.284785436,1369,551,402,104,0,104,0,22,0,0,empty,mBC-0814-1
"B10,C8",5429,5683,3973,1710,3353,0,1728,1730,1209,521,2.320537428,861,1933,1293,416,0,416,0,91,0,0.033653846,empty,mBC-0814-1
"B10,C9",263285,304855,169425,135430,178670,0,115908,116030,85707,30323,2.826468357,70640,82141,55127,15564,12,15552,2,1263,0,0.004822531,mm10,mBC-0814-1
"B10,C10",5774,6167,4176,1991,3545,0,1865,1866,1348,518,2.602316602,969,1858,1076,334,0,334,0,61,0,0,empty,mBC-0814-1
"B10,C11",4915,5421,3549,1872,3132,0,1752,1752,1271,481,2.642411642,939,1743,1192,381,0,381,0,64,0,0,empty,mBC-0814-1
"B10,C12",8364,9244,5852,3392,5383,0,2933,2937,2115,822,2.572992701,1647,10196,3988,1231,2,1229,2,164,0,0.061025224,empty,mBC-0814-1
"B10,D1",4574,4933,3285,1648,2861,0,1591,1592,1126,466,2.416309013,831,832,527,181,0,181,0,41,0,0,empty,mBC-0814-1
"B10,D2",5423,5681,3983,1698,3241,0,1632,1634,1128,506,2.229249012,808,1749,1307,398,0,398,0,88,0,0,empty,mBC-0814-1
"B10,D3",11088,11859,7902,3957,6933,0,3719,3723,2610,1113,2.345013477,2019,7579,2974,858,3,855,1,141,0,0.01754386,empty,mBC-0814-1
"B10,D4",4776,5128,3426,1702,3039,0,1692,1694,1186,508,2.334645669,880,1608,1100,316,2,314,1,75,0,0.003184713,empty,mBC-0814-1
"B10,D5",4317,4819,3014,1805,2907,0,1654,1654,1191,463,2.572354212,946,2146,1421,403,1,402,1,109,0,0,empty,mBC-0814-1
"B10,D6",4939,5418,3573,1845,3121,0,1693,1693,1264,429,2.946386946,903,1657,1253,337,0,337,0,55,0,0,empty,mBC-0814-1
"B10,D7",5896,6141,4268,1873,3610,0,1869,1871,1359,512,2.654296875,942,3401,2443,667,0,667,0,121,0,0.002998501,empty,mBC-0814-1
"B10,D8",4801,5181,3456,1725,3048,0,1644,1650,1187,463,2.563714903,847,967,669,230,0,230,0,47,0,0,empty,mBC-0814-1
"B10,D9",3242,3532,2279,1253,2024,1,1113,1114,784,330,2.375757576,617,1578,1106,338,0,338,0,68,0,0,empty,mBC-0814-1
"B10,D10",3702,3957,2629,1328,2308,0,1256,1257,925,332,2.786144578,674,846,581,192,0,192,0,51,0,0,empty,mBC-0814-1
"B10,D11",528651,617058,350750,266308,363954,0,228445,228714,197442,31272,6.313699156,137360,350018,245300,68973,44,68929,4,3267,0,0.001073568,mm10,mBC-0814-1
"B10,D12",6346,6802,4527,2275,4034,0,2168,2174,1485,689,2.155297533,1169,3623,2744,714,1,713,1,123,0,0,empty,mBC-0814-1
"B10,E1",699433,773598,477164,296434,450709,0,270514,270796,196040,74756,2.622398202,154486,171339,125233,35424,22,35402,3,2240,0,0.000338964,mm10,mBC-0814-1
"B10,E2",3482,3819,2485,1334,2299,0,1263,1267,901,366,2.461748634,695,1352,910,282,0,282,0,73,0,0,empty,mBC-0814-1
"B10,E3",3516,3795,2509,1286,2151,0,1126,1126,798,328,2.432926829,594,1952,1393,405,1,404,1,85,0,0,empty,mBC-0814-1
"B10,E4",3205,3536,2325,1211,2033,0,1071,1075,751,324,2.317901235,575,996,723,235,0,235,0,59,0,0,empty,mBC-0814-1
"B10,E5",3776,3976,2847,1129,2333,0,1214,1216,859,357,2.406162465,599,1418,1041,254,0,254,0,44,0,0,empty,mBC-0814-1
"B10,E6",4751,5081,3449,1632,2919,0,1502,1503,1105,398,2.77638191,776,1308,915,342,1,341,1,84,0,0,empty,mBC-0814-1
"B10,E7",634405,717820,431638,286182,416029,0,251987,252306,216475,35831,6.041556194,146113,42845,20475,5911,8,5903,3,750,0,0.062171777,mm10,mBC-0814-1
"B10,E8",4761,5035,3448,1587,2936,0,1550,1553,1135,418,2.715311005,774,2336,1671,571,2,569,1,100,0,0.043936731,empty,mBC-0814-1
"B10,E9",3240,3437,2339,1098,2024,0,1089,1091,752,339,2.218289086,535,1840,1272,430,0,430,0,81,0,0,empty,mBC-0814-1
"B10,E10",4072,4459,2885,1574,2637,0,1459,1459,1013,446,2.271300448,788,2372,1638,502,0,502,0,103,0,0,empty,mBC-0814-1
"B10,E11",4130,4310,3016,1294,2548,0,1339,1339,933,406,2.298029557,669,2680,1449,463,0,463,0,82,0,0.025917927,empty,mBC-0814-1
"B10,E12",4157,4588,2943,1645,2713,0,1527,1534,1108,426,2.600938967,841,1421,1041,283,0,283,0,63,0,0,empty,mBC-0814-1
"B10,F1",4776,5100,3454,1646,3006,2,1582,1585,1154,431,2.6774942,830,1985,1313,397,0,397,0,78,0,0,empty,mBC-0814-1
"B10,F2",6625,7168,4710,2458,4169,1,2258,2262,1641,621,2.642512077,1227,12559,4225,1423,1,1422,1,187,0,0.040787623,empty,mBC-0814-1
"B10,F3",5093,5344,3634,1710,3132,0,1624,1629,1215,414,2.934782609,832,1933,1297,360,1,359,1,85,0,0.027855153,empty,mBC-0814-1
"B10,F4",5349,5870,3788,2082,3429,0,1867,1872,1421,451,3.150776053,1043,350,274,124,0,124,0,30,0,0,empty,mBC-0814-1
"B10,F5",5229,5612,3808,1804,3224,0,1689,1693,1198,495,2.42020202,872,1395,870,271,0,271,0,62,0,0.003690037,empty,mBC-0814-1
"B10,F6",5108,5671,3632,2039,3244,0,1824,1825,1266,559,2.264758497,991,1871,1323,446,0,446,0,92,0,0.098654709,empty,mBC-0814-1
"B10,F7",4721,5014,3349,1665,2882,0,1553,1558,1101,457,2.409190372,836,852,529,160,0,160,0,39,0,0,empty,mBC-0814-1
"B10,F8",6545,6555,4627,1928,3863,0,2116,2116,1544,572,2.699300699,1056,4071,1150,349,1,348,1,41,0,0.086206897,empty,mBC-0814-1
"B10,F9",5659,6054,4184,1870,3576,0,1873,1877,1337,540,2.475925926,948,2285,1604,512,0,512,0,102,0,0,empty,mBC-0814-1
"B10,F10",6742,7055,4845,2210,4131,0,2208,2215,1614,601,2.685524126,1132,1654,1185,336,0,336,0,78,0,0,empty,mBC-0814-1
"B10,F11",4437,4820,3161,1659,2836,0,1546,1555,1128,427,2.641686183,848,1363,1010,305,0,305,0,64,0,0.042622951,empty,mBC-0814-1
"B10,F12",4780,5118,3434,1684,2931,0,1590,1592,1087,505,2.152475248,825,51,17,9,0,9,0,9,0,0,empty,mBC-0814-1
"B10,G1",7342,8057,5304,2753,4776,0,2587,2601,1857,744,2.495967742,1412,4015,2902,849,0,849,0,168,0,0.010600707,empty,mBC-0814-1
"B10,G2",5973,6028,4310,1718,3528,0,1844,1844,1333,511,2.608610568,892,451,279,108,0,108,0,30,0,0.009259259,empty,mBC-0814-1
"B10,G3",5205,5677,3583,2094,3285,0,1867,1872,1324,548,2.416058394,1036,2136,1440,507,0,507,0,124,0,0,empty,mBC-0814-1
"B10,G4",5458,5775,3898,1877,3305,0,1691,1694,1209,485,2.492783505,884,4,4,2,0,2,0,1,0,0,empty,mBC-0814-1
"B10,G5",4693,5201,3373,1828,3006,0,1635,1637,1165,472,2.468220339,902,1430,960,374,0,374,0,76,0,0,empty,mBC-0814-1
"B10,G6",9150,9723,6509,3214,5620,0,2991,2992,2140,852,2.511737089,1548,186,121,42,0,42,0,16,0,0.119047619,empty,mBC-0814-1
"B10,G7",5389,5835,3922,1913,3464,0,1869,1871,1353,518,2.611969112,978,3426,2295,664,0,664,0,125,0,0.013554217,empty,mBC-0814-1
"B10,G8",7034,7802,5006,2796,4771,0,2716,2716,1919,797,2.407779172,1522,3709,2598,803,0,803,0,160,0,0.02366127,empty,mBC-0814-1
"B10,G9",5462,5800,3878,1922,3456,3,1894,1901,1369,532,2.573308271,1027,2981,2085,657,2,655,1,139,0,0.004580153,empty,mBC-0814-1
"B10,G10",9312,9986,6685,3301,5781,0,3113,3115,2211,904,2.44579646,1659,3488,2525,779,0,779,0,157,0,0.024390244,empty,mBC-0814-1
"B10,G11",1093920,1241045,736565,504480,723890,1,447643,448145,363712,84433,4.307699596,262708,228042,158990,45229,37,45192,3,2744,0,0.00019915,mm10,mBC-0814-1
"B10,G12",4702,5283,3327,1956,3065,1,1707,1714,1225,489,2.505112474,945,2105,1537,442,0,442,0,96,0,0,empty,mBC-0814-1
"B10,H1",4985,5547,3553,1994,3234,0,1808,1813,1266,547,2.314442413,992,1072,667,231,0,231,0,55,0,0.051948052,empty,mBC-0814-1
"B10,H2",556593,653247,363485,289762,386417,1,251907,252178,186568,65610,2.843590916,153635,79567,53559,15474,10,15464,3,1265,0,0.002586653,mm10,mBC-0814-1
"B10,H3",5374,5776,3833,1943,3384,0,1815,1822,1267,555,2.282882883,973,1702,1091,380,1,379,1,97,0,0.047493404,empty,mBC-0814-1
"B10,H4",471205,534518,324176,210342,318026,1,188036,188259,146583,41676,3.517204146,113327,6602,3050,934,5,929,1,127,0,0.166846071,empty,mBC-0814-1
"B10,H5",7115,7582,4992,2590,4366,0,2386,2393,1718,675,2.545185185,1288,3348,2018,652,0,652,0,103,0,0.044478528,empty,mBC-0814-1
"B10,H6",6592,7000,4829,2171,4051,0,2129,2134,1507,627,2.403508772,1090,2469,1786,572,0,572,0,114,0,0,empty,mBC-0814-1
"B10,H7",461393,510107,317862,192245,305135,2,180216,180440,145828,34612,4.213220848,103400,42443,30240,8416,5,8411,2,846,0,0,mm10,mBC-0814-1
"B10,H8",499441,574417,331054,243363,338003,0,212670,212872,170100,42772,3.976900776,127307,156234,110579,31903,23,31880,2,2162,0,0.000784191,mm10,mBC-0814-1
"B10,H9",5783,6157,4065,2092,3665,0,2009,2015,1482,533,2.780487805,1085,1607,1122,326,0,326,0,55,0,0,empty,mBC-0814-1
"B10,H10",3753,4145,2658,1487,2403,1,1314,1315,956,359,2.662952646,721,953,668,205,0,205,0,48,0,0,empty,mBC-0814-1
"B10,H11",3778,4173,2718,1455,2470,0,1380,1383,947,436,2.172018349,725,91,51,14,0,14,0,4,0,0,empty,mBC-0814-1
"B10,H12",2630,2969,1871,1098,1730,0,974,977,693,284,2.440140845,554,1368,933,253,0,253,0,64,0,0,empty,mBC-0814-1
"B11,A1",5709,6219,4102,2117,3672,0,2026,2031,1481,550,2.692727273,1092,1624,1151,349,2,347,1,63,0,0,empty,mBC-0814-1
"B11,A2",6268,6424,4551,1873,3766,0,1993,1998,1452,546,2.659340659,953,6385,2447,891,0,891,0,123,0,0.063973064,empty,mBC-0814-1
"B11,A3",428209,491921,289514,202407,289504,0,176717,176937,148121,28816,5.140234592,104580,130510,92912,26527,12,26515,4,1833,0,0.001018292,mm10,mBC-0814-1
"B11,A4",6100,6604,4492,2112,3899,0,2072,2072,1394,678,2.056047198,1089,549,316,108,0,108,0,28,0,0,empty,mBC-0814-1
"B11,A5",4943,5136,3580,1556,3010,3,1571,1575,1105,470,2.35106383,764,1151,816,297,0,297,0,62,0,0.02020202,empty,mBC-0814-1
"B11,A6",3863,4017,2776,1241,2431,0,1305,1307,890,417,2.134292566,659,1412,1007,317,0,317,0,59,0,0,empty,mBC-0814-1
"B11,A7",5808,6161,4123,2038,3710,0,2032,2041,1438,603,2.384742952,1093,1626,1183,297,1,296,1,67,0,0,empty,mBC-0814-1
"B11,A8",2378,2663,1644,1019,1612,0,914,917,666,251,2.653386454,535,1421,889,268,0,268,0,66,0,0,empty,mBC-0814-1
"B11,A9",6907,7541,4971,2570,4298,0,2293,2298,1643,655,2.508396947,1257,1535,1102,306,0,306,0,63,0,0,empty,mBC-0814-1
"B11,A10",272536,307687,185179,122508,184957,2,112074,112190,88114,24076,3.659827214,65638,8388,6073,1787,0,1787,0,232,0,0,mm10,mBC-0814-1
"B11,A11",5080,5569,3647,1922,3324,11,1844,1862,1335,527,2.533206831,1015,1880,1367,373,0,373,0,88,0,0,empty,mBC-0814-1
"B11,A12",4858,5281,3392,1889,3129,0,1763,1765,1296,469,2.763326226,968,4149,2278,675,0,675,0,153,0,0,empty,mBC-0814-1
"B11,B1",457710,532156,307535,224621,315530,0,196094,196276,155627,40649,3.828556668,116989,145533,107228,32067,16,32051,3,2086,0,0.000156001,mm10,mBC-0814-1
"B11,B2",5310,5715,3608,2107,3359,0,1837,1839,1304,535,2.437383178,1062,411,276,120,0,120,0,28,0,0,empty,mBC-0814-1
"B11,B3",4437,4854,3117,1737,2907,0,1652,1656,1178,478,2.464435146,896,1075,763,219,0,219,0,51,0,0,empty,mBC-0814-1
"B11,B4",4694,5068,3316,1752,2997,0,1653,1653,1187,466,2.5472103,889,4102,1476,477,1,476,1,86,0,0.00210084,empty,mBC-0814-1
"B11,B5",494634,328588,184323,144265,237747,4,150199,150833,109941,40892,2.688569891,94227,49848,34400,9691,7,9684,2,957,0,0.000206526,mm10,mBC-0814-1
"B11,B6",4340,4593,3196,1397,2725,0,1472,1472,1073,399,2.689223058,734,1329,941,269,0,269,0,42,0,0,empty,mBC-0814-1
"B11,B7",5694,6264,4096,2168,3638,0,2002,2008,1480,528,2.803030303,1062,1300,984,343,0,343,0,56,0,0,empty,mBC-0814-1
"B11,B8",3775,3961,2750,1211,2367,3,1243,1247,889,358,2.483240223,643,974,659,222,0,222,0,47,0,0.027027027,empty,mBC-0814-1
"B11,B9",5073,5776,3600,2176,3326,0,1894,1896,1366,530,2.577358491,1064,933,632,216,0,216,0,54,0,0,empty,mBC-0814-1
"B11,B10",4670,4823,3248,1575,2957,0,1648,1652,1200,452,2.654867257,859,559,407,143,0,143,0,27,0,0,empty,mBC-0814-1
"B11,B11",6807,7258,4914,2344,4212,0,2223,2223,1565,658,2.378419453,1192,92,58,28,0,28,0,13,0,0,empty,mBC-0814-1
"B11,B12",5703,6135,4094,2041,3590,0,1967,1969,1420,549,2.586520947,1017,964,695,182,0,182,0,44,0,0,empty,mBC-0814-1
"B11,C1",5811,6337,4182,2155,3590,0,1926,1928,1410,518,2.722007722,994,686,483,147,0,147,0,36,0,0,empty,mBC-0814-1
"B11,C2",5569,5969,4058,1911,3479,0,1847,1854,1327,527,2.518026565,988,1498,1067,315,0,315,0,79,0,0.003174603,empty,mBC-0814-1
"B11,C3",5871,6364,4220,2144,3762,1,2059,2062,1477,585,2.524786325,1107,470,291,130,0,130,0,46,0,0.007692308,empty,mBC-0814-1
"B11,C4",5602,5856,4086,1770,3478,0,1836,1836,1316,520,2.530769231,887,1452,1036,325,1,324,1,70,0,0,empty,mBC-0814-1
"B11,C5",7491,8174,5355,2819,4786,0,2577,2579,1901,678,2.803834808,1397,1520,1036,365,0,365,0,93,0,0,empty,mBC-0814-1
"B11,C6",617364,725217,405499,319718,435176,1,280483,280800,206910,73890,2.800243605,170286,133858,98073,28281,16,28265,3,1984,0,0,mm10,mBC-0814-1
"B11,C7",7121,7773,5080,2693,4652,0,2543,2547,1853,694,2.670028818,1375,223,146,39,0,39,0,12,0,0,empty,mBC-0814-1
"B11,C8",5777,6000,4161,1839,3492,0,1869,1874,1339,535,2.502803738,912,1391,947,308,0,308,0,82,0,0,empty,mBC-0814-1
"B11,C9",4970,5373,3544,1829,3161,0,1683,1687,1253,434,2.887096774,885,1159,833,185,0,185,0,54,0,0.016216216,empty,mBC-0814-1
"B11,C10",5942,6416,4323,2093,3680,0,1966,1970,1402,568,2.468309859,1050,1173,837,256,0,256,0,48,0,0.02734375,empty,mBC-0814-1
"B11,C11",4739,5102,3383,1719,3022,0,1676,1680,1177,503,2.339960239,898,1687,1101,351,0,351,0,69,0,0.056980057,empty,mBC-0814-1
"B11,C12",8616,9576,6121,3455,5526,0,3046,3051,2159,892,2.420403587,1664,1811,1231,349,0,349,0,91,0,0,empty,mBC-0814-1
"B11,D1",4625,4963,3252,1711,2958,0,1554,1556,1145,411,2.785888078,875,448,289,72,0,72,0,24,0,0,empty,mBC-0814-1
"B11,D2",5210,5447,3754,1693,3242,0,1702,1704,1232,472,2.610169492,872,5438,2125,754,0,754,0,102,0,0.122015915,empty,mBC-0814-1
"B11,D3",11115,11768,8055,3713,6943,0,3694,3700,2567,1133,2.265666372,1925,2752,1793,570,0,570,0,109,0,0.001754386,empty,mBC-0814-1
"B11,D4",4955,5391,3588,1803,3173,0,1678,1681,1203,478,2.516736402,862,1584,1029,291,0,291,0,76,0,0.003436426,empty,mBC-0814-1
"B11,D5",4992,5535,3469,2066,3309,0,1892,1898,1410,488,2.889344262,1062,2216,1588,488,1,487,1,95,0,0,empty,mBC-0814-1
"B11,D6",5063,5538,3617,1921,3186,0,1697,1701,1267,434,2.919354839,903,1395,984,281,0,281,0,58,0,0,empty,mBC-0814-1
"B11,D7",6256,6577,4448,2129,3892,0,2073,2077,1491,586,2.544368601,1084,2337,1631,411,0,411,0,89,0,0.00729927,empty,mBC-0814-1
"B11,D8",5164,5584,3708,1876,3304,0,1758,1762,1308,454,2.881057269,969,1082,771,282,0,282,0,54,0,0,empty,mBC-0814-1
"B11,D9",3367,3497,2380,1117,2073,0,1115,1115,777,338,2.298816568,552,1150,775,230,0,230,0,44,0,0.034782609,empty,mBC-0814-1
"B11,D10",4011,4363,2821,1542,2474,0,1382,1382,965,417,2.314148681,732,793,561,212,0,212,0,39,0,0.146226415,empty,mBC-0814-1
"B11,D11",4414,4837,3141,1696,2808,6,1575,1582,1124,458,2.454148472,846,1555,1115,356,0,356,0,106,0,0.036516854,empty,mBC-0814-1
"B11,D12",6709,7307,4815,2492,4250,0,2340,2342,1646,696,2.364942529,1246,2742,1887,532,0,532,0,94,0,0.001879699,empty,mBC-0814-1
"B11,E1",5139,5444,3693,1751,3241,0,1677,1682,1199,483,2.482401656,907,1446,929,289,1,288,1,57,0,0.027777778,empty,mBC-0814-1
"B11,E2",3801,3915,2798,1117,2347,0,1236,1238,857,381,2.249343832,593,1173,847,266,0,266,0,67,0,0.071428571,empty,mBC-0814-1
"B11,E3",3407,3575,2453,1122,2113,0,1086,1089,835,254,3.287401575,563,1156,863,283,0,283,0,57,0,0,empty,mBC-0814-1
"B11,E4",3205,3511,2284,1227,2084,0,1156,1157,787,370,2.127027027,645,732,454,154,0,154,0,48,0,0,empty,mBC-0814-1
"B11,E5",135198,151804,95426,56378,88243,0,50790,50860,43424,7436,5.839698763,28480,28498,20339,5560,6,5554,1,582,0,0,mm10,mBC-0814-1
"B11,E6",4611,4893,3347,1546,2820,0,1476,1476,1104,372,2.967741935,737,959,675,213,0,213,0,52,0,0,empty,mBC-0814-1
"B11,E7",4626,4930,3385,1545,2864,0,1502,1505,1099,406,2.706896552,777,1013,739,197,0,197,0,48,0,0,empty,mBC-0814-1
"B11,E8",4726,4855,3455,1400,2818,0,1447,1455,1034,421,2.456057007,723,1919,1430,456,0,456,0,73,0,0.035087719,empty,mBC-0814-1
"B11,E9",3739,3971,2661,1310,2351,0,1269,1272,930,342,2.719298246,687,1117,789,300,0,300,0,67,0,0.023333333,empty,mBC-0814-1
"B11,E10",4212,4562,3048,1514,2681,0,1487,1487,1047,440,2.379545455,787,1296,841,322,0,322,0,79,0,0,empty,mBC-0814-1
"B11,E11",4415,4651,3230,1421,2787,0,1477,1477,1070,407,2.628992629,704,1204,921,310,0,310,0,62,0,0,empty,mBC-0814-1
"B11,E12",4461,4803,3129,1674,2797,0,1525,1531,1064,467,2.278372591,835,871,620,209,0,209,0,47,0,0.09569378,empty,mBC-0814-1
"B11,F1",4944,5233,3610,1623,2991,0,1506,1506,1080,426,2.535211268,783,3182,1635,515,0,515,0,85,0,0.025242718,empty,mBC-0814-1
"B11,F2",6890,7090,4911,2179,4164,0,2225,2228,1599,629,2.542130366,1116,10866,4114,1319,2,1317,1,222,0,0.114654518,empty,mBC-0814-1
"B11,F3",5250,5772,3820,1952,3419,1,1887,1890,1391,499,2.78757515,1010,1377,974,313,0,313,0,74,0,0,empty,mBC-0814-1
"B11,F4",5613,6004,3997,2007,3557,4,1907,1914,1346,568,2.36971831,1031,390,268,101,0,101,0,29,0,0,empty,mBC-0814-1
"B11,F5",5447,6022,3877,2145,3433,0,1940,1940,1430,510,2.803921569,1066,1397,987,266,0,266,0,64,0,0,empty,mBC-0814-1
"B11,F6",5439,5884,3938,1946,3466,0,1850,1853,1301,552,2.356884058,997,1720,1108,386,0,386,0,98,0,0,empty,mBC-0814-1
"B11,F7",637860,751174,425753,325421,444773,0,283202,283487,234292,49195,4.762516516,171008,66592,47946,13876,5,13871,1,1256,0,0.000216279,mm10,mBC-0814-1
"B11,F8",6241,6759,4448,2311,4026,0,2195,2199,1592,607,2.622734761,1175,471,384,95,0,95,0,18,0,0,empty,mBC-0814-1
"B11,F9",5649,5955,4205,1750,3484,0,1810,1814,1289,525,2.455238095,871,2156,1637,421,0,421,0,86,0,0.016627078,empty,mBC-0814-1
"B11,F10",6418,6848,4634,2214,4039,0,2105,2109,1510,599,2.520868114,1103,1337,946,334,0,334,0,69,0,0.050898204,empty,mBC-0814-1
"B11,F11",4557,4774,3332,1442,2868,0,1539,1541,1119,422,2.651658768,793,1273,862,258,0,258,0,48,0,0.050387597,empty,mBC-0814-1
"B11,F12",5113,5570,3660,1910,3224,0,1742,1746,1291,455,2.837362637,918,140,101,31,0,31,0,9,0,0,empty,mBC-0814-1
"B11,G1",643606,721551,438212,283339,422175,0,252653,252967,217823,35144,6.198013886,145346,262572,189943,55628,36,55592,6,2879,0,0.002140596,mm10,mBC-0814-1
"B11,G2",5968,6343,4274,2069,3725,0,2021,2031,1510,521,2.898272553,1087,541,417,128,0,128,0,22,0,0,empty,mBC-0814-1
"B11,G3",556465,662740,365414,297326,390911,0,253924,254173,191500,62673,3.055542259,156013,176995,130947,37793,21,37772,3,2240,0,0.000503018,mm10,mBC-0814-1
"B11,G4",5422,5760,3985,1775,3297,0,1730,1731,1265,466,2.714592275,859,1,0,0,0,0,0,0,0,0,empty,mBC-0814-1
"B11,G5",4791,5118,3402,1716,3012,0,1636,1639,1160,479,2.4217119,877,1318,869,266,0,266,0,56,0,0,empty,mBC-0814-1
"B11,G6",9411,10045,6855,3190,5793,0,3025,3025,2251,774,2.908268734,1560,1418,499,180,0,180,0,33,0,0,empty,mBC-0814-1
"B11,G7",5879,6330,4230,2100,3792,5,2067,2073,1483,590,2.513559322,1115,2215,1636,460,0,460,0,78,0,0,empty,mBC-0814-1
"B11,G8",8064,8573,5719,2854,5036,0,2773,2776,1985,791,2.509481669,1460,5019,2637,841,0,841,0,172,0,0.009512485,empty,mBC-0814-1
"B11,G9",498706,580584,334173,246411,342582,1,213582,213820,167142,46678,3.580744676,128457,210613,153039,43916,26,43890,2,2473,0,4.55685E-05,mm10,mBC-0814-1
"B11,G10",9627,10215,7007,3208,5996,0,3192,3197,2273,924,2.45995671,1632,2153,1536,506,0,506,0,144,0,0.0256917,empty,mBC-0814-1
"B11,G11",9540,10195,6844,3351,5983,0,3192,3195,2232,963,2.317757009,1713,1152,760,263,0,263,0,81,0,0,empty,mBC-0814-1
"B11,G12",5052,5336,3646,1690,3161,0,1734,1737,1245,492,2.530487805,894,2183,1635,425,0,425,0,83,0,0,empty,mBC-0814-1
"B11,H1",4761,5103,3365,1738,3004,0,1658,1660,1166,494,2.360323887,885,1421,954,236,0,236,0,48,0,0,empty,mBC-0814-1
"B11,H2",8285,8839,5996,2843,5229,0,2877,2877,2029,848,2.392688679,1463,3329,2263,772,0,772,0,160,0,0.047927461,empty,mBC-0814-1
"B11,H3",638367,731068,426434,304634,427021,0,265802,266076,222493,43583,5.105040956,157871,144476,104361,29927,10,29917,2,1954,0,0.000434536,mm10,mBC-0814-1
"B11,H4",5727,6212,4065,2147,3719,3,2063,2069,1498,571,2.623467601,1147,56,37,23,1,22,1,10,0,0,empty,mBC-0814-1
"B11,H5",649788,745975,427897,318078,430651,0,267323,267665,205169,62496,3.282914107,159801,357212,242117,69386,36,69350,3,3399,0,0.001874549,mm10,mBC-0814-1
"B11,H6",6464,6907,4741,2166,4115,3,2238,2246,1626,620,2.622580645,1179,2353,1760,568,2,566,1,98,0,0,empty,mBC-0814-1
"B11,H7",5580,6117,4005,2112,3555,0,1984,1986,1371,615,2.229268293,1060,2673,1463,400,0,400,0,59,0,0,empty,mBC-0814-1
"B11,H8",514211,581330,340938,240392,341567,1,215332,215564,156642,58922,2.658463732,128113,50396,35787,10360,5,10355,1,1086,0,0,mm10,mBC-0814-1
"B11,H9",5215,5540,3721,1819,3290,0,1825,1827,1271,556,2.285971223,960,1100,780,275,0,275,0,58,0,0.047272727,empty,mBC-0814-1
"B11,H10",3895,4208,2774,1434,2440,0,1358,1359,978,381,2.566929134,732,836,598,182,0,182,0,51,0,0,empty,mBC-0814-1
"B11,H11",4141,4631,2918,1713,2780,0,1569,1570,1129,441,2.560090703,881,28,24,15,0,15,0,11,0,0,empty,mBC-0814-1
"B11,H12",422556,497363,272402,224961,295555,1,192800,193018,161679,31339,5.159035068,118055,124071,89459,25925,12,25913,3,1776,0,0.000385907,mm10,mBC-0814-1
"B12,A1",5770,6035,4116,1919,3458,0,1834,1836,1352,484,2.79338843,922,1486,1055,321,0,321,0,70,0,0,empty,mBC-0814-1
"B12,A2",4981,5330,3645,1685,3181,2,1674,1677,1197,480,2.49375,886,1524,985,320,0,320,0,101,0,0.0125,empty,mBC-0814-1
"B12,A3",4709,5112,3408,1704,2977,0,1594,1595,1146,449,2.55233853,863,631,352,146,0,146,0,40,0,0,empty,mBC-0814-1
"B12,A4",5593,6048,4012,2036,3450,0,1816,1817,1316,501,2.626746507,988,539,358,136,0,136,0,27,0,0,empty,mBC-0814-1
"B12,A5",5022,5220,3532,1688,3056,0,1611,1613,1146,467,2.453961456,844,8696,3182,1050,4,1046,1,145,0,0.043977055,empty,mBC-0814-1
"B12,A6",10733,12162,7404,4758,7401,0,4411,4420,3236,1184,2.733108108,2553,8737,2924,945,3,942,1,125,0,0.032908705,empty,mBC-0814-1
"B12,A7",5507,5850,3863,1987,3380,0,1849,1850,1296,554,2.339350181,939,12042,4098,1213,1,1212,1,149,0,0.067656766,empty,mBC-0814-1
"B12,A8",2113,2228,1512,716,1355,0,719,719,495,224,2.209821429,379,1551,1032,312,0,312,0,78,0,0.003205128,empty,mBC-0814-1
"B12,A9",7497,7952,5368,2584,4692,0,2512,2523,1824,699,2.60944206,1342,1750,1282,367,1,366,1,61,0,0,empty,mBC-0814-1
"B12,A10",3522,3820,2498,1322,2241,0,1182,1183,819,364,2.25,671,149,80,34,0,34,0,9,0,0,empty,mBC-0814-1
"B12,A11",4722,5026,3491,1535,2937,0,1545,1545,1116,429,2.601398601,776,1838,1295,417,1,416,1,81,0,0,empty,mBC-0814-1
"B12,A12",308759,353811,205101,148710,210249,0,127858,127999,110068,17931,6.138419497,77291,756696,478478,129279,101,129178,7,5008,0,0.000410287,mm10,mBC-0814-1
"B12,B1",4679,4912,3402,1510,2876,0,1534,1534,1062,472,2.25,762,1429,948,291,0,291,0,71,0,0.037800687,empty,mBC-0814-1
"B12,B2",4832,5059,3330,1729,2912,0,1587,1589,1128,461,2.446854664,884,401,288,102,0,102,0,30,0,0.235294118,empty,mBC-0814-1
"B12,B3",4108,4460,2937,1523,2661,0,1471,1471,1029,442,2.328054299,776,925,593,176,0,176,0,44,0,0,empty,mBC-0814-1
"B12,B4",485393,547268,332914,214354,328070,0,199571,199776,151248,48528,3.116716123,116085,35472,14570,4129,5,4124,2,519,0,0.02643065,mm10,mBC-0814-1
"B12,B5",3535,2267,1423,844,1647,0,901,910,668,242,2.760330579,528,1386,980,246,0,246,0,60,0,0.004065041,empty,mBC-0814-1
"B12,B6",3926,4215,2815,1400,2500,0,1345,1346,986,360,2.738888889,743,1864,1367,377,0,377,0,60,0,0,empty,mBC-0814-1
"B12,B7",5360,5645,3874,1771,3362,0,1837,1839,1304,535,2.437383178,946,1809,1343,463,0,463,0,71,0,0.002159827,empty,mBC-0814-1
"B12,B8",3843,3871,2787,1084,2307,0,1194,1198,890,308,2.88961039,561,892,671,187,0,187,0,36,0,0,empty,mBC-0814-1
"B12,B9",4578,5146,3248,1898,2950,0,1652,1654,1180,474,2.489451477,947,1093,808,246,0,246,0,48,0,0,empty,mBC-0814-1
"B12,B10",4303,4576,2962,1614,2802,0,1538,1540,1099,441,2.492063492,840,189,97,35,0,35,0,17,0,0,empty,mBC-0814-1
"B12,B11",6324,6717,4547,2170,3968,0,2101,2106,1508,598,2.52173913,1128,229,161,51,0,51,0,16,0,0,empty,mBC-0814-1
"B12,B12",5242,5613,3810,1803,3330,0,1748,1752,1218,534,2.280898876,930,1367,1033,331,0,331,0,65,0,0.051359517,empty,mBC-0814-1
"B12,C1",5544,5943,4007,1936,3400,0,1770,1770,1275,495,2.575757576,943,763,413,145,0,145,0,33,0,0,empty,mBC-0814-1
"B12,C2",4857,5237,3566,1671,3058,0,1633,1635,1165,470,2.478723404,861,1857,1298,399,0,399,0,100,0,0,empty,mBC-0814-1
"B12,C3",5940,6251,4254,1997,3621,0,1936,1936,1381,555,2.488288288,999,808,580,167,0,167,0,35,0,0,empty,mBC-0814-1
"B12,C4",5091,5376,3587,1789,3142,1,1671,1677,1168,509,2.294695481,886,8840,3024,958,2,956,2,130,0,0.074267782,empty,mBC-0814-1
"B12,C5",21696,22295,15009,7286,13193,0,6997,7004,5313,1691,3.141927853,3738,2646,1562,456,1,455,1,89,0,0.032967033,empty,mBC-0814-1
"B12,C6",5424,5759,3931,1828,3514,0,1874,1881,1333,548,2.432481752,980,3885,1629,463,0,463,0,84,0,0.095032397,empty,mBC-0814-1
"B12,C7",7451,7678,5368,2310,4480,0,2386,2388,1762,626,2.814696486,1216,119,81,49,0,49,0,21,0,0,empty,mBC-0814-1
"B12,C8",5502,5929,3996,1933,3472,0,1842,1848,1279,569,2.247803163,994,10278,4001,1112,1,1111,1,132,0,0.129612961,empty,mBC-0814-1
"B12,C9",4633,4812,3298,1514,2832,0,1554,1555,1097,458,2.395196507,803,3491,1206,361,0,361,0,68,0,0,empty,mBC-0814-1
"B12,C10",5774,6294,4256,2038,3607,0,1879,1881,1321,560,2.358928571,959,1208,963,249,0,249,0,57,0,0.020080321,empty,mBC-0814-1
"B12,C11",4775,5244,3432,1812,3044,1,1714,1716,1223,493,2.480730223,921,3511,1145,357,3,354,3,71,0,0.005649718,empty,mBC-0814-1
"B12,C12",8248,8918,5803,3115,5147,0,2852,2857,2091,766,2.729765013,1520,2093,1520,468,0,468,0,84,0,0.032051282,empty,mBC-0814-1
"B12,D1",4443,4851,3156,1695,2791,0,1543,1545,1085,460,2.358695652,839,902,558,207,1,206,1,51,0,0,empty,mBC-0814-1
"B12,D2",5298,5669,3804,1865,3266,0,1692,1694,1182,512,2.30859375,889,1380,968,334,0,334,0,86,0,0.032934132,empty,mBC-0814-1
"B12,D3",10442,11512,7509,4003,6814,0,3720,3733,2632,1101,2.390554042,1999,2497,1713,538,1,537,1,109,0,0.018621974,empty,mBC-0814-1
"B12,D4",4608,4809,3275,1534,2884,0,1542,1545,1073,472,2.273305085,806,6982,2684,829,0,829,0,113,0,0.250904704,empty,mBC-0814-1
"B12,D5",4423,4637,3075,1562,2774,0,1508,1509,1053,456,2.309210526,811,2153,1566,434,0,434,0,112,0,0.013824885,empty,mBC-0814-1
"B12,D6",4932,5502,3596,1906,3188,0,1734,1738,1225,513,2.38791423,982,1137,795,239,0,239,0,55,0,0,empty,mBC-0814-1
"B12,D7",5663,6118,4085,2033,3603,0,1925,1930,1372,558,2.458781362,1011,1958,1323,471,0,471,0,87,0,0.002123142,empty,mBC-0814-1
"B12,D8",5308,5811,3788,2023,3329,0,1835,1836,1323,513,2.578947368,999,1156,847,250,0,250,0,50,0,0,empty,mBC-0814-1
"B12,D9",508912,581338,336258,245080,344893,0,220279,220537,163143,57394,2.84250967,131361,47383,33306,9712,10,9702,2,927,0,0.000103072,mm10,mBC-0814-1
"B12,D10",3650,4173,2597,1576,2405,0,1379,1379,984,395,2.491139241,780,818,636,185,0,185,0,36,0,0,empty,mBC-0814-1
"B12,D11",1132009,1320085,743688,576397,772575,0,499594,500156,386906,113250,3.416388521,300925,443524,318019,87226,44,87182,3,3897,0,6.88215E-05,mm10,mBC-0814-1
"B12,D12",6568,7065,4754,2311,4274,0,2385,2389,1678,711,2.360056259,1296,3273,2367,687,0,687,0,114,0,0.001455604,empty,mBC-0814-1
"B12,E1",4825,5046,3503,1543,3013,0,1598,1601,1123,478,2.349372385,811,2062,1537,448,0,448,0,86,0,0,empty,mBC-0814-1
"B12,E2",3603,3951,2595,1356,2357,0,1253,1255,896,359,2.495821727,679,1076,802,210,0,210,0,52,0,0,empty,mBC-0814-1
"B12,E3",3507,3764,2517,1247,2190,0,1164,1164,817,347,2.354466859,630,1759,1333,388,1,387,1,60,0,0,empty,mBC-0814-1
"B12,E4",3119,3437,2236,1201,1995,0,1116,1120,780,340,2.294117647,611,706,470,134,0,134,0,51,0,0,empty,mBC-0814-1
"B12,E5",3563,3762,2629,1133,2246,0,1127,1129,831,298,2.788590604,573,1273,915,215,0,215,0,37,0,0,empty,mBC-0814-1
"B12,E6",597139,673987,411323,262664,393357,0,237589,237853,174687,63166,2.765522591,137422,104576,75068,21564,10,21554,1,1495,0,4.63951E-05,mm10,mBC-0814-1
"B12,E7",603535,690806,407337,283469,406252,9,251295,251578,191279,60299,3.172175326,148307,140352,102516,28827,15,28812,1,1849,0,0,mm10,mBC-0814-1
"B12,E8",4926,5109,3571,1538,3036,0,1612,1615,1170,445,2.629213483,793,27034,8512,2629,3,2626,2,266,0,0.083015994,empty,mBC-0814-1
"B12,E9",3196,3416,2310,1106,2040,0,1109,1111,790,321,2.46105919,599,1819,1403,432,0,432,0,79,0,0,empty,mBC-0814-1
"B12,E10",4064,4514,2987,1527,2696,0,1475,1481,1039,442,2.350678733,786,1501,930,300,0,300,0,75,0,0.066666667,empty,mBC-0814-1
"B12,E11",4185,4538,2977,1561,2679,1,1491,1499,1034,465,2.223655914,825,1713,1219,402,1,401,1,72,0,0.027431421,empty,mBC-0814-1
"B12,E12",4341,4839,3095,1744,2888,0,1609,1611,1176,435,2.703448276,879,968,503,175,0,175,0,51,0,0.005714286,empty,mBC-0814-1
"B12,F1",4628,5067,3299,1768,2984,0,1613,1615,1156,459,2.518518519,876,1217,765,227,0,227,0,64,0,0.044052863,empty,mBC-0814-1
"B12,F2",6373,6734,4542,2192,3884,0,2024,2026,1501,525,2.859047619,1062,1898,1293,428,0,428,0,113,0,0,empty,mBC-0814-1
"B12,F3",4937,5351,3489,1862,3175,0,1733,1738,1261,477,2.64360587,951,1848,1417,444,0,444,0,101,0,0.101351351,empty,mBC-0814-1
"B12,F4",5398,5709,3895,1814,3412,0,1773,1776,1309,467,2.802997859,902,775,481,106,1,105,1,30,0,0,empty,mBC-0814-1
"B12,F5",4917,5350,3460,1890,3103,0,1715,1719,1202,517,2.324951644,899,1022,758,227,0,227,0,63,0,0,empty,mBC-0814-1
"B12,F6",1102853,1278101,729582,548519,748798,2,474350,474890,407338,67552,6.02999171,285702,494591,359838,101185,83,101102,12,4117,0,0.000939645,mm10,mBC-0814-1
"B12,F7",4696,4934,3396,1538,2898,0,1545,1547,1099,448,2.453125,780,587,425,136,1,135,1,35,0,0,empty,mBC-0814-1
"B12,F8",6353,6851,4544,2307,4014,0,2178,2178,1530,648,2.361111111,1165,158,100,43,0,43,0,10,0,0,empty,mBC-0814-1
"B12,F9",5481,5812,4029,1783,3387,0,1809,1816,1281,535,2.394392523,909,2237,1529,464,0,464,0,90,0,0,empty,mBC-0814-1
"B12,F10",6643,7039,4837,2202,4086,0,2176,2178,1521,657,2.315068493,1134,1483,1079,343,0,343,0,71,0,0.049562682,empty,mBC-0814-1
"B12,F11",5916,4503,3086,1417,2656,0,1349,1349,934,415,2.25060241,688,4291,1610,505,1,504,1,86,0,0,empty,mBC-0814-1
"B12,F12",4797,4992,3400,1592,2898,0,1550,1550,1115,435,2.563218391,778,154,126,36,0,36,0,14,0,0,empty,mBC-0814-1
"B12,G1",7312,7909,5287,2622,4618,0,2450,2454,1795,659,2.723823976,1332,3017,2257,638,0,638,0,130,0,0.031347962,empty,mBC-0814-1
"B12,G2",5742,6039,4193,1846,3570,0,1880,1880,1335,545,2.449541284,958,604,379,102,0,102,0,24,0,0,empty,mBC-0814-1
"B12,G3",5114,5400,3612,1788,3251,12,1764,1782,1272,510,2.494117647,975,1975,1342,423,2,421,1,109,0,0.019002375,empty,mBC-0814-1
"B12,G4",5430,5562,3988,1574,3288,0,1676,1679,1217,462,2.634199134,866,5,4,3,0,3,0,1,0,0,empty,mBC-0814-1
"B12,G5",407871,475724,272138,203586,285156,0,181395,181575,140978,40597,3.47262113,109430,30113,18232,5311,6,5305,1,579,0,0.017719133,mm10,mBC-0814-1
"B12,G6",9011,9486,6594,2892,5511,0,2940,2948,2064,884,2.334841629,1496,182,118,53,0,53,0,13,0,0,empty,mBC-0814-1
"B12,G7",5482,5950,3999,1951,3427,1,1787,1790,1253,537,2.333333333,951,2101,1507,481,0,481,0,97,0,0.002079002,empty,mBC-0814-1
"B12,G8",7218,7753,5150,2603,4700,0,2567,2569,1803,766,2.353785901,1421,4737,2574,782,0,782,0,156,0,0.016624041,empty,mBC-0814-1
"B12,G9",5438,5796,3835,1961,3445,0,1854,1858,1348,510,2.643137255,982,4572,2410,744,0,744,0,148,0,0.038978495,empty,mBC-0814-1
"B12,G10",8931,9555,6501,3054,5650,0,2982,2994,2116,878,2.410022779,1560,2624,1757,515,1,514,1,149,0,0,empty,mBC-0814-1
"B12,G11",9504,10077,6710,3367,5872,0,3140,3143,2222,921,2.412595005,1677,11795,4238,1238,1,1237,1,166,0,0.017784964,empty,mBC-0814-1
"B12,G12",4583,5034,3226,1808,3063,0,1738,1742,1226,516,2.375968992,934,2455,1791,527,0,527,0,106,0,0,empty,mBC-0814-1
"B12,H1",4444,4849,3181,1668,2881,0,1579,1583,1138,445,2.557303371,872,732,518,127,0,127,0,40,0,0,empty,mBC-0814-1
"B12,H2",11262,12242,8016,4226,7373,0,4165,4176,3027,1149,2.634464752,2309,3402,2481,762,0,762,0,153,0,0.001312336,empty,mBC-0814-1
"B12,H3",5519,5739,3954,1785,3390,1,1773,1776,1264,512,2.46875,942,1660,1284,364,0,364,0,80,0,0.049450549,empty,mBC-0814-1
"B12,H4",5534,5816,3868,1948,3388,0,1845,1850,1320,530,2.490566038,982,184,85,30,0,30,0,11,0,0,empty,mBC-0814-1
"B12,H5",6918,7468,4934,2534,4304,0,2322,2328,1682,646,2.60371517,1236,1696,1197,392,0,392,0,76,0,0.048469388,empty,mBC-0814-1
"B12,H6",6282,6564,4480,2084,3855,0,2024,2033,1458,575,2.535652174,1030,2039,1444,449,0,449,0,98,0,0,empty,mBC-0814-1
"B12,H7",5275,5643,3685,1958,3344,1,1821,1828,1302,526,2.475285171,988,1272,921,237,0,237,0,53,0,0,empty,mBC-0814-1
"B12,H8",3990,4264,2888,1376,2535,0,1387,1391,1030,361,2.853185596,719,1471,971,280,1,279,1,77,0,0,empty,mBC-0814-1
"B12,H9",577020,651958,386798,265160,384438,4,234022,234282,191422,42860,4.466215586,137773,106163,78165,21779,11,21768,1,1654,0,0.000367512,mm10,mBC-0814-1
"B12,H10",3518,3845,2493,1352,2222,0,1235,1236,893,343,2.603498542,641,1098,787,212,0,212,0,46,0,0.014150943,empty,mBC-0814-1
"B12,H11",3830,4282,2741,1541,2539,0,1446,1447,1033,414,2.495169082,765,11,6,5,0,5,0,4,0,0,empty,mBC-0814-1
"B12,H12",314850,370026,204244,165782,225244,0,148128,148264,109312,38952,2.806325734,91515,19056,13216,3737,3,3734,1,462,0,0,mm10,mBC-0814-1
"C1,A1",384395,446736,257567,189169,270076,2,171057,171245,136969,34276,3.996061384,102916,27699,19429,5708,2,5706,2,632,0,0.003154574,mm10,mBC-0814-1
"C1,A2",609485,677542,410138,267404,394848,1,239913,240207,187638,52569,3.569365976,138653,132941,95107,27819,16,27803,2,1815,0,0.000251771,mm10,mBC-0814-1
"C1,A3",4594,5070,3256,1814,2947,0,1621,1621,1140,481,2.37006237,902,1088,781,194,0,194,0,49,0,0.005154639,empty,mBC-0814-1
"C1,A4",6466,6572,4463,2109,3681,0,1980,1982,1435,547,2.623400366,1013,21388,7281,2319,4,2315,1,197,0,0.201295896,empty,mBC-0814-1
"C1,A5",5212,5523,3761,1762,3228,0,1724,1725,1239,486,2.549382716,884,1536,1096,303,1,302,1,60,0,0,empty,mBC-0814-1
"C1,A6",3958,4340,2867,1473,2554,0,1398,1402,1013,389,2.604113111,719,1319,975,294,0,294,0,58,0,0,empty,mBC-0814-1
"C1,A7",5617,6155,3968,2187,3614,0,2028,2030,1471,559,2.631484794,1110,1901,1016,260,2,258,1,69,0,0.089147287,empty,mBC-0814-1
"C1,A8",2361,2522,1632,890,1450,0,844,844,619,225,2.751111111,443,1776,1238,426,0,426,0,82,0,0.002347418,empty,mBC-0814-1
"C1,A9",8287,8956,5830,3126,5262,0,2926,2933,2210,723,3.05670816,1567,1574,1074,349,0,349,0,73,0,0,empty,mBC-0814-1
"C1,A10",3662,4023,2552,1471,2379,0,1318,1318,959,359,2.671309192,725,188,137,52,0,52,0,16,0,0,empty,mBC-0814-1
"C1,A11",4810,5252,3476,1776,3045,0,1631,1633,1156,477,2.423480084,853,1499,1008,380,0,380,0,88,0,0,empty,mBC-0814-1
"C1,A12",3894,4168,2795,1373,2469,0,1294,1294,924,370,2.497297297,704,2499,1805,549,0,549,0,149,0,0,empty,mBC-0814-1
"C1,B1",373191,431161,245297,185864,256025,0,159040,159217,134040,25177,5.32390674,95724,227873,166916,47162,19,47143,3,2625,0,0.000699998,mm10,mBC-0814-1
"C1,B2",4774,5203,3333,1870,3112,0,1694,1701,1227,474,2.588607595,942,767,545,168,0,168,0,42,0,0,empty,mBC-0814-1
"C1,B3",4042,4399,2922,1477,2653,0,1411,1411,1017,394,2.581218274,779,857,586,182,2,180,2,48,0,0,empty,mBC-0814-1
"C1,B4",4263,4590,2967,1623,2719,0,1472,1476,1027,449,2.287305122,838,1188,839,220,0,220,0,65,0,0.059090909,empty,mBC-0814-1
"C1,B5",3833,2495,1535,960,1781,0,955,956,670,286,2.342657343,572,1206,890,254,0,254,0,55,0,0.003937008,empty,mBC-0814-1
"C1,B6",4272,4546,3103,1443,2632,0,1456,1457,1063,394,2.697969543,753,1213,839,290,1,289,1,57,0,0,empty,mBC-0814-1
"C1,B7",605274,704769,406098,298671,414997,2,260300,260583,215080,45503,4.726721315,155210,137521,99739,27833,15,27818,2,1848,0,0.000683011,mm10,mBC-0814-1
"C1,B8",3954,4292,2868,1424,2459,0,1264,1266,885,381,2.322834646,677,1219,859,223,0,223,0,51,0,0,empty,mBC-0814-1
"C1,B9",482971,567865,320371,247494,334471,0,212827,213039,172107,40932,4.204705365,128958,42309,31437,8819,2,8817,1,808,0,0,mm10,mBC-0814-1
"C1,B10",4401,4496,3046,1450,2749,0,1444,1445,1027,418,2.456937799,766,399,280,97,0,97,0,30,0,0,empty,mBC-0814-1
"C1,B11",6439,6815,4605,2210,3903,1,2072,2081,1498,583,2.569468268,1090,198,153,50,0,50,0,10,0,0,empty,mBC-0814-1
"C1,B12",5450,6076,3911,2165,3610,0,2030,2035,1453,582,2.496563574,1160,1237,947,291,1,290,1,66,0,0,empty,mBC-0814-1
"C1,C1",5525,5855,3998,1857,3519,0,1892,1893,1392,501,2.778443114,989,753,514,182,0,182,0,34,0,0,empty,mBC-0814-1
"C1,C2",5239,5640,3695,1945,3289,0,1810,1811,1298,513,2.530214425,974,1276,953,284,1,283,1,82,0,0,empty,mBC-0814-1
"C1,C3",5976,6599,4148,2451,3926,0,2142,2149,1546,603,2.56384743,1186,627,470,124,0,124,0,39,0,0,empty,mBC-0814-1
"C1,C4",591241,680799,384749,296050,401016,1,259383,259667,200839,58828,3.414003536,155480,189826,134857,38123,30,38093,3,2215,0,0.000603785,mm10,mBC-0814-1
"C1,C5",7215,7835,5180,2655,4552,0,2408,2413,1757,656,2.678353659,1324,1553,1106,365,0,365,0,93,0,0.016438356,empty,mBC-0814-1
"C1,C6",5928,6433,4179,2254,3804,0,2112,2114,1574,540,2.914814815,1168,1251,913,325,1,324,1,83,0,0.00308642,empty,mBC-0814-1
"C1,C7",7991,8760,5675,3085,5093,6,2768,2776,2020,756,2.671957672,1541,245,146,38,0,38,0,16,0,0,empty,mBC-0814-1
"C1,C8",5496,5980,3946,2034,3485,0,1853,1855,1327,528,2.513257576,1022,1534,1065,274,0,274,0,62,0,0.069343066,empty,mBC-0814-1
"C1,C9",4705,5062,3404,1658,2962,0,1569,1569,1162,407,2.855036855,808,1379,1041,305,0,305,0,65,0,0.059016393,empty,mBC-0814-1
"C1,C10",5751,6178,4240,1938,3565,0,1886,1886,1346,540,2.492592593,909,982,638,171,0,171,0,43,0,0.011695906,empty,mBC-0814-1
"C1,C11",4654,5157,3381,1776,3012,0,1649,1655,1181,474,2.491561181,911,1186,844,223,0,223,0,64,0,0,empty,mBC-0814-1
"C1,C12",549353,642904,365209,277695,376357,0,237350,237594,187085,50509,3.703993348,143662,153080,111310,30950,15,30935,1,2019,0,0.000678843,mm10,mBC-0814-1
"C1,D1",541926,621948,362613,259335,365490,1,225395,225654,182957,42697,4.285008314,133429,136024,95071,27531,23,27508,1,1725,0,3.63531E-05,mm10,mBC-0814-1
"C1,D2",5180,5580,3794,1786,3262,0,1703,1705,1241,464,2.674568966,884,1464,1048,311,0,311,0,69,0,0.003215434,empty,mBC-0814-1
"C1,D3",11028,12102,7814,4288,7068,0,3851,3861,2748,1113,2.469002695,2083,2320,1558,439,0,439,0,106,0,0,empty,mBC-0814-1
"C1,D4",4612,4881,3344,1537,2866,0,1540,1544,1114,430,2.590697674,772,1724,1301,373,0,373,0,63,0,0,empty,mBC-0814-1
"C1,D5",4435,4831,3164,1667,2856,0,1592,1596,1132,464,2.439655172,839,2032,1328,425,0,425,0,109,0,0.023529412,empty,mBC-0814-1
"C1,D6",5320,5771,3887,1884,3408,6,1860,1866,1369,497,2.754527163,964,906,653,179,0,179,0,56,0,0,empty,mBC-0814-1
"C1,D7",5746,6189,4046,2143,3620,3,1968,1975,1422,553,2.571428571,1070,1873,1280,351,0,351,0,87,0,0,empty,mBC-0814-1
"C1,D8",4992,5489,3538,1951,3182,0,1739,1743,1255,488,2.571721311,958,706,363,141,0,141,0,46,0,0,empty,mBC-0814-1
"C1,D9",3125,3437,2211,1226,2016,0,1108,1116,779,337,2.3115727,600,776,527,150,0,150,0,43,0,0.006666667,empty,mBC-0814-1
"C1,D10",4565,5227,3170,2057,3141,0,1790,1790,1285,505,2.544554455,1066,810,602,133,0,133,0,39,0,0,empty,mBC-0814-1
"C1,D11",4141,4263,3089,1174,2547,0,1355,1355,982,373,2.632707775,666,2068,1509,471,0,471,0,107,0,0,empty,mBC-0814-1
"C1,D12",6519,7029,4605,2424,4163,0,2299,2305,1606,699,2.297567954,1244,3030,1956,560,0,560,0,106,0,0.039285714,empty,mBC-0814-1
"C1,E1",5096,5124,3698,1426,3022,0,1511,1515,1096,419,2.61575179,741,1269,938,218,0,218,0,61,0,0,empty,mBC-0814-1
"C1,E2",3658,4124,2602,1522,2450,0,1397,1397,1010,387,2.609819121,776,1495,1042,340,0,340,0,73,0,0,empty,mBC-0814-1
"C1,E3",3463,3799,2559,1240,2142,0,1135,1135,822,313,2.626198083,585,1750,1267,379,0,379,0,65,0,0.039577836,empty,mBC-0814-1
"C1,E4",459787,545387,305171,240216,322557,0,207219,207482,165010,42472,3.885147862,126118,166928,116458,33203,23,33180,4,2109,0,3.01386E-05,mm10,mBC-0814-1
"C1,E5",3929,4190,2904,1286,2518,0,1339,1339,960,379,2.53298153,708,807,580,167,0,167,0,34,0,0,empty,mBC-0814-1
"C1,E6",4694,4915,3451,1464,2884,2,1514,1518,1135,383,2.963446475,745,1237,751,213,1,212,1,51,0,0.014150943,empty,mBC-0814-1
"C1,E7",4518,4774,3254,1520,2790,5,1438,1448,1029,419,2.455847255,748,1335,988,271,0,271,0,59,0,0,empty,mBC-0814-1
"C1,E8",4616,4957,3359,1598,2850,0,1491,1491,1114,377,2.954907162,762,1575,1083,415,1,414,1,80,0,0,empty,mBC-0814-1
"C1,E9",3681,3812,2545,1267,2255,0,1222,1223,930,293,3.174061433,653,1377,951,252,0,252,0,61,0,0,empty,mBC-0814-1
"C1,E10",4102,4549,2953,1596,2680,0,1469,1471,1057,414,2.553140097,808,1717,1064,367,0,367,0,85,0,0,empty,mBC-0814-1
"C1,E11",4223,4386,3046,1340,2629,0,1404,1404,994,410,2.424390244,721,1341,947,271,0,271,0,63,0,0.003690037,empty,mBC-0814-1
"C1,E12",401870,470557,265359,205198,279932,0,174563,174756,148555,26201,5.669821763,105497,226265,165192,46489,30,46459,2,2602,0,0.000602682,mm10,mBC-0814-1
"C1,F1",4752,5047,3473,1574,2942,0,1515,1519,1062,457,2.323851204,802,1171,886,241,0,241,0,59,0,0.004149378,empty,mBC-0814-1
"C1,F2",6716,7350,4785,2565,4246,0,2310,2312,1687,625,2.6992,1249,1453,1069,349,0,349,0,92,0,0.022922636,empty,mBC-0814-1
"C1,F3",5113,5524,3666,1858,3279,0,1800,1804,1301,503,2.586481113,956,1275,846,276,0,276,0,69,0,0,empty,mBC-0814-1
"C1,F4",5437,5880,3897,1983,3530,0,1878,1879,1312,567,2.313932981,1030,486,338,105,0,105,0,31,0,0,empty,mBC-0814-1
"C1,F5",14505,16882,10342,6540,10035,0,6064,6070,4366,1704,2.562206573,3522,1622,1111,358,1,357,1,76,0,0,empty,mBC-0814-1
"C1,F6",1116369,1293612,737845,555767,753381,0,482262,482763,389425,93338,4.172202104,289527,415574,294337,84148,51,84097,2,3892,0,0.000701571,mm10,mBC-0814-1
"C1,F7",4625,5147,3315,1832,2996,0,1621,1622,1130,492,2.296747967,885,469,286,108,0,108,0,39,0,0,empty,mBC-0814-1
"C1,F8",7096,7548,5075,2473,4450,0,2438,2445,1771,674,2.627596439,1298,56,39,21,0,21,0,12,0,0,empty,mBC-0814-1
"C1,F9",5376,5672,3889,1783,3261,1,1692,1693,1254,439,2.856492027,888,1869,1301,409,0,409,0,86,0,0,empty,mBC-0814-1
"C1,F10",6609,7296,4748,2548,4235,0,2287,2290,1601,689,2.323657475,1250,1277,858,273,0,273,0,78,0,0,empty,mBC-0814-1
"C1,F11",4386,4696,3115,1581,2697,0,1430,1431,1008,423,2.382978723,775,893,601,222,0,222,0,49,0,0,empty,mBC-0814-1
"C1,F12",4912,5051,3354,1697,3041,0,1678,1679,1232,447,2.756152125,900,35,24,12,0,12,0,8,0,0,empty,mBC-0814-1
"C1,G1",7886,8119,5828,2291,4775,1,2453,2454,1749,705,2.480851064,1190,2966,2100,698,1,697,1,149,0,0.00143472,empty,mBC-0814-1
"C1,G2",5777,6285,4079,2206,3648,0,1968,1974,1394,580,2.403448276,1053,912,722,190,0,190,0,29,0,0,empty,mBC-0814-1
"C1,G3",413457,475907,278075,197832,283360,0,176960,177196,131033,46163,2.838485367,105850,52341,37181,10563,8,10555,2,1044,0,0.004073899,mm10,mBC-0814-1
"C1,G4",5315,5717,3763,1954,3367,0,1831,1834,1310,524,2.5,1025,13,11,5,0,5,0,4,0,0,empty,mBC-0814-1
"C1,G5",549480,647693,364535,283158,379957,0,240099,240366,202322,38044,5.318105352,145439,187821,132624,36780,25,36755,2,2331,0,2.72072E-05,mm10,mBC-0814-1
"C1,G6",8959,9486,6453,3033,5660,0,2955,2964,2195,769,2.854356307,1514,272,218,67,0,67,0,17,0,0,empty,mBC-0814-1
"C1,G7",5491,5903,3986,1917,3471,0,1854,1854,1332,522,2.551724138,977,2151,1314,494,0,494,0,111,0,0.004048583,empty,mBC-0814-1
"C1,G8",7263,7637,5218,2419,4602,0,2467,2471,1725,746,2.31233244,1277,2613,1837,584,2,582,2,148,0,0.04467354,empty,mBC-0814-1
"C1,G9",5320,5683,3849,1834,3364,0,1764,1770,1273,497,2.561368209,934,5011,2410,805,0,805,0,145,0,0.063354037,empty,mBC-0814-1
"C1,G10",8991,9525,6420,3105,5677,0,3036,3042,2193,849,2.583038869,1608,3319,2518,730,0,730,0,154,0,0,empty,mBC-0814-1
"C1,G11",9085,9557,6446,3111,5749,1,3101,3112,2217,895,2.477094972,1624,1204,828,249,0,249,0,71,0,0.076305221,empty,mBC-0814-1
"C1,G12",4628,5115,3281,1834,2975,1,1646,1650,1193,457,2.610503282,879,1753,1152,340,1,339,1,93,0,0.029498525,empty,mBC-0814-1
"C1,H1",455450,535565,302702,232863,319011,1,202882,203095,153897,49198,3.128114964,122527,74893,54112,15348,9,15339,1,1246,0,0,mm10,mBC-0814-1
"C1,H2",8113,8710,5822,2888,5124,0,2847,2851,2000,851,2.350176263,1519,2545,1715,512,0,512,0,134,0,0,empty,mBC-0814-1
"C1,H3",5436,5689,3745,1944,3297,0,1812,1816,1304,512,2.546875,965,7334,2867,884,2,882,1,102,0,0.129251701,empty,mBC-0814-1
"C1,H4",5427,5868,3898,1970,3465,0,1930,1935,1378,557,2.473967684,1024,130,98,43,0,43,0,13,0,0,empty,mBC-0814-1
"C1,H5",6948,7642,4962,2680,4402,0,2431,2438,1770,668,2.649700599,1305,1884,1304,438,0,438,0,80,0,0,empty,mBC-0814-1
"C1,H6",6782,7262,4908,2354,4230,0,2264,2269,1580,689,2.29317852,1180,2585,1758,551,0,551,0,117,0,0.038112523,empty,mBC-0814-1
"C1,H7",5269,5691,3750,1941,3401,0,1897,1905,1330,575,2.313043478,1043,1064,724,223,0,223,0,57,0,0.013452915,empty,mBC-0814-1
"C1,H8",921281,1067594,600299,467295,622045,1,400351,400727,306717,94010,3.262599723,241530,474678,337245,96802,60,96742,4,4121,0,0.000382461,mm10,mBC-0814-1
"C1,H9",4877,5136,3521,1615,2995,0,1592,1597,1156,441,2.621315193,814,1010,642,226,0,226,0,50,0,0,empty,mBC-0814-1
"C1,H10",3669,3933,2621,1312,2349,0,1293,1293,942,351,2.683760684,676,916,705,183,0,183,0,41,0,0,empty,mBC-0814-1
"C1,H11",4018,4218,2849,1369,2520,3,1430,1435,1060,375,2.826666667,745,33,23,13,0,13,0,6,0,0,empty,mBC-0814-1
"C1,H12",2727,2871,1896,975,1761,0,986,988,742,246,3.016260163,525,686,361,135,0,135,0,66,0,0,empty,mBC-0814-1
"C2,A1",4932,5316,3447,1869,3054,0,1689,1695,1219,476,2.56092437,926,1616,1158,379,0,379,0,82,0,0,empty,mBC-0814-1
"C2,A2",4574,4841,3238,1603,2882,0,1550,1555,1149,406,2.830049261,858,2966,1529,472,0,472,0,116,0,0.044491525,empty,mBC-0814-1
"C2,A3",6550,7677,4567,3110,4496,0,2679,2680,1679,1001,1.677322677,1598,11659,4393,1320,2,1318,2,152,0,0.050075873,empty,mBC-0814-1
"C2,A4",4958,5391,3578,1813,3178,0,1682,1687,1200,487,2.464065708,891,537,356,115,0,115,0,28,0,0,empty,mBC-0814-1
"C2,A5",386490,442265,264382,177883,266802,1,163541,163728,121512,42216,2.878339966,96001,59363,39697,11102,4,11098,1,1062,0,0.001081276,mm10,mBC-0814-1
"C2,A6",3220,3402,2306,1096,1996,0,1067,1072,766,306,2.503267974,549,1202,815,286,0,286,0,73,0,0.045454545,empty,mBC-0814-1
"C2,A7",4748,5291,3390,1901,3136,0,1713,1715,1210,505,2.396039604,969,1882,1293,394,0,394,0,89,0,0,empty,mBC-0814-1
"C2,A8",1924,2020,1380,640,1205,0,631,632,438,194,2.257731959,313,1927,1322,450,1,449,1,94,0,0.004454343,empty,mBC-0814-1
"C2,A9",501223,571085,341873,229212,337599,1,204915,205129,158723,46406,3.420312029,119877,146423,104962,29418,15,29403,3,1881,0,0.000408122,mm10,mBC-0814-1
"C2,A10",2939,3259,2081,1178,1895,0,1053,1053,736,317,2.321766562,586,330,228,55,0,55,0,25,0,0,empty,mBC-0814-1
"C2,A11",3997,4248,2879,1369,2517,0,1314,1316,967,349,2.770773639,679,2702,1927,528,0,528,0,109,0,0,empty,mBC-0814-1
"C2,A12",3316,3693,2245,1448,2267,0,1310,1310,1000,310,3.225806452,750,3360,2431,754,0,754,0,194,0,0.021220159,empty,mBC-0814-1
"C2,B1",4112,4474,2863,1611,2628,0,1413,1413,1022,391,2.613810742,792,1703,1208,369,0,369,0,94,0,0,empty,mBC-0814-1
"C2,B2",523190,598720,331561,267159,355420,0,228394,228593,184317,44276,4.162909929,139227,63069,44251,12314,4,12310,1,1123,0,0,mm10,mBC-0814-1
"C2,B3",3473,3796,2431,1365,2199,0,1232,1232,887,345,2.571014493,681,1577,1015,276,0,276,0,58,0,0,empty,mBC-0814-1
"C2,B4",3553,3642,2528,1114,2170,0,1195,1201,870,331,2.628398792,626,1190,878,274,1,273,1,69,0,0,empty,mBC-0814-1
"C2,B5",4119,3164,2041,1123,2088,0,1180,1180,917,263,3.486692015,656,1070,745,237,0,237,0,69,0,0,empty,mBC-0814-1
"C2,B6",3383,3608,2408,1200,2165,0,1142,1143,808,335,2.411940299,632,1132,772,269,0,269,0,53,0,0.044609665,empty,mBC-0814-1
"C2,B7",4377,4778,3210,1568,2752,0,1452,1454,1065,389,2.737789203,752,1058,729,259,0,259,0,56,0,0,empty,mBC-0814-1
"C2,B8",3271,3531,2372,1159,2101,0,1120,1124,803,321,2.501557632,597,1503,1108,329,0,329,0,58,0,0,empty,mBC-0814-1
"C2,B9",337467,395266,225146,170120,235273,0,146971,147136,124312,22824,5.446547494,88632,76710,56180,15870,14,15856,3,1282,0,0,mm10,mBC-0814-1
"C2,B10",259174,281609,166939,114670,174033,0,103751,103990,87267,16723,5.218381869,61336,102815,73278,20719,9,20710,4,1516,0,0.000724288,mm10,mBC-0814-1
"C2,B11",5891,6212,4128,2084,3511,0,1895,1895,1360,535,2.542056075,1017,164,130,54,0,54,0,16,0,0,empty,mBC-0814-1
"C2,B12",4669,5144,3343,1801,3039,0,1671,1673,1186,487,2.435318275,934,1172,736,252,0,252,0,55,0,0.047619048,empty,mBC-0814-1
"C2,C1",5042,5286,3570,1716,3048,7,1628,1643,1199,444,2.70045045,861,1252,871,272,0,272,0,52,0,0,empty,mBC-0814-1
"C2,C2",4669,5103,3318,1785,2915,0,1582,1582,1182,400,2.955,858,1887,1338,409,0,409,0,92,0,0.070904645,empty,mBC-0814-1
"C2,C3",5214,5554,3684,1870,3337,0,1834,1834,1305,529,2.466918715,966,711,440,134,0,134,0,33,0,0,empty,mBC-0814-1
"C2,C4",4600,4864,3301,1563,2819,0,1499,1499,1076,423,2.543735225,769,1577,1057,327,0,327,0,77,0,0.051987768,empty,mBC-0814-1
"C2,C5",6271,6667,4463,2204,3940,0,2108,2111,1576,535,2.945794393,1095,1466,1025,288,0,288,0,81,0,0,empty,mBC-0814-1
"C2,C6",5078,5406,3646,1760,3245,1,1790,1795,1286,509,2.526522593,965,1518,1054,276,1,275,1,73,0,0,empty,mBC-0814-1
"C2,C7",6277,6643,4514,2129,3941,0,2073,2079,1535,544,2.821691176,1108,654,483,157,0,157,0,31,0,0,empty,mBC-0814-1
"C2,C8",4630,4820,3359,1461,2893,0,1515,1518,1129,389,2.902313625,779,2040,1488,415,0,415,0,87,0,0,empty,mBC-0814-1
"C2,C9",4019,4238,2843,1395,2398,0,1283,1286,906,380,2.384210526,649,867,635,191,0,191,0,57,0,0.036649215,empty,mBC-0814-1
"C2,C10",5142,5279,3723,1556,3059,0,1642,1643,1210,433,2.794457275,827,1249,904,294,1,293,1,52,0,0,empty,mBC-0814-1
"C2,C11",4229,4637,2976,1661,2747,0,1516,1518,1088,430,2.530232558,860,1541,1030,353,0,353,0,73,0,0.014164306,empty,mBC-0814-1
"C2,C12",6863,7302,4814,2488,4279,0,2366,2368,1725,643,2.68273717,1284,2225,1665,373,1,372,1,79,0,0,empty,mBC-0814-1
"C2,D1",3805,3943,2764,1179,2343,0,1253,1257,901,356,2.530898876,636,576,395,132,0,132,0,24,0,0,empty,mBC-0814-1
"C2,D2",4600,4862,3383,1479,2822,0,1469,1473,1039,434,2.394009217,706,2033,1465,416,0,416,0,91,0,0.007211538,empty,mBC-0814-1
"C2,D3",9235,9933,6597,3336,5878,0,3347,3350,2380,970,2.453608247,1761,3025,2116,554,0,554,0,120,0,0,empty,mBC-0814-1
"C2,D4",4638,5027,3264,1763,2996,0,1677,1679,1290,389,3.316195373,900,1774,1273,382,1,381,1,83,0,0.026246719,empty,mBC-0814-1
"C2,D5",236578,267802,154554,113248,160627,0,98749,98846,82559,16287,5.069012096,59378,335648,198527,55170,38,55132,4,3153,0,0.021638976,mm10,mBC-0814-1
"C2,D6",4374,4642,3179,1463,2701,0,1425,1426,1047,379,2.762532982,741,1646,955,297,1,296,1,53,0,0,empty,mBC-0814-1
"C2,D7",4689,5107,3260,1847,3037,0,1635,1637,1171,466,2.512875536,930,4419,2571,735,0,735,0,124,0,0.131972789,empty,mBC-0814-1
"C2,D8",4108,4461,2945,1516,2625,0,1404,1408,1058,350,3.022857143,754,21648,5490,1651,4,1647,2,215,0,0.213114754,empty,mBC-0814-1
"C2,D9",2759,3153,1900,1253,1824,0,1028,1028,766,262,2.923664122,599,1505,1071,318,0,318,0,52,0,0.040880503,empty,mBC-0814-1
"C2,D10",3913,4313,2697,1616,2599,0,1483,1485,1096,389,2.81748072,826,673,467,143,0,143,0,42,0,0,empty,mBC-0814-1
"C2,D11",3534,3784,2566,1218,2261,0,1215,1215,884,331,2.670694864,614,1864,1373,411,0,411,0,114,0,0,empty,mBC-0814-1
"C2,D12",5225,5592,3722,1870,3392,0,1865,1868,1346,522,2.578544061,1004,3464,2569,756,0,756,0,139,0,0.010582011,empty,mBC-0814-1
"C2,E1",4330,4356,3106,1250,2605,0,1299,1299,955,344,2.776162791,655,1475,900,326,0,326,0,74,0,0.04601227,empty,mBC-0814-1
"C2,E2",3283,3612,2265,1347,2129,0,1186,1192,843,349,2.415472779,678,1520,1102,348,1,347,1,76,0,0,empty,mBC-0814-1
"C2,E3",3148,3397,2246,1151,1953,0,1032,1034,753,281,2.679715302,554,1520,1048,309,0,309,0,69,0,0.03236246,empty,mBC-0814-1
"C2,E4",2855,3130,1989,1141,1828,0,1056,1058,757,301,2.514950166,576,1322,874,256,0,256,0,55,0,0,empty,mBC-0814-1
"C2,E5",3304,3553,2396,1157,2108,0,1127,1133,820,313,2.619808307,607,1160,859,219,0,219,0,51,0,0,empty,mBC-0814-1
"C2,E6",4295,4627,3098,1529,2658,0,1441,1441,1066,375,2.842666667,751,1167,829,289,0,289,0,78,0,0,empty,mBC-0814-1
"C2,E7",4071,4230,2933,1297,2390,0,1242,1243,904,339,2.666666667,615,1643,1194,329,0,329,0,63,0,0,empty,mBC-0814-1
"C2,E8",3860,3881,2857,1024,2356,0,1205,1206,892,314,2.840764331,562,1612,1045,355,0,355,0,88,0,0,empty,mBC-0814-1
"C2,E9",242114,275918,161796,114122,165993,1,104071,104195,80752,23443,3.444610331,61625,126722,63165,17860,26,17834,5,1467,0,0.014522822,mm10,mBC-0814-1
"C2,E10",3432,3630,2486,1144,2187,0,1169,1169,813,356,2.283707865,617,1634,1202,361,0,361,0,83,0,0,empty,mBC-0814-1
"C2,E11",3611,3955,2613,1342,2332,0,1273,1277,918,359,2.557103064,693,1167,826,287,0,287,0,79,0,0,empty,mBC-0814-1
"C2,E12",3375,3649,2407,1242,2157,0,1189,1190,840,350,2.4,625,1260,883,289,0,289,0,62,0,0,empty,mBC-0814-1
"C2,F1",4046,4279,2933,1346,2554,0,1338,1340,964,376,2.563829787,725,1815,1357,329,0,329,0,83,0,0,empty,mBC-0814-1
"C2,F2",5595,5915,4036,1879,3589,0,1894,1902,1374,528,2.602272727,973,2021,1290,425,2,423,1,129,0,0,empty,mBC-0814-1
"C2,F3",4495,4892,3236,1656,2776,1,1551,1552,1156,396,2.919191919,800,1917,1126,409,0,409,0,84,0,0.004889976,empty,mBC-0814-1
"C2,F4",4699,5041,3350,1691,2934,0,1614,1616,1164,452,2.575221239,838,595,448,130,0,130,0,33,0,0,empty,mBC-0814-1
"C2,F5",4698,5069,3421,1648,2950,0,1575,1575,1116,459,2.431372549,830,1784,1431,416,0,416,0,75,0,0,empty,mBC-0814-1
"C2,F6",4272,4554,3036,1518,2722,0,1507,1507,1074,433,2.480369515,768,1778,1220,382,0,382,0,96,0,0,empty,mBC-0814-1
"C2,F7",3799,3991,2796,1195,2458,0,1276,1276,951,325,2.926153846,631,750,604,184,1,183,1,38,0,0,empty,mBC-0814-1
"C2,F8",5171,5616,3753,1863,3420,0,1808,1809,1322,487,2.714579055,1004,202,146,75,0,75,0,17,0,0,empty,mBC-0814-1
"C2,F9",4980,5300,3589,1711,3097,0,1649,1652,1208,444,2.720720721,854,2196,1578,482,0,482,0,98,0,0.058091286,empty,mBC-0814-1
"C2,F10",5768,6082,4135,1947,3592,0,1907,1915,1359,556,2.444244604,990,1939,1400,420,1,419,1,74,0,0.009546539,empty,mBC-0814-1
"C2,F11",3651,3871,2602,1269,2315,0,1256,1259,905,354,2.556497175,683,1066,665,243,0,243,0,52,0,0.061728395,empty,mBC-0814-1
"C2,F12",4008,4297,2903,1394,2554,0,1388,1390,1048,342,3.064327485,724,287,167,60,0,60,0,18,0,0,empty,mBC-0814-1
"C2,G1",6420,6930,4614,2316,4074,0,2186,2187,1563,624,2.504807692,1180,2815,1950,614,0,614,0,138,0,0,empty,mBC-0814-1
"C2,G2",4803,5171,3445,1726,3016,0,1611,1616,1180,436,2.706422018,855,580,383,86,0,86,0,22,0,0,empty,mBC-0814-1
"C2,G3",927789,1071730,613367,458363,627913,0,398887,399287,309921,89366,3.467996777,239266,521091,379466,106692,62,106630,3,4174,0,0.000281347,mm10,mBC-0814-1
"C2,G4",4624,5160,3279,1881,2960,0,1630,1631,1157,474,2.44092827,928,15,11,9,0,9,0,1,0,0,empty,mBC-0814-1
"C2,G5",4023,4315,2835,1480,2499,0,1334,1336,977,359,2.721448468,719,1440,1078,283,0,283,0,74,0,0,empty,mBC-0814-1
"C2,G6",657721,750251,440876,309375,439334,8,269998,270326,223896,46430,4.822227008,159348,27976,17145,4745,3,4742,3,497,0,0.001054407,mm10,mBC-0814-1
"C2,G7",367613,418678,242352,176326,250813,0,154513,154666,136101,18565,7.331053057,92875,584470,382520,100536,86,100450,8,4448,0,0.000238925,mm10,mBC-0814-1
"C2,G8",404466,466732,269563,197169,277101,0,169734,169914,143184,26730,5.35667789,101160,387284,278868,76930,48,76882,6,3625,0,0.000286153,mm10,mBC-0814-1
"C2,G9",295717,331021,194404,136617,197653,0,121666,121783,100535,21248,4.731504142,71921,235466,163994,46867,26,46841,2,2645,0,0.001515766,mm10,mBC-0814-1
"C2,G10",7794,8159,5615,2544,4848,0,2598,2604,1787,817,2.187270502,1339,3154,2344,750,0,750,0,167,0,0.001333333,empty,mBC-0814-1
"C2,G11",7837,8636,5662,2974,5037,3,2749,2757,1991,766,2.59921671,1477,1895,1312,402,0,402,0,90,0,0.027363184,empty,mBC-0814-1
"C2,G12",3812,4090,2670,1420,2433,0,1357,1357,972,385,2.524675325,725,2434,1804,470,0,470,0,96,0,0,empty,mBC-0814-1
"C2,H1",410130,486169,272148,214021,289163,2,182907,183120,153355,29765,5.152192172,111052,158662,115258,31480,21,31459,2,2050,0,0.001017197,mm10,mBC-0814-1
"C2,H2",7079,7555,5116,2439,4415,0,2409,2413,1774,639,2.776212833,1216,3710,2839,749,0,749,0,152,0,0.034712951,empty,mBC-0814-1
"C2,H3",4863,5079,3349,1730,2975,0,1632,1641,1189,452,2.630530973,858,10474,3723,1126,0,1126,0,156,0,0.145648313,empty,mBC-0814-1
"C2,H4",4879,5433,3463,1970,3133,1,1709,1713,1243,470,2.644680851,950,81,48,26,0,26,0,15,0,0,empty,mBC-0814-1
"C2,H5",5973,6322,4263,2059,3642,0,1928,1932,1336,596,2.241610738,1023,2543,1845,524,0,524,0,77,0,0,empty,mBC-0814-1
"C2,H6",5350,5565,3793,1772,3284,0,1769,1773,1246,527,2.364326376,932,2321,1508,396,0,396,0,108,0,0.002525253,empty,mBC-0814-1
"C2,H7",4423,4665,3156,1509,2807,0,1459,1470,1053,417,2.525179856,756,1379,893,282,0,282,0,66,0,0.070921986,empty,mBC-0814-1
"C2,H8",8033,8977,5513,3464,5412,0,3207,3211,2390,821,2.911084044,1854,2664,1400,436,0,436,0,97,0,0,empty,mBC-0814-1
"C2,H9",3946,4062,2816,1246,2443,0,1259,1259,888,371,2.393530997,640,9608,3129,958,0,958,0,125,0,0.042797495,empty,mBC-0814-1
"C2,H10",3161,3434,2296,1138,1987,0,1089,1091,786,305,2.57704918,547,1101,760,223,0,223,0,55,0,0,empty,mBC-0814-1
"C2,H11",3253,3618,2367,1251,2198,0,1266,1269,886,383,2.313315927,707,40,32,20,0,20,0,10,0,0,empty,mBC-0814-1
"C2,H12",2113,2391,1431,960,1473,0,868,868,626,242,2.58677686,515,1207,845,255,0,255,0,70,0,0.043137255,empty,mBC-0814-1
"C3,A1",4970,5323,3540,1783,3218,0,1748,1754,1203,551,2.183303085,954,1407,980,315,0,315,0,63,0,0.031746032,empty,mBC-0814-1
"C3,A2",3978,4404,2800,1604,2605,0,1389,1389,994,395,2.516455696,776,1423,973,309,0,309,0,81,0,0.003236246,empty,mBC-0814-1
"C3,A3",4184,4607,2926,1681,2728,0,1554,1554,1131,423,2.673758865,865,897,600,193,0,193,0,47,0,0,empty,mBC-0814-1
"C3,A4",5098,5378,3807,1571,3088,0,1551,1554,1080,474,2.278481013,756,259,152,54,0,54,0,15,0,0,empty,mBC-0814-1
"C3,A5",4128,4493,3016,1477,2635,0,1415,1415,1005,410,2.451219512,744,1431,1037,306,0,306,0,58,0,0,empty,mBC-0814-1
"C3,A6",4589,5078,3187,1891,3028,0,1729,1734,1232,502,2.454183267,968,965,699,223,0,223,0,52,0,0.053811659,empty,mBC-0814-1
"C3,A7",4741,5318,3351,1967,3101,0,1727,1729,1247,482,2.587136929,952,1294,826,244,0,244,0,72,0,0.118852459,empty,mBC-0814-1
"C3,A8",2046,2340,1401,939,1339,0,750,753,499,254,1.964566929,452,1432,949,295,0,295,0,65,0,0,empty,mBC-0814-1
"C3,A9",5463,5793,3947,1846,3358,0,1838,1842,1312,530,2.475471698,914,1645,1082,342,0,342,0,69,0,0.043859649,empty,mBC-0814-1
"C3,A10",2972,3189,2126,1063,1854,0,990,994,697,297,2.346801347,509,104,73,17,0,17,0,9,0,0,empty,mBC-0814-1
"C3,A11",3650,3986,2654,1332,2347,1,1263,1266,892,374,2.385026738,692,1672,1161,378,0,378,0,85,0,0.05026455,empty,mBC-0814-1
"C3,A12",2836,2952,2051,901,1803,0,979,982,721,261,2.762452107,507,3123,2349,805,0,805,0,180,0,0.001242236,empty,mBC-0814-1
"C3,B1",329351,373091,219023,154068,224306,2,140707,140838,115398,25440,4.536084906,83541,14228,10065,2768,0,2768,0,405,0,0.006141618,mm10,mBC-0814-1
"C3,B2",4480,4939,3119,1820,2821,0,1491,1492,1022,470,2.174468085,836,460,265,87,0,87,0,24,0,0.091954023,empty,mBC-0814-1
"C3,B3",3450,3586,2461,1125,2164,0,1184,1184,797,387,2.059431525,618,1112,765,195,0,195,0,43,0,0.066666667,empty,mBC-0814-1
"C3,B4",3304,3581,2357,1224,2109,0,1179,1179,860,319,2.695924765,621,1077,757,190,0,190,0,54,0,0,empty,mBC-0814-1
"C3,B5",3233,2225,1401,824,1564,0,845,845,587,258,2.275193798,490,1045,741,230,0,230,0,61,0,0,empty,mBC-0814-1
"C3,B6",3445,3542,2434,1108,2057,0,1126,1126,793,333,2.381381381,585,1778,1007,276,0,276,0,55,0,0.018115942,empty,mBC-0814-1
"C3,B7",4829,5020,3527,1493,2978,4,1580,1593,1156,437,2.645308924,783,1164,876,256,0,256,0,50,0,0,empty,mBC-0814-1
"C3,B8",286253,308119,195218,112901,183747,1,107932,108056,80131,27925,2.86950761,60776,19518,13376,3825,4,3821,2,461,0,0,mm10,mBC-0814-1
"C3,B9",3800,4014,2712,1302,2385,0,1284,1285,924,361,2.559556787,664,707,521,167,0,167,0,46,0,0,empty,mBC-0814-1
"C3,B10",3448,3566,2418,1148,2209,0,1198,1201,811,390,2.079487179,621,296,197,74,0,74,0,19,0,0,empty,mBC-0814-1
"C3,B11",5470,5881,3985,1896,3296,0,1734,1736,1198,538,2.226765799,901,252,205,60,0,60,0,13,0,0,empty,mBC-0814-1
"C3,B12",284910,338059,177335,160724,201869,1,141346,141521,69535,71986,0.965951713,88482,12154,8436,2249,1,2248,1,304,0,0.00088968,empty,mBC-0814-1
"C3,C1",501796,575148,336418,238730,337324,0,208656,208866,156286,52580,2.9723469,123394,80272,59430,16498,11,16487,1,1279,0,0,mm10,mBC-0814-1
"C3,C2",4482,4853,3165,1688,2868,0,1565,1567,1124,443,2.53724605,869,1084,722,274,0,274,0,73,0,0,empty,mBC-0814-1
"C3,C3",5264,5627,3753,1874,3275,1,1803,1811,1260,551,2.286751361,915,654,416,139,0,139,0,32,0,0,empty,mBC-0814-1
"C3,C4",4083,4416,2908,1508,2552,0,1355,1359,931,428,2.175233645,722,1155,825,305,0,305,0,75,0,0,empty,mBC-0814-1
"C3,C5",6452,6845,4561,2284,4007,0,2143,2146,1551,595,2.606722689,1126,1233,909,298,0,298,0,81,0,0.033557047,empty,mBC-0814-1
"C3,C6",4742,5084,3328,1756,3004,0,1599,1602,1157,445,2.6,861,1100,765,254,0,254,0,65,0,0.003937008,empty,mBC-0814-1
"C3,C7",464893,539542,309904,229638,316349,1,196153,196348,169801,26547,6.39624063,117314,29959,22098,6255,8,6247,1,610,0,0,mm10,mBC-0814-1
"C3,C8",465115,518960,313899,205061,307003,1,186013,186213,133703,52510,2.546238812,107573,189711,139091,39524,26,39498,6,2357,0,7.59532E-05,mm10,mBC-0814-1
"C3,C9",4154,4282,3031,1251,2456,0,1265,1267,892,375,2.378666667,636,1599,1195,316,1,315,1,67,0,0,empty,mBC-0814-1
"C3,C10",555551,656989,367002,289987,386194,0,248367,248643,194373,54270,3.58159204,150497,101967,70702,19751,12,19739,2,1607,0,0.000303967,mm10,mBC-0814-1
"C3,C11",4108,4433,2897,1536,2564,0,1403,1406,1001,405,2.471604938,766,7471,2734,827,0,827,0,106,0,0.021765417,empty,mBC-0814-1
"C3,C12",1148502,1364747,735139,629608,787785,0,530258,530921,385186,145735,2.643057605,328981,226045,163128,45869,20,45849,2,2698,0,0.001330454,mm10,mBC-0814-1
"C3,D1",3719,3906,2626,1280,2323,0,1231,1231,864,367,2.354223433,669,294,210,85,0,85,0,25,0,0,empty,mBC-0814-1
"C3,D2",4541,4656,3377,1279,2746,0,1326,1326,962,364,2.642857143,616,1798,1286,422,0,422,0,84,0,0,empty,mBC-0814-1
"C3,D3",360162,409633,239716,169917,245465,3,152975,153138,123394,29744,4.148534158,90922,32875,22260,6406,5,6401,1,694,0,0.005780347,mm10,mBC-0814-1
"C3,D4",4159,4410,3010,1400,2589,0,1380,1383,986,397,2.483627204,712,1304,937,272,0,272,0,71,0,0.003676471,empty,mBC-0814-1
"C3,D5",3306,3620,2204,1416,2104,0,1183,1185,851,334,2.547904192,667,1851,1324,413,0,413,0,85,0,0,empty,mBC-0814-1
"C3,D6",4598,4867,3260,1607,2791,0,1511,1517,1087,430,2.527906977,802,1430,1099,270,0,270,0,50,0,0.018518519,empty,mBC-0814-1
"C3,D7",4942,5293,3589,1704,3027,0,1622,1626,1156,470,2.459574468,823,1822,1269,391,0,391,0,95,0,0,empty,mBC-0814-1
"C3,D8",4177,4612,3056,1556,2647,0,1437,1440,1052,388,2.711340206,789,1144,849,303,0,303,0,52,0,0.02640264,empty,mBC-0814-1
"C3,D9",2646,2867,1894,973,1675,0,925,932,649,283,2.293286219,487,7369,2210,715,0,715,0,90,0,0.030769231,empty,mBC-0814-1
"C3,D10",3322,3703,2347,1356,2190,0,1253,1254,880,374,2.352941176,685,666,488,175,1,174,1,48,0,0.040229885,empty,mBC-0814-1
"C3,D11",3458,3770,2506,1264,2252,0,1186,1186,806,380,2.121052632,657,6595,2551,831,1,830,1,145,0,0.057831325,empty,mBC-0814-1
"C3,D12",5651,6182,4042,2140,3530,4,1945,1951,1389,562,2.471530249,1029,3077,2285,637,0,637,0,124,0,0.006279435,empty,mBC-0814-1
"C3,E1",4322,4546,3122,1424,2649,0,1374,1376,966,410,2.356097561,707,1571,1207,334,0,334,0,62,0,0,empty,mBC-0814-1
"C3,E2",3272,3474,2262,1212,2027,0,1123,1124,817,307,2.661237785,614,16935,4683,1591,2,1589,2,148,0,0.145374449,empty,mBC-0814-1
"C3,E3",3211,3438,2292,1146,2034,1,1078,1083,774,309,2.504854369,568,930,698,243,0,243,0,46,0,0.04526749,empty,mBC-0814-1
"C3,E4",2830,3135,2011,1124,1748,0,966,966,672,294,2.285714286,503,1178,858,244,0,244,0,48,0,0,empty,mBC-0814-1
"C3,E5",3611,4029,2565,1464,2308,0,1243,1246,868,378,2.296296296,671,1675,1292,401,1,400,1,67,0,0,empty,mBC-0814-1
"C3,E6",4282,4614,3117,1497,2695,0,1394,1394,1043,351,2.971509972,727,1453,921,306,0,306,0,58,0,0,empty,mBC-0814-1
"C3,E7",4190,4321,3111,1210,2575,0,1363,1365,949,416,2.28125,661,1564,1069,306,0,306,0,60,0,0,empty,mBC-0814-1
"C3,E8",485011,546372,327914,218458,321950,1,196095,196323,131643,64680,2.035296846,114172,178518,131413,37140,13,37127,1,2374,0,0.000242411,mm10,mBC-0814-1
"C3,E9",2741,2884,2017,867,1683,0,907,909,665,244,2.725409836,466,1017,685,190,1,189,1,56,0,0.079365079,empty,mBC-0814-1
"C3,E10",3381,3657,2476,1181,2180,0,1166,1169,864,305,2.832786885,616,1348,904,289,0,289,0,60,0,0,empty,mBC-0814-1
"C3,E11",357526,411755,237218,174537,246080,0,151231,151385,123301,28084,4.390435835,90208,291696,213867,59711,39,59672,2,3046,0,0.00010055,mm10,mBC-0814-1
"C3,E12",3288,3529,2372,1157,2035,1,1097,1103,763,340,2.244117647,556,1050,761,270,0,270,0,54,0,0,empty,mBC-0814-1
"C3,F1",608973,695395,413470,281925,406408,0,248427,248746,195039,53707,3.631537788,145906,148776,103677,29705,14,29691,3,1988,0,0.000606244,mm10,mBC-0814-1
"C3,F2",5705,5962,4025,1937,3516,1,1919,1920,1394,526,2.650190114,1020,1390,808,240,0,240,0,73,0,0,empty,mBC-0814-1
"C3,F3",4677,5069,3354,1715,2920,0,1583,1584,1086,498,2.180722892,846,7083,2443,841,0,841,0,119,0,0.007134364,empty,mBC-0814-1
"C3,F4",4658,4734,3397,1337,2828,1,1479,1482,1096,386,2.839378238,723,663,430,136,0,136,0,32,0,0,empty,mBC-0814-1
"C3,F5",4506,4702,3249,1453,2883,0,1577,1586,1115,471,2.367303609,830,1577,1131,290,0,290,0,63,0,0,empty,mBC-0814-1
"C3,F6",4107,4336,2934,1402,2577,0,1468,1474,1031,443,2.32731377,789,1527,1134,335,0,335,0,86,0,0.056716418,empty,mBC-0814-1
"C3,F7",3997,4306,2857,1449,2489,0,1340,1340,967,373,2.592493298,705,477,291,90,0,90,0,30,0,0,empty,mBC-0814-1
"C3,F8",5076,5220,3683,1537,3095,0,1602,1606,1115,491,2.270875764,801,270,174,42,0,42,0,11,0,0,empty,mBC-0814-1
"C3,F9",459307,530613,307134,223479,313389,0,195279,195522,161990,33532,4.83090779,116144,143946,106782,30715,16,30699,1,2026,0,0.000423467,mm10,mBC-0814-1
"C3,F10",5745,6052,4247,1805,3537,0,1811,1816,1263,553,2.283905967,917,1187,797,285,0,285,0,67,0,0,empty,mBC-0814-1
"C3,F11",3817,3994,2767,1227,2348,0,1244,1244,868,376,2.308510638,620,1898,1428,397,1,396,1,64,0,0,empty,mBC-0814-1
"C3,F12",4229,4377,3012,1365,2505,0,1337,1346,932,414,2.251207729,692,16,12,11,0,11,0,11,0,0,empty,mBC-0814-1
"C3,G1",6386,6776,4648,2128,3891,0,2060,2062,1512,550,2.749090909,1056,2638,1969,596,1,595,1,136,0,0.005042017,empty,mBC-0814-1
"C3,G2",449506,523868,302692,221176,311403,0,195719,195889,147757,48132,3.069828804,117290,24438,14621,3979,8,3971,1,466,0,0,mm10,mBC-0814-1
"C3,G3",4312,4675,3064,1611,2750,0,1514,1514,1086,428,2.537383178,822,1363,954,291,0,291,0,77,0,0.013745704,empty,mBC-0814-1
"C3,G4",4709,4897,3410,1487,2797,6,1465,1473,1040,433,2.401847575,745,2,2,2,0,2,0,2,0,0,empty,mBC-0814-1
"C3,G5",4245,4551,3017,1534,2675,0,1510,1512,1084,428,2.53271028,788,1272,983,325,0,325,0,67,0,0,empty,mBC-0814-1
"C3,G6",7854,8271,5706,2565,4776,0,2469,2469,1812,657,2.757990868,1236,856,248,72,0,72,0,18,0,0.041666667,empty,mBC-0814-1
"C3,G7",4672,4792,3350,1442,2829,0,1444,1447,1003,444,2.259009009,776,1721,1132,303,0,303,0,88,0,0,empty,mBC-0814-1
"C3,G8",311433,367960,204913,163047,219518,0,139010,139168,116015,23153,5.010797737,84880,238740,174989,49596,29,49567,2,2728,0,0.000201747,mm10,mBC-0814-1
"C3,G9",4139,4324,2855,1469,2497,0,1382,1382,984,398,2.472361809,695,2760,1858,567,0,567,0,122,0,0.008818342,empty,mBC-0814-1
"C3,G10",7873,8341,5734,2607,4964,0,2600,2602,1837,765,2.40130719,1344,4644,2433,726,2,724,1,156,0,0,empty,mBC-0814-1
"C3,G11",8002,8573,5754,2819,4986,0,2604,2608,1858,750,2.477333333,1360,1332,920,311,0,311,0,77,0,0.003215434,empty,mBC-0814-1
"C3,G12",4491,4944,3253,1691,2873,1,1564,1565,1118,447,2.501118568,800,2039,1348,436,0,436,0,95,0,0.009174312,empty,mBC-0814-1
"C3,H1",3804,4142,2688,1454,2438,0,1338,1342,963,379,2.540897098,733,877,639,175,0,175,0,38,0,0,empty,mBC-0814-1
"C3,H2",7036,7532,4919,2613,4409,0,2437,2438,1684,754,2.233421751,1318,26309,8161,2654,5,2649,2,276,0,0.104567761,empty,mBC-0814-1
"C3,H3",4491,4861,3135,1726,2784,0,1537,1538,1065,473,2.251585624,853,1473,1058,317,0,317,0,65,0,0.006309148,empty,mBC-0814-1
"C3,H4",4508,4728,3251,1477,2706,0,1437,1439,1003,436,2.300458716,742,127,89,33,0,33,0,13,0,0,empty,mBC-0814-1
"C3,H5",6164,6480,4498,1982,3724,0,1961,1964,1393,571,2.439579685,1006,1894,1328,408,1,407,1,78,0,0.007371007,empty,mBC-0814-1
"C3,H6",5470,5829,3877,1952,3469,0,1873,1876,1305,571,2.285464098,1026,2245,1483,465,0,465,0,91,0,0,empty,mBC-0814-1
"C3,H7",4569,4769,3241,1528,2850,0,1548,1556,1086,470,2.310638298,823,13081,4704,1413,2,1411,1,158,0,0.027639972,empty,mBC-0814-1
"C3,H8",315416,364812,208297,156515,216982,1,139552,139719,111795,27924,4.003545337,84036,34994,20105,5866,3,5863,1,619,0,0.006310762,mm10,mBC-0814-1
"C3,H9",4070,4384,2908,1476,2593,0,1379,1385,983,402,2.445273632,755,1242,936,309,0,309,0,49,0,0.022653722,empty,mBC-0814-1
"C3,H10",2889,3053,2047,1006,1780,0,982,985,693,292,2.373287671,498,1172,810,219,1,218,1,51,0,0,empty,mBC-0814-1
"C3,H11",370487,426021,241992,184029,254464,0,163955,164113,123506,40607,3.041495309,99489,2096,1369,360,1,359,1,65,0,0.061281337,empty,mBC-0814-1
"C3,H12",2078,2284,1431,853,1351,0,766,770,552,218,2.532110092,446,1407,1037,342,0,342,0,65,0,0.035087719,empty,mBC-0814-1
"C4,A1",5596,5965,4032,1933,3587,0,1992,1995,1368,627,2.181818182,1019,1657,1174,357,0,357,0,74,0,0,empty,mBC-0814-1
"C4,A2",5628,6077,3925,2152,3538,0,1936,1940,1455,485,3,1045,1993,1424,522,0,522,0,123,0,0,empty,mBC-0814-1
"C4,A3",5058,5507,3619,1888,3149,0,1725,1725,1196,529,2.260869565,922,2896,948,316,0,316,0,69,0,0,empty,mBC-0814-1
"C4,A4",5656,6156,4072,2084,3583,2,1912,1914,1359,555,2.448648649,1022,606,354,134,0,134,0,30,0,0,empty,mBC-0814-1
"C4,A5",360329,421359,240856,180503,255362,0,163170,163325,130111,33214,3.917354128,98588,21359,15277,4171,2,4169,1,485,0,0,mm10,mBC-0814-1
"C4,A6",3925,4183,2776,1407,2482,0,1383,1386,959,427,2.245901639,726,1406,957,241,1,240,1,55,0,0.054166667,empty,mBC-0814-1
"C4,A7",5616,6244,3962,2282,3682,0,2046,2046,1406,640,2.196875,1155,1914,1283,368,0,368,0,82,0,0.016304348,empty,mBC-0814-1
"C4,A8",221722,264181,145058,119123,161043,0,106239,106371,81785,24586,3.326486618,65307,94027,67103,19374,13,19361,2,1490,0,0.001704457,mm10,mBC-0814-1
"C4,A9",6525,6971,4729,2242,4057,0,2175,2179,1552,627,2.475279107,1103,1566,1052,317,0,317,0,81,0,0.015772871,empty,mBC-0814-1
"C4,A10",3697,3828,2592,1236,2343,0,1318,1318,959,359,2.671309192,699,109,49,31,0,31,0,15,0,0,empty,mBC-0814-1
"C4,A11",4843,5171,3471,1700,3116,0,1700,1702,1221,481,2.538461538,883,2705,2003,593,1,592,1,101,0,0.018581081,empty,mBC-0814-1
"C4,A12",4456,4790,3203,1587,2890,0,1603,1603,1224,379,3.229551451,840,3460,2263,709,0,709,0,187,0,0,empty,mBC-0814-1
"C4,B1",4914,5383,3474,1909,3178,0,1714,1718,1233,485,2.542268041,930,1106,815,259,0,259,0,76,0,0.011583012,empty,mBC-0814-1
"C4,B2",5117,5564,3686,1878,3271,0,1747,1750,1214,536,2.264925373,917,397,287,79,0,79,0,32,0,0,empty,mBC-0814-1
"C4,B3",1017706,1179877,676381,503496,699019,2,449615,450032,343831,106201,3.237549552,269875,205508,122867,34800,32,34768,7,2380,0,0.009347676,mm10,mBC-0814-1
"C4,B4",4597,5089,3375,1714,2958,3,1615,1618,1214,404,3.004950495,865,1314,885,288,0,288,0,76,0,0,empty,mBC-0814-1
"C4,B5",3956,2667,1657,1010,1902,4,1049,1057,761,296,2.570945946,620,886,463,197,0,197,0,70,0,0,empty,mBC-0814-1
"C4,B6",4141,4600,2948,1652,2789,0,1589,1592,1127,465,2.423655914,920,1616,1173,308,0,308,0,67,0,0.016233766,empty,mBC-0814-1
"C4,B7",5162,5399,3662,1737,3216,4,1643,1647,1225,422,2.902843602,856,1544,985,241,0,241,0,60,0,0.053941909,empty,mBC-0814-1
"C4,B8",3932,4132,2923,1209,2462,0,1264,1266,918,348,2.637931034,645,857,562,204,0,204,0,52,0,0,empty,mBC-0814-1
"C4,B9",4987,5433,3513,1920,3126,0,1732,1734,1289,445,2.896629213,928,559,378,134,0,134,0,59,0,0,empty,mBC-0814-1
"C4,B10",4611,4919,3179,1740,3064,0,1754,1759,1172,587,1.996592845,961,931,714,192,0,192,0,41,0,0.130208333,empty,mBC-0814-1
"C4,B11",479958,566970,319015,247955,333556,0,210780,210985,170296,40689,4.185308069,127723,10589,7651,2217,1,2216,1,277,0,0,mm10,mBC-0814-1
"C4,B12",5480,6012,3908,2104,3491,0,1913,1916,1388,528,2.628787879,1064,1300,936,292,1,291,1,66,0,0.068728522,empty,mBC-0814-1
"C4,C1",30282,33236,21732,11504,19273,0,10748,10761,6793,3968,1.711945565,5787,4944,3065,896,1,895,1,149,0,0.002234637,empty,mBC-0814-1
"C4,C2",5398,5850,3842,2008,3407,0,1886,1889,1353,536,2.524253731,999,1777,1156,385,0,385,0,93,0,0.002597403,empty,mBC-0814-1
"C4,C3",6045,6647,4299,2348,3820,0,2071,2071,1496,575,2.60173913,1137,692,454,181,0,181,0,42,0,0,empty,mBC-0814-1
"C4,C4",5360,5611,3866,1745,3332,0,1796,1802,1316,486,2.70781893,909,1763,1151,336,0,336,0,90,0,0.00297619,empty,mBC-0814-1
"C4,C5",9078,10112,6514,3598,5952,0,3334,3337,2471,866,2.85334873,1825,1384,914,328,0,328,0,85,0,0,empty,mBC-0814-1
"C4,C6",6510,7070,4643,2427,4338,0,2402,2402,1786,616,2.899350649,1276,13270,4184,1368,2,1366,1,152,0,0.156661786,empty,mBC-0814-1
"C4,C7",6994,7623,4919,2704,4398,0,2434,2436,1779,657,2.707762557,1307,396,277,96,0,96,0,27,0,0,empty,mBC-0814-1
"C4,C8",5373,5630,3881,1749,3411,0,1799,1803,1309,494,2.649797571,939,2239,1550,485,0,485,0,92,0,0,empty,mBC-0814-1
"C4,C9",4605,4905,3283,1622,2977,0,1628,1628,1140,488,2.336065574,920,1418,976,272,0,272,0,70,0,0,empty,mBC-0814-1
"C4,C10",495005,564075,337404,226671,334993,4,206730,206957,169053,37904,4.460030604,121472,40556,27915,8109,11,8098,3,766,0,0.000123487,mm10,mBC-0814-1
"C4,C11",4903,5271,3458,1813,3062,0,1724,1724,1231,493,2.496957404,947,9334,2984,941,1,940,1,123,0,0.036170213,empty,mBC-0814-1
"C4,C12",8405,9236,5848,3388,5285,0,2963,2965,2098,867,2.419838524,1615,1865,1226,430,0,430,0,97,0,0.044186047,empty,mBC-0814-1
"C4,D1",4462,4680,3198,1482,2879,0,1507,1507,1103,404,2.73019802,773,693,420,122,0,122,0,31,0,0,empty,mBC-0814-1
"C4,D2",5483,6068,3954,2114,3398,0,1754,1755,1277,478,2.671548117,951,1515,1035,341,1,340,1,81,0,0,empty,mBC-0814-1
"C4,D3",11027,11819,7856,3963,6896,0,3771,3775,2673,1102,2.425589837,2010,12551,4231,1321,3,1318,2,168,0,0.004552352,empty,mBC-0814-1
"C4,D4",4645,5099,3383,1716,3075,0,1735,1737,1201,536,2.240671642,922,1668,1053,314,0,314,0,75,0,0,empty,mBC-0814-1
"C4,D5",4751,5222,3388,1834,3076,3,1691,1695,1254,441,2.843537415,920,1952,1265,414,0,414,0,107,0,0,empty,mBC-0814-1
"C4,D6",591957,704222,395082,309140,411713,1,261953,262221,207886,54335,3.826005337,159217,315059,225410,63699,44,63655,3,3161,0,0.000235645,mm10,mBC-0814-1
"C4,D7",5680,6032,4070,1962,3545,2,1861,1868,1368,500,2.736,986,2587,1932,514,0,514,0,106,0,0,empty,mBC-0814-1
"C4,D8",5198,5556,3649,1907,3304,0,1823,1827,1334,493,2.705882353,1002,6150,2287,695,0,695,0,97,0,0.001438849,empty,mBC-0814-1
"C4,D9",3506,3918,2526,1392,2347,2,1298,1302,941,361,2.606648199,698,1411,1008,265,0,265,0,52,0,0.045283019,empty,mBC-0814-1
"C4,D10",455343,521116,308593,212523,308177,0,188915,189108,160632,28476,5.640960809,111068,84428,61119,18092,10,18082,2,1435,0,0.000442429,mm10,mBC-0814-1
"C4,D11",4405,4868,3186,1682,2843,4,1498,1507,1091,416,2.622596154,824,2109,1494,430,0,430,0,124,0,0,empty,mBC-0814-1
"C4,D12",6361,7010,4644,2366,4029,0,2208,2212,1545,667,2.316341829,1188,2912,2024,594,0,594,0,112,0,0,empty,mBC-0814-1
"C4,E1",5262,5548,3771,1777,3258,0,1751,1754,1312,442,2.968325792,918,1076,720,243,0,243,0,80,0,0,empty,mBC-0814-1
"C4,E2",3537,3796,2428,1368,2306,0,1261,1261,885,376,2.353723404,693,1140,846,242,2,240,1,69,0,0,empty,mBC-0814-1
"C4,E3",3590,3885,2698,1187,2290,0,1228,1230,887,343,2.586005831,648,1290,949,276,0,276,0,71,0,0,empty,mBC-0814-1
"C4,E4",3260,3506,2273,1233,2142,0,1206,1206,849,357,2.378151261,675,1116,713,279,1,278,1,86,0,0.010791367,empty,mBC-0814-1
"C4,E5",612641,709808,408142,301666,417337,4,264834,265185,200252,64933,3.083978871,158549,125397,91093,25817,14,25803,3,1749,0,0,mm10,mBC-0814-1
"C4,E6",4563,4867,3320,1547,2834,0,1519,1519,1097,422,2.599526066,778,1437,955,271,0,271,0,64,0,0,empty,mBC-0814-1
"C4,E7",4931,5464,3622,1842,3050,1,1590,1591,1193,398,2.997487437,842,1521,1010,322,0,322,0,69,0,0,empty,mBC-0814-1
"C4,E8",4565,4902,3283,1619,2920,0,1563,1564,1095,469,2.334754797,823,1619,1158,347,2,345,1,83,0,0.055072464,empty,mBC-0814-1
"C4,E9",3388,3640,2378,1262,2091,0,1179,1180,880,300,2.933333333,615,2975,1164,382,1,381,1,81,0,0.007874016,empty,mBC-0814-1
"C4,E10",323355,373306,218290,155016,225505,1,140624,140820,101228,39592,2.556779147,84012,37678,26168,7398,8,7390,1,773,0,0.000405954,mm10,mBC-0814-1
"C4,E11",437672,512750,288226,224524,306699,0,197024,197242,147563,49679,2.970329515,119105,182631,118738,33929,20,33909,2,2249,0,0.004158188,mm10,mBC-0814-1
"C4,E12",4081,4446,2858,1588,2624,0,1469,1471,1108,363,3.052341598,823,1082,795,219,0,219,0,59,0,0.00913242,empty,mBC-0814-1
"C4,F1",4526,4999,3182,1817,2946,0,1606,1608,1131,477,2.371069182,867,1872,1342,399,0,399,0,75,0,0,empty,mBC-0814-1
"C4,F2",6842,7394,4872,2522,4268,0,2340,2342,1768,574,3.080139373,1232,1516,1008,327,0,327,0,109,0,0.064220183,empty,mBC-0814-1
"C4,F3",644549,746486,432088,314398,440293,3,277919,278218,194107,84111,2.307748095,166128,109988,79677,22424,12,22412,3,1800,0,0.000892379,mm10,mBC-0814-1
"C4,F4",1665808,1930304,1106381,823923,1130450,2,725426,726213,579782,146431,3.959421161,434212,213258,154023,43478,24,43454,4,2632,0,0.000805449,mm10,mBC-0814-1
"C4,F5",5446,5693,3820,1873,3403,0,1847,1849,1333,516,2.583333333,993,1349,998,278,0,278,0,58,0,0,empty,mBC-0814-1
"C4,F6",1623823,1869905,1074604,795301,1079843,1,685570,686257,589087,97170,6.062436966,411091,894510,589896,172204,103,172101,9,5354,0,0.000668212,mm10,mBC-0814-1
"C4,F7",664557,783107,443633,339474,463205,8,293013,293332,241746,51586,4.686271469,176700,117427,86302,24438,10,24428,1,1796,0,0.000695923,mm10,mBC-0814-1
"C4,F8",6082,6644,4368,2276,3928,0,2150,2153,1506,647,2.327666151,1123,26,15,12,0,12,0,10,0,0,empty,mBC-0814-1
"C4,F9",5613,5920,3993,1927,3468,6,1826,1832,1350,482,2.800829876,996,2052,1473,395,0,395,0,81,0,0,empty,mBC-0814-1
"C4,F10",6792,7112,4938,2174,4111,0,2181,2185,1577,608,2.59375,1094,1250,836,274,0,274,0,73,0,0.069343066,empty,mBC-0814-1
"C4,F11",4482,4849,3172,1677,2791,0,1576,1578,1128,450,2.506666667,833,1323,872,238,0,238,0,48,0,0.046218487,empty,mBC-0814-1
"C4,F12",461285,532585,310280,222305,312914,0,193710,193872,165327,28545,5.791802417,115544,8633,5336,1512,0,1512,0,219,0,0,mm10,mBC-0814-1
"C4,G1",493641,559146,332058,227088,333343,0,207721,207905,157544,50361,3.128293719,122260,36828,25856,7320,5,7315,2,815,0,0,mm10,mBC-0814-1
"C4,G2",5671,6127,4046,2081,3615,0,1972,1972,1383,589,2.348047538,1056,521,310,85,1,84,1,25,0,0,empty,mBC-0814-1
"C4,G3",5097,5598,3692,1906,3341,0,1852,1852,1346,506,2.660079051,1007,2423,1915,593,0,593,0,114,0,0,empty,mBC-0814-1
"C4,G4",5469,5696,3979,1717,3422,0,1857,1859,1347,512,2.630859375,966,1,0,0,0,0,0,0,0,0,empty,mBC-0814-1
"C4,G5",4476,4856,3154,1702,2907,0,1570,1570,1131,439,2.576309795,889,1520,1058,279,1,278,1,69,0,0,empty,mBC-0814-1
"C4,G6",542531,593103,378002,215101,350966,3,204582,204841,129574,75267,1.721524705,116036,1255,775,258,0,258,0,44,0,0,empty,mBC-0814-1
"C4,G7",5591,6168,3962,2206,3571,0,1970,1971,1420,551,2.577132486,1051,2486,1661,475,0,475,0,124,0,0,empty,mBC-0814-1
"C4,G8",7765,8349,5487,2862,4903,0,2726,2735,1943,792,2.453282828,1456,3815,2796,852,0,852,0,174,0,0.001173709,empty,mBC-0814-1
"C4,G9",5378,5908,3846,2062,3586,0,2055,2057,1525,532,2.866541353,1125,2723,1842,546,0,546,0,144,0,0.001831502,empty,mBC-0814-1
"C4,G10",9392,9876,6774,3102,5941,0,3159,3161,2277,884,2.575791855,1671,3339,2321,719,1,718,1,167,0,0.001392758,empty,mBC-0814-1
"C4,G11",9368,10178,6722,3456,5990,1,3270,3273,2317,956,2.423640167,1765,1341,891,295,0,295,0,81,0,0,empty,mBC-0814-1
"C4,G12",4999,5580,3562,2018,3305,0,1904,1904,1412,492,2.869918699,1045,2752,1927,564,0,564,0,101,0,0.026595745,empty,mBC-0814-1
"C4,H1",4815,5227,3486,1741,3036,0,1641,1641,1211,430,2.81627907,883,983,695,210,0,210,0,43,0,0,empty,mBC-0814-1
"C4,H2",213198,257885,143923,113962,154324,1,100673,100773,72567,28206,2.572750479,62098,24662,14086,3981,4,3977,2,509,0,0.015338195,mm10,mBC-0814-1
"C4,H3",5506,5743,3866,1877,3463,0,1916,1921,1354,567,2.388007055,965,1183,735,252,0,252,0,66,0,0.003968254,empty,mBC-0814-1
"C4,H4",988100,1153696,659478,494218,670223,1,425747,426212,335135,91077,3.679688615,256426,15430,10967,2883,3,2880,1,383,0,0,mm10,mBC-0814-1
"C4,H5",6841,7533,4903,2630,4321,0,2434,2435,1695,740,2.290540541,1315,1610,1083,322,0,322,0,76,0,0,empty,mBC-0814-1
"C4,H6",6361,6752,4592,2160,3944,0,2158,2171,1591,580,2.743103448,1110,7901,3014,855,2,853,1,140,0,0.012895662,empty,mBC-0814-1
"C4,H7",5626,6057,4004,2053,3658,0,2032,2033,1458,575,2.535652174,1108,1585,1087,383,0,383,0,80,0,0.049608355,empty,mBC-0814-1
"C4,H8",5239,5475,3731,1744,3213,0,1770,1770,1333,437,3.050343249,911,12221,3994,1383,2,1381,1,203,0,0.068066618,empty,mBC-0814-1
"C4,H9",4856,5076,3490,1586,3053,0,1668,1668,1203,465,2.587096774,847,1924,1040,336,0,336,0,67,0,0.0625,empty,mBC-0814-1
"C4,H10",3793,4143,2701,1442,2454,0,1368,1368,985,383,2.571801567,716,841,563,189,0,189,0,64,0,0,empty,mBC-0814-1
"C4,H11",4151,4749,2894,1855,2737,0,1559,1559,1092,467,2.338329764,891,33,19,12,0,12,0,7,0,0,empty,mBC-0814-1
"C4,H12",2940,3130,1966,1164,1890,0,1092,1096,790,306,2.581699346,613,1645,1172,366,1,365,1,94,0,0,empty,mBC-0814-1
"C5,A1",5524,6152,3899,2253,3544,0,1974,1979,1382,597,2.314907873,1078,1260,857,258,1,257,1,60,0,0,empty,mBC-0814-1
"C5,A2",5938,6128,4083,2045,3504,0,1902,1905,1339,566,2.365724382,1009,127408,38360,13010,18,12992,3,967,0,0.100138547,empty,mBC-0814-1
"C5,A3",5456,6185,3922,2263,3559,0,1974,1974,1483,491,3.020366599,1104,1133,664,225,0,225,0,52,0,0,empty,mBC-0814-1
"C5,A4",5343,5725,3857,1868,3308,0,1709,1709,1226,483,2.538302277,910,236,151,84,0,84,0,18,0,0,empty,mBC-0814-1
"C5,A5",4611,5020,3335,1685,2978,0,1583,1585,1095,490,2.234693878,846,3167,1267,373,1,372,1,64,0,0.040322581,empty,mBC-0814-1
"C5,A6",3840,3956,2811,1145,2287,0,1225,1229,866,363,2.385674931,570,1024,767,258,1,257,1,60,0,0.003891051,empty,mBC-0814-1
"C5,A7",5189,5587,3766,1821,3328,0,1788,1792,1274,518,2.459459459,955,1791,1245,393,0,393,0,71,0,0.066157761,empty,mBC-0814-1
"C5,A8",186708,222404,121726,100678,134613,0,87101,87190,62630,24560,2.550081433,53909,145640,106114,29550,27,29523,2,2105,0,0.001151644,mm10,mBC-0814-1
"C5,A9",6369,7015,4487,2528,4014,0,2169,2176,1558,618,2.521035599,1233,1176,770,273,0,273,0,70,0,0,empty,mBC-0814-1
"C5,A10",3442,3716,2410,1306,2204,0,1209,1209,852,357,2.386554622,674,271,142,33,0,33,0,12,0,0,empty,mBC-0814-1
"C5,A11",4900,5100,3482,1618,3031,2,1638,1642,1166,476,2.449579832,844,2331,1392,444,1,443,1,81,0,0.013544018,empty,mBC-0814-1
"C5,A12",3810,4137,2739,1398,2503,0,1408,1413,1057,356,2.969101124,766,2969,2032,673,0,673,0,152,0,0.008915305,empty,mBC-0814-1
"C5,B1",4619,5099,3363,1736,2970,0,1573,1576,1084,492,2.203252033,894,1434,966,314,0,314,0,76,0,0,empty,mBC-0814-1
"C5,B2",462735,538186,306092,232094,318911,1,201508,201716,151395,50321,3.008584885,121528,45898,32604,9391,10,9381,3,885,0,0,mm10,mBC-0814-1
"C5,B3",3875,4189,2768,1421,2533,1,1427,1430,1030,400,2.575,778,1374,902,269,0,269,0,56,0,0,empty,mBC-0814-1
"C5,B4",4236,4401,3056,1345,2638,5,1428,1437,1054,383,2.751958225,737,7611,2635,770,0,770,0,86,0,0.061038961,empty,mBC-0814-1
"C5,B5",3958,2813,1821,992,1932,0,1118,1125,845,280,3.017857143,608,1242,804,211,1,210,1,56,0,0,empty,mBC-0814-1
"C5,B6",3782,4105,2699,1406,2421,0,1327,1338,958,380,2.521052632,717,5147,2392,750,1,749,1,96,0,0.025367156,empty,mBC-0814-1
"C5,B7",4914,5395,3526,1869,3084,0,1658,1661,1206,455,2.650549451,900,1340,899,289,0,289,0,51,0,0,empty,mBC-0814-1
"C5,B8",3504,3770,2576,1194,2276,0,1226,1231,869,362,2.400552486,635,1367,1070,274,0,274,0,56,0,0,empty,mBC-0814-1
"C5,B9",4721,5208,3440,1768,3003,0,1628,1629,1151,478,2.407949791,860,893,596,187,0,187,0,54,0,0,empty,mBC-0814-1
"C5,B10",4223,4278,2948,1330,2531,0,1356,1356,956,400,2.39,687,508,370,122,0,122,0,22,0,0,empty,mBC-0814-1
"C5,B11",6271,6798,4488,2310,3798,2,2006,2009,1495,514,2.908560311,1017,112,80,24,0,24,0,4,0,0,empty,mBC-0814-1
"C5,B12",412024,480589,276225,204364,286474,1,179891,180092,134967,45125,2.990958449,108578,70237,51535,14490,13,14477,2,1190,0,0.0002763,mm10,mBC-0814-1
"C5,C1",5520,5772,3961,1811,3279,0,1720,1720,1224,496,2.467741935,870,917,538,174,1,173,1,33,0,0,empty,mBC-0814-1
"C5,C2",5205,5652,3780,1872,3323,0,1806,1811,1287,524,2.45610687,977,2031,1494,400,1,399,1,102,0,0.002506266,empty,mBC-0814-1
"C5,C3",5834,6074,4143,1931,3518,1,1861,1865,1366,499,2.73747495,984,370,197,71,0,71,0,21,0,0,empty,mBC-0814-1
"C5,C4",5120,5511,3592,1919,3216,0,1737,1739,1245,494,2.520242915,939,1305,908,324,0,324,0,69,0,0.040123457,empty,mBC-0814-1
"C5,C5",6957,7494,5108,2386,4330,0,2328,2328,1672,656,2.548780488,1235,1040,679,198,0,198,0,62,0,0,empty,mBC-0814-1
"C5,C6",5329,5820,3832,1988,3484,0,1932,1934,1357,577,2.351819757,1062,1384,914,315,1,314,1,62,0,0,empty,mBC-0814-1
"C5,C7",7033,7321,5227,2094,4192,0,2166,2167,1594,573,2.781849913,1050,308,227,58,0,58,0,20,0,0,empty,mBC-0814-1
"C5,C8",5231,5485,3776,1709,3221,0,1684,1688,1256,432,2.907407407,848,1455,832,239,0,239,0,63,0,0,empty,mBC-0814-1
"C5,C9",4509,5099,3276,1823,2928,0,1611,1621,1102,519,2.123314066,917,1343,861,268,0,268,0,68,0,0.082089552,empty,mBC-0814-1
"C5,C10",5736,6364,4186,2178,3704,0,1989,1999,1393,606,2.298679868,1091,1392,963,278,1,277,1,58,0,0,empty,mBC-0814-1
"C5,C11",548288,640745,365961,274784,375169,0,233392,233720,190277,43443,4.379923118,140095,330578,230480,66080,38,66042,3,3178,0,0.001135641,mm10,mBC-0814-1
"C5,C12",470874,549008,313682,235326,320226,0,198653,198896,169435,29461,5.751162554,119762,179138,126896,35932,20,35912,4,2207,0,0.001559367,mm10,mBC-0814-1
"C5,D1",447892,533317,289116,244201,317943,1,211807,212068,143407,68661,2.088623818,131032,30778,21634,5920,5,5915,1,620,0,0.000845309,mm10,mBC-0814-1
"C5,D2",5230,5437,3886,1551,3118,0,1583,1585,1114,471,2.365180467,770,1682,1263,420,0,420,0,80,0,0,empty,mBC-0814-1
"C5,D3",10961,11981,7808,4173,7009,0,3868,3879,2797,1082,2.585027726,2125,1976,1410,414,0,414,0,93,0,0.04589372,empty,mBC-0814-1
"C5,D4",4594,5005,3225,1780,2994,0,1653,1657,1162,495,2.347474747,930,1000,725,222,0,222,0,64,0,0.004504505,empty,mBC-0814-1
"C5,D5",4352,4564,3059,1505,2679,0,1484,1487,1076,411,2.618004866,782,20188,6005,1905,0,1905,0,242,0,0.007349081,empty,mBC-0814-1
"C5,D6",5025,5278,3654,1624,3064,0,1637,1641,1157,484,2.390495868,848,996,613,202,0,202,0,53,0,0.074257426,empty,mBC-0814-1
"C5,D7",5525,5822,3876,1946,3434,0,1865,1867,1344,523,2.569789675,991,2143,1503,496,1,495,1,98,0,0.022222222,empty,mBC-0814-1
"C5,D8",4920,5226,3491,1735,3067,0,1679,1680,1215,465,2.612903226,866,1124,794,194,0,194,0,46,0,0,empty,mBC-0814-1
"C5,D9",2909,3272,2006,1266,1914,0,1070,1070,754,316,2.386075949,613,1414,979,310,0,310,0,43,0,0.009677419,empty,mBC-0814-1
"C5,D10",3461,3703,2425,1278,2226,0,1249,1250,919,331,2.776435045,681,924,610,213,0,213,0,53,0,0,empty,mBC-0814-1
"C5,D11",627704,717864,424448,293416,416935,0,255587,255881,215139,40742,5.280521329,150225,229040,167161,46986,34,46952,2,2477,0,0.000191685,mm10,mBC-0814-1
"C5,D12",6397,6680,4493,2187,3930,0,2103,2106,1476,630,2.342857143,1131,3292,2350,583,0,583,0,114,0,0,empty,mBC-0814-1
"C5,E1",4856,5075,3532,1543,3008,6,1528,1538,1118,420,2.661904762,792,1528,1092,332,0,332,0,68,0,0,empty,mBC-0814-1
"C5,E2",485284,577201,321508,255693,339834,2,220105,220326,150232,70094,2.143293292,134185,106191,78185,22648,11,22637,1,1644,0,0,mm10,mBC-0814-1
"C5,E3",3378,3549,2489,1060,2007,0,1019,1021,737,284,2.595070423,504,1786,1377,362,2,360,1,70,0,0,empty,mBC-0814-1
"C5,E4",3123,3478,2233,1245,2043,0,1181,1182,802,380,2.110526316,663,819,517,195,0,195,0,47,0,0,empty,mBC-0814-1
"C5,E5",580740,664244,392830,271414,388597,0,240466,240760,191632,49128,3.900667644,141001,105668,74823,21545,16,21529,1,1601,0,0.000975428,mm10,mBC-0814-1
"C5,E6",4499,4742,3263,1479,2773,0,1486,1490,1080,410,2.634146341,784,1108,765,208,0,208,0,55,0,0,empty,mBC-0814-1
"C5,E7",4521,4977,3287,1690,2835,0,1511,1511,1101,410,2.685365854,801,1127,801,225,0,225,0,54,0,0,empty,mBC-0814-1
"C5,E8",4572,4814,3253,1561,2791,0,1437,1443,1030,413,2.493946731,730,1468,991,323,0,323,0,71,0,0.040247678,empty,mBC-0814-1
"C5,E9",3154,3607,2222,1385,2021,0,1135,1142,796,346,2.300578035,653,6191,2530,778,0,778,0,107,0,0.017994859,empty,mBC-0814-1
"C5,E10",4529,4734,3174,1560,2704,0,1481,1481,1056,425,2.484705882,777,16660,5923,2052,5,2047,2,193,0,0.210552027,empty,mBC-0814-1
"C5,E11",4230,4512,3073,1439,2560,0,1366,1366,1006,360,2.794444444,691,1479,977,317,1,316,1,69,0,0,empty,mBC-0814-1
"C5,E12",3862,4237,2753,1484,2525,0,1399,1402,980,422,2.322274882,775,1430,1054,310,0,310,0,60,0,0,empty,mBC-0814-1
"C5,F1",4756,5113,3485,1628,2888,0,1532,1534,1093,441,2.47845805,760,1729,1297,342,0,342,0,62,0,0.043859649,empty,mBC-0814-1
"C5,F2",6186,6539,4481,2058,3822,0,2047,2047,1499,548,2.73540146,1053,2248,1670,505,0,505,0,102,0,0,empty,mBC-0814-1
"C5,F3",54534,61534,37803,23731,36253,2,21166,21190,16451,4739,3.47140747,12203,32330,24179,6864,5,6859,2,667,0,0.000728969,empty,mBC-0814-1
"C5,F4",5219,5559,3797,1762,3334,0,1769,1771,1298,473,2.744186047,938,591,360,91,0,91,0,25,0,0,empty,mBC-0814-1
"C5,F5",4971,5389,3631,1758,3091,0,1707,1714,1258,456,2.75877193,894,1141,786,226,0,226,0,47,0,0,empty,mBC-0814-1
"C5,F6",4748,5243,3447,1796,3045,0,1685,1685,1193,492,2.424796748,913,1887,1331,433,0,433,0,98,0,0,empty,mBC-0814-1
"C5,F7",4452,4879,3209,1670,2879,0,1550,1550,1091,459,2.376906318,831,695,488,182,0,182,0,41,0,0,empty,mBC-0814-1
"C5,F8",1509180,1737184,1001229,735955,1004713,0,656207,656959,471634,185325,2.544902199,390889,18849,13486,3615,1,3614,1,440,0,0,mm10,mBC-0814-1
"C5,F9",5399,5591,3837,1754,3309,3,1737,1742,1256,486,2.58436214,914,1964,1362,397,0,397,0,89,0,0.032745592,empty,mBC-0814-1
"C5,F10",6539,7030,4666,2364,4087,1,2207,2212,1546,666,2.321321321,1177,1596,1127,328,0,328,0,60,0,0,empty,mBC-0814-1
"C5,F11",4257,4675,3068,1607,2733,0,1484,1486,1047,439,2.384965831,792,1514,1060,376,1,375,1,77,0,0.008,empty,mBC-0814-1
"C5,F12",4796,5063,3477,1586,2916,0,1559,1559,1139,420,2.711904762,786,95,61,23,0,23,0,5,0,0,empty,mBC-0814-1
"C5,G1",550351,633778,369022,264756,373506,6,232682,232950,169301,63649,2.659916102,138647,183833,133773,37370,26,37344,6,2418,0,2.67781E-05,mm10,mBC-0814-1
"C5,G2",5480,5805,3947,1858,3382,0,1843,1843,1313,530,2.477358491,960,337,202,57,0,57,0,14,0,0,empty,mBC-0814-1
"C5,G3",5279,5528,3836,1692,3147,1,1688,1694,1205,489,2.464212679,842,1846,1235,412,1,411,1,87,0,0,empty,mBC-0814-1
"C5,G4",5272,5477,3822,1655,3208,0,1688,1689,1176,513,2.292397661,863,7,7,2,0,2,0,2,0,0,empty,mBC-0814-1
"C5,G5",4636,5152,3291,1861,2942,0,1629,1629,1165,464,2.510775862,900,1266,885,272,0,272,0,59,0,0,empty,mBC-0814-1
"C5,G6",632759,731262,425822,305440,425477,0,263660,263965,210451,53514,3.932634451,156847,11235,7322,2096,1,2095,1,264,0,0,mm10,mBC-0814-1
"C5,G7",5407,5752,3885,1867,3378,0,1824,1824,1288,536,2.402985075,929,2953,1917,622,0,622,0,115,0,0,empty,mBC-0814-1
"C5,G8",7224,7969,5107,2862,4586,0,2531,2537,1812,725,2.499310345,1376,4365,3117,843,1,842,1,158,0,0.020190024,empty,mBC-0814-1
"C5,G9",4992,5284,3587,1697,3148,4,1727,1732,1218,514,2.369649805,919,2766,1720,534,0,534,0,114,0,0,empty,mBC-0814-1
"C5,G10",8891,9347,6430,2917,5565,0,2982,2983,2185,798,2.738095238,1509,3634,2211,669,1,668,1,162,0,0.00748503,empty,mBC-0814-1
"C5,G11",8774,9254,6357,2897,5449,1,2941,2946,2149,797,2.696361355,1472,1562,1114,304,0,304,0,64,0,0,empty,mBC-0814-1
"C5,G12",4629,4974,3258,1716,2949,1,1588,1592,1136,456,2.49122807,861,2031,1500,431,0,431,0,91,0,0,empty,mBC-0814-1
"C5,H1",4624,5046,3271,1775,2892,0,1576,1578,1117,461,2.422993492,880,733,497,172,0,172,0,40,0,0.069767442,empty,mBC-0814-1
"C5,H2",633592,741323,418847,322476,435436,0,282949,283225,210295,72930,2.883518442,171584,34111,24500,6743,5,6738,1,758,0,0.003858712,mm10,mBC-0814-1
"C5,H3",5546,5912,3910,2002,3436,0,1839,1839,1330,509,2.612966601,990,12579,4540,1340,2,1338,1,166,0,0.140508221,empty,mBC-0814-1
"C5,H4",5413,5845,3896,1949,3354,0,1874,1875,1341,534,2.511235955,1004,910,335,109,1,108,1,21,0,0,empty,mBC-0814-1
"C5,H5",599884,713483,394358,319125,415480,0,268141,268425,210529,57896,3.636330662,164580,147890,103278,29033,12,29021,2,1951,0,0.003066745,mm10,mBC-0814-1
"C5,H6",6088,6563,4450,2113,3757,0,1996,2001,1426,575,2.48,1046,2498,1759,527,0,527,0,98,0,0.022770398,empty,mBC-0814-1
"C5,H7",5180,5523,3735,1788,3249,0,1758,1759,1272,487,2.611909651,934,1615,1156,303,1,302,1,61,0,0,empty,mBC-0814-1
"C5,H8",4193,4542,2963,1579,2665,0,1496,1498,1088,410,2.653658537,808,2106,1376,420,0,420,0,102,0,0,empty,mBC-0814-1
"C5,H9",366657,425428,243991,181437,252098,0,163688,163873,106533,57340,1.857917684,98598,18799,12922,3708,2,3706,2,444,0,0,mm10,mBC-0814-1
"C5,H10",329128,370098,219573,150525,220175,0,136319,136474,109839,26635,4.123859583,80703,10966,7426,2038,1,2037,1,309,0,0.008836524,mm10,mBC-0814-1
"C5,H11",3766,4168,2698,1470,2479,0,1424,1427,990,437,2.265446224,766,188,71,26,0,26,0,8,0,0,empty,mBC-0814-1
"C5,H12",2561,2621,1830,791,1523,1,818,821,625,196,3.18877551,389,1196,857,228,0,228,0,57,0,0.00877193,empty,mBC-0814-1
"C6,A1",5048,5568,3554,2014,3296,2,1839,1841,1343,498,2.696787149,1042,1550,1097,327,0,327,0,80,0,0,empty,mBC-0814-1
"C6,A2",352478,408652,232703,175949,243750,1,152934,153121,122086,31035,3.933816659,92031,178242,128098,36085,11,36074,2,2282,0,0.001330598,mm10,mBC-0814-1
"C6,A3",4277,4541,3084,1457,2712,0,1467,1468,1068,400,2.67,754,981,586,153,0,153,0,42,0,0,empty,mBC-0814-1
"C6,A4",5193,5432,3691,1741,3109,0,1635,1636,1192,444,2.684684685,838,10265,3149,973,0,973,0,102,0,0.099691675,empty,mBC-0814-1
"C6,A5",4395,4765,3152,1613,2828,1,1531,1538,1084,454,2.387665198,823,16873,5404,1626,2,1624,1,163,0,0.10591133,empty,mBC-0814-1
"C6,A6",3308,3647,2394,1253,2159,0,1175,1175,805,370,2.175675676,626,1566,1094,311,0,311,0,64,0,0,empty,mBC-0814-1
"C6,A7",5002,5212,3627,1585,3091,0,1658,1663,1185,478,2.479079498,829,2015,1476,401,0,401,0,69,0,0.024937656,empty,mBC-0814-1
"C6,A8",1998,2251,1411,840,1330,0,756,757,520,237,2.194092827,435,1291,769,250,0,250,0,70,0,0,empty,mBC-0814-1
"C6,A9",6016,6652,4299,2353,3755,0,2040,2040,1490,550,2.709090909,1103,1670,1180,365,0,365,0,70,0,0,empty,mBC-0814-1
"C6,A10",3162,3373,2250,1123,2026,0,1125,1127,833,294,2.833333333,613,182,122,42,0,42,0,14,0,0,empty,mBC-0814-1
"C6,A11",4248,4569,3059,1510,2660,0,1463,1466,1057,409,2.584352078,790,1535,1007,348,0,348,0,74,0,0,empty,mBC-0814-1
"C6,A12",3990,4155,2776,1379,2564,0,1422,1425,1032,393,2.625954198,766,2864,1919,641,0,641,0,158,0,0,empty,mBC-0814-1
"C6,B1",4436,4799,3145,1654,2870,0,1589,1595,1129,466,2.422746781,860,9584,3325,1051,1,1050,1,140,0,0.065714286,empty,mBC-0814-1
"C6,B2",4518,4902,3114,1788,2860,0,1578,1581,1151,430,2.676744186,886,4410,1279,395,0,395,0,48,0,0.053164557,empty,mBC-0814-1
"C6,B3",3916,4445,2769,1676,2663,0,1503,1503,1135,368,3.08423913,862,1363,892,275,0,275,0,65,0,0.025454545,empty,mBC-0814-1
"C6,B4",373254,437631,248266,189365,261925,0,161907,162057,137176,24881,5.513283228,97951,229232,165866,46700,27,46673,3,2608,0,4.28513E-05,mm10,mBC-0814-1
"C6,B5",339409,239932,132454,107478,172309,1,110232,110610,86548,24062,3.59687474,69291,85496,58543,16019,14,16005,3,1345,0,0.00137457,mm10,mBC-0814-1
"C6,B6",3550,3851,2470,1381,2319,0,1284,1284,948,336,2.821428571,677,1738,1234,345,0,345,0,55,0,0,empty,mBC-0814-1
"C6,B7",4804,5246,3520,1726,3125,0,1690,1690,1258,432,2.912037037,903,942,568,171,0,171,0,54,0,0.046783626,empty,mBC-0814-1
"C6,B8",3380,3672,2395,1277,2177,0,1177,1177,859,318,2.701257862,652,902,529,164,0,164,0,51,0,0,empty,mBC-0814-1
"C6,B9",4234,4661,3107,1554,2811,0,1560,1563,1120,443,2.528216704,841,864,604,183,0,183,0,62,0,0.027322404,empty,mBC-0814-1
"C6,B10",243553,269224,158571,110653,166771,3,101219,101424,78434,22990,3.411657242,60252,29829,20735,6062,2,6060,1,680,0,0,mm10,mBC-0814-1
"C6,B11",7776,8497,5483,3014,4996,0,2803,2811,2127,684,3.109649123,1509,164,119,43,0,43,0,11,0,0,empty,mBC-0814-1
"C6,B12",4846,5419,3372,2047,3221,0,1867,1873,1272,601,2.116472546,1071,1335,845,252,0,252,0,62,0,0.043650794,empty,mBC-0814-1
"C6,C1",5068,5319,3521,1798,3191,0,1727,1731,1258,473,2.65961945,954,2994,1281,357,0,357,0,63,0,0.193277311,empty,mBC-0814-1
"C6,C2",497143,595909,316557,279352,351928,0,236432,236693,180662,56031,3.22432225,146440,196801,139535,39363,26,39337,3,2306,0,0.000711798,mm10,mBC-0814-1
"C6,C3",5744,6149,4059,2090,3588,0,1949,1949,1369,580,2.360344828,1084,804,509,174,0,174,0,44,0,0,empty,mBC-0814-1
"C6,C4",4638,5007,3297,1710,2942,0,1633,1634,1180,454,2.599118943,861,1300,894,278,0,278,0,67,0,0.007194245,empty,mBC-0814-1
"C6,C5",6792,7119,4915,2204,4130,0,2219,2224,1654,570,2.901754386,1200,1328,964,381,0,381,0,94,0,0.010498688,empty,mBC-0814-1
"C6,C6",4965,5291,3525,1766,3138,0,1703,1710,1237,473,2.615221987,894,998,648,238,0,238,0,56,0,0,empty,mBC-0814-1
"C6,C7",6253,6553,4440,2113,3900,0,2139,2143,1546,597,2.58961474,1098,482,291,98,0,98,0,17,0,0,empty,mBC-0814-1
"C6,C8",478653,552756,318606,234150,329409,0,207142,207398,169627,37771,4.490932197,123411,170340,123445,34557,25,34532,2,2089,0,0.000376462,mm10,mBC-0814-1
"C6,C9",542954,640834,350658,290176,376427,0,245534,245767,186887,58880,3.174031929,150542,124227,88095,23795,14,23781,1,1716,0,0.000168202,mm10,mBC-0814-1
"C6,C10",4998,5596,3599,1997,3252,0,1791,1793,1276,517,2.468085106,1011,739,479,139,0,139,0,40,0,0,empty,mBC-0814-1
"C6,C11",4068,4436,2831,1605,2632,0,1417,1423,1004,419,2.396181384,818,1599,1205,299,0,299,0,62,0,0,empty,mBC-0814-1
"C6,C12",441002,515450,290391,225059,305812,2,194380,194578,160199,34379,4.659792315,118334,141496,99820,27679,22,27657,2,1890,0,7.23144E-05,mm10,mBC-0814-1
"C6,D1",4001,4216,2861,1355,2495,0,1327,1332,946,386,2.450777202,691,352,265,115,0,115,0,34,0,0,empty,mBC-0814-1
"C6,D2",4696,5028,3431,1597,2924,0,1574,1574,1108,466,2.377682403,758,1317,853,225,1,224,1,64,0,0.053571429,empty,mBC-0814-1
"C6,D3",9629,10569,6888,3681,6197,0,3480,3486,2476,1010,2.451485149,1909,2525,1785,463,1,462,1,105,0,0.012987013,empty,mBC-0814-1
"C6,D4",4510,4827,3205,1622,2900,0,1594,1600,1130,470,2.404255319,869,1386,958,275,0,275,0,66,0,0.036363636,empty,mBC-0814-1
"C6,D5",3932,4249,2730,1519,2533,0,1418,1424,1042,382,2.727748691,790,3139,2177,637,1,636,1,120,0,0.062893082,empty,mBC-0814-1
"C6,D6",4479,4764,3196,1568,2821,0,1546,1549,1078,471,2.288747346,841,13369,3939,1244,0,1244,0,137,0,0.024115756,empty,mBC-0814-1
"C6,D7",5400,5799,3947,1852,3383,0,1793,1801,1299,502,2.587649402,953,2486,1746,457,0,457,0,100,0,0,empty,mBC-0814-1
"C6,D8",4678,5274,3245,2029,2997,0,1678,1680,1275,405,3.148148148,907,1202,923,239,1,238,1,43,0,0,empty,mBC-0814-1
"C6,D9",2782,3102,1952,1150,1758,0,955,959,653,306,2.133986928,520,1373,962,229,1,228,1,44,0,0,empty,mBC-0814-1
"C6,D10",3257,3708,2274,1434,2145,0,1187,1188,875,313,2.795527157,688,613,365,87,0,87,0,28,0,0,empty,mBC-0814-1
"C6,D11",3962,4347,2869,1478,2544,0,1385,1386,1027,359,2.860724234,732,2112,1508,424,0,424,0,105,0,0,empty,mBC-0814-1
"C6,D12",5573,6222,3956,2266,3655,0,2049,2053,1474,579,2.545768566,1130,2502,1763,541,0,541,0,114,0,0.011090573,empty,mBC-0814-1
"C6,E1",4429,4580,3243,1337,2736,0,1420,1426,1045,381,2.742782152,738,1274,1010,313,1,312,1,72,0,0.064102564,empty,mBC-0814-1
"C6,E2",326739,378062,218254,159808,224969,6,137496,137655,111272,26383,4.217564341,82075,257470,185401,51581,30,51551,3,2936,0,0.000543151,mm10,mBC-0814-1
"C6,E3",3155,3313,2301,1012,2025,1,1101,1102,777,325,2.390769231,584,1132,782,266,0,266,0,57,0,0,empty,mBC-0814-1
"C6,E4",2896,3315,2044,1271,1912,0,1075,1079,723,356,2.030898876,615,1349,935,288,0,288,0,57,0,0.003472222,empty,mBC-0814-1
"C6,E5",3643,4070,2692,1378,2353,0,1291,1294,940,354,2.655367232,718,1957,924,261,1,260,1,48,0,0.007692308,empty,mBC-0814-1
"C6,E6",4040,4389,2905,1484,2500,0,1343,1347,932,415,2.245783133,691,1098,804,227,0,227,0,59,0,0.004405286,empty,mBC-0814-1
"C6,E7",4052,4299,2898,1401,2511,2,1302,1304,985,319,3.087774295,687,1278,805,215,0,215,0,52,0,0,empty,mBC-0814-1
"C6,E8",4268,4402,3148,1254,2579,0,1277,1281,899,382,2.353403141,640,1714,1313,317,0,317,0,75,0,0,empty,mBC-0814-1
"C6,E9",3035,3345,2124,1221,2013,0,1141,1145,832,313,2.658146965,644,1235,974,300,0,300,0,54,0,0,empty,mBC-0814-1
"C6,E10",3837,4186,2762,1424,2443,0,1313,1318,932,386,2.414507772,693,1493,1123,320,0,320,0,66,0,0.05625,empty,mBC-0814-1
"C6,E11",3801,4221,2764,1457,2419,0,1327,1329,956,373,2.563002681,716,1696,1196,314,1,313,1,63,0,0,empty,mBC-0814-1
"C6,E12",3613,3909,2577,1332,2320,0,1268,1272,892,380,2.347368421,676,1099,722,192,0,192,0,51,0,0,empty,mBC-0814-1
"C6,F1",4220,4635,3070,1565,2672,0,1477,1481,1058,423,2.501182033,777,1468,987,292,0,292,0,61,0,0.044520548,empty,mBC-0814-1
"C6,F2",5899,6243,4277,1966,3659,0,1969,1977,1431,546,2.620879121,1018,1339,951,341,1,340,1,109,0,0.014705882,empty,mBC-0814-1
"C6,F3",4649,4940,3284,1656,2929,0,1613,1616,1163,453,2.567328918,877,1928,1395,456,0,456,0,77,0,0.030701754,empty,mBC-0814-1
"C6,F4",4726,5129,3399,1730,3000,1,1586,1588,1145,443,2.584650113,837,342,171,67,0,67,0,20,0,0,empty,mBC-0814-1
"C6,F5",496058,578661,330414,248247,342151,0,215076,215334,175228,40106,4.369121827,129340,221561,156611,43288,31,43257,2,2436,0,0.000254294,mm10,mBC-0814-1
"C6,F6",4611,5144,3285,1859,3028,0,1668,1668,1188,480,2.475,930,1448,986,326,1,325,1,75,0,0.049230769,empty,mBC-0814-1
"C6,F7",4181,4446,3031,1415,2649,0,1415,1417,1034,383,2.699738903,727,926,626,210,0,210,0,40,0,0,empty,mBC-0814-1
"C6,F8",5843,6396,4165,2231,3826,3,2107,2111,1576,535,2.945794393,1172,117,88,20,0,20,0,9,0,0,empty,mBC-0814-1
"C6,F9",5169,5597,3767,1830,3231,0,1741,1746,1278,468,2.730769231,940,1940,1357,397,0,397,0,81,0,0,empty,mBC-0814-1
"C6,F10",5908,6254,4387,1867,3631,0,1862,1867,1313,554,2.370036101,952,1604,1072,312,0,312,0,70,0,0,empty,mBC-0814-1
"C6,F11",3932,4189,2694,1495,2453,3,1321,1324,960,364,2.637362637,722,7789,2562,828,0,828,0,119,0,0,empty,mBC-0814-1
"C6,F12",4402,4803,3139,1664,2776,0,1507,1508,1078,430,2.506976744,822,207,134,52,0,52,0,11,0,0,empty,mBC-0814-1
"C6,G1",462403,527794,313567,214227,315139,1,194803,195008,152009,42999,3.535175237,114792,63908,41322,11806,15,11791,1,1086,0,0.003222797,mm10,mBC-0814-1
"C6,G2",5104,5566,3606,1960,3311,0,1843,1846,1278,568,2.25,1020,406,248,97,0,97,0,24,0,0,empty,mBC-0814-1
"C6,G3",5560,6095,3873,2222,3551,0,1967,1972,1458,514,2.836575875,1092,2730,2033,570,0,570,0,93,0,0.01754386,empty,mBC-0814-1
"C6,G4",593144,661502,407816,253686,390286,0,233907,234182,187428,46754,4.00881208,134215,492,252,57,0,57,0,17,0,0,empty,mBC-0814-1
"C6,G5",4081,4257,2804,1453,2491,0,1370,1371,978,393,2.488549618,728,1514,1070,290,0,290,0,66,0,0.017241379,empty,mBC-0814-1
"C6,G6",8187,8720,5988,2732,4995,0,2621,2626,1898,728,2.607142857,1320,92,70,32,0,32,0,12,0,0,empty,mBC-0814-1
"C6,G7",4948,5377,3566,1811,3239,0,1761,1763,1270,493,2.576064909,970,1510,983,355,0,355,0,83,0,0,empty,mBC-0814-1
"C6,G8",6841,7494,4819,2675,4504,0,2499,2501,1763,738,2.388888889,1405,3894,2873,771,0,771,0,155,0,0.02464332,empty,mBC-0814-1
"C6,G9",5266,5717,3749,1968,3370,0,1893,1901,1331,570,2.335087719,1041,3325,2336,717,0,717,0,146,0,0.016736402,empty,mBC-0814-1
"C6,G10",13430,14042,9520,4522,8184,0,4384,4386,3291,1095,3.005479452,2281,9608,5073,1643,2,1641,1,221,0,0.259597806,empty,mBC-0814-1
"C6,G11",8398,9086,6058,3028,5280,0,2833,2843,2012,831,2.421179302,1527,927,672,236,0,236,0,71,0,0,empty,mBC-0814-1
"C6,G12",4446,4748,3185,1563,2809,0,1523,1526,1115,411,2.712895377,799,1974,1498,369,0,369,0,84,0,0.005420054,empty,mBC-0814-1
"C6,H1",4107,4465,2933,1532,2597,0,1436,1438,1025,413,2.481840194,753,924,693,178,0,178,0,41,0,0,empty,mBC-0814-1
"C6,H2",61854,69134,43738,25396,39989,1,22573,22611,17445,5166,3.37688734,12327,56195,41020,11555,9,11546,1,994,0,0.003637623,empty,mBC-0814-1
"C6,H3",401527,462800,265993,196807,275235,0,171884,172082,133686,38396,3.481768934,103037,230720,163356,44957,17,44940,2,2645,0,0.000267023,mm10,mBC-0814-1
"C6,H4",512930,588806,343163,245643,343477,0,211471,211723,178293,33430,5.333323362,125623,7774,5552,1440,0,1440,0,199,0,0.001388889,mm10,mBC-0814-1
"C6,H5",6231,6778,4416,2362,3923,0,2188,2189,1603,586,2.735494881,1190,32950,10232,3213,4,3209,1,290,0,0.078529137,empty,mBC-0814-1
"C6,H6",5826,6177,4200,1977,3549,0,1897,1901,1356,545,2.488073394,964,8996,3442,1022,2,1020,1,155,0,0.026470588,empty,mBC-0814-1
"C6,H7",4928,5435,3543,1892,3220,0,1757,1758,1276,482,2.647302905,955,1767,1171,311,0,311,0,63,0,0,empty,mBC-0814-1
"C6,H8",3966,4428,2779,1649,2686,0,1536,1539,1129,410,2.753658537,860,2078,1371,431,1,430,1,93,0,0,empty,mBC-0814-1
"C6,H9",4436,4665,3261,1404,2766,0,1456,1456,1057,399,2.649122807,730,1295,816,252,1,251,1,51,0,0,empty,mBC-0814-1
"C6,H10",3637,3974,2631,1343,2346,0,1286,1286,935,351,2.663817664,670,787,556,170,0,170,0,39,0,0,empty,mBC-0814-1
"C6,H11",3674,3901,2623,1278,2379,0,1310,1313,966,347,2.783861671,698,70,57,7,0,7,0,7,0,0,empty,mBC-0814-1
"C6,H12",2574,2886,1805,1081,1738,0,968,973,746,227,3.286343612,553,1428,1097,327,0,327,0,61,0,0,empty,mBC-0814-1
"C7,A1",5631,5903,4030,1873,3562,1,1881,1886,1328,558,2.379928315,980,1345,819,257,1,256,1,84,0,0,empty,mBC-0814-1
"C7,A2",594106,657677,401105,256572,383090,1,229468,229761,196670,33091,5.943307848,131753,162273,115755,34072,23,34049,4,2090,0,0.000234956,mm10,mBC-0814-1
"C7,A3",4741,5065,3430,1635,2879,0,1530,1532,1085,447,2.427293065,767,1154,778,259,0,259,0,70,0,0,empty,mBC-0814-1
"C7,A4",5566,6064,4077,1987,3452,0,1834,1835,1266,569,2.224956063,987,571,363,85,0,85,0,20,0,0,empty,mBC-0814-1
"C7,A5",4528,4931,3198,1733,2938,0,1607,1609,1150,459,2.505446623,894,1458,975,308,1,307,1,69,0,0.003257329,empty,mBC-0814-1
"C7,A6",810997,933717,538545,395172,548584,1,345713,346133,271801,74332,3.656581284,206283,252302,184197,52302,30,52272,5,3078,0,0.000420875,mm10,mBC-0814-1
"C7,A7",5657,6057,4074,1983,3469,0,1838,1844,1321,523,2.52581262,938,1841,1252,364,1,363,1,92,0,0.002754821,empty,mBC-0814-1
"C7,A8",2156,2376,1494,882,1414,0,811,811,547,264,2.071969697,458,1548,1091,400,0,400,0,105,0,0.0025,empty,mBC-0814-1
"C7,A9",6279,6714,4593,2121,3838,0,1984,1994,1379,615,2.242276423,1013,1826,1256,402,0,402,0,84,0,0,empty,mBC-0814-1
"C7,A10",3264,3559,2223,1336,2145,1,1209,1210,872,338,2.579881657,685,157,86,44,0,44,0,16,0,0,empty,mBC-0814-1
"C7,A11",4380,4692,3141,1551,2811,1,1539,1542,1093,449,2.434298441,798,2673,1727,534,0,534,0,145,0,0.007490637,empty,mBC-0814-1
"C7,A12",306015,335970,204480,131490,200194,1,122277,122459,97746,24713,3.955246227,71282,32598,23657,6588,6,6582,1,892,0,0.003342449,mm10,mBC-0814-1
"C7,B1",4741,5022,3354,1668,2959,1,1610,1614,1104,510,2.164705882,844,1736,1234,272,0,272,0,100,0,0.036764706,empty,mBC-0814-1
"C7,B2",4912,5210,3456,1754,3043,0,1650,1652,1153,499,2.310621242,880,587,300,115,0,115,0,45,0,0,empty,mBC-0814-1
"C7,B3",375110,439121,248263,190858,261178,0,162702,162857,137901,24956,5.525765347,98282,193314,139027,40356,18,40338,2,2297,0,0.000793297,mm10,mBC-0814-1
"C7,B4",570664,661770,373221,288549,391539,0,252796,253041,200638,52403,3.828750262,152842,118958,72805,20626,22,20604,6,1634,0,0.001358959,mm10,mBC-0814-1
"C7,B5",5267,4388,2675,1713,2921,0,1732,1740,1165,575,2.026086957,1009,1276,733,258,0,258,0,79,0,0.089147287,empty,mBC-0814-1
"C7,B6",3779,3942,2774,1168,2369,0,1283,1285,932,353,2.640226629,633,1274,852,275,0,275,0,62,0,0.061818182,empty,mBC-0814-1
"C7,B7",5133,5376,3739,1637,3185,0,1680,1684,1219,465,2.621505376,851,1621,1083,299,0,299,0,66,0,0.056856187,empty,mBC-0814-1
"C7,B8",4405,4650,3217,1433,2744,0,1463,1467,1064,403,2.640198511,772,1595,1131,303,0,303,0,72,0,0.04620462,empty,mBC-0814-1
"C7,B9",4617,4886,3178,1708,2900,0,1580,1585,1184,401,2.952618454,857,868,562,200,0,200,0,70,0,0,empty,mBC-0814-1
"C7,B10",528229,562802,343120,219682,347828,7,210398,210845,141460,69385,2.038769186,123409,9859,4964,1289,1,1288,1,187,0,0.007763975,mm10,mBC-0814-1
"C7,B11",204411,233649,126999,106650,135179,2,89373,89495,53255,36240,1.46950883,55013,6251,4122,1217,0,1217,0,163,0,0,mm10,mBC-0814-1
"C7,B12",5463,5625,3921,1704,3393,0,1827,1833,1317,516,2.552325581,912,1234,940,280,0,280,0,90,0,0.010714286,empty,mBC-0814-1
"C7,C1",5549,5807,4048,1759,3408,0,1784,1786,1259,527,2.388994307,923,856,541,175,0,175,0,52,0,0,empty,mBC-0814-1
"C7,C2",585972,696130,384396,311734,406594,2,260592,260905,208359,52546,3.965268527,159054,345214,252793,71236,38,71198,2,3334,0,0.000646086,mm10,mBC-0814-1
"C7,C3",5881,6269,4228,2041,3605,0,1960,1962,1433,529,2.708884688,975,858,594,176,0,176,0,53,0,0,empty,mBC-0814-1
"C7,C4",5080,5445,3644,1801,3186,0,1715,1716,1231,485,2.53814433,909,2195,1471,485,0,485,0,123,0,0,empty,mBC-0814-1
"C7,C5",6972,7271,5029,2242,4276,0,2243,2249,1684,565,2.980530973,1119,1786,1227,377,0,377,0,113,0,0.00795756,empty,mBC-0814-1
"C7,C6",6843,7466,4642,2824,4307,0,2412,2416,1795,621,2.890499195,1365,71084,20202,6220,7,6213,3,458,0,0.144696604,empty,mBC-0814-1
"C7,C7",7216,7761,5126,2635,4581,0,2557,2560,1782,778,2.290488432,1377,379,295,73,0,73,0,24,0,0,empty,mBC-0814-1
"C7,C8",812977,994360,495520,498840,586345,0,423506,423896,230918,192978,1.196602722,270979,183678,104473,29317,23,29294,3,2322,0,0.006656653,mm10,mBC-0814-1
"C7,C9",4498,4813,3293,1520,2852,0,1525,1525,1088,437,2.489702517,790,1569,1002,323,0,323,0,84,0,0,empty,mBC-0814-1
"C7,C10",5673,5986,4212,1774,3514,0,1878,1880,1376,504,2.73015873,912,1745,1098,284,0,284,0,71,0,0,empty,mBC-0814-1
"C7,C11",4525,4945,3284,1661,2916,2,1573,1581,1077,504,2.136904762,832,1845,1148,349,1,348,1,86,0,0,empty,mBC-0814-1
"C7,C12",7955,8665,5617,3048,5014,0,2675,2681,1902,779,2.441591784,1447,2694,1897,529,0,529,0,110,0,0,empty,mBC-0814-1
"C7,D1",4394,4618,3146,1472,2794,16,1491,1507,1082,425,2.545882353,797,675,403,130,0,130,0,43,0,0,empty,mBC-0814-1
"C7,D2",5179,5469,3818,1651,3191,0,1619,1623,1159,464,2.497844828,840,2597,1705,500,0,500,0,108,0,0.002,empty,mBC-0814-1
"C7,D3",10785,11844,7578,4266,6879,1,3830,3837,2725,1112,2.450539568,2113,11484,4383,1398,2,1396,2,200,0,0.033667622,empty,mBC-0814-1
"C7,D4",4904,5487,3442,2045,3230,0,1843,1846,1207,639,1.888888889,1036,2010,1351,387,1,386,1,103,0,0.018134715,empty,mBC-0814-1
"C7,D5",181467,209371,117066,92305,126776,1,79604,79682,67928,11754,5.779139017,48521,203488,145538,40910,28,40882,4,2545,0,0.000171224,mm10,mBC-0814-1
"C7,D6",5074,5623,3634,1989,3195,2,1736,1742,1209,533,2.268292683,952,1359,944,290,0,290,0,65,0,0,empty,mBC-0814-1
"C7,D7",5653,5866,4070,1796,3421,0,1769,1770,1288,482,2.67219917,897,4717,2686,760,1,759,1,162,0,0.014492754,empty,mBC-0814-1
"C7,D8",5117,5475,3506,1969,3224,0,1822,1828,1318,510,2.584313725,1012,1010,752,246,1,245,1,66,0,0.008163265,empty,mBC-0814-1
"C7,D9",2974,3155,2033,1122,1824,0,987,994,703,291,2.41580756,547,3889,1677,523,0,523,0,80,0,0,empty,mBC-0814-1
"C7,D10",5246,5907,3648,2259,3424,0,1989,1989,1543,446,3.459641256,1115,760,477,174,0,174,0,61,0,0,empty,mBC-0814-1
"C7,D11",4097,4503,2915,1588,2547,0,1397,1397,979,418,2.342105263,753,2434,1823,603,0,603,0,163,0,0.018242123,empty,mBC-0814-1
"C7,D12",5886,6519,4165,2354,3865,0,2201,2203,1583,620,2.553225806,1215,3293,2345,691,0,691,0,136,0,0.001447178,empty,mBC-0814-1
"C7,E1",5045,5272,3713,1559,3113,0,1656,1657,1182,475,2.488421053,849,2473,1583,400,0,400,0,104,0,0,empty,mBC-0814-1
"C7,E2",3663,3817,2622,1195,2261,0,1225,1225,898,327,2.74617737,642,5765,2074,585,0,585,0,119,0,0.011965812,empty,mBC-0814-1
"C7,E3",3522,3900,2561,1339,2249,1,1252,1253,877,376,2.332446809,648,2026,1207,391,2,389,1,91,0,0.025706941,empty,mBC-0814-1
"C7,E4",3278,3530,2378,1152,2076,0,1136,1136,830,306,2.712418301,602,1366,816,243,0,243,0,77,0,0,empty,mBC-0814-1
"C7,E5",42796,38983,25059,13924,22751,0,12984,12997,10773,2224,4.84397482,7190,8332,6105,1628,1,1627,1,216,0,0,empty,mBC-0814-1
"C7,E6",4729,5269,3360,1909,2927,2,1555,1557,1144,413,2.769975787,847,1592,1220,338,0,338,0,59,0,0,empty,mBC-0814-1
"C7,E7",5668,6207,4113,2094,3579,0,1895,1899,1386,513,2.701754386,1028,1294,985,356,0,356,0,81,0,0,empty,mBC-0814-1
"C7,E8",4569,4648,3390,1258,2742,0,1386,1390,1009,381,2.648293963,644,2385,1734,524,1,523,1,111,0,0.026768642,empty,mBC-0814-1
"C7,E9",2942,3076,2115,961,1794,0,959,963,678,285,2.378947368,490,1520,1023,335,0,335,0,76,0,0,empty,mBC-0814-1
"C7,E10",4103,4448,2950,1498,2558,0,1400,1403,1019,384,2.653645833,728,1598,1079,333,3,330,2,97,0,0.054545455,empty,mBC-0814-1
"C7,E11",447237,498803,298985,199818,300427,0,182835,183064,149877,33187,4.516135836,106632,166385,113570,32181,29,32152,3,2062,0,0.005753919,mm10,mBC-0814-1
"C7,E12",3915,4185,2719,1466,2439,0,1348,1349,943,406,2.322660099,716,10463,3261,1056,1,1055,1,137,0,0.02464455,empty,mBC-0814-1
"C7,F1",4995,5299,3600,1699,3089,3,1632,1636,1155,481,2.401247401,834,2003,1344,457,0,457,0,97,0,0,empty,mBC-0814-1
"C7,F2",6385,6849,4595,2254,4002,0,2098,2104,1516,588,2.578231293,1063,2396,1617,493,1,492,1,163,0,0.00203252,empty,mBC-0814-1
"C7,F3",4971,5185,3535,1650,3056,0,1660,1664,1183,481,2.459459459,876,1234,820,323,0,323,0,102,0,0.018575851,empty,mBC-0814-1
"C7,F4",5508,5854,3942,1912,3446,1,1833,1836,1306,530,2.464150943,987,8098,2553,810,2,808,2,89,0,0.035891089,empty,mBC-0814-1
"C7,F5",5216,5605,3714,1891,3207,3,1743,1749,1262,487,2.59137577,930,1530,997,319,0,319,0,79,0,0,empty,mBC-0814-1
"C7,F6",1002727,1160657,660971,499686,676386,1,429307,429779,348599,81180,4.294148805,258836,566454,401507,113976,67,113909,6,4315,0,0.001220272,mm10,mBC-0814-1
"C7,F7",4656,4781,3448,1333,2877,0,1468,1468,1061,407,2.606879607,712,860,682,236,0,236,0,51,0,0,empty,mBC-0814-1
"C7,F8",6724,7211,4747,2464,4331,0,2363,2364,1700,664,2.560240964,1279,311,238,49,0,49,0,23,0,0,empty,mBC-0814-1
"C7,F9",5599,5768,4087,1681,3422,0,1799,1799,1305,494,2.641700405,890,2282,1702,511,0,511,0,116,0,0.037181996,empty,mBC-0814-1
"C7,F10",841330,954932,558806,396126,554524,0,349843,350245,245597,104648,2.346886706,206897,112868,79683,22144,13,22131,1,1762,0,0.001310379,mm10,mBC-0814-1
"C7,F11",4138,4245,2966,1279,2528,0,1337,1337,935,402,2.325870647,669,1926,1336,385,0,385,0,88,0,0,empty,mBC-0814-1
"C7,F12",4815,5372,3389,1983,3092,1,1720,1721,1248,473,2.638477801,963,83,52,29,0,29,0,15,0,0,empty,mBC-0814-1
"C7,G1",7343,7939,5218,2721,4665,0,2511,2515,1732,783,2.212005109,1364,3983,2805,915,0,915,0,200,0,0.016393443,empty,mBC-0814-1
"C7,G2",5460,5849,3990,1859,3361,0,1746,1750,1244,506,2.458498024,872,690,482,158,0,158,0,41,0,0,empty,mBC-0814-1
"C7,G3",4993,5384,3562,1822,3132,0,1699,1706,1199,507,2.364891519,863,3035,1961,653,0,653,0,155,0,0.013782542,empty,mBC-0814-1
"C7,G4",617236,709259,413885,295374,416109,1,255776,256035,216761,39274,5.519198452,151809,2323,1552,402,1,401,1,63,0,0,empty,mBC-0814-1
"C7,G5",4799,5226,3413,1813,3141,0,1746,1757,1249,508,2.458661417,971,1739,1187,375,0,375,0,85,0,0,empty,mBC-0814-1
"C7,G6",8921,9592,6535,3057,5617,0,2934,2943,2047,896,2.284598214,1559,156,129,38,0,38,0,12,0,0.552631579,empty,mBC-0814-1
"C7,G7",5750,6106,4112,1994,3587,0,1899,1899,1402,497,2.820925553,987,7062,3007,918,1,917,1,178,0,0.070883315,empty,mBC-0814-1
"C7,G8",6809,7190,4858,2332,4309,0,2345,2348,1613,735,2.194557823,1245,3287,2261,706,0,706,0,190,0,0.029745042,empty,mBC-0814-1
"C7,G9",731220,833332,484082,349250,493662,0,309449,309808,246438,63370,3.888874862,184465,385300,264953,75812,41,75771,5,3535,0,0.001121801,mm10,mBC-0814-1
"C7,G10",9270,9898,6684,3214,5860,0,3220,3225,2243,982,2.284114053,1687,4693,3492,1060,0,1060,0,198,0,0.011320755,empty,mBC-0814-1
"C7,G11",9137,9961,6550,3411,5668,0,3045,3045,2203,842,2.616389549,1603,1933,1408,448,0,448,0,109,0,0,empty,mBC-0814-1
"C7,G12",4670,5052,3223,1829,3038,0,1658,1662,1177,485,2.426804124,940,4124,2362,754,3,751,2,132,0,0,empty,mBC-0814-1
"C7,H1",980694,1143019,662013,481006,669642,0,420325,420809,342784,78025,4.393258571,250931,207953,151056,42400,27,42373,3,2594,0,0.000212399,mm10,mBC-0814-1
"C7,H2",7867,8367,5609,2758,4889,0,2673,2674,1934,740,2.613513514,1409,4949,2636,914,0,914,0,228,0,0.035010941,empty,mBC-0814-1
"C7,H3",1070655,1235529,711060,524469,719200,0,456735,457265,382097,75168,5.083240209,273383,232724,164498,45690,20,45670,1,2784,0,0.000941537,mm10,mBC-0814-1
"C7,H4",5359,5857,3837,2020,3458,0,1879,1880,1362,518,2.629343629,1015,159,82,36,0,36,0,16,0,0,empty,mBC-0814-1
"C7,H5",7122,7917,5086,2831,4483,0,2502,2502,1761,741,2.376518219,1394,2411,1844,490,0,490,0,90,0,0.026530612,empty,mBC-0814-1
"C7,H6",6137,6411,4374,2037,3819,0,2029,2031,1489,542,2.747232472,1073,2468,1702,540,0,540,0,141,0,0.001851852,empty,mBC-0814-1
"C7,H7",5335,5630,3862,1768,3384,0,1803,1806,1268,538,2.356877323,930,1759,1192,358,0,358,0,85,0,0.047486034,empty,mBC-0814-1
"C7,H8",4696,4830,3350,1480,2746,0,1491,1492,1085,407,2.665847666,706,2400,1678,557,0,557,0,140,0,0.016157989,empty,mBC-0814-1
"C7,H9",4590,4897,3313,1584,2858,0,1494,1498,1032,466,2.214592275,796,1695,1290,361,1,360,1,70,0,0.019444444,empty,mBC-0814-1
"C7,H10",4232,4517,2959,1558,2576,0,1387,1388,1032,356,2.898876404,753,1381,976,321,0,321,0,67,0,0.031152648,empty,mBC-0814-1
"C7,H11",363139,424221,238441,185780,253286,1,160911,161097,131340,29757,4.413751386,98298,5028,2781,863,1,862,1,129,0,0,empty,mBC-0814-1
"C7,H12",230933,274702,146364,128338,165769,0,107781,107875,87401,20474,4.268877601,67506,260210,168637,47301,31,47270,2,2813,0,0.002369367,mm10,mBC-0814-1
"C8,A1",5438,6002,3946,2056,3480,0,1881,1886,1412,474,2.978902954,1015,1238,907,252,0,252,0,52,0,0,empty,mBC-0814-1
"C8,A2",5233,5797,3778,2019,3410,0,1885,1891,1413,478,2.956066946,985,1749,1312,337,0,337,0,81,0,0,empty,mBC-0814-1
"C8,A3",4547,4824,3208,1616,2870,1,1564,1568,1158,410,2.824390244,829,1351,937,247,0,247,0,62,0,0,empty,mBC-0814-1
"C8,A4",5191,5522,3765,1757,3168,1,1661,1666,1195,471,2.537154989,871,415,221,90,0,90,0,24,0,0.088888889,empty,mBC-0814-1
"C8,A5",4574,4890,3218,1672,2921,0,1627,1629,1144,485,2.358762887,868,12413,3926,1241,4,1237,3,144,0,0.052546483,empty,mBC-0814-1
"C8,A6",3564,3850,2591,1259,2237,0,1166,1166,812,354,2.293785311,610,1730,1237,327,1,326,1,66,0,0.003067485,empty,mBC-0814-1
"C8,A7",5158,5899,3628,2271,3526,0,2046,2051,1432,619,2.313408724,1170,1695,1202,338,1,337,1,67,0,0.008902077,empty,mBC-0814-1
"C8,A8",2209,2439,1541,898,1417,0,804,806,561,245,2.289795918,441,2935,1592,462,0,462,0,80,0,0.041125541,empty,mBC-0814-1
"C8,A9",6296,6800,4383,2417,3878,0,2056,2060,1473,587,2.509369676,1116,1664,919,309,1,308,1,64,0,0,empty,mBC-0814-1
"C8,A10",3396,3674,2439,1235,2181,0,1216,1218,826,392,2.107142857,628,1068,381,122,0,122,0,21,0,0.016393443,empty,mBC-0814-1
"C8,A11",4757,5109,3403,1706,3057,0,1647,1653,1203,450,2.673333333,873,2297,1577,402,0,402,0,79,0,0,empty,mBC-0814-1
"C8,A12",4191,4578,2916,1662,2702,0,1543,1548,1169,379,3.084432718,842,2931,1914,579,0,579,0,140,0,0,empty,mBC-0814-1
"C8,B1",8503,9140,5675,3465,5455,0,3253,3254,2341,913,2.56407448,1825,2415,1659,502,0,502,0,93,0,0,empty,mBC-0814-1
"C8,B2",4751,4950,3302,1648,2992,0,1563,1566,1107,459,2.411764706,841,649,454,153,0,153,0,29,0,0,empty,mBC-0814-1
"C8,B3",4075,4502,2870,1632,2690,1,1519,1520,1090,430,2.534883721,824,1460,1022,255,0,255,0,45,0,0.003921569,empty,mBC-0814-1
"C8,B4",406445,464484,271326,193158,275996,0,166958,167138,144664,22474,6.436949364,98975,159340,115330,31792,23,31769,3,2029,0,0.000314772,mm10,mBC-0814-1
"C8,B5",391219,265223,146361,118862,191308,1,121484,121953,99654,22299,4.468989641,76316,106292,76420,21495,10,21485,1,1502,0,0.000186176,mm10,mBC-0814-1
"C8,B6",3930,4450,2798,1652,2597,0,1461,1461,1064,397,2.680100756,802,1760,1209,359,0,359,0,56,0,0.033426184,empty,mBC-0814-1
"C8,B7",5063,5324,3701,1623,3108,0,1612,1613,1187,426,2.786384977,833,1084,744,236,0,236,0,54,0,0,empty,mBC-0814-1
"C8,B8",3411,3656,2467,1189,2260,0,1230,1233,880,353,2.492917847,652,921,616,165,0,165,0,36,0,0,empty,mBC-0814-1
"C8,B9",4661,5018,3358,1660,2964,0,1655,1658,1205,453,2.66004415,875,506,279,79,0,79,0,29,0,0,empty,mBC-0814-1
"C8,B10",4298,4485,3012,1473,2751,1,1486,1489,1030,459,2.244008715,793,1377,519,161,0,161,0,36,0,0.062111801,empty,mBC-0814-1
"C8,B11",6062,6606,4380,2226,3787,0,2061,2061,1481,580,2.553448276,1107,206,126,41,0,41,0,9,0,0,empty,mBC-0814-1
"C8,B12",4996,5341,3549,1792,3225,3,1751,1755,1273,482,2.641078838,949,853,609,195,0,195,0,50,0,0.01025641,empty,mBC-0814-1
"C8,C1",5193,5326,3728,1598,3215,0,1649,1649,1196,453,2.6401766,875,1019,741,251,0,251,0,37,0,0,empty,mBC-0814-1
"C8,C2",5014,5457,3565,1892,3244,0,1790,1790,1302,488,2.668032787,948,2041,1466,391,0,391,0,92,0,0.012787724,empty,mBC-0814-1
"C8,C3",1092750,1245780,739928,505852,723311,0,447099,447613,345819,101794,3.397243452,261898,145975,101438,28723,15,28708,1,1971,0,0,mm10,mBC-0814-1
"C8,C4",5136,5507,3654,1853,3248,1,1715,1718,1235,483,2.556935818,910,1352,921,245,1,244,1,68,0,0,empty,mBC-0814-1
"C8,C5",8089,8815,5767,3048,5269,0,2975,2978,2261,717,3.153417015,1617,1463,1031,314,0,314,0,65,0,0.015923567,empty,mBC-0814-1
"C8,C6",5699,6307,4028,2279,3887,0,2148,2151,1573,578,2.721453287,1179,678,443,157,0,157,0,44,0,0,empty,mBC-0814-1
"C8,C7",6978,7546,4924,2622,4386,0,2402,2418,1764,654,2.697247706,1274,598,282,52,0,52,0,18,0,0,empty,mBC-0814-1
"C8,C8",5307,5789,3770,2019,3360,0,1797,1798,1268,530,2.39245283,986,1337,915,314,0,314,0,67,0,0.003184713,empty,mBC-0814-1
"C8,C9",4636,5114,3346,1768,2972,0,1618,1621,1200,421,2.850356295,888,1266,946,279,0,279,0,50,0,0,empty,mBC-0814-1
"C8,C10",577184,668717,388928,279789,390850,1,241562,241841,204469,37372,5.471181633,142862,169595,119990,33863,16,33847,2,2238,0,0.000206813,mm10,mBC-0814-1
"C8,C11",388950,452198,259829,192369,271371,0,172182,172369,126184,46185,2.73214247,104641,18026,12935,3666,2,3664,1,445,0,0,mm10,mBC-0814-1
"C8,C12",7855,8487,5530,2957,4971,0,2633,2635,1887,748,2.522727273,1447,2187,1575,457,0,457,0,78,0,0,empty,mBC-0814-1
"C8,D1",4295,4532,3029,1503,2704,0,1526,1526,1095,431,2.540603248,794,664,478,149,0,149,0,33,0,0,empty,mBC-0814-1
"C8,D2",4734,5013,3502,1511,2931,0,1494,1501,1070,431,2.482598608,771,1324,936,274,0,274,0,55,0,0.003649635,empty,mBC-0814-1
"C8,D3",393613,446064,266431,179633,268678,0,165532,165727,123766,41961,2.94954839,97740,35298,23146,6450,5,6445,1,703,0,0.007292475,mm10,mBC-0814-1
"C8,D4",4392,4892,3068,1824,2945,0,1640,1641,1163,478,2.433054393,940,1278,906,236,0,236,0,51,0,0,empty,mBC-0814-1
"C8,D5",4261,4760,2913,1847,2886,0,1640,1647,1174,473,2.482029598,945,2374,1645,454,0,454,0,92,0,0,empty,mBC-0814-1
"C8,D6",539484,590915,368541,222374,347352,2,206307,206557,165180,41377,3.992072891,118118,12015,8206,2222,4,2218,1,335,0,0,mm10,mBC-0814-1
"C8,D7",5599,5939,3982,1957,3497,0,1852,1861,1337,524,2.551526718,979,1735,1273,375,0,375,0,87,0,0,empty,mBC-0814-1
"C8,D8",4852,5237,3461,1776,3064,0,1690,1695,1282,413,3.104116223,896,660,408,132,0,132,0,30,0,0,empty,mBC-0814-1
"C8,D9",2941,3197,2105,1092,1926,0,1089,1089,802,287,2.794425087,589,1660,1100,311,0,311,0,68,0,0.028938907,empty,mBC-0814-1
"C8,D10",387860,468019,253628,214391,278568,1,179989,180168,140080,40088,3.494312512,111713,125970,88627,25036,19,25017,1,1811,0,3.99728E-05,mm10,mBC-0814-1
"C8,D11",4133,4505,2903,1602,2648,0,1467,1472,1080,392,2.755102041,828,1793,1280,409,1,408,1,87,0,0.029411765,empty,mBC-0814-1
"C8,D12",6079,6700,4281,2419,3814,5,2134,2147,1514,633,2.39178515,1160,3397,2298,666,0,666,0,114,0,0.001501502,empty,mBC-0814-1
"C8,E1",4767,5110,3478,1632,3000,4,1595,1601,1217,384,3.169270833,848,2673,1342,386,0,386,0,64,0,0,empty,mBC-0814-1
"C8,E2",3633,3954,2619,1335,2316,0,1254,1260,893,367,2.433242507,704,1535,994,349,0,349,0,65,0,0.040114613,empty,mBC-0814-1
"C8,E3",3173,3312,2340,972,1971,0,1019,1019,740,279,2.652329749,520,971,652,212,0,212,0,40,0,0,empty,mBC-0814-1
"C8,E4",2952,3124,2091,1033,1828,6,1001,1010,725,285,2.543859649,527,1338,701,215,0,215,0,46,0,0.027906977,empty,mBC-0814-1
"C8,E5",3721,4029,2748,1281,2270,0,1192,1197,850,347,2.449567723,611,973,692,207,0,207,0,33,0,0,empty,mBC-0814-1
"C8,E6",4451,4710,3175,1535,2701,0,1405,1405,985,420,2.345238095,752,6694,2369,692,1,691,1,89,0,0.075253256,empty,mBC-0814-1
"C8,E7",4270,4415,3017,1398,2620,0,1381,1384,994,390,2.548717949,729,1217,905,202,0,202,0,45,0,0,empty,mBC-0814-1
"C8,E8",4398,4543,3224,1319,2744,0,1406,1406,1067,339,3.147492625,720,1703,1246,356,0,356,0,66,0,0.014044944,empty,mBC-0814-1
"C8,E9",3035,3431,2205,1226,2013,0,1096,1098,797,301,2.647840532,605,1247,842,262,0,262,0,55,0,0,empty,mBC-0814-1
"C8,E10",4249,4875,2951,1924,2804,0,1592,1593,1144,449,2.547884187,919,1721,1183,333,0,333,0,67,0,0,empty,mBC-0814-1
"C8,E11",4081,4370,2865,1505,2609,0,1435,1437,1032,405,2.548148148,767,1693,1247,363,0,363,0,73,0,0.033057851,empty,mBC-0814-1
"C8,E12",3905,4342,2807,1535,2551,0,1384,1384,986,398,2.477386935,759,765,505,225,0,225,0,50,0,0,empty,mBC-0814-1
"C8,F1",4444,4719,3185,1534,2803,0,1480,1484,1083,401,2.70074813,765,1359,1003,282,1,281,1,49,0,0,empty,mBC-0814-1
"C8,F2",7183,7886,5084,2802,4621,0,2516,2518,1837,681,2.697503671,1390,22170,7594,2343,0,2343,0,247,0,0.09346991,empty,mBC-0814-1
"C8,F3",4836,5082,3490,1592,2897,0,1547,1550,1117,433,2.579676674,777,1409,1031,326,0,326,0,64,0,0,empty,mBC-0814-1
"C8,F4",5059,5319,3589,1730,3156,1,1742,1745,1237,508,2.43503937,912,740,474,115,0,115,0,17,0,0,empty,mBC-0814-1
"C8,F5",5131,5568,3722,1846,3260,0,1782,1785,1313,472,2.781779661,935,1344,994,285,0,285,0,50,0,0,empty,mBC-0814-1
"C8,F6",4873,5234,3416,1818,3024,0,1682,1684,1243,441,2.818594104,911,1651,1138,381,0,381,0,93,0,0.020997375,empty,mBC-0814-1
"C8,F7",4935,4744,3178,1566,2826,0,1536,1536,1110,426,2.605633803,802,10181,3126,959,0,959,0,116,0,0.038581856,empty,mBC-0814-1
"C8,F8",5904,6273,4281,1992,3545,1,1893,1897,1417,480,2.952083333,973,264,202,61,0,61,0,15,0,0,empty,mBC-0814-1
"C8,F9",938368,1048613,641729,406884,620644,3,380578,381054,273074,107980,2.528931284,221540,171900,65427,19486,23,19463,6,1532,0,0.051585059,mm10,mBC-0814-1
"C8,F10",688690,784367,467474,316893,456878,0,273339,273618,224340,49278,4.552538658,158745,339759,249746,68237,42,68195,4,3281,0,0.000557226,mm10,mBC-0814-1
"C8,F11",4297,4700,3062,1638,2770,0,1538,1541,1095,446,2.455156951,844,1221,934,237,0,237,0,49,0,0,empty,mBC-0814-1
"C8,F12",4767,5272,3379,1893,2967,0,1640,1644,1156,488,2.368852459,876,92,57,11,0,11,0,8,0,0,empty,mBC-0814-1
"C8,G1",7199,7721,5180,2541,4579,0,2489,2490,1815,675,2.688888889,1317,3248,2323,710,0,710,0,133,0,0.011267606,empty,mBC-0814-1
"C8,G2",5502,5978,3960,2018,3484,0,1921,1924,1360,564,2.411347518,1043,481,287,90,0,90,0,19,0,0,empty,mBC-0814-1
"C8,G3",5162,5776,3648,2128,3324,0,1855,1856,1313,543,2.418047882,1032,1380,918,287,0,287,0,66,0,0,empty,mBC-0814-1
"C8,G4",4825,5110,3556,1554,3000,0,1544,1547,1097,450,2.437777778,812,1,0,0,0,0,0,0,0,0,empty,mBC-0814-1
"C8,G5",4398,4512,3096,1416,2716,0,1454,1455,1051,404,2.601485149,763,1427,960,278,0,278,0,57,0,0,empty,mBC-0814-1
"C8,G6",8362,8829,6058,2771,5212,0,2765,2778,2017,761,2.650459921,1411,79,60,16,0,16,0,5,0,0,empty,mBC-0814-1
"C8,G7",5073,5373,3637,1736,3232,0,1723,1729,1223,506,2.416996047,883,2138,1442,434,0,434,0,87,0,0,empty,mBC-0814-1
"C8,G8",7082,7885,5022,2863,4642,0,2593,2593,1872,721,2.596393897,1428,3191,2078,537,0,537,0,117,0,0.03538175,empty,mBC-0814-1
"C8,G9",5267,5763,3703,2060,3406,2,1936,1946,1395,551,2.531760436,1047,2746,1986,581,0,581,0,104,0,0.008605852,empty,mBC-0814-1
"C8,G10",9048,9681,6473,3208,5666,0,3043,3049,2200,849,2.591283863,1630,3210,2242,641,1,640,1,142,0,0.0140625,empty,mBC-0814-1
"C8,G11",8871,9486,6369,3117,5618,0,3071,3079,2251,828,2.718599034,1621,1668,1074,342,0,342,0,66,0,0.023391813,empty,mBC-0814-1
"C8,G12",4522,4872,3166,1706,2923,0,1600,1602,1149,453,2.536423841,848,29760,8573,2649,7,2642,2,236,0,0.092732778,empty,mBC-0814-1
"C8,H1",4537,4829,3276,1553,2876,0,1553,1553,1130,423,2.671394799,830,1025,756,213,0,213,0,41,0,0,empty,mBC-0814-1
"C8,H2",7977,8804,5685,3119,5065,0,2786,2789,1961,828,2.368357488,1530,6768,4015,1111,0,1111,0,157,0,0.02160216,empty,mBC-0814-1
"C8,H3",5260,5584,3752,1832,3265,0,1803,1805,1347,458,2.941048035,926,1395,986,337,0,337,0,63,0,0,empty,mBC-0814-1
"C8,H4",5378,5903,3825,2078,3446,0,1925,1930,1337,593,2.254637437,1047,66,54,18,0,18,0,7,0,0,empty,mBC-0814-1
"C8,H5",6476,6899,4676,2223,3964,0,2184,2191,1583,608,2.603618421,1128,6760,2829,746,1,745,1,104,0,0.051006711,empty,mBC-0814-1
"C8,H6",5891,6466,4150,2316,3771,0,2096,2101,1556,545,2.855045872,1142,1891,1200,355,0,355,0,75,0,0.03943662,empty,mBC-0814-1
"C8,H7",5091,5410,3584,1826,3190,0,1752,1756,1273,483,2.635610766,940,1512,1025,300,0,300,0,57,0,0,empty,mBC-0814-1
"C8,H8",4337,4587,3193,1394,2691,0,1445,1451,1053,398,2.645728643,723,2132,1557,452,1,451,1,70,0,0.037694013,empty,mBC-0814-1
"C8,H9",4714,5264,3370,1894,3053,0,1685,1689,1189,500,2.378,945,1211,895,236,0,236,0,50,0,0.004237288,empty,mBC-0814-1
"C8,H10",3445,3709,2402,1307,2154,1,1235,1236,894,342,2.614035088,667,1014,810,183,1,182,1,42,0,0,empty,mBC-0814-1
"C8,H11",3809,4182,2667,1515,2515,0,1426,1430,1039,391,2.657289003,793,711,217,62,0,62,0,11,0,0,empty,mBC-0814-1
"C8,H12",209496,241825,138820,103005,146403,0,91053,91149,71670,19479,3.679346989,54839,133282,96074,26393,19,26374,2,1840,0,0.000113748,mm10,mBC-0814-1
"C9,A1",5487,5943,3909,2034,3403,0,1868,1874,1255,619,2.027463651,1000,1616,1122,308,0,308,0,62,0,0.081168831,empty,mBC-0814-1
"C9,A2",5051,5228,3657,1571,3076,0,1591,1591,1130,461,2.451193059,823,1764,1249,410,0,410,0,96,0,0.036585366,empty,mBC-0814-1
"C9,A3",4528,4782,3321,1461,2836,0,1500,1504,1044,460,2.269565217,770,798,513,133,0,133,0,36,0,0,empty,mBC-0814-1
"C9,A4",5539,5835,4006,1829,3363,1,1782,1783,1317,466,2.826180258,923,390,308,100,0,100,0,26,0,0,empty,mBC-0814-1
"C9,A5",4444,4598,3165,1433,2768,0,1451,1453,1013,440,2.302272727,753,1348,963,302,0,302,0,64,0,0,empty,mBC-0814-1
"C9,A6",3889,4140,2779,1361,2375,0,1296,1299,880,419,2.100238663,673,1410,1000,278,0,278,0,49,0,0,empty,mBC-0814-1
"C9,A7",5487,5824,3931,1893,3421,0,1819,1821,1325,496,2.671370968,979,1447,973,348,0,348,0,77,0,0,empty,mBC-0814-1
"C9,A8",2175,2380,1523,857,1427,0,796,796,576,220,2.618181818,456,1194,848,271,0,271,0,55,0,0.014760148,empty,mBC-0814-1
"C9,A9",757102,849403,514054,335349,492722,0,298922,299250,230555,68695,3.356212243,173083,151267,110429,30983,11,30972,2,1982,0,0.000484308,mm10,mBC-0814-1
"C9,A10",3404,3716,2473,1243,2136,0,1176,1178,828,350,2.365714286,601,147,105,35,0,35,0,11,0,0,empty,mBC-0814-1
"C9,A11",4743,5022,3382,1640,2949,0,1608,1608,1155,453,2.549668874,864,66507,17259,5427,11,5416,3,406,0,0.071454948,empty,mBC-0814-1
"C9,A12",3573,3663,2595,1068,2152,0,1110,1110,806,304,2.651315789,570,2915,1831,557,1,556,1,118,0,0.04676259,empty,mBC-0814-1
"C9,B1",4758,5184,3415,1769,2950,0,1592,1598,1103,495,2.228282828,850,1441,982,286,0,286,0,56,0,0,empty,mBC-0814-1
"C9,B2",4707,4871,3244,1627,2930,0,1599,1605,1176,429,2.741258741,881,269,150,59,0,59,0,15,0,0,empty,mBC-0814-1
"C9,B3",3883,4275,2648,1627,2523,0,1424,1430,1028,402,2.55721393,834,3977,1861,515,2,513,2,69,0,0.005847953,empty,mBC-0814-1
"C9,B4",4062,4272,2951,1321,2571,0,1367,1370,950,420,2.261904762,706,1095,816,246,0,246,0,47,0,0,empty,mBC-0814-1
"C9,B5",4763,3162,1929,1233,2150,0,1265,1272,938,334,2.808383234,748,942,652,184,1,183,1,48,0,0,empty,mBC-0814-1
"C9,B6",3870,4207,2765,1442,2502,7,1365,1378,994,384,2.588541667,744,1833,1202,376,0,376,0,69,0,0.098404255,empty,mBC-0814-1
"C9,B7",4883,5272,3393,1879,3073,0,1657,1663,1179,484,2.435950413,882,13163,3928,1268,2,1266,2,112,0,0.110584518,empty,mBC-0814-1
"C9,B8",3677,3969,2687,1282,2295,0,1260,1261,891,370,2.408108108,661,1015,687,212,0,212,0,48,0,0,empty,mBC-0814-1
"C9,B9",4535,4822,3371,1451,2799,1,1454,1457,1062,395,2.688607595,739,525,384,146,0,146,0,33,0,0,empty,mBC-0814-1
"C9,B10",429871,442190,284295,157895,268777,0,153268,153654,121657,31997,3.8021377,85822,13611,9260,2389,1,2388,1,298,0,0,mm10,mBC-0814-1
"C9,B11",6160,6542,4448,2094,3797,0,1999,2003,1409,594,2.372053872,1040,55,39,18,0,18,0,7,0,0,empty,mBC-0814-1
"C9,B12",5255,5760,3749,2011,3266,0,1796,1798,1232,566,2.176678445,974,7677,2427,767,3,764,2,82,0,0.006544503,empty,mBC-0814-1
"C9,C1",5491,5709,4023,1686,3338,0,1700,1700,1196,504,2.373015873,859,689,480,147,0,147,0,28,0,0,empty,mBC-0814-1
"C9,C2",4971,5240,3640,1600,3080,0,1649,1654,1201,453,2.651214128,839,2412,1685,465,0,465,0,97,0,0,empty,mBC-0814-1
"C9,C3",5939,6561,4252,2309,3731,0,2000,2001,1456,545,2.671559633,1114,818,553,204,0,204,0,38,0,0.009803922,empty,mBC-0814-1
"C9,C4",4711,5116,3389,1727,2955,0,1575,1575,1147,428,2.679906542,813,1630,1155,376,0,376,0,74,0,0.015957447,empty,mBC-0814-1
"C9,C5",7259,7722,5234,2488,4464,1,2424,2429,1747,682,2.561583578,1246,1159,784,184,0,184,0,52,0,0,empty,mBC-0814-1
"C9,C6",529098,611031,351772,259259,365949,1,226789,227072,187464,39608,4.732983236,135273,160542,110547,30859,22,30837,1,2038,0,9.72857E-05,mm10,mBC-0814-1
"C9,C7",6781,7180,4747,2433,4240,0,2295,2295,1630,665,2.45112782,1221,303,225,47,0,47,0,16,0,0,empty,mBC-0814-1
"C9,C8",5369,5642,3904,1738,3236,0,1726,1726,1227,499,2.458917836,885,1531,1050,317,0,317,0,60,0,0.015772871,empty,mBC-0814-1
"C9,C9",4581,5121,3223,1898,2953,0,1617,1619,1167,452,2.581858407,892,3051,1461,411,1,410,1,72,0,0.063414634,empty,mBC-0814-1
"C9,C10",5469,5903,3921,1982,3419,0,1813,1821,1291,530,2.435849057,952,1053,702,204,0,204,0,33,0,0.014705882,empty,mBC-0814-1
"C9,C11",4367,4878,3042,1836,2849,0,1608,1608,1129,479,2.356993737,878,1527,1064,278,0,278,0,60,0,0.035971223,empty,mBC-0814-1
"C9,C12",510087,598728,332910,265818,354037,1,234166,234401,160843,73558,2.186614644,143896,42930,28002,7690,5,7685,2,762,0,0.001951854,mm10,mBC-0814-1
"C9,D1",4279,4595,3129,1466,2689,4,1452,1460,1039,421,2.467933492,771,499,310,83,0,83,0,20,0,0,empty,mBC-0814-1
"C9,D2",5109,5415,3785,1630,3177,0,1649,1655,1183,472,2.506355932,835,1602,1148,318,0,318,0,69,0,0,empty,mBC-0814-1
"C9,D3",454083,532877,300401,232476,317235,1,200723,200943,162533,38410,4.231528248,121975,148471,104203,28551,17,28534,2,1898,0,0.000315413,mm10,mBC-0814-1
"C9,D4",474906,554516,309702,244814,329433,4,212077,212317,170806,41511,4.114716581,129473,63419,46383,13251,7,13244,1,1080,0,0.0012836,mm10,mBC-0814-1
"C9,D5",4134,4323,2907,1416,2543,0,1400,1400,1011,389,2.598971722,719,1864,1308,385,0,385,0,85,0,0.007792208,empty,mBC-0814-1
"C9,D6",4794,5386,3410,1976,3033,0,1669,1670,1207,463,2.606911447,944,1582,1080,313,0,313,0,58,0,0.022364217,empty,mBC-0814-1
"C9,D7",5541,6058,3958,2100,3508,0,1859,1865,1392,473,2.942917548,990,2371,1509,471,0,471,0,89,0,0,empty,mBC-0814-1
"C9,D8",4964,5198,3586,1612,3009,0,1611,1620,1163,457,2.544857768,835,1470,1130,288,0,288,0,38,0,0,empty,mBC-0814-1
"C9,D9",3220,3466,2307,1159,1991,0,1091,1092,785,307,2.557003257,574,1189,812,222,0,222,0,41,0,0,empty,mBC-0814-1
"C9,D10",3595,3922,2562,1360,2299,0,1245,1245,884,361,2.448753463,695,531,363,120,0,120,0,40,0,0,empty,mBC-0814-1
"C9,D11",611770,697753,415806,281947,407737,1,246371,246660,197748,48912,4.042934249,143523,407224,300228,80881,46,80835,4,3594,0,0.00013608,mm10,mBC-0814-1
"C9,D12",6265,6889,4451,2438,3969,0,2187,2193,1566,627,2.497607656,1184,2656,1829,602,0,602,0,109,0,0,empty,mBC-0814-1
"C9,E1",4702,5014,3380,1634,2866,0,1461,1467,1021,446,2.289237668,754,1418,1039,330,0,330,0,59,0,0,empty,mBC-0814-1
"C9,E2",3701,4027,2666,1361,2292,8,1259,1268,914,354,2.581920904,670,1229,758,253,0,253,0,50,0,0.003952569,empty,mBC-0814-1
"C9,E3",3258,3396,2386,1010,2023,5,1055,1061,723,338,2.139053254,524,871,591,197,0,197,0,45,0,0,empty,mBC-0814-1
"C9,E4",6220,5905,3733,2172,3441,0,1947,1957,1416,541,2.617375231,1117,1283,832,250,0,250,0,53,0,0,empty,mBC-0814-1
"C9,E5",3676,3901,2649,1252,2227,0,1184,1185,850,335,2.537313433,620,660,493,168,0,168,0,37,0,0,empty,mBC-0814-1
"C9,E6",4463,4730,3225,1505,2721,0,1433,1433,1037,396,2.618686869,736,1496,1010,279,0,279,0,69,0,0,empty,mBC-0814-1
"C9,E7",4416,4555,3193,1362,2598,0,1333,1333,959,374,2.564171123,676,1143,708,187,0,187,0,38,0,0,empty,mBC-0814-1
"C9,E8",4505,4732,3287,1445,2753,0,1408,1410,993,417,2.381294964,698,2942,1682,440,0,440,0,92,0,0,empty,mBC-0814-1
"C9,E9",3191,3416,2294,1122,1966,0,1064,1064,738,326,2.263803681,546,1213,824,257,0,257,0,51,0,0,empty,mBC-0814-1
"C9,E10",3790,4198,2766,1432,2464,0,1323,1323,923,400,2.3075,689,2078,1367,441,0,441,0,87,0,0,empty,mBC-0814-1
"C9,E11",368363,441865,229222,212643,267742,0,186240,186444,112799,73645,1.531658633,117908,22798,14694,3778,1,3777,1,544,0,0.003971406,mm10,mBC-0814-1
"C9,E12",3901,4013,2818,1195,2299,0,1187,1189,851,338,2.517751479,586,1436,1043,300,0,300,0,50,0,0.046666667,empty,mBC-0814-1
"C9,F1",4691,5153,3323,1830,3001,0,1608,1611,1132,479,2.363256785,894,1407,1023,282,0,282,0,49,0,0.014184397,empty,mBC-0814-1
"C9,F2",6262,6675,4509,2166,3865,0,2064,2068,1453,615,2.362601626,1065,1763,1240,381,0,381,0,81,0,0,empty,mBC-0814-1
"C9,F3",4810,5094,3509,1585,3062,0,1643,1650,1174,476,2.466386555,852,2064,1435,333,2,331,2,68,0,0.003021148,empty,mBC-0814-1
"C9,F4",5238,5425,3741,1684,3184,0,1736,1736,1281,455,2.815384615,880,269,143,40,0,40,0,20,0,0,empty,mBC-0814-1
"C9,F5",4785,5074,3438,1636,2938,0,1592,1593,1136,457,2.485776805,817,1200,904,270,0,270,0,53,0,0,empty,mBC-0814-1
"C9,F6",4820,5135,3425,1710,3011,0,1657,1661,1200,461,2.603036876,869,1892,1293,403,0,403,0,82,0,0,empty,mBC-0814-1
"C9,F7",4224,4479,3076,1403,2597,0,1362,1362,957,405,2.362962963,692,515,372,110,0,110,0,23,0,0,empty,mBC-0814-1
"C9,F8",5953,6301,4328,1973,3612,0,1941,1943,1370,573,2.390924956,985,55,33,11,0,11,0,8,0,0,empty,mBC-0814-1
"C9,F9",5300,5602,3902,1700,3364,0,1790,1795,1287,508,2.533464567,915,2573,1657,480,0,480,0,94,0,0,empty,mBC-0814-1
"C9,F10",6301,6589,4609,1980,3859,0,1985,1987,1413,574,2.461672474,1022,1627,1131,305,0,305,0,65,0,0,empty,mBC-0814-1
"C9,F11",4204,4410,3147,1263,2634,0,1382,1383,1025,358,2.863128492,729,1554,1113,323,0,323,0,60,0,0,empty,mBC-0814-1
"C9,F12",4655,5100,3234,1866,2930,1,1643,1647,1134,513,2.210526316,914,12,6,5,0,5,0,3,0,0,empty,mBC-0814-1
"C9,G1",6877,7309,4914,2395,4305,0,2295,2296,1624,672,2.416666667,1188,2956,1988,631,1,630,1,122,0,0.022222222,empty,mBC-0814-1
"C9,G2",5686,5995,4076,1919,3425,1,1838,1843,1283,560,2.291071429,944,520,403,86,0,86,0,15,0,0,empty,mBC-0814-1
"C9,G3",5148,5509,3647,1862,3145,0,1741,1750,1243,507,2.451676529,934,2528,1849,555,1,554,1,96,0,0,empty,mBC-0814-1
"C9,G4",5385,5597,3825,1772,3272,0,1754,1759,1279,480,2.664583333,921,22,21,11,0,11,0,1,0,0,empty,mBC-0814-1
"C9,G5",4634,5142,3257,1885,2883,0,1559,1559,1076,483,2.227743271,861,1249,872,244,0,244,0,60,0,0,empty,mBC-0814-1
"C9,G6",9200,9774,6627,3147,5580,0,2911,2916,2104,812,2.591133005,1522,640,385,126,0,126,0,16,0,0,empty,mBC-0814-1
"C9,G7",5392,5947,3935,2012,3481,0,1885,1887,1279,608,2.103618421,1016,2490,1722,468,0,468,0,94,0,0.002136752,empty,mBC-0814-1
"C9,G8",7296,7727,5144,2583,4491,5,2447,2456,1726,730,2.364383562,1300,6436,3312,1010,0,1010,0,160,0,0.032673267,empty,mBC-0814-1
"C9,G9",4995,5405,3578,1827,3154,0,1722,1730,1200,530,2.264150943,910,2853,1965,521,2,519,1,108,0,0,empty,mBC-0814-1
"C9,G10",8992,9545,6535,3010,5614,0,2967,2973,2146,827,2.594921403,1561,2684,1888,526,0,526,0,119,0,0,empty,mBC-0814-1
"C9,G11",9088,9720,6472,3248,5691,0,3108,3115,2241,874,2.564073227,1690,13270,3993,1263,0,1263,0,152,0,0.005542359,empty,mBC-0814-1
"C9,G12",4684,5127,3334,1793,2975,0,1640,1643,1156,487,2.373716632,892,2194,1616,495,0,495,0,75,0,0,empty,mBC-0814-1
"C9,H1",4447,4849,3276,1573,2816,0,1524,1527,1081,446,2.423766816,792,3028,1260,397,0,397,0,67,0,0.01511335,empty,mBC-0814-1
"C9,H2",8272,8794,5894,2900,5147,0,2793,2795,1958,837,2.339307049,1488,19749,6440,1976,5,1971,3,235,0,0.047691527,empty,mBC-0814-1
"C9,H3",434698,515044,286405,228639,304183,1,193345,193554,157181,36373,4.321364749,118174,228895,168538,45177,24,45153,2,2605,0,6.64408E-05,mm10,mBC-0814-1
"C9,H4",5251,5687,3784,1903,3284,2,1732,1737,1293,444,2.912162162,952,109,81,25,0,25,0,7,0,0,empty,mBC-0814-1
"C9,H5",6461,6861,4622,2239,3958,0,2141,2148,1534,614,2.498371336,1158,2446,1797,493,0,493,0,83,0,0.002028398,empty,mBC-0814-1
"C9,H6",6572,6571,4440,2131,3766,0,2036,2036,1449,587,2.468483816,1049,31972,11120,3361,5,3356,2,342,0,0.117103695,empty,mBC-0814-1
"C9,H7",5300,5509,3822,1687,3255,0,1726,1732,1246,486,2.563786008,881,1737,1104,318,0,318,0,54,0,0,empty,mBC-0814-1
"C9,H8",4246,4655,3137,1518,2714,0,1440,1440,1005,435,2.310344828,776,2202,1520,431,0,431,0,75,0,0.03712297,empty,mBC-0814-1
"C9,H9",5095,5386,3596,1790,3217,0,1715,1715,1303,412,3.162621359,890,1188,792,252,0,252,0,50,0,0,empty,mBC-0814-1
"C9,H10",3539,3832,2466,1366,2163,0,1165,1165,816,349,2.338108883,617,1209,800,219,1,218,1,43,0,0.036697248,empty,mBC-0814-1
"C9,H11",3843,4165,2655,1510,2401,0,1368,1368,984,384,2.5625,752,12,5,3,0,3,0,3,0,0,empty,mBC-0814-1
"C9,H12",2407,2648,1606,1042,1578,0,885,885,621,264,2.352272727,500,1023,638,217,1,216,1,51,0,0.00462963,empty,mBC-0814-1
"C10,A1",5807,6365,4135,2230,3760,0,2020,2023,1445,578,2.5,1122,1845,1271,384,0,384,0,72,0,0.015625,empty,mBC-0814-1
"C10,A2",6182,7017,4363,2654,4158,0,2323,2323,1739,584,2.977739726,1345,1484,1019,291,0,291,0,76,0,0.068728522,empty,mBC-0814-1
"C10,A3",5085,5714,3566,2148,3283,0,1782,1784,1288,496,2.596774194,997,7950,2593,792,0,792,0,127,0,0.005050505,empty,mBC-0814-1
"C10,A4",5962,6358,4321,2037,3628,0,1942,1944,1391,553,2.515370705,984,443,279,79,0,79,0,15,0,0.341772152,empty,mBC-0814-1
"C10,A5",5123,5660,3678,1982,3363,0,1850,1859,1331,528,2.520833333,1024,1132,688,202,0,202,0,43,0,0,empty,mBC-0814-1
"C10,A6",3838,3952,2697,1255,2363,0,1272,1272,943,329,2.866261398,650,2723,1354,387,0,387,0,68,0,0,empty,mBC-0814-1
"C10,A7",5859,6227,4143,2084,3751,0,2056,2056,1483,573,2.588132635,1112,1114,727,232,0,232,0,58,0,0,empty,mBC-0814-1
"C10,A8",2430,2690,1677,1013,1563,5,875,883,627,256,2.44921875,489,1748,1185,289,0,289,0,61,0,0.020761246,empty,mBC-0814-1
"C10,A9",6656,7149,4704,2445,4150,0,2225,2227,1588,639,2.48513302,1173,2563,1746,498,0,498,0,68,0,0.016064257,empty,mBC-0814-1
"C10,A10",4055,4543,2778,1765,2681,0,1536,1541,1123,418,2.686602871,846,6263,2245,688,1,687,1,86,0,0.033478894,empty,mBC-0814-1
"C10,A11",5183,5646,3656,1990,3280,0,1810,1815,1327,488,2.719262295,1011,2404,1649,479,2,477,1,82,0,0,empty,mBC-0814-1
"C10,A12",5214,5705,3628,2077,3282,0,1833,1836,1410,426,3.309859155,987,2913,2207,574,2,572,1,127,0,0,empty,mBC-0814-1
"C10,B1",5140,5481,3760,1721,3208,0,1732,1734,1236,498,2.481927711,881,1414,975,262,0,262,0,56,0,0,empty,mBC-0814-1
"C10,B2",5378,5664,3737,1927,3368,0,1822,1825,1283,542,2.367158672,997,6301,1892,575,0,575,0,68,0,0,empty,mBC-0814-1
"C10,B3",5011,5602,3475,2127,3343,0,1886,1886,1351,535,2.525233645,1092,1069,792,187,0,187,0,43,0,0,empty,mBC-0814-1
"C10,B4",996138,1101797,696089,405708,653833,2,387333,387782,262637,125145,2.098661553,222363,51049,27768,8111,11,8100,2,971,0,0.002222222,mm10,mBC-0814-1
"C10,B5",4436,3217,1967,1250,2264,4,1286,1295,957,338,2.831360947,769,1151,850,248,0,248,0,40,0,0.044354839,empty,mBC-0814-1
"C10,B6",4436,4959,3094,1865,2904,0,1634,1636,1173,463,2.533477322,904,3054,1187,350,0,350,0,64,0,0.037142857,empty,mBC-0814-1
"C10,B7",5391,5789,3899,1890,3472,0,1889,1891,1376,515,2.67184466,1001,1260,836,231,0,231,0,53,0,0,empty,mBC-0814-1
"C10,B8",3964,4155,2861,1294,2494,0,1322,1326,953,373,2.554959786,686,932,639,188,0,188,0,45,0,0,empty,mBC-0814-1
"C10,B9",5393,5977,3717,2260,3587,6,2043,2050,1481,569,2.602811951,1165,680,494,181,0,181,0,38,0,0,empty,mBC-0814-1
"C10,B10",4745,4962,3306,1656,2930,0,1598,1599,1128,471,2.394904459,865,424,299,110,0,110,0,22,0,0,empty,mBC-0814-1
"C10,B11",11734,13005,8251,4754,7764,0,4523,4531,3284,1247,2.633520449,2530,749,217,69,0,69,0,18,0,0,empty,mBC-0814-1
"C10,B12",5738,6414,4078,2336,3780,0,2159,2163,1515,648,2.337962963,1185,4026,1528,466,0,466,0,83,0,0.02360515,empty,mBC-0814-1
"C10,C1",5684,6045,4148,1897,3542,0,1820,1822,1301,521,2.497120921,938,862,617,157,0,157,0,28,0,0.01910828,empty,mBC-0814-1
"C10,C2",5915,6211,4206,2005,3733,0,2060,2062,1487,575,2.586086957,1096,5596,2280,789,2,787,1,120,0,0.005082592,empty,mBC-0814-1
"C10,C3",6344,6459,4656,1803,3858,0,2022,2028,1450,578,2.508650519,983,655,395,104,0,104,0,28,0,0,empty,mBC-0814-1
"C10,C4",5882,6432,4236,2196,3752,0,2046,2049,1537,512,3.001953125,1094,1228,848,252,0,252,0,62,0,0.095238095,empty,mBC-0814-1
"C10,C5",240480,293008,159444,133564,171372,0,114272,114413,68468,45945,1.490216563,70028,43936,31518,8886,5,8881,2,830,0,0.005404797,mm10,mBC-0814-1
"C10,C6",6148,6672,4350,2322,4016,1,2242,2245,1672,573,2.917975567,1203,1797,1285,417,0,417,0,66,0,0,empty,mBC-0814-1
"C10,C7",7115,7630,5114,2516,4473,0,2478,2478,1752,726,2.41322314,1272,292,229,66,0,66,0,13,0,0,empty,mBC-0814-1
"C10,C8",5801,6264,4221,2043,3627,0,1935,1936,1351,585,2.309401709,1009,1354,922,251,1,250,1,50,0,0,empty,mBC-0814-1
"C10,C9",4760,5099,3434,1665,3037,0,1671,1673,1213,460,2.636956522,904,1059,739,195,0,195,0,49,0,0.020512821,empty,mBC-0814-1
"C10,C10",5852,6356,4310,2046,3718,1,1963,1974,1421,553,2.569620253,1061,1216,870,246,0,246,0,47,0,0,empty,mBC-0814-1
"C10,C11",5085,5587,3615,1972,3264,0,1781,1787,1271,516,2.463178295,1007,1430,1011,333,0,333,0,59,0,0.03003003,empty,mBC-0814-1
"C10,C12",8766,9389,6222,3167,5435,0,2956,2960,2104,856,2.457943925,1573,2197,1488,462,0,462,0,80,0,0.071428571,empty,mBC-0814-1
"C10,D1",5264,5792,3708,2084,3377,1,1867,1871,1317,554,2.377256318,1053,438,312,106,0,106,0,35,0,0,empty,mBC-0814-1
"C10,D2",713465,807960,493374,314586,470584,0,283638,283967,224425,59542,3.769188136,163238,220026,164501,46590,34,46556,2,2495,0,0.000300713,mm10,mBC-0814-1
"C10,D3",11254,12276,8027,4249,7239,0,4000,4004,2836,1168,2.428082192,2187,2991,2291,571,1,570,1,103,0,0,empty,mBC-0814-1
"C10,D4",405250,475859,265040,210819,283308,0,181140,181355,150771,30584,4.929734502,110354,159285,117964,32351,26,32325,2,2092,0,6.18716E-05,mm10,mBC-0814-1
"C10,D5",5236,5765,3763,2002,3526,0,2021,2021,1492,529,2.820415879,1084,1823,1291,379,0,379,0,86,0,0,empty,mBC-0814-1
"C10,D6",4816,5062,3438,1624,3011,0,1605,1609,1161,448,2.591517857,846,1150,661,217,0,217,0,56,0,0.004608295,empty,mBC-0814-1
"C10,D7",6413,6828,4441,2387,4058,0,2234,2237,1594,643,2.479004666,1255,23142,7444,2331,7,2324,2,250,0,0.065834768,empty,mBC-0814-1
"C10,D8",5707,6222,4060,2162,3636,0,2031,2034,1470,564,2.606382979,1081,1153,840,235,0,235,0,51,0,0,empty,mBC-0814-1
"C10,D9",3316,3496,2308,1188,2160,0,1215,1222,881,341,2.583577713,640,1045,720,221,0,221,0,53,0,0,empty,mBC-0814-1
"C10,D10",4782,5234,3353,1881,3095,0,1766,1766,1303,463,2.81425486,963,874,611,175,0,175,0,42,0,0,empty,mBC-0814-1
"C10,D11",450814,470045,341930,128115,276079,2,136900,137129,113418,23711,4.7833495,69511,179450,126583,35453,23,35430,3,2268,0,0,mm10,mBC-0814-1
"C10,D12",6749,7402,4789,2613,4334,0,2416,2418,1689,729,2.316872428,1323,2767,1992,541,0,541,0,104,0,0.001848429,empty,mBC-0814-1
"C10,E1",5429,5697,3879,1818,3356,0,1764,1770,1244,526,2.365019011,949,8416,2873,986,2,984,2,124,0,0.089430894,empty,mBC-0814-1
"C10,E2",3823,4232,2721,1511,2488,0,1355,1357,974,383,2.54308094,744,1462,1024,259,1,258,1,55,0,0,empty,mBC-0814-1
"C10,E3",3639,3886,2674,1212,2222,0,1192,1192,834,358,2.329608939,633,1564,1179,352,0,352,0,59,0,0,empty,mBC-0814-1
"C10,E4",3293,3496,2438,1058,2027,0,1085,1088,773,315,2.453968254,547,764,569,208,0,208,0,44,0,0,empty,mBC-0814-1
"C10,E5",3892,4133,2862,1271,2419,0,1268,1268,885,383,2.310704961,632,944,656,185,0,185,0,36,0,0,empty,mBC-0814-1
"C10,E6",4628,4942,3382,1560,2933,0,1520,1525,1089,436,2.497706422,813,1289,951,268,1,267,1,58,0,0.003745318,empty,mBC-0814-1
"C10,E7",4838,5412,3448,1964,3115,0,1658,1664,1213,451,2.689578714,952,1788,1329,318,0,318,0,60,0,0.003144654,empty,mBC-0814-1
"C10,E8",46812,60216,30559,29657,35522,0,24824,24846,15510,9336,1.661311054,15772,8608,6109,1599,0,1599,0,181,0,0.027517198,empty,mBC-0814-1
"C10,E9",3718,3911,2652,1259,2326,0,1279,1284,977,307,3.182410423,680,1572,1106,324,0,324,0,63,0,0.009259259,empty,mBC-0814-1
"C10,E10",4365,4832,3065,1767,2824,0,1523,1530,1045,485,2.154639175,822,1310,947,321,0,321,0,70,0,0,empty,mBC-0814-1
"C10,E11",4514,4899,3229,1670,2901,1,1555,1557,1141,416,2.742788462,824,1662,1113,305,0,305,0,62,0,0,empty,mBC-0814-1
"C10,E12",4396,4680,3132,1548,2775,0,1514,1514,1090,424,2.570754717,779,534,369,127,0,127,0,39,0,0,empty,mBC-0814-1
"C10,F1",5178,5677,3839,1838,3219,0,1721,1721,1234,487,2.533880903,915,1231,867,275,0,275,0,52,0,0,empty,mBC-0814-1
"C10,F2",6885,7336,4972,2364,4355,0,2335,2335,1717,618,2.778317152,1239,1769,1219,377,0,377,0,103,0,0,empty,mBC-0814-1
"C10,F3",5395,5876,3814,2062,3453,0,1894,1894,1426,468,3.047008547,1023,1135,829,263,0,263,0,50,0,0,empty,mBC-0814-1
"C10,F4",5820,6270,4137,2133,3707,0,2036,2040,1503,537,2.798882682,1082,246,124,51,0,51,0,21,0,0,empty,mBC-0814-1
"C10,F5",5506,5975,3901,2074,3544,0,1932,1938,1416,522,2.712643678,1074,1633,1174,309,0,309,0,65,0,0,empty,mBC-0814-1
"C10,F6",5667,6107,4120,1987,3646,0,1971,1971,1397,574,2.433797909,1030,1547,1072,352,1,351,1,79,0,0.031339031,empty,mBC-0814-1
"C10,F7",4896,5229,3585,1644,3056,0,1592,1592,1119,473,2.365750529,818,823,551,163,0,163,0,33,0,0,empty,mBC-0814-1
"C10,F8",6611,6962,4814,2148,4119,0,2189,2194,1549,645,2.401550388,1108,403,331,82,0,82,0,15,0,0,empty,mBC-0814-1
"C10,F9",474844,532742,328797,203945,318514,0,190195,190404,151295,39109,3.868546882,109565,57258,39116,11453,6,11447,2,1086,0,0.001223028,mm10,mBC-0814-1
"C10,F10",6725,7154,4932,2222,4161,0,2195,2199,1557,642,2.425233645,1142,1767,1194,336,0,336,0,59,0,0,empty,mBC-0814-1
"C10,F11",4648,5063,3355,1708,2986,0,1600,1602,1153,449,2.567928731,878,1745,1213,327,0,327,0,68,0,0.006116208,empty,mBC-0814-1
"C10,F12",5460,5733,3857,1876,3349,0,1837,1837,1338,499,2.681362725,993,24,11,9,0,9,0,7,0,0,empty,mBC-0814-1
"C10,G1",7930,8536,5685,2851,5029,0,2713,2719,1971,748,2.635026738,1478,2988,2087,652,0,652,0,115,0,0.006134969,empty,mBC-0814-1
"C10,G2",6093,6488,4343,2145,3783,0,2055,2055,1462,593,2.465430017,1109,618,455,165,0,165,0,20,0,0.139393939,empty,mBC-0814-1
"C10,G3",5565,6131,3912,2219,3547,0,2016,2016,1474,542,2.719557196,1084,2200,1305,416,0,416,0,94,0,0,empty,mBC-0814-1
"C10,G4",5359,5802,3888,1914,3350,0,1770,1774,1302,472,2.758474576,966,20,8,0,0,0,0,0,0,0,empty,mBC-0814-1
"C10,G5",4990,5638,3527,2111,3257,0,1863,1865,1311,554,2.366425993,1039,1230,889,248,0,248,0,50,0,0,empty,mBC-0814-1
"C10,G6",9580,10461,6925,3536,6167,0,3316,3319,2414,905,2.667403315,1777,97,72,30,0,30,0,9,0,0,empty,mBC-0814-1
"C10,G7",6382,7128,4584,2544,4174,0,2325,2328,1636,692,2.36416185,1306,2653,1833,539,0,539,0,96,0,0,empty,mBC-0814-1
"C10,G8",486569,548223,338514,209709,320302,0,193955,194184,146088,48096,3.03742515,111257,47458,26366,7722,6,7716,1,805,0,0.006091239,mm10,mBC-0814-1
"C10,G9",6205,6890,4453,2437,4045,0,2249,2249,1650,599,2.754590985,1229,2729,1916,618,1,617,1,108,0,0,empty,mBC-0814-1
"C10,G10",10142,10670,7221,3449,6448,0,3504,3504,2548,956,2.665271967,1861,2609,1773,590,0,590,0,121,0,0.022033898,empty,mBC-0814-1
"C10,G11",9870,10662,7185,3477,6203,0,3405,3410,2425,985,2.461928934,1771,1261,893,313,0,313,0,57,0,0,empty,mBC-0814-1
"C10,G12",4946,5460,3504,1956,3292,0,1844,1853,1358,495,2.743434343,1035,1777,1109,353,0,353,0,73,0,0,empty,mBC-0814-1
"C10,H1",467321,553923,309408,244515,329451,0,210503,210702,167982,42720,3.932162921,128939,99024,72647,20323,18,20305,4,1525,0,0.000147747,mm10,mBC-0814-1
"C10,H2",564188,667285,371462,295823,392066,1,247119,247394,197865,49529,3.994932262,150316,412092,296840,80712,50,80662,5,3703,0,0.000867819,mm10,mBC-0814-1
"C10,H3",6106,6723,4215,2508,3844,0,2175,2177,1607,570,2.819298246,1205,3803,1592,440,1,439,1,77,0,0.031890661,empty,mBC-0814-1
"C10,H4",990324,1155015,661141,493874,674027,0,429260,429684,333972,95712,3.489343029,258461,8443,5787,1687,0,1687,0,222,0,0,mm10,mBC-0814-1
"C10,H5",6848,7236,4955,2281,4173,2,2243,2249,1619,630,2.56984127,1164,2177,1340,391,0,391,0,75,0,0,empty,mBC-0814-1
"C10,H6",11646,13687,8430,5257,8191,0,4792,4797,3163,1634,1.935740514,2759,10662,4795,1524,3,1521,2,202,0,0.032215648,empty,mBC-0814-1
"C10,H7",5843,6215,4130,2085,3656,0,1997,2003,1431,572,2.501748252,1087,1104,741,265,0,265,0,47,0,0.018867925,empty,mBC-0814-1
"C10,H8",5090,5671,3588,2083,3285,0,1850,1851,1363,488,2.793032787,1040,2086,1320,379,0,379,0,89,0,0.023746702,empty,mBC-0814-1
"C10,H9",16354,19269,10516,8753,11075,0,6973,6986,3447,3539,0.974003956,4270,47778,15667,4725,10,4715,2,430,0,0.116012725,empty,mBC-0814-1
"C10,H10",3955,4148,2805,1343,2405,0,1321,1322,991,331,2.993957704,668,720,395,125,0,125,0,34,0,0.08,empty,mBC-0814-1
"C10,H11",4664,5132,3340,1792,3024,0,1701,1705,1252,453,2.763796909,920,8,5,4,0,4,0,4,0,0,empty,mBC-0814-1
"C10,H12",3324,3685,2343,1342,2173,0,1200,1204,890,314,2.834394904,683,1033,658,175,0,175,0,47,0,0,empty,mBC-0814-1
"C11,A1",5404,5833,3866,1967,3542,1,1900,1906,1319,587,2.247018739,1041,1489,917,296,0,296,0,66,0,0,empty,mBC-0814-1
"C11,A2",525531,582513,357503,225010,343604,2,204082,204313,167469,36844,4.545353382,117494,116812,83491,24264,23,24241,1,1887,0,0.000123757,mm10,mBC-0814-1
"C11,A3",4511,4957,3237,1720,2883,0,1576,1580,1106,474,2.333333333,852,911,663,215,0,215,0,42,0,0,empty,mBC-0814-1
"C11,A4",5340,5663,3874,1789,3260,0,1712,1713,1246,467,2.668094218,884,564,291,97,0,97,0,33,0,0,empty,mBC-0814-1
"C11,A5",4502,5052,3246,1806,2915,0,1590,1594,1108,486,2.279835391,874,1317,800,219,0,219,0,42,0,0,empty,mBC-0814-1
"C11,A6",3508,3804,2459,1345,2256,0,1227,1231,851,380,2.239473684,646,1246,870,285,0,285,0,56,0,0,empty,mBC-0814-1
"C11,A7",5366,5789,3727,2062,3408,0,1906,1908,1336,572,2.335664336,1067,2284,1440,469,0,469,0,75,0,0.012793177,empty,mBC-0814-1
"C11,A8",2039,2244,1437,807,1302,1,720,721,542,179,3.027932961,408,1403,912,260,0,260,0,72,0,0.034615385,empty,mBC-0814-1
"C11,A9",6942,7252,4861,2391,4279,0,2279,2280,1658,622,2.665594855,1204,1379,880,288,0,288,0,58,0,0,empty,mBC-0814-1
"C11,A10",254406,293565,168968,124597,178222,0,112593,112720,88576,24144,3.668654738,68108,3042,2124,576,0,576,0,88,0,0.019097222,empty,mBC-0814-1
"C11,A11",4402,4622,3130,1492,2717,0,1450,1453,1030,423,2.43498818,746,1875,1210,321,0,321,0,73,0,0.018691589,empty,mBC-0814-1
"C11,A12",3863,4136,2730,1406,2421,0,1317,1323,955,368,2.595108696,680,12606,4125,1399,0,1399,0,188,0,0.015725518,empty,mBC-0814-1
"C11,B1",4423,4743,3221,1522,2833,1,1505,1509,1038,471,2.203821656,800,1048,687,230,0,230,0,54,0,0.004347826,empty,mBC-0814-1
"C11,B2",4872,5077,3498,1579,2981,0,1598,1600,1108,492,2.25203252,810,541,395,131,0,131,0,29,0,0,empty,mBC-0814-1
"C11,B3",3879,4109,2759,1350,2430,0,1351,1352,987,365,2.704109589,689,949,709,224,0,224,0,44,0,0,empty,mBC-0814-1
"C11,B4",4020,4279,2927,1352,2521,0,1401,1401,1015,386,2.629533679,700,2044,884,267,1,266,1,59,0,0.086466165,empty,mBC-0814-1
"C11,B5",3536,2315,1454,861,1666,0,915,920,639,281,2.274021352,549,1282,624,233,1,232,1,41,0,0.004310345,empty,mBC-0814-1
"C11,B6",3835,4106,2782,1324,2437,0,1292,1292,959,333,2.87987988,670,2638,1107,333,0,333,0,61,0,0.138138138,empty,mBC-0814-1
"C11,B7",658241,770356,439747,330609,455625,1,287312,287634,234223,53411,4.385295164,172398,92818,67134,18946,17,18929,3,1477,0,0.000792435,mm10,mBC-0814-1
"C11,B8",3586,3946,2635,1311,2323,0,1283,1286,903,383,2.35770235,671,913,585,160,1,159,1,34,0,0,empty,mBC-0814-1
"C11,B9",4488,4845,3334,1511,2903,0,1530,1535,1137,398,2.85678392,797,649,443,155,0,155,0,38,0,0,empty,mBC-0814-1
"C11,B10",4292,4440,3095,1345,2672,0,1416,1417,1019,398,2.560301508,719,717,475,131,0,131,0,23,0,0,empty,mBC-0814-1
"C11,B11",6276,6683,4540,2143,3893,1,2028,2033,1456,577,2.52339688,1074,46,10,4,0,4,0,2,0,0,empty,mBC-0814-1
"C11,B12",5178,5643,3631,2012,3310,0,1882,1883,1336,547,2.442413163,1049,1154,814,269,0,269,0,55,0,0,empty,mBC-0814-1
"C11,C1",5312,5809,3895,1914,3340,0,1736,1737,1264,473,2.67230444,921,1103,810,236,0,236,0,46,0,0,empty,mBC-0814-1
"C11,C2",592949,691144,395237,295907,405878,1,257072,257341,202031,55310,3.652702947,154146,175557,127538,36880,24,36856,2,2178,0,2.71326E-05,mm10,mBC-0814-1
"C11,C3",5456,6088,3893,2195,3526,0,1927,1930,1433,497,2.883299799,1076,561,324,120,1,119,1,30,0,0,empty,mBC-0814-1
"C11,C4",5026,5219,3660,1559,3115,1,1639,1640,1209,431,2.805104408,830,1187,844,224,0,224,0,63,0,0,empty,mBC-0814-1
"C11,C5",1199865,1364386,815669,548717,794064,3,486068,486674,411827,74847,5.502251259,284308,355450,258318,73785,46,73739,4,3525,0,0.000623822,mm10,mBC-0814-1
"C11,C6",552843,648814,364120,284694,391650,0,250936,251258,195406,55852,3.498639261,152250,142691,97137,28255,14,28241,2,1864,0,0.003222266,mm10,mBC-0814-1
"C11,C7",7074,7690,5175,2515,4496,0,2381,2389,1740,649,2.681047766,1255,579,367,81,0,81,0,16,0,0,empty,mBC-0814-1
"C11,C8",5242,5458,3834,1624,3241,0,1704,1707,1214,493,2.462474645,864,1300,934,245,0,245,0,63,0,0.073469388,empty,mBC-0814-1
"C11,C9",4508,4988,3227,1761,2825,0,1552,1555,1106,449,2.46325167,818,1110,747,238,0,238,0,40,0,0.050420168,empty,mBC-0814-1
"C11,C10",533923,593626,370708,222918,350338,3,207283,207569,150674,56895,2.648281923,118479,28616,20348,5826,2,5824,1,647,0,0.001201923,mm10,mBC-0814-1
"C11,C11",4402,4571,3144,1427,2737,0,1507,1508,1069,439,2.435079727,805,1385,973,274,1,273,1,61,0,0,empty,mBC-0814-1
"C11,C12",474270,522254,326572,195682,311125,1,183420,183637,144520,39117,3.694557354,105363,12316,9049,2402,1,2401,1,350,0,0,mm10,mBC-0814-1
"C11,D1",4062,4211,2894,1317,2535,0,1359,1362,973,389,2.501285347,665,494,292,80,0,80,0,22,0,0,empty,mBC-0814-1
"C11,D2",5080,5278,3713,1565,3073,0,1552,1552,1127,425,2.651764706,769,1141,775,195,0,195,0,42,0,0,empty,mBC-0814-1
"C11,D3",9886,10594,7013,3581,6306,0,3423,3432,2423,1009,2.401387512,1830,3717,2094,552,0,552,0,94,0,0.014492754,empty,mBC-0814-1
"C11,D4",4494,4870,3162,1708,2830,0,1581,1584,1136,448,2.535714286,879,1239,914,300,0,300,0,64,0,0.046666667,empty,mBC-0814-1
"C11,D5",4039,4512,2825,1687,2702,0,1495,1496,1107,389,2.845758355,889,1237,802,242,0,242,0,70,0,0.004132231,empty,mBC-0814-1
"C11,D6",4900,5371,3488,1883,3110,0,1719,1725,1224,501,2.443113772,925,941,625,188,0,188,0,38,0,0.005319149,empty,mBC-0814-1
"C11,D7",5547,5963,4020,1943,3586,0,1963,1963,1412,551,2.56261343,1028,2241,1519,416,0,416,0,80,0,0.028846154,empty,mBC-0814-1
"C11,D8",4818,5124,3455,1669,2971,0,1605,1608,1131,477,2.371069182,817,762,581,156,0,156,0,32,0,0,empty,mBC-0814-1
"C11,D9",2972,3179,2113,1066,1837,0,1002,1002,711,291,2.443298969,528,1379,971,263,0,263,0,47,0,0,empty,mBC-0814-1
"C11,D10",3706,4109,2675,1434,2479,0,1348,1348,1014,334,3.035928144,724,733,529,159,0,159,0,34,0,0,empty,mBC-0814-1
"C11,D11",3880,4072,2789,1283,2419,0,1276,1283,930,353,2.634560907,676,2033,1339,344,0,344,0,94,0,0,empty,mBC-0814-1
"C11,D12",80760,104841,52101,52740,62831,0,44159,44206,21560,22646,0.952044511,28685,19283,9077,2529,3,2526,1,334,0,0.004354711,empty,mBC-0814-1
"C11,E1",4634,5013,3356,1657,2957,0,1543,1543,1121,422,2.656398104,846,1388,1040,272,0,272,0,66,0,0,empty,mBC-0814-1
"C11,E2",3443,3569,2502,1067,2146,0,1160,1162,851,311,2.736334405,560,988,732,243,0,243,0,39,0,0.004115226,empty,mBC-0814-1
"C11,E3",3450,3614,2489,1125,2124,5,1100,1105,817,288,2.836805556,569,4441,1868,547,0,547,0,80,0,0,empty,mBC-0814-1
"C11,E4",3184,3404,2262,1142,1991,0,1089,1091,809,282,2.868794326,572,7599,2463,749,1,748,1,80,0,0.017379679,empty,mBC-0814-1
"C11,E5",18291,19797,13309,6488,11566,0,6168,6182,4938,1244,3.969453376,3296,5920,4353,1261,1,1260,1,173,0,0,empty,mBC-0814-1
"C11,E6",4465,4913,3215,1698,2771,0,1486,1488,1035,453,2.284768212,791,1744,971,298,0,298,0,59,0,0.023489933,empty,mBC-0814-1
"C11,E7",4392,4617,3157,1460,2665,0,1400,1406,986,420,2.347619048,708,1511,1020,341,0,341,0,47,0,0,empty,mBC-0814-1
"C11,E8",4539,4846,3301,1545,2816,0,1471,1471,1082,389,2.781491003,763,1731,1176,375,0,375,0,69,0,0.008,empty,mBC-0814-1
"C11,E9",2931,3092,2070,1022,1862,0,1009,1009,712,297,2.397306397,527,1028,756,241,0,241,0,46,0,0,empty,mBC-0814-1
"C11,E10",4019,4404,2858,1546,2562,0,1399,1399,985,414,2.379227053,722,1454,1091,290,0,290,0,66,0,0,empty,mBC-0814-1
"C11,E11",3976,4262,2844,1418,2551,1,1384,1385,968,417,2.321342926,719,1607,1166,343,1,342,1,67,0,0.052631579,empty,mBC-0814-1
"C11,E12",4130,4382,2835,1547,2537,0,1417,1419,1033,386,2.676165803,796,21204,6250,2001,2,1999,2,222,0,0.111555778,empty,mBC-0814-1
"C11,F1",4478,4844,3224,1620,2864,1,1535,1538,1099,439,2.503416856,807,1291,883,263,0,263,0,56,0,0,empty,mBC-0814-1
"C11,F2",6318,6626,4526,2100,3825,0,2027,2029,1481,548,2.702554745,1042,1718,1192,416,0,416,0,90,0,0,empty,mBC-0814-1
"C11,F3",5086,5685,3635,2050,3322,0,1856,1856,1312,544,2.411764706,1026,1337,970,313,0,313,0,59,0,0,empty,mBC-0814-1
"C11,F4",5165,5314,3749,1565,3240,0,1647,1654,1202,452,2.659292035,879,873,663,168,0,168,0,24,0,0,empty,mBC-0814-1
"C11,F5",4947,5429,3588,1841,3164,0,1695,1697,1241,456,2.721491228,908,1016,729,208,0,208,0,52,0,0,empty,mBC-0814-1
"C11,F6",4788,5068,3373,1695,2928,0,1612,1618,1190,428,2.780373832,845,1407,1027,358,0,358,0,84,0,0.055865922,empty,mBC-0814-1
"C11,F7",4322,4662,3079,1583,2758,0,1435,1435,1047,388,2.698453608,784,493,346,109,0,109,0,27,0,0,empty,mBC-0814-1
"C11,F8",6395,6720,4592,2128,4022,0,2156,2158,1568,590,2.657627119,1119,206,143,35,0,35,0,6,0,0,empty,mBC-0814-1
"C11,F9",651977,726475,433273,293202,428165,1,267270,267624,198342,69282,2.862821512,156204,59837,42034,11953,4,11949,1,1131,0,0,mm10,mBC-0814-1
"C11,F10",6238,6610,4655,1955,3856,0,2023,2028,1493,535,2.790654206,999,1418,971,294,0,294,0,74,0,0,empty,mBC-0814-1
"C11,F11",4102,4341,2939,1402,2585,0,1430,1432,1019,413,2.467312349,737,1263,905,261,0,261,0,49,0,0.003831418,empty,mBC-0814-1
"C11,F12",4780,5009,3426,1583,2976,0,1664,1668,1157,511,2.264187867,844,250,158,33,0,33,0,8,0,0,empty,mBC-0814-1
"C11,G1",7453,7703,5190,2513,4520,0,2405,2409,1711,698,2.451289398,1250,34170,10459,3259,4,3255,1,326,0,0.037788018,empty,mBC-0814-1
"C11,G2",5508,5878,3930,1948,3417,0,1852,1853,1340,513,2.61208577,976,658,505,138,0,138,0,27,0,0,empty,mBC-0814-1
"C11,G3",4745,5244,3378,1866,3080,3,1710,1713,1238,475,2.606315789,967,2444,1727,464,0,464,0,83,0,0,empty,mBC-0814-1
"C11,G4",4736,5057,3430,1627,2954,14,1585,1600,1189,411,2.892944039,799,0,0,0,0,0,0,0,0,0,empty,mBC-0814-1
"C11,G5",422267,478887,283532,195355,286070,3,177988,178185,134203,43982,3.051316448,106120,14385,9694,2603,3,2600,1,368,0,0.000769231,mm10,mBC-0814-1
"C11,G6",8516,9259,6174,3085,5434,0,2932,2937,2134,803,2.657534247,1556,163,95,27,0,27,0,10,0,0,empty,mBC-0814-1
"C11,G7",5100,5230,3610,1620,3210,4,1685,1694,1186,508,2.334645669,879,1815,1164,348,0,348,0,81,0,0.011494253,empty,mBC-0814-1
"C11,G8",6811,7576,4776,2800,4445,0,2538,2541,1849,692,2.671965318,1433,3095,2115,595,0,595,0,122,0,0.038655462,empty,mBC-0814-1
"C11,G9",5011,5451,3618,1833,3159,0,1783,1783,1276,507,2.516765286,909,1975,1314,370,0,370,0,79,0,0.024324324,empty,mBC-0814-1
"C11,G10",8610,8997,6237,2760,5459,0,2837,2841,2053,788,2.605329949,1476,3544,2447,689,0,689,0,138,0,0,empty,mBC-0814-1
"C11,G11",8623,9075,6249,2826,5348,0,2865,2873,2064,809,2.551297899,1468,1170,821,225,0,225,0,55,0,0,empty,mBC-0814-1
"C11,G12",4354,4715,3176,1539,2895,0,1545,1549,1135,414,2.741545894,806,1160,754,212,0,212,0,50,0,0,empty,mBC-0814-1
"C11,H1",4235,4563,3004,1559,2728,0,1494,1495,1093,402,2.718905473,790,1051,739,207,0,207,0,43,0,0,empty,mBC-0814-1
"C11,H2",7850,8709,5585,3124,5096,0,2830,2832,2032,800,2.54,1546,3330,2401,676,0,676,0,122,0,0.00591716,empty,mBC-0814-1
"C11,H3",5120,5561,3541,2020,3253,0,1756,1758,1250,508,2.460629921,961,1445,1045,328,0,328,0,62,0,0.057926829,empty,mBC-0814-1
"C11,H4",5353,5734,3821,1913,3374,0,1774,1774,1280,494,2.591093117,939,246,131,41,0,41,0,9,0,0,empty,mBC-0814-1
"C11,H5",6390,7088,4658,2430,4114,0,2250,2250,1615,635,2.543307087,1230,4022,2205,589,2,587,1,80,0,0,empty,mBC-0814-1
"C11,H6",5986,6330,4356,1974,3684,0,1967,1975,1373,602,2.280730897,1029,1954,1456,383,0,383,0,74,0,0.052219321,empty,mBC-0814-1
"C11,H7",4886,5240,3465,1775,3176,0,1752,1753,1262,491,2.570264766,936,1431,1077,331,0,331,0,55,0,0,empty,mBC-0814-1
"C11,H8",3989,4444,2794,1650,2662,0,1508,1512,1065,447,2.382550336,832,2120,1293,398,1,397,1,82,0,0.04534005,empty,mBC-0814-1
"C11,H9",4841,5157,3370,1787,3011,0,1611,1611,1149,462,2.487012987,870,1243,711,204,0,204,0,50,0,0.058823529,empty,mBC-0814-1
"C11,H10",480193,557588,318925,238663,328551,0,207627,207844,159010,48834,3.256133022,125096,109392,77806,22518,10,22508,1,1558,0,0.000488715,mm10,mBC-0814-1
"C11,H11",3687,4136,2648,1488,2444,0,1349,1351,933,418,2.232057416,766,13,9,8,0,8,0,6,0,0,empty,mBC-0814-1
"C11,H12",2501,2709,1754,955,1673,0,896,902,656,246,2.666666667,503,1136,889,267,0,267,0,55,0,0.02247191,empty,mBC-0814-1
"C12,A1",5762,6441,4167,2274,3839,0,2133,2134,1572,562,2.797153025,1182,920,652,216,0,216,0,53,0,0.00462963,empty,mBC-0814-1
"C12,A2",5467,5774,3983,1791,3389,0,1831,1833,1327,506,2.622529644,948,1162,845,270,0,270,0,82,0,0.059259259,empty,mBC-0814-1
"C12,A3",4792,5001,3344,1657,2844,0,1538,1540,1110,430,2.581395349,815,823,600,165,1,164,1,43,0,0,empty,mBC-0814-1
"C12,A4",5667,6143,4159,1984,3582,0,1951,1953,1387,566,2.450530035,1013,282,178,63,0,63,0,18,0,0,empty,mBC-0814-1
"C12,A5",484393,586641,311592,275049,354094,0,241554,241786,164237,77549,2.11784807,151555,28139,19358,5634,1,5633,1,586,0,0.002662879,mm10,mBC-0814-1
"C12,A6",3939,4119,2849,1270,2422,0,1339,1348,987,361,2.734072022,648,839,543,180,0,180,0,43,0,0.005555556,empty,mBC-0814-1
"C12,A7",5512,5829,3953,1876,3420,0,1840,1842,1331,511,2.604696673,941,1514,1045,307,0,307,0,68,0,0.003257329,empty,mBC-0814-1
"C12,A8",2289,2481,1636,845,1419,0,785,788,530,258,2.054263566,384,1257,903,312,0,312,0,65,0,0,empty,mBC-0814-1
"C12,A9",6369,6747,4556,2191,3883,0,2081,2081,1496,585,2.557264957,1088,2448,1116,315,1,314,1,58,0,0,empty,mBC-0814-1
"C12,A10",3544,3675,2479,1196,2219,0,1242,1242,916,326,2.809815951,673,221,156,70,0,70,0,19,0,0,empty,mBC-0814-1
"C12,A11",4352,4631,3181,1450,2736,1,1382,1385,1006,379,2.654353562,718,1363,989,326,0,326,0,71,0,0,empty,mBC-0814-1
"C12,A12",4365,4727,3032,1695,2831,0,1592,1592,1143,449,2.545657016,896,24700,7808,2384,5,2379,1,304,0,0.062631358,empty,mBC-0814-1
"C12,B1",4844,5016,3450,1566,2930,0,1520,1522,1120,402,2.786069652,795,1391,1036,280,0,280,0,60,0,0.003571429,empty,mBC-0814-1
"C12,B2",4817,5042,3357,1685,2992,0,1599,1599,1165,434,2.684331797,852,298,211,83,0,83,0,23,0,0,empty,mBC-0814-1
"C12,B3",4074,4383,2851,1532,2649,0,1494,1496,1067,429,2.487179487,789,580,416,133,0,133,0,43,0,0.105263158,empty,mBC-0814-1
"C12,B4",4269,4799,2939,1860,2849,0,1619,1621,1206,415,2.906024096,944,2279,978,314,0,314,0,80,0,0.047770701,empty,mBC-0814-1
"C12,B5",3667,2452,1578,874,1735,0,937,942,649,293,2.215017065,546,1047,778,254,0,254,0,64,0,0.023622047,empty,mBC-0814-1
"C12,B6",4141,4392,2958,1434,2633,0,1406,1407,1009,398,2.535175879,760,1698,1146,329,0,329,0,53,0,0.003039514,empty,mBC-0814-1
"C12,B7",5085,5395,3745,1650,3157,1,1650,1651,1178,473,2.490486258,829,894,669,229,0,229,0,63,0,0,empty,mBC-0814-1
"C12,B8",3621,3825,2659,1166,2322,0,1228,1232,886,346,2.560693642,614,601,418,160,0,160,0,39,0,0,empty,mBC-0814-1
"C12,B9",4876,5344,3488,1856,3141,0,1703,1707,1262,445,2.835955056,932,740,463,162,0,162,0,48,0,0,empty,mBC-0814-1
"C12,B10",4301,4399,3080,1319,2626,0,1418,1421,982,439,2.23690205,702,895,488,152,0,152,0,26,0,0,empty,mBC-0814-1
"C12,B11",6238,6576,4553,2023,3944,0,2100,2100,1481,619,2.392568659,1109,197,140,65,0,65,0,17,0,0,empty,mBC-0814-1
"C12,B12",5466,5747,3946,1801,3399,0,1828,1835,1295,540,2.398148148,934,1030,801,262,0,262,0,59,0,0,empty,mBC-0814-1
"C12,C1",2227008,2509367,1512973,996394,1415219,3,885018,886007,705993,180014,3.921878298,512795,239675,178906,50989,29,50960,3,2786,0,0.000372841,mm10,mBC-0814-1
"C12,C2",5313,5572,3799,1773,3236,0,1720,1720,1284,436,2.944954128,884,1626,1218,365,0,365,0,75,0,0,empty,mBC-0814-1
"C12,C3",5968,6477,4320,2157,3632,8,1960,1976,1403,573,2.448516579,1031,673,526,196,0,196,0,35,0,0.005102041,empty,mBC-0814-1
"C12,C4",5315,5678,3801,1877,3332,0,1714,1717,1311,406,3.229064039,957,13241,4299,1331,1,1330,1,176,0,0.036090226,empty,mBC-0814-1
"C12,C5",568027,632462,385646,246816,372846,0,225916,226195,181684,44511,4.081777538,131382,28102,19393,5462,3,5459,1,644,0,0,mm10,mBC-0814-1
"C12,C6",721694,831899,466542,365357,496479,0,326113,326485,240653,85832,2.803767826,196441,54851,39115,11148,1,11147,1,1093,0,0,mm10,mBC-0814-1
"C12,C7",6939,7523,5048,2475,4393,0,2387,2390,1737,653,2.660030628,1251,520,397,125,0,125,0,27,0,0,empty,mBC-0814-1
"C12,C8",5514,5836,3895,1941,3388,0,1820,1820,1310,510,2.568627451,968,1513,1053,325,1,324,1,70,0,0.00617284,empty,mBC-0814-1
"C12,C9",4695,5040,3322,1718,2912,0,1622,1622,1099,523,2.101338432,846,930,713,181,0,181,0,38,0,0.005524862,empty,mBC-0814-1
"C12,C10",5719,6034,4147,1887,3509,15,1846,1861,1320,541,2.439926063,932,926,538,186,0,186,0,42,0,0.096774194,empty,mBC-0814-1
"C12,C11",4646,5143,3311,1832,2970,0,1690,1691,1174,517,2.270793037,921,879,623,190,0,190,0,46,0,0.036842105,empty,mBC-0814-1
"C12,C12",8107,8778,5679,3099,5197,6,2891,2901,2089,812,2.572660099,1577,1821,1306,406,0,406,0,78,0,0.017241379,empty,mBC-0814-1
"C12,D1",4525,4781,3282,1499,2770,0,1482,1485,1084,401,2.703241895,737,585,388,69,0,69,0,31,0,0,empty,mBC-0814-1
"C12,D2",690641,783908,475867,308041,456861,0,272309,272629,232777,39852,5.841036836,156518,257196,177232,49732,36,49696,3,2889,0,0.000825016,mm10,mBC-0814-1
"C12,D3",460627,521240,311123,210117,313000,0,194158,194400,156888,37512,4.182341651,114587,24050,14583,4050,3,4047,1,592,0,0,mm10,mBC-0814-1
"C12,D4",4616,4849,3285,1564,2873,0,1539,1548,1084,464,2.336206897,804,1052,693,256,1,255,1,65,0,0,empty,mBC-0814-1
"C12,D5",269911,313563,176247,137316,189493,0,119416,119556,98997,20559,4.815263388,73093,123686,86999,24949,12,24937,1,1773,0,0.000521314,mm10,mBC-0814-1
"C12,D6",5074,5340,3637,1703,3150,0,1679,1679,1162,517,2.247582205,881,838,575,183,0,183,0,55,0,0,empty,mBC-0814-1
"C12,D7",5566,6051,3939,2112,3472,0,1844,1846,1378,468,2.944444444,1001,1576,925,308,0,308,0,70,0,0.00974026,empty,mBC-0814-1
"C12,D8",4686,4935,3345,1590,2900,0,1570,1574,1121,453,2.474613687,838,1261,852,252,0,252,0,44,0,0,empty,mBC-0814-1
"C12,D9",3242,3532,2225,1307,2062,0,1139,1146,784,362,2.165745856,621,1370,876,252,0,252,0,44,0,0,empty,mBC-0814-1
"C12,D10",3846,4114,2727,1387,2425,7,1315,1326,972,354,2.745762712,696,786,618,163,0,163,0,41,0,0,empty,mBC-0814-1
"C12,D11",4451,4734,3096,1638,2814,0,1493,1496,1067,429,2.487179487,816,1494,1066,413,1,412,1,114,0,0,empty,mBC-0814-1
"C12,D12",6383,7122,4478,2644,4086,0,2245,2247,1629,618,2.63592233,1283,3425,2428,638,1,637,1,110,0,0.017268446,empty,mBC-0814-1
"C12,E1",4980,5234,3617,1617,3115,0,1625,1632,1180,452,2.610619469,839,1844,1268,390,0,390,0,77,0,0,empty,mBC-0814-1
"C12,E2",3573,3806,2491,1315,2282,0,1254,1258,898,360,2.494444444,672,3026,1364,401,0,401,0,77,0,0,empty,mBC-0814-1
"C12,E3",560546,609218,410267,198951,355638,2,190942,191207,154985,36222,4.278753244,103291,307718,225114,63560,43,63517,5,3113,0,0.000188926,mm10,mBC-0814-1
"C12,E4",1149611,1367119,745801,621318,797498,1,526737,527320,437461,89859,4.868304789,323262,530848,367354,106338,57,106281,9,4104,0,0.000752722,mm10,mBC-0814-1
"C12,E5",3927,4106,2798,1308,2403,0,1243,1244,920,324,2.839506173,649,1642,830,261,1,260,1,49,0,0.138461538,empty,mBC-0814-1
"C12,E6",4499,4735,3215,1520,2741,0,1478,1481,1059,422,2.509478673,762,1466,1101,298,0,298,0,70,0,0,empty,mBC-0814-1
"C12,E7",4580,4858,3307,1551,2802,0,1498,1500,1087,413,2.631961259,768,1008,639,211,0,211,0,54,0,0,empty,mBC-0814-1
"C12,E8",4840,5266,3548,1718,3023,0,1609,1611,1163,448,2.595982143,835,1640,1139,347,0,347,0,62,0,0,empty,mBC-0814-1
"C12,E9",344194,392679,227323,165356,232938,0,145602,145810,120019,25791,4.653522547,86837,124827,85346,23843,17,23826,3,1688,0,0.001133216,mm10,mBC-0814-1
"C12,E10",4118,4430,3022,1408,2643,0,1451,1455,1028,427,2.407494145,734,879,578,218,0,218,0,78,0,0.004587156,empty,mBC-0814-1
"C12,E11",4227,4651,2962,1689,2758,0,1511,1512,1050,462,2.272727273,820,1510,1105,308,0,308,0,60,0,0,empty,mBC-0814-1
"C12,E12",3904,4408,2747,1661,2593,0,1395,1401,993,408,2.433823529,805,1035,774,209,0,209,0,41,0,0,empty,mBC-0814-1
"C12,F1",4623,4827,3322,1505,2855,0,1515,1520,1074,446,2.408071749,774,1465,1098,346,0,346,0,66,0,0,empty,mBC-0814-1
"C12,F2",6585,7017,4683,2334,4137,0,2247,2253,1636,617,2.651539708,1189,883,578,221,1,220,1,75,0,0,empty,mBC-0814-1
"C12,F3",5095,5467,3724,1743,3178,0,1718,1722,1250,472,2.648305085,885,1784,1243,364,0,364,0,76,0,0,empty,mBC-0814-1
"C12,F4",5357,5718,3697,2021,3425,0,1881,1886,1298,588,2.207482993,1045,290,201,55,0,55,0,23,0,0,empty,mBC-0814-1
"C12,F5",5035,5375,3641,1734,3148,0,1695,1702,1264,438,2.885844749,899,1373,928,302,0,302,0,55,0,0.016556291,empty,mBC-0814-1
"C12,F6",4915,5433,3459,1974,3330,0,1861,1863,1391,472,2.947033898,1037,2718,1675,513,0,513,0,99,0,0.025341131,empty,mBC-0814-1
"C12,F7",4818,5211,3458,1753,3079,0,1701,1702,1198,504,2.376984127,894,554,426,105,0,105,0,26,0,0,empty,mBC-0814-1
"C12,F8",5984,6442,4199,2243,3765,0,2074,2075,1529,546,2.8003663,1155,84,39,14,0,14,0,9,0,0,empty,mBC-0814-1
"C12,F9",5612,5931,4089,1842,3433,0,1772,1774,1266,508,2.492125984,904,1292,803,290,1,289,1,70,0,0,empty,mBC-0814-1
"C12,F10",6813,7191,4829,2362,4200,0,2270,2277,1627,650,2.503076923,1212,867,627,191,0,191,0,58,0,0,empty,mBC-0814-1
"C12,F11",4299,4571,3064,1507,2680,0,1414,1418,1009,409,2.466992665,764,1156,812,265,0,265,0,57,0,0,empty,mBC-0814-1
"C12,F12",5185,5438,3643,1795,3230,0,1813,1815,1293,522,2.477011494,957,190,163,50,0,50,0,11,0,0,empty,mBC-0814-1
"C12,G1",7259,7744,5277,2467,4610,0,2456,2458,1818,640,2.840625,1279,2286,1650,506,0,506,0,112,0,0.011857708,empty,mBC-0814-1
"C12,G2",5680,6097,4028,2069,3577,0,1968,1971,1433,538,2.663568773,1043,1387,540,167,1,166,1,34,0,0,empty,mBC-0814-1
"C12,G3",5409,5984,3765,2219,3568,0,1998,2004,1389,615,2.258536585,1123,1930,1416,396,0,396,0,83,0,0,empty,mBC-0814-1
"C12,G4",531402,622215,348152,274063,367722,0,233803,234071,191471,42600,4.494624413,142039,1928,1430,422,0,422,0,52,0,0,empty,mBC-0814-1
"C12,G5",4559,4954,3310,1644,2916,0,1570,1574,1094,480,2.279166667,846,1481,999,288,1,287,1,60,0,0.066202091,empty,mBC-0814-1
"C12,G6",8899,9411,6419,2992,5478,0,2885,2886,2100,786,2.671755725,1516,92,72,40,0,40,0,17,0,0,empty,mBC-0814-1
"C12,G7",5437,5805,3929,1876,3465,0,1861,1863,1324,539,2.456400742,981,2160,1314,393,0,393,0,90,0,0.048346056,empty,mBC-0814-1
"C12,G8",7128,7740,5103,2637,4484,0,2519,2520,1815,705,2.574468085,1314,2442,1693,571,0,571,0,126,0,0,empty,mBC-0814-1
"C12,G9",5417,5607,3854,1753,3319,0,1798,1798,1322,476,2.777310924,902,8055,2847,952,3,949,2,143,0,0.105374078,empty,mBC-0814-1
"C12,G10",1768091,1986553,1173231,813322,1156255,7,743379,744242,497933,246309,2.021578586,439029,52754,35743,9622,8,9614,2,1061,0,0.000312045,mm10,mBC-0814-1
"C12,G11",9285,9858,6603,3255,5861,0,3123,3123,2238,885,2.528813559,1666,4348,1994,606,0,606,0,98,0,0.004950495,empty,mBC-0814-1
"C12,G12",488498,597416,307223,290193,360852,0,245389,245650,183940,61710,2.980716253,155775,207224,145192,41411,35,41376,8,2508,0,0.000290023,mm10,mBC-0814-1
"C12,H1",4739,5084,3391,1693,2974,0,1594,1600,1116,484,2.305785124,848,673,484,123,0,123,0,44,0,0.008130081,empty,mBC-0814-1
"C12,H2",8368,8827,5963,2864,5320,0,2866,2871,2080,791,2.629582807,1528,2745,1859,562,0,562,0,138,0,0.046263345,empty,mBC-0814-1
"C12,H3",8414,9861,5894,3967,5843,0,3541,3548,2216,1332,1.663663664,2069,5498,2399,720,0,720,0,111,0,0.004166667,empty,mBC-0814-1
"C12,H4",5670,6091,4057,2034,3627,0,1968,1972,1367,605,2.259504132,1083,55,36,21,0,21,0,10,0,0,empty,mBC-0814-1
"C12,H5",6847,7460,4867,2593,4199,0,2266,2271,1608,663,2.425339367,1231,2019,1478,404,0,404,0,63,0,0.02970297,empty,mBC-0814-1
"C12,H6",6394,6831,4435,2396,4054,0,2218,2218,1598,620,2.577419355,1252,2260,1628,486,1,485,1,90,0,0,empty,mBC-0814-1
"C12,H7",88259,95937,52390,43547,57832,0,38670,38699,22093,16606,1.330422739,23969,14563,5276,1568,2,1566,1,203,0,0.03256705,empty,mBC-0814-1
"C12,H8",9984,11106,6847,4259,6662,0,3920,3924,3092,832,3.716346154,2246,1616,1072,348,0,348,0,78,0,0.002873563,empty,mBC-0814-1
"C12,H9",4730,5162,3313,1849,3027,6,1607,1617,1220,397,3.073047859,888,1109,828,218,0,218,0,50,0,0.064220183,empty,mBC-0814-1
"C12,H10",4251,4756,2956,1800,2721,0,1568,1574,1116,458,2.436681223,872,5784,1776,546,1,545,1,75,0,0.152293578,empty,mBC-0814-1
"C12,H11",4032,4461,2773,1688,2633,0,1486,1490,1033,457,2.260393873,834,28,21,8,0,8,0,3,0,0,empty,mBC-0814-1
"C12,H12",2848,3174,1903,1271,1898,0,1117,1121,815,306,2.663398693,650,779,524,158,0,158,0,45,0,0,empty,mBC-0814-1
"D1,A1",6180,6711,4332,2379,4056,0,2198,2202,1585,617,2.568881686,1233,2229,1417,423,0,423,0,72,0,0,empty,mBC-0814-1
"D1,A2",6480,6903,4571,2332,4103,0,2265,2267,1697,570,2.977192982,1230,2332,1488,459,1,458,1,116,0,0.034934498,empty,mBC-0814-1
"D1,A3",5315,5794,3714,2080,3376,0,1866,1869,1317,552,2.385869565,1013,1986,1418,408,1,407,1,88,0,0.007371007,empty,mBC-0814-1
"D1,A4",6247,6821,4540,2281,3926,0,2148,2150,1528,622,2.45659164,1152,531,403,109,0,109,0,29,0,0.091743119,empty,mBC-0814-1
"D1,A5",5443,5911,3904,2007,3455,0,1917,1920,1310,610,2.147540984,1035,1680,1161,364,0,364,0,69,0,0,empty,mBC-0814-1
"D1,A6",4376,4544,2997,1547,2674,0,1473,1476,1056,420,2.514285714,796,36918,12034,3763,4,3759,1,301,0,0.230912477,empty,mBC-0814-1
"D1,A7",433951,518256,281034,237222,309244,1,205310,205505,153780,51725,2.973030449,126856,46197,27227,7253,5,7248,1,881,0,0,mm10,mBC-0814-1
"D1,A8",2882,3263,2060,1203,1918,0,1075,1077,772,305,2.531147541,601,2554,1723,518,0,518,0,92,0,0,empty,mBC-0814-1
"D1,A9",6971,7378,4981,2397,4319,0,2287,2288,1633,655,2.493129771,1227,2265,1454,417,0,417,0,81,0,0.009592326,empty,mBC-0814-1
"D1,A10",388992,447603,254656,192947,264725,1,167836,168030,138579,29451,4.705408984,100935,32770,20013,5733,4,5729,2,581,0,0.001920056,mm10,mBC-0814-1
"D1,A11",5258,5644,3678,1966,3302,0,1833,1834,1327,507,2.617357002,957,16351,5236,1553,4,1549,1,221,0,0.0058102,empty,mBC-0814-1
"D1,A12",4907,5485,3425,2060,3326,0,1879,1880,1408,472,2.983050847,1067,3915,2887,879,0,879,0,217,0,0,empty,mBC-0814-1
"D1,B1",5565,5813,4015,1798,3488,0,1863,1864,1355,509,2.662082515,992,2095,1372,455,1,454,1,95,0,0,empty,mBC-0814-1
"D1,B2",5328,5580,3733,1847,3301,0,1804,1806,1254,552,2.27173913,956,359,228,82,0,82,0,30,0,0,empty,mBC-0814-1
"D1,B3",5469,6077,3773,2304,3660,0,2090,2092,1523,569,2.676625659,1191,1318,847,306,0,306,0,69,0,0.003267974,empty,mBC-0814-1
"D1,B4",342474,384619,231872,152747,231645,1,141047,141197,114664,26533,4.321561829,83130,14220,10006,2666,1,2665,1,403,0,0.002626642,mm10,mBC-0814-1
"D1,B5",5983,5003,2970,2033,3332,0,2010,2018,1498,520,2.880769231,1162,1144,872,258,0,258,0,63,0,0.003875969,empty,mBC-0814-1
"D1,B6",438699,506556,286530,220026,298348,0,189217,189422,149019,40403,3.688315224,114517,191741,140425,40359,23,40336,2,2256,0,0.00042146,mm10,mBC-0814-1
"D1,B7",5617,6064,3996,2068,3616,0,1959,1964,1344,620,2.167741935,1011,1236,878,263,0,263,0,61,0,0,empty,mBC-0814-1
"D1,B8",4410,4657,3191,1466,2775,0,1489,1495,1061,434,2.444700461,760,1778,1244,360,0,360,0,72,0,0,empty,mBC-0814-1
"D1,B9",1505618,1781411,990430,790981,1034471,2,679123,679792,536097,143695,3.73079787,414374,288812,207626,57401,25,57376,4,3084,0,0.001028305,mm10,mBC-0814-1
"D1,B10",275991,305123,178830,126293,187499,0,112892,113092,85493,27599,3.097684699,67115,51813,34739,9698,7,9691,1,902,0,0.000825508,mm10,mBC-0814-1
"D1,B11",446369,517322,293837,223485,302191,4,190426,190624,162111,28513,5.685511872,114747,5282,3591,1090,1,1089,1,164,0,0.01010101,mm10,mBC-0814-1
"D1,B12",5884,6311,4190,2121,3646,0,1978,1983,1440,543,2.651933702,1035,1149,773,216,0,216,0,61,0,0,empty,mBC-0814-1
"D1,C1",6327,6647,4646,2001,3903,0,2026,2027,1443,584,2.470890411,1014,1310,884,274,0,274,0,58,0,0.054744526,empty,mBC-0814-1
"D1,C2",5925,6272,4192,2080,3836,0,2120,2126,1541,585,2.634188034,1120,1911,1333,379,0,379,0,84,0,0,empty,mBC-0814-1
"D1,C3",6321,6970,4544,2426,4008,0,2103,2112,1510,602,2.508305648,1146,823,627,159,0,159,0,49,0,0,empty,mBC-0814-1
"D1,C4",6365,6735,4446,2289,3964,0,2162,2168,1561,607,2.571663921,1139,2528,1697,471,0,471,0,105,0,0.012738854,empty,mBC-0814-1
"D1,C5",7994,8635,5729,2906,5116,0,2766,2770,2051,719,2.852573018,1487,1729,1140,396,0,396,0,102,0,0,empty,mBC-0814-1
"D1,C6",6250,6757,4415,2342,3974,0,2162,2164,1555,609,2.553366174,1171,10270,3244,1031,3,1028,1,138,0,0.017509728,empty,mBC-0814-1
"D1,C7",7995,8726,5722,3004,4974,0,2727,2734,1985,749,2.650200267,1421,2177,886,291,0,291,0,43,0,0.030927835,empty,mBC-0814-1
"D1,C8",5986,6655,4229,2426,3882,2,2140,2145,1544,601,2.569051581,1160,2594,1721,532,2,530,1,118,0,0,empty,mBC-0814-1
"D1,C9",4989,5307,3592,1715,3195,0,1758,1759,1288,471,2.734607219,943,1465,1066,333,0,333,0,64,0,0,empty,mBC-0814-1
"D1,C10",845947,965671,569638,396033,554601,4,345873,346324,284911,61413,4.639262045,202888,175131,108704,30339,22,30317,6,2092,0,0.00874097,mm10,mBC-0814-1
"D1,C11",5157,5491,3716,1775,3292,0,1791,1791,1285,506,2.539525692,925,1872,1323,406,0,406,0,85,0,0,empty,mBC-0814-1
"D1,C12",9075,9819,6420,3399,5672,0,3033,3037,2227,810,2.749382716,1668,2457,1673,553,0,553,0,116,0,0.036166365,empty,mBC-0814-1
"D1,D1",5059,5442,3591,1851,3183,0,1744,1744,1258,486,2.588477366,900,860,589,186,0,186,0,58,0,0.005376344,empty,mBC-0814-1
"D1,D2",5683,6008,4256,1752,3456,0,1723,1726,1218,508,2.397637795,893,2018,1332,391,0,391,0,99,0,0,empty,mBC-0814-1
"D1,D3",11641,12650,8288,4362,7523,0,4182,4190,2972,1218,2.440065681,2271,3183,2117,562,0,562,0,105,0,0.001779359,empty,mBC-0814-1
"D1,D4",450640,526990,297415,229575,312351,1,199009,199215,160693,38522,4.171460464,120169,185887,133319,36124,18,36106,2,2236,0,0.00168947,mm10,mBC-0814-1
"D1,D5",221641,252852,143891,108961,151148,0,93652,93748,81178,12570,6.458074781,56510,210682,149691,41680,31,41649,5,2471,0,0.000192081,mm10,mBC-0814-1
"D1,D6",5624,6098,4007,2091,3538,7,1902,1911,1393,518,2.689189189,1063,1459,936,271,0,271,0,65,0,0.022140221,empty,mBC-0814-1
"D1,D7",6507,6993,4617,2376,4121,0,2238,2242,1592,650,2.449230769,1206,2403,1610,486,0,486,0,91,0,0.008230453,empty,mBC-0814-1
"D1,D8",5695,6098,3984,2114,3496,0,1905,1907,1416,491,2.883910387,1013,16930,5495,1683,2,1681,2,170,0,0.108863772,empty,mBC-0814-1
"D1,D9",3459,3859,2436,1423,2242,0,1290,1292,971,321,3.024922118,696,3414,1852,542,0,542,0,88,0,0.062730627,empty,mBC-0814-1
"D1,D10",4395,4701,3245,1456,2762,0,1483,1486,1113,373,2.983914209,746,969,715,241,0,241,0,61,0,0.004149378,empty,mBC-0814-1
"D1,D11",4619,5117,3272,1845,3035,0,1638,1641,1192,449,2.654788419,923,3091,2288,658,0,658,0,138,0,0,empty,mBC-0814-1
"D1,D12",7134,7604,5128,2476,4616,0,2528,2532,1754,778,2.254498715,1394,4048,2825,790,0,790,0,132,0,0.007594937,empty,mBC-0814-1
"D1,E1",5654,6021,3977,2044,3562,0,1914,1920,1337,583,2.293310463,1028,2023,1354,412,0,412,0,99,0,0,empty,mBC-0814-1
"D1,E2",4184,4485,2982,1503,2599,0,1408,1412,1010,402,2.512437811,737,1647,1214,317,0,317,0,62,0,0,empty,mBC-0814-1
"D1,E3",4038,4253,2887,1366,2517,9,1351,1360,974,386,2.523316062,706,2427,1668,504,0,504,0,81,0,0,empty,mBC-0814-1
"D1,E4",3592,3912,2567,1345,2289,0,1234,1236,916,320,2.8625,658,1402,860,270,0,270,0,61,0,0,empty,mBC-0814-1
"D1,E5",4364,4483,3236,1247,2587,0,1260,1261,918,343,2.67638484,611,1374,963,302,0,302,0,54,0,0,empty,mBC-0814-1
"D1,E6",5185,5725,3754,1971,3249,1,1706,1711,1229,482,2.549792531,931,1621,1043,331,0,331,0,78,0,0,empty,mBC-0814-1
"D1,E7",4846,5243,3532,1711,3086,0,1656,1661,1229,432,2.844907407,844,1744,1221,342,0,342,0,73,0,0,empty,mBC-0814-1
"D1,E8",4975,5284,3654,1630,3074,0,1556,1556,1127,429,2.627039627,782,14359,4587,1414,3,1411,3,161,0,0.001417434,empty,mBC-0814-1
"D1,E9",3692,3951,2650,1301,2345,0,1268,1268,958,310,3.090322581,662,2142,1448,465,0,465,0,83,0,0,empty,mBC-0814-1
"D1,E10",4852,5483,3448,2035,3108,0,1710,1712,1254,458,2.737991266,955,2554,1631,467,0,467,0,102,0,0.023554604,empty,mBC-0814-1
"D1,E11",4725,5137,3430,1707,3045,0,1613,1613,1162,451,2.576496674,857,1626,1182,385,0,385,0,92,0,0,empty,mBC-0814-1
"D1,E12",4536,4907,3173,1734,2870,0,1580,1582,1195,387,3.087855297,862,1043,694,222,0,222,0,50,0,0,empty,mBC-0814-1
"D1,F1",5204,5446,3762,1684,3304,0,1753,1757,1225,532,2.302631579,946,2601,1842,525,0,525,0,79,0,0.00952381,empty,mBC-0814-1
"D1,F2",7468,8241,5361,2880,4813,0,2598,2602,1868,734,2.544959128,1420,2439,1693,520,0,520,0,124,0,0.076923077,empty,mBC-0814-1
"D1,F3",628164,701732,423858,277874,411749,0,254337,254597,186441,68156,2.735503844,148623,57368,41727,11948,8,11940,1,1128,0,0.000167504,mm10,mBC-0814-1
"D1,F4",6006,6385,4312,2073,3770,0,2111,2114,1547,567,2.728395062,1084,497,352,152,0,152,0,36,0,0,empty,mBC-0814-1
"D1,F5",5781,6137,4221,1916,3573,0,1910,1916,1352,564,2.397163121,1007,1414,960,278,1,277,1,73,0,0,empty,mBC-0814-1
"D1,F6",6322,6962,4401,2561,4062,0,2272,2276,1625,651,2.496159754,1277,20614,6830,2080,4,2076,1,281,0,0.012042389,empty,mBC-0814-1
"D1,F7",16286,18879,11510,7369,10986,0,6375,6386,5014,1372,3.65451895,3651,3796,2586,710,0,710,0,120,0,0,empty,mBC-0814-1
"D1,F8",6879,7468,4902,2566,4330,0,2381,2381,1695,686,2.470845481,1275,289,224,61,0,61,0,15,0,0,empty,mBC-0814-1
"D1,F9",6311,6926,4522,2404,4085,1,2243,2254,1564,690,2.266666667,1218,2709,1851,607,1,606,1,113,0,0,empty,mBC-0814-1
"D1,F10",7202,7581,5176,2405,4459,0,2316,2317,1702,615,2.767479675,1212,2309,1557,481,0,481,0,102,0,0,empty,mBC-0814-1
"D1,F11",4856,5222,3458,1764,3090,0,1724,1727,1239,488,2.538934426,911,2288,1691,429,0,429,0,88,0,0.034965035,empty,mBC-0814-1
"D1,F12",580556,650655,397819,252836,376622,2,224221,224512,179910,44602,4.03367562,129397,11501,8098,2090,4,2086,1,299,0,0,mm10,mBC-0814-1
"D1,G1",608401,691779,409644,282135,406425,0,249568,249869,198486,51383,3.862872935,146262,186644,133453,37043,25,37018,3,2383,0,0.000675347,mm10,mBC-0814-1
"D1,G2",6216,6572,4370,2202,3894,0,2101,2104,1486,618,2.404530744,1138,440,295,102,0,102,0,20,0,0,empty,mBC-0814-1
"D1,G3",5829,6554,4110,2444,3741,3,2142,2145,1488,657,2.264840183,1176,2396,1600,479,0,479,0,130,0,0,empty,mBC-0814-1
"D1,G4",5694,5992,4155,1837,3489,0,1857,1860,1360,500,2.72,975,0,0,0,0,0,0,0,0,0,empty,mBC-0814-1
"D1,G5",5572,6051,3972,2079,3544,0,1970,1982,1419,563,2.520426288,1087,1996,1350,417,1,416,1,84,0,0,empty,mBC-0814-1
"D1,G6",9630,10250,6835,3415,5945,0,3162,3168,2324,844,2.753554502,1694,138,100,44,0,44,0,19,0,0,empty,mBC-0814-1
"D1,G7",519506,587955,348029,239926,348197,2,212565,212809,166600,46209,3.605358264,124611,360666,254950,71541,39,71502,4,3262,0,0.000587396,mm10,mBC-0814-1
"D1,G8",8065,8494,5586,2908,5063,0,2856,2860,1997,863,2.314020857,1560,4127,2794,803,1,802,1,165,0,0.00872818,empty,mBC-0814-1
"D1,G9",451948,524239,299044,225195,308370,0,191702,191924,148274,43650,3.396884307,114901,349396,248668,67634,36,67598,3,3289,0,0.000517767,mm10,mBC-0814-1
"D1,G10",1203223,1358785,802356,556429,793591,2,502968,503495,374487,129008,2.90281998,295635,372664,266252,72929,49,72880,4,3549,0,0.001577936,mm10,mBC-0814-1
"D1,G11",10486,11121,7606,3515,6584,0,3495,3506,2523,983,2.566632757,1774,1694,1131,385,0,385,0,80,0,0.002597403,empty,mBC-0814-1
"D1,G12",5261,5634,3718,1916,3409,0,1858,1865,1375,490,2.806122449,1026,9965,3569,1067,1,1066,1,150,0,0.001876173,empty,mBC-0814-1
"D1,H1",5642,5984,4036,1948,3468,0,1913,1918,1371,547,2.506398537,1007,1400,1018,276,0,276,0,62,0,0,empty,mBC-0814-1
"D1,H2",597062,713662,386536,327126,419700,0,278602,278913,205462,73451,2.797266205,172847,237323,170834,47090,28,47062,3,2658,0,0.000488717,mm10,mBC-0814-1
"D1,H3",490034,552866,325875,226991,323622,2,199564,199830,160690,39140,4.105518651,117879,212550,154358,41807,25,41782,1,2549,0,0.000359006,mm10,mBC-0814-1
"D1,H4",6322,6783,4492,2291,4085,0,2252,2256,1613,643,2.508553655,1243,189,85,29,0,29,0,12,0,0,empty,mBC-0814-1
"D1,H5",7691,8293,5507,2786,4695,0,2553,2557,1795,762,2.355643045,1365,2635,1881,572,1,571,1,95,0,0.028021016,empty,mBC-0814-1
"D1,H6",6959,7443,4957,2486,4422,0,2420,2421,1740,681,2.555066079,1289,2864,2067,603,0,603,0,136,0,0.001658375,empty,mBC-0814-1
"D1,H7",5861,6342,4150,2192,3771,0,2062,2065,1466,599,2.447412354,1156,2277,1779,503,0,503,0,88,0,0.027833002,empty,mBC-0814-1
"D1,H8",5135,5375,3634,1741,3253,0,1746,1746,1250,496,2.52016129,967,4252,2154,652,0,652,0,155,0,0.015337423,empty,mBC-0814-1
"D1,H9",5822,6466,4109,2357,3815,0,2099,2104,1511,593,2.548060708,1188,5828,2322,676,1,675,1,94,0,0,empty,mBC-0814-1
"D1,H10",3988,4244,2823,1421,2498,1,1380,1384,977,407,2.4004914,751,1091,797,222,0,222,0,55,0,0.004504505,empty,mBC-0814-1
"D1,H11",4406,4943,2998,1945,2966,0,1767,1768,1245,523,2.380497132,1022,63,50,20,0,20,0,13,0,0.05,empty,mBC-0814-1
"D1,H12",3082,3397,2184,1213,2016,0,1155,1157,828,329,2.516717325,639,1724,1036,301,0,301,0,78,0,0.059800664,empty,mBC-0814-1
"D2,A1",5740,6294,4083,2211,3743,0,2042,2044,1434,610,2.350819672,1144,1771,1253,411,0,411,0,90,0,0.00243309,empty,mBC-0814-1
"D2,A2",4923,5215,3507,1708,3149,0,1715,1717,1215,502,2.420318725,890,1836,1262,392,1,391,1,100,0,0,empty,mBC-0814-1
"D2,A3",4883,5260,3525,1735,2988,0,1612,1612,1127,485,2.32371134,819,871,650,164,0,164,0,41,0,0,empty,mBC-0814-1
"D2,A4",5701,5991,4129,1862,3494,0,1822,1824,1293,531,2.435028249,951,688,433,123,0,123,0,28,0,0,empty,mBC-0814-1
"D2,A5",4967,5540,3473,2067,3212,0,1814,1818,1307,511,2.557729941,1006,1874,1212,365,0,365,0,78,0,0,empty,mBC-0814-1
"D2,A6",4080,4168,2980,1188,2421,0,1197,1199,829,370,2.240540541,574,1463,1045,314,0,314,0,65,0,0.015923567,empty,mBC-0814-1
"D2,A7",5427,5896,3797,2099,3487,0,1915,1916,1356,560,2.421428571,1022,2370,1738,481,1,480,1,88,0,0,empty,mBC-0814-1
"D2,A8",2377,2557,1685,872,1538,0,869,872,621,251,2.474103586,454,2635,1395,401,1,400,1,81,0,0,empty,mBC-0814-1
"D2,A9",591329,677543,397071,280472,394688,0,243708,243990,193209,50781,3.804749808,143644,247162,153497,41768,38,41730,5,2478,0,0.000239636,mm10,mBC-0814-1
"D2,A10",3483,3908,2440,1468,2243,0,1230,1230,877,353,2.484419263,685,237,171,41,0,41,0,16,0,0,empty,mBC-0814-1
"D2,A11",5159,5285,3705,1580,3227,3,1672,1675,1165,510,2.284313725,840,3765,2664,756,0,756,0,133,0,0.003968254,empty,mBC-0814-1
"D2,A12",3883,4212,2824,1388,2485,0,1372,1372,1015,357,2.843137255,744,2924,2105,597,0,597,0,166,0,0,empty,mBC-0814-1
"D2,B1",354840,409423,235350,174073,242013,2,151237,151374,128762,22612,5.694410048,90586,141230,102430,28672,13,28659,3,1889,0,0.000488503,mm10,mBC-0814-1
"D2,B2",5318,5751,3679,2072,3269,0,1781,1786,1219,567,2.149911817,975,458,316,81,0,81,0,17,0,0,empty,mBC-0814-1
"D2,B3",3945,4374,2797,1577,2550,0,1419,1421,1050,371,2.830188679,776,1072,767,232,0,232,0,55,0,0.107758621,empty,mBC-0814-1
"D2,B4",4301,4510,3059,1451,2657,0,1460,1463,1008,455,2.215384615,759,1608,1133,345,0,345,0,78,0,0,empty,mBC-0814-1
"D2,B5",3626,2292,1486,806,1654,0,909,911,664,247,2.688259109,513,1036,524,181,0,181,0,49,0,0.044198895,empty,mBC-0814-1
"D2,B6",269210,325309,174693,150616,194132,0,127928,128057,98777,29280,3.373531421,79809,115124,82494,22936,15,22921,2,1702,0,0.000959819,mm10,mBC-0814-1
"D2,B7",638974,708289,427740,280549,418342,0,259506,259831,215820,44011,4.903774056,151163,13624,9586,2442,2,2440,1,392,0,0.002868852,mm10,mBC-0814-1
"D2,B8",3862,3974,2779,1195,2346,1,1209,1213,822,391,2.10230179,605,1588,1018,298,0,298,0,64,0,0,empty,mBC-0814-1
"D2,B9",881588,1025255,580344,444911,598233,1,384010,384474,290662,93812,3.098345627,232022,106068,74565,20794,8,20786,2,1679,0,0.000432984,mm10,mBC-0814-1
"D2,B10",4319,4367,3074,1293,2619,0,1395,1397,991,406,2.4408867,666,664,430,107,0,107,0,28,0,0,empty,mBC-0814-1
"D2,B11",6531,7204,4611,2593,4160,1,2258,2265,1605,660,2.431818182,1267,220,144,50,0,50,0,13,0,0,empty,mBC-0814-1
"D2,B12",5738,6301,4111,2190,3727,0,2037,2042,1475,567,2.601410935,1139,1333,752,229,0,229,0,51,0,0,empty,mBC-0814-1
"D2,C1",5834,6216,4238,1978,3570,0,1888,1893,1341,552,2.429347826,947,1128,730,239,0,239,0,44,0,0,empty,mBC-0814-1
"D2,C2",5558,5855,4004,1851,3347,0,1775,1780,1277,503,2.538767396,915,1308,772,285,0,285,0,76,0,0,empty,mBC-0814-1
"D2,C3",673727,790168,448095,342073,458246,0,291311,291660,245092,46568,5.263099124,175135,79626,57014,15634,7,15627,1,1319,0,0.000255967,mm10,mBC-0814-1
"D2,C4",4951,5378,3535,1843,3186,0,1731,1731,1239,492,2.518292683,936,1511,1103,321,0,321,0,82,0,0.003115265,empty,mBC-0814-1
"D2,C5",7184,7816,5118,2698,4603,0,2604,2604,1850,754,2.453580902,1381,1283,838,262,0,262,0,84,0,0,empty,mBC-0814-1
"D2,C6",5894,6198,4212,1986,3820,0,2066,2074,1483,591,2.509306261,1076,1956,1430,418,1,417,1,79,0,0.03117506,empty,mBC-0814-1
"D2,C7",558355,618422,384148,234274,360352,1,212871,213124,173371,39753,4.361205444,121986,12125,8481,2385,2,2383,1,305,0,0,mm10,mBC-0814-1
"D2,C8",526880,605139,348452,256687,355680,0,224857,225094,147686,77408,1.907890657,134354,152162,111001,30544,12,30532,2,1982,0,0.000622298,mm10,mBC-0814-1
"D2,C9",4453,4865,3193,1672,2823,0,1517,1521,1044,477,2.188679245,828,1280,867,246,0,246,0,62,0,0,empty,mBC-0814-1
"D2,C10",6090,6552,4446,2106,3719,1,1989,1991,1453,538,2.700743494,1027,1297,869,268,0,268,0,47,0,0,empty,mBC-0814-1
"D2,C11",4736,5152,3367,1785,3067,0,1665,1669,1203,466,2.581545064,905,1005,656,284,0,284,0,74,0,0,empty,mBC-0814-1
"D2,C12",8610,9162,6115,3047,5310,0,2895,2898,2041,857,2.381563594,1564,2398,1858,432,0,432,0,87,0,0.018518519,empty,mBC-0814-1
"D2,D1",4431,4707,3115,1592,2799,0,1506,1509,1085,424,2.558962264,841,838,588,157,0,157,0,36,0,0.01910828,empty,mBC-0814-1
"D2,D2",5707,6216,4152,2064,3557,0,1872,1875,1316,559,2.354203936,1025,2429,1749,538,1,537,1,101,0,0.001862197,empty,mBC-0814-1
"D2,D3",10676,11460,7561,3899,6789,0,3671,3676,2614,1062,2.461393597,1984,2626,1859,559,1,558,1,112,0,0.007168459,empty,mBC-0814-1
"D2,D4",4936,5236,3556,1680,3125,0,1715,1720,1205,515,2.339805825,873,2160,1407,388,0,388,0,82,0,0.051546392,empty,mBC-0814-1
"D2,D5",4162,4379,2946,1433,2607,0,1410,1413,1024,389,2.632390746,752,9251,3046,999,1,998,1,157,0,0.113226453,empty,mBC-0814-1
"D2,D6",5224,5515,3839,1676,3192,0,1658,1660,1189,471,2.524416136,842,1465,1042,333,0,333,0,66,0,0,empty,mBC-0814-1
"D2,D7",5824,6137,4151,1986,3537,0,1878,1881,1303,578,2.25432526,993,2826,1953,589,0,589,0,109,0,0,empty,mBC-0814-1
"D2,D8",4808,5108,3448,1660,3002,0,1598,1603,1164,439,2.651480638,857,1271,884,234,0,234,0,52,0,0,empty,mBC-0814-1
"D2,D9",114831,132788,73475,59313,80204,0,51421,51475,42750,8725,4.899713467,31630,160298,113773,31641,17,31624,2,2066,0,0.000917025,mm10,mBC-0814-1
"D2,D10",5469,5936,3974,1962,3498,0,1882,1887,1370,517,2.649903288,998,932,681,223,1,222,1,51,0,0,empty,mBC-0814-1
"D2,D11",4088,4364,2890,1474,2564,0,1361,1363,1002,361,2.775623269,737,2308,1708,569,0,569,0,113,0,0,empty,mBC-0814-1
"D2,D12",497233,595747,318000,277747,351970,0,235554,235818,168718,67100,2.51442623,147420,116942,81452,22223,19,22204,2,1715,0,0.002657179,mm10,mBC-0814-1
"D2,E1",5104,5378,3687,1691,3081,0,1617,1618,1110,508,2.18503937,835,1804,1177,312,0,312,0,71,0,0,empty,mBC-0814-1
"D2,E2",3839,3924,2797,1127,2300,0,1173,1175,828,347,2.386167147,560,1408,896,268,1,267,1,65,0,0,empty,mBC-0814-1
"D2,E3",3633,3842,2679,1163,2228,0,1111,1114,790,324,2.438271605,574,2024,1535,432,0,432,0,87,0,0,empty,mBC-0814-1
"D2,E4",3198,3277,2336,941,1934,0,980,984,733,251,2.920318725,494,1029,689,246,0,246,0,54,0,0.089430894,empty,mBC-0814-1
"D2,E5",664641,738382,454100,284282,431883,1,261735,262061,213804,48257,4.430528214,149926,45314,30340,8496,4,8492,1,835,0,0.008007537,mm10,mBC-0814-1
"D2,E6",4766,5025,3367,1658,2863,0,1541,1544,1101,443,2.485327314,800,1914,1369,407,0,407,0,73,0,0,empty,mBC-0814-1
"D2,E7",4519,4872,3296,1576,2753,0,1458,1458,1044,414,2.52173913,758,1381,944,288,0,288,0,62,0,0,empty,mBC-0814-1
"D2,E8",4736,5112,3427,1685,2942,0,1556,1558,1108,450,2.462222222,821,2577,1793,458,1,457,1,83,0,0.002188184,empty,mBC-0814-1
"D2,E9",363397,417422,238330,179092,244859,2,151936,152107,123936,28171,4.399417841,91153,395317,283913,78976,49,78927,4,3437,0,0.000760196,mm10,mBC-0814-1
"D2,E10",4172,4369,2975,1394,2503,0,1385,1388,1003,385,2.605194805,731,2132,1538,473,0,473,0,97,0,0.002114165,empty,mBC-0814-1
"D2,E11",4200,4528,2905,1623,2677,0,1438,1438,1060,378,2.804232804,767,1328,928,232,0,232,0,59,0,0,empty,mBC-0814-1
"D2,E12",4169,4568,2976,1592,2695,0,1500,1500,1094,406,2.694581281,805,1079,797,254,0,254,0,61,0,0.015748031,empty,mBC-0814-1
"D2,F1",4680,4975,3382,1593,2925,0,1558,1558,1089,469,2.32196162,813,1440,1020,300,0,300,0,72,0,0.006666667,empty,mBC-0814-1
"D2,F2",7499,8152,5336,2816,4783,0,2612,2615,1958,657,2.98021309,1422,2639,1798,538,0,538,0,120,0,0.027881041,empty,mBC-0814-1
"D2,F3",5103,5492,3663,1829,3167,0,1720,1722,1191,531,2.242937853,902,1357,918,263,0,263,0,75,0,0.007604563,empty,mBC-0814-1
"D2,F4",5757,6039,4082,1957,3568,0,1896,1900,1345,555,2.423423423,986,946,594,167,0,167,0,38,0,0,empty,mBC-0814-1
"D2,F5",573900,662242,384644,277598,388026,1,243752,244023,197644,46379,4.261497661,144888,183005,123484,34387,16,34371,3,2228,0,0.001512903,mm10,mBC-0814-1
"D2,F6",4988,5484,3462,2022,3202,0,1810,1814,1274,540,2.359259259,1009,2331,1649,435,0,435,0,97,0,0,empty,mBC-0814-1
"D2,F7",4916,5447,3578,1869,3143,0,1682,1685,1209,476,2.539915966,901,682,466,164,1,163,1,43,0,0.030674847,empty,mBC-0814-1
"D2,F8",214246,246783,137669,109114,144493,0,92406,92513,59768,32745,1.825255764,56105,9560,6760,1831,2,1829,1,226,0,0,mm10,mBC-0814-1
"D2,F9",5849,6309,4198,2111,3673,0,1999,2009,1434,575,2.493913043,1052,6592,2776,946,2,944,1,143,0,0.039194915,empty,mBC-0814-1
"D2,F10",7255,7635,5272,2363,4373,0,2285,2292,1579,713,2.214586255,1160,1819,1255,307,0,307,0,68,0,0,empty,mBC-0814-1
"D2,F11",4495,4456,3193,1263,2688,0,1401,1404,1033,371,2.784366577,703,1811,1344,411,1,410,1,75,0,0,empty,mBC-0814-1
"D2,F12",4911,5391,3467,1924,3124,0,1710,1711,1258,453,2.777041943,909,206,111,29,0,29,0,8,0,0,empty,mBC-0814-1
"D2,G1",7249,7965,5233,2732,4765,0,2558,2561,1819,742,2.45148248,1411,6646,3296,1054,0,1054,0,179,0,0.013282732,empty,mBC-0814-1
"D2,G2",5779,6023,4090,1933,3529,0,1849,1850,1276,574,2.222996516,989,703,419,91,0,91,0,21,0,0,empty,mBC-0814-1
"D2,G3",6683,7262,4625,2637,4149,0,2347,2348,1711,637,2.686028257,1287,3160,2322,697,3,694,1,137,0,0.002881844,empty,mBC-0814-1
"D2,G4",5781,6262,4220,2042,3607,1,1941,1949,1393,556,2.505395683,1029,6,1,1,0,1,0,1,0,0,empty,mBC-0814-1
"D2,G5",479796,549604,325881,223723,322743,0,198402,198609,158007,40602,3.891606325,117205,69980,50528,14250,13,14237,5,1185,0,0.001264311,mm10,mBC-0814-1
"D2,G6",544878,619872,368485,251387,365919,0,228556,228814,175317,53497,3.277137036,135423,2059,1545,433,0,433,0,65,0,0,empty,mBC-0814-1
"D2,G7",6640,6931,4647,2284,4072,0,2164,2165,1487,678,2.193215339,1144,9150,4071,1172,0,1172,0,179,0,0.017918089,empty,mBC-0814-1
"D2,G8",652477,763718,428207,335511,450836,0,288508,288780,225378,63402,3.554745907,175472,330633,236293,65669,39,65630,2,3287,0,0.000457108,mm10,mBC-0814-1
"D2,G9",5185,5671,3669,2002,3322,0,1832,1840,1263,577,2.188908146,1024,3329,2281,712,0,712,0,145,0,0,empty,mBC-0814-1
"D2,G10",9313,9899,6759,3140,5775,0,3053,3061,2146,915,2.345355191,1592,4483,2965,931,0,931,0,198,0,0.009667025,empty,mBC-0814-1
"D2,G11",9505,9862,6871,2991,5721,0,3052,3056,2194,862,2.545243619,1542,10924,4075,1158,2,1156,1,138,0,0.044117647,empty,mBC-0814-1
"D2,G12",4677,4999,3322,1677,2954,0,1641,1641,1150,491,2.342158859,874,2678,1891,583,1,582,1,109,0,0.036082474,empty,mBC-0814-1
"D2,H1",865184,984975,600973,384002,580056,0,355283,355671,252876,102795,2.460002918,208208,38628,17596,4872,15,4857,4,496,0,0.084826024,mm10,mBC-0814-1
"D2,H2",8257,9100,5979,3121,5278,0,2841,2844,1947,897,2.170568562,1513,4358,2957,859,1,858,1,180,0,0.017482517,empty,mBC-0814-1
"D2,H3",5328,5799,3812,1987,3453,4,1937,1941,1435,506,2.835968379,1077,1742,1285,419,1,418,1,90,0,0.038277512,empty,mBC-0814-1
"D2,H4",5429,5750,3901,1849,3378,0,1772,1776,1305,471,2.770700637,945,221,121,35,0,35,0,13,0,0,empty,mBC-0814-1
"D2,H5",762405,899734,500560,399174,516386,0,331017,331427,268656,62771,4.279938188,201351,279912,201787,56026,37,55989,2,2854,0,0.001000196,mm10,mBC-0814-1
"D2,H6",6485,7038,4640,2398,4049,0,2211,2211,1569,642,2.443925234,1193,2831,1990,582,0,582,0,133,0,0.049828179,empty,mBC-0814-1
"D2,H7",5306,5656,3859,1797,3379,0,1828,1833,1304,529,2.465028355,975,1742,1253,344,0,344,0,59,0,0,empty,mBC-0814-1
"D2,H8",10654,12212,7175,5037,7262,0,4247,4253,3288,965,3.407253886,2525,2272,1598,475,0,475,0,104,0,0.107368421,empty,mBC-0814-1
"D2,H9",4786,4984,3354,1630,2916,0,1557,1559,1119,440,2.543181818,810,9078,3336,923,1,922,1,109,0,0.026030369,empty,mBC-0814-1
"D2,H10",3628,3973,2593,1380,2264,0,1261,1261,874,387,2.258397933,663,1331,1013,318,0,318,0,66,0,0,empty,mBC-0814-1
"D2,H11",3845,4333,2706,1627,2529,0,1432,1432,1040,392,2.653061224,817,223,47,24,0,24,0,7,0,0,empty,mBC-0814-1
"D2,H12",2384,2652,1703,949,1626,0,930,932,633,299,2.117056856,511,1461,988,318,0,318,0,74,0,0,empty,mBC-0814-1
"D3,A1",726419,832976,489484,343492,483948,1,300869,301238,237703,63535,3.741292201,176593,218940,150155,41611,32,41579,4,2575,0,0.002188605,mm10,mBC-0814-1
"D3,A2",6002,6633,4329,2304,3902,0,2165,2176,1602,574,2.790940767,1185,1951,1418,424,0,424,0,107,0,0,empty,mBC-0814-1
"D3,A3",5272,5738,3920,1818,3345,1,1800,1802,1240,562,2.206405694,940,1261,862,271,0,271,0,69,0,0,empty,mBC-0814-1
"D3,A4",17191,20963,10987,9976,12531,0,8641,8646,5057,3589,1.409027584,5470,42779,11918,3770,7,3763,4,343,0,0.053946319,empty,mBC-0814-1
"D3,A5",4884,5420,3333,2087,3157,0,1728,1729,1212,517,2.344294004,1034,1825,1206,285,0,285,0,68,0,0,empty,mBC-0814-1
"D3,A6",17303,20155,11716,8439,12196,0,7577,7579,5705,1874,3.044290288,4474,2068,1498,377,0,377,0,68,0,0.00530504,empty,mBC-0814-1
"D3,A7",5754,6039,4045,1994,3616,0,1994,1995,1407,588,2.392857143,1054,1833,1200,315,0,315,0,75,0,0.003174603,empty,mBC-0814-1
"D3,A8",2315,2530,1554,976,1561,0,881,882,657,225,2.92,507,1767,1217,366,0,366,0,97,0,0,empty,mBC-0814-1
"D3,A9",7241,7671,5102,2569,4411,0,2386,2391,1713,678,2.526548673,1283,1295,857,288,0,288,0,70,0,0,empty,mBC-0814-1
"D3,A10",3732,4001,2656,1345,2370,0,1255,1255,920,335,2.746268657,663,179,113,34,0,34,0,16,0,0,empty,mBC-0814-1
"D3,A11",4907,5386,3507,1879,3225,0,1772,1773,1260,513,2.456140351,968,2017,1307,428,1,427,1,97,0,0.018735363,empty,mBC-0814-1
"D3,A12",5057,5417,3607,1810,3226,0,1744,1746,1326,420,3.157142857,930,2770,1898,705,0,705,0,181,0,0.00141844,empty,mBC-0814-1
"D3,B1",5017,5151,3634,1517,3051,0,1610,1611,1157,454,2.54845815,817,1919,1280,398,0,398,0,96,0,0.050251256,empty,mBC-0814-1
"D3,B2",4958,5186,3490,1696,3053,0,1640,1642,1193,449,2.65701559,860,531,314,82,0,82,0,38,0,0,empty,mBC-0814-1
"D3,B3",4679,5068,3317,1751,2905,0,1669,1671,1173,498,2.355421687,871,17143,5076,1543,5,1538,2,148,0,0.084525358,empty,mBC-0814-1
"D3,B4",4573,5175,3252,1923,3018,0,1691,1693,1233,460,2.680434783,934,1594,1119,363,0,363,0,80,0,0,empty,mBC-0814-1
"D3,B5",4695,3278,2027,1251,2252,0,1320,1328,977,351,2.783475783,764,1221,877,234,0,234,0,58,0,0.072649573,empty,mBC-0814-1
"D3,B6",4175,4667,2937,1730,2748,0,1547,1548,1120,428,2.61682243,870,1494,985,349,1,348,1,82,0,0.031609195,empty,mBC-0814-1
"D3,B7",5486,5853,3993,1860,3442,0,1837,1837,1348,489,2.756646217,951,1187,810,286,0,286,0,76,0,0,empty,mBC-0814-1
"D3,B8",421205,489381,282328,207053,288848,1,178919,179095,148089,31006,4.776140102,106531,150501,111162,31461,28,31433,2,2004,0,3.18137E-05,mm10,mBC-0814-1
"D3,B9",5283,5833,3740,2093,3415,0,1899,1902,1359,543,2.502762431,1041,4452,1687,553,0,553,0,106,0,0.018083183,empty,mBC-0814-1
"D3,B10",4587,5028,3191,1837,2982,0,1669,1670,1162,508,2.287401575,926,608,410,130,0,130,0,35,0,0,empty,mBC-0814-1
"D3,B11",7011,7684,5038,2646,4535,0,2503,2508,1775,733,2.421555252,1402,681,149,58,0,58,0,12,0,0.068965517,empty,mBC-0814-1
"D3,B12",5734,6175,4049,2126,3598,3,1960,1966,1353,613,2.207177814,1058,1339,873,261,0,261,0,68,0,0,empty,mBC-0814-1
"D3,C1",5751,6149,4108,2041,3487,0,1883,1884,1362,522,2.609195402,968,840,626,179,0,179,0,46,0,0,empty,mBC-0814-1
"D3,C2",5653,6436,4027,2409,3618,0,2029,2035,1478,557,2.653500898,1142,1790,1222,395,0,395,0,103,0,0,empty,mBC-0814-1
"D3,C3",5975,6563,4372,2191,3825,0,2077,2080,1473,607,2.426688633,1119,572,419,159,1,158,1,41,0,0.069620253,empty,mBC-0814-1
"D3,C4",964286,1109969,642350,467619,649514,1,406276,406738,338905,67833,4.996167057,242118,425512,289500,80161,44,80117,4,3832,0,0.001822335,mm10,mBC-0814-1
"D3,C5",8579,9154,6181,2973,5487,0,2976,2976,2228,748,2.978609626,1567,1835,1375,412,1,411,1,92,0,0.00486618,empty,mBC-0814-1
"D3,C6",5489,5846,3850,1996,3498,0,1925,1929,1429,500,2.858,1037,28738,8697,2739,9,2730,3,317,0,0.04981685,empty,mBC-0814-1
"D3,C7",7014,7580,5040,2540,4437,0,2407,2419,1759,660,2.665151515,1284,437,304,115,0,115,0,28,0,0,empty,mBC-0814-1
"D3,C8",5847,6298,4210,2088,3719,0,1964,1974,1396,578,2.415224913,1027,2500,1803,530,0,530,0,100,0,0.037735849,empty,mBC-0814-1
"D3,C9",5111,5524,3639,1885,3203,0,1738,1744,1244,500,2.488,955,1304,860,301,0,301,0,70,0,0.069767442,empty,mBC-0814-1
"D3,C10",5863,6070,4267,1803,3553,0,1869,1870,1392,478,2.912133891,922,1188,835,271,1,270,1,58,0,0,empty,mBC-0814-1
"D3,C11",4922,5510,3535,1975,3150,0,1758,1760,1261,499,2.527054108,974,1794,1263,365,0,365,0,83,0,0.043835616,empty,mBC-0814-1
"D3,C12",8541,9416,6204,3212,5382,0,2898,2908,2085,823,2.533414338,1553,2879,1944,546,2,544,1,96,0,0.029411765,empty,mBC-0814-1
"D3,D1",4871,4992,3509,1483,3066,0,1659,1660,1197,463,2.585313175,854,2048,671,217,0,217,0,46,0,0,empty,mBC-0814-1
"D3,D2",5095,5240,3765,1475,3072,0,1560,1561,1149,412,2.788834951,765,2799,1564,418,2,416,1,94,0,0.026442308,empty,mBC-0814-1
"D3,D3",11505,12375,8050,4325,7266,0,3980,3991,2884,1107,2.605239386,2236,3382,2257,623,0,623,0,128,0,0.014446228,empty,mBC-0814-1
"D3,D4",4926,5399,3491,1908,3156,0,1779,1779,1265,514,2.461089494,973,1870,1307,371,0,371,0,88,0,0.002695418,empty,mBC-0814-1
"D3,D5",254841,301066,164060,137006,180819,1,116664,116785,95648,21137,4.525145479,72182,258755,169508,48055,36,48019,4,2824,0,0.020033737,mm10,mBC-0814-1
"D3,D6",497851,575546,339511,236035,337291,1,207655,207921,157487,50434,3.122635524,122781,113818,82619,22880,11,22869,2,1715,0,0.000349819,mm10,mBC-0814-1
"D3,D7",6115,6600,4422,2178,3809,0,2092,2098,1573,525,2.996190476,1106,2386,1512,517,0,517,0,138,0,0.001934236,empty,mBC-0814-1
"D3,D8",6413,7483,4622,2861,4305,5,2506,2515,1842,673,2.736998514,1410,4831,1732,550,1,549,1,78,0,0.054644809,empty,mBC-0814-1
"D3,D9",3343,3569,2378,1191,2074,0,1155,1155,818,337,2.427299703,584,1349,913,297,0,297,0,70,0,0,empty,mBC-0814-1
"D3,D10",4487,5115,3143,1972,3026,0,1740,1744,1277,467,2.734475375,1001,819,479,170,0,170,0,47,0,0,empty,mBC-0814-1
"D3,D11",4466,4677,3231,1446,2822,0,1554,1556,1119,437,2.560640732,791,2145,1385,479,0,479,0,125,0,0.002087683,empty,mBC-0814-1
"D3,D12",6753,7174,4797,2377,4168,0,2242,2242,1585,657,2.412480974,1202,3491,2389,753,0,753,0,135,0,0,empty,mBC-0814-1
"D3,E1",5194,5419,3827,1592,3232,0,1627,1629,1155,474,2.436708861,821,1363,834,273,0,273,0,64,0,0,empty,mBC-0814-1
"D3,E2",3839,3972,2699,1273,2327,0,1260,1266,872,394,2.21319797,659,1194,788,243,0,243,0,72,0,0.008230453,empty,mBC-0814-1
"D3,E3",3390,3881,2501,1380,2228,0,1218,1223,876,347,2.524495677,655,1599,1086,330,0,330,0,91,0,0,empty,mBC-0814-1
"D3,E4",3283,3517,2299,1218,2032,0,1115,1120,822,298,2.758389262,609,973,723,251,1,250,1,65,0,0,empty,mBC-0814-1
"D3,E5",4435,4708,3239,1469,2707,0,1413,1415,1015,400,2.5375,728,2482,1930,542,1,541,1,71,0,0.007393715,empty,mBC-0814-1
"D3,E6",4709,4919,3401,1518,2772,1,1471,1476,1052,424,2.481132075,748,2169,1619,423,0,423,0,81,0,0.004728132,empty,mBC-0814-1
"D3,E7",974467,1129072,642791,486281,657580,0,426378,426767,322434,104333,3.090431599,256728,227686,148839,42472,29,42443,6,2620,0,0.004500153,mm10,mBC-0814-1
"D3,E8",4869,5268,3527,1741,3145,0,1652,1654,1169,485,2.410309278,906,3995,2483,726,0,726,0,117,0,0.170798898,empty,mBC-0814-1
"D3,E9",3418,3746,2439,1307,2173,0,1189,1193,855,338,2.529585799,640,1897,1354,369,0,369,0,73,0,0,empty,mBC-0814-1
"D3,E10",635649,736954,430459,306495,428485,0,262803,263133,213080,50053,4.257087487,155719,241024,171952,48196,29,48167,4,2686,0,0.000643594,mm10,mBC-0814-1
"D3,E11",4418,4703,3245,1458,2728,0,1448,1451,1046,405,2.582716049,714,1711,1245,424,0,424,0,88,0,0,empty,mBC-0814-1
"D3,E12",4598,4809,3177,1632,2778,0,1527,1531,1092,439,2.487471526,812,29900,8357,2663,6,2657,2,230,0,0.137372977,empty,mBC-0814-1
"D3,F1",4858,5094,3519,1575,2942,0,1546,1552,1092,460,2.373913043,776,1786,1329,371,0,371,0,85,0,0,empty,mBC-0814-1
"D3,F2",6377,7022,4584,2438,4123,0,2266,2270,1650,620,2.661290323,1220,1899,1331,421,0,421,0,117,0,0,empty,mBC-0814-1
"D3,F3",5257,5769,3767,2002,3340,0,1802,1808,1285,523,2.456978967,990,1560,1154,357,1,356,1,88,0,0,empty,mBC-0814-1
"D3,F4",5941,6469,4234,2235,3793,0,2062,2067,1515,552,2.744565217,1145,789,533,157,0,157,0,35,0,0,empty,mBC-0814-1
"D3,F5",5479,5947,3842,2105,3457,0,1875,1875,1349,526,2.564638783,1064,2153,1465,388,0,388,0,88,0,0.00257732,empty,mBC-0814-1
"D3,F6",5583,6009,4052,1957,3566,0,2012,2014,1478,536,2.757462687,1026,2445,1755,571,1,570,1,116,0,0,empty,mBC-0814-1
"D3,F7",628398,741644,419122,322522,436939,1,276603,276893,232269,44624,5.205024202,166883,166100,119853,32656,17,32639,1,2142,0,0.000122553,mm10,mBC-0814-1
"D3,F8",6369,6971,4552,2419,3964,0,2128,2134,1611,523,3.080305927,1130,251,199,41,0,41,0,13,0,0,empty,mBC-0814-1
"D3,F9",5904,6232,4353,1879,3650,0,1876,1882,1358,524,2.591603053,973,2945,2199,662,0,662,0,119,0,0,empty,mBC-0814-1
"D3,F10",6454,6894,4719,2175,4015,0,2134,2135,1534,601,2.552412646,1085,1774,1213,405,0,405,0,91,0,0.04691358,empty,mBC-0814-1
"D3,F11",4562,4953,3278,1675,2858,1,1567,1570,1131,439,2.576309795,820,1381,896,260,0,260,0,57,0,0.003846154,empty,mBC-0814-1
"D3,F12",5258,5777,3642,2135,3344,0,1865,1870,1298,572,2.269230769,1041,204,156,44,0,44,0,12,0,0,empty,mBC-0814-1
"D3,G1",8231,8807,5892,2915,5037,0,2732,2735,2009,726,2.767217631,1394,52708,14972,4725,8,4717,1,506,0,0.028831885,empty,mBC-0814-1
"D3,G2",5853,6114,4215,1899,3633,0,1910,1917,1407,510,2.758823529,966,560,337,125,0,125,0,28,0,0,empty,mBC-0814-1
"D3,G3",5924,6484,4167,2317,3773,0,2070,2076,1484,592,2.506756757,1154,2435,1755,579,0,579,0,121,0,0,empty,mBC-0814-1
"D3,G4",5463,5750,3948,1802,3323,1,1746,1754,1218,536,2.27238806,896,61,50,8,0,8,0,1,0,0,empty,mBC-0814-1
"D3,G5",4837,5216,3459,1757,3044,0,1658,1659,1209,450,2.686666667,895,1432,872,285,0,285,0,68,0,0,empty,mBC-0814-1
"D3,G6",8884,9519,6345,3174,5574,0,3024,3026,2152,874,2.462242563,1610,170,134,49,0,49,0,15,0,0,empty,mBC-0814-1
"D3,G7",5880,6327,4150,2177,3701,0,2015,2016,1418,598,2.371237458,1131,20358,6568,2008,7,2001,3,258,0,0.04197901,empty,mBC-0814-1
"D3,G8",8034,8765,5782,2983,5046,0,2821,2826,1987,839,2.36829559,1499,3407,2477,852,0,852,0,173,0,0.002347418,empty,mBC-0814-1
"D3,G9",5867,6407,4232,2175,3792,0,2108,2114,1486,628,2.366242038,1181,2717,1859,587,0,587,0,154,0,0,empty,mBC-0814-1
"D3,G10",10347,10871,7506,3365,6365,0,3388,3390,2459,931,2.641245972,1739,3588,2421,763,1,762,1,202,0,0.019685039,empty,mBC-0814-1
"D3,G11",564073,652036,378905,273131,384595,4,244327,244578,172702,71876,2.402777005,145357,27961,19461,5446,2,5444,2,617,0,0.001285819,mm10,mBC-0814-1
"D3,G12",4977,5445,3561,1884,3205,0,1756,1760,1265,495,2.555555556,988,1853,1282,385,0,385,0,104,0,0.023376623,empty,mBC-0814-1
"D3,H1",4732,5417,3356,2061,3206,0,1809,1811,1315,496,2.651209677,1051,1371,827,257,0,257,0,49,0,0.050583658,empty,mBC-0814-1
"D3,H2",513839,610052,339372,270680,357927,0,228692,228965,188474,40491,4.654713393,139821,311076,222072,61551,34,61517,3,3075,0,0,mm10,mBC-0814-1
"D3,H3",5908,6595,4229,2366,3881,0,2147,2150,1500,650,2.307692308,1221,1664,1192,348,0,348,0,89,0,0,empty,mBC-0814-1
"D3,H4",5772,6254,4102,2152,3719,0,2071,2071,1499,572,2.620629371,1129,115,81,37,0,37,0,15,0,0,empty,mBC-0814-1
"D3,H5",6758,7426,4788,2638,4226,0,2366,2366,1703,663,2.568627451,1281,2438,1759,492,0,492,0,101,0,0.006097561,empty,mBC-0814-1
"D3,H6",475977,564126,307031,257095,332158,0,216920,217153,177470,39683,4.472192123,133470,306195,222636,62513,35,62478,1,2836,0,0.000784276,mm10,mBC-0814-1
"D3,H7",434237,515217,286003,229214,307509,0,197434,197623,160565,37058,4.332802634,120853,174074,122820,34027,15,34012,1,2172,0,0.000705633,mm10,mBC-0814-1
"D3,H8",4884,5284,3419,1865,3084,0,1720,1726,1206,520,2.319230769,931,2343,1787,495,1,494,1,118,0,0.002024291,empty,mBC-0814-1
"D3,H9",5445,5960,3943,2017,3523,0,1902,1906,1418,488,2.905737705,1032,1448,902,293,0,293,0,70,0,0.078498294,empty,mBC-0814-1
"D3,H10",3710,4076,2683,1393,2338,0,1254,1260,918,342,2.684210526,684,1526,1119,330,0,330,0,65,0,0.006060606,empty,mBC-0814-1
"D3,H11",4224,4625,3032,1593,2752,0,1568,1571,1130,441,2.562358277,846,81,47,23,0,23,0,11,0,0,empty,mBC-0814-1
"D3,H12",345707,409863,217061,192802,243213,0,162387,162545,128302,34243,3.746809567,101049,256417,171690,46787,36,46751,2,2663,0,0.000641698,mm10,mBC-0814-1
"D4,A1",5811,6243,4153,2090,3609,0,2011,2011,1413,598,2.362876254,1034,1845,1258,404,0,404,0,94,0,0,empty,mBC-0814-1
"D4,A2",5815,6171,4121,2050,3698,0,1971,1974,1386,588,2.357142857,1078,1828,1295,416,1,415,1,107,0,0,empty,mBC-0814-1
"D4,A3",557250,647177,371534,275643,381677,0,240904,241145,195016,46129,4.227622537,144374,97936,68953,19516,13,19503,1,1456,0,0.000922935,mm10,mBC-0814-1
"D4,A4",5621,5913,4146,1767,3468,0,1831,1833,1315,518,2.538610039,955,712,415,123,0,123,0,30,0,0.032520325,empty,mBC-0814-1
"D4,A5",5106,5664,3638,2026,3272,0,1771,1771,1263,508,2.486220472,956,1364,985,286,0,286,0,52,0,0,empty,mBC-0814-1
"D4,A6",3785,4258,2719,1539,2455,2,1361,1363,959,404,2.373762376,766,899,521,182,0,182,0,42,0,0,empty,mBC-0814-1
"D4,A7",5440,5935,3965,1970,3605,0,1994,1996,1425,571,2.495621716,1080,1360,940,284,0,284,0,71,0,0,empty,mBC-0814-1
"D4,A8",2254,2511,1544,967,1510,0,854,855,609,246,2.475609756,487,1859,1212,411,0,411,0,91,0,0.0243309,empty,mBC-0814-1
"D4,A9",8063,8908,5715,3193,5091,0,2767,2770,2041,729,2.799725652,1526,1979,1359,410,0,410,0,85,0,0.031707317,empty,mBC-0814-1
"D4,A10",3838,4157,2653,1504,2379,4,1326,1334,969,365,2.654794521,717,318,252,63,0,63,0,18,0,0,empty,mBC-0814-1
"D4,A11",5416,5724,3877,1847,3403,0,1827,1830,1340,490,2.734693878,933,2161,1370,434,1,433,1,100,0,0,empty,mBC-0814-1
"D4,A12",4693,5108,3298,1810,3031,0,1662,1667,1244,423,2.940898345,932,3507,2411,726,0,726,0,180,0,0.017906336,empty,mBC-0814-1
"D4,B1",5093,5723,3577,2146,3382,0,1854,1858,1294,564,2.294326241,1069,1553,1069,334,0,334,0,99,0,0,empty,mBC-0814-1
"D4,B2",5324,5610,3678,1932,3347,0,1832,1838,1329,509,2.611001965,971,309,217,83,0,83,0,41,0,0,empty,mBC-0814-1
"D4,B3",580921,678768,386897,291871,401374,0,253439,253730,208835,44895,4.651631585,152423,130723,92575,25450,21,25429,2,1763,0,0.000157301,mm10,mBC-0814-1
"D4,B4",4450,4880,3153,1727,2968,0,1682,1683,1154,529,2.18147448,897,1298,897,283,0,283,0,66,0,0,empty,mBC-0814-1
"D4,B5",4307,2918,1871,1047,2046,0,1154,1160,866,294,2.945578231,687,1396,915,277,0,277,0,63,0,0,empty,mBC-0814-1
"D4,B6",4008,4328,2875,1453,2643,0,1471,1477,1055,422,2.5,800,1541,1090,310,0,310,0,62,0,0,empty,mBC-0814-1
"D4,B7",5236,5692,3795,1897,3437,2,1888,1893,1371,522,2.626436782,1031,1237,879,240,1,239,1,63,0,0,empty,mBC-0814-1
"D4,B8",3894,4265,2751,1514,2549,0,1403,1404,950,454,2.092511013,758,1550,1162,386,1,385,1,82,0,0.031168831,empty,mBC-0814-1
"D4,B9",4994,5302,3536,1766,3216,1,1787,1789,1278,511,2.500978474,969,820,499,191,1,190,1,74,0,0,empty,mBC-0814-1
"D4,B10",4661,4926,3234,1692,2961,1,1639,1643,1154,489,2.3599182,870,618,440,139,0,139,0,44,0,0,empty,mBC-0814-1
"D4,B11",7053,7743,4959,2784,4436,0,2431,2436,1732,704,2.460227273,1310,1385,411,124,0,124,0,28,0,0.008064516,empty,mBC-0814-1
"D4,B12",960968,1128165,637600,490565,666773,0,427416,427854,333492,94362,3.534176893,258854,212670,149320,40321,26,40295,3,2554,0,0.000620424,mm10,mBC-0814-1
"D4,C1",51754,57126,36126,21000,32845,0,19347,19367,12858,6509,1.975418651,10645,3886,2860,764,0,764,0,123,0,0,empty,mBC-0814-1
"D4,C2",5471,5914,3916,1998,3532,0,1982,1985,1429,556,2.570143885,1060,1563,1020,340,0,340,0,97,0,0,empty,mBC-0814-1
"D4,C3",6147,6725,4392,2333,3911,0,2183,2186,1606,580,2.768965517,1173,906,690,203,0,203,0,44,0,0,empty,mBC-0814-1
"D4,C4",5524,5909,3998,1911,3467,0,1851,1851,1331,520,2.559615385,967,1462,993,297,0,297,0,91,0,0,empty,mBC-0814-1
"D4,C5",8215,8920,5846,3074,5351,2,2956,2958,2099,859,2.443538999,1591,2079,1530,417,0,417,0,112,0,0,empty,mBC-0814-1
"D4,C6",664787,784124,438799,345325,468857,1,301226,301538,233940,67598,3.460753277,183210,246467,178248,50073,20,50053,3,2697,0,0.000319661,mm10,mBC-0814-1
"D4,C7",7564,8089,5519,2570,4730,0,2585,2590,1908,682,2.797653959,1308,373,289,103,0,103,0,26,0,0,empty,mBC-0814-1
"D4,C8",5830,5824,4197,1627,3424,0,1780,1781,1286,495,2.597979798,862,2676,1592,482,0,482,0,92,0,0,empty,mBC-0814-1
"D4,C9",4901,5263,3509,1754,3093,1,1650,1653,1215,438,2.773972603,910,1500,1083,337,0,337,0,68,0,0.068249258,empty,mBC-0814-1
"D4,C10",5782,6355,4102,2253,3722,0,2041,2046,1489,557,2.673249551,1155,2020,1375,349,0,349,0,64,0,0,empty,mBC-0814-1
"D4,C11",4803,5305,3382,1923,3097,0,1733,1736,1228,508,2.417322835,953,1397,931,268,0,268,0,69,0,0.014925373,empty,mBC-0814-1
"D4,C12",8579,9266,6098,3168,5397,0,2985,2989,2120,869,2.439585731,1614,2963,2002,589,0,589,0,99,0,0.013582343,empty,mBC-0814-1
"D4,D1",382083,428062,258159,169903,257962,1,158034,158174,127896,30278,4.224057071,92633,12355,8396,2333,2,2331,2,321,0,0.001716002,mm10,mBC-0814-1
"D4,D2",5170,5258,3784,1474,3149,0,1612,1618,1154,464,2.487068966,830,1344,991,306,0,306,0,94,0,0.022875817,empty,mBC-0814-1
"D4,D3",507412,589906,339971,249935,352470,0,225882,226106,168142,57964,2.900800497,135458,20303,13551,3769,3,3766,2,515,0,0.000265534,mm10,mBC-0814-1
"D4,D4",4808,5140,3412,1728,3049,0,1671,1677,1221,456,2.677631579,899,1772,1152,365,0,365,0,81,0,0.038356164,empty,mBC-0814-1
"D4,D5",484405,551838,322335,229503,326545,0,200693,200903,173704,27199,6.386411265,119050,243744,171592,47760,33,47727,1,2602,0,0.000880005,mm10,mBC-0814-1
"D4,D6",5500,5961,3824,2137,3516,0,1971,1977,1360,617,2.204213938,1090,2797,1641,471,0,471,0,83,0,0.036093418,empty,mBC-0814-1
"D4,D7",6880,7090,4701,2389,3972,2,2142,2146,1505,641,2.347893916,1134,70461,21543,6721,10,6711,4,564,0,0.175234689,empty,mBC-0814-1
"D4,D8",5409,5860,3823,2037,3471,0,1942,1949,1419,530,2.677358491,1065,718,445,146,0,146,0,46,0,0,empty,mBC-0814-1
"D4,D9",3269,3636,2381,1255,2147,0,1181,1183,848,335,2.531343284,659,1748,1165,361,0,361,0,64,0,0.002770083,empty,mBC-0814-1
"D4,D10",3979,4456,2878,1578,2606,0,1465,1467,1082,385,2.81038961,829,983,588,154,0,154,0,51,0,0,empty,mBC-0814-1
"D4,D11",599957,688226,399995,288231,403825,0,253042,253287,185945,67342,2.761204003,150515,199925,144313,39680,22,39658,3,2375,0,0.000378234,mm10,mBC-0814-1
"D4,D12",6579,7181,4620,2561,4087,0,2235,2238,1569,669,2.34529148,1228,2257,1507,444,0,444,0,117,0,0.002252252,empty,mBC-0814-1
"D4,E1",5407,5913,4036,1877,3479,0,1824,1827,1305,522,2.5,997,2292,1649,470,0,470,0,97,0,0,empty,mBC-0814-1
"D4,E2",3620,4139,2595,1544,2472,0,1404,1405,983,422,2.329383886,798,2138,1369,425,0,425,0,85,0,0.011764706,empty,mBC-0814-1
"D4,E3",3543,3720,2539,1181,2229,0,1147,1150,850,300,2.833333333,596,1803,1250,344,0,344,0,72,0,0,empty,mBC-0814-1
"D4,E4",3339,3516,2408,1108,2024,0,1094,1094,755,339,2.227138643,536,1609,1240,348,0,348,0,73,0,0.002873563,empty,mBC-0814-1
"D4,E5",4332,4697,3058,1639,2769,0,1500,1506,1062,444,2.391891892,804,1606,1124,332,0,332,0,72,0,0,empty,mBC-0814-1
"D4,E6",4474,4808,3346,1462,2854,0,1493,1495,1077,418,2.576555024,771,1936,1431,449,0,449,0,88,0,0.002227171,empty,mBC-0814-1
"D4,E7",4492,4774,3264,1510,2877,0,1516,1516,1077,439,2.453302961,786,1606,1170,372,0,372,0,66,0,0.010752688,empty,mBC-0814-1
"D4,E8",4916,5376,3528,1848,3139,0,1656,1659,1157,502,2.304780876,891,1922,1242,378,0,378,0,84,0,0.023809524,empty,mBC-0814-1
"D4,E9",3622,3676,2645,1031,2145,0,1167,1167,855,312,2.740384615,553,1147,769,262,0,262,0,66,0,0.003816794,empty,mBC-0814-1
"D4,E10",424627,466127,298087,168040,278648,4,161967,162174,109347,52827,2.069907434,90943,56173,24325,6982,6,6976,1,699,0,0.040280963,mm10,mBC-0814-1
"D4,E11",494334,545151,340916,204235,325582,2,192687,192915,152784,40131,3.807131644,109584,59916,40373,11298,9,11289,3,1101,0,0.000177164,mm10,mBC-0814-1
"D4,E12",4009,4213,2890,1323,2543,0,1350,1352,931,421,2.211401425,702,1096,831,302,0,302,0,67,0,0.003311258,empty,mBC-0814-1
"D4,F1",4825,5176,3488,1688,2996,0,1587,1590,1138,452,2.517699115,850,1963,1430,410,0,410,0,76,0,0,empty,mBC-0814-1
"D4,F2",6861,7440,4856,2584,4303,0,2400,2402,1807,595,3.03697479,1294,1583,1066,313,0,313,0,89,0,0,empty,mBC-0814-1
"D4,F3",5539,6031,3967,2064,3541,0,1909,1909,1395,514,2.714007782,1046,1736,1165,398,0,398,0,93,0,0,empty,mBC-0814-1
"D4,F4",5509,5723,3912,1811,3444,0,1842,1847,1357,490,2.769387755,970,512,346,113,0,113,0,30,0,0,empty,mBC-0814-1
"D4,F5",5347,5772,3964,1808,3417,0,1792,1794,1284,510,2.517647059,918,1402,969,279,0,279,0,79,0,0,empty,mBC-0814-1
"D4,F6",5466,5902,3861,2041,3497,0,1922,1923,1385,538,2.574349442,1071,2546,1735,502,0,502,0,102,0,0,empty,mBC-0814-1
"D4,F7",1479660,1672239,1014080,658159,966939,1,592085,592761,434844,157917,2.753623739,342826,175047,126291,35820,15,35805,3,2338,0,8.37872E-05,mm10,mBC-0814-1
"D4,F8",6350,6830,4664,2166,4091,0,2219,2220,1569,651,2.410138249,1146,124,81,19,0,19,0,9,0,0,empty,mBC-0814-1
"D4,F9",5805,6168,4215,1953,3686,0,1923,1928,1405,523,2.686424474,1019,2560,1932,598,1,597,1,102,0,0,empty,mBC-0814-1
"D4,F10",618823,711715,420340,291375,417827,2,255069,255354,217148,38206,5.683609904,149739,98347,71125,19116,8,19108,1,1566,0,0.001360687,mm10,mBC-0814-1
"D4,F11",4306,4756,3082,1674,2838,0,1619,1623,1159,464,2.497844828,871,1763,1207,350,1,349,1,71,0,0.048710602,empty,mBC-0814-1
"D4,F12",5064,5664,3563,2101,3322,0,1923,1928,1353,575,2.353043478,1083,207,174,58,0,58,0,13,0,0,empty,mBC-0814-1
"D4,G1",7657,8137,5466,2671,4919,0,2650,2654,1911,743,2.572005384,1463,2929,2135,684,0,684,0,168,0,0.004385965,empty,mBC-0814-1
"D4,G2",5867,6247,4225,2022,3603,0,1927,1929,1367,562,2.432384342,995,334,225,54,0,54,0,21,0,0,empty,mBC-0814-1
"D4,G3",5447,5961,3932,2029,3526,0,1930,1934,1378,556,2.478417266,1050,2616,1844,570,0,570,0,120,0,0,empty,mBC-0814-1
"D4,G4",5551,6004,3937,2067,3379,3,1818,1824,1328,496,2.677419355,987,8,4,2,0,2,0,1,0,0,empty,mBC-0814-1
"D4,G5",577973,667678,386124,281554,390688,3,241675,241981,209469,32512,6.442821112,143681,306525,219013,61754,30,61724,3,2969,0,0.000745253,mm10,mBC-0814-1
"D4,G6",608176,690726,412299,278427,403827,0,240322,240575,213047,27528,7.739283638,140019,28343,19008,5175,3,5172,1,549,0,0,mm10,mBC-0814-1
"D4,G7",5707,6245,4093,2152,3688,0,2009,2014,1453,561,2.590017825,1074,2821,1974,644,0,644,0,133,0,0.02173913,empty,mBC-0814-1
"D4,G8",529067,619774,349001,270773,366132,0,233754,233969,157479,76490,2.058818146,142671,229341,138293,39545,29,39516,3,2480,0,0.036314404,mm10,mBC-0814-1
"D4,G9",6056,6600,4142,2458,3841,0,2172,2174,1552,622,2.495176849,1206,34872,12252,3729,2,3727,2,379,0,0.170646633,empty,mBC-0814-1
"D4,G10",9595,10021,6906,3115,6004,0,3205,3210,2323,887,2.618940248,1641,3799,2716,755,0,755,0,162,0,0,empty,mBC-0814-1
"D4,G11",1020956,1172348,687059,485289,689895,0,433880,434331,346168,88163,3.926454408,256824,72527,47134,12970,10,12960,2,1153,0,7.71605E-05,mm10,mBC-0814-1
"D4,G12",4712,5204,3352,1852,3058,0,1693,1693,1149,544,2.112132353,937,2168,1637,515,0,515,0,119,0,0.003883495,empty,mBC-0814-1
"D4,H1",4841,5240,3357,1883,3044,0,1752,1758,1248,510,2.447058824,958,1181,804,257,0,257,0,62,0,0,empty,mBC-0814-1
"D4,H2",504926,597029,334432,262597,353330,1,226436,226663,186014,40649,4.576102733,137800,283233,194163,52984,29,52955,4,2921,0,0.001416297,mm10,mBC-0814-1
"D4,H3",136505,154419,81957,72462,90752,0,59452,59526,39666,19860,1.997280967,37191,59784,42406,11631,5,11626,1,934,0,0.000344056,mm10,mBC-0814-1
"D4,H4",5897,6471,4242,2229,3839,0,2105,2115,1496,619,2.416801292,1164,271,197,65,0,65,0,15,0,0,empty,mBC-0814-1
"D4,H5",561425,649520,379686,269834,380884,0,237154,237392,172320,65072,2.648143595,141238,94618,66731,18187,13,18174,2,1552,0,0,mm10,mBC-0814-1
"D4,H6",6500,6872,4633,2239,4185,0,2275,2281,1603,678,2.364306785,1204,2999,2123,642,1,641,1,122,0,0,empty,mBC-0814-1
"D4,H7",5599,6010,4039,1971,3563,0,1937,1939,1338,601,2.226289517,992,1693,1174,293,0,293,0,68,0,0.030716724,empty,mBC-0814-1
"D4,H8",4906,5322,3456,1866,2960,1,1628,1631,1180,451,2.616407982,865,1374,940,355,0,355,0,103,0,0.047887324,empty,mBC-0814-1
"D4,H9",6078,6648,4365,2283,3923,0,2174,2176,1583,593,2.669477234,1149,1312,885,271,0,271,0,72,0,0,empty,mBC-0814-1
"D4,H10",3925,4318,2806,1512,2491,0,1410,1411,1056,355,2.974647887,775,1505,1058,307,1,306,1,65,0,0,empty,mBC-0814-1
"D4,H11",4853,5499,3429,2070,3291,0,1878,1881,1346,535,2.51588785,1111,50,34,21,0,21,0,16,0,0,empty,mBC-0814-1
"D4,H12",2817,2948,1996,952,1802,0,992,992,722,270,2.674074074,502,1257,891,263,0,263,0,65,0,0,empty,mBC-0814-1
"D5,A1",5482,5883,3854,2029,3392,0,1831,1835,1292,543,2.379373849,971,25052,7924,2469,7,2462,2,224,0,0.187246141,empty,mBC-0814-1
"D5,A2",773248,872211,517083,355128,515123,3,314596,314924,268127,46797,5.729576682,184626,388118,276614,77709,56,77653,6,3621,0,0.000283312,mm10,mBC-0814-1
"D5,A3",4200,4395,3092,1303,2560,0,1326,1326,967,359,2.693593315,656,832,515,144,0,144,0,30,0,0,empty,mBC-0814-1
"D5,A4",5260,5762,3819,1943,3345,0,1766,1769,1262,507,2.489151874,948,334,275,69,0,69,0,12,0,0,empty,mBC-0814-1
"D5,A5",528080,597285,362615,234670,356558,1,218068,218303,165299,53004,3.11861369,127492,20454,14080,3847,3,3844,1,460,0,0.002081165,mm10,mBC-0814-1
"D5,A6",3601,3852,2626,1226,2261,0,1231,1231,877,354,2.47740113,621,1261,712,248,0,248,0,59,0,0,empty,mBC-0814-1
"D5,A7",420016,489319,279064,210255,292720,0,183784,183980,156775,27205,5.76272744,110388,107043,74881,20987,12,20975,2,1557,0,0,mm10,mBC-0814-1
"D5,A8",1936,2004,1345,659,1211,0,677,677,472,205,2.302439024,343,2024,1487,415,0,415,0,68,0,0.024096386,empty,mBC-0814-1
"D5,A9",5726,5956,4034,1922,3483,0,1835,1836,1351,485,2.78556701,951,1448,991,249,0,249,0,58,0,0,empty,mBC-0814-1
"D5,A10",2927,3210,2109,1101,1928,0,1051,1051,713,338,2.109467456,560,111,92,31,0,31,0,7,0,0,empty,mBC-0814-1
"D5,A11",3893,4078,2840,1238,2484,0,1285,1285,937,348,2.692528736,649,2060,1376,362,0,362,0,76,0,0,empty,mBC-0814-1
"D5,A12",366136,399538,247456,152082,237098,0,139772,139947,109645,30302,3.618408026,80126,244615,176095,49243,26,49217,1,2699,0,0.000304773,mm10,mBC-0814-1
"D5,B1",4110,4560,2944,1616,2656,0,1395,1397,956,441,2.167800454,756,1232,939,257,0,257,0,60,0,0,empty,mBC-0814-1
"D5,B2",403794,452415,271008,181407,271955,1,166502,166700,118201,48499,2.437184272,98121,8891,5777,1837,0,1837,0,224,0,0,mm10,mBC-0814-1
"D5,B3",3521,3983,2518,1465,2314,5,1299,1304,936,368,2.543478261,735,979,623,158,1,157,1,43,0,0,empty,mBC-0814-1
"D5,B4",3702,4141,2600,1541,2451,0,1374,1379,1003,376,2.667553191,749,1211,838,200,0,200,0,44,0,0,empty,mBC-0814-1
"D5,B5",3357,2252,1455,797,1618,0,869,875,614,261,2.352490421,502,981,631,201,0,201,0,42,0,0,empty,mBC-0814-1
"D5,B6",3479,3821,2534,1287,2271,0,1233,1234,831,403,2.062034739,675,2175,1030,328,1,327,1,70,0,0.042813456,empty,mBC-0814-1
"D5,B7",4574,4745,3306,1439,2827,0,1474,1474,1071,403,2.657568238,743,909,705,170,0,170,0,42,0,0,empty,mBC-0814-1
"D5,B8",3361,3585,2450,1135,2125,0,1138,1146,818,328,2.493902439,617,958,652,190,0,190,0,46,0,0,empty,mBC-0814-1
"D5,B9",4313,4557,3074,1483,2632,0,1434,1438,1064,374,2.844919786,729,552,418,150,0,150,0,38,0,0,empty,mBC-0814-1
"D5,B10",3897,4065,2712,1353,2472,0,1339,1340,891,449,1.9844098,712,363,207,54,0,54,0,19,0,0,empty,mBC-0814-1
"D5,B11",5585,6166,3956,2210,3599,0,1975,1976,1405,571,2.460595447,1080,216,98,32,0,32,0,15,0,0.15625,empty,mBC-0814-1
"D5,B12",382851,432141,257963,174178,262365,0,162067,162232,120904,41328,2.925474255,96166,10155,7246,1866,3,1863,1,273,0,0.002147075,mm10,mBC-0814-1
"D5,C1",5030,5444,3601,1843,3179,0,1734,1736,1228,508,2.417322835,913,956,681,208,0,208,0,32,0,0,empty,mBC-0814-1
"D5,C2",980667,1136999,653991,483008,668581,0,421625,422054,336895,85159,3.956070409,253310,395510,289447,80053,45,80008,1,3586,0,0.000462454,mm10,mBC-0814-1
"D5,C3",6566,7241,4634,2607,4273,2,2404,2411,1713,698,2.454154728,1296,734,500,158,0,158,0,36,0,0.018987342,empty,mBC-0814-1
"D5,C4",4499,4784,3204,1580,2810,0,1494,1494,1095,399,2.744360902,775,1472,1053,312,1,311,1,64,0,0.051446945,empty,mBC-0814-1
"D5,C5",6416,6791,4694,2097,4001,2,2151,2156,1617,539,3,1079,1240,824,268,0,268,0,74,0,0,empty,mBC-0814-1
"D5,C6",4842,5153,3495,1658,3097,0,1637,1644,1196,448,2.669642857,865,1318,939,228,0,228,0,53,0,0.026315789,empty,mBC-0814-1
"D5,C7",6356,6714,4546,2168,3998,0,2216,2221,1663,558,2.980286738,1158,298,205,76,0,76,0,26,0,0,empty,mBC-0814-1
"D5,C8",4895,5137,3468,1669,3088,0,1625,1625,1202,423,2.841607565,854,1508,1054,263,0,263,0,47,0,0,empty,mBC-0814-1
"D5,C9",4220,4470,2979,1491,2586,0,1412,1414,1032,382,2.701570681,740,1586,1197,357,0,357,0,53,0,0,empty,mBC-0814-1
"D5,C10",5196,5486,3774,1712,3196,0,1630,1630,1176,454,2.59030837,834,986,673,180,0,180,0,42,0,0,empty,mBC-0814-1
"D5,C11",590218,681718,399279,282439,401953,1,248722,248993,200331,48662,4.116785171,146993,142845,104950,29968,18,29950,2,1987,0,0.000801336,mm10,mBC-0814-1
"D5,C12",7380,8324,5204,3120,4815,0,2657,2659,1877,782,2.400255754,1518,1753,1044,318,0,318,0,65,0,0.003144654,empty,mBC-0814-1
"D5,D1",621977,703599,421965,281634,414483,1,251877,252112,200511,51601,3.885796787,147154,82476,58954,16354,12,16342,1,1257,0,0,mm10,mBC-0814-1
"D5,D2",4852,5114,3618,1496,3036,0,1585,1587,1153,434,2.656682028,801,1328,982,280,0,280,0,55,0,0,empty,mBC-0814-1
"D5,D3",9828,10532,6984,3548,6168,0,3313,3315,2390,925,2.583783784,1783,2103,1399,435,0,435,0,95,0,0.018390805,empty,mBC-0814-1
"D5,D4",5215,5853,3650,2203,3477,0,2035,2037,1503,534,2.814606742,1134,1243,926,307,0,307,0,66,0,0,empty,mBC-0814-1
"D5,D5",3522,3809,2516,1293,2247,0,1213,1215,869,346,2.511560694,638,1643,1128,332,0,332,0,86,0,0,empty,mBC-0814-1
"D5,D6",4748,5119,3405,1714,2952,0,1617,1621,1160,461,2.51626898,843,701,513,150,0,150,0,38,0,0,empty,mBC-0814-1
"D5,D7",5119,5456,3659,1797,3271,0,1781,1785,1279,506,2.527667984,949,2273,1696,500,1,499,1,89,0,0,empty,mBC-0814-1
"D5,D8",4323,4662,3091,1571,2762,0,1496,1497,1076,421,2.555819477,800,964,680,224,0,224,0,50,0,0,empty,mBC-0814-1
"D5,D9",3016,3279,2122,1157,1899,0,1044,1046,732,314,2.331210191,559,1022,706,211,0,211,0,50,0,0,empty,mBC-0814-1
"D5,D10",3322,3562,2281,1281,2201,0,1229,1233,917,316,2.901898734,716,583,293,108,0,108,0,27,0,0,empty,mBC-0814-1
"D5,D11",3784,4017,2690,1327,2305,0,1218,1218,838,380,2.205263158,592,7134,2687,837,0,837,0,151,0,0.054958184,empty,mBC-0814-1
"D5,D12",345099,400901,216124,184777,238127,1,155818,155973,107411,48562,2.211832297,96708,120214,84390,23060,12,23048,3,1722,0,0.001692121,mm10,mBC-0814-1
"D5,E1",4398,4584,3120,1464,2731,0,1396,1398,974,424,2.297169811,714,1252,936,287,0,287,0,59,0,0,empty,mBC-0814-1
"D5,E2",3437,3713,2423,1290,2179,0,1176,1178,857,321,2.669781931,645,1504,1083,313,0,313,0,59,0,0,empty,mBC-0814-1
"D5,E3",3257,3647,2384,1263,2096,0,1135,1139,776,363,2.137741047,638,1341,987,291,0,291,0,62,0,0,empty,mBC-0814-1
"D5,E4",2947,3247,2025,1222,1909,0,1065,1068,727,341,2.131964809,601,809,530,182,0,182,0,46,0,0,empty,mBC-0814-1
"D5,E5",3599,3725,2634,1091,2213,0,1122,1125,814,311,2.617363344,545,858,622,210,0,210,0,37,0,0,empty,mBC-0814-1
"D5,E6",4051,4246,2970,1276,2523,0,1295,1297,898,399,2.250626566,691,1011,663,190,0,190,0,43,0,0,empty,mBC-0814-1
"D5,E7",4201,4501,3028,1473,2575,0,1339,1346,946,400,2.365,711,1050,730,250,1,249,1,48,0,0,empty,mBC-0814-1
"D5,E8",4362,4706,3115,1591,2717,0,1460,1462,1019,443,2.300225734,781,1046,688,238,0,238,0,67,0,0,empty,mBC-0814-1
"D5,E9",2793,2992,2037,955,1777,0,972,972,718,254,2.826771654,510,1553,1206,358,2,356,1,66,0,0,empty,mBC-0814-1
"D5,E10",3574,3813,2598,1215,2303,0,1231,1234,900,334,2.694610778,642,1542,1089,334,0,334,0,73,0,0.017964072,empty,mBC-0814-1
"D5,E11",3963,4364,2875,1489,2605,0,1418,1420,1041,379,2.746701847,749,1528,1134,341,0,341,0,72,0,0,empty,mBC-0814-1
"D5,E12",3571,3733,2549,1184,2270,0,1242,1247,913,334,2.733532934,654,1028,741,232,0,232,0,45,0,0.004310345,empty,mBC-0814-1
"D5,F1",4215,4375,3100,1275,2578,1,1357,1363,988,375,2.634666667,683,1232,923,275,0,275,0,54,0,0,empty,mBC-0814-1
"D5,F2",499917,569051,339558,229493,339689,2,210526,210777,160352,50425,3.180009916,123438,63416,43340,12342,12,12330,4,1137,0,0.002270884,mm10,mBC-0814-1
"D5,F3",19376,21451,14362,7089,12501,0,6592,6603,4954,1649,3.004244997,3465,13073,8946,2607,0,2607,0,389,0,0,empty,mBC-0814-1
"D5,F4",4819,5090,3410,1680,3068,0,1650,1651,1167,484,2.411157025,891,500,341,115,0,115,0,31,0,0,empty,mBC-0814-1
"D5,F5",4596,4830,3277,1553,2863,0,1549,1551,1090,461,2.364425163,805,993,661,267,0,267,0,69,0,0,empty,mBC-0814-1
"D5,F6",4303,4714,3021,1693,2723,0,1563,1564,1109,455,2.437362637,858,1815,1025,336,0,336,0,85,0,0,empty,mBC-0814-1
"D5,F7",4133,4372,3053,1319,2557,0,1323,1325,933,392,2.380102041,666,493,370,118,0,118,0,25,0,0,empty,mBC-0814-1
"D5,F8",6782,7230,4744,2486,4354,0,2428,2438,1830,608,3.009868421,1332,233,203,56,0,56,0,12,0,0,empty,mBC-0814-1
"D5,F9",5040,5434,3660,1774,3179,0,1663,1666,1196,470,2.544680851,825,1525,966,296,0,296,0,74,0,0,empty,mBC-0814-1
"D5,F10",6106,6547,4436,2111,3817,0,2035,2039,1444,595,2.426890756,1076,777,544,148,0,148,0,48,0,0,empty,mBC-0814-1
"D5,F11",3627,3903,2680,1223,2299,6,1217,1230,879,351,2.504273504,640,1636,1127,345,1,344,1,54,0,0,empty,mBC-0814-1
"D5,F12",4444,4764,3135,1629,2851,0,1574,1576,1102,474,2.324894515,845,49,42,17,0,17,0,9,0,0,empty,mBC-0814-1
"D5,G1",6991,7330,4986,2344,4290,2,2224,2231,1553,678,2.290560472,1137,2446,1526,468,0,468,0,109,0,0,empty,mBC-0814-1
"D5,G2",519156,607320,340185,267135,362027,0,231621,231835,180419,51416,3.509004979,140440,39622,28174,7959,4,7955,2,771,0,0.000125707,mm10,mBC-0814-1
"D5,G3",4503,4701,3123,1578,2796,1,1536,1542,1062,480,2.2125,853,2185,1573,442,0,442,0,92,0,0,empty,mBC-0814-1
"D5,G4",4787,5164,3421,1743,2989,0,1603,1605,1113,492,2.262195122,844,1,1,1,0,1,0,1,0,0,empty,mBC-0814-1
"D5,G5",4075,4437,2923,1514,2594,1,1414,1416,995,421,2.363420428,771,1010,700,248,0,248,0,48,0,0.024193548,empty,mBC-0814-1
"D5,G6",7969,8506,5785,2721,5044,1,2649,2656,1935,721,2.683772538,1335,213,169,32,0,32,0,9,0,0,empty,mBC-0814-1
"D5,G7",522683,616078,330888,285190,368289,3,244969,245246,195942,49304,3.974160312,151330,252832,174866,48025,28,47997,2,2647,0,0.001416755,mm10,mBC-0814-1
"D5,G8",6428,6834,4551,2283,4038,0,2207,2210,1556,654,2.379204893,1182,2620,1862,626,0,626,0,145,0,0.025559105,empty,mBC-0814-1
"D5,G9",4353,4608,3099,1509,2749,0,1539,1540,1088,452,2.407079646,786,2410,1845,536,0,536,0,94,0,0.035447761,empty,mBC-0814-1
"D5,G10",8093,8648,5770,2878,5027,0,2666,2668,1872,796,2.351758794,1406,3006,2203,619,0,619,0,133,0,0.011308562,empty,mBC-0814-1
"D5,G11",8371,9082,6034,3048,5358,0,2812,2815,2063,752,2.743351064,1544,1354,964,263,0,263,0,69,0,0,empty,mBC-0814-1
"D5,G12",3990,4313,2822,1491,2579,0,1456,1457,1011,446,2.266816143,795,1873,1294,391,1,390,1,78,0,0,empty,mBC-0814-1
"D5,H1",4165,4286,3072,1214,2577,0,1395,1396,1020,376,2.712765957,698,1195,797,202,0,202,0,47,0,0,empty,mBC-0814-1
"D5,H2",7233,7564,5161,2403,4510,0,2395,2399,1718,681,2.522760646,1256,2496,1758,543,0,543,0,119,0,0.023941068,empty,mBC-0814-1
"D5,H3",4712,5014,3377,1637,2984,0,1686,1686,1260,426,2.957746479,872,1198,908,243,1,242,1,64,0,0,empty,mBC-0814-1
"D5,H4",4803,5181,3395,1786,3074,0,1688,1693,1162,531,2.188323917,911,31,24,18,0,18,0,10,0,0,empty,mBC-0814-1
"D5,H5",6313,6759,4514,2245,3984,0,2151,2154,1544,610,2.531147541,1181,2400,1762,456,0,456,0,71,0,0.004385965,empty,mBC-0814-1
"D5,H6",5552,6156,3945,2211,3542,0,1992,1993,1429,564,2.533687943,1092,11222,3867,1247,1,1246,1,156,0,0.007223114,empty,mBC-0814-1
"D5,H7",4806,5301,3433,1868,3107,0,1758,1760,1221,539,2.265306122,987,1431,1007,292,0,292,0,56,0,0.04109589,empty,mBC-0814-1
"D5,H8",3968,4349,2853,1496,2556,0,1392,1392,1035,357,2.899159664,748,1739,1240,367,0,367,0,78,0,0,empty,mBC-0814-1
"D5,H9",4382,4513,3174,1339,2682,0,1403,1407,1017,390,2.607692308,714,7322,2493,801,0,801,0,116,0,0.033707865,empty,mBC-0814-1
"D5,H10",3252,3655,2314,1341,2101,0,1158,1159,819,340,2.408823529,653,1265,800,267,0,267,0,44,0,0,empty,mBC-0814-1
"D5,H11",3461,3757,2420,1337,2207,0,1213,1216,880,336,2.619047619,658,127,100,55,0,55,0,12,0,0,empty,mBC-0814-1
"D5,H12",191730,223923,124237,99686,136941,0,88686,88751,63958,24793,2.579679748,54716,22841,15973,4449,0,4449,0,515,0,0.001348618,mm10,mBC-0814-1
"D6,A1",4695,5002,3393,1609,2960,0,1575,1578,1134,444,2.554054054,798,1270,854,274,3,271,1,56,0,0,empty,mBC-0814-1
"D6,A2",4102,4169,2949,1220,2485,0,1252,1253,903,350,2.58,624,1351,928,262,0,262,0,67,0,0,empty,mBC-0814-1
"D6,A3",3963,4367,2772,1595,2530,1,1413,1416,1010,406,2.487684729,771,1037,813,205,1,204,1,36,0,0,empty,mBC-0814-1
"D6,A4",4659,4928,3391,1537,2881,0,1529,1529,1065,464,2.295258621,767,329,137,46,0,46,0,12,0,0,empty,mBC-0814-1
"D6,A5",3886,4089,2824,1265,2397,1,1286,1289,915,374,2.446524064,682,1057,788,248,1,247,1,47,0,0.036437247,empty,mBC-0814-1
"D6,A6",3171,3417,2307,1110,2007,0,1052,1056,710,346,2.052023121,543,1426,1065,347,1,346,1,61,0,0,empty,mBC-0814-1
"D6,A7",4481,4878,3146,1732,2845,0,1547,1550,1069,481,2.222453222,816,1349,801,253,0,253,0,60,0,0,empty,mBC-0814-1
"D6,A8",1815,2095,1249,846,1242,0,695,695,459,236,1.944915254,416,1827,1255,357,0,357,0,60,0,0,empty,mBC-0814-1
"D6,A9",5471,5875,3943,1932,3405,0,1775,1780,1232,548,2.248175182,952,1629,1196,346,0,346,0,69,0,0,empty,mBC-0814-1
"D6,A10",2811,3106,2077,1029,1883,3,1067,1071,762,309,2.466019417,579,187,141,25,0,25,0,9,0,0,empty,mBC-0814-1
"D6,A11",3642,3863,2575,1288,2310,0,1263,1263,892,371,2.404312668,656,3167,1922,577,0,577,0,94,0,0.077989601,empty,mBC-0814-1
"D6,A12",293705,331568,194104,137464,197362,0,121947,122091,99995,22096,4.525479725,72521,291177,210723,60227,29,60198,1,3073,0,1.66118E-05,mm10,mBC-0814-1
"D6,B1",3912,4168,2754,1414,2473,0,1324,1329,948,381,2.488188976,717,1312,882,247,0,247,0,68,0,0.020242915,empty,mBC-0814-1
"D6,B2",4154,4341,2972,1369,2515,0,1293,1295,908,387,2.34625323,671,441,284,63,0,63,0,22,0,0.047619048,empty,mBC-0814-1
"D6,B3",3150,3420,2170,1250,2033,7,1130,1138,781,357,2.18767507,626,832,505,155,0,155,0,45,0,0,empty,mBC-0814-1
"D6,B4",3434,3853,2401,1452,2266,0,1278,1279,888,391,2.271099744,716,1020,788,218,0,218,0,50,0,0.009174312,empty,mBC-0814-1
"D6,B5",6878,6789,3862,2927,4341,0,2626,2627,2109,518,4.071428571,1608,798,479,159,0,159,0,50,0,0.062893082,empty,mBC-0814-1
"D6,B6",3353,3425,2292,1133,2041,0,1118,1121,783,338,2.316568047,620,3473,1753,572,0,572,0,75,0,0.236013986,empty,mBC-0814-1
"D6,B7",773214,861441,533409,328032,515752,1,311983,312317,213189,99128,2.150643612,180836,32614,16248,4185,8,4177,2,603,0,0.016997845,mm10,mBC-0814-1
"D6,B8",2948,3155,2100,1055,1887,0,1036,1039,721,318,2.267295597,541,1005,686,162,0,162,0,39,0,0.074074074,empty,mBC-0814-1
"D6,B9",241401,270938,162933,108005,163284,0,99633,99740,78240,21500,3.639069767,58589,5652,3950,1172,0,1172,0,217,0,0,mm10,mBC-0814-1
"D6,B10",3470,3634,2470,1164,2205,0,1202,1205,846,359,2.356545961,635,305,154,48,0,48,0,19,0,0,empty,mBC-0814-1
"D6,B11",7051,8000,4897,3103,4756,0,2736,2738,2038,700,2.911428571,1595,75,45,14,0,14,0,10,0,0,empty,mBC-0814-1
"D6,B12",4492,5085,3142,1943,2800,0,1587,1591,1071,520,2.059615385,856,12963,3667,1122,1,1121,1,113,0,0.074933095,empty,mBC-0814-1
"D6,C1",4786,5025,3519,1506,2910,0,1451,1451,1011,440,2.297727273,702,761,638,211,0,211,0,34,0,0,empty,mBC-0814-1
"D6,C2",4279,4641,3034,1607,2679,0,1446,1448,1087,361,3.011080332,804,1774,1094,342,1,341,1,82,0,0.038123167,empty,mBC-0814-1
"D6,C3",532453,625445,359368,266077,367446,2,227104,227355,183110,44245,4.138546728,136146,156032,111663,31238,15,31223,3,1989,0,0.000896775,mm10,mBC-0814-1
"D6,C4",4016,4215,2878,1337,2515,0,1335,1337,944,393,2.402035623,722,1298,1005,284,0,284,0,69,0,0,empty,mBC-0814-1
"D6,C5",5700,5854,4131,1723,3508,0,1838,1839,1295,544,2.380514706,941,1293,925,298,0,298,0,75,0,0,empty,mBC-0814-1
"D6,C6",4428,4592,3226,1366,2778,0,1440,1442,1059,383,2.765013055,744,1103,671,245,0,245,0,51,0,0,empty,mBC-0814-1
"D6,C7",842699,975012,562348,412664,576144,2,366165,366575,301665,64910,4.64743491,219159,33056,23017,6303,5,6298,1,665,0,0.000635122,mm10,mBC-0814-1
"D6,C8",4609,4791,3317,1474,2776,0,1357,1359,931,428,2.175233645,704,1502,1067,352,0,352,0,74,0,0,empty,mBC-0814-1
"D6,C9",487507,568364,322696,245668,334612,0,211940,212164,174233,37931,4.59341963,127834,102561,72054,19846,12,19834,1,1547,0,0.000201674,mm10,mBC-0814-1
"D6,C10",4910,5243,3496,1747,3067,2,1677,1679,1246,433,2.877598152,871,1409,1030,286,0,286,0,58,0,0,empty,mBC-0814-1
"D6,C11",3649,4094,2551,1543,2493,0,1404,1404,998,406,2.458128079,811,1220,912,276,0,276,0,55,0,0,empty,mBC-0814-1
"D6,C12",418335,496539,271647,224892,294921,0,193817,194007,128676,65331,1.969600955,120280,126475,47828,14382,15,14367,4,1218,0,0.032365838,mm10,mBC-0814-1
"D6,D1",661128,771379,433630,337749,462050,1,299062,299395,239947,59448,4.036250168,181579,75341,50058,14372,8,14364,1,1234,0,0.001949318,mm10,mBC-0814-1
"D6,D2",4284,4474,3145,1329,2652,0,1307,1307,930,377,2.466843501,674,1833,1288,403,0,403,0,65,0,0,empty,mBC-0814-1
"D6,D3",8796,9286,6242,3044,5466,0,2945,2950,2069,881,2.34846765,1556,3675,1956,573,1,572,1,93,0,0,empty,mBC-0814-1
"D6,D4",3736,3977,2584,1393,2319,0,1262,1262,868,394,2.203045685,674,2871,1341,421,1,420,1,84,0,0.019047619,empty,mBC-0814-1
"D6,D5",3408,3649,2392,1257,2173,0,1217,1217,892,325,2.744615385,628,1997,1479,405,0,405,0,97,0,0.049382716,empty,mBC-0814-1
"D6,D6",4155,4441,2984,1457,2610,3,1415,1418,995,423,2.352245863,744,1218,816,257,1,256,1,57,0,0,empty,mBC-0814-1
"D6,D7",4641,4887,3284,1603,2963,0,1628,1628,1165,463,2.516198704,869,9004,3608,1100,0,1100,0,149,0,0.084545455,empty,mBC-0814-1
"D6,D8",3866,4278,2671,1607,2492,0,1362,1365,1032,333,3.099099099,766,1304,954,300,1,299,1,57,0,0,empty,mBC-0814-1
"D6,D9",2613,2801,1906,895,1598,0,871,871,663,208,3.1875,419,1456,1055,311,0,311,0,53,0,0,empty,mBC-0814-1
"D6,D10",3650,3979,2608,1371,2303,0,1335,1337,988,349,2.830945559,711,8048,2512,790,0,790,0,95,0,0.030379747,empty,mBC-0814-1
"D6,D11",3257,3473,2360,1113,2019,1,1034,1037,736,301,2.445182724,532,1987,1410,422,1,421,1,95,0,0,empty,mBC-0814-1
"D6,D12",5252,5413,3771,1642,3116,1,1633,1634,1159,475,2.44,826,2098,1503,447,0,447,0,78,0,0,empty,mBC-0814-1
"D6,E1",4035,4308,2961,1347,2532,0,1347,1349,984,365,2.695890411,691,35550,10085,3374,4,3370,2,313,0,0.09851632,empty,mBC-0814-1
"D6,E2",2940,3143,2110,1033,1800,0,959,960,689,271,2.542435424,500,1190,868,240,0,240,0,53,0,0,empty,mBC-0814-1
"D6,E3",2942,3120,2119,1001,1833,0,959,960,697,263,2.650190114,482,1924,1289,347,0,347,0,64,0,0,empty,mBC-0814-1
"D6,E4",2623,2738,1882,856,1575,1,824,829,601,228,2.635964912,425,1352,887,235,0,235,0,43,0,0,empty,mBC-0814-1
"D6,E5",3128,3339,2266,1073,1918,0,985,985,697,288,2.420138889,497,953,702,277,0,277,0,49,0,0,empty,mBC-0814-1
"D6,E6",3619,3800,2721,1079,2197,0,1107,1109,800,309,2.588996764,539,1712,1222,373,0,373,0,62,0,0,empty,mBC-0814-1
"D6,E7",3701,3871,2637,1234,2204,0,1154,1157,815,342,2.383040936,578,1532,1084,314,0,314,0,59,0,0.00955414,empty,mBC-0814-1
"D6,E8",3759,4098,2655,1443,2368,0,1254,1261,906,355,2.552112676,684,2522,1891,485,1,484,1,82,0,0,empty,mBC-0814-1
"D6,E9",2430,2698,1717,981,1559,0,879,879,620,259,2.393822394,485,1801,1135,354,1,353,1,53,0,0.02266289,empty,mBC-0814-1
"D6,E10",3328,3724,2402,1322,2120,5,1142,1153,852,301,2.830564784,599,1407,918,283,0,283,0,61,0,0,empty,mBC-0814-1
"D6,E11",3456,3585,2459,1126,2147,0,1148,1148,834,314,2.656050955,581,1521,1133,329,2,327,1,59,0,0,empty,mBC-0814-1
"D6,E12",3072,3225,2132,1093,1970,0,1083,1083,779,304,2.5625,625,2139,858,306,1,305,1,60,0,0.081967213,empty,mBC-0814-1
"D6,F1",3797,4020,2716,1304,2333,0,1251,1252,922,330,2.793939394,654,1708,1285,309,0,309,0,61,0,0,empty,mBC-0814-1
"D6,F2",5691,6042,4062,1980,3573,0,1924,1927,1389,538,2.581784387,1036,1876,1273,415,0,415,0,101,0,0,empty,mBC-0814-1
"D6,F3",4421,4717,3203,1514,2750,0,1476,1476,1076,400,2.69,784,1015,746,240,0,240,0,67,0,0.008333333,empty,mBC-0814-1
"D6,F4",4504,4620,3365,1255,2814,0,1452,1456,1017,439,2.316628702,725,511,338,122,0,122,0,25,0,0,empty,mBC-0814-1
"D6,F5",4376,4597,3118,1479,2726,0,1484,1484,1042,442,2.357466063,784,1250,787,255,1,254,1,66,0,0.003937008,empty,mBC-0814-1
"D6,F6",3840,3952,2698,1254,2360,0,1268,1277,891,386,2.308290155,682,1647,1156,434,0,434,0,91,0,0.025345622,empty,mBC-0814-1
"D6,F7",3830,3934,2840,1094,2303,0,1216,1219,846,373,2.268096515,565,731,560,147,0,147,0,32,0,0,empty,mBC-0814-1
"D6,F8",4957,5136,3639,1497,3075,1,1596,1601,1172,429,2.731934732,834,75,63,17,0,17,0,4,0,0,empty,mBC-0814-1
"D6,F9",5326,5623,3763,1860,3288,0,1782,1784,1280,504,2.53968254,927,2242,1467,426,0,426,0,89,0,0.016431925,empty,mBC-0814-1
"D6,F10",5405,5835,3957,1878,3445,3,1800,1805,1240,565,2.194690265,959,1503,1081,372,0,372,0,70,0,0,empty,mBC-0814-1
"D6,F11",3500,3677,2536,1141,2160,0,1135,1139,807,332,2.430722892,594,1526,1099,320,0,320,0,54,0,0,empty,mBC-0814-1
"D6,F12",4158,4483,2933,1550,2613,0,1444,1444,1047,397,2.637279597,761,52,23,14,0,14,0,8,0,0,empty,mBC-0814-1
"D6,G1",6640,7122,4806,2316,4165,0,2112,2117,1481,636,2.328616352,1116,4059,2872,803,0,803,0,147,0,0.00622665,empty,mBC-0814-1
"D6,G2",5036,5226,3678,1548,3075,0,1595,1595,1151,444,2.592342342,803,253,175,43,0,43,0,13,0,0,empty,mBC-0814-1
"D6,G3",4327,4774,3090,1684,2725,0,1514,1519,1076,443,2.428893905,840,2772,2011,545,0,545,0,93,0,0,empty,mBC-0814-1
"D6,G4",4588,5000,3326,1674,2819,5,1502,1509,1069,440,2.429545455,817,6,5,5,0,5,0,1,0,0,empty,mBC-0814-1
"D6,G5",4275,4665,2984,1681,2734,3,1499,1502,1068,434,2.460829493,838,1632,1058,330,0,330,0,50,0,0,empty,mBC-0814-1
"D6,G6",7203,7534,5172,2362,4457,0,2325,2337,1645,692,2.37716763,1210,226,184,56,0,56,0,10,0,0,empty,mBC-0814-1
"D6,G7",4440,4677,3187,1490,2724,0,1462,1468,1047,421,2.486935867,729,9677,3641,1137,0,1137,0,133,0,0.033421284,empty,mBC-0814-1
"D6,G8",329515,376048,216175,159873,225577,1,144815,144955,108870,36085,3.017043093,87010,44149,30477,8492,11,8481,3,852,0,0.006838816,mm10,mBC-0814-1
"D6,G9",220720,251476,147329,104147,150988,3,92537,92657,76400,16257,4.699514055,55158,201717,142106,39219,19,39200,4,2445,0,0.000535714,mm10,mBC-0814-1
"D6,G10",10355,10985,7532,3453,6466,0,3467,3467,2482,985,2.519796954,1794,3031,2107,664,1,663,1,157,0,0.004524887,empty,mBC-0814-1
"D6,G11",436411,497546,288941,208605,294996,1,184565,184796,133159,51637,2.57875167,109974,64752,47528,13007,6,13001,1,1151,0,0,mm10,mBC-0814-1
"D6,G12",3790,4001,2660,1341,2384,0,1304,1308,966,342,2.824561404,686,2096,1521,448,1,447,1,83,0,0,empty,mBC-0814-1
"D6,H1",3765,3953,2659,1294,2345,0,1284,1289,902,387,2.330749354,701,2991,1361,356,1,355,1,69,0,0,empty,mBC-0814-1
"D6,H2",712386,797457,485052,312405,465799,1,279675,280049,222412,57637,3.858840675,161835,254885,183038,51271,34,51237,5,2773,0,0.000936823,mm10,mBC-0814-1
"D6,H3",4469,4694,3163,1531,2811,5,1508,1515,1083,432,2.506944444,781,1596,1192,333,0,333,0,66,0,0,empty,mBC-0814-1
"D6,H4",356820,422125,236070,186055,251297,0,160251,160434,128016,32418,3.948917268,98021,3752,2753,736,1,735,1,112,0,0,empty,mBC-0814-1
"D6,H5",5735,6247,4087,2160,3644,0,1977,1979,1431,548,2.611313869,1092,1987,1505,408,0,408,0,73,0,0,empty,mBC-0814-1
"D6,H6",5126,5571,3700,1871,3204,0,1701,1701,1184,517,2.290135397,901,2287,1657,493,0,493,0,97,0,0,empty,mBC-0814-1
"D6,H7",4459,4754,3135,1619,2871,0,1577,1577,1108,469,2.362473348,872,1733,1309,332,0,332,0,65,0,0,empty,mBC-0814-1
"D6,H8",3494,3751,2549,1202,2168,0,1167,1169,852,317,2.687697161,612,2207,1503,472,0,472,0,92,0,0.008474576,empty,mBC-0814-1
"D6,H9",4488,4782,3189,1593,2807,6,1508,1515,1097,418,2.624401914,815,1440,1061,260,0,260,0,43,0,0,empty,mBC-0814-1
"D6,H10",2896,3148,2075,1073,1893,1,1042,1043,765,278,2.751798561,555,7959,2481,848,0,848,0,95,0,0.016509434,empty,mBC-0814-1
"D6,H11",332147,381995,217392,164603,230997,0,150030,150182,117606,32576,3.610203831,90559,426,294,102,0,102,0,19,0,0,empty,mBC-0814-1
"D6,H12",1892,1992,1325,667,1244,0,684,686,495,191,2.591623037,386,5453,2081,705,2,703,1,101,0,0.031294452,empty,mBC-0814-1
"D7,A1",5786,6370,4108,2262,3728,0,2090,2092,1473,619,2.379644588,1128,2022,1494,410,1,409,1,76,0,0,empty,mBC-0814-1
"D7,A2",5584,6019,3960,2059,3463,0,1845,1852,1347,505,2.667326733,997,11988,3872,1309,1,1308,1,168,0,0.088685015,empty,mBC-0814-1
"D7,A3",11867,14182,8437,5745,8310,0,5042,5044,3904,1140,3.424561404,2930,4978,3419,1007,0,1007,0,138,0,0,empty,mBC-0814-1
"D7,A4",5597,5854,4098,1756,3442,0,1776,1780,1320,460,2.869565217,912,343,219,72,0,72,0,25,0,0,empty,mBC-0814-1
"D7,A5",4869,5163,3533,1630,3116,0,1653,1653,1117,536,2.083955224,890,1060,715,224,0,224,0,64,0,0.09375,empty,mBC-0814-1
"D7,A6",3616,3716,2617,1099,2262,0,1176,1177,886,291,3.04467354,579,1557,1103,335,0,335,0,74,0,0,empty,mBC-0814-1
"D7,A7",5627,6140,4044,2096,3573,0,1968,1972,1411,561,2.515151515,1056,1409,1076,314,0,314,0,78,0,0.047770701,empty,mBC-0814-1
"D7,A8",2386,2575,1677,898,1520,0,821,825,576,249,2.313253012,449,1325,884,275,0,275,0,91,0,0.003636364,empty,mBC-0814-1
"D7,A9",6665,7027,4827,2200,4043,0,2071,2073,1485,588,2.525510204,1052,1314,1028,292,2,290,1,56,0,0,empty,mBC-0814-1
"D7,A10",3512,3806,2503,1303,2196,0,1186,1191,834,357,2.336134454,612,56,36,21,0,21,0,13,0,0,empty,mBC-0814-1
"D7,A11",4439,4834,3172,1662,2898,0,1547,1549,1096,453,2.419426049,828,1535,1050,327,0,327,0,86,0,0,empty,mBC-0814-1
"D7,A12",4390,4853,3093,1760,2766,1,1573,1576,1176,400,2.94,851,2338,1637,596,1,595,1,187,0,0.005042017,empty,mBC-0814-1
"D7,B1",451754,510123,304662,205461,301523,1,183503,183732,146822,36910,3.977837984,107902,95691,62087,17884,22,17862,6,1456,0,0.001679543,mm10,mBC-0814-1
"D7,B2",4944,5304,3417,1887,3121,0,1725,1729,1185,544,2.178308824,939,216,132,52,0,52,0,18,0,0,empty,mBC-0814-1
"D7,B3",4384,4884,3082,1802,3018,0,1766,1771,1226,545,2.249541284,1026,1402,875,253,0,253,0,64,0,0,empty,mBC-0814-1
"D7,B4",490073,564355,327919,236436,333902,1,208045,208282,165328,42954,3.848954696,124467,105485,77528,22036,15,22021,1,1608,0,0.000136234,mm10,mBC-0814-1
"D7,B5",3693,2413,1520,893,1706,0,958,963,696,267,2.606741573,559,1494,808,223,1,222,1,58,0,0,empty,mBC-0814-1
"D7,B6",512059,582304,339143,243161,340831,2,209668,209897,162476,47421,3.426245756,124693,131625,93942,26742,7,26735,1,1906,0,0,mm10,mBC-0814-1
"D7,B7",5311,5800,3845,1955,3332,0,1795,1798,1283,515,2.491262136,973,810,472,168,0,168,0,59,0,0,empty,mBC-0814-1
"D7,B8",3880,4111,2808,1303,2415,3,1314,1318,963,355,2.712676056,696,913,632,228,0,228,0,72,0,0.092105263,empty,mBC-0814-1
"D7,B9",320235,381741,213740,168001,225434,1,140705,140875,114169,26706,4.275031828,87086,128797,74538,19393,14,19379,1,1881,0,0.001290056,mm10,mBC-0814-1
"D7,B10",4452,4695,3151,1544,2764,0,1438,1442,1033,409,2.525672372,741,119,47,27,0,27,0,19,0,0,empty,mBC-0814-1
"D7,B11",7573,8217,5379,2838,4849,0,2637,2643,1971,672,2.933035714,1414,151,98,22,0,22,0,10,0,0,empty,mBC-0814-1
"D7,B12",5315,5705,3816,1889,3330,0,1836,1840,1329,511,2.600782779,944,1294,959,223,0,223,0,54,0,0,empty,mBC-0814-1
"D7,C1",5773,5901,4118,1783,3492,0,1819,1823,1344,479,2.805845511,928,783,518,183,0,183,0,43,0,0.005464481,empty,mBC-0814-1
"D7,C2",5827,6341,4177,2164,3652,0,1983,1984,1455,529,2.75047259,1053,1685,1202,404,0,404,0,112,0,0,empty,mBC-0814-1
"D7,C3",5852,6380,4082,2298,3687,2,1992,1995,1422,573,2.481675393,1088,589,387,126,0,126,0,31,0,0,empty,mBC-0814-1
"D7,C4",524892,584863,353422,231441,344648,3,208982,209244,160756,48488,3.315377,121513,137554,95685,27012,7,27005,2,1929,0,0.000703573,mm10,mBC-0814-1
"D7,C5",6953,7329,5001,2328,4288,0,2294,2297,1658,639,2.594679186,1184,2279,1104,408,0,408,0,92,0,0,empty,mBC-0814-1
"D7,C6",5767,6160,4105,2055,3702,0,2086,2086,1523,563,2.705150977,1108,1178,785,251,1,250,1,68,0,0.004,empty,mBC-0814-1
"D7,C7",6980,7695,5202,2493,4411,0,2332,2334,1655,679,2.437407953,1222,86,37,20,0,20,0,16,0,0,empty,mBC-0814-1
"D7,C8",506684,573941,338353,235588,336160,2,203912,204125,167782,36343,4.616624935,119940,269925,196114,55043,46,54997,3,2961,0,0.00149099,mm10,mBC-0814-1
"D7,C9",4671,4920,3287,1633,2843,0,1568,1569,1114,455,2.448351648,818,808,509,164,0,164,0,62,0,0,empty,mBC-0814-1
"D7,C10",5834,6178,4245,1933,3658,0,1957,1963,1348,615,2.191869919,1034,1150,718,208,0,208,0,37,0,0,empty,mBC-0814-1
"D7,C11",4893,5319,3526,1793,3023,0,1674,1675,1146,529,2.166351607,889,1035,812,262,1,261,1,72,0,0,empty,mBC-0814-1
"D7,C12",8326,9161,5863,3298,5217,0,2876,2886,2073,813,2.549815498,1592,2172,1479,378,0,378,0,90,0,0,empty,mBC-0814-1
"D7,D1",4568,4851,3281,1570,2895,3,1584,1590,1094,496,2.205645161,803,718,465,112,0,112,0,33,0,0.026785714,empty,mBC-0814-1
"D7,D2",5109,5304,3808,1496,3066,0,1549,1558,1125,433,2.598152425,761,1431,1053,311,1,310,1,81,0,0,empty,mBC-0814-1
"D7,D3",10983,12222,7867,4355,7062,2,3908,3919,2806,1113,2.521114106,2096,1407,959,348,0,348,0,98,0,0.020114943,empty,mBC-0814-1
"D7,D4",5137,5708,3654,2054,3299,0,1816,1820,1344,476,2.823529412,1000,1640,1137,298,0,298,0,85,0,0,empty,mBC-0814-1
"D7,D5",4598,4996,3278,1718,2976,0,1605,1607,1158,449,2.579064588,899,1550,1088,338,0,338,0,108,0,0,empty,mBC-0814-1
"D7,D6",5447,5874,3993,1881,3325,12,1751,1769,1299,470,2.763829787,917,1128,778,268,0,268,0,73,0,0.044776119,empty,mBC-0814-1
"D7,D7",508021,563831,343337,220494,329938,0,197290,197528,167204,30324,5.51391637,113827,221232,159682,43925,20,43905,4,2527,0,0.000979387,mm10,mBC-0814-1
"D7,D8",5152,5626,3667,1959,3237,0,1773,1775,1339,436,3.071100917,922,902,717,270,0,270,0,49,0,0.007407407,empty,mBC-0814-1
"D7,D9",2967,3172,2128,1044,1921,0,1063,1065,744,321,2.317757009,577,1172,707,219,0,219,0,43,0,0,empty,mBC-0814-1
"D7,D10",4510,4917,3160,1757,2936,0,1651,1657,1243,414,3.002415459,913,638,453,183,0,183,0,50,0,0.016393443,empty,mBC-0814-1
"D7,D11",491635,563250,332083,231167,332242,1,203783,203991,159947,44044,3.631527563,120223,308541,206244,59601,40,59561,3,2949,0,0.002602374,mm10,mBC-0814-1
"D7,D12",6379,6979,4505,2474,4042,0,2246,2248,1645,603,2.728026534,1251,2511,1754,502,1,501,1,102,0,0.015968064,empty,mBC-0814-1
"D7,E1",564446,633650,388537,245113,371366,0,220525,220805,170021,50784,3.347924543,127275,154543,110351,32009,18,31991,2,2025,0,0.00103154,mm10,mBC-0814-1
"D7,E2",3609,3828,2574,1254,2246,0,1225,1225,903,322,2.804347826,651,947,686,241,0,241,0,80,0,0.008298755,empty,mBC-0814-1
"D7,E3",3454,3489,2515,974,2111,0,1077,1078,744,334,2.22754491,538,1330,1015,324,0,324,0,69,0,0,empty,mBC-0814-1
"D7,E4",3017,3326,2152,1174,1908,0,1069,1069,748,321,2.330218069,537,1103,835,196,0,196,0,59,0,0,empty,mBC-0814-1
"D7,E5",3847,4191,2769,1422,2381,0,1270,1279,875,404,2.165841584,657,4395,1748,520,1,519,1,81,0,0.090558767,empty,mBC-0814-1
"D7,E6",609669,709224,410125,299099,409835,0,255654,255961,204649,51312,3.988326317,152678,177451,129897,36007,14,35993,2,2248,0,2.77832E-05,mm10,mBC-0814-1
"D7,E7",4570,4991,3361,1630,2802,0,1500,1503,1052,451,2.332594235,756,1427,1076,288,0,288,0,53,0,0,empty,mBC-0814-1
"D7,E8",4778,5054,3440,1614,2953,6,1561,1568,1140,428,2.663551402,805,1554,1135,317,1,316,1,85,0,0,empty,mBC-0814-1
"D7,E9",3290,3406,2287,1119,2045,0,1143,1147,813,334,2.434131737,600,960,713,240,0,240,0,59,0,0,empty,mBC-0814-1
"D7,E10",4621,5050,3161,1889,2876,0,1624,1628,1145,483,2.370600414,905,5322,2200,648,0,648,0,98,0,0.179012346,empty,mBC-0814-1
"D7,E11",4579,4955,3228,1727,2932,0,1605,1607,1178,429,2.745920746,879,1529,989,359,0,359,0,88,0,0.002785515,empty,mBC-0814-1
"D7,E12",4027,4526,2912,1614,2665,0,1479,1479,1068,411,2.598540146,786,26131,7418,2293,3,2290,3,230,0,0.030131004,empty,mBC-0814-1
"D7,F1",4976,5440,3553,1887,3150,0,1699,1708,1225,483,2.536231884,938,917,542,196,0,196,0,65,0,0,empty,mBC-0814-1
"D7,F2",6810,7142,4755,2387,4224,0,2292,2295,1606,689,2.330914369,1245,2485,1686,515,1,514,1,123,0,0.038910506,empty,mBC-0814-1
"D7,F3",5264,5529,3802,1727,3183,0,1708,1710,1215,495,2.454545455,867,906,607,190,1,189,1,70,0,0,empty,mBC-0814-1
"D7,F4",5523,5942,3952,1990,3439,0,1863,1868,1355,513,2.641325536,950,370,254,78,0,78,0,28,0,0,empty,mBC-0814-1
"D7,F5",1379051,1564087,941074,623013,898541,0,559969,560659,438627,122032,3.594360496,325716,231903,147845,42178,27,42151,2,2432,0,0.001518351,mm10,mBC-0814-1
"D7,F6",5089,5622,3611,2011,3241,0,1794,1795,1277,518,2.465250965,978,2440,1209,429,0,429,0,110,0,0.037296037,empty,mBC-0814-1
"D7,F7",5012,5449,3644,1805,3096,0,1724,1727,1244,483,2.575569358,897,788,506,172,0,172,0,52,0,0.069767442,empty,mBC-0814-1
"D7,F8",6079,6235,4340,1895,3737,0,1962,1964,1416,548,2.583941606,1007,119,96,34,0,34,0,14,0,0,empty,mBC-0814-1
"D7,F9",5766,6169,4168,2001,3634,0,1929,1933,1381,552,2.501811594,1024,1473,1046,361,0,361,0,77,0,0,empty,mBC-0814-1
"D7,F10",6356,6667,4656,2011,3969,0,2058,2060,1417,643,2.203732504,1063,1597,1262,385,0,385,0,84,0,0.080519481,empty,mBC-0814-1
"D7,F11",4449,4788,3167,1621,2765,0,1499,1501,1060,441,2.403628118,810,1449,1045,284,0,284,0,57,0,0.003521127,empty,mBC-0814-1
"D7,F12",457440,537248,302997,234251,316004,0,203306,203515,158136,45379,3.484783711,123604,3106,2140,610,0,610,0,93,0,0,empty,mBC-0814-1
"D7,G1",7507,7905,5430,2475,4738,0,2552,2553,1823,730,2.497260274,1322,2877,1855,563,0,563,0,152,0,0.026642984,empty,mBC-0814-1
"D7,G2",405771,463655,272126,191529,276445,2,171959,172157,138449,33708,4.107303904,101831,10965,7659,2214,3,2211,1,302,0,0,mm10,mBC-0814-1
"D7,G3",7600,8336,5317,3019,4861,0,2739,2742,2027,715,2.834965035,1490,2105,1484,510,0,510,0,110,0,0,empty,mBC-0814-1
"D7,G4",5508,5995,3939,2056,3442,0,1813,1818,1254,564,2.223404255,986,7,2,2,0,2,0,2,0,0,empty,mBC-0814-1
"D7,G5",4681,5079,3361,1718,2920,2,1561,1563,1098,465,2.361290323,842,1097,730,241,0,241,0,68,0,0.078838174,empty,mBC-0814-1
"D7,G6",9078,9824,6615,3209,5679,0,3036,3040,2174,866,2.51039261,1571,128,71,25,0,25,0,12,0,0,empty,mBC-0814-1
"D7,G7",5665,5974,4082,1892,3495,0,1835,1839,1348,491,2.745417515,951,2000,1435,482,0,482,0,118,0,0.018672199,empty,mBC-0814-1
"D7,G8",390925,466673,253780,212893,276237,0,179560,179709,145281,34428,4.219850122,110978,159630,111666,32100,23,32077,3,2141,0,0.001402874,mm10,mBC-0814-1
"D7,G9",5340,5886,3835,2051,3554,0,1986,1992,1474,518,2.845559846,1085,3026,1879,562,0,562,0,127,0,0.03024911,empty,mBC-0814-1
"D7,G10",1318587,1530474,863171,667303,888521,2,573847,574463,451437,123026,3.669443857,347380,498161,358757,101871,62,101809,5,4157,0,0.00012769,mm10,mBC-0814-1
"D7,G11",9503,10348,6767,3581,6017,0,3240,3247,2315,932,2.483905579,1750,1209,858,279,1,278,1,76,0,0.003597122,empty,mBC-0814-1
"D7,G12",4767,5187,3336,1851,3089,0,1707,1712,1214,498,2.437751004,947,2114,1455,401,0,401,0,86,0,0.004987531,empty,mBC-0814-1
"D7,H1",508238,593695,337536,256159,348660,3,217350,217602,177727,39875,4.457103448,130887,139101,96079,26767,11,26756,2,1880,0,0.006914337,mm10,mBC-0814-1
"D7,H2",8616,9568,6190,3378,5611,0,3094,3100,2267,833,2.721488595,1723,3069,2281,682,1,681,1,185,0,0.020558003,empty,mBC-0814-1
"D7,H3",5551,6119,3853,2266,3526,0,1961,1961,1471,490,3.002040816,1107,1858,1229,376,0,376,0,83,0,0.002659574,empty,mBC-0814-1
"D7,H4",5786,6206,4151,2055,3700,0,2061,2065,1515,550,2.754545455,1077,37,22,13,0,13,0,6,0,0,empty,mBC-0814-1
"D7,H5",6843,7235,4998,2237,4169,0,2220,2222,1593,629,2.532591415,1125,1953,1434,416,1,415,1,75,0,0.009638554,empty,mBC-0814-1
"D7,H6",6795,7357,4864,2493,4281,0,2336,2340,1660,680,2.441176471,1275,2491,1709,557,0,557,0,113,0,0,empty,mBC-0814-1
"D7,H7",5356,5849,3807,2042,3391,0,1860,1860,1329,531,2.502824859,1018,5231,1891,621,1,620,1,101,0,0.029032258,empty,mBC-0814-1
"D7,H8",4707,5253,3323,1930,3011,0,1675,1681,1196,485,2.465979381,953,1594,1056,344,0,344,0,97,0,0.040697674,empty,mBC-0814-1
"D7,H9",5213,5766,3689,2077,3397,0,1867,1869,1376,493,2.791075051,1042,1408,956,239,0,239,0,57,0,0.079497908,empty,mBC-0814-1
"D7,H10",3464,3899,2418,1481,2283,0,1262,1262,909,353,2.575070822,724,1358,919,275,0,275,0,57,0,0.003636364,empty,mBC-0814-1
"D7,H11",4071,4532,2917,1615,2658,0,1501,1503,1047,456,2.296052632,808,146,57,19,0,19,0,8,0,0.052631579,empty,mBC-0814-1
"D7,H12",2938,3218,2072,1146,1975,0,1109,1109,818,291,2.810996564,608,1222,888,267,0,267,0,67,0,0,empty,mBC-0814-1
"D8,A1",6122,6523,4388,2135,3779,0,2017,2025,1418,607,2.336079077,1061,1543,1013,329,0,329,0,76,0,0.003039514,empty,mBC-0814-1
"D8,A2",5487,6009,3847,2162,3550,0,1949,1953,1402,551,2.54446461,1070,1727,1258,369,0,369,0,93,0,0.002710027,empty,mBC-0814-1
"D8,A3",4655,5162,3389,1773,3074,0,1672,1674,1179,495,2.381818182,927,1006,763,202,0,202,0,42,0,0,empty,mBC-0814-1
"D8,A4",5654,5928,4073,1855,3467,0,1808,1810,1296,514,2.521400778,938,524,389,103,0,103,0,21,0,0,empty,mBC-0814-1
"D8,A5",4866,5376,3552,1824,3162,0,1735,1740,1259,481,2.617463617,939,1648,1165,305,0,305,0,58,0,0,empty,mBC-0814-1
"D8,A6",7418,8351,5541,2810,4847,0,2716,2716,2085,631,3.304278922,1414,2641,1843,561,0,561,0,93,0,0.001782531,empty,mBC-0814-1
"D8,A7",5994,6767,4225,2542,3860,0,2201,2205,1493,712,2.096910112,1227,2132,1395,375,1,374,1,83,0,0.005347594,empty,mBC-0814-1
"D8,A8",205883,246693,133203,113490,148971,0,97086,97201,78636,18565,4.235712362,60111,268616,192724,53781,34,53747,5,2696,0,0.00026048,mm10,mBC-0814-1
"D8,A9",6915,7284,5056,2228,4187,0,2127,2127,1497,630,2.376190476,1132,1563,1102,361,1,360,1,67,0,0.030555556,empty,mBC-0814-1
"D8,A10",3665,3857,2572,1285,2268,0,1235,1237,890,347,2.564841499,668,78,66,23,0,23,0,7,0,0,empty,mBC-0814-1
"D8,A11",4841,5346,3472,1874,3055,0,1639,1639,1169,470,2.487234043,916,2568,1837,524,1,523,1,93,0,0.036328872,empty,mBC-0814-1
"D8,A12",4314,4716,3015,1701,2760,0,1542,1543,1151,392,2.93622449,883,3288,2210,594,2,592,1,133,0,0.016891892,empty,mBC-0814-1
"D8,B1",4713,5127,3372,1755,3039,0,1635,1637,1209,428,2.824766355,873,979,730,244,0,244,0,80,0,0.004098361,empty,mBC-0814-1
"D8,B2",4998,5142,3562,1580,3049,0,1621,1627,1151,476,2.418067227,818,694,402,150,0,150,0,36,0,0,empty,mBC-0814-1
"D8,B3",4608,5231,3227,2004,3034,0,1750,1756,1268,488,2.598360656,974,1250,897,217,1,216,1,43,0,0.00462963,empty,mBC-0814-1
"D8,B4",379784,437797,254926,182871,260354,0,160757,160939,131508,29431,4.468349699,95712,99295,72076,20516,8,20508,1,1637,0,0,mm10,mBC-0814-1
"D8,B5",44376,29633,18438,11195,21007,1,11792,11875,9383,2492,3.765248796,6935,15250,10461,2841,0,2841,0,370,0,0,empty,mBC-0814-1
"D8,B6",4258,4569,3137,1432,2682,0,1437,1437,1016,421,2.413301663,738,1027,708,210,0,210,0,39,0,0,empty,mBC-0814-1
"D8,B7",579879,649063,397760,251303,383102,0,231202,231486,189642,41844,4.5321193,133328,49959,29809,8362,5,8357,2,816,0,0.0147182,mm10,mBC-0814-1
"D8,B8",3919,4159,2819,1340,2470,0,1331,1333,967,366,2.642076503,677,1190,861,271,1,270,1,65,0,0.018518519,empty,mBC-0814-1
"D8,B9",4846,5211,3538,1673,3106,3,1703,1713,1206,507,2.378698225,913,556,394,150,0,150,0,47,0,0,empty,mBC-0814-1
"D8,B10",4462,4746,3082,1664,2877,0,1591,1592,1084,508,2.133858268,888,392,175,61,0,61,0,11,0,0,empty,mBC-0814-1
"D8,B11",6513,6840,4731,2109,3955,0,2037,2047,1452,595,2.440336134,1040,141,109,41,0,41,0,12,0,0,empty,mBC-0814-1
"D8,B12",5485,5942,3955,1987,3526,0,1906,1910,1356,554,2.44765343,1019,1057,758,244,0,244,0,53,0,0,empty,mBC-0814-1
"D8,C1",5848,6129,4209,1920,3536,0,1837,1842,1345,497,2.706237425,949,880,527,188,0,188,0,39,0,0,empty,mBC-0814-1
"D8,C2",5452,5953,3896,2057,3435,0,1896,1902,1338,564,2.372340426,1028,2076,1510,446,0,446,0,86,0,0,empty,mBC-0814-1
"D8,C3",5802,6114,4078,2036,3526,0,1885,1891,1321,570,2.31754386,988,902,613,162,0,162,0,31,0,0,empty,mBC-0814-1
"D8,C4",6805,7097,4782,2315,4285,0,2281,2286,1694,592,2.861486486,1224,2142,1330,377,0,377,0,79,0,0,empty,mBC-0814-1
"D8,C5",7200,8006,5202,2804,4616,0,2481,2486,1778,708,2.511299435,1356,1502,1127,333,0,333,0,81,0,0,empty,mBC-0814-1
"D8,C6",5482,5599,3913,1686,3295,0,1782,1786,1307,479,2.728601253,882,6711,2353,706,0,706,0,108,0,0.056657224,empty,mBC-0814-1
"D8,C7",7114,7647,5002,2645,4443,1,2506,2509,1766,743,2.376850606,1330,374,244,76,0,76,0,18,0,0,empty,mBC-0814-1
"D8,C8",5539,5922,3883,2039,3487,0,1885,1885,1359,526,2.58365019,1027,1927,1255,371,1,370,1,71,0,0,empty,mBC-0814-1
"D8,C9",4699,5121,3380,1741,3020,0,1633,1634,1176,458,2.56768559,882,826,547,147,0,147,0,48,0,0,empty,mBC-0814-1
"D8,C10",5769,6261,4211,2050,3559,0,1910,1913,1354,559,2.422182469,994,1464,860,269,0,269,0,58,0,0.018587361,empty,mBC-0814-1
"D8,C11",4901,5257,3534,1723,3088,0,1623,1625,1160,465,2.494623656,861,1488,1025,330,0,330,0,65,0,0.039393939,empty,mBC-0814-1
"D8,C12",8362,8786,5906,2880,5154,0,2720,2725,1954,771,2.534370947,1433,1931,1391,431,0,431,0,78,0,0,empty,mBC-0814-1
"D8,D1",4621,5003,3293,1710,3005,0,1685,1689,1174,515,2.27961165,928,546,390,128,0,128,0,28,0,0.078125,empty,mBC-0814-1
"D8,D2",5201,5710,3738,1972,3300,0,1752,1752,1205,547,2.202925046,939,1738,1218,329,0,329,0,70,0,0,empty,mBC-0814-1
"D8,D3",11071,11988,7813,4175,6951,0,3827,3832,2720,1112,2.446043165,2037,4013,2096,578,3,575,1,107,0,0.003478261,empty,mBC-0814-1
"D8,D4",4930,5518,3491,2027,3233,5,1811,1821,1306,515,2.53592233,1025,1637,1161,359,0,359,0,70,0,0,empty,mBC-0814-1
"D8,D5",4641,5054,3240,1814,2956,0,1681,1685,1207,478,2.525104603,938,2088,1343,444,0,444,0,98,0,0.002252252,empty,mBC-0814-1
"D8,D6",5165,5676,3755,1921,3329,0,1848,1854,1345,509,2.642436149,952,1279,887,246,0,246,0,57,0,0,empty,mBC-0814-1
"D8,D7",6183,6645,4459,2186,3848,0,2102,2103,1553,550,2.823636364,1099,2338,1668,445,0,445,0,91,0,0.049438202,empty,mBC-0814-1
"D8,D8",5189,5635,3740,1895,3319,0,1828,1830,1321,509,2.595284872,987,995,703,202,0,202,0,36,0,0,empty,mBC-0814-1
"D8,D9",3117,3377,2274,1103,1969,0,1082,1084,770,314,2.452229299,539,1583,1002,309,0,309,0,52,0,0,empty,mBC-0814-1
"D8,D10",3947,4349,2785,1564,2521,0,1367,1368,997,371,2.687331536,766,904,616,192,0,192,0,42,0,0,empty,mBC-0814-1
"D8,D11",4083,4288,2936,1352,2594,0,1401,1404,1042,362,2.878453039,744,1910,1360,427,0,427,0,94,0,0,empty,mBC-0814-1
"D8,D12",6437,6843,4516,2327,3943,0,2114,2120,1520,600,2.533333333,1142,3775,2438,630,0,630,0,112,0,0.00952381,empty,mBC-0814-1
"D8,E1",5456,5975,3958,2017,3444,0,1833,1834,1274,560,2.275,979,1898,1406,416,0,416,0,71,0,0.007211538,empty,mBC-0814-1
"D8,E2",896205,1050144,596194,453950,616429,0,393301,393706,297015,96691,3.07179572,237012,317882,217517,60098,39,60059,3,3287,0,0.00054946,mm10,mBC-0814-1
"D8,E3",3543,3648,2636,1012,2153,0,1106,1109,819,290,2.824137931,520,1001,718,231,0,231,0,50,0,0,empty,mBC-0814-1
"D8,E4",3676,4001,2472,1529,2218,0,1244,1246,906,340,2.664705882,699,48421,14404,4604,5,4599,3,376,0,0.157860404,empty,mBC-0814-1
"D8,E5",3826,3960,2767,1193,2309,0,1225,1227,853,374,2.280748663,616,635,456,121,0,121,0,31,0,0.165289256,empty,mBC-0814-1
"D8,E6",4642,4845,3353,1492,2837,0,1492,1495,1080,415,2.602409639,746,1844,1210,317,0,317,0,59,0,0,empty,mBC-0814-1
"D8,E7",4716,4982,3416,1566,2903,0,1523,1531,1062,469,2.264392324,781,1211,812,232,0,232,0,52,0,0,empty,mBC-0814-1
"D8,E8",4789,4941,3443,1498,2830,0,1454,1457,1030,427,2.412177986,726,1681,1132,350,0,350,0,73,0,0,empty,mBC-0814-1
"D8,E9",3232,3440,2246,1194,2058,0,1173,1173,877,296,2.962837838,624,1649,1080,324,0,324,0,65,0,0,empty,mBC-0814-1
"D8,E10",455511,545572,309974,235598,325981,0,207882,208100,160149,47951,3.339846927,125914,117868,76432,21684,24,21660,4,1710,0,0.009464451,mm10,mBC-0814-1
"D8,E11",4394,4706,3116,1590,2772,0,1474,1484,1017,467,2.177730193,825,1754,997,299,0,299,0,60,0,0,empty,mBC-0814-1
"D8,E12",4095,4395,2907,1488,2567,0,1432,1435,1062,373,2.847184987,746,1569,941,256,0,256,0,46,0,0,empty,mBC-0814-1
"D8,F1",4644,4905,3357,1548,2929,0,1522,1522,1078,444,2.427927928,805,1315,943,276,1,275,1,57,0,0,empty,mBC-0814-1
"D8,F2",6796,7286,4910,2376,4197,0,2278,2286,1675,611,2.741407529,1158,1892,1213,374,0,374,0,109,0,0.00802139,empty,mBC-0814-1
"D8,F3",5183,5676,3698,1978,3344,0,1831,1835,1341,494,2.714574899,1005,1559,1181,339,0,339,0,62,0,0,empty,mBC-0814-1
"D8,F4",5616,6030,4016,2014,3610,0,1953,1956,1405,551,2.549909256,1051,302,187,55,0,55,0,11,0,0,empty,mBC-0814-1
"D8,F5",5251,5659,3779,1880,3268,0,1776,1780,1263,517,2.442940039,931,1020,668,218,0,218,0,55,0,0,empty,mBC-0814-1
"D8,F6",4988,5237,3522,1715,3019,0,1666,1666,1224,442,2.769230769,852,2018,1468,425,1,424,1,87,0,0.002358491,empty,mBC-0814-1
"D8,F7",4644,5041,3422,1619,2933,0,1570,1572,1144,428,2.672897196,838,488,390,140,0,140,0,36,0,0,empty,mBC-0814-1
"D8,F8",6341,6915,4475,2440,3972,0,2123,2127,1528,599,2.550918197,1174,1563,643,187,0,187,0,23,0,0.155080214,empty,mBC-0814-1
"D8,F9",6194,6733,4490,2243,3886,0,2061,2061,1452,609,2.384236453,1098,2734,1768,554,0,554,0,101,0,0.023465704,empty,mBC-0814-1
"D8,F10",6986,7570,5071,2499,4425,0,2312,2315,1704,611,2.788870704,1237,1799,1216,384,0,384,0,72,0,0,empty,mBC-0814-1
"D8,F11",4488,4668,3227,1441,2755,0,1462,1466,985,481,2.047817048,758,1822,1288,330,0,330,0,60,0,0,empty,mBC-0814-1
"D8,F12",4904,5238,3601,1637,3099,0,1686,1694,1210,484,2.5,882,124,101,29,0,29,0,9,0,0,empty,mBC-0814-1
"D8,G1",614041,709731,414011,295720,416925,0,258144,258430,205503,52927,3.882763051,153389,242564,175674,50435,31,50404,3,2667,0,0.00063487,mm10,mBC-0814-1
"D8,G2",5872,6473,4160,2313,3756,0,2029,2031,1478,553,2.672694394,1072,2262,782,230,0,230,0,38,0,0,empty,mBC-0814-1
"D8,G3",5241,5728,3795,1933,3408,1,1838,1841,1336,505,2.645544554,975,1758,1178,461,0,461,0,101,0,0,empty,mBC-0814-1
"D8,G4",5253,5724,3828,1896,3299,3,1720,1725,1216,509,2.388998035,930,12,0,0,0,0,0,0,0,0,empty,mBC-0814-1
"D8,G5",4754,5452,3326,2126,3123,0,1760,1765,1274,491,2.594704684,1009,1507,1030,273,0,273,0,62,0,0.076923077,empty,mBC-0814-1
"D8,G6",8906,9549,6498,3051,5542,3,2915,2927,2139,788,2.714467005,1522,146,116,24,0,24,0,9,0,0,empty,mBC-0814-1
"D8,G7",5651,6063,4043,2020,3521,0,1890,1893,1353,540,2.505555556,997,2980,1812,514,0,514,0,100,0,0,empty,mBC-0814-1
"D8,G8",7317,7950,5216,2734,4716,0,2631,2635,1864,771,2.417639429,1423,3631,2384,712,0,712,0,137,0,0.008426966,empty,mBC-0814-1
"D8,G9",368857,429154,244124,185030,254990,0,158631,158773,133821,24952,5.363137223,95957,303633,219236,60758,31,60727,2,3104,0,0.00034581,mm10,mBC-0814-1
"D8,G10",9429,10015,6624,3391,5962,3,3244,3252,2299,953,2.412381952,1751,31411,9112,2885,8,2877,3,326,0,0.002085506,empty,mBC-0814-1
"D8,G11",9321,9907,6842,3065,5875,0,3070,3072,2222,850,2.614117647,1557,1325,831,263,0,263,0,60,0,0,empty,mBC-0814-1
"D8,G12",4849,5445,3427,2018,3194,0,1780,1780,1269,511,2.483365949,990,2308,1497,479,0,479,0,95,0,0,empty,mBC-0814-1
"D8,H1",4758,5180,3419,1761,3034,0,1658,1658,1156,502,2.302788845,885,782,480,186,0,186,0,41,0,0,empty,mBC-0814-1
"D8,H2",511674,604619,339588,265031,356694,0,226446,226719,191267,35452,5.395097597,137296,222261,162380,46345,29,46316,2,2573,0,0.000151136,mm10,mBC-0814-1
"D8,H3",448907,523591,291840,231751,310486,1,203467,203675,152505,51170,2.980359586,124787,19334,13140,3495,4,3491,1,458,0,0.000286451,mm10,mBC-0814-1
"D8,H4",5934,6224,4235,1989,3662,4,1976,1985,1398,587,2.381601363,999,90,53,27,0,27,0,13,0,0,empty,mBC-0814-1
"D8,H5",7063,7696,5102,2594,4448,0,2507,2516,1789,727,2.460797799,1336,2972,2066,533,0,533,0,71,0,0,empty,mBC-0814-1
"D8,H6",6298,6624,4554,2070,3898,0,2115,2116,1536,580,2.648275862,1088,2755,1943,501,0,501,0,96,0,0,empty,mBC-0814-1
"D8,H7",5662,5938,4008,1930,3528,0,1939,1942,1422,520,2.734615385,983,1531,1093,295,0,295,0,63,0,0,empty,mBC-0814-1
"D8,H8",4702,5121,3353,1768,2907,3,1599,1602,1133,469,2.415778252,853,1783,1210,391,0,391,0,94,0,0.002557545,empty,mBC-0814-1
"D8,H9",5373,5801,3852,1949,3463,0,1892,1896,1349,547,2.466179159,1032,963,702,211,0,211,0,43,0,0,empty,mBC-0814-1
"D8,H10",408361,457761,283889,173872,270746,1,160569,160742,121684,39058,3.115469302,92791,17781,12798,3588,1,3587,1,432,0,0.001115138,mm10,mBC-0814-1
"D8,H11",4192,4539,2927,1612,2708,2,1459,1465,1033,432,2.391203704,838,130,102,25,0,25,0,7,0,0,empty,mBC-0814-1
"D8,H12",2900,3135,2001,1134,1891,0,1037,1037,775,262,2.958015267,553,1558,1067,304,0,304,0,56,0,0,empty,mBC-0814-1
"D9,A1",5926,6386,4294,2092,3807,0,2067,2072,1478,594,2.488215488,1118,2118,1265,432,1,431,1,81,0,0.032482599,empty,mBC-0814-1
"D9,A2",6343,6775,4483,2292,3955,7,2137,2151,1575,576,2.734375,1105,1191,816,279,0,279,0,90,0,0.003584229,empty,mBC-0814-1
"D9,A3",4991,5507,3580,1927,3211,0,1773,1777,1280,497,2.575452716,980,1031,725,220,0,220,0,41,0,0,empty,mBC-0814-1
"D9,A4",5543,5897,4068,1829,3392,0,1783,1789,1337,452,2.957964602,919,2917,790,270,0,270,0,54,0,0.040740741,empty,mBC-0814-1
"D9,A5",5117,5683,3654,2029,3301,0,1792,1792,1268,524,2.419847328,987,1339,870,311,0,311,0,70,0,0,empty,mBC-0814-1
"D9,A6",515037,589450,350637,238813,343612,3,208533,208825,174953,33872,5.165121634,122024,201356,127187,36800,24,36776,3,2212,0,0.009136393,mm10,mBC-0814-1
"D9,A7",5938,6453,4229,2224,3823,0,2085,2092,1505,587,2.563884157,1128,1256,893,252,0,252,0,73,0,0,empty,mBC-0814-1
"D9,A8",250446,299196,162568,136628,179962,1,118000,118110,84910,33200,2.55753012,72956,85536,59115,16392,7,16385,2,1375,0,0.001098566,mm10,mBC-0814-1
"D9,A9",7106,7643,5123,2520,4365,0,2326,2330,1677,653,2.568147014,1225,3657,1215,377,0,377,0,83,0,0,empty,mBC-0814-1
"D9,A10",4127,4435,2897,1538,2572,0,1417,1420,1011,409,2.471882641,762,161,122,52,0,52,0,12,0,0,empty,mBC-0814-1
"D9,A11",606564,686445,407319,279126,405999,0,247105,247364,208123,39241,5.303712953,145031,237183,173260,48723,32,48691,3,2817,0,0.001088497,mm10,mBC-0814-1
"D9,A12",398650,452428,264661,187767,265700,0,164215,164430,135465,28965,4.676851372,97469,256841,168156,48307,34,48273,6,2689,0,0.003024465,mm10,mBC-0814-1
"D9,B1",5062,5651,3604,2047,3274,6,1800,1811,1270,541,2.347504621,1018,1248,713,239,0,239,0,62,0,0,empty,mBC-0814-1
"D9,B2",5066,5316,3569,1747,3135,5,1694,1706,1221,485,2.517525773,895,399,217,87,0,87,0,23,0,0,empty,mBC-0814-1
"D9,B3",4473,4902,3242,1660,2946,0,1647,1649,1185,464,2.55387931,891,1287,865,280,1,279,1,44,0,0,empty,mBC-0814-1
"D9,B4",4789,5276,3499,1777,3016,0,1676,1678,1198,480,2.495833333,875,978,674,160,0,160,0,45,0,0,empty,mBC-0814-1
"D9,B5",5480,4322,2635,1687,2911,0,1721,1725,1194,531,2.248587571,1025,1119,748,183,0,183,0,54,0,0.005464481,empty,mBC-0814-1
"D9,B6",4595,5090,3278,1812,2942,0,1619,1626,1116,510,2.188235294,895,1303,794,217,0,217,0,45,0,0.069124424,empty,mBC-0814-1
"D9,B7",5233,5430,3821,1609,3162,0,1665,1671,1230,441,2.789115646,847,1075,838,287,0,287,0,63,0,0,empty,mBC-0814-1
"D9,B8",4320,4605,3085,1520,2666,1,1401,1408,1029,379,2.715039578,752,1107,741,161,0,161,0,49,0,0.049689441,empty,mBC-0814-1
"D9,B9",5257,5803,3666,2137,3362,0,1883,1884,1406,478,2.941422594,1032,622,392,144,0,144,0,47,0,0,empty,mBC-0814-1
"D9,B10",283742,299665,184949,114716,185751,0,109424,109687,86320,23367,3.694098515,63784,5427,3472,853,3,850,1,124,0,0,empty,mBC-0814-1
"D9,B11",7749,8299,5466,2833,4773,0,2563,2567,1861,706,2.635977337,1360,932,423,146,0,146,0,22,0,0,empty,mBC-0814-1
"D9,B12",5772,6415,4116,2299,3748,0,2108,2110,1535,575,2.669565217,1156,1186,702,219,0,219,0,44,0,0,empty,mBC-0814-1
"D9,C1",5778,5981,4198,1783,3488,0,1787,1799,1267,532,2.381578947,878,825,634,178,2,176,1,36,0,0.011363636,empty,mBC-0814-1
"D9,C2",5564,5881,4017,1864,3523,0,1914,1916,1381,535,2.581308411,982,1788,1146,372,0,372,0,96,0,0,empty,mBC-0814-1
"D9,C3",6133,6669,4253,2416,3911,0,2124,2127,1544,583,2.648370497,1204,2851,873,300,1,299,1,49,0,0.010033445,empty,mBC-0814-1
"D9,C4",5812,6184,4123,2061,3708,0,2021,2030,1499,531,2.822975518,1100,1710,1061,365,1,364,1,81,0,0.005494505,empty,mBC-0814-1
"D9,C5",7809,8342,5637,2705,4895,0,2592,2596,1874,722,2.595567867,1384,1265,888,284,0,284,0,73,0,0,empty,mBC-0814-1
"D9,C6",5600,5877,4077,1800,3587,0,1936,1936,1392,544,2.558823529,975,9643,2695,909,0,909,0,133,0,0.112211221,empty,mBC-0814-1
"D9,C7",7126,7722,5115,2607,4477,0,2444,2449,1764,685,2.575182482,1294,339,236,79,0,79,0,22,0,0,empty,mBC-0814-1
"D9,C8",6126,6678,4503,2175,3855,0,2080,2084,1483,601,2.467554077,1099,2019,1340,423,0,423,0,84,0,0.063829787,empty,mBC-0814-1
"D9,C9",67616,89014,43671,45343,52045,0,37146,37189,18339,18850,0.972891247,23911,40977,17082,4996,4,4992,2,520,0,0.012620192,empty,mBC-0814-1
"D9,C10",5684,6060,4125,1935,3556,0,1893,1893,1369,524,2.61259542,970,1234,929,244,0,244,0,48,0,0,empty,mBC-0814-1
"D9,C11",4869,5234,3430,1804,3062,0,1694,1696,1207,489,2.468302658,893,1372,931,276,0,276,0,55,0,0,empty,mBC-0814-1
"D9,C12",9198,9842,6508,3334,5730,0,3173,3178,2277,901,2.527192009,1725,2097,1519,501,1,500,1,86,0,0.026,empty,mBC-0814-1
"D9,D1",5129,5482,3644,1838,3155,0,1717,1721,1242,479,2.592901879,912,3006,1107,370,0,370,0,60,0,0.010810811,empty,mBC-0814-1
"D9,D2",5337,5612,3856,1756,3268,1,1667,1668,1169,499,2.342685371,899,5042,1886,629,0,629,0,100,0,0.06200318,empty,mBC-0814-1
"D9,D3",11653,12409,8284,4125,7111,0,3861,3871,2748,1123,2.447016919,2017,2035,1264,423,0,423,0,101,0,0,empty,mBC-0814-1
"D9,D4",5367,5906,3631,2275,3514,0,2023,2026,1433,593,2.416526138,1155,16879,6124,1881,3,1878,1,203,0,0.14057508,empty,mBC-0814-1
"D9,D5",5417,5771,3841,1930,3482,0,1917,1922,1429,493,2.898580122,1006,2010,1466,428,0,428,0,96,0,0.042056075,empty,mBC-0814-1
"D9,D6",5060,5612,3624,1988,3265,4,1772,1776,1227,549,2.234972678,992,1491,1072,334,0,334,0,54,0,0,empty,mBC-0814-1
"D9,D7",367974,404970,247250,157720,238259,0,142426,142566,119918,22648,5.294860473,82062,108021,77075,22131,16,22115,1,1570,0,0.001446982,mm10,mBC-0814-1
"D9,D8",4997,5493,3546,1947,3156,0,1724,1726,1199,527,2.275142315,947,949,674,169,0,169,0,40,0,0.053254438,empty,mBC-0814-1
"D9,D9",3506,3766,2514,1252,2123,0,1126,1129,807,322,2.50621118,590,1283,932,226,0,226,0,49,0,0,empty,mBC-0814-1
"D9,D10",4224,4448,3041,1407,2642,0,1460,1461,1092,369,2.959349593,735,800,563,148,0,148,0,49,0,0,empty,mBC-0814-1
"D9,D11",4653,5226,3305,1921,3066,3,1706,1709,1237,472,2.620762712,971,2416,1835,491,0,491,0,110,0,0.099796334,empty,mBC-0814-1
"D9,D12",6903,7343,4943,2400,4293,0,2327,2334,1680,654,2.568807339,1229,2323,1642,497,0,497,0,95,0,0.002012072,empty,mBC-0814-1
"D9,E1",5454,5683,3848,1835,3352,0,1787,1789,1272,517,2.460348162,926,1441,1051,321,0,321,0,66,0,0.003115265,empty,mBC-0814-1
"D9,E2",4056,4416,2916,1500,2496,0,1387,1387,1022,365,2.8,734,1052,650,249,0,249,0,60,0,0,empty,mBC-0814-1
"D9,E3",492389,567059,333252,233807,333903,0,207365,207611,160252,47359,3.383770772,122290,128111,89922,25846,14,25832,2,1931,0,3.87117E-05,mm10,mBC-0814-1
"D9,E4",3359,3623,2410,1213,2074,4,1115,1119,820,299,2.742474916,566,1169,795,236,0,236,0,57,0,0,empty,mBC-0814-1
"D9,E5",3875,4016,2822,1194,2380,0,1283,1286,924,362,2.552486188,649,769,605,172,0,172,0,41,0,0,empty,mBC-0814-1
"D9,E6",4720,5041,3364,1677,2964,0,1528,1531,1079,452,2.387168142,834,1220,900,314,0,314,0,65,0,0,empty,mBC-0814-1
"D9,E7",5352,5643,3858,1785,3236,3,1688,1694,1263,431,2.930394432,875,1283,912,304,0,304,0,59,0,0,empty,mBC-0814-1
"D9,E8",4842,5198,3427,1771,2976,0,1587,1590,1165,425,2.741176471,844,2076,1381,382,1,381,1,68,0,0.031496063,empty,mBC-0814-1
"D9,E9",3655,3991,2623,1368,2363,0,1326,1326,992,334,2.97005988,703,1331,898,246,0,246,0,54,0,0,empty,mBC-0814-1
"D9,E10",4321,4807,3149,1658,2868,0,1568,1568,1141,427,2.672131148,872,1470,1016,380,0,380,0,89,0,0.007894737,empty,mBC-0814-1
"D9,E11",601022,689333,400513,288820,405031,0,253329,253599,201144,52455,3.834601087,149918,163030,116943,32360,13,32347,2,2196,0,0.000154574,mm10,mBC-0814-1
"D9,E12",4374,4839,3166,1673,2834,0,1551,1557,1048,509,2.058939096,834,903,531,171,0,171,0,51,0,0,empty,mBC-0814-1
"D9,F1",5185,5583,3797,1786,3242,0,1744,1747,1218,529,2.302457467,916,1423,1030,286,0,286,0,64,0,0,empty,mBC-0814-1
"D9,F2",6973,7435,4946,2489,4344,0,2429,2432,1782,650,2.741538462,1270,1867,1382,475,0,475,0,109,0,0,empty,mBC-0814-1
"D9,F3",5423,5917,3958,1959,3322,0,1821,1825,1353,472,2.866525424,911,1559,1159,374,0,374,0,76,0,0,empty,mBC-0814-1
"D9,F4",5823,6269,4160,2109,3763,0,2013,2016,1489,527,2.825426945,1103,464,341,112,0,112,0,29,0,0,empty,mBC-0814-1
"D9,F5",5431,5866,3900,1966,3452,0,1845,1846,1345,501,2.684630739,1016,1139,788,230,0,230,0,60,0,0,empty,mBC-0814-1
"D9,F6",547238,642087,359275,282812,377767,1,242219,242480,187151,55329,3.382511883,147824,150783,106182,30176,23,30153,1,2097,0,0.000464299,mm10,mBC-0814-1
"D9,F7",4826,5174,3449,1725,2948,0,1593,1596,1129,467,2.417558887,859,334,165,67,0,67,0,28,0,0,empty,mBC-0814-1
"D9,F8",6486,6935,4614,2321,4090,0,2274,2276,1653,623,2.65329053,1214,134,58,24,0,24,0,13,0,0,empty,mBC-0814-1
"D9,F9",6111,6364,4412,1952,3712,0,1953,1955,1410,545,2.587155963,1025,1849,1350,408,0,408,0,79,0,0.00245098,empty,mBC-0814-1
"D9,F10",6789,7408,4948,2460,4312,0,2309,2309,1695,614,2.760586319,1211,1474,1030,336,1,335,1,57,0,0,empty,mBC-0814-1
"D9,F11",1532521,1733776,1030672,703104,999919,3,623390,624134,489697,134437,3.642576077,365209,437984,315484,91291,50,91241,7,4153,0,0.00019728,mm10,mBC-0814-1
"D9,F12",5168,5521,3747,1774,3218,0,1811,1815,1296,519,2.497109827,958,109,60,19,0,19,0,6,0,0,empty,mBC-0814-1
"D9,G1",7953,8578,5814,2764,5076,0,2722,2731,1917,814,2.355036855,1445,2859,1614,538,0,538,0,158,0,0,empty,mBC-0814-1
"D9,G2",5855,5984,4199,1785,3522,0,1829,1829,1329,500,2.658,923,428,308,103,0,103,0,19,0,0,empty,mBC-0814-1
"D9,G3",5616,5837,4129,1708,3424,1,1804,1809,1311,498,2.63253012,885,2237,1531,499,0,499,0,106,0,0,empty,mBC-0814-1
"D9,G4",5366,5764,3850,1914,3320,0,1771,1777,1306,471,2.772823779,930,13,13,2,0,2,0,2,0,0,empty,mBC-0814-1
"D9,G5",5100,5395,3598,1797,3157,0,1668,1674,1202,472,2.546610169,906,1023,733,226,0,226,0,56,0,0,empty,mBC-0814-1
"D9,G6",484706,528463,337117,191346,311550,1,179157,179365,141761,37604,3.769838315,101004,1174,767,262,0,262,0,50,0,0,empty,mBC-0814-1
"D9,G7",5881,6104,4110,1994,3597,0,1948,1952,1422,530,2.683018868,1042,1846,1372,419,0,419,0,81,0,0.026252983,empty,mBC-0814-1
"D9,G8",497549,584390,326600,257790,341795,1,217915,218129,168700,49429,3.412976188,132652,234479,161400,46468,27,46441,3,2641,0,0.005469305,mm10,mBC-0814-1
"D9,G9",6062,6526,4381,2145,3893,0,2174,2178,1573,605,2.6,1177,2549,1796,534,1,533,1,122,0,0.060037523,empty,mBC-0814-1
"D9,G10",9812,10876,7071,3805,6336,1,3407,3409,2440,969,2.518059856,1844,2752,2009,663,0,663,0,127,0,0,empty,mBC-0814-1
"D9,G11",9761,10420,7086,3334,6142,0,3259,3265,2364,901,2.623751387,1689,1285,905,291,0,291,0,71,0,0.065292096,empty,mBC-0814-1
"D9,G12",5368,5787,3752,2035,3502,0,1961,1965,1409,556,2.534172662,1071,10624,3812,1203,1,1202,1,164,0,0.081530782,empty,mBC-0814-1
"D9,H1",4889,5407,3491,1916,3060,0,1673,1673,1221,452,2.701327434,924,977,673,201,0,201,0,51,0,0,empty,mBC-0814-1
"D9,H2",8795,9442,6317,3125,5474,0,2993,2999,2109,890,2.369662921,1594,24088,7696,2299,3,2296,2,294,0,0.013937282,empty,mBC-0814-1
"D9,H3",6246,6917,4473,2444,3975,0,2229,2231,1638,593,2.76222597,1208,1383,967,311,0,311,0,73,0,0.025723473,empty,mBC-0814-1
"D9,H4",6134,6811,4309,2502,3934,0,2202,2211,1555,656,2.370426829,1227,91,72,23,0,23,0,9,0,0,empty,mBC-0814-1
"D9,H5",6903,7660,4906,2754,4472,0,2479,2484,1780,704,2.528409091,1389,2386,1789,461,0,461,0,77,0,0.023861171,empty,mBC-0814-1
"D9,H6",6878,7530,4889,2641,4353,0,2415,2415,1738,677,2.567208272,1329,2326,1588,429,0,429,0,98,0,0.034965035,empty,mBC-0814-1
"D9,H7",5734,6278,4147,2131,3703,0,2035,2038,1469,569,2.58172232,1116,1517,999,340,0,340,0,65,0,0,empty,mBC-0814-1
"D9,H8",4925,5211,3581,1630,3013,0,1582,1584,1164,420,2.771428571,835,1852,1361,444,1,443,1,91,0,0,empty,mBC-0814-1
"D9,H9",5464,5934,3979,1955,3429,0,1859,1860,1340,520,2.576923077,957,907,604,194,0,194,0,49,0,0,empty,mBC-0814-1
"D9,H10",3943,4220,2825,1395,2466,0,1332,1332,943,389,2.424164524,709,923,620,199,0,199,0,41,0,0,empty,mBC-0814-1
"D9,H11",4401,4733,3122,1611,2768,0,1524,1531,1098,433,2.535796767,816,56,34,19,0,19,0,9,0,0,empty,mBC-0814-1
"D9,H12",3543,4018,2507,1511,2381,0,1386,1387,998,389,2.565552699,804,1511,1129,342,0,342,0,58,0,0,empty,mBC-0814-1
"D10,A1",5941,6533,4299,2234,3840,0,2094,2095,1524,571,2.669001751,1127,1373,955,308,0,308,0,62,0,0,empty,mBC-0814-1
"D10,A2",5999,6414,4326,2088,3759,0,1958,1958,1466,492,2.979674797,1012,1773,1277,445,0,445,0,117,0,0,empty,mBC-0814-1
"D10,A3",4885,5347,3524,1823,3168,0,1690,1694,1243,451,2.756097561,928,2368,1027,341,0,341,0,65,0,0.079178886,empty,mBC-0814-1
"D10,A4",5891,6155,4232,1923,3593,0,1894,1896,1360,536,2.537313433,986,598,390,157,0,157,0,31,0,0,empty,mBC-0814-1
"D10,A5",4977,5419,3608,1811,3250,0,1773,1773,1284,489,2.625766871,967,1669,1066,324,0,324,0,59,0,0,empty,mBC-0814-1
"D10,A6",11163,12916,7572,5344,7808,0,4695,4702,3697,1005,3.678606965,2775,2182,1487,444,0,444,0,62,0,0.027027027,empty,mBC-0814-1
"D10,A7",5791,6429,4096,2333,3816,0,2127,2127,1476,651,2.267281106,1204,1504,1035,333,0,333,0,93,0,0.063063063,empty,mBC-0814-1
"D10,A8",2324,2676,1664,1012,1611,0,916,917,644,273,2.358974359,508,3946,1978,638,2,636,1,100,0,0.04245283,empty,mBC-0814-1
"D10,A9",7029,7436,5072,2364,4289,0,2228,2229,1593,636,2.504716981,1135,1644,1086,349,1,348,1,68,0,0.005747126,empty,mBC-0814-1
"D10,A10",756933,872399,500410,371989,517074,0,326892,327240,265196,62044,4.274321449,195311,61500,43365,12171,12,12159,2,1093,0,0,mm10,mBC-0814-1
"D10,A11",5143,5547,3695,1852,3297,1,1760,1768,1277,491,2.600814664,958,1893,1356,448,0,448,0,97,0,0.002232143,empty,mBC-0814-1
"D10,A12",326111,369092,216834,152258,218690,1,135332,135509,103609,31900,3.247931034,80034,253001,181322,50426,29,50397,5,2742,0,0.000317479,mm10,mBC-0814-1
"D10,B1",552048,631592,367226,264366,370461,1,226800,227093,181790,45303,4.012758537,134215,327025,228138,64393,49,64344,6,3174,0,0.001087903,mm10,mBC-0814-1
"D10,B2",5277,5532,3693,1839,3273,0,1791,1792,1309,483,2.710144928,940,538,341,111,0,111,0,29,0,0.027027027,empty,mBC-0814-1
"D10,B3",4482,4808,3149,1659,2871,0,1606,1606,1140,466,2.446351931,864,1197,935,297,0,297,0,57,0,0,empty,mBC-0814-1
"D10,B4",4775,5063,3367,1696,3032,1,1704,1706,1234,472,2.61440678,883,1175,775,232,1,231,1,61,0,0,empty,mBC-0814-1
"D10,B5",3988,2640,1645,995,1889,0,1073,1085,727,358,2.030726257,623,947,639,176,0,176,0,51,0,0,empty,mBC-0814-1
"D10,B6",488511,584450,316380,268070,344797,0,222110,222299,184396,37903,4.864944727,136660,170455,121906,33838,18,33820,3,2275,0,0.001094027,mm10,mBC-0814-1
"D10,B7",5309,5741,3855,1886,3458,0,1865,1867,1360,507,2.682445759,989,1009,664,215,0,215,0,55,0,0,empty,mBC-0814-1
"D10,B8",3985,4332,2915,1417,2530,0,1355,1359,959,400,2.3975,696,6458,2031,657,3,654,2,97,0,0.068807339,empty,mBC-0814-1
"D10,B9",5451,5875,3951,1924,3475,0,1908,1908,1392,516,2.697674419,987,538,386,147,0,147,0,63,0,0,empty,mBC-0814-1
"D10,B10",4581,4758,3177,1581,2829,0,1503,1504,1060,444,2.387387387,768,392,269,100,0,100,0,24,0,0,empty,mBC-0814-1
"D10,B11",6909,7535,4903,2632,4344,0,2340,2342,1638,704,2.326704545,1308,107,73,31,0,31,0,14,0,0,empty,mBC-0814-1
"D10,B12",511760,594598,339889,254709,353418,0,221931,222185,186194,35991,5.173348893,133305,88018,63860,17253,14,17239,1,1358,0,0.000522072,mm10,mBC-0814-1
"D10,C1",6087,6295,4342,1953,3694,0,1916,1919,1373,546,2.514652015,987,646,439,164,0,164,0,52,0,0,empty,mBC-0814-1
"D10,C2",5746,6282,4119,2163,3721,0,2009,2014,1500,514,2.918287938,1115,2115,1449,460,0,460,0,100,0,0.002173913,empty,mBC-0814-1
"D10,C3",6237,6585,4558,2027,3927,0,2123,2125,1517,608,2.495065789,1102,613,370,115,1,114,1,28,0,0,empty,mBC-0814-1
"D10,C4",5705,6026,4133,1893,3530,0,1828,1828,1333,495,2.692929293,931,1594,1101,352,1,351,1,88,0,0,empty,mBC-0814-1
"D10,C5",702918,808666,476560,332106,472052,0,287321,287602,230156,57446,4.006475647,168927,274234,189927,54047,39,54008,1,2902,0,0.00298104,mm10,mBC-0814-1
"D10,C6",5884,6014,4139,1875,3684,0,2008,2010,1457,553,2.634719711,1018,984,649,205,0,205,0,62,0,0,empty,mBC-0814-1
"D10,C7",7669,8362,5500,2862,4781,0,2577,2582,1818,764,2.379581152,1358,342,237,90,0,90,0,25,0,0,empty,mBC-0814-1
"D10,C8",6186,6670,4406,2264,3882,0,2087,2089,1444,645,2.23875969,1118,2226,1598,409,0,409,0,100,0,0,empty,mBC-0814-1
"D10,C9",5373,5854,3786,2068,3419,0,1929,1929,1443,486,2.969135802,1048,885,666,152,0,152,0,48,0,0.039473684,empty,mBC-0814-1
"D10,C10",6007,6478,4348,2130,3723,0,1951,1958,1399,559,2.502683363,1031,13383,3996,1289,1,1288,1,138,0,0.059006211,empty,mBC-0814-1
"D10,C11",539516,616792,367133,249659,364761,0,222612,222877,190944,31933,5.979519619,130891,137117,87303,24577,25,24552,4,1825,0,0.001792115,mm10,mBC-0814-1
"D10,C12",8848,9545,6317,3228,5532,5,3020,3028,2115,913,2.316538883,1616,2103,1557,412,0,412,0,86,0,0.002427184,empty,mBC-0814-1
"D10,D1",4969,5233,3536,1697,3105,2,1707,1709,1202,507,2.370808679,911,3108,889,275,0,275,0,55,0,0.032727273,empty,mBC-0814-1
"D10,D2",5259,5602,3910,1692,3350,0,1742,1744,1205,539,2.235621521,902,1545,1136,363,0,363,0,83,0,0.005509642,empty,mBC-0814-1
"D10,D3",11448,12181,8123,4058,7131,0,3905,3917,2751,1166,2.359348199,2085,2578,1838,440,1,439,1,97,0,0,empty,mBC-0814-1
"D10,D4",475992,577670,308885,268785,344971,0,227331,227555,176376,51179,3.446257254,142075,143187,103686,28709,18,28691,1,1890,0,0.000557666,mm10,mBC-0814-1
"D10,D5",5221,5629,3633,1996,3376,3,1913,1920,1374,546,2.516483516,1045,6933,2208,687,1,686,1,127,0,0.023323615,empty,mBC-0814-1
"D10,D6",5175,5665,3761,1904,3252,4,1744,1748,1250,498,2.510040161,906,1724,1215,377,0,377,0,68,0,0.00530504,empty,mBC-0814-1
"D10,D7",6248,6676,4477,2199,3955,0,2141,2145,1576,569,2.769771529,1144,1848,1121,354,0,354,0,106,0,0.048022599,empty,mBC-0814-1
"D10,D8",618895,729467,412707,316760,427722,4,270490,270792,216594,54198,3.996346729,162797,149955,111457,30260,19,30241,1,2106,0,0.000297609,mm10,mBC-0814-1
"D10,D9",3469,3863,2431,1432,2337,0,1280,1282,902,380,2.373684211,745,24729,7656,2183,1,2182,1,224,0,0.017415215,empty,mBC-0814-1
"D10,D10",4080,4475,2880,1595,2672,0,1508,1509,1080,429,2.517482517,861,941,671,178,0,178,0,42,0,0,empty,mBC-0814-1
"D10,D11",5326,5800,3825,1975,3379,0,1847,1850,1282,568,2.257042254,977,3796,2817,809,0,809,0,149,0,0,empty,mBC-0814-1
"D10,D12",6838,7507,4849,2658,4322,0,2391,2393,1680,713,2.356241234,1312,2775,1982,598,1,597,1,119,0,0.031825796,empty,mBC-0814-1
"D10,E1",5393,5746,4042,1704,3349,0,1712,1712,1274,438,2.908675799,822,2081,1415,377,0,377,0,75,0,0.00795756,empty,mBC-0814-1
"D10,E2",4023,4397,2830,1567,2535,0,1407,1409,995,414,2.403381643,780,987,698,187,0,187,0,61,0,0.096256684,empty,mBC-0814-1
"D10,E3",3645,3911,2593,1318,2379,0,1256,1260,904,356,2.539325843,695,1356,966,299,0,299,0,73,0,0,empty,mBC-0814-1
"D10,E4",3206,3587,2301,1286,2083,0,1144,1147,825,322,2.562111801,609,811,582,207,0,207,0,60,0,0,empty,mBC-0814-1
"D10,E5",4018,4294,2933,1361,2497,0,1318,1322,965,357,2.703081232,704,845,611,192,0,192,0,40,0,0,empty,mBC-0814-1
"D10,E6",4717,5229,3359,1870,2984,2,1577,1582,1168,414,2.821256039,880,1313,874,278,0,278,0,67,0,0.028776978,empty,mBC-0814-1
"D10,E7",636828,738572,429037,309535,431447,0,269358,269722,224130,45592,4.915994034,160093,148413,101046,28835,23,28812,3,1913,0,0.002186589,mm10,mBC-0814-1
"D10,E8",4918,5149,3601,1548,3054,1,1603,1606,1190,416,2.860576923,761,2023,1460,419,0,419,0,88,0,0,empty,mBC-0814-1
"D10,E9",3781,3964,2728,1236,2333,0,1270,1275,900,375,2.4,667,1585,1040,302,0,302,0,69,0,0,empty,mBC-0814-1
"D10,E10",4446,4829,3208,1621,2770,0,1500,1500,1098,402,2.731343284,812,1475,1085,337,0,337,0,79,0,0,empty,mBC-0814-1
"D10,E11",4742,5057,3408,1649,3022,0,1601,1605,1135,470,2.414893617,838,1447,949,285,0,285,0,61,0,0,empty,mBC-0814-1
"D10,E12",533372,607524,367035,240489,362123,0,221676,221899,164277,57622,2.850942348,130705,15492,10914,2965,2,2963,1,374,0,0,mm10,mBC-0814-1
"D10,F1",4938,5440,3532,1908,3204,0,1691,1693,1214,479,2.534446764,938,1736,1270,373,0,373,0,69,0,0.032171582,empty,mBC-0814-1
"D10,F2",6721,7283,4968,2315,4252,0,2299,2303,1660,643,2.581648523,1137,1813,1264,420,0,420,0,104,0,0.00952381,empty,mBC-0814-1
"D10,F3",5497,5958,4046,1912,3510,0,1873,1877,1369,508,2.69488189,934,1612,1249,383,0,383,0,80,0,0,empty,mBC-0814-1
"D10,F4",5783,6037,4147,1890,3697,1,1966,1971,1474,497,2.965794769,1037,411,268,94,0,94,0,27,0,0,empty,mBC-0814-1
"D10,F5",5599,6184,4041,2143,3641,0,1989,1995,1426,569,2.506151142,1081,769,518,192,0,192,0,68,0,0.010416667,empty,mBC-0814-1
"D10,F6",6517,7174,4572,2602,4207,0,2411,2415,1841,574,3.207317073,1302,1787,1105,363,0,363,0,104,0,0.008264463,empty,mBC-0814-1
"D10,F7",4710,4894,3420,1474,2875,0,1508,1510,1061,449,2.363028953,779,714,555,183,0,183,0,50,0,0,empty,mBC-0814-1
"D10,F8",6588,7140,4648,2492,4221,0,2367,2369,1714,655,2.616793893,1292,341,245,60,0,60,0,16,0,0,empty,mBC-0814-1
"D10,F9",6047,6640,4269,2371,3805,1,2062,2071,1466,605,2.423140496,1139,1535,1096,319,0,319,0,77,0,0,empty,mBC-0814-1
"D10,F10",6835,7413,4913,2500,4394,0,2392,2393,1662,731,2.273597811,1313,3636,1833,554,0,554,0,91,0,0,empty,mBC-0814-1
"D10,F11",4497,4911,3256,1655,2843,0,1520,1525,1081,444,2.434684685,810,1648,1071,292,0,292,0,68,0,0,empty,mBC-0814-1
"D10,F12",542641,636014,354737,281277,372195,1,242527,242766,171162,71604,2.390397185,147797,6510,4893,1345,1,1344,1,177,0,0,mm10,mBC-0814-1
"D10,G1",7966,8422,5779,2643,5081,0,2730,2739,1978,761,2.599211564,1435,2453,1731,571,1,570,1,126,0,0,empty,mBC-0814-1
"D10,G2",6126,6495,4349,2146,3872,0,2128,2130,1546,584,2.647260274,1149,571,408,146,0,146,0,29,0,0.082191781,empty,mBC-0814-1
"D10,G3",5389,5835,3774,2061,3458,0,1947,1953,1394,559,2.493738819,1045,2216,1615,461,0,461,0,120,0,0.002169197,empty,mBC-0814-1
"D10,G4",5758,5974,4144,1830,3437,4,1808,1812,1301,511,2.545988258,919,2,1,1,0,1,0,1,0,0,empty,mBC-0814-1
"D10,G5",5084,5456,3680,1776,3173,0,1660,1663,1186,477,2.486373166,910,1358,971,367,0,367,0,83,0,0,empty,mBC-0814-1
"D10,G6",724173,833282,487089,346193,486264,0,303114,303414,249140,54274,4.590411615,179387,7939,5760,1711,1,1710,1,224,0,0,mm10,mBC-0814-1
"D10,G7",5826,6306,4172,2134,3726,0,1959,1961,1384,577,2.398613518,1051,4119,2114,688,2,686,1,135,0,0,empty,mBC-0814-1
"D10,G8",8153,8997,5714,3283,5323,6,2935,2952,2080,872,2.385321101,1648,5487,2824,921,1,920,1,188,0,0.036956522,empty,mBC-0814-1
"D10,G9",5830,6427,4081,2346,3883,0,2182,2185,1600,585,2.735042735,1235,4517,2417,710,2,708,1,140,0,0.032485876,empty,mBC-0814-1
"D10,G10",1140529,1288169,761476,526693,753343,0,467309,467905,396942,70963,5.593647394,274725,409878,296643,84150,57,84093,4,3605,0,0.000309182,mm10,mBC-0814-1
"D10,G11",9911,10362,7152,3210,6105,1,3187,3190,2254,936,2.408119658,1655,1079,772,236,0,236,0,66,0,0.012711864,empty,mBC-0814-1
"D10,G12",5205,5719,3645,2074,3352,0,1807,1811,1301,510,2.550980392,1010,1611,1139,348,0,348,0,92,0,0,empty,mBC-0814-1
"D10,H1",5140,5542,3656,1886,3334,0,1817,1818,1260,558,2.258064516,976,783,518,179,0,179,0,46,0,0.005586592,empty,mBC-0814-1
"D10,H2",8665,9266,6186,3080,5515,0,3069,3075,2207,868,2.542626728,1621,3554,2488,752,0,752,0,152,0,0,empty,mBC-0814-1
"D10,H3",6136,6692,4344,2348,4010,0,2235,2241,1574,667,2.35982009,1246,1708,1197,405,0,405,0,79,0,0.009876543,empty,mBC-0814-1
"D10,H4",6239,6808,4369,2439,4016,0,2318,2318,1587,731,2.170998632,1278,710,269,84,0,84,0,17,0,0.023809524,empty,mBC-0814-1
"D10,H5",7097,7687,5141,2546,4376,0,2358,2358,1693,665,2.545864662,1249,2050,1489,490,1,489,1,77,0,0,empty,mBC-0814-1
"D10,H6",6693,7118,4914,2204,4188,1,2220,2227,1577,650,2.426153846,1169,2240,1582,426,1,425,1,106,0,0.009411765,empty,mBC-0814-1
"D10,H7",1589070,1818950,1060301,758649,1063705,3,678113,678806,546262,132544,4.121363472,403897,315543,221624,62663,46,62617,5,3333,0,0.000590894,mm10,mBC-0814-1
"D10,H8",412660,474814,276052,198762,282408,1,179254,179492,139100,40392,3.443751238,107179,21346,14375,4167,2,4165,1,527,0,0.000960384,mm10,mBC-0814-1
"D10,H9",5291,5593,3734,1859,3296,0,1789,1791,1257,534,2.353932584,954,1206,769,272,0,272,0,55,0,0,empty,mBC-0814-1
"D10,H10",3802,4035,2668,1367,2445,0,1378,1380,1001,379,2.64116095,730,824,617,152,0,152,0,38,0,0,empty,mBC-0814-1
"D10,H11",803209,961355,528336,433019,569426,1,368926,369286,295039,74247,3.973749781,227168,13252,8579,2484,2,2482,1,331,0,0,mm10,mBC-0814-1
"D10,H12",3275,3590,2272,1318,2195,0,1234,1237,907,330,2.748484848,709,1170,720,234,0,234,0,64,0,0,empty,mBC-0814-1
"D11,A1",5296,5776,3769,2007,3517,0,1913,1916,1360,556,2.446043165,1067,1474,1001,289,0,289,0,60,0,0.051903114,empty,mBC-0814-1
"D11,A2",5019,5339,3560,1779,3240,0,1689,1694,1249,445,2.806741573,912,2713,1063,443,1,442,1,100,0,0.002262443,empty,mBC-0814-1
"D11,A3",4460,4726,3181,1545,2762,0,1455,1456,1083,373,2.903485255,744,960,695,227,0,227,0,48,0,0.101321586,empty,mBC-0814-1
"D11,A4",5453,5865,3887,1978,3413,0,1885,1887,1366,521,2.621880998,1011,560,395,105,0,105,0,25,0,0,empty,mBC-0814-1
"D11,A5",4598,4941,3313,1628,2853,3,1551,1556,1112,444,2.504504505,793,905,697,172,0,172,0,45,0,0,empty,mBC-0814-1
"D11,A6",9402,10619,6584,4035,6391,0,3756,3762,2902,860,3.374418605,2101,1172,890,256,0,256,0,61,0,0,empty,mBC-0814-1
"D11,A7",563409,646548,375472,271076,383431,0,238268,238538,191717,46821,4.094679738,141644,125108,90323,25169,17,25152,2,1795,0,0.000397583,mm10,mBC-0814-1
"D11,A8",5325,5173,3135,2038,3121,0,1853,1855,1232,623,1.97752809,1086,1302,900,244,0,244,0,59,0,0,empty,mBC-0814-1
"D11,A9",5908,6200,4143,2057,3708,0,2003,2003,1413,590,2.394915254,1066,718,494,160,1,159,1,39,0,0,empty,mBC-0814-1
"D11,A10",3096,3310,2219,1091,1997,0,1084,1084,769,315,2.441269841,546,57,33,21,0,21,0,12,0,0,empty,mBC-0814-1
"D11,A11",4183,4496,2944,1552,2699,0,1451,1454,1058,396,2.671717172,816,2866,1685,602,0,602,0,82,0,0.164451827,empty,mBC-0814-1
"D11,A12",3765,4178,2675,1503,2423,0,1341,1344,973,371,2.622641509,748,2304,1732,621,1,620,1,147,0,0.012903226,empty,mBC-0814-1
"D11,B1",4429,4755,3164,1591,2825,0,1519,1519,1032,487,2.119096509,799,10856,3450,1030,6,1024,2,158,0,0.001953125,empty,mBC-0814-1
"D11,B2",4353,4581,3057,1524,2775,0,1489,1493,1048,445,2.35505618,815,282,211,80,0,80,0,23,0,0,empty,mBC-0814-1
"D11,B3",3670,3988,2590,1398,2341,0,1315,1316,966,350,2.76,713,835,539,184,0,184,0,46,0,0.016304348,empty,mBC-0814-1
"D11,B4",3990,4341,2774,1567,2533,0,1411,1413,1032,381,2.708661417,753,1039,686,197,0,197,0,49,0,0.065989848,empty,mBC-0814-1
"D11,B5",3362,2234,1431,803,1561,1,890,893,638,255,2.501960784,495,1012,629,218,0,218,0,50,0,0,empty,mBC-0814-1
"D11,B6",3789,4096,2735,1361,2366,0,1285,1286,914,372,2.456989247,680,2986,926,330,1,329,1,59,0,0.088145897,empty,mBC-0814-1
"D11,B7",6925,7536,5102,2434,4458,0,2427,2429,1803,626,2.880191693,1292,1403,1011,300,0,300,0,69,0,0.003333333,empty,mBC-0814-1
"D11,B8",3485,3775,2459,1316,2228,0,1183,1185,867,318,2.726415094,652,1073,764,218,0,218,0,44,0,0,empty,mBC-0814-1
"D11,B9",4337,4759,3111,1648,2830,0,1572,1572,1155,417,2.769784173,818,617,423,145,0,145,0,58,0,0,empty,mBC-0814-1
"D11,B10",3863,4014,2714,1300,2520,1,1381,1387,977,410,2.382926829,758,474,290,76,0,76,0,17,0,0,empty,mBC-0814-1
"D11,B11",8891,10083,6229,3854,6092,0,3516,3526,2744,782,3.508951407,2012,77,16,9,0,9,0,6,0,0,empty,mBC-0814-1
"D11,B12",5161,5339,3570,1769,3117,5,1709,1714,1180,534,2.209737828,859,22751,6159,1911,5,1906,3,175,0,0.089192025,empty,mBC-0814-1
"D11,C1",5208,5453,3817,1636,3183,0,1644,1651,1189,462,2.573593074,831,5537,1810,575,1,574,1,90,0,0.057491289,empty,mBC-0814-1
"D11,C2",4975,5285,3543,1742,3102,0,1634,1634,1148,486,2.362139918,875,1220,771,278,0,278,0,81,0,0,empty,mBC-0814-1
"D11,C3",6796,7367,4787,2580,4473,0,2532,2534,1850,684,2.704678363,1375,355,235,74,1,73,1,31,0,0,empty,mBC-0814-1
"D11,C4",4563,4812,3323,1489,2870,0,1505,1506,1108,398,2.783919598,757,1053,765,228,0,228,0,65,0,0,empty,mBC-0814-1
"D11,C5",6532,6957,4702,2255,4201,0,2229,2229,1655,574,2.883275261,1164,1764,1363,392,0,392,0,90,0,0.022959184,empty,mBC-0814-1
"D11,C6",1164513,1339337,777145,562192,799009,1,504801,505303,407600,97703,4.171826863,299257,222481,161227,45428,27,45401,4,2490,0,0.000286337,mm10,mBC-0814-1
"D11,C7",6362,6771,4530,2241,3994,0,2179,2181,1564,617,2.534846029,1167,225,168,72,0,72,0,21,0,0.055555556,empty,mBC-0814-1
"D11,C8",5019,5249,3606,1643,3169,0,1702,1702,1241,461,2.69197397,874,2112,1469,403,0,403,0,95,0,0,empty,mBC-0814-1
"D11,C9",4180,4491,3023,1468,2578,3,1380,1384,1001,383,2.613577023,730,1015,637,181,0,181,0,46,0,0,empty,mBC-0814-1
"D11,C10",5465,5776,3941,1835,3381,0,1877,1883,1358,525,2.586666667,979,6569,2013,637,1,636,1,84,0,0.056603774,empty,mBC-0814-1
"D11,C11",4382,4656,3176,1480,2753,8,1515,1526,1088,438,2.484018265,805,921,640,212,1,211,1,47,0,0,empty,mBC-0814-1
"D11,C12",7592,8355,5380,2975,4825,0,2698,2702,1889,813,2.323493235,1445,2202,1543,383,0,383,0,68,0,0,empty,mBC-0814-1
"D11,D1",4126,4342,2990,1352,2569,0,1350,1353,991,362,2.737569061,684,435,278,108,0,108,0,31,0,0,empty,mBC-0814-1
"D11,D2",4639,4848,3400,1448,2869,0,1452,1452,1046,406,2.57635468,741,2225,1502,452,0,452,0,97,0,0,empty,mBC-0814-1
"D11,D3",10054,10897,7219,3678,6445,0,3498,3508,2563,945,2.712169312,1889,21298,6522,2151,7,2144,1,233,0,0.054570896,empty,mBC-0814-1
"D11,D4",4868,5442,3456,1986,3278,0,1849,1849,1334,515,2.590291262,1048,859,527,179,0,179,0,69,0,0,empty,mBC-0814-1
"D11,D5",4015,4313,2803,1510,2610,0,1509,1511,1106,405,2.730864198,813,1441,918,296,0,296,0,80,0,0,empty,mBC-0814-1
"D11,D6",4566,4842,3292,1550,2855,0,1554,1556,1125,431,2.610208817,807,989,629,202,0,202,0,47,0,0,empty,mBC-0814-1
"D11,D7",406856,474990,266324,208666,283418,8,180292,180453,146936,33517,4.383924576,109380,259296,183055,51511,23,51488,2,2842,0,0.001009944,mm10,mBC-0814-1
"D11,D8",4880,5180,3471,1709,3113,1,1681,1685,1209,476,2.539915966,897,2490,915,304,0,304,0,56,0,0.013157895,empty,mBC-0814-1
"D11,D9",3063,3449,2113,1336,2035,0,1178,1178,834,344,2.424418605,706,998,667,198,0,198,0,44,0,0.03030303,empty,mBC-0814-1
"D11,D10",844106,974243,563460,410783,574208,3,356520,356917,293578,63339,4.635027392,212727,143560,101460,28922,20,28902,3,1990,0,0,mm10,mBC-0814-1
"D11,D11",449746,525281,299647,225634,312349,0,194410,194636,165279,29357,5.629969002,116269,233045,170161,45950,24,45926,6,2588,0,0.00089274,mm10,mBC-0814-1
"D11,D12",6133,6577,4208,2369,3878,0,2175,2180,1548,632,2.449367089,1208,23877,7655,2456,2,2454,1,259,0,0.124694377,empty,mBC-0814-1
"D11,E1",4681,4890,3489,1401,2849,0,1458,1462,1064,398,2.673366834,694,1497,1061,363,0,363,0,70,0,0.071625344,empty,mBC-0814-1
"D11,E2",3356,3552,2416,1136,2136,0,1131,1133,791,342,2.312865497,632,950,731,193,0,193,0,53,0,0,empty,mBC-0814-1
"D11,E3",3166,3448,2289,1159,2036,0,1096,1096,756,340,2.223529412,587,922,698,228,0,228,0,47,0,0,empty,mBC-0814-1
"D11,E4",2847,2923,2062,861,1743,0,899,901,638,263,2.425855513,433,892,519,135,0,135,0,43,0,0,empty,mBC-0814-1
"D11,E5",17140,18345,12533,5812,10670,0,5477,5485,4354,1131,3.849690539,2882,3467,2288,694,0,694,0,135,0,0,empty,mBC-0814-1
"D11,E6",4094,4155,2926,1229,2384,0,1241,1241,896,345,2.597101449,607,909,638,204,0,204,0,51,0,0,empty,mBC-0814-1
"D11,E7",528902,609413,353076,256337,358917,0,222370,222654,178611,44043,4.055377699,132583,199904,138572,37997,14,37983,1,2301,0,0.000605534,mm10,mBC-0814-1
"D11,E8",483985,541093,328519,212574,322472,1,195946,196146,131343,64803,2.026804315,113318,72210,51186,14135,14,14121,3,1448,0,0,mm10,mBC-0814-1
"D11,E9",419804,467920,278725,189195,276873,0,168711,168871,139732,29139,4.79536017,98767,143862,102488,28451,22,28429,3,1910,0,0.000809033,mm10,mBC-0814-1
"D11,E10",3787,4166,2735,1431,2486,0,1371,1378,974,404,2.410891089,733,1736,1275,395,0,395,0,73,0,0.070886076,empty,mBC-0814-1
"D11,E11",3974,4193,2768,1425,2568,0,1436,1441,1027,414,2.480676329,800,1288,931,245,0,245,0,85,0,0,empty,mBC-0814-1
"D11,E12",3683,3857,2565,1292,2345,0,1303,1304,927,377,2.458885942,696,550,346,143,0,143,0,48,0,0,empty,mBC-0814-1
"D11,F1",4323,4620,3073,1547,2740,0,1518,1522,1063,459,2.315904139,813,1141,816,241,0,241,0,53,0,0,empty,mBC-0814-1
"D11,F2",647398,745885,435389,310496,439291,2,273387,273687,224980,48707,4.619048597,161971,203284,148150,42038,22,42016,1,2494,0,0.000285605,mm10,mBC-0814-1
"D11,F3",4652,4926,3419,1507,2959,0,1576,1580,1177,403,2.920595533,789,981,675,252,0,252,0,74,0,0,empty,mBC-0814-1
"D11,F4",513713,596401,337050,259351,362423,1,237609,237848,177954,59894,2.97114903,144283,13594,9403,2506,3,2503,1,323,0,0.000799041,mm10,mBC-0814-1
"D11,F5",4912,5209,3465,1744,3075,0,1676,1679,1192,487,2.447638604,886,766,469,165,0,165,0,56,0,0.012121212,empty,mBC-0814-1
"D11,F6",4413,4732,3149,1583,2878,0,1563,1564,1111,453,2.452538631,834,1468,1135,334,0,334,0,78,0,0,empty,mBC-0814-1
"D11,F7",4131,4450,2927,1523,2685,0,1479,1482,1072,410,2.614634146,790,725,572,140,0,140,0,36,0,0,empty,mBC-0814-1
"D11,F8",8362,8890,5943,2947,5252,0,2761,2764,2121,643,3.298600311,1520,117,35,20,0,20,0,9,0,0,empty,mBC-0814-1
"D11,F9",5236,5709,3737,1972,3289,0,1814,1815,1315,500,2.63,957,16083,5063,1464,4,1460,1,196,0,0.025342466,empty,mBC-0814-1
"D11,F10",6139,6463,4450,2013,3806,0,2021,2021,1466,555,2.641441441,1048,1387,1034,323,0,323,0,68,0,0,empty,mBC-0814-1
"D11,F11",3974,4277,2936,1341,2509,0,1342,1342,998,344,2.901162791,707,918,578,225,0,225,0,52,0,0,empty,mBC-0814-1
"D11,F12",4430,4764,3171,1593,2822,0,1563,1568,1142,426,2.680751174,841,65,44,20,0,20,0,6,0,0,empty,mBC-0814-1
"D11,G1",396044,454081,271147,182934,270391,0,164132,164310,130136,34174,3.808041201,95913,179069,105462,30032,21,30011,5,2122,0,0.01642731,mm10,mBC-0814-1
"D11,G2",5084,5474,3552,1922,3305,0,1812,1824,1233,591,2.086294416,1014,459,328,101,0,101,0,18,0,0,empty,mBC-0814-1
"D11,G3",4620,4904,3263,1641,2879,0,1564,1568,1155,413,2.796610169,853,2380,1671,539,0,539,0,124,0,0.005565863,empty,mBC-0814-1
"D11,G4",4730,5061,3378,1683,2823,4,1477,1482,1085,397,2.732997481,737,3,3,1,0,1,0,1,0,0,empty,mBC-0814-1
"D11,G5",4239,4490,3086,1404,2648,0,1381,1384,976,408,2.392156863,728,1535,1093,319,1,318,1,61,0,0,empty,mBC-0814-1
"D11,G6",8004,8406,5761,2645,5011,0,2627,2627,1875,752,2.493351064,1371,769,259,95,0,95,0,19,0,0,empty,mBC-0814-1
"D11,G7",449873,517504,297718,219786,313917,2,200870,201126,153956,47170,3.263854145,120298,28335,18726,5243,5,5238,2,688,0,0.001145475,mm10,mBC-0814-1
"D11,G8",6455,7055,4591,2464,4190,0,2320,2322,1619,703,2.302987198,1279,3012,1836,643,0,643,0,161,0,0.00933126,empty,mBC-0814-1
"D11,G9",5050,5380,3557,1823,3193,0,1758,1759,1267,492,2.575203252,975,2315,1712,497,0,497,0,107,0,0,empty,mBC-0814-1
"D11,G10",8122,8335,5880,2455,5004,0,2603,2605,1847,758,2.436675462,1327,2692,1986,637,1,636,1,134,0,0,empty,mBC-0814-1
"D11,G11",8686,9134,6199,2935,5426,1,2957,2965,2170,795,2.729559748,1537,1568,1153,350,1,349,1,72,0,0,empty,mBC-0814-1
"D11,G12",354120,401149,236656,164493,241847,0,150950,151077,114819,36258,3.166721827,90065,18020,12490,3461,2,3459,1,437,0,0.002312807,mm10,mBC-0814-1
"D11,H1",4208,4599,2983,1616,2682,0,1472,1474,1043,431,2.419953596,793,727,512,132,0,132,0,40,0,0,empty,mBC-0814-1
"D11,H2",9526,10685,6748,3937,6360,0,3605,3607,2664,943,2.825026511,2048,2466,1805,505,0,505,0,133,0,0.041584158,empty,mBC-0814-1
"D11,H3",4936,5225,3540,1685,3130,0,1664,1664,1158,506,2.288537549,881,997,727,229,1,228,1,67,0,0,empty,mBC-0814-1
"D11,H4",500687,588893,331269,257624,347201,1,221632,221850,186994,34856,5.364757861,133589,6544,4751,1247,0,1247,0,186,0,0,mm10,mBC-0814-1
"D11,H5",5968,6474,4204,2270,3791,0,2053,2061,1465,596,2.458053691,1124,1384,959,324,0,324,0,64,0,0.009259259,empty,mBC-0814-1
"D11,H6",485607,552032,326833,225199,327820,1,199709,199903,167049,32854,5.084586352,117675,177186,127663,36074,18,36056,2,2220,0,5.54693E-05,mm10,mBC-0814-1
"D11,H7",4875,5191,3459,1732,3075,0,1661,1667,1183,484,2.444214876,870,1343,1028,321,0,321,0,57,0,0.065420561,empty,mBC-0814-1
"D11,H8",8625,9560,5988,3572,5789,0,3353,3360,2580,780,3.307692308,1903,1664,1113,325,0,325,0,77,0,0.033846154,empty,mBC-0814-1
"D11,H9",452182,489561,305815,183746,291175,0,172233,172465,132333,40132,3.297443437,98422,26814,18383,5391,1,5390,1,595,0,0.001298701,mm10,mBC-0814-1
"D11,H10",3312,3610,2339,1271,2075,0,1120,1121,792,329,2.407294833,627,7931,2748,767,2,765,1,98,0,0.071895425,empty,mBC-0814-1
"D11,H11",3698,4050,2537,1513,2405,0,1332,1334,964,370,2.605405405,747,19,14,11,0,11,0,7,0,0,empty,mBC-0814-1
"D11,H12",2595,2962,1768,1194,1778,0,1027,1034,758,276,2.746376812,612,1796,1286,370,0,370,0,70,0,0.027027027,empty,mBC-0814-1
"D12,A1",501810,592630,333647,258983,352447,0,224051,224281,169043,55238,3.060266483,135259,144064,104726,29763,29,29734,1,2000,0,0.000470841,mm10,mBC-0814-1
"D12,A2",4839,5171,3396,1775,3074,0,1668,1670,1197,473,2.530655391,925,1174,773,225,1,224,1,56,0,0.0625,empty,mBC-0814-1
"D12,A3",4617,5111,3293,1818,2935,0,1576,1583,1104,479,2.30480167,846,868,600,120,0,120,0,31,0,0,empty,mBC-0814-1
"D12,A4",469633,532264,320929,211335,314245,0,193307,193509,153570,39939,3.845113799,112995,6267,4531,1255,0,1255,0,170,0,0,mm10,mBC-0814-1
"D12,A5",4668,4969,3330,1639,2890,0,1586,1587,1124,463,2.427645788,846,4409,1714,511,0,511,0,77,0,0.019569472,empty,mBC-0814-1
"D12,A6",3685,3878,2650,1228,2258,0,1201,1201,839,362,2.317679558,619,1569,1073,275,1,274,1,59,0,0.032846715,empty,mBC-0814-1
"D12,A7",5454,5819,3849,1970,3417,0,1858,1862,1324,538,2.460966543,1006,3323,1484,472,0,472,0,79,0,0.063559322,empty,mBC-0814-1
"D12,A8",2089,2267,1470,797,1316,0,742,742,544,198,2.747474747,392,2052,1341,376,0,376,0,70,0,0,empty,mBC-0814-1
"D12,A9",6518,6833,4752,2081,3989,0,2111,2111,1564,547,2.859232176,1055,1335,813,243,0,243,0,49,0,0.028806584,empty,mBC-0814-1
"D12,A10",3130,3508,2245,1263,2119,0,1191,1193,841,352,2.389204545,656,191,111,27,0,27,0,12,0,0,empty,mBC-0814-1
"D12,A11",4596,4772,3292,1480,2788,0,1476,1479,1040,439,2.369020501,750,1475,1033,318,1,317,1,74,0,0.018927445,empty,mBC-0814-1
"D12,A12",3571,3930,2528,1402,2396,0,1344,1348,975,373,2.613941019,753,3110,2247,643,0,643,0,120,0,0,empty,mBC-0814-1
"D12,B1",122737,126873,69249,57624,75431,0,48416,48483,31784,16699,1.903347506,30140,39813,27216,7160,4,7156,2,649,0,0.000139743,empty,mBC-0814-1
"D12,B2",4686,4875,3309,1566,2900,0,1565,1567,1166,401,2.907730673,828,253,159,52,0,52,0,15,0,0,empty,mBC-0814-1
"D12,B3",3708,4107,2675,1432,2440,0,1352,1353,963,390,2.469230769,745,1303,908,261,0,261,0,44,0,0,empty,mBC-0814-1
"D12,B4",4009,4397,2814,1583,2643,0,1477,1480,1030,450,2.288888889,824,1262,861,227,0,227,0,49,0,0.04845815,empty,mBC-0814-1
"D12,B5",3616,2457,1496,961,1690,0,982,984,707,277,2.55234657,569,1638,933,274,0,274,0,53,0,0.01459854,empty,mBC-0814-1
"D12,B6",298600,352896,195923,156973,212233,1,136957,137099,105531,31568,3.342973898,84301,81520,58256,17102,14,17088,2,1237,0,0,mm10,mBC-0814-1
"D12,B7",5109,5477,3745,1732,3210,0,1699,1703,1243,460,2.702173913,881,1328,1011,259,0,259,0,53,0,0,empty,mBC-0814-1
"D12,B8",3482,3813,2459,1354,2291,0,1265,1266,919,347,2.648414986,745,790,631,175,0,175,0,32,0,0.04,empty,mBC-0814-1
"D12,B9",4710,4929,3385,1544,2891,0,1562,1562,1122,440,2.55,800,4318,1453,443,0,443,0,63,0,0.002257336,empty,mBC-0814-1
"D12,B10",4208,4365,2999,1366,2632,0,1407,1408,991,417,2.376498801,735,459,348,82,1,81,1,16,0,0,empty,mBC-0814-1
"D12,B11",492040,567349,329528,237821,331689,0,202402,202658,174755,27903,6.262946637,120601,18961,13785,4121,2,4119,2,470,0,0,mm10,mBC-0814-1
"D12,B12",5055,5528,3582,1946,3217,1,1739,1740,1244,496,2.508064516,938,835,650,197,0,197,0,45,0,0.005076142,empty,mBC-0814-1
"D12,C1",5475,5876,4021,1855,3385,0,1742,1746,1262,484,2.607438017,909,328,195,80,0,80,0,22,0,0,empty,mBC-0814-1
"D12,C2",5083,5337,3693,1644,3088,0,1634,1638,1161,477,2.433962264,869,1591,1026,347,0,347,0,64,0,0,empty,mBC-0814-1
"D12,C3",5368,5802,3844,1958,3375,1,1779,1780,1266,514,2.463035019,944,638,434,141,0,141,0,21,0,0,empty,mBC-0814-1
"D12,C4",4719,5035,3414,1621,3019,0,1637,1638,1208,430,2.809302326,872,4788,2010,619,1,618,1,90,0,0.079288026,empty,mBC-0814-1
"D12,C5",6801,7278,4828,2450,4287,1,2357,2360,1721,639,2.693270736,1257,1636,1061,324,0,324,0,67,0,0,empty,mBC-0814-1
"D12,C6",569066,658905,378350,280555,395961,1,249706,249979,210921,39058,5.400199703,149856,85443,60270,17271,15,17256,2,1302,0,0.000405656,mm10,mBC-0814-1
"D12,C7",6740,7111,4902,2209,4117,0,2214,2222,1634,588,2.778911565,1126,345,244,62,0,62,0,10,0,0,empty,mBC-0814-1
"D12,C8",5282,5696,3766,1930,3237,0,1755,1755,1285,470,2.734042553,911,1685,1210,375,0,375,0,73,0,0,empty,mBC-0814-1
"D12,C9",4362,4515,3096,1419,2685,0,1450,1451,1069,382,2.798429319,714,915,652,184,1,183,1,34,0,0.005464481,empty,mBC-0814-1
"D12,C10",5455,5741,3985,1756,3362,6,1742,1748,1242,506,2.454545455,887,1103,732,250,0,250,0,46,0,0,empty,mBC-0814-1
"D12,C11",4273,4714,3057,1657,2764,0,1500,1500,1053,447,2.355704698,820,1103,709,216,0,216,0,40,0,0,empty,mBC-0814-1
"D12,C12",8037,8674,5721,2953,5027,0,2735,2741,1926,815,2.363190184,1492,1368,1028,253,1,252,1,53,0,0,empty,mBC-0814-1
"D12,D1",4206,4581,3064,1517,2679,0,1437,1441,1033,408,2.531862745,755,620,473,109,1,108,1,22,0,0,empty,mBC-0814-1
"D12,D2",4839,5172,3560,1612,2986,0,1525,1525,1085,440,2.465909091,754,1528,1053,325,0,325,0,54,0,0,empty,mBC-0814-1
"D12,D3",10337,11210,7358,3852,6505,0,3521,3526,2515,1011,2.487636004,1900,2709,1898,523,1,522,1,91,0,0.024904215,empty,mBC-0814-1
"D12,D4",4295,4622,3117,1505,2775,0,1529,1534,1093,441,2.47845805,800,997,605,202,0,202,0,43,0,0,empty,mBC-0814-1
"D12,D5",4111,4249,2797,1452,2578,0,1439,1442,1037,405,2.560493827,774,13129,5453,1567,0,1567,0,223,0,0.014039566,empty,mBC-0814-1
"D12,D6",4938,5394,3568,1826,3128,0,1712,1716,1254,462,2.714285714,940,868,639,149,0,149,0,28,0,0,empty,mBC-0814-1
"D12,D7",5353,5563,3806,1757,3268,0,1770,1772,1346,426,3.159624413,891,2285,1548,433,1,432,1,72,0,0.011574074,empty,mBC-0814-1
"D12,D8",4812,5166,3511,1655,3056,1,1671,1673,1209,464,2.605603448,885,1838,1046,243,0,243,0,47,0,0,empty,mBC-0814-1
"D12,D9",2810,2923,1999,924,1769,0,978,982,667,315,2.117460317,505,968,614,189,0,189,0,40,0,0,empty,mBC-0814-1
"D12,D10",3827,4281,2683,1598,2464,0,1372,1375,1023,352,2.90625,783,6853,2247,627,0,627,0,68,0,0.090909091,empty,mBC-0814-1
"D12,D11",4087,4505,2964,1541,2626,0,1361,1364,950,414,2.29468599,745,1473,1082,303,0,303,0,66,0,0.00330033,empty,mBC-0814-1
"D12,D12",6124,6837,4356,2481,3912,1,2162,2165,1487,678,2.193215339,1178,3110,2308,640,1,639,1,104,0,0.014084507,empty,mBC-0814-1
"D12,E1",4858,5039,3538,1501,2877,0,1443,1446,1023,423,2.418439716,728,1288,916,231,0,231,0,49,0,0,empty,mBC-0814-1
"D12,E2",3589,3697,2645,1052,2234,0,1167,1169,849,320,2.653125,582,1425,959,310,0,310,0,53,0,0.003225806,empty,mBC-0814-1
"D12,E3",3718,4216,2678,1538,2386,0,1325,1331,910,421,2.16152019,757,1949,1077,279,0,279,0,59,0,0.082437276,empty,mBC-0814-1
"D12,E4",3007,3202,2157,1045,1894,1,1035,1038,741,297,2.494949495,546,995,674,176,0,176,0,51,0,0,empty,mBC-0814-1
"D12,E5",3664,3898,2684,1214,2265,0,1174,1176,853,323,2.640866873,614,818,586,149,0,149,0,27,0,0,empty,mBC-0814-1
"D12,E6",4440,4836,3249,1587,2761,0,1487,1489,1072,417,2.570743405,808,962,690,206,0,206,0,45,0,0,empty,mBC-0814-1
"D12,E7",4221,4466,3012,1454,2534,0,1353,1353,937,416,2.252403846,717,1086,830,209,0,209,0,42,0,0,empty,mBC-0814-1
"D12,E8",5054,5252,3685,1567,2985,0,1505,1505,1063,442,2.404977376,755,2409,1896,457,0,457,0,69,0,0,empty,mBC-0814-1
"D12,E9",2910,3281,2119,1162,1912,0,1049,1051,790,261,3.026819923,589,1264,824,258,0,258,0,55,0,0,empty,mBC-0814-1
"D12,E10",3908,4288,2770,1518,2504,0,1372,1372,1006,366,2.74863388,724,1282,773,249,0,249,0,56,0,0,empty,mBC-0814-1
"D12,E11",3798,4123,2769,1354,2446,0,1312,1315,914,401,2.279301746,691,1315,990,242,0,242,0,61,0,0,empty,mBC-0814-1
"D12,E12",3709,3942,2697,1245,2334,0,1248,1250,918,332,2.765060241,631,771,588,181,0,181,0,31,0,0,empty,mBC-0814-1
"D12,F1",4658,5079,3310,1769,2905,0,1515,1521,1108,413,2.682808717,848,1019,811,218,0,218,0,42,0,0,empty,mBC-0814-1
"D12,F2",5961,6076,4241,1835,3636,0,1951,1955,1431,524,2.730916031,999,1914,1375,411,0,411,0,73,0,0,empty,mBC-0814-1
"D12,F3",4688,5064,3382,1682,3042,0,1634,1636,1172,464,2.525862069,844,1703,1239,339,0,339,0,65,0,0,empty,mBC-0814-1
"D12,F4",4867,5163,3466,1697,3008,0,1563,1563,1083,480,2.25625,816,297,179,71,0,71,0,16,0,0,empty,mBC-0814-1
"D12,F5",637729,727302,425112,302190,426120,1,270513,270785,220958,49827,4.434503382,159733,51168,35658,9906,8,9898,2,987,0,0.002222671,mm10,mBC-0814-1
"D12,F6",5137,5624,3558,2066,3318,0,1894,1901,1293,608,2.126644737,1091,15091,6024,1828,4,1824,3,184,0,0.163925439,empty,mBC-0814-1
"D12,F7",4288,4571,3122,1449,2709,0,1419,1427,1004,423,2.373522459,727,596,400,140,0,140,0,32,0,0.042857143,empty,mBC-0814-1
"D12,F8",5889,6412,4307,2105,3704,0,1968,1970,1438,532,2.703007519,1030,167,128,37,0,37,0,8,0,0,empty,mBC-0814-1
"D12,F9",5262,5597,3711,1886,3279,0,1701,1707,1196,511,2.340508806,924,2151,1630,495,0,495,0,71,0,0,empty,mBC-0814-1
"D12,F10",6332,6786,4524,2262,3920,0,2132,2138,1504,634,2.372239748,1091,2270,1045,299,0,299,0,56,0,0.143812709,empty,mBC-0814-1
"D12,F11",4022,4334,2958,1376,2575,0,1335,1344,920,424,2.169811321,696,1507,1114,299,0,299,0,45,0,0.023411371,empty,mBC-0814-1
"D12,F12",4635,5000,3239,1761,2910,0,1664,1666,1180,486,2.427983539,923,50,32,12,0,12,0,5,0,0,empty,mBC-0814-1
"D12,G1",7101,7561,5035,2526,4479,0,2461,2470,1763,707,2.493635078,1284,2828,2151,590,0,590,0,115,0,0,empty,mBC-0814-1
"D12,G2",5577,5912,4050,1862,3410,0,1777,1781,1285,496,2.590725806,915,522,331,89,1,88,1,17,0,0,empty,mBC-0814-1
"D12,G3",6204,6651,4381,2270,3969,0,2255,2260,1702,558,3.050179211,1223,8732,3040,954,0,954,0,124,0,0.035639413,empty,mBC-0814-1
"D12,G4",5016,5439,3572,1867,3192,0,1697,1697,1187,510,2.32745098,931,9,5,2,0,2,0,1,0,0,empty,mBC-0814-1
"D12,G5",4397,4723,3193,1530,2785,0,1502,1509,1052,457,2.301969365,778,1596,1133,283,1,282,1,48,0,0,empty,mBC-0814-1
"D12,G6",8456,9038,6048,2990,5318,0,2812,2813,1997,816,2.447303922,1461,154,95,33,0,33,0,9,0,0,empty,mBC-0814-1
"D12,G7",5230,5548,3867,1681,3274,0,1724,1726,1216,510,2.384313725,903,2320,1679,493,0,493,0,72,0,0.068965517,empty,mBC-0814-1
"D12,G8",6627,7145,4674,2471,4155,0,2348,2349,1677,672,2.495535714,1217,2559,1714,492,0,492,0,94,0,0,empty,mBC-0814-1
"D12,G9",730876,849256,482258,366998,501035,0,315753,316131,264135,51996,5.079909993,190052,437755,311013,86797,44,86753,2,3990,0,0.000242067,mm10,mBC-0814-1
"D12,G10",8850,9416,6229,3187,5547,2,3004,3014,2120,894,2.371364653,1607,2222,1582,457,0,457,0,86,0,0,empty,mBC-0814-1
"D12,G11",1512521,1738825,1012801,726024,1005873,1,632407,633128,524497,108631,4.82824424,375379,333952,239730,65789,44,65745,5,3296,0,0.000136893,mm10,mBC-0814-1
"D12,G12",4382,4697,3119,1578,2794,0,1521,1523,1112,411,2.705596107,803,1964,1373,421,0,421,0,82,0,0.007125891,empty,mBC-0814-1
"D12,H1",4424,4891,3103,1788,2752,0,1523,1523,1100,423,2.600472813,833,892,703,188,0,188,0,36,0,0,empty,mBC-0814-1
"D12,H2",7769,8067,5591,2476,4762,0,2515,2520,1747,773,2.260025873,1257,3862,2904,821,1,820,1,128,0,0.013414634,empty,mBC-0814-1
"D12,H3",5128,5468,3637,1831,3197,0,1740,1740,1261,479,2.63256785,934,2338,1224,386,0,386,0,65,0,0,empty,mBC-0814-1
"D12,H4",5201,5608,3710,1898,3285,1,1790,1793,1253,540,2.32037037,960,142,118,53,0,53,0,10,0,0.264150943,empty,mBC-0814-1
"D12,H5",6451,6973,4738,2235,4028,0,2136,2139,1499,640,2.3421875,1128,2047,1437,377,0,377,0,63,0,0.029177719,empty,mBC-0814-1
"D12,H6",6020,6595,4305,2290,3797,0,2015,2017,1473,544,2.707720588,1094,2810,1669,441,1,440,1,83,0,0.020454545,empty,mBC-0814-1
"D12,H7",5034,5334,3571,1763,3128,2,1695,1697,1192,505,2.36039604,897,1731,1274,394,0,394,0,52,0,0,empty,mBC-0814-1
"D12,H8",3994,4303,2798,1505,2496,0,1339,1339,941,398,2.364321608,716,1842,1303,370,1,369,1,70,0,0,empty,mBC-0814-1
"D12,H9",4579,4954,3360,1594,2989,0,1650,1657,1192,465,2.56344086,878,937,613,183,1,182,1,37,0,0,empty,mBC-0814-1
"D12,H10",3195,3510,2246,1264,2067,0,1161,1165,789,376,2.098404255,627,1189,667,208,0,208,0,49,0,0.067307692,empty,mBC-0814-1
"D12,H11",3551,3765,2554,1211,2252,0,1265,1272,874,398,2.195979899,692,55,38,8,0,8,0,5,0,0,empty,mBC-0814-1
"D12,H12",2340,2476,1688,788,1529,0,851,851,626,225,2.782222222,476,1650,1074,328,0,328,0,67,0,0,empty,mBC-0814-1
"E1,A1",6551,6861,4736,2125,4075,0,2153,2158,1491,667,2.235382309,1126,1978,1411,504,0,504,0,96,0,0,empty,mBC-0814-1
"E1,A2",6013,6469,4271,2198,3845,0,2089,2096,1500,596,2.516778523,1135,2498,1692,569,0,569,0,132,0,0,empty,mBC-0814-1
"E1,A3",5024,5528,3563,1965,3286,0,1777,1780,1260,520,2.423076923,988,1156,741,207,0,207,0,51,0,0,empty,mBC-0814-1
"E1,A4",5987,6493,4293,2200,3748,0,2019,2019,1467,552,2.657608696,1093,718,525,158,0,158,0,24,0,0,empty,mBC-0814-1
"E1,A5",5052,5383,3714,1669,3212,0,1732,1739,1226,513,2.389863548,883,1684,1131,323,0,323,0,57,0,0,empty,mBC-0814-1
"E1,A6",4101,4269,2973,1296,2516,0,1376,1376,962,414,2.323671498,691,4954,2178,642,0,642,0,98,0,0.001557632,empty,mBC-0814-1
"E1,A7",5705,6126,4017,2109,3613,0,1981,1982,1386,596,2.325503356,1008,5313,2148,597,1,596,1,120,0,0.063758389,empty,mBC-0814-1
"E1,A8",255520,311168,164741,146427,188154,0,124967,125104,99583,25521,3.902002273,78101,177113,124471,35201,16,35185,2,2285,0,0.00048316,mm10,mBC-0814-1
"E1,A9",18110,19742,12932,6810,11517,0,6361,6366,4874,1492,3.266756032,3359,6798,4616,1190,2,1188,1,175,0,0,empty,mBC-0814-1
"E1,A10",328333,391804,212967,178837,235924,0,152875,153020,123914,29106,4.257335257,94505,16483,11514,3134,2,3132,1,383,0,0,mm10,mBC-0814-1
"E1,A11",5227,5607,3737,1870,3313,5,1793,1802,1302,500,2.604,964,2515,1755,561,0,561,0,124,0,0,empty,mBC-0814-1
"E1,A12",4618,5079,3219,1860,2971,0,1614,1617,1194,423,2.822695035,908,9678,4616,1387,4,1383,1,237,0,0.004338395,empty,mBC-0814-1
"E1,B1",6147,6275,4302,1973,3674,0,1955,1961,1388,573,2.422338569,1015,3780,2102,630,1,629,1,112,0,0.143084261,empty,mBC-0814-1
"E1,B2",5310,5616,3745,1871,3235,0,1774,1778,1238,540,2.292592593,952,319,165,56,0,56,0,23,0,0,empty,mBC-0814-1
"E1,B3",499866,572359,329383,242976,342747,0,219867,220119,165326,54793,3.01728323,131447,39129,27063,7616,5,7611,1,789,0,0.001839443,mm10,mBC-0814-1
"E1,B4",4940,5263,3471,1792,3127,0,1749,1756,1240,516,2.403100775,992,1385,932,281,0,281,0,67,0,0,empty,mBC-0814-1
"E1,B5",10379,9775,5675,4100,6338,0,4034,4042,2633,1409,1.868701207,2395,29257,8885,2862,6,2856,2,276,0,0.154061625,empty,mBC-0814-1
"E1,B6",4307,4677,3043,1634,2802,3,1514,1521,1064,457,2.328227571,830,3378,1474,484,0,484,0,84,0,0.006198347,empty,mBC-0814-1
"E1,B7",515135,603423,334225,269198,361279,0,238578,238821,192471,46350,4.152556634,145701,15892,10472,2989,1,2988,1,375,0,0.007697456,mm10,mBC-0814-1
"E1,B8",4096,4400,2967,1433,2612,0,1377,1381,1002,379,2.643799472,722,1920,1426,318,0,318,0,60,0,0,empty,mBC-0814-1
"E1,B9",5072,5464,3745,1719,3274,0,1759,1759,1293,466,2.774678112,928,872,623,246,0,246,0,63,0,0,empty,mBC-0814-1
"E1,B10",454269,503203,299098,204105,307358,3,185125,185445,140583,44862,3.133676608,109385,53908,31300,9007,5,9002,3,834,0,0.01399689,mm10,mBC-0814-1
"E1,B11",7032,7514,5059,2455,4376,0,2345,2348,1701,647,2.629057187,1260,149,117,35,0,35,0,17,0,0,empty,mBC-0814-1
"E1,B12",5812,6125,4136,1989,3585,0,1968,1975,1385,590,2.347457627,1026,8362,2982,904,3,901,2,109,0,0.097669256,empty,mBC-0814-1
"E1,C1",5970,6334,4294,2040,3662,0,1944,1944,1378,566,2.434628975,1003,849,596,186,0,186,0,43,0,0,empty,mBC-0814-1
"E1,C2",5747,6213,4260,1953,3674,0,1928,1929,1400,529,2.646502836,1031,1882,1283,357,1,356,1,79,0,0.04494382,empty,mBC-0814-1
"E1,C3",7360,8182,5223,2959,4849,0,2662,2662,1983,679,2.920471281,1467,910,611,146,0,146,0,32,0,0,empty,mBC-0814-1
"E1,C4",5732,6203,3991,2212,3629,0,1945,1949,1393,556,2.505395683,1106,2000,1460,450,0,450,0,86,0,0.026666667,empty,mBC-0814-1
"E1,C5",7826,8370,5585,2785,4938,1,2681,2686,1951,735,2.654421769,1440,1753,1124,368,2,366,1,101,0,0,empty,mBC-0814-1
"E1,C6",5743,6227,4124,2103,3740,0,2064,2070,1511,559,2.703041145,1113,1169,805,263,0,263,0,69,0,0,empty,mBC-0814-1
"E1,C7",7777,8347,5447,2900,4873,0,2653,2654,1990,664,2.996987952,1407,129,74,27,0,27,0,9,0,0,empty,mBC-0814-1
"E1,C8",5900,6196,4232,1964,3730,0,1978,1980,1466,514,2.852140078,1022,4471,2075,647,0,647,0,117,0,0.125193199,empty,mBC-0814-1
"E1,C9",669982,795203,421982,373221,471868,0,328952,329262,192273,136989,1.40356525,204918,22782,14152,3793,4,3789,1,470,0,0.001847453,mm10,mBC-0814-1
"E1,C10",6349,6799,4653,2146,3915,0,2067,2076,1497,579,2.585492228,1093,1852,1288,320,0,320,0,67,0,0,empty,mBC-0814-1
"E1,C11",5142,5456,3717,1739,3177,1,1736,1738,1242,496,2.504032258,889,1937,1456,408,0,408,0,84,0,0,empty,mBC-0814-1
"E1,C12",8808,9609,6374,3235,5552,0,3002,3010,2130,880,2.420454545,1613,2601,1736,508,1,507,1,104,0,0.001972387,empty,mBC-0814-1
"E1,D1",4857,5203,3443,1760,3055,0,1636,1636,1192,444,2.684684685,848,727,467,163,0,163,0,48,0,0,empty,mBC-0814-1
"E1,D2",5328,5788,3887,1901,3357,0,1728,1731,1203,528,2.278409091,879,2023,1429,439,0,439,0,106,0,0,empty,mBC-0814-1
"E1,D3",11718,12711,8380,4331,7528,0,4103,4105,2928,1177,2.487680544,2204,2686,1789,515,0,515,0,99,0,0,empty,mBC-0814-1
"E1,D4",5100,5476,3670,1806,3275,0,1805,1805,1270,535,2.373831776,954,2416,1660,482,0,482,0,97,0,0.010373444,empty,mBC-0814-1
"E1,D5",5099,5523,3591,1932,3315,0,1829,1833,1326,507,2.615384615,985,3238,2166,584,0,584,0,118,0,0.006849315,empty,mBC-0814-1
"E1,D6",5239,5608,3765,1843,3308,0,1842,1844,1341,503,2.666003976,974,6273,2337,690,0,690,0,79,0,0.044927536,empty,mBC-0814-1
"E1,D7",12283,14114,8918,5196,8414,0,4785,4785,3687,1098,3.357923497,2703,9314,6878,1880,1,1879,1,249,0,0.002128792,empty,mBC-0814-1
"E1,D8",5114,5680,3699,1981,3380,0,1830,1838,1276,562,2.270462633,996,952,605,227,0,227,0,56,0,0,empty,mBC-0814-1
"E1,D9",3467,3604,2488,1116,2132,0,1147,1147,828,319,2.595611285,624,2052,1376,359,1,358,1,74,0,0.005586592,empty,mBC-0814-1
"E1,D10",4070,4425,2985,1440,2624,0,1445,1445,1060,385,2.753246753,733,728,540,183,0,183,0,52,0,0,empty,mBC-0814-1
"E1,D11",4303,4616,3091,1525,2786,1,1520,1523,1092,431,2.533642691,807,2311,1627,511,0,511,0,110,0,0,empty,mBC-0814-1
"E1,D12",7051,7743,5048,2695,4377,0,2383,2385,1717,668,2.570359281,1294,3931,2860,847,0,847,0,129,0,0.0094451,empty,mBC-0814-1
"E1,E1",5459,5829,3953,1876,3456,3,1866,1870,1353,517,2.617021277,961,1570,1145,338,0,338,0,71,0,0,empty,mBC-0814-1
"E1,E2",3878,4255,2808,1447,2552,0,1407,1409,987,422,2.338862559,736,1455,966,292,0,292,0,71,0,0.075342466,empty,mBC-0814-1
"E1,E3",3855,4113,2793,1320,2377,0,1283,1286,893,393,2.272264631,655,1482,916,278,0,278,0,70,0,0,empty,mBC-0814-1
"E1,E4",498016,590538,331641,258897,349680,1,221299,221509,193961,27548,7.04083781,133881,240597,175576,50622,31,50591,3,2632,0,0.001561543,mm10,mBC-0814-1
"E1,E5",4171,4484,3035,1449,2568,1,1360,1363,971,392,2.477040816,711,1269,944,283,2,281,1,50,0,0,empty,mBC-0814-1
"E1,E6",4692,5057,3501,1556,2966,0,1576,1581,1156,425,2.72,818,1685,1074,312,0,312,0,74,0,0,empty,mBC-0814-1
"E1,E7",4895,5090,3584,1506,2975,0,1534,1539,1139,400,2.8475,771,1819,1242,385,2,383,2,85,0,0.07310705,empty,mBC-0814-1
"E1,E8",4885,5231,3622,1609,3039,0,1543,1545,1101,444,2.47972973,782,2620,1940,520,0,520,0,90,0,0,empty,mBC-0814-1
"E1,E9",3797,4003,2747,1256,2440,3,1349,1356,1020,336,3.035714286,691,1404,941,276,0,276,0,67,0,0.061594203,empty,mBC-0814-1
"E1,E10",4100,4461,2973,1488,2737,2,1486,1488,1028,460,2.234782609,797,2278,1586,422,1,421,1,92,0,0,empty,mBC-0814-1
"E1,E11",4657,5040,3266,1774,2924,0,1578,1582,1081,501,2.157684631,862,1373,877,239,0,239,0,62,0,0.083682008,empty,mBC-0814-1
"E1,E12",4378,4734,3163,1571,2723,0,1465,1465,1015,450,2.255555556,797,1119,756,247,1,246,1,59,0,0,empty,mBC-0814-1
"E1,F1",5186,5496,3680,1816,3147,0,1680,1680,1165,515,2.262135922,884,1869,1205,352,0,352,0,71,0,0,empty,mBC-0814-1
"E1,F2",610912,709227,408071,301156,417625,0,261714,262007,219235,42772,5.125666324,156465,273454,183258,52416,45,52371,6,2841,0,7.63781E-05,mm10,mBC-0814-1
"E1,F3",634382,744008,422821,321187,439260,2,277002,277284,227590,49694,4.579828551,166538,317133,234155,65468,45,65423,7,3232,0,0.000443269,mm10,mBC-0814-1
"E1,F4",5829,6166,4122,2044,3696,0,1986,1986,1425,561,2.540106952,1104,509,344,123,0,123,0,29,0,0,empty,mBC-0814-1
"E1,F5",5699,5962,4221,1741,3473,0,1832,1832,1324,508,2.606299213,920,1442,1085,333,0,333,0,77,0,0,empty,mBC-0814-1
"E1,F6",5845,6182,4112,2070,3729,0,1993,1993,1415,578,2.448096886,1046,2808,1839,612,2,610,1,127,0,0.02295082,empty,mBC-0814-1
"E1,F7",177033,212917,120157,92760,127353,0,83564,83671,48877,34794,1.404753693,50684,16509,7434,1892,2,1890,2,239,0,0.02962963,mm10,mBC-0814-1
"E1,F8",6904,7370,4943,2427,4254,0,2280,2281,1650,631,2.614896989,1199,344,238,71,1,70,1,18,0,0,empty,mBC-0814-1
"E1,F9",5897,6512,4224,2288,3809,0,2086,2093,1504,589,2.553480475,1167,2137,1488,473,1,472,1,99,0,0,empty,mBC-0814-1
"E1,F10",6716,7158,4866,2292,4310,0,2252,2259,1626,633,2.568720379,1198,2330,1495,439,1,438,1,96,0,0.002283105,empty,mBC-0814-1
"E1,F11",4467,4860,3203,1657,2906,0,1552,1555,1124,431,2.607888631,845,1670,1268,383,0,383,0,73,0,0,empty,mBC-0814-1
"E1,F12",5139,5852,3612,2240,3317,0,1865,1866,1259,607,2.074135091,1025,81,52,10,0,10,0,9,0,0,empty,mBC-0814-1
"E1,G1",502764,597375,329937,267438,357184,0,230501,230721,190313,40408,4.709785191,141190,208563,145710,42112,26,42086,3,2491,0,0.000522739,mm10,mBC-0814-1
"E1,G2",6333,6693,4584,2109,3927,0,2084,2088,1511,577,2.618717504,1045,510,323,88,0,88,0,23,0,0,empty,mBC-0814-1
"E1,G3",5494,5891,3861,2030,3424,0,1894,1897,1325,572,2.316433566,994,3226,2254,639,0,639,0,118,0,0,empty,mBC-0814-1
"E1,G4",8075,8730,5578,3152,5155,0,2978,2984,1695,1289,1.314972847,1665,172,85,28,0,28,0,4,0,0,empty,mBC-0814-1
"E1,G5",606428,700547,407938,292609,411087,0,255519,255821,219531,36290,6.049352439,151975,141764,101551,28881,14,28867,2,1926,0,0.000346416,mm10,mBC-0814-1
"E1,G6",9560,10188,6898,3290,5967,4,3181,3191,2332,859,2.714784633,1679,138,94,29,0,29,0,13,0,0,empty,mBC-0814-1
"E1,G7",6263,6647,4521,2126,3941,0,2111,2113,1494,619,2.413570275,1083,3358,2484,789,1,788,1,124,0,0.026649746,empty,mBC-0814-1
"E1,G8",7996,8556,5745,2811,5121,3,2777,2783,2049,734,2.791553134,1496,4829,3436,1040,1,1039,1,219,0,0.005774783,empty,mBC-0814-1
"E1,G9",6022,6492,4327,2165,3831,12,2098,2113,1524,589,2.587436333,1143,2327,1520,522,1,521,1,152,0,0,empty,mBC-0814-1
"E1,G10",10223,10757,7377,3380,6402,0,3378,3385,2413,972,2.482510288,1763,4051,2923,954,0,954,0,179,0,0.006289308,empty,mBC-0814-1
"E1,G11",1105238,1265528,739902,525626,742103,0,464093,464637,372728,91909,4.055402627,274125,335493,236761,65859,38,65821,4,3201,0,0.000349433,mm10,mBC-0814-1
"E1,G12",5409,5907,3790,2117,3453,0,1950,1950,1422,528,2.693181818,1046,2702,1851,552,0,552,0,112,0,0.019927536,empty,mBC-0814-1
"E1,H1",5091,5446,3702,1744,3199,3,1708,1715,1237,478,2.587866109,902,1703,1226,327,0,327,0,63,0,0,empty,mBC-0814-1
"E1,H2",9275,10113,6731,3382,5882,0,3246,3250,2210,1040,2.125,1676,4443,3071,979,1,978,1,187,0,0.009202454,empty,mBC-0814-1
"E1,H3",6297,6843,4545,2298,3977,0,2149,2151,1546,605,2.555371901,1133,1980,1347,376,1,375,1,85,0,0,empty,mBC-0814-1
"E1,H4",5728,6130,4204,1926,3648,0,1952,1954,1393,561,2.483065954,1024,42,29,15,0,15,0,11,0,0,empty,mBC-0814-1
"E1,H5",7376,8101,5157,2944,4648,0,2568,2573,1810,763,2.372214941,1402,2464,1783,483,0,483,0,90,0,0,empty,mBC-0814-1
"E1,H6",7012,7533,5069,2464,4364,0,2322,2327,1654,673,2.457652303,1197,2594,1789,621,1,620,1,135,0,0.017741935,empty,mBC-0814-1
"E1,H7",607360,691482,412460,279022,410934,2,250329,250603,206249,44354,4.650065383,146740,170109,123252,35514,13,35501,2,2165,0,0,mm10,mBC-0814-1
"E1,H8",431752,501052,286503,214549,295104,0,184281,184480,157698,26782,5.888208498,110533,273195,198997,56877,28,56849,1,2972,0,0.000492533,mm10,mBC-0814-1
"E1,H9",5413,5738,3888,1850,3368,0,1749,1754,1232,522,2.360153257,905,1904,1440,328,1,327,1,61,0,0.003058104,empty,mBC-0814-1
"E1,H10",3919,4207,2839,1368,2449,0,1343,1343,959,384,2.497395833,684,936,672,235,0,235,0,49,0,0,empty,mBC-0814-1
"E1,H11",4337,4738,3034,1704,2772,0,1572,1572,1128,444,2.540540541,877,55,33,17,0,17,0,10,0,0,empty,mBC-0814-1
"E1,H12",3234,3516,2306,1210,2168,0,1251,1255,842,413,2.03874092,689,1864,1339,404,0,404,0,97,0,0,empty,mBC-0814-1
"E2,A1",5486,5977,3920,2057,3546,0,1930,1934,1376,558,2.465949821,1053,1920,1326,415,0,415,0,89,0,0,empty,mBC-0814-1
"E2,A2",5079,5093,3586,1507,2990,0,1539,1541,1084,457,2.371991247,769,56881,16050,5364,5,5359,2,485,0,0.143870125,empty,mBC-0814-1
"E2,A3",4538,4861,3243,1618,2783,0,1522,1524,1094,430,2.544186047,796,8325,3015,867,1,866,1,120,0,0.072748268,empty,mBC-0814-1
"E2,A4",5556,5856,3922,1934,3458,0,1881,1885,1335,550,2.427272727,1016,1108,508,156,0,156,0,30,0,0.006410256,empty,mBC-0814-1
"E2,A5",4669,4887,3381,1506,2915,0,1566,1567,1136,431,2.635730858,800,2484,1494,396,0,396,0,70,0,0.070707071,empty,mBC-0814-1
"E2,A6",3933,4240,2819,1421,2482,0,1370,1371,939,432,2.173611111,742,1265,827,287,0,287,0,74,0,0.003484321,empty,mBC-0814-1
"E2,A7",5392,5709,3902,1807,3500,0,1889,1890,1261,629,2.004769475,989,2325,1481,424,1,423,1,107,0,0.007092199,empty,mBC-0814-1
"E2,A8",2412,2665,1729,936,1544,0,883,883,626,257,2.435797665,480,1663,1130,356,0,356,0,78,0,0.02247191,empty,mBC-0814-1
"E2,A9",423578,483673,283463,200210,286627,1,177153,177356,144955,32401,4.473781673,104726,141867,102582,29031,16,29015,3,1869,0,0.000965018,mm10,mBC-0814-1
"E2,A10",3298,3640,2333,1307,2140,0,1177,1180,803,377,2.129973475,631,230,182,75,0,75,0,24,0,0,empty,mBC-0814-1
"E2,A11",266472,302299,175166,127133,181311,0,113895,114006,84923,29083,2.920022006,68127,49389,35634,10230,7,10223,1,953,0,0.001369461,mm10,mBC-0814-1
"E2,A12",284381,322069,187231,134838,191169,0,118915,119035,100957,18078,5.584522624,70503,228593,168315,47911,31,47880,1,2614,0,0.000459482,mm10,mBC-0814-1
"E2,B1",432080,494024,290186,203838,291627,1,176712,176925,143016,33909,4.217641334,104862,137899,98378,27689,21,27668,4,1942,0,0.000722857,mm10,mBC-0814-1
"E2,B2",560524,629505,352153,277352,372971,0,235398,235645,184554,51091,3.612260476,143647,29626,20516,5639,1,5638,1,641,0,0.000532104,mm10,mBC-0814-1
"E2,B3",272691,323871,174600,149271,197198,0,132927,133069,84236,48833,1.724981058,83003,15331,10631,2781,4,2777,1,388,0,0,mm10,mBC-0814-1
"E2,B4",4031,4242,2898,1344,2581,0,1404,1404,994,410,2.424390244,762,1453,1028,300,0,300,0,70,0,0,empty,mBC-0814-1
"E2,B5",3530,2332,1480,852,1670,0,918,923,605,318,1.902515723,571,892,577,235,0,235,0,60,0,0,empty,mBC-0814-1
"E2,B6",5144,5636,3720,1916,3220,0,1780,1780,1311,469,2.795309168,968,1933,1383,449,1,448,1,85,0,0,empty,mBC-0814-1
"E2,B7",5251,5627,3847,1780,3217,0,1630,1632,1167,465,2.509677419,846,1164,780,270,0,270,0,88,0,0.040740741,empty,mBC-0814-1
"E2,B8",3612,3812,2512,1300,2247,0,1183,1183,825,358,2.304469274,660,1235,797,275,0,275,0,55,0,0,empty,mBC-0814-1
"E2,B9",4712,4927,3394,1533,2885,0,1527,1530,1069,461,2.318872017,803,801,520,206,0,206,0,74,0,0,empty,mBC-0814-1
"E2,B10",4088,4170,2820,1350,2532,0,1390,1397,989,408,2.424019608,752,680,388,116,0,116,0,28,0,0,empty,mBC-0814-1
"E2,B11",6287,6668,4533,2135,3843,0,2061,2067,1485,582,2.551546392,1084,365,278,117,0,117,0,15,0,0,empty,mBC-0814-1
"E2,B12",5392,5862,3858,2004,3407,0,1878,1880,1310,570,2.298245614,1019,1443,1012,284,1,283,1,73,0,0,empty,mBC-0814-1
"E2,C1",5806,6309,4151,2158,3601,10,1883,1894,1331,563,2.364120782,996,666,445,146,0,146,0,51,0,0,empty,mBC-0814-1
"E2,C2",528001,591782,359095,232687,346919,0,210022,210280,168233,42047,4.001070231,121647,52094,37089,10340,9,10331,3,1000,0,0.000387184,mm10,mBC-0814-1
"E2,C3",11451,12124,8079,4045,7066,0,3865,3881,2903,978,2.968302658,2093,1016,747,228,0,228,0,53,0,0.039473684,empty,mBC-0814-1
"E2,C4",8107,8545,5829,2716,4965,0,2554,2556,1846,710,2.6,1326,4718,3189,1046,1,1045,1,181,0,0,empty,mBC-0814-1
"E2,C5",7072,7384,5009,2375,4250,0,2294,2298,1609,689,2.335268505,1187,1954,1158,454,0,454,0,110,0,0.055066079,empty,mBC-0814-1
"E2,C6",5143,5650,3654,1996,3353,0,1855,1855,1330,525,2.533333333,997,1673,1159,363,0,363,0,100,0,0.002754821,empty,mBC-0814-1
"E2,C7",6913,7613,4852,2761,4423,0,2407,2407,1694,713,2.375876578,1328,632,473,141,0,141,0,20,0,0,empty,mBC-0814-1
"E2,C8",5538,5938,4079,1859,3452,0,1818,1818,1257,561,2.240641711,920,2063,1476,467,1,466,1,85,0,0.032188841,empty,mBC-0814-1
"E2,C9",4658,5089,3301,1788,2955,0,1669,1669,1200,469,2.558635394,912,1390,933,259,0,259,0,72,0,0,empty,mBC-0814-1
"E2,C10",6014,6515,4401,2114,3774,7,1922,1930,1357,573,2.368237347,1043,1020,718,237,0,237,0,60,0,0,empty,mBC-0814-1
"E2,C11",4822,5120,3400,1720,2967,0,1668,1670,1176,494,2.380566802,869,1563,1069,339,1,338,1,65,0,0,empty,mBC-0814-1
"E2,C12",618609,712007,414904,297103,413167,1,255867,256161,199052,57109,3.485475144,152159,153392,108858,31137,26,31111,6,1983,0,0.000128572,mm10,mBC-0814-1
"E2,D1",4159,4347,2963,1384,2562,0,1394,1394,991,403,2.459057072,716,782,502,144,0,144,0,37,0,0,empty,mBC-0814-1
"E2,D2",765940,866182,518671,347511,500987,2,305075,305467,243752,61715,3.949639472,177093,359041,263763,74267,50,74217,3,3471,0,0.000444642,mm10,mBC-0814-1
"E2,D3",11299,12200,7791,4409,7063,1,3813,3819,2652,1167,2.272493573,2097,38060,11405,3658,4,3654,2,405,0,0.016694034,empty,mBC-0814-1
"E2,D4",793002,927226,524271,402955,547677,0,349962,350347,274311,76036,3.607646378,211428,314417,221442,63943,42,63901,5,3206,0,0.000234738,mm10,mBC-0814-1
"E2,D5",3693,3998,2651,1347,2412,0,1339,1339,982,357,2.75070028,737,2051,1465,508,0,508,0,131,0,0.029527559,empty,mBC-0814-1
"E2,D6",5063,5322,3727,1595,3042,0,1596,1598,1136,462,2.458874459,816,1702,1284,402,2,400,1,69,0,0.05,empty,mBC-0814-1
"E2,D7",5542,5673,3981,1692,3284,0,1724,1726,1226,500,2.452,869,3109,2101,612,2,610,1,135,0,0.004918033,empty,mBC-0814-1
"E2,D8",4649,5134,3395,1739,2950,0,1605,1610,1180,430,2.744186047,850,1324,950,275,0,275,0,69,0,0.072727273,empty,mBC-0814-1
"E2,D9",2990,3171,2144,1027,1860,0,1002,1005,692,313,2.21086262,506,1766,1326,357,0,357,0,67,0,0,empty,mBC-0814-1
"E2,D10",3753,4195,2663,1532,2415,0,1273,1280,933,347,2.688760807,745,1072,795,289,0,289,0,71,0,0,empty,mBC-0814-1
"E2,D11",3864,4176,2778,1398,2519,13,1310,1330,940,390,2.41025641,733,4270,1980,641,0,641,0,178,0,0.054602184,empty,mBC-0814-1
"E2,D12",6106,6497,4381,2116,3737,0,2022,2023,1437,586,2.45221843,1038,3225,2409,647,0,647,0,121,0,0,empty,mBC-0814-1
"E2,E1",4884,5277,3505,1772,3074,0,1635,1639,1140,499,2.284569138,889,1537,1032,356,0,356,0,83,0,0.014044944,empty,mBC-0814-1
"E2,E2",3746,3818,2714,1104,2260,1,1165,1167,823,344,2.39244186,570,1477,961,299,0,299,0,82,0,0,empty,mBC-0814-1
"E2,E3",3450,3817,2510,1307,2225,1,1167,1168,799,369,2.165311653,621,1398,950,274,0,274,0,72,0,0,empty,mBC-0814-1
"E2,E4",3148,3537,2246,1291,2026,0,1111,1113,791,322,2.456521739,638,1109,743,263,0,263,0,72,0,0.003802281,empty,mBC-0814-1
"E2,E5",3944,4113,2845,1268,2479,0,1232,1237,886,351,2.524216524,672,887,619,189,0,189,0,43,0,0,empty,mBC-0814-1
"E2,E6",4431,4662,3194,1468,2741,0,1416,1421,1014,407,2.491400491,720,1175,809,249,0,249,0,66,0,0,empty,mBC-0814-1
"E2,E7",4347,4611,3156,1455,2752,0,1464,1468,1060,408,2.598039216,765,1307,1004,293,0,293,0,68,0,0,empty,mBC-0814-1
"E2,E8",4663,4741,3457,1284,2798,0,1414,1416,1054,362,2.91160221,693,1713,1219,346,0,346,0,81,0,0.054913295,empty,mBC-0814-1
"E2,E9",2957,3344,2097,1247,1924,0,1087,1087,810,277,2.924187726,591,2717,2046,573,0,573,0,100,0,0,empty,mBC-0814-1
"E2,E10",3793,4005,2762,1243,2407,0,1310,1315,965,350,2.757142857,664,1474,1057,335,0,335,0,88,0,0,empty,mBC-0814-1
"E2,E11",4351,4535,3054,1481,2611,0,1421,1421,1003,418,2.399521531,724,7675,2732,815,3,812,2,127,0,0.016009852,empty,mBC-0814-1
"E2,E12",3618,3860,2595,1265,2368,0,1275,1279,908,371,2.447439353,697,979,648,229,0,229,0,53,0,0.017467249,empty,mBC-0814-1
"E2,F1",4485,4809,3220,1589,2817,0,1528,1528,1055,473,2.230443975,821,1983,1427,401,0,401,0,81,0,0.059850374,empty,mBC-0814-1
"E2,F2",504651,579942,336527,243415,342241,0,214147,214392,160011,54381,2.942406355,127944,134528,97534,27425,17,27408,1,2011,0,0.000401343,mm10,mBC-0814-1
"E2,F3",5779,6322,4048,2274,3596,0,1990,1994,1490,504,2.956349206,1076,5753,2586,829,3,826,1,153,0,0.021791768,empty,mBC-0814-1
"E2,F4",5469,5782,3892,1890,3326,0,1743,1747,1262,485,2.602061856,913,557,386,128,0,128,0,42,0,0,empty,mBC-0814-1
"E2,F5",5201,5435,3717,1718,3162,0,1678,1679,1167,512,2.279296875,897,1631,1161,388,0,388,0,80,0,0,empty,mBC-0814-1
"E2,F6",4507,4798,3185,1613,2866,0,1546,1547,1066,481,2.216216216,839,2013,1374,386,0,386,0,110,0,0,empty,mBC-0814-1
"E2,F7",4346,4882,3098,1784,2920,1,1579,1583,1130,453,2.494481236,898,590,368,118,0,118,0,37,0,0,empty,mBC-0814-1
"E2,F8",5736,6059,4205,1854,3593,0,1927,1929,1381,548,2.520072993,941,214,163,74,0,74,0,20,0,0,empty,mBC-0814-1
"E2,F9",978973,1113337,653874,459463,652970,1,408495,408965,328451,80514,4.07942718,241345,350946,252033,71060,37,71023,3,3398,0,0.000323839,mm10,mBC-0814-1
"E2,F10",814857,952174,526830,425344,554218,1,368368,368732,268378,100354,2.674312932,223380,118531,83190,23708,11,23697,1,1668,0,0.000506393,mm10,mBC-0814-1
"E2,F11",4406,4506,3193,1313,2665,0,1397,1398,966,432,2.236111111,702,2208,1454,494,0,494,0,100,0,0.046558704,empty,mBC-0814-1
"E2,F12",400631,459395,265147,194248,272574,1,173441,173646,142523,31123,4.579346464,104486,1048,615,170,0,170,0,37,0,0,empty,mBC-0814-1
"E2,G1",488058,559779,330402,229377,332086,0,201893,202095,171556,30539,5.61760372,119022,236664,171712,49013,31,48982,4,2654,0,0.000530807,mm10,mBC-0814-1
"E2,G2",5422,5745,3827,1918,3366,0,1833,1837,1283,554,2.315884477,973,735,478,180,0,180,0,40,0,0.016666667,empty,mBC-0814-1
"E2,G3",1036776,1209959,682177,527782,701755,0,443543,444005,359903,84102,4.279363154,268504,670541,484434,136298,77,136221,4,4808,0,0.000161502,mm10,mBC-0814-1
"E2,G4",5160,5524,3751,1773,3206,0,1665,1667,1204,463,2.600431965,864,4,1,1,0,1,0,1,0,0,empty,mBC-0814-1
"E2,G5",4577,4883,3247,1636,2932,0,1588,1590,1076,514,2.093385214,866,18399,5902,1773,3,1770,1,177,0,0.018079096,empty,mBC-0814-1
"E2,G6",8753,9457,6356,3101,5479,0,2864,2870,2042,828,2.466183575,1511,191,145,39,0,39,0,12,0,0,empty,mBC-0814-1
"E2,G7",5197,5666,3759,1907,3336,0,1820,1824,1260,564,2.234042553,960,1932,1293,432,0,432,0,117,0,0.013888889,empty,mBC-0814-1
"E2,G8",6788,7091,4792,2299,4248,0,2287,2296,1636,660,2.478787879,1185,3591,2496,729,0,729,0,187,0,0,empty,mBC-0814-1
"E2,G9",4977,5230,3533,1697,3143,0,1759,1763,1221,542,2.252767528,940,3239,2255,757,0,757,0,179,0,0,empty,mBC-0814-1
"E2,G10",8652,9290,6222,3068,5523,0,2963,2967,2147,820,2.618292683,1636,3338,2327,731,0,731,0,177,0,0,empty,mBC-0814-1
"E2,G11",9059,9767,6513,3254,5636,1,2941,2943,2094,849,2.466431095,1598,1087,734,234,0,234,0,75,0,0,empty,mBC-0814-1
"E2,G12",4492,5002,3191,1811,2910,0,1577,1577,1096,481,2.278586279,878,2008,1469,527,0,527,0,119,0,0.032258065,empty,mBC-0814-1
"E2,H1",4616,4894,3255,1639,2843,3,1564,1570,1154,416,2.774038462,805,793,554,188,1,187,1,64,0,0.010695187,empty,mBC-0814-1
"E2,H2",7995,8906,5589,3317,5164,0,2849,2849,2003,846,2.367612293,1573,34093,11453,3773,3,3770,1,401,0,0.09204244,empty,mBC-0814-1
"E2,H3",4922,5180,3545,1635,3028,2,1612,1616,1142,474,2.4092827,833,2116,1468,425,1,424,1,97,0,0,empty,mBC-0814-1
"E2,H4",5385,5545,3827,1718,3233,0,1742,1742,1277,465,2.746236559,896,82,41,19,0,19,0,11,0,0,empty,mBC-0814-1
"E2,H5",6998,7272,5104,2168,4211,0,2194,2197,1512,685,2.20729927,1090,2276,1687,463,1,462,1,95,0,0,empty,mBC-0814-1
"E2,H6",5832,6427,4248,2179,3763,0,2029,2029,1486,543,2.73664825,1083,2578,1689,518,0,518,0,116,0,0.042471042,empty,mBC-0814-1
"E2,H7",4977,5277,3528,1749,3145,0,1686,1688,1204,484,2.487603306,920,2013,1583,449,0,449,0,83,0,0,empty,mBC-0814-1
"E2,H8",4380,4717,3148,1569,2751,0,1465,1470,1063,407,2.611793612,782,2377,1731,502,0,502,0,111,0,0,empty,mBC-0814-1
"E2,H9",4538,4847,3205,1642,2841,0,1511,1512,1080,432,2.5,837,1625,1146,308,0,308,0,59,0,0,empty,mBC-0814-1
"E2,H10",3511,3653,2589,1064,2161,0,1128,1128,797,331,2.407854985,594,1026,719,273,0,273,0,55,0,0,empty,mBC-0814-1
"E2,H11",337548,400811,220447,180364,240224,1,155428,155616,124215,31401,3.95576574,95800,3595,2487,770,1,769,1,112,0,0,empty,mBC-0814-1
"E2,H12",2050,2279,1457,822,1407,0,790,790,595,195,3.051282051,447,1259,871,242,0,242,0,76,0,0,empty,mBC-0814-1
"E3,A1",5194,5555,3778,1777,3293,1,1759,1763,1247,516,2.416666667,913,1593,1127,392,0,392,0,81,0,0,empty,mBC-0814-1
"E3,A2",4754,4954,3354,1600,2929,0,1549,1553,1154,399,2.892230576,819,2485,1735,544,0,544,0,115,0,0.012867647,empty,mBC-0814-1
"E3,A3",334819,383464,226260,157204,231973,0,143882,144045,116311,27734,4.193805437,85592,43065,28273,7713,1,7712,1,834,0,0.002463693,mm10,mBC-0814-1
"E3,A4",5268,5618,3754,1864,3299,1,1743,1750,1195,555,2.153153153,930,4799,1264,424,1,423,1,55,0,0,empty,mBC-0814-1
"E3,A5",4538,4881,3316,1565,2874,0,1541,1541,1095,446,2.455156951,806,1810,1112,322,1,321,1,60,0,0,empty,mBC-0814-1
"E3,A6",5804,6410,4026,2384,3862,0,2214,2218,1655,563,2.939609236,1251,1738,1193,334,0,334,0,64,0,0.053892216,empty,mBC-0814-1
"E3,A7",4978,5378,3715,1663,3165,1,1668,1671,1224,447,2.738255034,828,1946,1265,408,0,408,0,86,0,0.00245098,empty,mBC-0814-1
"E3,A8",1990,2224,1362,862,1283,0,727,727,544,183,2.972677596,401,1604,958,237,0,237,0,66,0,0.012658228,empty,mBC-0814-1
"E3,A9",6082,6614,4278,2336,3892,0,2086,2092,1494,598,2.498327759,1165,8042,2946,868,1,867,1,105,0,0.115340254,empty,mBC-0814-1
"E3,A10",3248,3530,2282,1248,2129,0,1199,1200,856,344,2.488372093,668,206,138,46,0,46,0,15,0,0.02173913,empty,mBC-0814-1
"E3,A11",4114,4441,2855,1586,2669,0,1492,1494,1048,446,2.349775785,840,2557,1833,553,0,553,0,96,0,0.007233273,empty,mBC-0814-1
"E3,A12",3404,3660,2444,1216,2164,0,1163,1163,854,309,2.763754045,596,3741,2626,862,0,862,0,169,0,0,empty,mBC-0814-1
"E3,B1",4305,4542,3117,1425,2855,0,1535,1538,1110,428,2.593457944,824,2559,1686,509,0,509,0,91,0,0.023575639,empty,mBC-0814-1
"E3,B2",4929,5506,3419,2087,3287,0,1848,1850,1309,541,2.419593346,1065,540,387,110,0,110,0,27,0,0,empty,mBC-0814-1
"E3,B3",3500,3817,2505,1312,2261,0,1269,1273,919,354,2.596045198,679,1611,998,302,0,302,0,54,0,0,empty,mBC-0814-1
"E3,B4",4021,4256,2891,1365,2531,0,1348,1352,946,406,2.330049261,712,1525,1055,333,0,333,0,78,0,0.006006006,empty,mBC-0814-1
"E3,B5",393042,250450,145981,104469,182152,5,109652,110158,86677,23481,3.691367489,67413,161935,115241,32095,17,32078,2,2029,0,0.001309309,mm10,mBC-0814-1
"E3,B6",3577,3771,2535,1236,2247,0,1246,1248,885,363,2.438016529,660,4160,2072,547,1,546,1,94,0,0.062271062,empty,mBC-0814-1
"E3,B7",549146,628750,372538,256212,373707,0,228022,228297,173322,54975,3.152742156,134238,97882,67523,18594,14,18580,2,1613,0,0.001184069,mm10,mBC-0814-1
"E3,B8",384776,445926,257602,188324,266317,1,164619,164818,134764,30054,4.484062022,98103,208248,151560,41996,24,41972,2,2468,0,0.000262079,mm10,mBC-0814-1
"E3,B9",4101,4371,2980,1391,2660,1,1461,1466,1040,426,2.441314554,752,980,715,238,1,237,1,67,0,0.063291139,empty,mBC-0814-1
"E3,B10",3929,4092,2728,1364,2534,0,1363,1363,954,409,2.332518337,747,795,600,190,0,190,0,31,0,0,empty,mBC-0814-1
"E3,B11",5896,6554,4222,2332,3790,2,2041,2044,1441,603,2.389718076,1131,408,202,63,0,63,0,17,0,0,empty,mBC-0814-1
"E3,B12",5078,5522,3615,1907,3249,0,1781,1782,1264,518,2.44015444,952,1746,1332,397,1,396,1,68,0,0,empty,mBC-0814-1
"E3,C1",5378,5796,3906,1890,3401,0,1791,1797,1297,500,2.594,947,1033,770,270,1,269,1,43,0,0.05204461,empty,mBC-0814-1
"E3,C2",5107,5393,3635,1758,3138,0,1659,1659,1200,459,2.614379085,877,2721,1761,540,0,540,0,113,0,0.022222222,empty,mBC-0814-1
"E3,C3",460823,524803,315417,209386,314588,2,194574,194833,143164,51669,2.770790997,113958,50494,22589,6585,4,6581,2,646,0,0.007901535,mm10,mBC-0814-1
"E3,C4",5176,5376,3698,1678,3124,0,1636,1637,1184,453,2.613686534,833,42215,12931,4049,1,4048,1,366,0,0.078804348,empty,mBC-0814-1
"E3,C5",6742,7330,4861,2469,4315,1,2381,2383,1797,586,3.066552901,1265,2247,1637,522,0,522,0,99,0,0.022988506,empty,mBC-0814-1
"E3,C6",5366,5834,3802,2032,3555,0,1950,1955,1410,545,2.587155963,1065,1408,918,277,0,277,0,76,0,0,empty,mBC-0814-1
"E3,C7",6576,6927,4650,2277,4139,0,2225,2230,1602,628,2.550955414,1199,490,344,115,0,115,0,22,0,0,empty,mBC-0814-1
"E3,C8",5207,5605,3784,1821,3291,0,1695,1703,1200,503,2.385685885,898,2185,1505,452,0,452,0,93,0,0.053097345,empty,mBC-0814-1
"E3,C9",4732,5108,3254,1854,3029,5,1699,1706,1240,466,2.660944206,931,1424,911,280,0,280,0,68,0,0,empty,mBC-0814-1
"E3,C10",5514,5953,3969,1984,3479,0,1913,1917,1353,564,2.39893617,1032,1353,829,251,0,251,0,57,0,0,empty,mBC-0814-1
"E3,C11",4379,4598,3196,1402,2780,0,1498,1499,1045,454,2.301762115,797,2044,1494,447,0,447,0,68,0,0,empty,mBC-0814-1
"E3,C12",8036,8536,5755,2781,4932,0,2668,2672,1964,708,2.774011299,1401,2620,1794,542,0,542,0,96,0,0,empty,mBC-0814-1
"E3,D1",3954,4367,2835,1532,2575,0,1396,1399,997,402,2.480099502,766,984,648,119,0,119,0,27,0,0,empty,mBC-0814-1
"E3,D2",4968,5317,3649,1668,3083,0,1589,1591,1145,446,2.567264574,823,2095,1463,392,1,391,1,81,0,0.002557545,empty,mBC-0814-1
"E3,D3",9939,10809,7018,3791,6452,1,3594,3606,2563,1043,2.457334612,1963,20549,6567,2050,3,2047,3,229,0,0.065950171,empty,mBC-0814-1
"E3,D4",296819,343237,195810,147427,208188,1,130489,130601,103863,26738,3.884471539,78760,247778,180553,49154,17,49137,3,2640,0,0,mm10,mBC-0814-1
"E3,D5",3869,4306,2693,1613,2570,0,1481,1481,1062,419,2.534606205,814,2842,2065,530,0,530,0,103,0,0,empty,mBC-0814-1
"E3,D6",5175,5444,3807,1637,3221,0,1711,1711,1239,472,2.625,887,1757,1263,398,0,398,0,76,0,0.012562814,empty,mBC-0814-1
"E3,D7",5433,5903,3821,2082,3419,0,1817,1819,1309,510,2.566666667,1014,2833,2001,521,1,520,1,98,0,0.026923077,empty,mBC-0814-1
"E3,D8",4545,4932,3176,1756,3002,0,1706,1708,1229,479,2.565762004,947,997,677,199,0,199,0,51,0,0,empty,mBC-0814-1
"E3,D9",2851,3203,1983,1220,1865,0,1052,1055,723,332,2.177710843,595,1908,1359,375,0,375,0,67,0,0.029333333,empty,mBC-0814-1
"E3,D10",3976,4492,2785,1707,2688,0,1567,1569,1140,429,2.657342657,871,1241,858,285,0,285,0,51,0,0.038596491,empty,mBC-0814-1
"E3,D11",3870,4174,2701,1473,2389,0,1269,1270,944,326,2.895705521,673,2923,2198,527,0,527,0,99,0,0,empty,mBC-0814-1
"E3,D12",5727,6072,4070,2002,3621,1,1975,1982,1391,591,2.353637902,1069,5116,3471,809,0,809,0,141,0,0,empty,mBC-0814-1
"E3,E1",599353,694614,387103,307511,415932,0,276135,276444,182828,93616,1.95295676,168178,84028,47122,13228,12,13216,3,1269,0,0.012182203,mm10,mBC-0814-1
"E3,E2",3368,3512,2406,1106,2090,0,1142,1142,787,355,2.216901408,589,1341,897,249,0,249,0,52,0,0.080321285,empty,mBC-0814-1
"E3,E3",3388,3599,2503,1096,2062,1,1047,1048,742,306,2.424836601,501,1625,1166,307,0,307,0,72,0,0.022801303,empty,mBC-0814-1
"E3,E4",2916,3062,2077,985,1830,0,1001,1001,693,308,2.25,525,1738,1319,340,2,338,2,69,0,0.091715976,empty,mBC-0814-1
"E3,E5",3559,3827,2573,1254,2338,0,1249,1251,864,387,2.23255814,670,1831,1285,305,0,305,0,58,0,0,empty,mBC-0814-1
"E3,E6",4193,4400,3095,1305,2608,0,1371,1372,950,422,2.251184834,701,2083,1419,429,0,429,0,84,0,0,empty,mBC-0814-1
"E3,E7",4427,4875,3161,1714,2824,0,1549,1556,1081,475,2.275789474,864,2160,1320,390,0,390,0,79,0,0.043589744,empty,mBC-0814-1
"E3,E8",4444,4658,3221,1437,2689,0,1409,1412,1058,354,2.988700565,701,2554,1856,511,0,511,0,94,0,0.031311155,empty,mBC-0814-1
"E3,E9",2939,3209,2131,1078,1838,0,1009,1009,733,276,2.655797101,536,1659,1124,338,0,338,0,81,0,0.00887574,empty,mBC-0814-1
"E3,E10",4210,4491,3098,1393,2623,0,1417,1421,982,439,2.23690205,719,3557,1675,523,1,522,1,101,0,0.045977011,empty,mBC-0814-1
"E3,E11",3932,4190,2893,1297,2536,0,1361,1361,925,436,2.121559633,708,1686,1078,340,0,340,0,68,0,0,empty,mBC-0814-1
"E3,E12",3752,4044,2688,1356,2396,0,1272,1273,911,362,2.516574586,673,1827,1273,315,0,315,0,59,0,0,empty,mBC-0814-1
"E3,F1",4359,4641,3072,1569,2772,0,1504,1507,1094,413,2.648910412,841,2452,1698,494,0,494,0,75,0,0.036437247,empty,mBC-0814-1
"E3,F2",6699,7230,4895,2335,4266,0,2242,2244,1655,589,2.809847199,1185,3159,2232,658,0,658,0,122,0,0,empty,mBC-0814-1
"E3,F3",4584,4890,3166,1724,2913,0,1560,1560,1139,421,2.705463183,844,1909,1378,404,0,404,0,84,0,0.007425743,empty,mBC-0814-1
"E3,F4",1039874,1175233,691648,483585,701857,2,444124,444634,332605,112029,2.968918762,262499,99494,70841,19706,11,19695,2,1545,0,0.000253872,mm10,mBC-0814-1
"E3,F5",4900,5400,3452,1948,3187,0,1745,1747,1232,515,2.39223301,957,1693,1165,336,0,336,0,66,0,0,empty,mBC-0814-1
"E3,F6",4807,5388,3436,1952,3129,0,1717,1717,1223,494,2.475708502,939,2118,1455,458,1,457,1,100,0,0,empty,mBC-0814-1
"E3,F7",4577,5013,3300,1713,2975,0,1670,1670,1170,500,2.34,876,770,559,170,0,170,0,34,0,0,empty,mBC-0814-1
"E3,F8",5759,5954,4237,1717,3541,0,1884,1886,1353,533,2.538461538,929,333,255,98,0,98,0,15,0,0,empty,mBC-0814-1
"E3,F9",587653,678163,397188,280975,401679,2,248942,249235,195303,53932,3.621282356,146853,327487,229943,64289,32,64257,4,3022,0,0.000326813,mm10,mBC-0814-1
"E3,F10",6205,6551,4460,2091,3853,0,1977,1985,1463,522,2.802681992,1059,1784,1094,346,2,344,1,78,0,0,empty,mBC-0814-1
"E3,F11",4048,4308,2931,1377,2543,0,1354,1357,998,359,2.77994429,695,1780,1275,380,0,380,0,85,0,0,empty,mBC-0814-1
"E3,F12",4614,4941,3301,1640,2960,0,1611,1613,1142,471,2.42462845,859,290,234,92,0,92,0,11,0,0,empty,mBC-0814-1
"E3,G1",6765,7160,4862,2298,4327,0,2304,2310,1608,702,2.290598291,1221,5476,3787,1038,1,1037,1,171,0,0.003857281,empty,mBC-0814-1
"E3,G2",5424,5736,3955,1781,3364,0,1782,1787,1315,472,2.786016949,924,467,294,111,0,111,0,31,0,0.072072072,empty,mBC-0814-1
"E3,G3",932933,1113105,606279,506826,654842,0,430515,430962,353896,77066,4.592115849,265425,584362,419732,117036,70,116966,6,4494,0,0.001239676,mm10,mBC-0814-1
"E3,G4",5035,5253,3702,1551,3066,0,1602,1602,1169,433,2.699769053,783,83,58,18,0,18,0,3,0,0,empty,mBC-0814-1
"E3,G5",4405,4702,3150,1552,2714,0,1483,1486,1010,476,2.121848739,777,1822,1330,409,0,409,0,71,0,0.034229829,empty,mBC-0814-1
"E3,G6",8295,8847,5976,2871,5106,0,2661,2669,1931,738,2.616531165,1402,182,91,32,0,32,0,13,0,0,empty,mBC-0814-1
"E3,G7",5084,5497,3655,1842,3288,0,1749,1751,1232,519,2.373795761,961,3125,2131,643,0,643,0,130,0,0.049766719,empty,mBC-0814-1
"E3,G8",6698,7102,4716,2386,4296,0,2345,2347,1655,692,2.391618497,1265,4461,3067,950,1,949,1,170,0,0.029504742,empty,mBC-0814-1
"E3,G9",4867,5292,3412,1880,3115,1,1762,1763,1270,493,2.576064909,946,3917,2591,789,0,789,0,150,0,0.003802281,empty,mBC-0814-1
"E3,G10",23851,26250,16943,9307,15501,0,8777,8789,6906,1883,3.667551779,4855,10317,6974,1942,2,1940,1,282,0,0.001030928,empty,mBC-0814-1
"E3,G11",8879,9324,6415,2909,5561,0,2978,2980,2132,848,2.514150943,1493,1465,1085,337,1,336,1,77,0,0,empty,mBC-0814-1
"E3,G12",4443,4669,3116,1553,2814,0,1551,1553,1105,448,2.466517857,823,2608,1864,559,0,559,0,112,0,0.037567084,empty,mBC-0814-1
"E3,H1",421646,489923,280225,209698,294618,0,189510,189703,144892,44811,3.233402513,114741,15643,10968,3027,4,3023,1,342,0,0.000330797,mm10,mBC-0814-1
"E3,H2",7647,8360,5407,2953,4924,0,2690,2693,1894,799,2.370463079,1450,4826,3478,938,1,937,1,150,0,0.001067236,empty,mBC-0814-1
"E3,H3",5065,5425,3580,1845,3195,0,1741,1742,1257,485,2.591752577,949,1964,1397,309,0,309,0,81,0,0,empty,mBC-0814-1
"E3,H4",4952,5327,3595,1732,3150,0,1761,1766,1279,487,2.626283368,930,58,37,25,0,25,0,10,0,0,empty,mBC-0814-1
"E3,H5",6274,6800,4493,2307,3985,2,2160,2173,1504,669,2.24813154,1173,2115,1381,401,0,401,0,87,0,0.004987531,empty,mBC-0814-1
"E3,H6",5946,6249,4241,2008,3721,0,2002,2008,1383,625,2.2128,1033,5328,2656,782,0,782,0,139,0,0.037084399,empty,mBC-0814-1
"E3,H7",5229,5546,3729,1817,3316,0,1815,1820,1314,506,2.596837945,986,2159,1373,402,1,401,1,63,0,0.049875312,empty,mBC-0814-1
"E3,H8",4059,4334,2884,1450,2619,0,1431,1436,1028,408,2.519607843,788,2346,1611,480,0,480,0,94,0,0,empty,mBC-0814-1
"E3,H9",4345,4642,3129,1513,2724,0,1459,1462,1023,439,2.330296128,786,2317,1676,442,1,441,1,64,0,0,empty,mBC-0814-1
"E3,H10",3228,3427,2305,1122,2031,0,1117,1119,787,332,2.370481928,575,1256,912,269,0,269,0,53,0,0,empty,mBC-0814-1
"E3,H11",330652,382587,220347,162240,229078,0,140127,140305,115857,24448,4.738915249,85240,13340,8728,2253,2,2251,1,351,0,0,mm10,mBC-0814-1
"E3,H12",2343,2494,1611,883,1506,1,859,862,626,236,2.652542373,481,1839,1311,429,0,429,0,72,0,0,empty,mBC-0814-1
"E4,A1",5765,6297,4155,2142,3659,0,2013,2020,1476,544,2.713235294,1088,1624,1140,364,1,363,1,85,0,0,empty,mBC-0814-1
"E4,A2",57826,54411,35166,19245,32085,0,18130,18169,12923,5246,2.463400686,10090,5499,3729,1038,1,1037,1,224,0,0.026036644,empty,mBC-0814-1
"E4,A3",370266,438900,242584,196316,264055,0,172653,172834,125168,47666,2.625938824,106327,29296,20107,5586,5,5581,1,653,0,0.001433435,mm10,mBC-0814-1
"E4,A4",5925,6418,4280,2138,3656,0,1934,1940,1366,574,2.379790941,1036,511,374,93,0,93,0,27,0,0,empty,mBC-0814-1
"E4,A5",4968,5267,3619,1648,3089,0,1656,1657,1192,465,2.56344086,824,1659,1308,391,0,391,0,65,0,0,empty,mBC-0814-1
"E4,A6",422655,472276,293733,178543,282187,0,169047,169249,115894,53355,2.172130072,97275,33808,17698,4836,0,4836,0,609,0,0.02770885,mm10,mBC-0814-1
"E4,A7",5634,6125,3938,2187,3588,0,1961,1962,1370,592,2.314189189,1106,1106,734,252,0,252,0,70,0,0,empty,mBC-0814-1
"E4,A8",2191,2422,1575,847,1473,0,822,826,578,248,2.330645161,455,1335,991,271,0,271,0,72,0,0,empty,mBC-0814-1
"E4,A9",6179,6758,4392,2366,4007,0,2206,2208,1528,680,2.247058824,1214,1520,1010,325,0,325,0,66,0,0,empty,mBC-0814-1
"E4,A10",3422,3632,2397,1235,2096,0,1140,1145,819,326,2.512269939,627,269,200,49,0,49,0,14,0,0,empty,mBC-0814-1
"E4,A11",4896,5227,3356,1871,3085,1,1687,1692,1233,459,2.68627451,953,2032,1280,415,0,415,0,99,0,0,empty,mBC-0814-1
"E4,A12",3532,3732,2459,1273,2227,0,1203,1209,891,318,2.801886792,651,3800,2299,704,0,704,0,182,0,0.005681818,empty,mBC-0814-1
"E4,B1",4665,5035,3384,1651,2929,1,1552,1558,1085,473,2.293868922,832,1157,875,258,0,258,0,82,0,0.003875969,empty,mBC-0814-1
"E4,B2",765942,883976,504783,379193,514619,2,323278,323654,269161,54493,4.939368359,192998,72831,48931,13573,10,13563,2,1241,0,0.00014746,mm10,mBC-0814-1
"E4,B3",4137,4575,2908,1667,2746,0,1561,1568,1103,465,2.372043011,900,1373,947,276,0,276,0,61,0,0,empty,mBC-0814-1
"E4,B4",4168,4556,2957,1599,2694,0,1501,1503,1072,431,2.487238979,801,1485,1096,285,0,285,0,76,0,0,empty,mBC-0814-1
"E4,B5",7134,6005,3855,2150,4021,0,2195,2200,1790,410,4.365853659,1261,970,691,198,1,197,1,45,0,0,empty,mBC-0814-1
"E4,B6",4051,4628,2865,1763,2650,1,1428,1433,1014,419,2.420047733,812,1170,765,218,0,218,0,44,0,0.018348624,empty,mBC-0814-1
"E4,B7",5542,5984,4045,1939,3471,1,1764,1767,1286,481,2.673596674,935,973,695,225,0,225,0,67,0,0,empty,mBC-0814-1
"E4,B8",3931,4209,2821,1388,2502,0,1356,1356,933,423,2.205673759,727,1144,867,293,0,293,0,68,0,0,empty,mBC-0814-1
"E4,B9",531173,601413,359096,242317,354444,4,217870,218111,166135,51976,3.196379098,128405,25015,17792,4823,3,4820,1,552,0,0,mm10,mBC-0814-1
"E4,B10",4395,4647,3086,1561,2745,0,1527,1534,1071,463,2.313174946,824,541,314,104,0,104,0,33,0,0,empty,mBC-0814-1
"E4,B11",476027,530286,319986,210300,311821,2,191034,191224,147490,43734,3.372433347,111261,3459,2434,757,0,757,0,123,0,0,empty,mBC-0814-1
"E4,B12",5656,6374,4031,2343,3701,0,2053,2053,1476,577,2.558058925,1121,6287,2230,682,1,681,1,110,0,0.039647577,empty,mBC-0814-1
"E4,C1",17187,18838,11969,6869,10969,0,6307,6318,4223,2095,2.01575179,3533,2065,1522,386,1,385,1,72,0,0.018181818,empty,mBC-0814-1
"E4,C2",5361,5878,3843,2035,3487,1,1948,1954,1400,554,2.527075812,1075,1804,1279,405,0,405,0,85,0,0.04691358,empty,mBC-0814-1
"E4,C3",5846,6240,4180,2060,3577,0,1899,1901,1352,549,2.462659381,979,761,450,156,0,156,0,39,0,0,empty,mBC-0814-1
"E4,C4",4917,5099,3559,1540,3096,0,1676,1680,1267,413,3.06779661,845,1050,670,268,0,268,0,80,0,0,empty,mBC-0814-1
"E4,C5",1964947,2266855,1317826,949029,1298652,0,832479,833406,636602,196804,3.234700514,495810,444405,319621,89779,52,89727,7,3847,0,0.000490376,mm10,mBC-0814-1
"E4,C6",6199,6634,4377,2257,3938,0,2163,2163,1512,651,2.322580645,1144,1500,1011,314,0,314,0,78,0,0,empty,mBC-0814-1
"E4,C7",7257,7712,5306,2406,4506,0,2418,2425,1751,674,2.597922849,1250,249,195,69,0,69,0,27,0,0,empty,mBC-0814-1
"E4,C8",5506,5864,3997,1867,3360,1,1751,1765,1264,501,2.522954092,883,2000,1259,374,0,374,0,79,0,0.002673797,empty,mBC-0814-1
"E4,C9",517778,582557,348044,234513,339366,0,196311,196591,170659,25932,6.58101959,116468,743947,477987,124249,98,124151,6,5148,0,0.000281915,mm10,mBC-0814-1
"E4,C10",5992,6524,4345,2179,3759,0,1988,1992,1456,536,2.71641791,1077,1033,703,200,1,199,1,57,0,0.065326633,empty,mBC-0814-1
"E4,C11",4841,5356,3424,1932,3102,0,1736,1738,1242,496,2.504032258,942,20037,6565,2016,6,2010,2,202,0,0.054726368,empty,mBC-0814-1
"E4,C12",8290,9154,5913,3241,5317,0,2979,2981,2143,838,2.557279236,1622,1333,925,317,0,317,0,75,0,0,empty,mBC-0814-1
"E4,D1",4529,4909,3288,1621,2795,0,1474,1482,1031,451,2.286031042,771,459,351,112,0,112,0,30,0,0,empty,mBC-0814-1
"E4,D2",860079,968229,587834,380395,557441,2,336664,337091,267766,69325,3.862473855,193839,304124,221433,60606,42,60564,3,3022,0,0.000132092,mm10,mBC-0814-1
"E4,D3",10734,11797,7549,4248,6891,0,3815,3818,2709,1109,2.442741208,2113,2054,1334,479,0,479,0,110,0,0.012526096,empty,mBC-0814-1
"E4,D4",4541,4818,3291,1527,2808,0,1550,1551,1134,417,2.71942446,797,1078,738,238,0,238,0,76,0,0,empty,mBC-0814-1
"E4,D5",4027,4504,2825,1679,2615,0,1513,1513,1075,438,2.4543379,811,3420,1791,485,0,485,0,125,0,0,empty,mBC-0814-1
"E4,D6",1127565,1350015,746609,603406,785495,3,512299,512960,409027,103933,3.935487285,314835,364656,262528,71831,35,71796,2,3369,0,0.000362137,mm10,mBC-0814-1
"E4,D7",5469,5789,3875,1914,3410,0,1829,1829,1306,523,2.497131931,988,3531,1754,570,0,570,0,100,0,0.036842105,empty,mBC-0814-1
"E4,D8",4848,5151,3437,1714,3042,2,1628,1636,1161,475,2.444210526,887,1378,795,250,0,250,0,62,0,0,empty,mBC-0814-1
"E4,D9",3200,3574,2211,1363,2093,0,1165,1167,859,308,2.788961039,667,1560,1089,327,0,327,0,65,0,0,empty,mBC-0814-1
"E4,D10",5763,6509,4074,2435,3855,0,2221,2227,1669,558,2.991039427,1233,768,531,153,0,153,0,40,0,0,empty,mBC-0814-1
"E4,D11",4025,4323,2841,1482,2561,0,1394,1397,992,405,2.449382716,750,4208,2415,687,0,687,0,138,0,0.005822416,empty,mBC-0814-1
"E4,D12",6182,6547,4435,2112,3798,0,2029,2032,1396,636,2.194968553,1034,2764,1878,592,0,592,0,110,0,0.047297297,empty,mBC-0814-1
"E4,E1",532805,621850,352027,269823,366668,0,231143,231378,189983,41395,4.589515642,139112,225603,162661,44597,33,44564,3,2573,0,0.000942465,mm10,mBC-0814-1
"E4,E2",3559,3924,2529,1395,2320,0,1313,1315,945,370,2.554054054,748,1562,1034,267,0,267,0,68,0,0,empty,mBC-0814-1
"E4,E3",475807,533478,325248,208230,315225,1,190879,191118,152214,38904,3.912553979,110244,47934,33534,9293,4,9289,1,941,0,0.003767898,mm10,mBC-0814-1
"E4,E4",3415,3693,2453,1240,2154,0,1197,1199,888,311,2.855305466,631,1301,968,296,0,296,0,75,0,0,empty,mBC-0814-1
"E4,E5",3932,4267,2864,1403,2468,0,1270,1272,917,355,2.583098592,657,991,765,193,0,193,0,46,0,0,empty,mBC-0814-1
"E4,E6",4997,5366,3563,1803,3078,0,1640,1643,1145,498,2.299196787,902,9202,3230,1031,1,1030,1,120,0,0.042718447,empty,mBC-0814-1
"E4,E7",5304,5569,3823,1746,3181,0,1694,1698,1196,502,2.38247012,871,1109,754,239,0,239,0,62,0,0,empty,mBC-0814-1
"E4,E8",4735,4947,3419,1528,2841,0,1459,1459,1070,389,2.750642674,731,1546,1147,358,0,358,0,81,0,0.06424581,empty,mBC-0814-1
"E4,E9",3129,3363,2168,1195,1956,0,1058,1061,808,253,3.193675889,554,1244,939,335,0,335,0,92,0,0.047761194,empty,mBC-0814-1
"E4,E10",4199,4557,2983,1574,2730,0,1528,1539,1072,467,2.295503212,844,1566,1021,299,0,299,0,92,0,0.066889632,empty,mBC-0814-1
"E4,E11",4299,4648,3001,1647,2749,0,1483,1484,1057,427,2.475409836,841,4630,1964,547,1,546,1,96,0,0,empty,mBC-0814-1
"E4,E12",3915,4286,2783,1503,2526,0,1413,1413,999,414,2.413043478,769,988,699,223,0,223,0,40,0,0,empty,mBC-0814-1
"E4,F1",4843,5255,3496,1759,3018,0,1602,1603,1135,468,2.425213675,861,1195,804,258,0,258,0,63,0,0,empty,mBC-0814-1
"E4,F2",7116,7360,4996,2364,4227,0,2245,2250,1572,678,2.318584071,1171,86929,23273,7573,13,7560,3,638,0,0.054497354,empty,mBC-0814-1
"E4,F3",5252,5840,3601,2239,3359,3,1910,1915,1387,528,2.626893939,1046,1527,1074,298,0,298,0,87,0,0.030201342,empty,mBC-0814-1
"E4,F4",5589,5914,4029,1885,3523,0,1877,1884,1371,513,2.67251462,976,1657,674,220,0,220,0,40,0,0,empty,mBC-0814-1
"E4,F5",5259,5538,3852,1686,3265,0,1773,1775,1232,543,2.268876611,908,1534,1086,320,1,319,1,79,0,0,empty,mBC-0814-1
"E4,F6",4614,5060,3322,1738,2946,0,1591,1593,1128,465,2.425806452,875,1908,1268,369,0,369,0,90,0,0,empty,mBC-0814-1
"E4,F7",5053,5422,3735,1687,3229,0,1729,1729,1200,529,2.268431002,894,954,732,205,0,205,0,47,0,0.004878049,empty,mBC-0814-1
"E4,F8",6224,6476,4357,2119,3799,0,2033,2034,1453,581,2.500860585,1043,571,222,90,0,90,0,20,0,0,empty,mBC-0814-1
"E4,F9",612102,689638,413755,275883,409014,0,253375,253648,204829,48819,4.195682009,148817,25598,18221,5126,2,5124,1,592,0,0.00058548,mm10,mBC-0814-1
"E4,F10",1607636,1854101,1072953,781148,1064187,1,680135,680995,559234,121761,4.592882779,403632,267838,189891,52418,31,52387,4,2929,0,0.000248153,mm10,mBC-0814-1
"E4,F11",4414,4711,3212,1499,2743,0,1428,1429,1030,399,2.581453634,728,1515,1111,305,0,305,0,66,0,0,empty,mBC-0814-1
"E4,F12",4730,5224,3421,1803,3067,0,1679,1686,1182,504,2.345238095,921,163,83,27,0,27,0,14,0,0,empty,mBC-0814-1
"E4,G1",7513,7967,5376,2591,4622,0,2419,2424,1715,709,2.418899859,1269,2628,1915,590,0,590,0,162,0,0.010169492,empty,mBC-0814-1
"E4,G2",6087,6486,4266,2220,3803,0,2124,2127,1478,649,2.277349769,1169,384,184,39,0,39,0,14,0,0,empty,mBC-0814-1
"E4,G3",382447,435976,253327,182649,261483,0,166254,166391,136171,30220,4.505989411,99673,22175,12223,3411,6,3405,2,486,0,0,mm10,mBC-0814-1
"E4,G4",5405,5750,3918,1832,3324,1,1763,1767,1248,519,2.404624277,907,26,20,11,0,11,0,4,0,0,empty,mBC-0814-1
"E4,G5",4785,4909,3396,1513,2896,0,1545,1546,1116,430,2.595348837,786,1278,905,248,0,248,0,61,0,0,empty,mBC-0814-1
"E4,G6",8951,9392,6584,2808,5316,0,2765,2767,1995,772,2.584196891,1319,116,90,50,0,50,0,20,0,0,empty,mBC-0814-1
"E4,G7",5243,5629,3759,1870,3416,0,1845,1848,1307,541,2.415896488,983,2207,1434,474,0,474,0,114,0,0.052742616,empty,mBC-0814-1
"E4,G8",7099,7669,5090,2579,4507,0,2475,2475,1771,704,2.515625,1323,3781,2379,794,0,794,0,192,0,0.023929471,empty,mBC-0814-1
"E4,G9",5164,5590,3640,1950,3270,0,1831,1833,1291,542,2.381918819,1003,3058,2336,610,1,609,1,137,0,0,empty,mBC-0814-1
"E4,G10",474824,527726,325982,201744,315266,1,188682,188940,147859,41081,3.599206446,108471,48017,34925,10111,4,10107,1,1020,0,0.002473533,mm10,mBC-0814-1
"E4,G11",604572,692068,406427,285641,405563,0,250014,250283,208393,41890,4.974767248,147958,44150,30812,8582,4,8578,1,857,0,0.000466309,mm10,mBC-0814-1
"E4,G12",4453,5015,3074,1941,2991,0,1653,1656,1173,483,2.428571429,982,1579,1180,381,0,381,0,85,0,0.002624672,empty,mBC-0814-1
"E4,H1",597148,667849,409308,258541,393865,0,239363,239627,177773,61854,2.874074433,138773,9008,6382,1850,3,1847,1,259,0,0.006497022,mm10,mBC-0814-1
"E4,H2",8213,8826,5924,2902,5204,0,2850,2854,2024,830,2.438554217,1518,2740,1977,637,0,637,0,161,0,0.023547881,empty,mBC-0814-1
"E4,H3",5346,5792,3782,2010,3421,0,1858,1860,1349,511,2.639921722,1033,1495,1065,395,0,395,0,83,0,0,empty,mBC-0814-1
"E4,H4",5545,6029,3894,2135,3490,0,1907,1909,1390,519,2.67822736,1042,179,155,55,0,55,0,15,0,0,empty,mBC-0814-1
"E4,H5",7072,7608,5081,2527,4397,0,2406,2416,1754,662,2.649546828,1306,1762,1244,351,3,348,1,80,0,0,empty,mBC-0814-1
"E4,H6",6184,6456,4527,1929,3692,0,1922,1928,1379,549,2.511839709,933,1903,1344,398,0,398,0,106,0,0,empty,mBC-0814-1
"E4,H7",5411,6017,3910,2107,3533,0,1974,1975,1425,550,2.590909091,1040,1707,1175,331,0,331,0,83,0,0.009063444,empty,mBC-0814-1
"E4,H8",376556,443703,246844,196859,263120,1,167386,167549,140541,27008,5.203680391,102391,292732,186432,53412,32,53380,4,2929,0,0.002341701,mm10,mBC-0814-1
"E4,H9",4666,4917,3352,1565,2988,6,1579,1589,1140,449,2.538975501,833,1222,843,240,0,240,0,58,0,0.05,empty,mBC-0814-1
"E4,H10",3638,3765,2533,1232,2206,0,1191,1197,826,371,2.226415094,632,5282,1892,651,0,651,0,98,0,0.036866359,empty,mBC-0814-1
"E4,H11",4281,4584,2916,1668,2714,0,1549,1549,1074,475,2.261052632,875,1182,440,120,0,120,0,28,0,0,empty,mBC-0814-1
"E4,H12",2398,2644,1613,1031,1600,0,935,939,666,273,2.43956044,540,1229,822,258,0,258,0,62,0,0,empty,mBC-0814-1
"E5,A1",4966,5416,3610,1806,3162,2,1690,1695,1212,483,2.50931677,933,1980,1381,346,0,346,0,66,0,0,empty,mBC-0814-1
"E5,A2",4782,5037,3322,1715,2901,0,1519,1519,1122,397,2.826196474,847,22870,7671,2581,3,2578,1,264,0,0.1613654,empty,mBC-0814-1
"E5,A3",529677,610793,349827,260966,361628,0,225914,226158,184402,41756,4.416179711,135372,261814,182825,51426,41,51385,7,2749,0,9.73047E-05,mm10,mBC-0814-1
"E5,A4",5169,5376,3681,1695,3080,0,1623,1627,1211,416,2.911057692,834,485,311,108,1,107,1,20,0,0,empty,mBC-0814-1
"E5,A5",4346,4699,3073,1626,2757,0,1518,1519,1080,439,2.460136674,822,28166,9454,2866,4,2862,2,272,0,0.033193571,empty,mBC-0814-1
"E5,A6",3241,3415,2354,1061,1983,0,1073,1077,756,321,2.355140187,526,2020,1181,399,0,399,0,72,0,0.015037594,empty,mBC-0814-1
"E5,A7",368432,411537,251502,160035,248754,0,150663,150824,114863,35961,3.194099163,87044,40932,27556,7555,4,7551,1,790,0,0.000132433,mm10,mBC-0814-1
"E5,A8",167946,190349,112278,78071,115646,0,70273,70385,59909,10476,5.71869034,41493,181624,130802,35809,21,35788,2,2296,0,0.000167654,mm10,mBC-0814-1
"E5,A9",5388,5798,3805,1993,3432,0,1861,1861,1348,513,2.627680312,991,2055,1282,341,1,340,1,68,0,0,empty,mBC-0814-1
"E5,A10",2909,3141,2032,1109,1924,0,1093,1093,772,321,2.404984424,614,207,143,54,0,54,0,13,0,0,empty,mBC-0814-1
"E5,A11",3918,4077,2819,1258,2445,0,1297,1300,955,345,2.768115942,650,1989,1372,410,1,409,1,78,0,0.034229829,empty,mBC-0814-1
"E5,A12",3415,3691,2307,1384,2234,4,1249,1254,907,347,2.613832853,729,46583,13607,4253,4,4249,2,367,0,0.109908214,empty,mBC-0814-1
"E5,B1",3957,4377,2811,1566,2649,1,1419,1420,963,457,2.107221007,799,1529,1062,281,0,281,0,70,0,0,empty,mBC-0814-1
"E5,B2",445904,522003,296104,225899,312083,0,194523,194728,168245,26483,6.352943398,117457,85612,55024,15451,13,15438,3,1295,0,0.000971628,mm10,mBC-0814-1
"E5,B3",3454,3746,2467,1279,2256,0,1275,1275,886,389,2.277634961,678,1276,988,280,2,278,2,52,0,0,empty,mBC-0814-1
"E5,B4",3660,3852,2639,1213,2342,0,1277,1280,938,342,2.742690058,634,1162,792,201,0,201,0,53,0,0.004975124,empty,mBC-0814-1
"E5,B5",3145,2021,1255,766,1474,0,854,860,607,253,2.399209486,509,1628,1094,317,0,317,0,52,0,0.003154574,empty,mBC-0814-1
"E5,B6",3400,3880,2425,1455,2260,0,1258,1260,892,368,2.423913043,721,1428,1095,361,0,361,0,55,0,0.038781163,empty,mBC-0814-1
"E5,B7",4438,4691,3249,1442,2821,0,1497,1497,1021,476,2.144957983,746,963,718,205,0,205,0,46,0,0.029268293,empty,mBC-0814-1
"E5,B8",3306,3576,2385,1191,2123,0,1154,1154,796,358,2.223463687,636,2775,2101,633,0,633,0,90,0,0,empty,mBC-0814-1
"E5,B9",696976,814993,465884,349109,483313,0,304182,304480,235470,69010,3.412114186,182712,221127,152666,43160,31,43129,3,2502,0,0.000255049,mm10,mBC-0814-1
"E5,B10",3697,3889,2626,1263,2314,0,1260,1261,922,339,2.719764012,639,494,361,100,0,100,0,25,0,0,empty,mBC-0814-1
"E5,B11",8035,8858,5494,3364,5144,0,2854,2857,2248,609,3.691297209,1603,166,126,34,0,34,0,12,0,0,empty,mBC-0814-1
"E5,B12",350073,425474,215209,210265,254821,3,173735,173917,101932,71985,1.416017226,110926,188417,135965,36770,26,36744,2,2185,0,0.00163292,mm10,mBC-0814-1
"E5,C1",4583,4886,3394,1492,2775,1,1427,1428,1020,408,2.5,719,909,654,185,1,184,1,39,0,0,empty,mBC-0814-1
"E5,C2",4766,5034,3452,1582,2925,0,1553,1558,1090,468,2.329059829,791,1334,924,288,0,288,0,70,0,0.052083333,empty,mBC-0814-1
"E5,C3",5096,5284,3727,1557,3238,0,1718,1718,1215,503,2.415506958,867,816,566,150,0,150,0,34,0,0,empty,mBC-0814-1
"E5,C4",4548,4934,3283,1651,2839,0,1506,1510,1104,406,2.719211823,795,2204,1542,400,0,400,0,75,0,0.0275,empty,mBC-0814-1
"E5,C5",6115,6636,4466,2170,3880,0,2078,2078,1516,562,2.697508897,1072,869,557,197,0,197,0,63,0,0.005076142,empty,mBC-0814-1
"E5,C6",4838,5090,3570,1520,3073,0,1626,1629,1120,509,2.200392927,821,1634,1196,300,0,300,0,69,0,0,empty,mBC-0814-1
"E5,C7",6180,6596,4467,2129,3791,0,1984,1989,1450,539,2.690166976,1024,560,421,116,0,116,0,18,0,0.086206897,empty,mBC-0814-1
"E5,C8",4828,5041,3508,1533,2966,2,1554,1558,1089,469,2.32196162,790,1965,1348,437,0,437,0,83,0,0.011441648,empty,mBC-0814-1
"E5,C9",3927,4256,2837,1419,2478,0,1308,1311,917,394,2.327411168,718,1124,715,233,0,233,0,47,0,0.068669528,empty,mBC-0814-1
"E5,C10",4697,4982,3389,1593,3065,0,1608,1611,1153,458,2.517467249,864,758,474,162,1,161,1,33,0,0,empty,mBC-0814-1
"E5,C11",4217,4564,3021,1543,2681,0,1489,1490,1026,464,2.211206897,800,1686,1125,377,0,377,0,57,0,0,empty,mBC-0814-1
"E5,C12",7277,7682,5246,2436,4418,0,2373,2378,1728,650,2.658461538,1233,2216,1603,483,0,483,0,72,0,0.01242236,empty,mBC-0814-1
"E5,D1",3977,4324,2822,1502,2583,0,1365,1367,974,393,2.478371501,785,677,470,133,0,133,0,25,0,0,empty,mBC-0814-1
"E5,D2",4850,5118,3440,1678,3016,0,1608,1608,1161,447,2.597315436,849,19294,5680,1778,1,1777,1,175,0,0.126055149,empty,mBC-0814-1
"E5,D3",9159,9612,6517,3095,5681,1,2994,2998,2126,872,2.438073394,1567,2789,1916,607,1,606,1,100,0,0.04950495,empty,mBC-0814-1
"E5,D4",3854,4027,2783,1244,2403,0,1228,1229,913,316,2.889240506,620,1381,820,238,0,238,0,58,0,0,empty,mBC-0814-1
"E5,D5",3509,3843,2416,1427,2306,0,1293,1293,919,374,2.457219251,719,1991,1434,385,0,385,0,86,0,0,empty,mBC-0814-1
"E5,D6",4423,4829,3175,1654,2816,3,1552,1556,1113,443,2.51241535,851,1181,821,269,0,269,0,53,0,0.003717472,empty,mBC-0814-1
"E5,D7",5004,5326,3642,1684,3126,10,1661,1672,1190,482,2.468879668,869,3884,2417,643,0,643,0,112,0,0.01244168,empty,mBC-0814-1
"E5,D8",4151,4507,3028,1479,2644,0,1441,1445,1021,424,2.408018868,740,1159,809,268,0,268,0,47,0,0,empty,mBC-0814-1
"E5,D9",2689,2892,1855,1037,1721,17,995,1012,757,255,2.968627451,529,1339,947,280,1,279,1,54,0,0,empty,mBC-0814-1
"E5,D10",3316,3549,2402,1147,2088,1,1152,1155,831,324,2.564814815,588,831,552,183,0,183,0,37,0,0.06010929,empty,mBC-0814-1
"E5,D11",315134,358143,212817,145326,216666,0,133831,133977,103840,30137,3.445598434,78839,60217,42696,11830,5,11825,1,1124,0,0.002790698,mm10,mBC-0814-1
"E5,D12",5526,5764,3921,1843,3393,3,1841,1848,1344,504,2.666666667,962,3507,2540,779,1,778,1,111,0,0,empty,mBC-0814-1
"E5,E1",4424,4701,3206,1495,2767,0,1482,1486,1080,406,2.660098522,773,1745,1174,344,0,344,0,75,0,0,empty,mBC-0814-1
"E5,E2",3325,3517,2321,1196,2084,0,1140,1142,821,321,2.557632399,619,1156,714,248,1,247,1,39,0,0,empty,mBC-0814-1
"E5,E3",3092,3325,2251,1074,2007,0,1060,1063,756,307,2.462540717,563,5246,1991,625,1,624,1,85,0,0,empty,mBC-0814-1
"E5,E4",2702,3052,1909,1143,1762,0,986,986,689,297,2.31986532,560,1274,823,213,0,213,0,63,0,0.009389671,empty,mBC-0814-1
"E5,E5",3143,3360,2262,1098,2001,0,1042,1043,761,282,2.69858156,539,1471,1090,329,0,329,0,54,0,0,empty,mBC-0814-1
"E5,E6",3903,4086,2835,1251,2424,0,1252,1252,917,335,2.737313433,639,1634,1132,280,0,280,0,63,0,0,empty,mBC-0814-1
"E5,E7",3998,4227,2906,1321,2467,0,1290,1293,859,434,1.979262673,677,1763,1337,384,0,384,0,52,0,0,empty,mBC-0814-1
"E5,E8",3996,4275,2904,1371,2571,0,1345,1346,921,425,2.167058824,740,1664,1105,322,0,322,0,65,0,0,empty,mBC-0814-1
"E5,E9",2734,3000,1974,1026,1721,0,940,941,681,260,2.619230769,500,1267,857,276,0,276,0,55,0,0.007246377,empty,mBC-0814-1
"E5,E10",3622,3905,2565,1340,2375,0,1329,1332,958,374,2.561497326,712,1320,854,272,0,272,0,60,0,0,empty,mBC-0814-1
"E5,E11",3936,4222,2777,1445,2464,0,1332,1332,942,390,2.415384615,707,13278,4100,1322,0,1322,0,150,0,0.016641452,empty,mBC-0814-1
"E5,E12",3248,3420,2374,1046,2040,0,1023,1023,731,292,2.503424658,510,1273,881,274,0,274,0,46,0,0.018248175,empty,mBC-0814-1
"E5,F1",4066,4379,3015,1364,2648,0,1399,1399,956,443,2.158013544,730,1512,1074,350,0,350,0,59,0,0.105714286,empty,mBC-0814-1
"E5,F2",5952,6285,4221,2064,3761,0,2062,2063,1483,580,2.556896552,1108,2604,1874,532,1,531,1,90,0,0,empty,mBC-0814-1
"E5,F3",15318,17317,11018,6299,10170,0,5559,5563,4292,1271,3.376868607,3124,18352,11464,3023,3,3020,2,404,0,0.003311258,empty,mBC-0814-1
"E5,F4",4502,4794,3258,1536,2856,0,1527,1528,1085,443,2.449209932,813,541,273,112,1,111,1,29,0,0,empty,mBC-0814-1
"E5,F5",4516,4867,3242,1625,2861,7,1581,1589,1131,458,2.469432314,869,1675,983,295,0,295,0,59,0,0,empty,mBC-0814-1
"E5,F6",4296,4604,3112,1492,2744,1,1448,1452,1037,415,2.498795181,782,2409,1690,489,2,487,1,86,0,0.036960986,empty,mBC-0814-1
"E5,F7",4059,4329,2960,1369,2512,0,1304,1308,939,369,2.544715447,668,796,635,162,0,162,0,33,0,0,empty,mBC-0814-1
"E5,F8",5238,5601,3748,1853,3392,0,1837,1837,1369,468,2.925213675,990,96,68,32,0,32,0,13,0,0,empty,mBC-0814-1
"E5,F9",4984,5289,3611,1678,3001,0,1546,1550,1129,421,2.681710214,787,2271,1669,432,0,432,0,77,0,0,empty,mBC-0814-1
"E5,F10",5793,6219,4125,2094,3581,1,1907,1910,1346,564,2.386524823,1006,6016,2322,745,1,744,1,110,0,0.034946237,empty,mBC-0814-1
"E5,F11",3954,4277,2840,1437,2503,0,1348,1348,975,373,2.613941019,706,1468,974,269,0,269,0,67,0,0,empty,mBC-0814-1
"E5,F12",4281,4460,3066,1394,2612,0,1429,1433,984,449,2.191536748,741,1609,479,139,0,139,0,26,0,0,empty,mBC-0814-1
"E5,G1",6487,6908,4729,2179,4094,0,2114,2115,1485,630,2.357142857,1084,2588,1842,621,0,621,0,118,0,0.037037037,empty,mBC-0814-1
"E5,G2",4958,5308,3554,1754,3149,0,1640,1643,1154,489,2.3599182,894,460,317,91,0,91,0,21,0,0,empty,mBC-0814-1
"E5,G3",4423,4671,3122,1549,2792,0,1527,1531,1022,509,2.007858546,805,2795,2056,493,3,490,2,94,0,0.016326531,empty,mBC-0814-1
"E5,G4",4517,4730,3245,1485,2849,1,1538,1539,1126,413,2.726392252,792,36,26,10,0,10,0,3,0,0,empty,mBC-0814-1
"E5,G5",4035,4335,3019,1316,2583,0,1345,1345,949,396,2.396464646,688,1494,1049,333,1,332,1,65,0,0.003012048,empty,mBC-0814-1
"E5,G6",7640,8172,5519,2653,4811,0,2544,2546,1769,777,2.276705277,1322,195,57,27,0,27,0,8,0,0,empty,mBC-0814-1
"E5,G7",4776,4964,3473,1491,3008,0,1573,1576,1097,479,2.290187891,812,7885,3345,960,1,959,1,146,0,0.066736184,empty,mBC-0814-1
"E5,G8",6440,7038,4576,2462,4111,0,2259,2262,1592,670,2.376119403,1227,5929,3447,1018,0,1018,0,167,0,0.015717092,empty,mBC-0814-1
"E5,G9",4535,4950,3271,1679,2918,1,1627,1629,1162,467,2.488222698,864,2991,2146,606,0,606,0,112,0,0,empty,mBC-0814-1
"E5,G10",7757,8148,5599,2549,4791,0,2552,2561,1845,716,2.576815642,1281,3740,2693,908,0,908,0,175,0,0.004405286,empty,mBC-0814-1
"E5,G11",7924,8139,5706,2433,4869,0,2543,2546,1847,699,2.642346209,1275,1914,1425,423,1,422,1,77,0,0.002369668,empty,mBC-0814-1
"E5,G12",3978,4411,2708,1703,2589,0,1477,1477,1069,408,2.620098039,831,2404,1909,522,0,522,0,97,0,0.001915709,empty,mBC-0814-1
"E5,H1",4005,4315,2805,1510,2536,0,1399,1408,989,419,2.360381862,741,1307,925,229,0,229,0,42,0,0,empty,mBC-0814-1
"E5,H2",7526,8177,5274,2903,4640,0,2559,2561,1865,696,2.679597701,1369,3948,2927,875,0,875,0,141,0,0,empty,mBC-0814-1
"E5,H3",4729,4999,3362,1637,3007,0,1635,1635,1166,469,2.486140725,873,1646,1165,378,0,378,0,79,0,0,empty,mBC-0814-1
"E5,H4",425342,500859,280804,220055,297576,0,188413,188625,163142,25483,6.401993486,114546,14011,10309,2845,0,2845,0,316,0,0,mm10,mBC-0814-1
"E5,H5",6014,6481,4364,2117,3731,0,2010,2014,1404,610,2.301639344,1061,2211,1664,382,1,381,1,75,0,0.007874016,empty,mBC-0814-1
"E5,H6",5728,6273,4035,2238,3639,0,1973,1976,1452,524,2.770992366,1118,2769,2032,629,0,629,0,95,0,0.027027027,empty,mBC-0814-1
"E5,H7",4653,4919,3191,1728,2992,1,1651,1659,1154,505,2.285148515,918,21913,6691,2119,4,2115,2,208,0,0.002836879,empty,mBC-0814-1
"E5,H8",6121,7081,4300,2781,4119,3,2422,2432,1876,556,3.374100719,1394,3787,2714,819,0,819,0,116,0,0,empty,mBC-0814-1
"E5,H9",4487,4703,3196,1507,2794,0,1521,1524,1058,466,2.270386266,776,1714,1133,316,0,316,0,57,0,0,empty,mBC-0814-1
"E5,H10",2988,3259,2135,1124,1913,0,1063,1064,744,320,2.325,562,1085,849,229,0,229,0,42,0,0,empty,mBC-0814-1
"E5,H11",387116,438881,258746,180135,261506,2,158086,158254,130266,27988,4.654351865,92967,10863,6976,2037,2,2035,2,237,0,0.004422604,mm10,mBC-0814-1
"E5,H12",205680,237235,133791,103444,144970,1,91032,91129,72665,18464,3.935496101,55171,208110,151925,41922,19,41903,1,2252,0,0.000835262,mm10,mBC-0814-1
"E6,A1",4720,4923,3308,1615,2923,0,1517,1528,1080,448,2.410714286,790,1001,703,216,0,216,0,50,0,0.013888889,empty,mBC-0814-1
"E6,A2",460619,505509,309013,196496,291929,2,174548,174746,142859,31887,4.48016433,100173,106838,77776,22182,9,22173,1,1698,0,0.0001353,mm10,mBC-0814-1
"E6,A3",4197,4558,3034,1524,2579,0,1386,1393,1020,373,2.73458445,740,1618,729,271,0,271,0,69,0,0,empty,mBC-0814-1
"E6,A4",4818,5094,3454,1640,2890,0,1507,1509,1094,415,2.636144578,765,264,147,41,0,41,0,16,0,0,empty,mBC-0814-1
"E6,A5",4202,4478,2944,1534,2562,0,1390,1393,1006,387,2.599483204,740,1154,766,247,0,247,0,56,0,0,empty,mBC-0814-1
"E6,A6",3265,3507,2425,1082,2006,0,1087,1089,788,301,2.617940199,548,1820,1353,371,0,371,0,77,0,0,empty,mBC-0814-1
"E6,A7",4888,5361,3542,1819,3061,0,1642,1643,1163,480,2.422916667,842,18156,5251,1525,4,1521,3,159,0,0.019066404,empty,mBC-0814-1
"E6,A8",2020,2261,1356,905,1287,0,714,716,518,198,2.616161616,407,1480,1089,302,0,302,0,72,0,0,empty,mBC-0814-1
"E6,A9",5554,5830,4034,1796,3323,3,1778,1782,1271,511,2.487279843,924,1874,1345,403,0,403,0,63,0,0.022332506,empty,mBC-0814-1
"E6,A10",2935,3207,2040,1167,1828,0,961,963,712,251,2.836653386,527,390,272,68,0,68,0,19,0,0,empty,mBC-0814-1
"E6,A11",4028,4073,2898,1175,2453,0,1346,1346,939,407,2.307125307,677,2710,1489,426,0,426,0,85,0,0,empty,mBC-0814-1
"E6,A12",3477,3667,2536,1131,2121,0,1153,1153,834,319,2.614420063,583,2719,1917,559,0,559,0,177,0,0,empty,mBC-0814-1
"E6,B1",453642,515829,301411,214418,301761,1,184811,185057,158480,26577,5.963050758,109586,148342,108620,30203,7,30196,2,1963,0,0,mm10,mBC-0814-1
"E6,B2",6858,7896,4453,3443,4666,1,2991,2996,1563,1433,1.090718772,1847,12154,3040,963,3,960,2,105,0,0.069791667,empty,mBC-0814-1
"E6,B3",3446,3977,2477,1500,2300,0,1264,1266,906,360,2.516666667,703,1278,798,232,1,231,1,57,0,0.056277056,empty,mBC-0814-1
"E6,B4",3503,3853,2511,1342,2250,0,1276,1276,875,401,2.182044888,705,1329,861,264,0,264,0,56,0,0,empty,mBC-0814-1
"E6,B5",3585,2716,1619,1097,1848,0,1066,1069,775,294,2.636054422,636,1056,673,222,0,222,0,58,0,0,empty,mBC-0814-1
"E6,B6",3304,3435,2426,1009,2022,0,1049,1051,809,242,3.342975207,529,918,588,191,1,190,1,56,0,0.068421053,empty,mBC-0814-1
"E6,B7",4373,4833,3159,1674,2738,0,1477,1478,1082,396,2.732323232,799,1077,650,187,0,187,0,51,0,0.090909091,empty,mBC-0814-1
"E6,B8",3316,3419,2393,1026,1982,0,1073,1073,776,297,2.612794613,537,1286,911,279,0,279,0,70,0,0,empty,mBC-0814-1
"E6,B9",526742,604710,348912,255798,349969,0,219917,220190,171484,48706,3.520798259,131199,76133,51964,14961,5,14956,2,1176,0,0.000334314,mm10,mBC-0814-1
"E6,B10",3690,3723,2510,1213,2262,0,1214,1222,800,422,1.895734597,657,499,363,150,0,150,0,32,0,0,empty,mBC-0814-1
"E6,B11",6308,6983,4505,2478,3946,1,2203,2204,1579,625,2.5264,1237,252,206,64,0,64,0,18,0,0,empty,mBC-0814-1
"E6,B12",4591,4933,3230,1703,2849,0,1550,1555,1071,484,2.212809917,844,1293,972,255,0,255,0,72,0,0.003921569,empty,mBC-0814-1
"E6,C1",4747,5029,3483,1546,2872,0,1476,1479,1091,388,2.81185567,737,1250,798,213,0,213,0,59,0,0.03286385,empty,mBC-0814-1
"E6,C2",4700,5127,3330,1797,2944,0,1605,1608,1154,454,2.54185022,847,1718,1182,372,0,372,0,101,0,0,empty,mBC-0814-1
"E6,C3",5552,5869,3979,1890,3367,0,1815,1815,1276,539,2.367346939,939,860,520,172,0,172,0,50,0,0,empty,mBC-0814-1
"E6,C4",4416,4658,3139,1519,2702,0,1426,1430,1032,398,2.592964824,753,11871,3502,1068,0,1068,0,146,0,0.012172285,empty,mBC-0814-1
"E6,C5",6340,6834,4481,2353,3939,0,2119,2122,1548,574,2.696864111,1168,1469,948,289,1,288,1,92,0,0.03125,empty,mBC-0814-1
"E6,C6",6019,6637,4200,2437,3917,0,2211,2212,1648,564,2.921985816,1213,1101,805,263,0,263,0,89,0,0,empty,mBC-0814-1
"E6,C7",506589,600364,334219,266145,350363,1,226498,226748,184059,42689,4.311625946,138039,23116,15925,4478,2,4476,2,506,0,0.000223414,mm10,mBC-0814-1
"E6,C8",4774,5033,3410,1623,2868,0,1531,1531,1139,392,2.905612245,797,3413,1672,527,0,527,0,91,0,0.028462998,empty,mBC-0814-1
"E6,C9",4124,4558,2992,1566,2590,0,1379,1381,926,455,2.035164835,756,1225,795,283,0,283,0,70,0,0,empty,mBC-0814-1
"E6,C10",557169,657241,371200,286041,381577,0,244768,245065,186012,59053,3.149916177,147731,107901,67408,18936,19,18917,2,1455,0,0.00148015,mm10,mBC-0814-1
"E6,C11",3864,4173,2871,1302,2362,0,1268,1268,919,349,2.633237822,636,1213,899,262,0,262,0,65,0,0.045801527,empty,mBC-0814-1
"E6,C12",6975,7522,4898,2624,4319,0,2322,2327,1625,702,2.314814815,1280,1438,965,299,1,298,1,79,0,0.080536913,empty,mBC-0814-1
"E6,D1",1013131,1143294,678518,464776,663300,1,414061,414556,325832,88724,3.672422343,243118,112998,78354,22543,11,22532,1,1669,0,0,mm10,mBC-0814-1
"E6,D2",4598,4627,3314,1313,2649,0,1356,1358,976,382,2.554973822,644,1854,1337,427,0,427,0,90,0,0.004683841,empty,mBC-0814-1
"E6,D3",191207,222619,127236,95383,130791,0,81995,82088,65347,16741,3.903410788,48881,112404,79798,21884,12,21872,1,1491,0,0.000777249,mm10,mBC-0814-1
"E6,D4",359525,419314,237260,182054,247886,8,156613,156808,116868,39940,2.926089134,95176,268981,154538,44643,37,44606,4,2747,0,0.017957225,mm10,mBC-0814-1
"E6,D5",330304,381573,217021,164552,226122,0,141201,141343,115566,25777,4.483299065,85101,283703,203274,55991,37,55954,3,2907,0,0.000822104,mm10,mBC-0814-1
"E6,D6",4272,4805,3033,1772,2746,0,1499,1505,1063,442,2.404977376,848,879,656,218,0,218,0,57,0,0,empty,mBC-0814-1
"E6,D7",331828,387659,216753,170906,230289,0,150097,150257,112125,38132,2.940443722,91681,98491,56084,15690,12,15678,1,1319,0,0.024556704,mm10,mBC-0814-1
"E6,D8",3998,4241,2854,1387,2505,1,1378,1379,999,380,2.628947368,742,654,476,156,0,156,0,43,0,0,empty,mBC-0814-1
"E6,D9",2658,2863,1799,1064,1677,0,935,937,687,250,2.748,522,5406,1875,584,1,583,1,90,0,0,empty,mBC-0814-1
"E6,D10",550792,647201,367979,279222,375638,1,238103,238403,182757,55646,3.284279193,144199,58276,43157,12214,10,12204,1,1095,0,0,mm10,mBC-0814-1
"E6,D11",3497,3586,2557,1029,2093,1,1124,1127,814,313,2.600638978,552,2938,1773,547,0,547,0,133,0,0,empty,mBC-0814-1
"E6,D12",5787,6385,3824,2561,3571,1,2029,2032,1486,546,2.721611722,1202,171475,50716,15831,32,15799,6,1118,0,0.105576302,empty,mBC-0814-1
"E6,E1",459536,530702,306352,224350,309803,1,192682,192939,155578,37361,4.164181901,114894,251118,176202,49656,36,49620,3,2548,0,0.000201532,mm10,mBC-0814-1
"E6,E2",3079,3371,2238,1133,1972,0,1089,1094,770,324,2.37654321,582,1344,714,253,0,253,0,62,0,0.090909091,empty,mBC-0814-1
"E6,E3",3110,3230,2323,907,1861,0,933,938,664,274,2.423357664,448,970,737,250,0,250,0,65,0,0,empty,mBC-0814-1
"E6,E4",2525,2696,1834,862,1565,0,832,832,588,244,2.409836066,444,952,684,218,0,218,0,65,0,0.100917431,empty,mBC-0814-1
"E6,E5",3176,3194,2316,878,1887,0,1018,1020,721,299,2.411371237,496,1043,766,212,0,212,0,46,0,0,empty,mBC-0814-1
"E6,E6",3811,4095,2778,1317,2339,0,1207,1209,841,368,2.285326087,621,771,522,148,0,148,0,48,0,0,empty,mBC-0814-1
"E6,E7",3832,4102,2801,1301,2330,0,1249,1254,886,368,2.407608696,654,1314,1013,280,0,280,0,55,0,0.021428571,empty,mBC-0814-1
"E6,E8",3883,3914,2777,1137,2341,1,1225,1228,883,345,2.55942029,603,1493,1104,288,0,288,0,57,0,0,empty,mBC-0814-1
"E6,E9",2715,2904,1939,965,1693,0,924,927,689,238,2.894957983,479,4727,1669,496,0,496,0,96,0,0.030241935,empty,mBC-0814-1
"E6,E10",3610,4098,2615,1483,2313,0,1281,1284,938,346,2.710982659,709,1259,813,255,0,255,0,69,0,0.003921569,empty,mBC-0814-1
"E6,E11",3608,3750,2578,1172,2237,0,1220,1220,864,356,2.426966292,627,1562,1141,323,0,323,0,67,0,0.018575851,empty,mBC-0814-1
"E6,E12",3388,3658,2466,1192,2122,0,1138,1138,802,336,2.386904762,588,974,743,262,0,262,0,57,0,0,empty,mBC-0814-1
"E6,F1",4100,4347,2989,1358,2502,0,1316,1318,939,379,2.477572559,666,1434,1014,357,0,357,0,77,0,0.056022409,empty,mBC-0814-1
"E6,F2",5630,6022,4094,1928,3488,1,1861,1864,1337,527,2.537001898,981,1794,1232,430,1,429,1,107,0,0,empty,mBC-0814-1
"E6,F3",4375,4902,3060,1842,2781,0,1516,1519,1071,448,2.390625,829,1807,1284,375,0,375,0,75,0,0,empty,mBC-0814-1
"E6,F4",6548,7430,4659,2771,4341,0,2506,2516,2001,515,3.885436893,1421,1865,779,245,0,245,0,48,0,0.028571429,empty,mBC-0814-1
"E6,F5",584179,674913,390480,284433,389882,1,245628,245904,191294,54610,3.502911555,146457,185580,133768,37204,28,37176,6,2221,0,0.000376587,mm10,mBC-0814-1
"E6,F6",4335,4858,3051,1807,2777,0,1534,1539,1055,484,2.179752066,870,1403,1001,383,1,382,1,96,0,0.02617801,empty,mBC-0814-1
"E6,F7",3803,3910,2727,1183,2336,0,1268,1268,930,338,2.75147929,656,508,370,90,0,90,0,33,0,0,empty,mBC-0814-1
"E6,F8",5783,6215,4076,2139,3629,0,1959,1963,1467,496,2.95766129,1052,1481,651,194,1,193,1,25,0,0.103626943,empty,mBC-0814-1
"E6,F9",491842,555979,326579,229400,325994,1,206914,207167,154035,53132,2.899100354,122565,57125,39838,10944,4,10940,1,1076,0,0.002102377,mm10,mBC-0814-1
"E6,F10",5782,6157,4115,2042,3478,1,1828,1833,1287,546,2.357142857,988,6371,2385,704,1,703,1,105,0,0.052631579,empty,mBC-0814-1
"E6,F11",3696,3892,2703,1189,2264,0,1212,1213,858,355,2.416901408,602,788,514,200,0,200,0,59,0,0.005,empty,mBC-0814-1
"E6,F12",4065,4299,2889,1410,2511,0,1377,1383,974,409,2.381418093,736,205,158,49,0,49,0,13,0,0,empty,mBC-0814-1
"E6,G1",6724,7015,4993,2022,4177,0,2239,2242,1598,644,2.48136646,1123,3573,2504,707,0,707,0,173,0,0,empty,mBC-0814-1
"E6,G2",5072,5483,3694,1789,3185,0,1702,1702,1197,505,2.37029703,907,437,283,73,0,73,0,22,0,0,empty,mBC-0814-1
"E6,G3",5742,6138,3986,2152,3597,0,2006,2008,1418,590,2.403389831,1075,3497,2487,780,0,780,0,138,0,0,empty,mBC-0814-1
"E6,G4",4640,5044,3356,1688,2917,2,1513,1519,1084,435,2.491954023,804,19,12,0,0,0,0,0,0,0,empty,mBC-0814-1
"E6,G5",3972,4241,2788,1453,2445,0,1357,1357,933,424,2.200471698,729,1342,836,252,0,252,0,57,0,0,empty,mBC-0814-1
"E6,G6",421113,476788,291637,185151,279610,0,167157,167366,124022,43344,2.861341824,96998,4998,3192,943,0,943,0,130,0,0,empty,mBC-0814-1
"E6,G7",4748,5222,3384,1838,2977,0,1610,1613,1134,479,2.36743215,883,1859,1380,377,0,377,0,89,0,0,empty,mBC-0814-1
"E6,G8",6067,6747,4380,2367,3897,0,2152,2155,1511,644,2.346273292,1151,2667,1806,530,0,530,0,137,0,0.001886792,empty,mBC-0814-1
"E6,G9",4998,5508,3450,2058,3232,0,1842,1846,1323,523,2.529636711,1036,31551,10749,3325,4,3321,3,326,0,0.165311653,empty,mBC-0814-1
"E6,G10",15568,16110,11448,4662,9283,0,4772,4777,3543,1234,2.871150729,2376,4154,3039,946,0,946,0,195,0,0.002114165,empty,mBC-0814-1
"E6,G11",8018,8659,5773,2886,4885,0,2507,2512,1778,734,2.422343324,1328,1976,1065,311,0,311,0,70,0,0,empty,mBC-0814-1
"E6,G12",3997,4387,2846,1541,2492,0,1355,1355,951,404,2.353960396,705,1670,1139,359,0,359,0,93,0,0.005571031,empty,mBC-0814-1
"E6,H1",414887,488539,274250,214289,286630,0,183611,183793,131992,51801,2.548058918,111563,95364,68676,18934,13,18921,2,1484,0,0,mm10,mBC-0814-1
"E6,H2",517621,621545,342072,279473,362591,0,234185,234485,172467,62018,2.780918443,145814,215798,158962,44462,16,44446,2,2527,0,0.000404986,mm10,mBC-0814-1
"E6,H3",4433,4803,3200,1603,2792,1,1500,1501,1134,367,3.089918256,767,1817,1224,339,0,339,0,76,0,0,empty,mBC-0814-1
"E6,H4",4544,5063,3179,1884,2979,0,1688,1693,1200,493,2.434077079,940,73,46,19,0,19,0,11,0,0,empty,mBC-0814-1
"E6,H5",5972,6776,4235,2541,3738,0,2070,2070,1493,577,2.587521664,1188,1738,1188,329,0,329,0,70,0,0,empty,mBC-0814-1
"E6,H6",520839,610472,332630,277842,355289,1,236889,237138,161293,75845,2.126613488,145313,147733,102021,28695,15,28680,2,1876,0,0.002719665,mm10,mBC-0814-1
"E6,H7",4593,4974,3347,1627,2866,0,1521,1521,1072,449,2.38752784,787,1713,1165,338,0,338,0,75,0,0.059171598,empty,mBC-0814-1
"E6,H8",3532,3822,2454,1368,2180,0,1160,1161,834,327,2.550458716,649,1864,1317,398,0,398,0,96,0,0,empty,mBC-0814-1
"E6,H9",4719,5077,3399,1678,2870,0,1536,1542,1131,411,2.751824818,803,13713,4373,1426,3,1423,2,166,0,0.083626142,empty,mBC-0814-1
"E6,H10",2919,3037,2051,986,1823,0,979,980,713,267,2.670411985,530,762,517,185,0,185,0,48,0,0,empty,mBC-0814-1
"E6,H11",3390,3617,2433,1184,2124,0,1169,1172,852,320,2.6625,633,108,79,23,0,23,0,8,0,0,empty,mBC-0814-1
"E6,H12",2231,2440,1574,866,1429,0,797,797,557,240,2.320833333,435,1697,1103,278,0,278,0,69,0,0,empty,mBC-0814-1
"E7,A1",592240,680870,398040,282830,403263,0,247549,247824,209926,37898,5.539236899,146014,202708,144174,41194,22,41172,3,2422,0,0.000121442,mm10,mBC-0814-1
"E7,A2",4585,4945,3237,1708,2900,0,1552,1555,1169,386,3.028497409,851,1489,1079,352,0,352,0,99,0,0,empty,mBC-0814-1
"E7,A3",4303,4674,3028,1646,2739,0,1522,1525,1122,403,2.784119107,848,1812,1138,315,0,315,0,64,0,0,empty,mBC-0814-1
"E7,A4",5103,5465,3712,1753,3172,0,1644,1646,1181,465,2.539784946,848,535,283,82,0,82,0,22,0,0,empty,mBC-0814-1
"E7,A5",417234,487619,277978,209641,292130,0,182455,182624,148992,33632,4.430066603,109837,244271,169795,46775,28,46747,5,2647,0,0.002010824,mm10,mBC-0814-1
"E7,A6",3534,3592,2453,1139,2175,0,1178,1183,830,353,2.351274788,621,2104,1406,433,2,431,1,85,0,0,empty,mBC-0814-1
"E7,A7",5075,5510,3649,1861,3322,0,1841,1843,1343,500,2.686,1008,1441,938,303,0,303,0,79,0,0.02310231,empty,mBC-0814-1
"E7,A8",2118,2285,1462,823,1359,0,775,777,563,214,2.630841121,451,1543,1032,284,0,284,0,69,0,0.003521127,empty,mBC-0814-1
"E7,A9",6182,6677,4460,2217,3969,0,2182,2185,1551,634,2.44637224,1170,1296,908,296,0,296,0,64,0,0,empty,mBC-0814-1
"E7,A10",3097,3220,2243,977,1930,0,1007,1007,733,274,2.675182482,511,281,185,71,0,71,0,18,0,0,empty,mBC-0814-1
"E7,A11",4112,4331,2955,1376,2620,0,1402,1402,953,449,2.122494432,736,2267,1610,426,2,424,1,104,0,0,empty,mBC-0814-1
"E7,A12",514528,582094,341367,240727,344259,0,210032,210244,173471,36773,4.717346967,123744,1193289,875334,240567,132,240435,10,6064,0,0.000162206,mm10,mBC-0814-1
"E7,B1",4318,4623,3127,1496,2756,0,1489,1489,1049,440,2.384090909,799,2298,1660,415,0,415,0,96,0,0,empty,mBC-0814-1
"E7,B2",4291,4470,3064,1406,2616,0,1350,1353,965,388,2.487113402,700,764,498,182,0,182,0,40,0,0,empty,mBC-0814-1
"E7,B3",3607,3885,2533,1352,2319,6,1298,1306,953,353,2.699716714,697,1175,786,224,0,224,0,65,0,0.053571429,empty,mBC-0814-1
"E7,B4",3905,4212,2759,1453,2532,0,1439,1441,1024,417,2.455635492,777,1445,1052,305,0,305,0,71,0,0.009836066,empty,mBC-0814-1
"E7,B5",3377,2169,1413,756,1558,0,848,854,587,267,2.198501873,492,834,573,192,0,192,0,66,0,0,empty,mBC-0814-1
"E7,B6",3853,4120,2683,1437,2403,0,1338,1339,965,374,2.580213904,712,1548,1085,339,1,338,1,73,0,0,empty,mBC-0814-1
"E7,B7",5044,5414,3749,1665,3142,0,1639,1640,1169,471,2.481953291,824,1406,988,306,0,306,0,71,0,0.117647059,empty,mBC-0814-1
"E7,B8",34798,39556,25140,14416,23249,0,13338,13362,10077,3285,3.067579909,7388,3322,2243,658,1,657,1,138,0,0,empty,mBC-0814-1
"E7,B9",309129,360078,203227,156851,215310,0,135049,135187,110448,24739,4.46452969,82103,81495,57854,16106,17,16089,2,1286,0,0.001678165,mm10,mBC-0814-1
"E7,B10",3833,4173,2704,1469,2564,0,1383,1390,984,406,2.42364532,772,582,429,149,0,149,0,32,0,0,empty,mBC-0814-1
"E7,B11",5780,6019,4125,1894,3528,1,1819,1822,1292,530,2.437735849,982,120,86,38,0,38,0,14,0,0.342105263,empty,mBC-0814-1
"E7,B12",4811,5425,3386,2039,3192,0,1800,1804,1335,469,2.846481876,992,1238,883,253,0,253,0,61,0,0,empty,mBC-0814-1
"E7,C1",5170,5442,3705,1737,3171,0,1694,1698,1220,478,2.552301255,885,995,724,201,0,201,0,46,0,0.039800995,empty,mBC-0814-1
"E7,C2",1015599,1150180,686556,463624,671847,1,411116,411570,333368,78202,4.262908877,241209,337228,240194,67651,54,67597,9,3372,0,0.001346214,mm10,mBC-0814-1
"E7,C3",5641,6204,4014,2190,3606,4,1994,1998,1454,544,2.672794118,1080,28751,8272,2542,6,2536,3,262,0,0.058753943,empty,mBC-0814-1
"E7,C4",4669,4952,3378,1574,2953,2,1614,1620,1199,421,2.847980998,816,1594,1100,318,0,318,0,82,0,0,empty,mBC-0814-1
"E7,C5",6566,6868,4741,2127,4027,0,2098,2098,1528,570,2.680701754,1088,1317,924,294,0,294,0,71,0,0.003401361,empty,mBC-0814-1
"E7,C6",505615,596049,331458,264591,361465,1,232276,232512,194484,38028,5.114231619,141197,166913,117068,32951,17,32934,3,2104,0,9.10913E-05,mm10,mBC-0814-1
"E7,C7",6667,6996,4623,2373,4066,0,2223,2225,1656,569,2.910369069,1162,7343,1953,635,0,635,0,95,0,0.02992126,empty,mBC-0814-1
"E7,C8",5030,5298,3670,1628,3121,0,1637,1643,1176,467,2.518201285,841,2079,1398,424,0,424,0,94,0,0,empty,mBC-0814-1
"E7,C9",4434,4836,3159,1677,2804,0,1511,1511,1090,421,2.589073634,825,1342,865,314,0,314,0,63,0,0,empty,mBC-0814-1
"E7,C10",5278,5607,3754,1853,3243,0,1755,1755,1226,529,2.31758034,933,19415,5771,1736,4,1732,2,193,0,0.008660508,empty,mBC-0814-1
"E7,C11",4283,4788,3057,1731,2810,0,1537,1540,1069,471,2.269639066,880,1125,771,256,0,256,0,73,0,0.01953125,empty,mBC-0814-1
"E7,C12",7582,8191,5431,2760,4725,0,2586,2589,1885,704,2.677556818,1333,2087,1594,491,0,491,0,88,0,0,empty,mBC-0814-1
"E7,D1",470234,542341,312462,229879,324616,1,208048,208290,158036,50254,3.144744697,125125,11195,6972,2064,1,2063,1,273,0,0.000484731,mm10,mBC-0814-1
"E7,D2",4876,5144,3597,1547,3065,0,1589,1592,1143,449,2.545657016,821,1856,1416,394,1,393,1,83,0,0,empty,mBC-0814-1
"E7,D3",10040,10758,7150,3608,6346,0,3457,3459,2463,996,2.472891566,1822,3781,2624,673,1,672,1,121,0,0,empty,mBC-0814-1
"E7,D4",222167,258200,142018,116182,154754,0,99875,99986,73934,26052,2.837939506,61307,71357,51773,14407,7,14400,1,1198,0,0.001666667,mm10,mBC-0814-1
"E7,D5",4109,4676,2865,1811,2768,0,1569,1573,1175,398,2.952261307,914,2501,1678,533,0,533,0,124,0,0,empty,mBC-0814-1
"E7,D6",6584,6201,4134,2067,3578,0,1925,1927,1390,537,2.588454376,1038,2804,2043,610,0,610,0,97,0,0,empty,mBC-0814-1
"E7,D7",5335,5641,3823,1818,3344,0,1754,1757,1284,473,2.714587738,918,2646,1797,525,1,524,1,105,0,0.072519084,empty,mBC-0814-1
"E7,D8",4373,4861,3041,1820,2784,0,1557,1559,1105,454,2.433920705,889,1063,658,184,0,184,0,50,0,0,empty,mBC-0814-1
"E7,D9",2896,3143,2047,1096,1899,0,1051,1051,741,310,2.390322581,583,1957,1345,355,0,355,0,79,0,0,empty,mBC-0814-1
"E7,D10",4175,4613,2979,1634,2730,0,1531,1532,1084,448,2.419642857,827,874,655,230,0,230,0,56,0,0,empty,mBC-0814-1
"E7,D11",3965,4282,2765,1517,2572,0,1454,1454,1020,434,2.350230415,813,57436,15957,5075,11,5064,3,428,0,0.100118483,empty,mBC-0814-1
"E7,D12",5740,6108,4068,2040,3577,0,1935,1935,1376,559,2.461538462,1007,5478,2557,688,0,688,0,129,0,0.026162791,empty,mBC-0814-1
"E7,E1",4777,5252,3378,1874,3006,0,1612,1613,1156,457,2.529540481,884,2303,1560,505,0,505,0,94,0,0.001980198,empty,mBC-0814-1
"E7,E2",398609,467275,267556,199719,277882,0,174041,174235,143291,30944,4.630655377,104447,237689,174208,49546,30,49516,2,2601,0,0.000767429,mm10,mBC-0814-1
"E7,E3",3237,3433,2367,1066,2050,0,1067,1070,740,330,2.242424242,549,2273,1704,511,0,511,0,84,0,0.048923679,empty,mBC-0814-1
"E7,E4",3029,3344,2172,1172,1923,0,1029,1030,719,311,2.311897106,575,1025,741,261,0,261,0,67,0,0.0651341,empty,mBC-0814-1
"E7,E5",3455,3577,2498,1079,2185,0,1141,1142,799,343,2.329446064,602,1363,939,277,0,277,0,59,0,0.010830325,empty,mBC-0814-1
"E7,E6",673134,768401,455862,312539,443016,1,268894,269237,234972,34265,6.857493069,157515,386006,274859,76599,41,76558,5,3359,0,0.000822906,mm10,mBC-0814-1
"E7,E7",4110,4251,3046,1205,2491,0,1276,1276,929,347,2.677233429,606,1352,872,248,0,248,0,56,0,0,empty,mBC-0814-1
"E7,E8",4388,4674,3237,1437,2641,0,1334,1337,967,370,2.613513514,681,2088,1479,477,0,477,0,109,0,0.002096436,empty,mBC-0814-1
"E7,E9",3037,3312,2083,1229,1955,0,1111,1111,781,330,2.366666667,615,7137,2335,775,5,770,1,126,0,0.009090909,empty,mBC-0814-1
"E7,E10",483993,551730,327966,223764,330266,9,205764,205989,153062,52927,2.89194551,120991,46102,30812,8808,6,8802,2,887,0,0.00408998,mm10,mBC-0814-1
"E7,E11",3772,4056,2741,1315,2422,1,1322,1323,942,381,2.472440945,684,1366,843,303,0,303,0,75,0,0,empty,mBC-0814-1
"E7,E12",3531,3835,2502,1333,2326,0,1268,1268,907,361,2.512465374,710,788,383,144,0,144,0,43,0,0,empty,mBC-0814-1
"E7,F1",4379,4676,3089,1587,2772,0,1532,1537,1094,443,2.469525959,811,1857,1416,353,0,353,0,69,0,0,empty,mBC-0814-1
"E7,F2",6023,6323,4421,1902,3670,0,1900,1902,1385,517,2.678916828,930,2734,1971,611,1,610,1,128,0,0.004918033,empty,mBC-0814-1
"E7,F3",4533,4989,3301,1688,2950,0,1607,1611,1140,471,2.420382166,847,1483,925,272,0,272,0,78,0,0,empty,mBC-0814-1
"E7,F4",4891,5090,3529,1561,3075,0,1666,1669,1220,449,2.71714922,833,681,354,132,0,132,0,39,0,0,empty,mBC-0814-1
"E7,F5",4846,5046,3548,1498,2974,5,1558,1563,1161,402,2.888059701,775,1530,1091,306,0,306,0,71,0,0,empty,mBC-0814-1
"E7,F6",4643,5014,3309,1705,2918,0,1632,1632,1179,453,2.602649007,840,1946,1395,439,0,439,0,112,0,0.018223235,empty,mBC-0814-1
"E7,F7",4778,5181,3496,1685,3014,0,1600,1609,1122,487,2.303901437,861,891,622,169,0,169,0,46,0,0.00591716,empty,mBC-0814-1
"E7,F8",5708,5948,3987,1961,3514,0,1887,1887,1377,510,2.7,974,2656,1006,320,0,320,0,49,0,0.134375,empty,mBC-0814-1
"E7,F9",5144,5397,3752,1645,3200,0,1618,1619,1194,425,2.809411765,839,2522,1602,501,1,500,1,108,0,0,empty,mBC-0814-1
"E7,F10",5915,6246,4367,1879,3653,0,1859,1862,1335,527,2.533206831,953,1849,1328,390,0,390,0,70,0,0,empty,mBC-0814-1
"E7,F11",3925,4422,2691,1731,2526,0,1370,1370,973,397,2.450881612,775,1537,1160,321,0,321,0,72,0,0,empty,mBC-0814-1
"E7,F12",4584,5016,3196,1820,2890,0,1569,1569,1132,437,2.590389016,869,115,80,38,0,38,0,11,0,0,empty,mBC-0814-1
"E7,G1",6896,7501,4905,2596,4383,0,2394,2396,1730,666,2.597597598,1288,3829,2802,888,0,888,0,166,0,0,empty,mBC-0814-1
"E7,G2",5248,5554,3723,1831,3305,0,1797,1799,1289,510,2.52745098,969,587,350,127,0,127,0,34,0,0.007874016,empty,mBC-0814-1
"E7,G3",4593,4878,3285,1593,2898,0,1606,1607,1152,455,2.531868132,847,2542,1858,553,0,553,0,114,0,0,empty,mBC-0814-1
"E7,G4",4651,4910,3353,1557,2907,0,1532,1535,1095,440,2.488636364,836,9,7,5,0,5,0,4,0,0,empty,mBC-0814-1
"E7,G5",4214,4618,2966,1652,2678,1,1446,1452,1033,419,2.465393795,780,1486,1003,287,0,287,0,69,0,0,empty,mBC-0814-1
"E7,G6",8125,8743,5933,2810,5083,0,2614,2619,1874,745,2.515436242,1370,264,122,47,0,47,0,12,0,0,empty,mBC-0814-1
"E7,G7",360756,408618,242302,166316,247567,8,153880,154063,118347,35716,3.313556949,90738,29685,20626,5433,0,5433,0,655,0,0,mm10,mBC-0814-1
"E7,G8",414389,477442,275296,202146,285392,0,179719,179919,151257,28662,5.277266067,107812,96645,69552,19744,17,19727,1,1540,0,0.000861763,mm10,mBC-0814-1
"E7,G9",4782,5310,3393,1917,3160,0,1710,1710,1243,467,2.661670236,931,3148,2313,635,1,634,1,147,0,0,empty,mBC-0814-1
"E7,G10",8596,9387,6211,3176,5441,0,2952,2959,2078,881,2.358683314,1585,4865,3456,1043,1,1042,1,181,0,0.018234165,empty,mBC-0814-1
"E7,G11",485501,547715,326708,221007,327110,6,204438,204676,150943,53733,2.80913033,120420,13771,9479,2524,3,2521,2,356,0,0,mm10,mBC-0814-1
"E7,G12",4267,4822,3014,1808,2859,0,1579,1579,1149,430,2.672093023,885,2309,1785,473,0,473,0,106,0,0.014799154,empty,mBC-0814-1
"E7,H1",502646,581782,332010,249772,345965,0,220818,221050,169981,51069,3.328457577,133389,24477,17090,4829,6,4823,2,580,0,0.004561476,mm10,mBC-0814-1
"E7,H2",7993,8718,5618,3100,5078,0,2838,2841,1927,914,2.108315098,1519,6308,3339,957,1,956,1,201,0,0.018828452,empty,mBC-0814-1
"E7,H3",14002,16880,8721,8159,9684,0,6368,6376,2670,3706,0.720453319,4097,14534,5291,1373,2,1371,1,205,0,0.043034282,empty,mBC-0814-1
"E7,H4",5011,5539,3579,1960,3191,0,1749,1749,1270,479,2.651356994,915,124,49,24,0,24,0,10,0,0,empty,mBC-0814-1
"E7,H5",6200,6740,4375,2365,3892,0,2138,2142,1488,654,2.275229358,1128,2071,1420,447,2,445,1,79,0,0,empty,mBC-0814-1
"E7,H6",5611,5771,4001,1770,3396,0,1764,1768,1252,516,2.426356589,893,3050,2091,614,1,613,1,114,0,0.044045677,empty,mBC-0814-1
"E7,H7",4575,4907,3213,1694,2989,0,1638,1641,1176,465,2.529032258,906,2356,1764,443,1,442,1,76,0,0.038461538,empty,mBC-0814-1
"E7,H8",4058,4265,2885,1380,2542,0,1393,1393,1048,345,3.037681159,731,2820,1865,572,1,571,1,110,0,0.036777583,empty,mBC-0814-1
"E7,H9",4356,4517,3144,1373,2728,1,1412,1417,1039,378,2.748677249,716,1270,814,219,0,219,0,57,0,0.00913242,empty,mBC-0814-1
"E7,H10",35794,44062,21422,22640,26303,9,18849,18874,12860,6014,2.138343864,12298,16584,4794,1549,4,1545,2,192,0,0.078964401,empty,mBC-0814-1
"E7,H11",765459,874696,514818,359878,520603,0,325572,325903,259747,66156,3.926280307,192228,4687,3082,870,0,870,0,151,0,0,empty,mBC-0814-1
"E7,H12",313178,358728,207000,151728,216526,0,137374,137527,102000,35527,2.871055817,82075,53534,37414,10763,7,10756,1,995,0,0.001208628,mm10,mBC-0814-1
"E8,A1",5538,5925,3965,1960,3442,0,1837,1844,1289,555,2.322522523,972,1915,1372,387,0,387,0,64,0,0.041343669,empty,mBC-0814-1
"E8,A2",5585,5920,3928,1992,3556,0,1937,1939,1444,495,2.917171717,1019,2181,1585,449,0,449,0,95,0,0,empty,mBC-0814-1
"E8,A3",4714,5231,3411,1820,2995,2,1615,1617,1100,517,2.127659574,882,1109,810,267,0,267,0,55,0,0,empty,mBC-0814-1
"E8,A4",5381,5813,3877,1936,3337,0,1793,1794,1245,549,2.267759563,944,553,363,104,0,104,0,25,0,0,empty,mBC-0814-1
"E8,A5",4665,5024,3349,1675,2900,0,1557,1559,1129,430,2.625581395,807,1575,1088,347,0,347,0,58,0,0,empty,mBC-0814-1
"E8,A6",3564,3899,2507,1392,2317,0,1301,1301,929,372,2.497311828,703,1721,1214,326,0,326,0,69,0,0.027607362,empty,mBC-0814-1
"E8,A7",5350,5716,3813,1903,3413,0,1868,1870,1359,511,2.659491194,981,1975,1180,382,0,382,0,80,0,0.002617801,empty,mBC-0814-1
"E8,A8",2057,2230,1436,794,1356,0,750,752,512,240,2.133333333,431,2071,1311,384,0,384,0,71,0,0.0390625,empty,mBC-0814-1
"E8,A9",6393,6795,4526,2269,3905,0,2102,2103,1489,614,2.425081433,1130,2601,1293,358,0,358,0,71,0,0,empty,mBC-0814-1
"E8,A10",3496,3913,2435,1478,2311,0,1283,1283,907,376,2.412234043,739,329,245,81,0,81,0,21,0,0,empty,mBC-0814-1
"E8,A11",4437,4849,3192,1657,2852,0,1563,1563,1117,446,2.504484305,859,2415,1687,456,1,455,1,88,0,0,empty,mBC-0814-1
"E8,A12",4490,4819,3207,1612,2908,0,1591,1594,1159,435,2.664367816,881,2631,1815,624,0,624,0,167,0,0.024038462,empty,mBC-0814-1
"E8,B1",4715,5210,3373,1837,2974,0,1636,1637,1202,435,2.763218391,877,1725,1252,396,1,395,1,79,0,0,empty,mBC-0814-1
"E8,B2",4809,5271,3382,1889,3068,0,1616,1616,1134,482,2.352697095,900,355,230,88,1,87,1,24,0,0,empty,mBC-0814-1
"E8,B3",3814,4126,2727,1399,2449,0,1382,1386,1007,379,2.656992084,732,1330,949,259,0,259,0,54,0,0,empty,mBC-0814-1
"E8,B4",4158,4497,2958,1539,2714,0,1513,1519,1103,416,2.651442308,832,1078,675,194,0,194,0,57,0,0.005154639,empty,mBC-0814-1
"E8,B5",17703,11363,7110,4253,7996,0,4522,4542,3539,1003,3.528414756,2606,27053,9526,2736,7,2729,4,305,0,0.014657384,empty,mBC-0814-1
"E8,B6",4192,4585,2977,1608,2698,0,1485,1487,1079,408,2.644607843,774,1676,1076,319,1,318,1,63,0,0.006289308,empty,mBC-0814-1
"E8,B7",5313,5770,3807,1963,3359,0,1797,1801,1285,516,2.490310078,945,1530,1094,330,0,330,0,58,0,0,empty,mBC-0814-1
"E8,B8",3573,3820,2647,1173,2221,1,1188,1191,833,358,2.326815642,581,1197,917,292,0,292,0,57,0,0.071917808,empty,mBC-0814-1
"E8,B9",4702,5180,3271,1909,3061,0,1734,1735,1269,466,2.723175966,970,644,442,136,0,136,0,47,0,0.058823529,empty,mBC-0814-1
"E8,B10",4137,4338,2885,1453,2648,0,1414,1420,1037,383,2.707571802,772,326,250,67,0,67,0,21,0,0,empty,mBC-0814-1
"E8,B11",10430,11771,7353,4418,6857,0,4041,4048,2654,1394,1.903873745,2242,91,39,11,0,11,0,6,0,0,empty,mBC-0814-1
"E8,B12",5052,5362,3599,1763,3221,0,1765,1769,1248,521,2.395393474,918,1363,944,244,0,244,0,58,0,0.069672131,empty,mBC-0814-1
"E8,C1",5323,5712,3875,1837,3399,0,1754,1755,1258,497,2.531187123,979,751,498,157,0,157,0,40,0,0.025477707,empty,mBC-0814-1
"E8,C2",5221,5688,3816,1872,3312,0,1807,1808,1311,497,2.637826962,929,1933,1381,380,0,380,0,81,0,0,empty,mBC-0814-1
"E8,C3",5622,6123,4036,2087,3517,0,1901,1904,1392,512,2.71875,1029,899,658,183,0,183,0,36,0,0.010928962,empty,mBC-0814-1
"E8,C4",7931,8374,5685,2689,4887,0,2578,2583,1915,668,2.866766467,1330,2243,1208,360,0,360,0,79,0,0,empty,mBC-0814-1
"E8,C5",9727,10577,6915,3662,6292,0,3501,3506,2656,850,3.124705882,1883,1573,1012,327,0,327,0,79,0,0,empty,mBC-0814-1
"E8,C6",5612,6159,3939,2220,3658,0,2071,2078,1524,554,2.750902527,1150,1392,1013,337,0,337,0,67,0,0,empty,mBC-0814-1
"E8,C7",6801,7400,4913,2487,4271,0,2279,2281,1652,629,2.626391097,1244,470,326,88,0,88,0,20,0,0,empty,mBC-0814-1
"E8,C8",5513,5899,3990,1909,3382,0,1864,1865,1266,599,2.113522538,936,3917,2051,656,0,656,0,108,0,0.153963415,empty,mBC-0814-1
"E8,C9",4521,4897,3201,1696,2850,0,1511,1511,1087,424,2.563679245,830,5072,1544,482,2,480,1,70,0,0.072916667,empty,mBC-0814-1
"E8,C10",5385,5811,3907,1904,3366,1,1806,1816,1303,513,2.539961014,938,1417,1031,288,0,288,0,57,0,0,empty,mBC-0814-1
"E8,C11",4340,4630,3137,1493,2770,0,1521,1523,1088,435,2.501149425,800,1431,1050,318,0,318,0,69,0,0.006289308,empty,mBC-0814-1
"E8,C12",8007,8455,5664,2791,4980,0,2705,2717,1925,792,2.430555556,1422,13328,4881,1468,3,1465,3,154,0,0.090784983,empty,mBC-0814-1
"E8,D1",4496,4733,3204,1529,2824,0,1506,1508,1081,427,2.531615925,771,657,425,137,0,137,0,25,0,0,empty,mBC-0814-1
"E8,D2",5347,5379,3729,1650,3078,0,1653,1655,1213,442,2.744343891,851,14512,5797,1964,0,1964,0,185,0,0.297861507,empty,mBC-0814-1
"E8,D3",427936,492451,289437,203014,295219,3,184261,184475,140543,43932,3.199103159,110034,13591,9098,2459,1,2458,1,340,0,0.002034174,mm10,mBC-0814-1
"E8,D4",4516,4948,3205,1743,3010,0,1670,1676,1168,508,2.299212598,894,10612,3216,917,3,914,2,113,0,0.065645514,empty,mBC-0814-1
"E8,D5",336234,397611,215858,181753,238188,1,156616,156766,119077,37689,3.159462973,96837,111846,79281,22062,15,22047,3,1649,0,0.00154216,mm10,mBC-0814-1
"E8,D6",1012582,1165684,686099,479585,677549,2,420914,421388,339369,82019,4.137687609,249578,257568,182937,50754,34,50720,3,2894,0,0.000295741,mm10,mBC-0814-1
"E8,D7",8519,9201,6163,3038,5260,0,2847,2847,2009,838,2.397374702,1477,2708,1895,576,0,576,0,103,0,0.013888889,empty,mBC-0814-1
"E8,D8",4700,5130,3385,1745,2947,0,1607,1609,1189,420,2.830952381,869,1007,716,233,0,233,0,53,0,0.008583691,empty,mBC-0814-1
"E8,D9",3148,3392,2220,1172,1965,0,1106,1108,770,338,2.278106509,617,1499,1096,306,0,306,0,55,0,0,empty,mBC-0814-1
"E8,D10",5440,6075,3713,2362,3610,0,2119,2120,1580,540,2.925925926,1204,988,699,185,0,185,0,32,0,0,empty,mBC-0814-1
"E8,D11",4072,4442,2851,1591,2671,0,1481,1481,1063,418,2.543062201,827,2039,1453,454,0,454,0,83,0,0,empty,mBC-0814-1
"E8,D12",6019,6770,4313,2457,3899,0,2151,2157,1542,615,2.507317073,1188,4852,3599,966,0,966,0,151,0,0.001035197,empty,mBC-0814-1
"E8,E1",4902,5217,3495,1722,3054,0,1653,1653,1168,485,2.408247423,896,2113,1447,398,2,396,1,72,0,0.002525253,empty,mBC-0814-1
"E8,E2",3671,4068,2649,1419,2394,0,1257,1264,872,392,2.224489796,676,1597,1118,351,0,351,0,70,0,0.008547009,empty,mBC-0814-1
"E8,E3",3343,3655,2500,1155,2120,0,1108,1108,819,289,2.833910035,585,1292,933,339,0,339,0,58,0,0.026548673,empty,mBC-0814-1
"E8,E4",2942,3340,2118,1222,1963,0,1104,1104,773,331,2.335347432,622,1183,869,222,0,222,0,56,0,0,empty,mBC-0814-1
"E8,E5",3679,3965,2638,1327,2318,0,1232,1237,882,355,2.484507042,681,821,644,198,0,198,0,41,0,0,empty,mBC-0814-1
"E8,E6",4092,4340,2995,1345,2565,0,1375,1377,957,420,2.278571429,713,1373,1020,262,0,262,0,61,0,0,empty,mBC-0814-1
"E8,E7",4280,4514,3081,1433,2703,0,1425,1427,1036,391,2.649616368,752,1620,1106,324,0,324,0,71,0,0.030864198,empty,mBC-0814-1
"E8,E8",493360,555060,338489,216571,326135,2,194513,194752,163543,31209,5.24025121,112037,236105,170555,47173,34,47139,4,2576,0,0,mm10,mBC-0814-1
"E8,E9",3367,3708,2362,1346,2129,1,1196,1197,870,327,2.660550459,634,1888,1357,380,1,379,1,72,0,0,empty,mBC-0814-1
"E8,E10",3936,4332,2828,1504,2477,0,1352,1359,966,393,2.458015267,705,1957,1154,316,1,315,1,72,0,0,empty,mBC-0814-1
"E8,E11",394689,457418,263023,194395,274138,1,174320,174496,133960,40536,3.304716795,104662,56223,39239,10910,10,10900,1,998,0,9.17431E-05,mm10,mBC-0814-1
"E8,E12",3961,4157,2800,1357,2388,0,1274,1278,923,355,2.6,671,1544,1057,286,1,285,1,49,0,0,empty,mBC-0814-1
"E8,F1",4353,4434,3138,1296,2622,4,1334,1341,958,383,2.501305483,668,1892,1280,354,0,354,0,70,0,0.048022599,empty,mBC-0814-1
"E8,F2",6265,6644,4493,2151,3878,0,2103,2107,1540,567,2.716049383,1074,2306,1516,435,0,435,0,113,0,0.04137931,empty,mBC-0814-1
"E8,F3",4900,5407,3532,1875,3086,0,1703,1708,1226,482,2.543568465,911,1876,1268,410,2,408,1,80,0,0.007352941,empty,mBC-0814-1
"E8,F4",512169,589866,345040,244826,351237,1,217353,217595,177219,40376,4.389216366,128825,127372,67669,19671,13,19658,2,1511,0,0.008342659,mm10,mBC-0814-1
"E8,F5",4941,5318,3542,1776,3145,0,1732,1732,1245,487,2.556468172,954,2015,1264,428,0,428,0,74,0,0,empty,mBC-0814-1
"E8,F6",4808,5335,3470,1865,3105,0,1682,1684,1234,450,2.742222222,901,13986,4845,1531,5,1526,3,183,0,0.019003932,empty,mBC-0814-1
"E8,F7",4360,4779,3144,1635,2762,0,1483,1487,1068,419,2.548926014,804,946,607,201,0,201,0,41,0,0,empty,mBC-0814-1
"E8,F8",6012,6568,4365,2203,3698,0,1983,1983,1439,544,2.645220588,1006,210,148,49,0,49,0,14,0,0,empty,mBC-0814-1
"E8,F9",5758,6449,4054,2395,3722,0,2058,2065,1443,622,2.319935691,1173,3767,2662,687,0,687,0,102,0,0.017467249,empty,mBC-0814-1
"E8,F10",6187,6823,4570,2253,3971,0,2127,2129,1546,583,2.651801029,1154,2280,1416,429,2,427,1,66,0,0.014051522,empty,mBC-0814-1
"E8,F11",4200,4517,3064,1453,2649,0,1395,1395,957,438,2.184931507,743,1440,945,263,0,263,0,60,0,0,empty,mBC-0814-1
"E8,F12",4700,5175,3386,1789,2928,0,1637,1637,1163,474,2.453586498,843,104,42,24,0,24,0,9,0,0,empty,mBC-0814-1
"E8,G1",408811,458575,282298,176277,272440,1,162650,162853,124000,38853,3.191516743,93651,61044,42446,12027,7,12020,2,1148,0,0.001580699,mm10,mBC-0814-1
"E8,G2",5532,5939,3951,1988,3362,0,1798,1802,1336,466,2.86695279,943,515,347,78,0,78,0,24,0,0,empty,mBC-0814-1
"E8,G3",5070,5619,3552,2067,3250,2,1807,1809,1315,494,2.66194332,1017,2094,1347,432,0,432,0,83,0,0.039351852,empty,mBC-0814-1
"E8,G4",4970,5285,3567,1718,3093,2,1593,1595,1159,436,2.658256881,856,11,2,1,0,1,0,1,0,0,empty,mBC-0814-1
"E8,G5",4732,5149,3309,1840,3069,1,1705,1709,1194,515,2.318446602,972,1768,1233,354,0,354,0,69,0,0,empty,mBC-0814-1
"E8,G6",8384,9146,6058,3088,5356,0,2786,2791,1946,845,2.30295858,1527,31,22,10,0,10,0,8,0,0,empty,mBC-0814-1
"E8,G7",5336,5729,3856,1873,3418,1,1807,1812,1308,504,2.595238095,959,2428,1789,484,1,483,1,94,0,0,empty,mBC-0814-1
"E8,G8",7098,7711,5013,2698,4638,0,2565,2574,1863,711,2.620253165,1405,3609,2622,757,3,754,1,129,0,0.021220159,empty,mBC-0814-1
"E8,G9",5437,6003,3904,2099,3454,0,1926,1932,1389,543,2.55801105,1029,3123,2029,615,0,615,0,121,0,0.004878049,empty,mBC-0814-1
"E8,G10",592389,677885,395949,281936,398202,1,247542,247842,208431,39411,5.288650377,146628,198730,139579,39322,28,39294,5,2432,0,0.002824859,mm10,mBC-0814-1
"E8,G11",488925,574992,324623,250369,339412,0,214952,215201,170848,44353,3.852005501,130182,121716,80536,22191,10,22181,3,1542,0,0.005139534,mm10,mBC-0814-1
"E8,G12",4540,4974,3170,1804,2937,0,1662,1665,1205,460,2.619565217,916,2495,1795,567,0,567,0,80,0,0.008818342,empty,mBC-0814-1
"E8,H1",539405,638299,356927,281372,374669,0,237964,238277,191605,46672,4.105352245,144527,149886,109189,30037,20,30017,3,1944,0,0.001132691,mm10,mBC-0814-1
"E8,H2",9121,9729,6463,3266,5853,0,3190,3193,2369,824,2.875,1675,90355,27510,8470,22,8448,5,653,0,0.037050189,empty,mBC-0814-1
"E8,H3",5535,6060,3894,2166,3480,3,1903,1910,1392,518,2.687258687,1035,2412,1482,455,1,454,1,84,0,0.039647577,empty,mBC-0814-1
"E8,H4",1094864,1288143,730375,557768,747789,15,495781,496328,305647,190681,1.602923207,298980,5794,3061,864,2,862,1,128,0,0.042923434,empty,mBC-0814-1
"E8,H5",6373,6869,4582,2287,3962,0,2132,2137,1527,610,2.503278689,1166,4433,2696,736,1,735,1,95,0,0.002721088,empty,mBC-0814-1
"E8,H6",6060,6425,4345,2080,3875,0,2116,2117,1544,573,2.694589878,1136,1834,1180,386,0,386,0,82,0,0.044041451,empty,mBC-0814-1
"E8,H7",5160,5581,3686,1895,3327,0,1808,1817,1279,538,2.37732342,990,1797,1165,368,0,368,0,66,0,0.038043478,empty,mBC-0814-1
"E8,H8",4438,4903,3129,1774,2866,3,1608,1613,1126,487,2.31211499,883,1989,1362,409,0,409,0,75,0,0.026894866,empty,mBC-0814-1
"E8,H9",378861,428877,255990,172887,255574,0,155263,155443,125743,29700,4.233771044,91358,57015,39415,10965,5,10960,1,1098,0,0.001186131,mm10,mBC-0814-1
"E8,H10",3636,4018,2498,1520,2301,0,1269,1273,930,343,2.711370262,720,1526,1027,323,0,323,0,52,0,0.00619195,empty,mBC-0814-1
"E8,H11",3843,4149,2722,1427,2464,4,1329,1335,948,387,2.449612403,677,98,80,32,0,32,0,12,0,0,empty,mBC-0814-1
"E8,H12",2747,2936,1917,1019,1803,0,1041,1043,754,289,2.60899654,540,1315,807,195,0,195,0,52,0,0.005128205,empty,mBC-0814-1
"E9,A1",13785,14928,8553,6375,8763,0,5483,5489,3056,2433,1.256062474,3334,10243,4044,1240,0,1240,0,158,0,0.025806452,empty,mBC-0814-1
"E9,A2",5036,5304,3547,1757,3168,0,1729,1729,1251,478,2.617154812,931,1553,1149,350,0,350,0,83,0,0.02,empty,mBC-0814-1
"E9,A3",4420,4693,3201,1492,2778,0,1491,1491,1079,412,2.618932039,755,822,586,159,0,159,0,41,0,0,empty,mBC-0814-1
"E9,A4",5634,5969,4136,1833,3456,0,1831,1833,1304,529,2.465028355,963,750,525,147,0,147,0,24,0,0,empty,mBC-0814-1
"E9,A5",475341,544138,321103,223035,324228,1,203938,204171,160992,43179,3.728479122,120658,20758,14540,4019,5,4014,1,497,0,0.001993024,mm10,mBC-0814-1
"E9,A6",3845,4182,2816,1366,2381,0,1284,1287,889,398,2.233668342,662,2702,1348,372,0,372,0,67,0,0.005376344,empty,mBC-0814-1
"E9,A7",5245,5653,3693,1960,3370,0,1858,1859,1317,542,2.429889299,1036,1355,939,313,0,313,0,69,0,0,empty,mBC-0814-1
"E9,A8",2002,2279,1425,854,1324,0,751,751,557,194,2.871134021,406,1566,1119,318,0,318,0,64,0,0,empty,mBC-0814-1
"E9,A9",7166,7493,5074,2419,4302,0,2308,2309,1708,601,2.841930116,1200,1741,1212,375,0,375,0,74,0,0,empty,mBC-0814-1
"E9,A10",3356,3704,2334,1370,2133,6,1179,1187,877,310,2.829032258,636,285,163,41,0,41,0,15,0,0,empty,mBC-0814-1
"E9,A11",4517,4643,3228,1415,2749,0,1465,1465,1026,439,2.337129841,718,2410,1799,477,0,477,0,82,0,0,empty,mBC-0814-1
"E9,A12",3411,3480,2450,1030,2083,0,1100,1102,817,285,2.866666667,540,6379,2916,857,1,856,1,180,0,0,empty,mBC-0814-1
"E9,B1",4432,4741,3127,1614,2790,0,1504,1506,1046,460,2.273913043,825,1109,588,209,0,209,0,63,0,0,empty,mBC-0814-1
"E9,B2",554217,647655,359645,288010,381134,0,241783,242022,208395,33627,6.197252208,147321,59568,42642,11994,7,11987,1,1099,0,0.001084508,mm10,mBC-0814-1
"E9,B3",4729,5223,3298,1925,3178,0,1836,1836,1348,488,2.762295082,992,848,591,179,0,179,0,45,0,0.005586592,empty,mBC-0814-1
"E9,B4",4001,4382,2816,1566,2642,0,1464,1464,1073,391,2.744245524,796,1124,818,275,1,274,1,52,0,0.00729927,empty,mBC-0814-1
"E9,B5",4624,3723,2279,1444,2550,0,1522,1525,1150,375,3.066666667,890,1062,787,246,1,245,1,43,0,0.110204082,empty,mBC-0814-1
"E9,B6",3919,4190,2739,1451,2430,0,1346,1347,959,388,2.471649485,705,1075,813,236,0,236,0,62,0,0.029661017,empty,mBC-0814-1
"E9,B7",5494,5822,3886,1936,3244,2,1736,1740,1230,510,2.411764706,905,11847,3583,1073,4,1069,1,113,0,0.053320861,empty,mBC-0814-1
"E9,B8",3649,4024,2661,1363,2350,6,1241,1249,825,424,1.945754717,687,1153,849,257,0,257,0,55,0,0,empty,mBC-0814-1
"E9,B9",4523,4779,3251,1528,2807,0,1503,1503,1129,374,3.018716578,778,513,324,130,0,130,0,53,0,0,empty,mBC-0814-1
"E9,B10",4169,4362,2914,1448,2603,0,1393,1393,947,446,2.123318386,732,5479,1652,529,2,527,1,65,0,0,empty,mBC-0814-1
"E9,B11",10225,11243,7229,4014,6613,0,3644,3654,2797,857,3.263710618,2055,114,80,34,0,34,0,10,0,0,empty,mBC-0814-1
"E9,B12",5072,5444,3699,1745,3242,0,1752,1753,1278,475,2.690526316,919,1222,829,316,0,316,0,67,0,0.028481013,empty,mBC-0814-1
"E9,C1",5306,5591,3775,1816,3260,0,1735,1743,1202,541,2.22181146,916,832,469,136,0,136,0,29,0,0.051470588,empty,mBC-0814-1
"E9,C2",5017,5411,3515,1896,3110,0,1671,1673,1155,518,2.22972973,891,1229,907,230,1,229,1,64,0,0,empty,mBC-0814-1
"E9,C3",5671,5981,4118,1863,3515,7,1889,1897,1407,490,2.871428571,949,590,372,141,0,141,0,32,0,0,empty,mBC-0814-1
"E9,C4",4673,4961,3322,1639,2871,0,1521,1525,1146,379,3.023746702,796,1434,1002,315,0,315,0,70,0,0,empty,mBC-0814-1
"E9,C5",666999,755690,451044,304646,440119,2,266871,267204,227661,39543,5.757302177,156445,115520,83193,23929,14,23915,3,1729,0,0.001170813,mm10,mBC-0814-1
"E9,C6",5408,5734,3816,1918,3412,0,1854,1857,1346,511,2.634050881,1022,3439,1166,393,1,392,1,70,0,0,empty,mBC-0814-1
"E9,C7",7387,8284,5287,2997,4757,0,2652,2655,1923,732,2.62704918,1482,206,143,26,0,26,0,13,0,0,empty,mBC-0814-1
"E9,C8",5379,5601,3798,1803,3298,0,1730,1733,1243,490,2.536734694,926,9872,4167,1268,4,1264,3,153,0,0.234968354,empty,mBC-0814-1
"E9,C9",4453,4841,3171,1670,2800,0,1495,1495,1091,404,2.70049505,837,1131,724,204,0,204,0,45,0,0,empty,mBC-0814-1
"E9,C10",5761,6254,4120,2134,3477,0,1794,1794,1276,518,2.463320463,965,1215,842,255,0,255,0,43,0,0,empty,mBC-0814-1
"E9,C11",4503,4829,3245,1584,2808,0,1544,1544,1096,448,2.446428571,783,682,450,160,0,160,0,49,0,0,empty,mBC-0814-1
"E9,C12",518052,613331,339083,274248,358540,1,231676,231931,175500,56431,3.109992734,142401,122254,86856,24561,13,24548,2,1715,0,0.00187388,mm10,mBC-0814-1
"E9,D1",4284,4454,3052,1402,2685,1,1434,1437,1020,417,2.446043165,739,528,362,95,0,95,0,23,0,0,empty,mBC-0814-1
"E9,D2",5297,5605,3853,1752,3266,0,1666,1669,1135,534,2.125468165,870,2611,1354,431,0,431,0,72,0,0,empty,mBC-0814-1
"E9,D3",15428,16677,10818,5859,9797,0,5491,5498,3971,1527,2.600523903,3007,5435,3393,853,1,852,1,147,0,0.031690141,empty,mBC-0814-1
"E9,D4",4467,4982,3149,1833,2842,0,1554,1554,1100,454,2.422907489,860,10615,3280,1065,2,1063,1,148,0,0.044214487,empty,mBC-0814-1
"E9,D5",4000,4185,2840,1345,2492,0,1388,1390,1019,371,2.746630728,726,1794,1305,390,0,390,0,81,0,0.002564103,empty,mBC-0814-1
"E9,D6",103843,120073,64484,55589,70304,0,48017,48059,27831,20228,1.375865137,29790,3137,1642,449,2,447,1,81,0,0.111856823,empty,mBC-0814-1
"E9,D7",567635,643828,379652,264176,376663,1,233309,233586,185961,47625,3.904692913,137184,128943,93695,26256,15,26241,3,1814,0,0.000114325,mm10,mBC-0814-1
"E9,D8",4630,4868,3253,1615,2851,0,1541,1541,1088,453,2.401766004,811,806,540,176,0,176,0,41,0,0,empty,mBC-0814-1
"E9,D9",3094,3161,2178,983,1878,0,1016,1016,737,279,2.641577061,509,846,598,161,0,161,0,40,0,0,empty,mBC-0814-1
"E9,D10",3728,4265,2644,1621,2485,0,1413,1418,982,436,2.252293578,809,631,468,132,0,132,0,28,0,0.121212121,empty,mBC-0814-1
"E9,D11",3841,4157,2761,1396,2439,1,1307,1308,925,383,2.415143603,714,1945,1488,472,0,472,0,99,0,0.01059322,empty,mBC-0814-1
"E9,D12",5992,6396,4271,2125,3801,0,2034,2040,1395,645,2.162790698,1083,3352,2329,725,1,724,1,120,0,0,empty,mBC-0814-1
"E9,E1",4785,5065,3351,1714,2956,0,1563,1566,1102,464,2.375,864,1613,1165,399,0,399,0,63,0,0,empty,mBC-0814-1
"E9,E2",3347,3521,2418,1103,2078,0,1107,1107,795,312,2.548076923,579,984,695,197,0,197,0,53,0,0.065989848,empty,mBC-0814-1
"E9,E3",3579,3810,2542,1268,2291,0,1243,1245,895,350,2.557142857,659,29922,10588,3493,5,3488,3,294,0,0.128727064,empty,mBC-0814-1
"E9,E4",3124,3456,2256,1200,2069,0,1176,1177,853,324,2.632716049,673,846,560,174,1,173,1,38,0,0,empty,mBC-0814-1
"E9,E5",3658,3946,2695,1251,2295,0,1218,1218,908,310,2.929032258,647,982,710,181,0,181,0,31,0,0,empty,mBC-0814-1
"E9,E6",4536,4966,3228,1738,2830,0,1554,1559,1103,456,2.418859649,841,1179,761,219,0,219,0,43,0,0,empty,mBC-0814-1
"E9,E7",4363,4815,3102,1713,2726,0,1474,1479,1013,466,2.173819742,809,1847,1236,320,0,320,0,49,0,0.021875,empty,mBC-0814-1
"E9,E8",4533,4661,3306,1355,2742,0,1411,1418,1021,397,2.571788413,708,1949,1554,427,0,427,0,69,0,0.007025761,empty,mBC-0814-1
"E9,E9",3022,3148,2138,1010,1878,0,989,994,717,277,2.588447653,542,1292,1007,316,1,315,1,59,0,0.025396825,empty,mBC-0814-1
"E9,E10",437692,510924,295105,215819,300923,0,185576,185789,155052,30737,5.044474087,110785,194048,137311,39339,27,39312,3,2530,0,0.000763126,mm10,mBC-0814-1
"E9,E11",3991,4277,2814,1463,2505,0,1292,1293,953,340,2.802941176,702,1382,947,285,2,283,1,63,0,0,empty,mBC-0814-1
"E9,E12",3965,4259,2778,1481,2494,0,1392,1392,973,419,2.322195704,727,1312,747,200,0,200,0,52,0,0,empty,mBC-0814-1
"E9,F1",4713,5112,3423,1689,2939,0,1538,1540,1068,472,2.262711864,840,1542,1153,299,1,298,1,52,0,0,empty,mBC-0814-1
"E9,F2",6243,6676,4428,2248,3890,0,2122,2124,1547,577,2.681109185,1095,1487,989,380,0,380,0,93,0,0,empty,mBC-0814-1
"E9,F3",954885,1119543,633565,485978,653152,0,420668,421092,323749,97343,3.325858048,254890,222067,154664,45072,25,45047,3,2708,0,0.000488379,mm10,mBC-0814-1
"E9,F4",5045,5401,3644,1757,3267,0,1763,1773,1226,547,2.241316271,932,740,481,132,0,132,0,23,0,0.015151515,empty,mBC-0814-1
"E9,F5",4812,5234,3455,1779,3043,0,1637,1638,1202,436,2.756880734,870,1127,797,224,0,224,0,62,0,0,empty,mBC-0814-1
"E9,F6",5056,5286,3505,1781,3170,0,1723,1725,1225,500,2.45,953,1693,1141,339,0,339,0,75,0,0,empty,mBC-0814-1
"E9,F7",4375,4755,3152,1603,2849,0,1522,1526,1068,458,2.331877729,820,484,312,113,0,113,0,24,0,0,empty,mBC-0814-1
"E9,F8",6102,6455,4357,2098,3670,0,1961,1965,1431,534,2.679775281,1005,110,90,28,0,28,0,7,0,0,empty,mBC-0814-1
"E9,F9",5324,5799,3845,1954,3337,0,1788,1789,1318,471,2.798301486,932,1598,1104,377,0,377,0,71,0,0,empty,mBC-0814-1
"E9,F10",6548,7040,4725,2315,4054,0,2126,2128,1498,630,2.377777778,1114,1711,1195,296,1,295,1,64,0,0.006779661,empty,mBC-0814-1
"E9,F11",4384,4643,3147,1496,2697,0,1406,1408,1036,372,2.784946237,754,1026,715,274,0,274,0,50,0,0.00729927,empty,mBC-0814-1
"E9,F12",4712,4930,3395,1535,2818,0,1507,1508,1029,479,2.14822547,736,155,126,38,0,38,0,9,0,0,empty,mBC-0814-1
"E9,G1",7160,7709,5119,2590,4576,0,2422,2426,1685,741,2.273954116,1316,2842,1946,559,1,558,1,123,0,0.001792115,empty,mBC-0814-1
"E9,G2",5808,6074,4155,1919,3592,0,1922,1929,1354,575,2.354782609,1001,445,321,99,0,99,0,24,0,0,empty,mBC-0814-1
"E9,G3",4898,5235,3417,1818,3155,0,1751,1753,1266,487,2.599589322,986,2697,2031,555,1,554,1,100,0,0,empty,mBC-0814-1
"E9,G4",5185,5312,3714,1598,3072,0,1580,1581,1162,419,2.77326969,813,1,0,0,0,0,0,0,0,0,empty,mBC-0814-1
"E9,G5",414415,457266,283606,173660,269929,1,160147,160326,130480,29846,4.371775112,91690,12874,9194,2590,0,2590,0,386,0,0.004633205,mm10,mBC-0814-1
"E9,G6",14650,16609,10378,6231,9577,0,5360,5363,3958,1405,2.817081851,3045,212,131,54,0,54,0,19,0,0.037037037,empty,mBC-0814-1
"E9,G7",5332,5598,3830,1768,3252,0,1796,1796,1302,494,2.63562753,909,2677,1877,464,1,463,1,99,0,0.004319654,empty,mBC-0814-1
"E9,G8",6583,7475,4694,2781,4355,0,2457,2458,1720,738,2.330623306,1362,2775,1851,575,0,575,0,137,0,0.00173913,empty,mBC-0814-1
"E9,G9",5180,5522,3652,1870,3284,2,1820,1828,1344,484,2.776859504,991,24909,7512,2318,3,2315,1,273,0,0.006911447,empty,mBC-0814-1
"E9,G10",8811,9315,6323,2992,5396,0,2886,2892,2063,829,2.48854041,1517,2803,1843,578,1,577,1,129,0,0,empty,mBC-0814-1
"E9,G11",9239,9805,6528,3277,5700,0,3096,3103,2204,899,2.451612903,1624,1226,858,257,0,257,0,80,0,0,empty,mBC-0814-1
"E9,G12",4371,4651,2928,1723,2733,0,1528,1528,1087,441,2.464852608,866,2088,1579,410,0,410,0,91,0,0,empty,mBC-0814-1
"E9,H1",4654,4954,3299,1655,2884,0,1556,1560,1155,405,2.851851852,827,813,567,151,0,151,0,34,0,0,empty,mBC-0814-1
"E9,H2",1305602,1500077,876926,623151,861836,0,536971,537548,458630,78918,5.811475202,317788,550017,401994,113149,61,113088,8,4333,0,7.9584E-05,mm10,mBC-0814-1
"E9,H3",5119,5657,3658,1999,3288,0,1795,1797,1316,481,2.735966736,986,1584,1173,393,0,393,0,77,0,0,empty,mBC-0814-1
"E9,H4",591050,686538,394091,292447,399082,3,248913,249188,211241,37947,5.566737819,149253,8967,6297,1925,4,1921,1,246,0,0.001561687,mm10,mBC-0814-1
"E9,H5",6638,7283,4819,2464,4162,0,2240,2247,1595,652,2.446319018,1183,1872,1354,441,1,440,1,75,0,0.038636364,empty,mBC-0814-1
"E9,H6",6079,6495,4332,2163,3737,0,1986,1993,1441,552,2.610507246,1072,20890,6948,2047,1,2046,1,235,0,0.053763441,empty,mBC-0814-1
"E9,H7",5129,5475,3647,1828,3296,0,1765,1772,1274,498,2.558232932,973,1517,1207,333,0,333,0,63,0,0,empty,mBC-0814-1
"E9,H8",4318,4601,3085,1516,2703,0,1476,1480,1075,405,2.654320988,780,1328,899,296,0,296,0,88,0,0,empty,mBC-0814-1
"E9,H9",5814,6085,4079,2006,3672,0,1997,1999,1531,468,3.271367521,1081,1108,762,223,0,223,0,49,0,0.035874439,empty,mBC-0814-1
"E9,H10",861784,980069,576301,403768,571767,3,356010,356440,281312,75128,3.744436162,211346,217130,140608,41660,27,41633,4,2599,0,0.007494055,mm10,mBC-0814-1
"E9,H11",3657,4111,2607,1504,2432,5,1368,1374,961,413,2.326876513,799,9,7,3,0,3,0,3,0,0,empty,mBC-0814-1
"E9,H12",2306,2503,1582,921,1543,0,875,877,627,250,2.508,507,818,531,148,0,148,0,51,0,0,empty,mBC-0814-1
"E10,A1",5014,5375,3682,1693,3182,0,1673,1677,1198,479,2.501043841,864,1759,1197,385,0,385,0,69,0,0,empty,mBC-0814-1
"E10,A2",4780,5014,3449,1565,3106,0,1695,1698,1250,448,2.790178571,874,2072,1297,429,1,428,1,115,0,0,empty,mBC-0814-1
"E10,A3",3954,4123,2827,1296,2460,0,1299,1302,926,376,2.462765957,673,1241,881,285,0,285,0,61,0,0.063157895,empty,mBC-0814-1
"E10,A4",608997,697915,404686,293229,407576,1,252891,253185,208151,45034,4.622085535,150594,105345,75267,20666,15,20651,2,1568,0,0.000484238,mm10,mBC-0814-1
"E10,A5",4130,4354,2966,1388,2601,0,1414,1416,1014,402,2.52238806,741,1477,1109,317,0,317,0,64,0,0,empty,mBC-0814-1
"E10,A6",5230,5925,3624,2301,3480,0,1973,1977,1487,490,3.034693878,1127,1629,1159,284,0,284,0,61,0,0,empty,mBC-0814-1
"E10,A7",4952,5226,3491,1735,3113,0,1705,1705,1198,507,2.362919132,885,1981,1387,409,0,409,0,98,0,0.056234719,empty,mBC-0814-1
"E10,A8",1980,2135,1423,712,1287,0,732,732,531,201,2.641791045,388,1911,1316,364,0,364,0,81,0,0.002747253,empty,mBC-0814-1
"E10,A9",6106,6512,4496,2016,3708,0,1937,1937,1370,567,2.41622575,1016,2798,2028,536,0,536,0,100,0,0,empty,mBC-0814-1
"E10,A10",736923,855971,483972,371999,508809,1,328058,328401,236975,91426,2.591986962,198416,84414,52748,14723,7,14716,1,1332,0,0.014677902,mm10,mBC-0814-1
"E10,A11",4348,4602,3071,1531,2767,0,1544,1544,1131,413,2.738498789,819,3195,2368,768,0,768,0,158,0,0,empty,mBC-0814-1
"E10,A12",301382,344540,201704,142836,205208,0,125407,125557,108944,16613,6.557755974,74447,549230,401156,110672,61,110611,4,4142,0,0.000497238,mm10,mBC-0814-1
"E10,B1",4169,4559,2977,1582,2718,0,1466,1474,1042,432,2.412037037,783,2323,1698,516,2,514,2,98,0,0.021400778,empty,mBC-0814-1
"E10,B2",580759,669455,379682,289773,392745,0,249135,249376,193930,55446,3.497637341,150345,71251,50430,14049,10,14039,3,1246,0,0.000498611,mm10,mBC-0814-1
"E10,B3",3740,4177,2703,1474,2428,0,1380,1380,1015,365,2.780821918,737,1137,727,236,0,236,0,55,0,0.042372881,empty,mBC-0814-1
"E10,B4",3827,4254,2764,1490,2560,0,1444,1444,1074,370,2.902702703,783,1089,746,272,0,272,0,72,0,0,empty,mBC-0814-1
"E10,B5",3386,2172,1409,763,1542,0,806,811,583,228,2.557017544,479,1180,832,231,0,231,0,49,0,0,empty,mBC-0814-1
"E10,B6",3841,3979,2785,1194,2344,0,1273,1273,904,369,2.449864499,654,1410,945,252,0,252,0,58,0,0,empty,mBC-0814-1
"E10,B7",4264,4644,3069,1575,2804,0,1488,1489,1069,420,2.545238095,793,877,595,170,0,170,0,58,0,0.047058824,empty,mBC-0814-1
"E10,B8",342310,398844,227892,170952,237120,0,148159,148280,122769,25511,4.812394653,88905,118201,85961,24243,13,24230,2,1647,0,0.000288898,mm10,mBC-0814-1
"E10,B9",4351,4776,3077,1699,2770,0,1550,1551,1148,403,2.848635236,840,2343,1486,500,0,500,0,106,0,0,empty,mBC-0814-1
"E10,B10",3689,3877,2591,1286,2380,0,1271,1271,952,319,2.984326019,672,673,485,152,0,152,0,31,0,0,empty,mBC-0814-1
"E10,B11",414904,466488,280144,186344,275229,0,170254,170469,132658,37811,3.508449922,99843,2936,2025,580,0,580,0,77,0,0,empty,mBC-0814-1
"E10,B12",4859,5202,3425,1777,3076,0,1697,1698,1249,449,2.781737194,890,2013,1483,429,0,429,0,84,0,0,empty,mBC-0814-1
"E10,C1",5031,5325,3555,1770,3118,0,1700,1708,1202,506,2.375494071,934,3338,1289,384,0,384,0,70,0,0,empty,mBC-0814-1
"E10,C2",496716,577972,331993,245979,338041,2,210316,210588,172892,37696,4.586481324,126127,338523,238351,66361,34,66327,4,3106,0,0.000105538,mm10,mBC-0814-1
"E10,C3",4932,5224,3538,1686,3099,0,1674,1678,1218,460,2.647826087,875,650,467,119,0,119,0,34,0,0,empty,mBC-0814-1
"E10,C4",4753,5110,3370,1740,3040,0,1616,1621,1173,448,2.618303571,837,1760,1223,383,0,383,0,100,0,0.002610966,empty,mBC-0814-1
"E10,C5",6383,6756,4478,2278,3953,0,2114,2118,1610,508,3.169291339,1127,12394,4224,1386,1,1385,1,177,0,0.055595668,empty,mBC-0814-1
"E10,C6",4717,5006,3327,1679,2978,0,1619,1629,1165,464,2.510775862,850,1526,1043,308,0,308,0,88,0,0.025974026,empty,mBC-0814-1
"E10,C7",6242,6770,4406,2364,3966,0,2169,2172,1536,636,2.41509434,1198,721,554,135,0,135,0,33,0,0,empty,mBC-0814-1
"E10,C8",888030,1018111,596010,422101,598571,1,375527,375966,300025,75941,3.950764409,222066,353405,256689,72125,39,72086,4,3571,0,0.000887828,mm10,mBC-0814-1
"E10,C9",4499,4902,3205,1697,2888,0,1581,1587,1163,424,2.742924528,856,2888,2029,550,0,550,0,97,0,0,empty,mBC-0814-1
"E10,C10",4927,5280,3488,1792,3129,0,1680,1680,1214,466,2.605150215,924,2609,1945,492,1,491,1,76,0,0,empty,mBC-0814-1
"E10,C11",4284,4637,3029,1608,2717,0,1494,1500,1087,413,2.631961259,815,3117,2337,654,1,653,1,104,0,0,empty,mBC-0814-1
"E10,C12",7415,8042,5203,2839,4801,1,2647,2651,1808,843,2.144721234,1465,3125,2104,625,1,624,1,109,0,0.02724359,empty,mBC-0814-1
"E10,D1",4185,4469,3017,1452,2645,0,1440,1446,1016,430,2.362790698,755,1125,793,196,0,196,0,30,0,0,empty,mBC-0814-1
"E10,D2",4588,4841,3318,1523,2839,0,1448,1450,1038,412,2.519417476,733,12061,3283,1095,5,1090,2,151,0,0.055045872,empty,mBC-0814-1
"E10,D3",9548,10393,6759,3634,6119,0,3353,3363,2391,972,2.459876543,1829,2715,1797,525,0,525,0,123,0,0.003809524,empty,mBC-0814-1
"E10,D4",4797,5481,3449,2032,3195,0,1791,1798,1291,507,2.546351085,985,1569,1148,365,0,365,0,92,0,0.019178082,empty,mBC-0814-1
"E10,D5",4247,4510,2992,1518,2726,1,1538,1541,1099,442,2.486425339,829,14903,5567,1646,2,1644,1,202,0,0.02189781,empty,mBC-0814-1
"E10,D6",4525,4913,3229,1684,2817,0,1548,1550,1139,411,2.771289538,851,1292,780,263,0,263,0,66,0,0,empty,mBC-0814-1
"E10,D7",5411,5606,3838,1768,3361,2,1775,1779,1308,471,2.777070064,946,6446,2975,892,0,892,0,120,0,0.098654709,empty,mBC-0814-1
"E10,D8",5028,5602,3530,2072,3352,0,1875,1882,1419,463,3.064794816,1056,1163,865,212,0,212,0,63,0,0,empty,mBC-0814-1
"E10,D9",3026,3229,2057,1172,1881,0,1066,1066,782,284,2.753521127,559,4725,3539,984,1,983,1,135,0,0,empty,mBC-0814-1
"E10,D10",3344,3549,2423,1126,2134,0,1126,1127,830,297,2.794612795,603,1431,1014,268,0,268,0,60,0,0,empty,mBC-0814-1
"E10,D11",3818,4089,2720,1369,2401,1,1299,1301,955,346,2.760115607,682,4760,3523,937,1,936,1,185,0,0,empty,mBC-0814-1
"E10,D12",5719,6147,4003,2144,3508,7,1905,1912,1341,571,2.348511384,1019,4690,3210,890,0,890,0,151,0,0.013483146,empty,mBC-0814-1
"E10,E1",4639,4839,3270,1569,2836,0,1468,1472,1062,410,2.590243902,768,59791,18461,5724,10,5714,2,498,0,0.116730837,empty,mBC-0814-1
"E10,E2",3267,3438,2369,1069,2104,0,1108,1108,780,328,2.37804878,573,1338,737,229,0,229,0,72,0,0,empty,mBC-0814-1
"E10,E3",3245,3326,2344,982,1937,0,1001,1004,720,284,2.535211268,498,20454,6701,2029,2,2027,1,216,0,0.040947213,empty,mBC-0814-1
"E10,E4",2807,3205,1956,1249,1807,0,1013,1015,676,339,1.994100295,579,2060,1486,397,0,397,0,71,0,0,empty,mBC-0814-1
"E10,E5",3198,3283,2326,957,1971,0,1048,1051,785,266,2.95112782,519,1229,869,265,0,265,0,55,0,0.011320755,empty,mBC-0814-1
"E10,E6",4016,4288,2885,1403,2494,6,1360,1369,1008,361,2.792243767,701,1941,1428,411,0,411,0,72,0,0,empty,mBC-0814-1
"E10,E7",4141,4484,2925,1559,2614,1,1425,1428,1005,423,2.375886525,789,1525,1004,308,0,308,0,85,0,0,empty,mBC-0814-1
"E10,E8",4338,4671,3217,1454,2727,0,1414,1417,1010,407,2.481572482,741,2330,1605,413,0,413,0,82,0,0,empty,mBC-0814-1
"E10,E9",439635,493050,290376,202674,290023,0,178610,178801,152562,26239,5.814322192,104444,231436,167792,47908,21,47887,2,2850,0,0.001127655,mm10,mBC-0814-1
"E10,E10",3922,4169,2755,1414,2464,1,1350,1352,961,391,2.457800512,732,3241,2381,653,1,652,1,119,0,0,empty,mBC-0814-1
"E10,E11",3759,3939,2712,1227,2203,0,1166,1167,835,332,2.515060241,565,3813,2697,802,0,802,0,146,0,0,empty,mBC-0814-1
"E10,E12",3765,4115,2681,1434,2395,0,1329,1331,964,367,2.626702997,723,1640,1029,337,0,337,0,67,0,0,empty,mBC-0814-1
"E10,F1",4182,4445,3093,1352,2694,0,1426,1430,1046,384,2.723958333,741,2236,1459,438,0,438,0,84,0,0.011415525,empty,mBC-0814-1
"E10,F2",5486,5881,3964,1917,3530,0,1936,1940,1430,510,2.803921569,1016,2192,1533,465,1,464,1,128,0,0,empty,mBC-0814-1
"E10,F3",4457,4828,3193,1635,2833,0,1548,1548,1130,418,2.703349282,842,1713,1146,299,0,299,0,88,0,0.02006689,empty,mBC-0814-1
"E10,F4",4848,5220,3422,1798,3143,0,1723,1727,1252,475,2.635789474,952,623,454,103,0,103,0,30,0,0,empty,mBC-0814-1
"E10,F5",4571,4988,3278,1710,2904,0,1591,1594,1119,475,2.355789474,843,1629,1144,343,1,342,1,78,0,0,empty,mBC-0814-1
"E10,F6",421848,489463,281455,208008,290119,0,179783,180006,152927,27079,5.647438975,107791,339367,247980,68413,32,68381,2,3128,0,0.000321727,mm10,mBC-0814-1
"E10,F7",3973,4386,2774,1612,2592,0,1453,1455,1046,409,2.557457213,816,472,314,101,0,101,0,34,0,0,empty,mBC-0814-1
"E10,F8",5602,5895,4033,1862,3421,0,1809,1809,1296,513,2.526315789,940,369,211,66,0,66,0,15,0,0,empty,mBC-0814-1
"E10,F9",4867,5155,3493,1662,2962,0,1551,1558,1111,447,2.485458613,814,3812,2807,840,0,840,0,157,0,0.004761905,empty,mBC-0814-1
"E10,F10",5859,6305,4217,2088,3745,0,2015,2017,1451,566,2.56360424,1080,2644,1852,550,0,550,0,102,0,0,empty,mBC-0814-1
"E10,F11",3793,4187,2742,1445,2397,0,1287,1290,938,352,2.664772727,708,3874,2745,784,1,783,1,121,0,0,empty,mBC-0814-1
"E10,F12",4453,4957,3244,1713,2862,0,1590,1591,1120,471,2.377919321,865,67,52,28,0,28,0,11,0,0,empty,mBC-0814-1
"E10,G1",6588,6973,4654,2319,4067,9,2176,2196,1594,602,2.647840532,1141,4095,2851,853,1,852,1,164,0,0.007042254,empty,mBC-0814-1
"E10,G2",549895,632289,364337,267952,372530,2,230735,231000,189773,41227,4.603124166,137841,49776,33145,9491,2,9489,1,812,0,0.001686163,mm10,mBC-0814-1
"E10,G3",4641,5094,3283,1811,2952,0,1676,1682,1211,471,2.571125265,906,3886,2071,598,1,597,1,124,0,0.031825796,empty,mBC-0814-1
"E10,G4",4701,5040,3372,1668,2930,0,1592,1595,1137,458,2.482532751,814,15,10,7,0,7,0,4,0,0,empty,mBC-0814-1
"E10,G5",4014,4349,2831,1518,2511,0,1393,1393,1020,373,2.73458445,758,2207,1490,481,0,481,0,81,0,0,empty,mBC-0814-1
"E10,G6",8005,8621,5731,2890,4915,0,2525,2530,1839,691,2.661360347,1344,913,320,106,0,106,0,24,0,0.103773585,empty,mBC-0814-1
"E10,G7",4748,4998,3404,1594,2931,0,1525,1528,1107,421,2.629453682,772,2990,2160,657,1,656,1,131,0,0.035060976,empty,mBC-0814-1
"E10,G8",6592,7166,4727,2439,4226,0,2263,2271,1613,658,2.451367781,1238,3733,2465,764,0,764,0,189,0,0,empty,mBC-0814-1
"E10,G9",4818,5315,3417,1898,3165,0,1777,1778,1261,517,2.439071567,951,4400,3150,960,2,958,1,180,0,0.016701461,empty,mBC-0814-1
"E10,G10",8453,8994,6106,2888,5370,0,2905,2910,2042,868,2.352534562,1550,5347,3888,1084,0,1084,0,204,0,0.026752768,empty,mBC-0814-1
"E10,G11",7968,8465,5655,2810,5003,0,2689,2690,1958,732,2.674863388,1392,1939,1428,419,0,419,0,101,0,0,empty,mBC-0814-1
"E10,G12",4520,4905,3186,1719,2860,0,1582,1582,1129,453,2.492273731,860,3876,2747,872,1,871,1,149,0,0,empty,mBC-0814-1
"E10,H1",4493,5045,3238,1807,2905,1,1576,1577,1107,470,2.355319149,893,1046,693,252,0,252,0,71,0,0.007936508,empty,mBC-0814-1
"E10,H2",7183,7577,5104,2473,4466,0,2437,2444,1710,734,2.329700272,1268,3153,2073,693,0,693,0,170,0,0,empty,mBC-0814-1
"E10,H3",5160,5342,3682,1660,3146,0,1631,1635,1163,472,2.463983051,808,14317,4652,1375,3,1372,1,167,0,0.133381924,empty,mBC-0814-1
"E10,H4",1116654,1291649,738895,552754,745272,1,476924,477490,373758,103732,3.603111865,286584,12225,8198,2247,0,2247,0,323,0,0.005340454,mm10,mBC-0814-1
"E10,H5",5844,6306,4086,2220,3608,0,1979,1983,1399,584,2.395547945,1061,2999,1844,501,0,501,0,108,0,0.063872255,empty,mBC-0814-1
"E10,H6",562486,646683,377511,269172,380383,1,235417,235691,197245,38446,5.130442699,139259,357834,261618,70502,37,70465,2,3306,0,0.000425743,mm10,mBC-0814-1
"E10,H7",408279,444360,285632,158728,267185,1,154218,154386,102303,52083,1.964230171,87122,34452,14835,4123,5,4118,2,509,0,0.020883924,mm10,mBC-0814-1
"E10,H8",8502,9724,5829,3895,5796,0,3457,3458,2761,697,3.961262554,1999,2713,1997,608,0,608,0,120,0,0,empty,mBC-0814-1
"E10,H9",4413,4717,3182,1535,2782,1,1475,1478,1046,432,2.421296296,807,3478,2481,737,1,736,1,109,0,0.005434783,empty,mBC-0814-1
"E10,H10",3167,3455,2231,1224,2031,0,1106,1110,789,321,2.457943925,609,1849,1322,322,0,322,0,75,0,0,empty,mBC-0814-1
"E10,H11",3805,4386,2713,1673,2509,0,1427,1430,1028,402,2.55721393,783,112,57,32,0,32,0,13,0,0,empty,mBC-0814-1
"E10,H12",2569,2718,1790,928,1690,0,970,970,715,255,2.803921569,503,2186,1575,472,1,471,1,95,0,0,empty,mBC-0814-1
"E11,A1",5464,5975,3915,2060,3456,0,1885,1887,1344,543,2.475138122,1017,1265,792,309,0,309,0,78,0,0,empty,mBC-0814-1
"E11,A2",4516,4906,3273,1633,2787,0,1458,1462,1022,440,2.322727273,783,2120,1523,518,0,518,0,123,0,0,empty,mBC-0814-1
"E11,A3",4655,5159,3341,1818,2943,0,1635,1642,1174,468,2.508547009,890,1279,838,224,0,224,0,65,0,0,empty,mBC-0814-1
"E11,A4",5590,5972,4058,1914,3460,0,1839,1839,1321,518,2.55019305,931,410,263,66,0,66,0,22,0,0,empty,mBC-0814-1
"E11,A5",4530,4805,3190,1615,2813,0,1531,1532,1102,430,2.562790698,793,7187,2249,718,3,715,2,99,0,0.135664336,empty,mBC-0814-1
"E11,A6",306560,341858,210468,131390,204903,0,121568,121731,94976,26755,3.549841151,70145,52127,36408,10431,2,10429,1,999,0,0.002301275,mm10,mBC-0814-1
"E11,A7",5223,5664,3795,1869,3327,0,1786,1788,1293,495,2.612121212,929,1607,1073,312,0,312,0,89,0,0.038461538,empty,mBC-0814-1
"E11,A8",2080,2321,1497,824,1355,0,752,752,519,233,2.227467811,423,1654,1194,368,0,368,0,85,0,0,empty,mBC-0814-1
"E11,A9",6020,6581,4223,2358,3792,0,2039,2047,1430,617,2.317666126,1119,1870,1392,415,0,415,0,72,0,0.036144578,empty,mBC-0814-1
"E11,A10",3252,3538,2285,1253,2073,0,1185,1190,829,361,2.296398892,644,287,185,65,0,65,0,18,0,0.107692308,empty,mBC-0814-1
"E11,A11",301121,345651,198171,147480,208041,0,130195,130336,111427,18909,5.892802369,78187,178730,120685,35113,24,35089,5,2170,0,0.00054148,mm10,mBC-0814-1
"E11,A12",3536,3569,2470,1099,2133,0,1134,1138,818,320,2.55625,590,83870,25305,8121,16,8105,2,748,0,0.04898211,empty,mBC-0814-1
"E11,B1",4495,4931,3157,1774,2789,0,1522,1524,1085,439,2.471526196,840,1191,891,292,0,292,0,81,0,0,empty,mBC-0814-1
"E11,B2",4810,4984,3401,1583,2928,0,1618,1618,1151,467,2.464668094,831,3797,1141,316,1,315,1,58,0,0.038095238,empty,mBC-0814-1
"E11,B3",3710,3840,2592,1248,2292,3,1232,1235,879,356,2.469101124,626,17185,5530,1613,2,1611,1,183,0,0.049037865,empty,mBC-0814-1
"E11,B4",3929,4259,2787,1472,2534,0,1385,1385,946,439,2.154897494,738,912,584,210,0,210,0,72,0,0.004761905,empty,mBC-0814-1
"E11,B5",9037,8949,5212,3737,5621,0,3370,3379,2680,699,3.834048641,2032,1560,798,271,1,270,1,56,0,0,empty,mBC-0814-1
"E11,B6",3606,3980,2573,1407,2380,0,1327,1329,943,386,2.443005181,728,1711,1231,354,0,354,0,73,0,0.02259887,empty,mBC-0814-1
"E11,B7",5192,5600,3637,1963,3226,0,1754,1754,1236,518,2.386100386,958,1280,789,231,0,231,0,70,0,0,empty,mBC-0814-1
"E11,B8",3745,4014,2749,1265,2383,0,1256,1256,894,362,2.46961326,677,1176,819,257,0,257,0,59,0,0,empty,mBC-0814-1
"E11,B9",442466,510863,294899,215964,301805,0,188736,188934,132480,56454,2.34668934,113043,47796,34969,10049,10,10039,2,1015,0,0,mm10,mBC-0814-1
"E11,B10",301652,325269,195621,129648,201743,3,120338,120630,92555,28075,3.296705254,70597,46424,31131,8997,7,8990,1,832,0,0,mm10,mBC-0814-1
"E11,B11",6099,6636,4286,2350,3871,0,2140,2144,1512,632,2.392405063,1189,652,244,76,0,76,0,12,0,0,empty,mBC-0814-1
"E11,B12",487211,586947,310282,276665,353381,0,242665,242877,162162,80715,2.009068946,151846,42438,25571,7200,6,7194,2,759,0,0.005560189,mm10,mBC-0814-1
"E11,C1",5391,5600,3939,1661,3309,0,1710,1710,1220,490,2.489795918,881,905,671,211,0,211,0,50,0,0,empty,mBC-0814-1
"E11,C2",508278,619709,309977,309732,363505,0,263779,264096,150685,113411,1.328663004,166426,129772,94749,27201,17,27184,1,1840,0,0.001765745,mm10,mBC-0814-1
"E11,C3",5688,6059,4080,1979,3516,0,1960,1962,1402,560,2.503571429,999,772,446,137,0,137,0,46,0,0,empty,mBC-0814-1
"E11,C4",4646,4871,3372,1499,2925,0,1585,1590,1162,428,2.714953271,820,1769,1286,384,0,384,0,97,0,0,empty,mBC-0814-1
"E11,C5",7443,7965,5354,2611,4691,0,2558,2561,1846,715,2.581818182,1347,1769,1277,427,0,427,0,105,0,0.014051522,empty,mBC-0814-1
"E11,C6",6346,6863,4535,2328,4067,0,2210,2216,1664,552,3.014492754,1183,2022,1467,450,0,450,0,85,0,0.062222222,empty,mBC-0814-1
"E11,C7",6729,7072,4787,2285,4146,0,2223,2228,1613,615,2.622764228,1184,493,361,110,0,110,0,30,0,0.009090909,empty,mBC-0814-1
"E11,C8",502059,577670,337232,240438,342674,0,214050,214279,158510,55769,2.842260037,127248,123642,83720,23653,11,23642,1,1773,0,0.004821927,mm10,mBC-0814-1
"E11,C9",466786,550336,308889,241447,324631,1,204052,204295,173733,30562,5.684608337,123759,187310,133772,37615,25,37590,3,2378,0,0.000558659,mm10,mBC-0814-1
"E11,C10",5506,5718,4048,1670,3382,0,1736,1738,1256,482,2.605809129,888,1483,866,250,0,250,0,63,0,0.004,empty,mBC-0814-1
"E11,C11",4422,4718,3162,1556,2780,0,1504,1504,1076,428,2.514018692,838,1031,607,206,0,206,0,62,0,0.004854369,empty,mBC-0814-1
"E11,C12",7846,8557,5583,2974,4905,0,2684,2689,1919,770,2.492207792,1452,2431,1679,559,0,559,0,109,0,0,empty,mBC-0814-1
"E11,D1",4118,4540,2860,1680,2672,0,1472,1473,1047,426,2.457746479,843,796,573,163,0,163,0,39,0,0,empty,mBC-0814-1
"E11,D2",470236,500680,340089,160591,295588,1,160170,160372,114066,46306,2.46330929,85764,47128,22026,6341,7,6334,2,675,0,0.013735396,mm10,mBC-0814-1
"E11,D3",587907,689310,383654,305656,406543,0,263037,263325,190045,73280,2.593408843,160009,160338,112471,32055,23,32032,3,2156,0,0.000124875,mm10,mBC-0814-1
"E11,D4",4563,5052,3272,1780,2923,0,1619,1625,1153,472,2.44279661,856,1544,1097,346,0,346,0,83,0,0,empty,mBC-0814-1
"E11,D5",3652,4023,2507,1516,2437,0,1370,1371,957,414,2.311594203,756,2103,1466,423,1,422,1,116,0,0.042654028,empty,mBC-0814-1
"E11,D6",4781,5302,3435,1867,3023,0,1626,1628,1145,483,2.370600414,898,12140,3646,1169,2,1167,1,152,0,0.000856898,empty,mBC-0814-1
"E11,D7",5520,5910,3954,1956,3502,0,1842,1848,1331,517,2.574468085,973,2728,1823,536,0,536,0,98,0,0.03358209,empty,mBC-0814-1
"E11,D8",489709,571169,324070,247099,334432,0,206877,207115,177986,29129,6.110268118,124234,293067,203279,57587,35,57552,1,3009,0,0.000538643,mm10,mBC-0814-1
"E11,D9",2908,3085,2162,923,1806,0,942,942,674,268,2.514925373,468,1801,1178,351,0,351,0,77,0,0,empty,mBC-0814-1
"E11,D10",416958,494352,274843,219509,291989,0,183990,184163,152612,31551,4.836994073,112172,235400,162261,47159,35,47124,4,2633,0,6.36618E-05,mm10,mBC-0814-1
"E11,D11",4042,4236,2863,1373,2540,0,1361,1365,949,416,2.28125,721,2347,1708,513,0,513,0,133,0,0.033138402,empty,mBC-0814-1
"E11,D12",6194,6681,4462,2219,3795,0,2012,2016,1440,576,2.5,1087,3841,2665,867,0,867,0,153,0,0.01384083,empty,mBC-0814-1
"E11,E1",4539,4845,3204,1641,2802,0,1446,1448,1031,417,2.472422062,778,1722,1252,402,0,402,0,73,0,0.027363184,empty,mBC-0814-1
"E11,E2",3471,3667,2455,1212,2124,0,1125,1127,821,306,2.683006536,578,1827,1191,348,0,348,0,78,0,0.025862069,empty,mBC-0814-1
"E11,E3",3589,3721,2575,1146,2141,0,1122,1124,823,301,2.734219269,545,1351,1000,301,0,301,0,77,0,0,empty,mBC-0814-1
"E11,E4",3085,3224,2248,976,1841,0,966,966,709,257,2.758754864,485,1408,956,275,1,274,1,60,0,0,empty,mBC-0814-1
"E11,E5",10257,10958,7520,3438,6352,0,3222,3228,2478,750,3.304,1648,4669,3141,830,0,830,0,144,0,0,empty,mBC-0814-1
"E11,E6",4428,4946,3222,1724,2790,1,1532,1533,1118,415,2.693975904,805,1587,1156,341,1,340,1,76,0,0,empty,mBC-0814-1
"E11,E7",4975,5228,3623,1605,3061,0,1621,1621,1217,404,3.012376238,828,1585,1120,404,0,404,0,82,0,0,empty,mBC-0814-1
"E11,E8",4353,4526,3122,1404,2632,0,1348,1353,977,376,2.598404255,682,2799,2135,626,0,626,0,107,0,0.046325879,empty,mBC-0814-1
"E11,E9",395115,457863,262107,195756,270721,0,171569,171814,129783,42031,3.087792344,102964,138462,101559,29189,17,29172,2,1937,0,0.00061703,mm10,mBC-0814-1
"E11,E10",4006,4468,2886,1582,2650,0,1463,1467,1004,463,2.168466523,818,2012,1503,464,1,463,1,103,0,0.032397408,empty,mBC-0814-1
"E11,E11",4054,4363,2875,1488,2576,1,1411,1415,967,448,2.158482143,794,1944,1267,386,0,386,0,91,0,0,empty,mBC-0814-1
"E11,E12",3625,3882,2520,1362,2312,0,1296,1296,923,373,2.474530831,721,1136,694,194,0,194,0,54,0,0,empty,mBC-0814-1
"E11,F1",4433,4876,3145,1731,2818,0,1537,1537,1091,446,2.446188341,792,1822,1248,405,0,405,0,86,0,0,empty,mBC-0814-1
"E11,F2",6455,6846,4586,2260,3949,0,2102,2109,1508,601,2.509151414,1111,2041,1421,488,0,488,0,118,0,0,empty,mBC-0814-1
"E11,F3",4740,5084,3434,1650,2909,0,1565,1565,1136,429,2.648018648,786,2000,1393,466,0,466,0,115,0,0.051502146,empty,mBC-0814-1
"E11,F4",5212,5516,3646,1870,3220,0,1730,1730,1206,524,2.301526718,943,597,422,100,0,100,0,23,0,0,empty,mBC-0814-1
"E11,F5",4867,5230,3448,1782,3092,0,1663,1665,1200,465,2.580645161,903,1571,1080,333,0,333,0,81,0,0.003003003,empty,mBC-0814-1
"E11,F6",4657,4933,3268,1665,2906,0,1615,1619,1171,448,2.613839286,869,2242,1548,488,0,488,0,118,0,0.016393443,empty,mBC-0814-1
"E11,F7",4589,4991,3266,1725,2891,0,1570,1576,1064,512,2.078125,844,778,584,198,1,197,1,67,0,0.005076142,empty,mBC-0814-1
"E11,F8",6066,6448,4327,2121,3782,0,2008,2012,1470,542,2.712177122,1047,237,179,59,0,59,0,15,0,0,empty,mBC-0814-1
"E11,F9",5193,5576,3680,1896,3299,0,1790,1797,1259,538,2.340148699,916,4822,2476,756,0,756,0,136,0,0.013227513,empty,mBC-0814-1
"E11,F10",739552,848320,500675,347645,493372,0,304113,304490,225918,78572,2.875299089,178513,212171,157701,43566,20,43546,2,2449,0,0.000206678,mm10,mBC-0814-1
"E11,F11",3890,4060,2737,1323,2420,0,1302,1303,916,387,2.366925065,679,1689,1224,336,0,336,0,73,0,0.104166667,empty,mBC-0814-1
"E11,F12",4480,4925,3260,1665,2939,0,1596,1601,1149,452,2.542035398,875,126,100,31,0,31,0,13,0,0,empty,mBC-0814-1
"E11,G1",454609,535789,301148,234641,317695,0,201073,201288,165826,35462,4.676160397,121746,433392,300203,83948,44,83904,2,3621,0,0.000679348,mm10,mBC-0814-1
"E11,G2",5621,6155,4035,2120,3506,0,1883,1888,1433,455,3.149450549,1011,521,383,124,0,124,0,25,0,0.064516129,empty,mBC-0814-1
"E11,G3",4821,5165,3454,1711,3042,0,1665,1667,1184,483,2.451345756,915,14398,5139,1546,10,1536,3,217,0,0.012369792,empty,mBC-0814-1
"E11,G4",5024,5525,3607,1918,3184,0,1721,1722,1247,475,2.625263158,946,10,3,3,0,3,0,2,0,0,empty,mBC-0814-1
"E11,G5",4320,4803,3069,1734,2802,0,1557,1557,1073,484,2.216942149,831,1490,965,268,0,268,0,77,0,0.029850746,empty,mBC-0814-1
"E11,G6",8528,9287,6160,3127,5318,0,2776,2778,2049,729,2.810699588,1481,417,233,44,0,44,0,13,0,0,empty,mBC-0814-1
"E11,G7",4897,5188,3492,1696,3185,0,1721,1723,1173,550,2.132727273,924,2700,1784,606,0,606,0,134,0,0,empty,mBC-0814-1
"E11,G8",6585,7101,4642,2459,4080,0,2195,2198,1558,640,2.434375,1170,3272,2316,743,0,743,0,177,0,0.001345895,empty,mBC-0814-1
"E11,G9",4875,5335,3446,1889,3094,0,1630,1637,1130,507,2.228796844,893,2897,1875,642,0,642,0,148,0,0.00623053,empty,mBC-0814-1
"E11,G10",8461,9025,6262,2763,5261,0,2741,2745,1963,782,2.510230179,1325,3750,2308,772,0,772,0,172,0,0.011658031,empty,mBC-0814-1
"E11,G11",8775,9284,6323,2961,5486,3,2945,2954,2117,837,2.529271207,1532,1929,1376,361,0,361,0,106,0,0,empty,mBC-0814-1
"E11,G12",4237,4644,2958,1686,2786,0,1588,1590,1155,435,2.655172414,900,2207,1573,443,0,443,0,112,0,0.020316027,empty,mBC-0814-1
"E11,H1",4418,4605,3281,1324,2744,0,1478,1483,1063,420,2.530952381,736,1112,835,250,0,250,0,68,0,0,empty,mBC-0814-1
"E11,H2",9268,10029,6666,3363,5903,0,3286,3290,2409,881,2.734392736,1743,3922,2754,884,1,883,1,170,0,0,empty,mBC-0814-1
"E11,H3",5036,5574,3589,1985,3221,0,1783,1785,1282,503,2.548707753,961,1301,867,225,0,225,0,74,0,0,empty,mBC-0814-1
"E11,H4",5152,5561,3747,1814,3285,0,1792,1799,1280,519,2.46628131,961,83,54,33,0,33,0,15,0,0,empty,mBC-0814-1
"E11,H5",6514,6856,4751,2105,3961,0,2101,2104,1500,604,2.483443709,1067,2246,1528,411,0,411,0,79,0,0,empty,mBC-0814-1
"E11,H6",5917,6372,4185,2187,3671,0,1969,1972,1378,594,2.31986532,1065,2061,1470,431,0,431,0,107,0,0,empty,mBC-0814-1
"E11,H7",4962,5339,3563,1776,3196,0,1723,1728,1192,536,2.223880597,928,4207,1915,589,0,589,0,98,0,0,empty,mBC-0814-1
"E11,H8",292058,332001,197187,134814,198190,0,121484,121637,96444,25193,3.828206248,72006,64683,41186,11771,11,11760,3,1136,0,0.000765306,mm10,mBC-0814-1
"E11,H9",427454,491624,282973,208651,292772,0,182359,182513,151279,31234,4.843407825,109320,156698,106184,31231,20,31211,3,1994,0,0.001473839,mm10,mBC-0814-1
"E11,H10",3440,3619,2480,1139,2054,0,1096,1096,780,316,2.46835443,529,1427,952,353,2,351,1,74,0,0,empty,mBC-0814-1
"E11,H11",3507,3715,2441,1274,2257,0,1248,1252,889,363,2.449035813,687,17,10,9,0,9,0,8,0,0,empty,mBC-0814-1
"E11,H12",2117,2222,1472,750,1361,0,762,766,558,208,2.682692308,416,1349,878,265,0,265,0,76,0,0,empty,mBC-0814-1
"E12,A1",5513,6161,4027,2134,3579,0,1924,1927,1395,532,2.622180451,1045,2380,1136,341,0,341,0,63,0,0,empty,mBC-0814-1
"E12,A2",4453,4851,3163,1688,2881,0,1608,1612,1152,460,2.504347826,899,1350,974,308,0,308,0,88,0,0,empty,mBC-0814-1
"E12,A3",4370,4708,3111,1597,2767,0,1503,1504,1085,419,2.589498807,807,836,529,147,0,147,0,38,0,0,empty,mBC-0814-1
"E12,A4",5678,6028,4113,1915,3491,0,1802,1806,1279,527,2.426944972,919,911,707,180,0,180,0,27,0,0,empty,mBC-0814-1
"E12,A5",473278,552170,316518,235652,327751,0,205698,205951,160962,44989,3.577807909,123494,126180,91709,26005,19,25986,2,1821,0,0.001731702,mm10,mBC-0814-1
"E12,A6",332056,390479,212803,177676,232587,0,152287,152453,125572,26881,4.671403594,93538,134841,96082,27006,10,26996,3,1861,0,3.70425E-05,mm10,mBC-0814-1
"E12,A7",5264,5889,3719,2170,3426,0,1854,1857,1317,540,2.438888889,1046,1678,1072,331,0,331,0,68,0,0.006042296,empty,mBC-0814-1
"E12,A8",1989,2211,1397,814,1308,0,706,706,500,206,2.427184466,399,1354,936,288,0,288,0,64,0,0,empty,mBC-0814-1
"E12,A9",6028,6451,4384,2067,3739,3,1987,1995,1423,572,2.487762238,1020,894,618,218,0,218,0,46,0,0.02293578,empty,mBC-0814-1
"E12,A10",3175,3306,2292,1014,1955,0,1038,1041,710,331,2.145015106,544,398,262,63,0,63,0,18,0,0,empty,mBC-0814-1
"E12,A11",4205,4687,2944,1743,2755,0,1527,1528,1100,428,2.570093458,878,1849,1372,385,0,385,0,82,0,0.015584416,empty,mBC-0814-1
"E12,A12",369103,411772,244724,167048,244201,1,148889,149069,121461,27608,4.399485656,87596,278036,204807,58080,40,58040,4,2856,0,0.000223983,mm10,mBC-0814-1
"E12,B1",4240,4408,3101,1307,2590,0,1351,1352,954,398,2.396984925,693,1136,822,243,0,243,0,56,0,0.008230453,empty,mBC-0814-1
"E12,B2",4812,5225,3313,1912,3046,0,1688,1689,1214,475,2.555789474,966,567,279,62,1,61,1,16,0,0,empty,mBC-0814-1
"E12,B3",3828,4153,2637,1516,2422,1,1326,1332,940,392,2.397959184,737,838,513,153,0,153,0,40,0,0,empty,mBC-0814-1
"E12,B4",422662,495815,275179,220636,296509,1,190917,191097,151410,39687,3.815103182,116985,118229,82004,24065,21,24044,4,1705,0,0.000665447,mm10,mBC-0814-1
"E12,B5",304380,209384,125533,83851,148965,2,89470,89777,68580,21197,3.235363495,54054,46567,28256,8137,6,8131,3,832,0,0.000614931,mm10,mBC-0814-1
"E12,B6",3440,3636,2390,1246,2157,0,1176,1177,816,361,2.260387812,662,1122,743,246,0,246,0,52,0,0,empty,mBC-0814-1
"E12,B7",4953,5172,3630,1542,3080,0,1587,1590,1116,474,2.35443038,798,1641,1143,293,0,293,0,58,0,0,empty,mBC-0814-1
"E12,B8",3822,4082,2753,1329,2371,0,1301,1303,933,370,2.521621622,671,939,681,237,0,237,0,45,0,0,empty,mBC-0814-1
"E12,B9",4275,4524,3050,1474,2641,0,1426,1426,985,441,2.233560091,774,844,528,177,1,176,1,48,0,0,empty,mBC-0814-1
"E12,B10",3810,3853,2660,1193,2395,0,1273,1273,909,364,2.497252747,642,611,375,103,1,102,1,21,0,0,empty,mBC-0814-1
"E12,B11",6067,6657,4286,2371,3776,0,2030,2036,1483,553,2.681735986,1076,174,137,40,0,40,0,11,0,0,empty,mBC-0814-1
"E12,B12",4995,5459,3570,1889,3145,0,1750,1751,1250,501,2.49500998,928,2098,1011,326,0,326,0,63,0,0.036809816,empty,mBC-0814-1
"E12,C1",5396,5734,3973,1761,3389,0,1779,1784,1294,490,2.640816327,939,624,352,109,0,109,0,28,0,0,empty,mBC-0814-1
"E12,C2",4919,5228,3437,1791,3027,0,1608,1609,1169,440,2.656818182,849,1632,1120,319,0,319,0,83,0,0.07523511,empty,mBC-0814-1
"E12,C3",565445,647257,381927,265330,383093,1,242082,242334,183202,59132,3.098187107,143120,5884,4239,1269,1,1268,1,182,0,0.002365931,mm10,mBC-0814-1
"E12,C4",4881,5057,3355,1702,2973,0,1607,1607,1116,491,2.272912424,860,55310,15418,5027,10,5017,4,389,0,0.139126968,empty,mBC-0814-1
"E12,C5",6689,7165,4785,2380,4122,0,2204,2207,1605,602,2.666112957,1183,1338,913,299,0,299,0,74,0,0,empty,mBC-0814-1
"E12,C6",5235,5544,3742,1802,3357,3,1853,1858,1354,504,2.686507937,958,4349,1609,505,0,505,0,84,0,0.007920792,empty,mBC-0814-1
"E12,C7",6722,7113,4837,2276,4174,0,2217,2224,1577,647,2.4374034,1147,1211,500,167,0,167,0,36,0,0.089820359,empty,mBC-0814-1
"E12,C8",5160,5435,3673,1762,3179,0,1685,1688,1199,489,2.45194274,908,1399,958,326,0,326,0,79,0,0.024539877,empty,mBC-0814-1
"E12,C9",4554,4966,3281,1685,2867,0,1575,1576,1144,432,2.648148148,832,962,699,246,0,246,0,46,0,0,empty,mBC-0814-1
"E12,C10",5530,6002,3986,2016,3450,0,1785,1788,1284,504,2.547619048,959,1163,808,242,0,242,0,53,0,0,empty,mBC-0814-1
"E12,C11",4603,4827,3069,1758,2831,0,1587,1597,1092,505,2.162376238,888,7757,2777,839,1,838,1,136,0,0.077565632,empty,mBC-0814-1
"E12,C12",7865,8300,5593,2707,4762,1,2527,2532,1832,700,2.617142857,1334,1984,1437,431,0,431,0,71,0,0.025522042,empty,mBC-0814-1
"E12,D1",4069,4280,2895,1385,2529,0,1394,1396,980,416,2.355769231,704,468,306,91,0,91,0,27,0,0,empty,mBC-0814-1
"E12,D2",5151,5495,3844,1651,3152,0,1586,1591,1149,442,2.599547511,844,1408,1081,321,0,321,0,64,0,0.043613707,empty,mBC-0814-1
"E12,D3",10024,10909,7108,3801,6397,0,3492,3493,2552,941,2.712008502,1960,2691,1941,456,0,456,0,90,0,0.039473684,empty,mBC-0814-1
"E12,D4",5075,5483,3580,1903,3167,0,1724,1725,1231,494,2.491902834,951,1768,1262,312,0,312,0,71,0,0,empty,mBC-0814-1
"E12,D5",3473,3664,2392,1272,2208,0,1203,1205,823,382,2.154450262,636,1868,1236,384,0,384,0,90,0,0.03125,empty,mBC-0814-1
"E12,D6",4613,4852,3401,1451,2798,0,1464,1469,1030,439,2.346241458,748,825,509,170,0,170,0,55,0,0.052941176,empty,mBC-0814-1
"E12,D7",5369,5632,3840,1792,3209,0,1718,1719,1241,478,2.59623431,861,1615,1154,361,1,360,1,86,0,0,empty,mBC-0814-1
"E12,D8",492644,590171,319639,270532,352034,2,232556,232819,161476,71343,2.263375524,144377,73263,52456,14982,6,14976,2,1227,0,0,mm10,mBC-0814-1
"E12,D9",3188,3599,2306,1293,2089,0,1166,1167,813,354,2.296610169,630,1613,1212,364,0,364,0,63,0,0,empty,mBC-0814-1
"E12,D10",3593,3843,2588,1255,2283,0,1245,1246,870,376,2.313829787,661,687,367,135,0,135,0,48,0,0,empty,mBC-0814-1
"E12,D11",4001,4192,2817,1375,2434,0,1328,1329,924,405,2.281481481,711,2362,1802,520,0,520,0,112,0,0.001923077,empty,mBC-0814-1
"E12,D12",5637,6061,3974,2087,3503,0,1881,1883,1337,546,2.448717949,1005,3141,2335,773,0,773,0,130,0,0.01164295,empty,mBC-0814-1
"E12,E1",4508,4814,3333,1481,2746,2,1440,1446,1023,423,2.418439716,721,971,704,261,0,261,0,59,0,0,empty,mBC-0814-1
"E12,E2",3347,3677,2459,1218,2085,0,1149,1149,789,360,2.191666667,586,1071,802,241,0,241,0,53,0,0,empty,mBC-0814-1
"E12,E3",415692,492919,276072,216847,290898,0,186449,186659,150980,35679,4.231620841,112661,189229,130360,37921,24,37897,3,2283,0,0.000237486,mm10,mBC-0814-1
"E12,E4",3133,3253,2279,974,1922,0,1032,1032,744,288,2.583333333,509,748,515,179,1,178,1,60,0,0,empty,mBC-0814-1
"E12,E5",3649,3876,2693,1183,2311,1,1186,1189,881,308,2.86038961,614,740,497,168,1,167,1,45,0,0,empty,mBC-0814-1
"E12,E6",4427,4690,3306,1384,2705,0,1372,1377,1004,373,2.691689008,691,1211,903,264,1,263,1,58,0,0,empty,mBC-0814-1
"E12,E7",4976,5264,3524,1740,2992,0,1582,1587,1154,433,2.665127021,814,1321,882,315,0,315,0,74,0,0,empty,mBC-0814-1
"E12,E8",717455,800526,490010,310516,465535,3,280774,281104,212758,68346,3.112954672,161164,184385,133850,38238,29,38209,4,2346,0,0.000471093,mm10,mBC-0814-1
"E12,E9",2972,3233,2097,1136,1884,0,1022,1025,742,283,2.621908127,559,1056,625,259,0,259,0,58,0,0,empty,mBC-0814-1
"E12,E10",4000,4243,2797,1446,2464,0,1352,1352,979,373,2.624664879,687,10913,3683,1158,3,1155,2,159,0,0.145454545,empty,mBC-0814-1
"E12,E11",3882,4048,2680,1368,2396,0,1269,1269,882,387,2.279069767,668,1362,884,296,0,296,0,66,0,0.033783784,empty,mBC-0814-1
"E12,E12",3842,4196,2742,1454,2418,0,1333,1337,944,393,2.402035623,715,4569,1683,509,1,508,1,73,0,0.029527559,empty,mBC-0814-1
"E12,F1",4305,4513,3087,1426,2695,0,1460,1462,1037,425,2.44,770,1469,1045,302,0,302,0,61,0,0,empty,mBC-0814-1
"E12,F2",6556,7005,4695,2310,4112,0,2214,2219,1597,622,2.567524116,1183,2157,1578,474,0,474,0,99,0,0.044303797,empty,mBC-0814-1
"E12,F3",4705,5089,3387,1702,2912,0,1556,1559,1127,432,2.608796296,808,1799,1273,418,0,418,0,90,0,0,empty,mBC-0814-1
"E12,F4",5006,5366,3508,1858,3195,6,1701,1711,1209,502,2.408366534,942,4368,1323,436,1,435,1,62,0,0.020689655,empty,mBC-0814-1
"E12,F5",5090,5457,3534,1923,3156,0,1697,1702,1250,452,2.765486726,922,722,435,182,0,182,0,62,0,0,empty,mBC-0814-1
"E12,F6",4232,4543,2993,1550,2705,0,1494,1495,1061,434,2.444700461,811,8794,3103,989,0,989,0,155,0,0.062689585,empty,mBC-0814-1
"E12,F7",4276,4566,3088,1478,2677,3,1416,1421,997,424,2.351415094,735,631,487,165,0,165,0,38,0,0,empty,mBC-0814-1
"E12,F8",5923,6234,4196,2038,3661,0,1938,1940,1337,603,2.217247098,1049,227,185,56,0,56,0,15,0,0,empty,mBC-0814-1
"E12,F9",5167,5593,3681,1912,3234,0,1727,1731,1191,540,2.205555556,956,1557,1018,363,0,363,0,82,0,0,empty,mBC-0814-1
"E12,F10",6313,6520,4560,1960,3797,0,1925,1929,1352,577,2.343154246,976,1805,1206,407,0,407,0,71,0,0,empty,mBC-0814-1
"E12,F11",4273,4632,3132,1500,2660,0,1395,1395,1024,371,2.760107817,718,1386,1000,270,0,270,0,54,0,0,empty,mBC-0814-1
"E12,F12",993779,1156176,664987,491189,669499,2,420301,420791,345860,74931,4.615713123,251666,38285,25726,7376,6,7370,1,765,0,0.000407056,mm10,mBC-0814-1
"E12,G1",6808,7490,4858,2632,4401,0,2469,2476,1723,753,2.288180611,1365,3604,2707,893,0,893,0,160,0,0.001119821,empty,mBC-0814-1
"E12,G2",5665,5976,4012,1964,3428,0,1842,1847,1334,513,2.600389864,951,271,207,62,0,62,0,14,0,0,empty,mBC-0814-1
"E12,G3",653368,747679,436983,310696,434632,1,267713,268073,224444,43629,5.144376447,158458,227850,167980,47060,32,47028,7,2523,0,4.25279E-05,mm10,mBC-0814-1
"E12,G4",5095,5485,3652,1833,3178,0,1718,1719,1248,471,2.649681529,875,128,96,24,0,24,0,4,0,0,empty,mBC-0814-1
"E12,G5",4354,4873,3153,1720,2836,0,1566,1569,1126,443,2.541760722,855,1008,754,228,0,228,0,54,0,0.004385965,empty,mBC-0814-1
"E12,G6",8331,8898,6057,2841,5143,1,2662,2673,1892,781,2.422535211,1375,256,175,56,0,56,0,13,0,0,empty,mBC-0814-1
"E12,G7",459433,522414,308428,213986,312317,0,191835,192052,150677,41375,3.641740181,112867,180291,133937,38200,23,38177,1,2257,0,0.000445294,mm10,mBC-0814-1
"E12,G8",287875,336628,187685,148943,200836,0,127747,127861,106544,21317,4.998076652,77958,181675,133506,38298,24,38274,2,2265,0,0.000339656,mm10,mBC-0814-1
"E12,G9",4679,5048,3281,1767,2964,0,1663,1665,1155,510,2.264705882,896,3307,2453,589,0,589,0,118,0,0,empty,mBC-0814-1
"E12,G10",8458,8816,6052,2764,5180,0,2714,2716,1941,775,2.504516129,1408,2088,1490,502,0,502,0,104,0,0.007968127,empty,mBC-0814-1
"E12,G11",8846,9381,6291,3090,5471,0,2889,2891,1994,897,2.22296544,1543,1672,1252,389,0,389,0,72,0,0.025706941,empty,mBC-0814-1
"E12,G12",4324,4575,3042,1533,2712,0,1461,1463,1072,391,2.74168798,768,1515,1051,357,0,357,0,85,0,0,empty,mBC-0814-1
"E12,H1",4434,4908,3157,1751,2866,0,1592,1593,1091,502,2.173306773,859,951,671,218,0,218,0,46,0,0,empty,mBC-0814-1
"E12,H2",7536,7984,5530,2454,4662,1,2441,2447,1717,730,2.352054795,1269,3130,2316,646,1,645,1,134,0,0,empty,mBC-0814-1
"E12,H3",4724,5047,3410,1637,2952,0,1548,1550,1145,405,2.827160494,815,1558,1070,386,0,386,0,72,0,0,empty,mBC-0814-1
"E12,H4",5019,5435,3604,1831,3144,0,1720,1720,1213,507,2.392504931,889,45,23,12,0,12,0,10,0,0,empty,mBC-0814-1
"E12,H5",6349,6984,4534,2450,4019,0,2194,2203,1611,592,2.721283784,1224,2114,1517,416,0,416,0,77,0,0,empty,mBC-0814-1
"E12,H6",5760,6107,4132,1975,3541,0,1893,1893,1332,561,2.374331551,988,1776,1283,392,0,392,0,90,0,0,empty,mBC-0814-1
"E12,H7",4976,5540,3536,2004,3277,0,1824,1827,1331,496,2.683467742,1030,969,656,194,0,194,0,49,0,0.108247423,empty,mBC-0814-1
"E12,H8",4314,4639,3132,1507,2687,0,1478,1483,1100,383,2.872062663,777,1884,1362,467,0,467,0,90,0,0,empty,mBC-0814-1
"E12,H9",4235,4442,3050,1392,2576,0,1363,1363,994,369,2.693766938,699,1084,773,243,0,243,0,52,0,0,empty,mBC-0814-1
"E12,H10",3335,3581,2475,1106,2006,0,1033,1037,723,314,2.302547771,522,943,645,196,0,196,0,48,0,0,empty,mBC-0814-1
"E12,H11",3509,3726,2468,1258,2271,0,1267,1268,877,391,2.242966752,691,27,19,11,0,11,0,7,0,0,empty,mBC-0814-1
"E12,H12",2072,2239,1480,759,1381,0,770,770,559,211,2.6492891,420,1416,1098,342,1,341,1,80,0,0.052785924,empty,mBC-0814-1
"F1,A1",590234,700055,390334,309721,415974,10,270818,271099,204748,66351,3.085831412,164687,109113,76380,21999,21,21978,2,1561,0,0,mm10,mBC-0814-1
"F1,A2",389110,438783,257687,181096,261482,0,162757,162959,131503,31456,4.180537894,96168,136282,93652,27643,19,27624,5,1770,0,7.24008E-05,mm10,mBC-0814-1
"F1,A3",403222,468815,269005,199810,277239,1,170024,170262,146686,23576,6.221835765,101985,240155,155973,43788,26,43762,1,2599,0,0.002513596,mm10,mBC-0814-1
"F1,A4",6257,6638,4618,2020,3877,0,2033,2037,1385,652,2.124233129,1042,539,397,132,0,132,0,36,0,0,empty,mBC-0814-1
"F1,A5",513275,603108,343899,259209,358927,0,226790,226988,176071,50917,3.458000275,136936,154653,108489,30179,17,30162,2,1914,0,0.00092832,mm10,mBC-0814-1
"F1,A6",6086,6767,4307,2460,3994,0,2283,2287,1746,541,3.227356747,1270,1848,1391,458,1,457,1,78,0,0.021881838,empty,mBC-0814-1
"F1,A7",464770,528168,308955,219213,314943,0,199935,200179,155950,44229,3.525967126,118516,18240,12925,3870,1,3869,1,466,0,0,mm10,mBC-0814-1
"F1,A8",2270,2484,1617,867,1467,0,833,833,563,270,2.085185185,461,5252,2170,706,1,705,1,112,0,0.070921986,empty,mBC-0814-1
"F1,A9",6963,7472,4848,2624,4326,0,2358,2360,1691,669,2.527653214,1245,28026,8655,2642,3,2639,2,291,0,0.036756347,empty,mBC-0814-1
"F1,A10",3613,3917,2618,1299,2231,0,1236,1237,883,354,2.494350282,629,204,143,33,0,33,0,13,0,0,empty,mBC-0814-1
"F1,A11",4757,4978,3398,1580,2996,0,1570,1577,1131,446,2.535874439,819,11235,3925,1293,1,1292,1,168,0,0.090557276,empty,mBC-0814-1
"F1,A12",3812,4236,2642,1594,2523,0,1372,1375,996,379,2.627968338,774,63015,18962,6049,15,6034,2,555,0,0.035631422,empty,mBC-0814-1
"F1,B1",4839,4997,3480,1517,3000,0,1562,1568,1094,474,2.308016878,791,2477,1741,570,1,569,1,112,0,0.001757469,empty,mBC-0814-1
"F1,B2",5312,5792,3640,2152,3505,0,1950,1952,1382,570,2.424561404,1127,550,372,129,1,128,1,29,0,0,empty,mBC-0814-1
"F1,B3",4279,4754,3039,1715,2771,2,1578,1582,1111,471,2.35881104,848,1845,1371,362,0,362,0,65,0,0.016574586,empty,mBC-0814-1
"F1,B4",385539,459378,245997,213381,277202,0,187749,187920,132365,55555,2.382593826,117011,38875,26528,7545,3,7542,1,839,0,0.001193317,mm10,mBC-0814-1
"F1,B5",3760,2469,1640,829,1749,0,969,975,713,262,2.721374046,534,1501,1027,325,0,325,0,72,0,0,empty,mBC-0814-1
"F1,B6",4211,4433,3032,1401,2586,0,1397,1397,984,413,2.382566586,720,1570,1113,313,0,313,0,65,0,0,empty,mBC-0814-1
"F1,B7",5499,5736,3824,1912,3435,0,1918,1922,1325,597,2.219430486,1034,23476,7462,2363,3,2360,2,261,0,0.051271186,empty,mBC-0814-1
"F1,B8",461462,533722,307999,225723,316000,0,195513,195738,166264,29474,5.64103956,116474,233454,171635,49388,15,49373,2,2519,0,0.000344318,mm10,mBC-0814-1
"F1,B9",4798,5101,3390,1711,2933,0,1567,1567,1120,447,2.505592841,818,852,658,218,0,218,0,60,0,0,empty,mBC-0814-1
"F1,B10",4340,4556,3081,1475,2815,0,1501,1508,1046,462,2.264069264,787,409,280,80,0,80,0,26,0,0,empty,mBC-0814-1
"F1,B11",523765,601887,351672,250215,353212,0,218795,219033,167834,51199,3.278071837,130502,7126,4652,1295,1,1294,1,179,0,0.008500773,mm10,mBC-0814-1
"F1,B12",5492,5997,3960,2037,3568,0,1976,1979,1398,581,2.406196213,1079,1473,951,240,0,240,0,67,0,0,empty,mBC-0814-1
"F1,C1",5904,6304,4307,1997,3715,0,1996,2001,1446,555,2.605405405,1031,1098,856,205,0,205,0,45,0,0,empty,mBC-0814-1
"F1,C2",5422,5826,3969,1857,3320,0,1782,1788,1303,485,2.686597938,940,1653,1175,379,1,378,1,120,0,0,empty,mBC-0814-1
"F1,C3",205583,233794,140684,93110,142083,0,86783,86888,57243,29645,1.93094957,51209,8518,4351,1250,3,1247,1,197,0,0,mm10,mBC-0814-1
"F1,C4",5219,5545,3663,1882,3276,0,1763,1767,1255,512,2.451171875,918,1327,912,340,1,339,1,91,0,0,empty,mBC-0814-1
"F1,C5",7698,8158,5506,2652,4700,0,2469,2473,1759,714,2.463585434,1280,1972,1431,427,0,427,0,104,0,0,empty,mBC-0814-1
"F1,C6",5695,6138,4047,2091,3618,0,1956,1959,1414,545,2.594495413,1054,1496,1129,362,0,362,0,75,0,0.013812155,empty,mBC-0814-1
"F1,C7",6816,7251,4932,2319,4163,0,2217,2217,1621,596,2.719798658,1071,631,445,117,0,117,0,28,0,0,empty,mBC-0814-1
"F1,C8",493864,562089,328940,233149,333635,0,207268,207482,152046,55436,2.742730356,122929,107936,78487,21685,12,21673,1,1692,0,0.00124579,mm10,mBC-0814-1
"F1,C9",5074,5565,3574,1991,3258,0,1783,1789,1275,514,2.480544747,1000,1643,1199,362,0,362,0,69,0,0,empty,mBC-0814-1
"F1,C10",6273,6718,4514,2204,3816,0,2022,2022,1442,580,2.486206897,1075,8654,2723,841,1,840,1,104,0,0.025,empty,mBC-0814-1
"F1,C11",5098,5555,3628,1927,3205,1,1711,1713,1237,476,2.598739496,938,1628,1099,341,0,341,0,76,0,0,empty,mBC-0814-1
"F1,C12",9016,10003,6299,3704,5776,0,3230,3234,2258,976,2.31352459,1803,2476,1758,497,0,497,0,91,0,0,empty,mBC-0814-1
"F1,D1",4608,4975,3387,1588,2970,0,1616,1621,1119,502,2.229083665,849,628,474,138,0,138,0,32,0,0,empty,mBC-0814-1
"F1,D2",5504,5948,4015,1933,3405,0,1796,1805,1321,484,2.729338843,908,1829,1114,328,0,328,0,83,0,0.006097561,empty,mBC-0814-1
"F1,D3",11055,11892,7789,4103,7010,0,3847,3852,2722,1130,2.408849558,2055,2483,1685,508,0,508,0,117,0,0,empty,mBC-0814-1
"F1,D4",4838,5167,3343,1824,3075,0,1696,1700,1186,514,2.307392996,929,2243,1671,470,0,470,0,91,0,0,empty,mBC-0814-1
"F1,D5",4160,4260,2969,1291,2625,1,1389,1392,1012,380,2.663157895,718,2233,1474,496,0,496,0,126,0,0.016129032,empty,mBC-0814-1
"F1,D6",5161,5545,3722,1823,3232,0,1759,1760,1225,535,2.289719626,940,1524,1103,344,0,344,0,62,0,0,empty,mBC-0814-1
"F1,D7",5972,6290,4328,1962,3720,0,1926,1927,1368,559,2.447227191,992,3434,2133,614,1,613,1,113,0,0.016313214,empty,mBC-0814-1
"F1,D8",5045,5222,3676,1546,3120,0,1686,1690,1202,488,2.463114754,833,1246,837,263,0,263,0,65,0,0.02661597,empty,mBC-0814-1
"F1,D9",3308,3745,2306,1439,2208,0,1240,1242,890,352,2.528409091,701,2186,1667,458,0,458,0,71,0,0,empty,mBC-0814-1
"F1,D10",3791,4137,2675,1462,2431,0,1359,1362,934,428,2.182242991,733,938,710,229,0,229,0,58,0,0,empty,mBC-0814-1
"F1,D11",4270,4594,3058,1536,2663,0,1415,1421,1014,407,2.491400491,765,2641,1958,554,0,554,0,115,0,0.018050542,empty,mBC-0814-1
"F1,D12",6555,7082,4738,2344,4208,0,2284,2288,1611,677,2.379615953,1235,3584,2422,664,0,664,0,123,0,0,empty,mBC-0814-1
"F1,E1",5047,5206,3639,1567,3068,5,1571,1580,1171,409,2.863080685,793,2311,1626,473,0,473,0,104,0,0.00845666,empty,mBC-0814-1
"F1,E2",3586,3945,2541,1404,2327,0,1273,1279,904,375,2.410666667,699,1393,997,329,0,329,0,69,0,0.012158055,empty,mBC-0814-1
"F1,E3",3686,3995,2601,1394,2384,0,1332,1335,947,388,2.440721649,750,1646,1116,378,0,378,0,71,0,0.079365079,empty,mBC-0814-1
"F1,E4",3413,3720,2489,1231,2243,1,1231,1240,865,375,2.306666667,655,1637,1106,392,0,392,0,72,0,0.00255102,empty,mBC-0814-1
"F1,E5",4076,4199,2928,1271,2422,0,1276,1280,919,361,2.545706371,613,961,661,205,0,205,0,48,0,0,empty,mBC-0814-1
"F1,E6",4784,4989,3434,1555,2891,0,1527,1527,1128,399,2.827067669,785,1433,909,283,0,283,0,65,0,0,empty,mBC-0814-1
"F1,E7",4557,4770,3220,1550,2761,0,1463,1463,1066,397,2.685138539,768,1535,973,322,0,322,0,77,0,0,empty,mBC-0814-1
"F1,E8",4720,4990,3412,1578,2910,3,1574,1581,1148,433,2.651270208,805,2521,1678,470,0,470,0,97,0,0,empty,mBC-0814-1
"F1,E9",3209,3422,2363,1059,2002,0,1066,1068,791,277,2.855595668,558,1696,1080,360,0,360,0,87,0,0.022222222,empty,mBC-0814-1
"F1,E10",4250,4657,3057,1600,2818,0,1573,1576,1101,475,2.317894737,844,2111,1457,472,0,472,0,109,0,0,empty,mBC-0814-1
"F1,E11",4428,4746,3202,1544,2806,0,1491,1499,1054,445,2.368539326,775,1626,1055,380,0,380,0,93,0,0,empty,mBC-0814-1
"F1,E12",4056,4396,2879,1517,2614,0,1437,1442,1026,416,2.466346154,807,1064,662,219,0,219,0,68,0,0,empty,mBC-0814-1
"F1,F1",4843,5130,3541,1589,3029,0,1594,1597,1165,432,2.696759259,807,1738,1206,375,1,374,1,86,0,0.002673797,empty,mBC-0814-1
"F1,F2",7263,7763,5129,2634,4494,1,2429,2433,1723,710,2.426760563,1317,2723,1971,628,1,627,1,142,0,0.009569378,empty,mBC-0814-1
"F1,F3",5199,5675,3792,1883,3319,0,1794,1798,1285,513,2.504873294,996,2512,1796,526,0,526,0,92,0,0.020912548,empty,mBC-0814-1
"F1,F4",5568,5880,3962,1918,3460,0,1823,1824,1293,531,2.435028249,931,557,382,130,0,130,0,32,0,0,empty,mBC-0814-1
"F1,F5",5434,5733,3970,1763,3352,0,1786,1788,1302,486,2.679012346,913,1645,1192,340,0,340,0,87,0,0.005882353,empty,mBC-0814-1
"F1,F6",511854,569767,345355,224412,339344,2,207146,207326,144072,63254,2.277674139,121519,47406,32824,9286,4,9282,1,1026,0,0.000861883,mm10,mBC-0814-1
"F1,F7",4676,5005,3457,1548,2941,7,1561,1573,1089,484,2.25,796,457,321,120,0,120,0,44,0,0,empty,mBC-0814-1
"F1,F8",601808,688100,399838,288262,406276,5,259104,259441,198423,61018,3.251876495,153364,4949,3300,859,2,857,2,145,0,0,empty,mBC-0814-1
"F1,F9",5398,5678,3905,1773,3329,0,1747,1748,1263,485,2.604123711,900,1824,1312,398,0,398,0,105,0,0,empty,mBC-0814-1
"F1,F10",6713,6974,4917,2057,4161,1,2221,2226,1559,667,2.337331334,1137,1679,1163,368,0,368,0,77,0,0,empty,mBC-0814-1
"F1,F11",4316,4537,3078,1459,2729,0,1412,1414,1016,398,2.552763819,745,1291,885,305,0,305,0,63,0,0,empty,mBC-0814-1
"F1,F12",400812,457122,269891,187231,271580,1,168604,168786,137882,30904,4.461623091,100148,3703,2611,791,0,791,0,119,0,0,empty,mBC-0814-1
"F1,G1",828548,978677,545371,433306,578828,1,372628,373028,300914,72114,4.17275425,226203,500184,346925,97455,66,97389,5,4095,0,0.003275524,mm10,mBC-0814-1
"F1,G2",5884,6235,4219,2016,3700,0,1961,1964,1388,576,2.409722222,1065,751,496,117,0,117,0,29,0,0.042735043,empty,mBC-0814-1
"F1,G3",5150,5559,3626,1933,3233,0,1774,1774,1277,497,2.569416499,938,2477,1740,465,0,465,0,110,0,0,empty,mBC-0814-1
"F1,G4",5446,5772,3967,1805,3374,0,1813,1816,1282,534,2.400749064,924,6,3,3,0,3,0,2,0,0,empty,mBC-0814-1
"F1,G5",4972,5517,3607,1910,3171,0,1713,1717,1228,489,2.511247444,906,2038,1426,430,0,430,0,86,0,0.025581395,empty,mBC-0814-1
"F1,G6",9042,9630,6598,3032,5609,0,2923,2928,2091,837,2.498207885,1494,375,287,87,0,87,0,22,0,0,empty,mBC-0814-1
"F1,G7",5575,6031,3976,2055,3522,0,1921,1921,1366,555,2.461261261,1029,2634,1729,580,1,579,1,122,0,0.022452504,empty,mBC-0814-1
"F1,G8",1009906,1166927,679320,487607,688858,1,430727,431181,340854,90327,3.77355608,259891,852341,581475,159633,104,159529,4,5722,0,0.000269543,mm10,mBC-0814-1
"F1,G9",5446,5831,3872,1959,3480,1,1890,1891,1367,524,2.608778626,1002,3824,2554,869,1,868,1,152,0,0,empty,mBC-0814-1
"F1,G10",9161,9926,6442,3484,5840,0,3148,3149,2165,984,2.200203252,1745,4395,3117,927,0,927,0,199,0,0.015102481,empty,mBC-0814-1
"F1,G11",9667,10548,6932,3616,6066,0,3282,3290,2364,926,2.552915767,1726,1827,1431,416,0,416,0,91,0,0,empty,mBC-0814-1
"F1,G12",4759,5184,3307,1877,3032,0,1707,1709,1184,525,2.255238095,921,16303,5310,1565,6,1559,2,200,0,0.043617704,empty,mBC-0814-1
"F1,H1",4802,5239,3532,1707,3121,0,1666,1668,1197,471,2.541401274,903,973,722,212,1,211,1,52,0,0,empty,mBC-0814-1
"F1,H2",7838,8121,5610,2511,4838,0,2613,2616,1815,801,2.265917603,1316,3706,2520,806,0,806,0,167,0,0.018610422,empty,mBC-0814-1
"F1,H3",5619,5937,4033,1904,3480,0,1919,1922,1404,518,2.71042471,999,7569,3046,872,2,870,2,143,0,0.029885057,empty,mBC-0814-1
"F1,H4",5489,6027,4004,2023,3529,0,2002,2003,1458,545,2.675229358,1062,75,50,28,0,28,0,15,0,0,empty,mBC-0814-1
"F1,H5",7271,7758,5253,2505,4470,0,2462,2464,1754,710,2.470422535,1276,2184,1452,417,0,417,0,78,0,0.002398082,empty,mBC-0814-1
"F1,H6",6968,7365,5034,2331,4266,0,2306,2310,1606,704,2.28125,1158,3300,2498,710,0,710,0,140,0,0,empty,mBC-0814-1
"F1,H7",5511,5955,3997,1958,3521,0,1862,1862,1309,553,2.367088608,967,2425,1676,427,0,427,0,83,0,0,empty,mBC-0814-1
"F1,H8",4538,4820,3213,1607,2824,0,1549,1554,1094,460,2.37826087,822,46886,13565,4273,11,4262,4,387,0,0.077663069,empty,mBC-0814-1
"F1,H9",5186,5376,3720,1656,3154,1,1684,1685,1209,476,2.539915966,840,2267,1481,408,0,408,0,71,0,0.00245098,empty,mBC-0814-1
"F1,H10",3654,3873,2589,1284,2246,0,1174,1175,839,336,2.49702381,618,941,625,189,0,189,0,64,0,0.005291005,empty,mBC-0814-1
"F1,H11",3830,4135,2685,1450,2424,0,1370,1371,958,413,2.319612591,747,27,12,7,0,7,0,5,0,0,empty,mBC-0814-1
"F1,H12",238701,275267,154604,120663,166480,0,106013,106117,82668,23449,3.525438185,64678,102302,73109,20251,15,20236,2,1562,0,0.000988338,mm10,mBC-0814-1
"F2,A1",647451,746543,434371,312172,440073,1,273062,273404,208536,64868,3.214774619,161328,251090,179817,49493,44,49449,4,2865,0,0.000161783,mm10,mBC-0814-1
"F2,A2",445810,523658,283106,240552,310048,0,206929,207168,159872,47296,3.380243572,127247,247556,175200,49808,26,49782,4,2739,0,0.000763328,mm10,mBC-0814-1
"F2,A3",4751,5150,3319,1831,3047,0,1667,1670,1189,481,2.471933472,925,1262,955,255,2,253,1,54,0,0.007905138,empty,mBC-0814-1
"F2,A4",5583,5928,4016,1912,3432,0,1832,1837,1301,536,2.427238806,959,7528,2339,714,0,714,0,98,0,0.075630252,empty,mBC-0814-1
"F2,A5",4757,4959,3365,1594,2978,0,1610,1612,1156,456,2.535087719,841,2146,1557,456,0,456,0,82,0,0,empty,mBC-0814-1
"F2,A6",4045,4119,2936,1183,2394,0,1247,1247,874,373,2.343163539,607,1977,1273,373,0,373,0,67,0,0,empty,mBC-0814-1
"F2,A7",496558,551507,342240,209267,326276,0,192813,193055,157716,35339,4.462944622,110249,68512,49057,13380,7,13373,1,1225,0,0.002991101,mm10,mBC-0814-1
"F2,A8",322509,361554,217594,143960,216926,0,131776,131947,103281,28666,3.60290937,76769,118582,59159,16577,12,16565,2,1414,0,0.019921521,mm10,mBC-0814-1
"F2,A9",7167,7720,5044,2676,4506,2,2456,2461,1786,675,2.645925926,1335,2856,1971,553,0,553,0,96,0,0.014466546,empty,mBC-0814-1
"F2,A10",3754,3876,2711,1165,2342,0,1278,1283,953,330,2.887878788,644,458,322,120,0,120,0,23,0,0,empty,mBC-0814-1
"F2,A11",5325,5862,3814,2048,3532,5,1888,1893,1347,546,2.467032967,1022,4154,2954,802,1,801,1,131,0,0.018726592,empty,mBC-0814-1
"F2,A12",4446,4806,3109,1697,2858,0,1583,1584,1206,378,3.19047619,861,4669,3401,1092,1,1091,1,222,0,0,empty,mBC-0814-1
"F2,B1",629586,722444,424685,297759,420942,1,255934,256207,199493,56714,3.517526537,150910,340745,239425,67218,51,67167,6,3322,0,2.97765E-05,mm10,mBC-0814-1
"F2,B2",5179,5639,3662,1977,3351,0,1884,1885,1361,524,2.597328244,1029,1832,812,285,0,285,0,52,0,0,empty,mBC-0814-1
"F2,B3",4197,4545,2964,1581,2797,0,1566,1571,1086,485,2.239175258,877,2175,1469,422,0,422,0,82,0,0,empty,mBC-0814-1
"F2,B4",4483,4955,3222,1733,2922,0,1627,1632,1194,438,2.726027397,860,1612,1026,315,0,315,0,82,0,0.006349206,empty,mBC-0814-1
"F2,B5",3750,2454,1521,933,1753,0,1028,1031,715,316,2.262658228,595,1485,1018,303,0,303,0,73,0,0,empty,mBC-0814-1
"F2,B6",4270,4702,3074,1628,2772,0,1519,1521,1082,439,2.464692483,839,1714,1132,363,0,363,0,69,0,0,empty,mBC-0814-1
"F2,B7",5107,5366,3671,1695,3238,0,1701,1703,1216,487,2.496919918,867,1477,923,275,0,275,0,74,0,0.007272727,empty,mBC-0814-1
"F2,B8",3902,4225,2809,1416,2474,4,1340,1344,945,399,2.368421053,723,1620,1080,279,0,279,0,62,0,0,empty,mBC-0814-1
"F2,B9",4894,5214,3529,1685,3134,0,1715,1721,1230,491,2.50509165,887,1165,829,240,0,240,0,79,0,0,empty,mBC-0814-1
"F2,B10",4423,4711,3007,1704,2806,0,1543,1550,1095,455,2.406593407,868,1065,602,202,0,202,0,35,0,0,empty,mBC-0814-1
"F2,B11",6693,7266,4804,2462,4239,0,2317,2318,1601,717,2.232914923,1232,345,233,37,0,37,0,16,0,0,empty,mBC-0814-1
"F2,B12",668658,773523,438252,335271,454663,10,291330,291643,231864,59779,3.878686495,175017,110341,78535,21335,9,21326,1,1583,0,0.000140673,mm10,mBC-0814-1
"F2,C1",6134,6473,4461,2012,3708,0,1927,1931,1404,527,2.664136622,979,7959,3072,958,3,955,1,128,0,0.003141361,empty,mBC-0814-1
"F2,C2",5338,5700,3720,1980,3428,1,1898,1901,1397,504,2.771825397,983,34288,10058,3131,4,3127,2,336,0,0.016629357,empty,mBC-0814-1
"F2,C3",442336,508495,301675,206820,302308,1,185866,186078,145485,40593,3.583992314,109979,25541,15165,4263,3,4260,2,496,0,0.007746479,mm10,mBC-0814-1
"F2,C4",5295,5557,3769,1788,3337,0,1760,1764,1258,506,2.486166008,974,1716,1252,355,0,355,0,81,0,0.005633803,empty,mBC-0814-1
"F2,C5",7776,8417,5511,2906,4964,1,2680,2686,1869,817,2.287637699,1455,2555,1723,514,0,514,0,115,0,0,empty,mBC-0814-1
"F2,C6",5380,5899,3785,2114,3482,0,1890,1893,1351,542,2.492619926,1015,2628,1988,576,0,576,0,104,0,0,empty,mBC-0814-1
"F2,C7",7041,7571,5043,2528,4387,0,2344,2348,1659,689,2.407837446,1257,753,561,170,0,170,0,33,0,0,empty,mBC-0814-1
"F2,C8",5669,5916,4105,1811,3544,0,1900,1906,1375,531,2.589453861,961,14046,5545,1718,1,1717,1,211,0,0.058823529,empty,mBC-0814-1
"F2,C9",4725,5173,3308,1865,2924,0,1638,1641,1154,487,2.369609856,895,1196,785,280,0,280,0,77,0,0,empty,mBC-0814-1
"F2,C10",5389,5744,3908,1836,3308,0,1742,1742,1235,507,2.435897436,864,1507,1061,308,0,308,0,68,0,0,empty,mBC-0814-1
"F2,C11",7331,7866,5382,2484,4687,0,2489,2492,1862,630,2.955555556,1280,5156,3691,1018,0,1018,0,183,0,0.001964637,empty,mBC-0814-1
"F2,C12",8247,9046,5816,3230,5231,0,2857,2864,2047,817,2.505507956,1575,2551,1681,514,1,513,1,104,0,0.04288499,empty,mBC-0814-1
"F2,D1",4594,4934,3414,1520,2903,0,1560,1562,1146,416,2.754807692,798,880,533,182,0,182,0,42,0,0,empty,mBC-0814-1
"F2,D2",5131,5358,3779,1579,3178,0,1621,1621,1155,466,2.478540773,826,2631,1953,572,0,572,0,111,0,0.006993007,empty,mBC-0814-1
"F2,D3",521171,597311,343243,254068,354060,0,222619,222863,194734,28129,6.922890967,132989,114208,81677,22871,19,22852,2,1562,0,0.00271311,mm10,mBC-0814-1
"F2,D4",381010,448846,252298,196548,267239,0,167489,167682,142840,24842,5.749939618,101278,293141,209047,56967,27,56940,2,3067,0,0.001615736,mm10,mBC-0814-1
"F2,D5",4932,5499,3495,2004,3346,0,1912,1917,1409,508,2.773622047,1091,3414,2257,622,0,622,0,141,0,0.02733119,empty,mBC-0814-1
"F2,D6",5218,5549,3683,1866,3430,1,1887,1890,1375,515,2.669902913,1016,1637,1057,306,0,306,0,65,0,0,empty,mBC-0814-1
"F2,D7",5977,6472,4326,2146,3809,0,2074,2078,1475,603,2.446102819,1103,3399,2355,738,0,738,0,142,0,0.036585366,empty,mBC-0814-1
"F2,D8",4757,5158,3459,1699,3093,0,1689,1689,1223,466,2.624463519,912,1509,996,244,0,244,0,59,0,0,empty,mBC-0814-1
"F2,D9",442436,517333,282165,235168,309531,1,205758,205984,164195,41789,3.929144033,125157,333968,234573,64224,45,64179,9,3280,0,0.000888141,mm10,mBC-0814-1
"F2,D10",3842,4076,2753,1323,2397,13,1314,1327,992,335,2.96119403,679,1479,1018,304,0,304,0,61,0,0,empty,mBC-0814-1
"F2,D11",4082,4381,2916,1465,2637,0,1414,1416,1022,394,2.593908629,743,2860,2048,572,0,572,0,134,0,0,empty,mBC-0814-1
"F2,D12",6372,6696,4620,2076,3957,0,2127,2134,1515,619,2.447495961,1092,4497,3209,937,2,935,2,153,0,0.001069519,empty,mBC-0814-1
"F2,E1",5084,5431,3719,1712,3140,0,1675,1677,1199,478,2.508368201,840,2444,1775,431,0,431,0,89,0,0.048723898,empty,mBC-0814-1
"F2,E2",364955,422655,247480,175175,253140,1,158252,158403,118831,39572,3.002906095,94794,5093,3392,969,0,969,0,196,0,0.00619195,empty,mBC-0814-1
"F2,E3",3410,3739,2503,1236,2247,0,1203,1207,878,329,2.668693009,649,2016,1319,394,0,394,0,86,0,0,empty,mBC-0814-1
"F2,E4",3132,3351,2258,1093,2009,0,1103,1103,790,313,2.523961661,580,2139,1631,433,0,433,0,71,0,0.046189376,empty,mBC-0814-1
"F2,E5",3880,4284,2882,1402,2465,0,1329,1331,987,344,2.869186047,717,1171,854,268,0,268,0,55,0,0,empty,mBC-0814-1
"F2,E6",4641,4928,3384,1544,2846,0,1506,1509,1109,400,2.7725,781,1657,1122,344,0,344,0,78,0,0,empty,mBC-0814-1
"F2,E7",4693,4843,3436,1407,2829,0,1475,1480,1061,419,2.53221957,727,1516,983,259,0,259,0,67,0,0.065637066,empty,mBC-0814-1
"F2,E8",4833,5017,3448,1569,2972,1,1483,1486,1134,352,3.221590909,756,3616,1923,594,0,594,0,115,0,0.023569024,empty,mBC-0814-1
"F2,E9",3745,4104,2596,1508,2375,0,1333,1333,995,338,2.943786982,738,2889,2105,672,0,672,0,108,0,0.035714286,empty,mBC-0814-1
"F2,E10",4197,4577,2985,1592,2657,0,1474,1477,1053,424,2.483490566,810,2593,1936,612,0,612,0,121,0,0.032679739,empty,mBC-0814-1
"F2,E11",4333,4573,3053,1520,2866,0,1570,1573,1129,444,2.542792793,844,7361,3296,1030,0,1030,0,146,0,0.061165049,empty,mBC-0814-1
"F2,E12",5352,5669,3636,2033,3361,0,1929,1929,1436,493,2.912778905,1064,13998,4365,1417,3,1414,2,184,0,0.152050919,empty,mBC-0814-1
"F2,F1",4449,4740,3266,1474,2850,0,1486,1488,1087,401,2.710723192,791,1839,1296,373,0,373,0,74,0,0.021447721,empty,mBC-0814-1
"F2,F2",7029,7983,5006,2977,4569,0,2512,2515,1792,723,2.478561549,1405,3664,2395,776,1,775,1,148,0,0.021935484,empty,mBC-0814-1
"F2,F3",5060,5644,3597,2047,3241,0,1776,1776,1319,457,2.886214442,975,2543,1814,547,0,547,0,112,0,0,empty,mBC-0814-1
"F2,F4",578212,656578,389608,266970,388567,0,239777,240046,196544,43502,4.518045147,141451,60771,40119,10820,8,10812,1,1039,0,0.000369959,mm10,mBC-0814-1
"F2,F5",5241,5684,3628,2056,3293,0,1813,1817,1281,536,2.389925373,1009,1844,1340,411,0,411,0,81,0,0,empty,mBC-0814-1
"F2,F6",5218,5674,3639,2035,3336,0,1829,1833,1342,491,2.733197556,981,2114,1319,426,0,426,0,116,0,0.004694836,empty,mBC-0814-1
"F2,F7",4402,4766,3230,1536,2842,0,1541,1545,1138,407,2.796068796,783,915,565,222,0,222,0,61,0,0,empty,mBC-0814-1
"F2,F8",6667,7156,4725,2431,4362,0,2412,2418,1701,717,2.372384937,1310,183,119,38,0,38,0,18,0,0,empty,mBC-0814-1
"F2,F9",5681,5993,4087,1906,3479,0,1819,1822,1340,482,2.780082988,952,3184,2230,643,0,643,0,103,0,0,empty,mBC-0814-1
"F2,F10",6957,7387,5097,2290,4279,0,2255,2259,1559,700,2.227142857,1178,4972,2393,743,0,743,0,110,0,0.076716016,empty,mBC-0814-1
"F2,F11",4712,4927,3405,1522,2955,0,1559,1563,1072,491,2.183299389,786,1888,1256,442,0,442,0,85,0,0.063348416,empty,mBC-0814-1
"F2,F12",4922,5348,3559,1789,3110,0,1678,1679,1216,463,2.626349892,900,144,51,16,0,16,0,14,0,0,empty,mBC-0814-1
"F2,G1",7667,8121,5506,2615,4875,0,2607,2614,1901,713,2.666199158,1370,4400,3160,935,1,934,1,185,0,0,empty,mBC-0814-1
"F2,G2",351944,409007,233888,175119,247585,0,158918,159064,123235,35829,3.439532223,95781,11347,7485,2185,0,2185,0,284,0,0,mm10,mBC-0814-1
"F2,G3",5384,5665,3848,1817,3386,0,1855,1856,1299,557,2.332136445,953,2864,2037,591,1,590,1,120,0,0.003389831,empty,mBC-0814-1
"F2,G4",5026,5441,3595,1846,3188,0,1700,1703,1188,515,2.306796117,934,23,19,13,0,13,0,5,0,0,empty,mBC-0814-1
"F2,G5",4690,5134,3376,1758,2983,0,1638,1640,1166,474,2.459915612,875,1013,696,232,0,232,0,67,0,0,empty,mBC-0814-1
"F2,G6",8993,9487,6640,2847,5562,4,2898,2905,2104,801,2.626716604,1420,282,231,68,0,68,0,15,0,0,empty,mBC-0814-1
"F2,G7",419063,487729,276535,211194,293767,0,188161,188329,145680,42649,3.41578935,113733,236892,170715,47119,31,47088,2,2560,0,0.001529052,mm10,mBC-0814-1
"F2,G8",7464,8009,5346,2663,4773,0,2585,2586,1843,743,2.480484522,1374,5407,3831,1080,0,1080,0,187,0,0.023148148,empty,mBC-0814-1
"F2,G9",5718,6407,3987,2420,3726,0,2088,2095,1541,554,2.781588448,1175,3404,2283,710,0,710,0,151,0,0.008450704,empty,mBC-0814-1
"F2,G10",9553,10263,6800,3463,6075,0,3280,3286,2373,913,2.599123768,1714,4444,3239,988,0,988,0,185,0,0,empty,mBC-0814-1
"F2,G11",9654,10185,6919,3266,6100,0,3252,3256,2371,885,2.679096045,1699,2071,1427,405,5,400,1,89,0,0,empty,mBC-0814-1
"F2,G12",5057,5442,3505,1937,3199,0,1809,1812,1290,522,2.471264368,991,3063,2131,666,0,666,0,114,0,0,empty,mBC-0814-1
"F2,H1",4939,5359,3580,1779,3142,0,1705,1706,1210,496,2.439516129,885,1340,975,280,0,280,0,64,0,0,empty,mBC-0814-1
"F2,H2",8203,8778,5894,2884,5244,0,2860,2863,1989,874,2.275743707,1526,3990,2870,839,0,839,0,176,0,0.00476758,empty,mBC-0814-1
"F2,H3",5760,6332,4224,2108,3651,0,1951,1956,1431,525,2.725714286,1046,1853,1144,342,0,342,0,89,0,0,empty,mBC-0814-1
"F2,H4",6293,6768,4365,2403,4205,0,2369,2371,1648,723,2.279391425,1322,105,80,27,0,27,0,13,0,0,empty,mBC-0814-1
"F2,H5",6637,7049,4797,2252,4074,0,2128,2132,1479,653,2.264931087,1133,2772,1818,563,0,563,0,100,0,0.026642984,empty,mBC-0814-1
"F2,H6",6343,6895,4544,2351,3999,0,2203,2203,1537,666,2.307807808,1196,3367,2252,676,0,676,0,137,0,0,empty,mBC-0814-1
"F2,H7",5664,5849,4092,1757,3520,0,1856,1858,1297,561,2.311942959,942,2002,1458,442,1,441,1,84,0,0,empty,mBC-0814-1
"F2,H8",462338,540669,308745,231924,319200,0,200171,200414,154362,46052,3.35190654,120783,241872,177319,50583,25,50558,1,2623,0,0,mm10,mBC-0814-1
"F2,H9",5165,5585,3610,1975,3338,0,1868,1872,1339,533,2.512195122,1021,2040,1511,461,0,461,0,77,0,0.019522777,empty,mBC-0814-1
"F2,H10",3679,3834,2764,1070,2189,0,1127,1131,822,309,2.660194175,554,1263,731,235,0,235,0,66,0,0,empty,mBC-0814-1
"F2,H11",4060,4527,2826,1701,2668,0,1537,1539,1104,435,2.537931034,885,207,139,32,0,32,0,11,0,0,empty,mBC-0814-1
"F2,H12",3033,3323,2166,1157,2020,0,1127,1129,817,312,2.618589744,616,2225,1642,434,0,434,0,90,0,0,empty,mBC-0814-1
"F3,A1",5469,5963,3929,2034,3558,0,1937,1937,1388,549,2.528233151,1059,2848,1651,482,0,482,0,87,0,0,empty,mBC-0814-1
"F3,A2",5338,5649,3885,1764,3353,0,1769,1773,1287,486,2.648148148,880,1417,984,354,0,354,0,119,0,0,empty,mBC-0814-1
"F3,A3",561797,641077,379342,261735,377928,0,231653,231922,169826,62096,2.734894357,136538,92195,65816,18168,9,18159,3,1548,0,0.000110138,mm10,mBC-0814-1
"F3,A4",5366,5686,3866,1820,3281,0,1732,1732,1256,476,2.638655462,896,504,304,114,0,114,0,26,0,0,empty,mBC-0814-1
"F3,A5",4793,5210,3385,1825,3082,0,1668,1671,1196,475,2.517894737,896,2062,1359,406,2,404,2,81,0,0.004950495,empty,mBC-0814-1
"F3,A6",9978,11656,6941,4715,7072,0,4215,4222,3423,799,4.284105131,2467,1906,1257,395,0,395,0,79,0,0.037974684,empty,mBC-0814-1
"F3,A7",5382,5799,3906,1893,3463,0,1900,1900,1351,549,2.460837887,1018,1969,1317,401,0,401,0,100,0,0,empty,mBC-0814-1
"F3,A8",2188,2447,1490,957,1507,0,853,855,567,288,1.96875,515,2013,1439,403,0,403,0,86,0,0,empty,mBC-0814-1
"F3,A9",6386,6916,4598,2318,4094,0,2202,2208,1520,688,2.209302326,1181,2183,1511,431,0,431,0,81,0,0,empty,mBC-0814-1
"F3,A10",3385,3888,2376,1512,2288,0,1317,1318,941,377,2.49602122,760,201,115,40,0,40,0,16,0,0,empty,mBC-0814-1
"F3,A11",4642,5085,3269,1816,3072,0,1728,1734,1240,494,2.510121457,959,2219,1657,458,0,458,0,119,0,0,empty,mBC-0814-1
"F3,A12",4003,4320,2829,1491,2674,0,1476,1478,1079,399,2.704260652,805,4155,3065,972,0,972,0,238,0,0,empty,mBC-0814-1
"F3,B1",5065,5555,3642,1913,3280,1,1806,1810,1291,519,2.487475915,971,10139,3527,1124,1,1123,1,175,0,0.075690116,empty,mBC-0814-1
"F3,B2",5350,5618,3785,1833,3340,0,1784,1786,1282,504,2.543650794,917,5083,1246,362,0,362,0,56,0,0,empty,mBC-0814-1
"F3,B3",3872,4203,2678,1525,2517,0,1412,1412,987,425,2.322352941,742,1806,1084,336,0,336,0,73,0,0.035714286,empty,mBC-0814-1
"F3,B4",4510,4876,3140,1736,2944,0,1688,1690,1151,539,2.135435993,925,7626,2518,793,8,785,2,129,0,0.07133758,empty,mBC-0814-1
"F3,B5",4304,3108,2037,1071,2092,0,1123,1128,842,286,2.944055944,609,1154,813,252,0,252,0,61,0,0,empty,mBC-0814-1
"F3,B6",426094,493196,280738,212458,293765,0,186043,186233,151244,34989,4.322615679,112098,145004,103915,29667,15,29652,3,1986,0,0.000640766,mm10,mBC-0814-1
"F3,B7",4876,5369,3548,1821,3181,1,1699,1700,1216,484,2.512396694,918,1053,719,273,0,273,0,65,0,0.025641026,empty,mBC-0814-1
"F3,B8",3868,4036,2765,1271,2414,0,1257,1257,906,351,2.581196581,643,1165,828,313,0,313,0,65,0,0,empty,mBC-0814-1
"F3,B9",4654,5100,3326,1774,2986,0,1619,1619,1174,445,2.638202247,893,810,558,212,0,212,0,71,0,0,empty,mBC-0814-1
"F3,B10",4100,4457,2839,1618,2722,0,1503,1506,1075,431,2.494199536,841,660,506,156,0,156,0,28,0,0,empty,mBC-0814-1
"F3,B11",728759,803327,502058,301269,463046,0,271142,271472,211540,59932,3.529666956,154332,12192,8512,2474,2,2472,2,316,0,0,mm10,mBC-0814-1
"F3,B12",5350,5793,3833,1960,3481,0,1911,1914,1385,529,2.618147448,1052,1503,1067,346,1,345,1,84,0,0,empty,mBC-0814-1
"F3,C1",495072,572501,333777,238724,337511,1,209603,209818,163173,46645,3.498188445,123914,74633,52653,14447,8,14439,1,1292,0,6.92569E-05,mm10,mBC-0814-1
"F3,C2",5628,6093,3970,2123,3558,0,1923,1929,1362,567,2.402116402,1045,24674,7284,2263,7,2256,3,276,0,0.147163121,empty,mBC-0814-1
"F3,C3",9966,11049,7066,3983,6558,0,3780,3785,2889,896,3.224330357,2071,704,493,166,0,166,0,43,0,0,empty,mBC-0814-1
"F3,C4",5000,5209,3583,1626,3067,0,1600,1600,1179,421,2.800475059,781,1481,1021,356,0,356,0,95,0,0,empty,mBC-0814-1
"F3,C5",7228,7802,5092,2710,4554,0,2441,2448,1789,659,2.714719272,1320,1985,1370,416,0,416,0,108,0,0,empty,mBC-0814-1
"F3,C6",5151,5412,3615,1797,3324,0,1819,1824,1347,477,2.823899371,956,1630,1169,340,0,340,0,82,0,0,empty,mBC-0814-1
"F3,C7",7114,7427,5148,2279,4254,0,2317,2326,1728,598,2.889632107,1127,492,357,89,0,89,0,21,0,0,empty,mBC-0814-1
"F3,C8",5409,5757,3943,1814,3359,0,1771,1771,1249,522,2.392720307,886,2766,1885,574,0,574,0,98,0,0,empty,mBC-0814-1
"F3,C9",4574,5028,3214,1814,2895,0,1655,1655,1167,488,2.391393443,918,1431,1033,304,1,303,1,72,0,0,empty,mBC-0814-1
"F3,C10",5557,5980,4036,1944,3449,3,1829,1835,1304,531,2.455743879,971,1345,885,252,0,252,0,55,0,0,empty,mBC-0814-1
"F3,C11",4444,4837,3176,1661,2868,0,1601,1603,1155,448,2.578125,843,1704,1218,351,0,351,0,63,0,0,empty,mBC-0814-1
"F3,C12",7993,8690,5593,3097,5028,0,2811,2813,1976,837,2.360812425,1561,2774,2039,587,0,587,0,92,0,0,empty,mBC-0814-1
"F3,D1",4431,4736,3160,1576,2819,4,1529,1535,1065,470,2.265957447,816,554,396,104,0,104,0,28,0,0.105769231,empty,mBC-0814-1
"F3,D2",5088,5393,3710,1683,3129,0,1596,1596,1179,417,2.827338129,836,1777,1233,419,0,419,0,98,0,0.016706444,empty,mBC-0814-1
"F3,D3",10706,11479,7564,3915,6772,0,3709,3716,2643,1073,2.463187325,2026,2378,1661,521,1,520,1,127,0,0.017307692,empty,mBC-0814-1
"F3,D4",4690,5100,3301,1799,3054,1,1720,1723,1252,471,2.658174098,943,1614,1183,369,0,369,0,93,0,0.002710027,empty,mBC-0814-1
"F3,D5",4325,4641,3044,1597,2809,0,1587,1592,1176,416,2.826923077,873,2250,1463,460,0,460,0,118,0,0,empty,mBC-0814-1
"F3,D6",4937,5414,3581,1833,3140,0,1692,1693,1213,480,2.527083333,905,1142,727,270,0,270,0,63,0,0.007407407,empty,mBC-0814-1
"F3,D7",5784,6336,4052,2284,3728,0,2096,2096,1537,559,2.749552773,1173,15962,5998,1892,1,1891,1,233,0,0.066102591,empty,mBC-0814-1
"F3,D8",4812,5528,3468,2060,3078,0,1735,1742,1238,504,2.456349206,938,1267,927,275,0,275,0,59,0,0.010909091,empty,mBC-0814-1
"F3,D9",2977,3181,2164,1017,1863,0,998,1007,708,299,2.367892977,502,1395,1023,234,0,234,0,55,0,0,empty,mBC-0814-1
"F3,D10",3565,3950,2637,1313,2304,1,1231,1234,875,359,2.437325905,634,1025,633,191,0,191,0,41,0,0,empty,mBC-0814-1
"F3,D11",4068,4530,2835,1695,2653,0,1490,1490,1062,428,2.481308411,844,2092,1469,477,0,477,0,118,0,0,empty,mBC-0814-1
"F3,D12",6314,6631,4526,2105,3937,0,2160,2167,1547,620,2.49516129,1118,3372,2516,746,2,744,1,150,0,0.024193548,empty,mBC-0814-1
"F3,E1",5175,5639,3643,1996,3320,0,1818,1821,1267,554,2.28700361,970,2164,1506,488,0,488,0,79,0,0.028688525,empty,mBC-0814-1
"F3,E2",3794,4121,2672,1449,2436,0,1364,1367,1016,351,2.894586895,739,1634,1147,354,0,354,0,81,0,0,empty,mBC-0814-1
"F3,E3",3416,3727,2516,1211,2142,0,1149,1152,813,339,2.398230088,596,1267,908,309,0,309,0,67,0,0,empty,mBC-0814-1
"F3,E4",3156,3376,2307,1069,1957,0,1053,1053,761,292,2.606164384,540,1514,1080,337,1,336,1,77,0,0,empty,mBC-0814-1
"F3,E5",745250,848489,507387,341102,493562,2,299486,299873,242601,57272,4.235944266,173509,298587,214031,59878,29,59849,4,3039,0,0.000267339,mm10,mBC-0814-1
"F3,E6",4568,4764,3335,1429,2755,1,1468,1471,1066,405,2.632098765,714,1795,1211,369,0,369,0,71,0,0.051490515,empty,mBC-0814-1
"F3,E7",513933,599959,346029,253930,352485,1,218446,218727,185301,33426,5.54361874,130356,288023,209778,57959,36,57923,7,2970,0,0.000690572,mm10,mBC-0814-1
"F3,E8",4532,5002,3281,1721,2897,0,1550,1550,1135,415,2.734939759,838,2334,1543,490,1,489,1,116,0,0,empty,mBC-0814-1
"F3,E9",5155,5807,3299,2508,3361,0,2063,2064,1322,742,1.781671159,1236,19208,6586,2164,1,2163,1,227,0,0.02172908,empty,mBC-0814-1
"F3,E10",357310,405224,245585,159639,243103,0,147650,147804,107711,40093,2.68652882,86311,18709,13408,3772,0,3772,0,494,0,0.004772004,mm10,mBC-0814-1
"F3,E11",4073,4361,2920,1441,2559,0,1387,1390,976,414,2.357487923,730,2294,1548,448,0,448,0,92,0,0,empty,mBC-0814-1
"F3,E12",3901,4414,2809,1605,2568,0,1419,1425,1036,389,2.663239075,796,756,471,176,0,176,0,64,0,0.005681818,empty,mBC-0814-1
"F3,F1",4472,4884,3215,1669,2861,0,1523,1531,1123,408,2.75245098,839,1539,1067,324,0,324,0,66,0,0.030864198,empty,mBC-0814-1
"F3,F2",1737139,2036502,1148975,887527,1174703,1,766727,767597,627975,139622,4.497679449,463519,714153,464697,134313,126,134187,11,4812,0,0.002951106,mm10,mBC-0814-1
"F3,F3",5247,5685,3779,1906,3421,0,1869,1869,1350,519,2.601156069,1020,2198,1585,442,1,441,1,105,0,0,empty,mBC-0814-1
"F3,F4",5958,6398,4199,2199,3682,0,1954,1961,1428,533,2.679174484,1084,21943,6511,2037,3,2034,2,243,0,0.029498525,empty,mBC-0814-1
"F3,F5",546551,640746,364814,275932,377092,0,236350,236614,189719,46895,4.045612539,142707,255805,184800,51240,30,51210,1,2608,0,0.000156219,mm10,mBC-0814-1
"F3,F6",553498,629876,360327,269549,367584,0,234233,234497,187266,47231,3.964895937,139129,201055,145909,41338,22,41316,5,2405,0,0.00019363,mm10,mBC-0814-1
"F3,F7",525401,614861,352948,261913,367708,1,232014,232301,180454,51847,3.480509962,139220,60533,42408,11845,6,11839,1,1074,0,0,mm10,mBC-0814-1
"F3,F8",660965,752796,444670,308126,441655,9,270580,270910,232470,38440,6.04760666,158745,26484,18201,5065,2,5063,1,569,0,0.000987557,mm10,mBC-0814-1
"F3,F9",5409,6019,3919,2100,3470,0,1902,1906,1402,504,2.781746032,1028,2591,1701,542,0,542,0,114,0,0.033210332,empty,mBC-0814-1
"F3,F10",6247,6526,4646,1880,3829,0,1941,1941,1374,567,2.423280423,916,3970,2315,717,0,717,0,109,0,0.046025105,empty,mBC-0814-1
"F3,F11",4564,4821,3125,1696,2869,0,1543,1551,1139,412,2.764563107,865,80461,23683,7596,15,7581,3,596,0,0.12979818,empty,mBC-0814-1
"F3,F12",5029,5408,3578,1830,3213,0,1793,1798,1252,546,2.293040293,960,246,201,53,0,53,0,13,0,0,empty,mBC-0814-1
"F3,G1",6954,7203,5015,2188,4337,0,2250,2250,1591,659,2.414264036,1136,3103,1978,669,1,668,1,168,0,0,empty,mBC-0814-1
"F3,G2",5644,5932,4067,1865,3517,0,1824,1831,1269,562,2.258007117,974,518,336,92,0,92,0,21,0,0,empty,mBC-0814-1
"F3,G3",6416,7042,4537,2505,4069,0,2318,2322,1649,673,2.450222883,1251,8324,3881,1148,2,1146,1,170,0,0.045375218,empty,mBC-0814-1
"F3,G4",5127,5572,3616,1956,3235,0,1767,1771,1300,471,2.760084926,967,4,4,4,0,4,0,2,0,0,empty,mBC-0814-1
"F3,G5",4724,5193,3456,1737,3023,5,1598,1605,1137,468,2.429487179,872,1968,1255,385,0,385,0,87,0,0,empty,mBC-0814-1
"F3,G6",8507,9213,6137,3076,5561,0,2994,3000,2116,884,2.393665158,1585,110,81,25,0,25,0,14,0,0,empty,mBC-0814-1
"F3,G7",5521,5976,3938,2038,3542,0,1941,1948,1387,561,2.472370766,1067,2423,1877,562,0,562,0,112,0,0.028469751,empty,mBC-0814-1
"F3,G8",803285,970803,504515,466288,574071,0,402518,402904,219374,183530,1.19530322,254478,44429,27801,7344,5,7339,3,962,0,0.006676659,mm10,mBC-0814-1
"F3,G9",5376,5771,3842,1929,3505,0,1899,1904,1375,529,2.599243856,1025,2807,1703,577,2,575,1,157,0,0.043478261,empty,mBC-0814-1
"F3,G10",55298,63972,36978,26994,37451,0,23118,23150,19040,4110,4.632603406,13625,20852,14723,4268,3,4265,1,479,0,0.007268464,empty,mBC-0814-1
"F3,G11",535420,622189,354212,267977,366607,0,229977,230282,186936,43346,4.312647072,138151,85390,61367,16670,8,16662,1,1381,0,0.000600168,mm10,mBC-0814-1
"F3,G12",573041,678193,366090,312103,402844,1,267216,267487,201968,65519,3.082586731,164849,189586,134831,37925,25,37900,6,2307,0,0.00237467,mm10,mBC-0814-1
"F3,H1",4565,5045,3144,1901,2904,0,1632,1632,1095,537,2.039106145,909,929,699,258,0,258,0,63,0,0.027131783,empty,mBC-0814-1
"F3,H2",426019,486751,289576,197175,289213,2,175493,175716,141203,34513,4.091298931,103312,166939,115032,32806,19,32787,1,2156,0,0.000396499,mm10,mBC-0814-1
"F3,H3",5380,5717,3827,1890,3366,0,1807,1808,1263,545,2.317431193,944,1852,1313,399,0,399,0,90,0,0.002506266,empty,mBC-0814-1
"F3,H4",5352,5776,3789,1987,3518,0,1932,1936,1355,581,2.332185886,1066,84,56,33,0,33,0,17,0,0.03030303,empty,mBC-0814-1
"F3,H5",6497,7035,4676,2359,4033,0,2211,2215,1528,687,2.224163028,1165,12930,4322,1271,1,1270,1,141,0,0.037007874,empty,mBC-0814-1
"F3,H6",410065,474761,269600,205161,282850,0,180499,180700,143163,37537,3.813916935,110430,52992,34205,9233,8,9225,1,1113,0,0.001842818,mm10,mBC-0814-1
"F3,H7",5323,5699,3878,1821,3417,0,1874,1881,1356,525,2.582857143,983,982,636,193,0,193,0,54,0,0,empty,mBC-0814-1
"F3,H8",4646,5139,3282,1857,3015,0,1683,1683,1175,508,2.312992126,928,30053,9312,2856,5,2851,3,300,0,0.100666433,empty,mBC-0814-1
"F3,H9",4945,5350,3481,1869,3229,0,1803,1803,1276,527,2.421252372,1008,1809,1170,355,1,354,1,71,0,0,empty,mBC-0814-1
"F3,H10",3522,3836,2449,1387,2242,0,1212,1213,877,336,2.610119048,689,1267,835,251,1,250,1,59,0,0.004,empty,mBC-0814-1
"F3,H11",3966,4302,2776,1526,2621,0,1490,1490,1055,435,2.425287356,820,131,70,35,1,34,1,7,0,0,empty,mBC-0814-1
"F3,H12",2669,2857,1898,959,1726,0,929,929,683,246,2.776422764,478,1628,1214,313,0,313,0,65,0,0,empty,mBC-0814-1
"F4,A1",5927,6401,4189,2212,3750,0,2022,2022,1363,659,2.068285281,1118,1130,782,232,0,232,0,51,0,0,empty,mBC-0814-1
"F4,A2",5330,5597,3841,1756,3305,0,1710,1715,1202,513,2.343079922,889,1752,1247,397,0,397,0,80,0,0.070528967,empty,mBC-0814-1
"F4,A3",5202,5590,3734,1856,3306,0,1787,1792,1255,537,2.337057728,948,1132,824,275,0,275,0,53,0,0.036363636,empty,mBC-0814-1
"F4,A4",6035,6595,4413,2182,3765,8,1976,1986,1445,541,2.670979667,1039,524,271,64,0,64,0,19,0,0,empty,mBC-0814-1
"F4,A5",5210,5550,3655,1895,3253,1,1797,1805,1275,530,2.405660377,955,1216,783,207,0,207,0,45,0,0.009661836,empty,mBC-0814-1
"F4,A6",4102,4371,2964,1407,2548,7,1355,1367,925,442,2.092760181,690,1631,1102,349,0,349,0,54,0,0,empty,mBC-0814-1
"F4,A7",541616,640904,357702,283202,376733,0,239371,239633,196244,43389,4.522897509,145517,163634,116168,32898,15,32883,3,2133,0,0.000608217,mm10,mBC-0814-1
"F4,A8",2279,2451,1597,854,1470,0,843,843,606,237,2.556962025,433,1247,847,233,0,233,0,41,0,0,empty,mBC-0814-1
"F4,A9",764299,830798,514879,315919,480785,2,288690,289065,224146,64919,3.452702599,165580,45720,33339,9740,2,9738,1,899,0,0,mm10,mBC-0814-1
"F4,A10",3848,4035,2706,1329,2296,0,1226,1227,872,355,2.456338028,620,206,123,20,0,20,0,6,0,0,empty,mBC-0814-1
"F4,A11",6732,7228,4649,2579,4334,0,2364,2366,1737,629,2.761526232,1309,1855,1184,415,0,415,0,73,0,0,empty,mBC-0814-1
"F4,A12",4186,4344,2976,1368,2568,0,1375,1376,1008,368,2.739130435,736,2613,1953,583,1,582,1,117,0,0,empty,mBC-0814-1
"F4,B1",5094,5626,3631,1995,3284,1,1784,1785,1284,501,2.562874251,975,1124,726,246,0,246,0,47,0,0.048780488,empty,mBC-0814-1
"F4,B2",5456,5758,3777,1981,3426,0,1873,1877,1384,493,2.807302231,1007,405,299,99,0,99,0,15,0,0,empty,mBC-0814-1
"F4,B3",5117,5631,3567,2064,3394,0,1892,1893,1398,495,2.824242424,1047,832,578,188,0,188,0,40,0,0,empty,mBC-0814-1
"F4,B4",4324,4657,3095,1562,2791,0,1531,1535,1056,479,2.204592902,833,1321,860,189,0,189,0,37,0,0,empty,mBC-0814-1
"F4,B5",3990,2576,1657,919,1816,0,974,982,690,292,2.363013699,549,624,361,109,0,109,0,30,0,0.146788991,empty,mBC-0814-1
"F4,B6",4207,4538,2953,1585,2569,0,1420,1423,1010,413,2.445520581,770,1084,678,231,0,231,0,49,0,0.004329004,empty,mBC-0814-1
"F4,B7",600157,702252,403978,298274,413570,0,260581,260873,193603,67270,2.877999108,155864,103952,76991,22201,17,22184,2,1579,0,0.000856473,mm10,mBC-0814-1
"F4,B8",3854,4203,2814,1389,2447,0,1325,1333,942,391,2.409207161,697,841,661,217,0,217,0,34,0,0,empty,mBC-0814-1
"F4,B9",4762,5159,3311,1848,3069,0,1698,1701,1258,443,2.83972912,953,626,390,130,4,126,1,39,0,0,empty,mBC-0814-1
"F4,B10",4610,4876,3240,1636,2864,0,1544,1548,1067,481,2.218295218,828,444,301,81,0,81,0,25,0,0,empty,mBC-0814-1
"F4,B11",6464,7084,4696,2388,4152,0,2238,2241,1580,661,2.3903177,1215,29,16,13,0,13,0,8,0,0,empty,mBC-0814-1
"F4,B12",5646,5912,4093,1819,3497,0,1880,1882,1338,544,2.459558824,953,1150,799,210,0,210,0,44,0,0,empty,mBC-0814-1
"F4,C1",16946,18885,11825,7060,10730,1,6240,6251,4226,2025,2.08691358,3467,2117,1554,381,0,381,0,66,0,0,empty,mBC-0814-1
"F4,C2",5925,6295,4208,2087,3558,0,1908,1908,1393,515,2.704854369,1011,1014,739,238,0,238,0,61,0,0,empty,mBC-0814-1
"F4,C3",6488,7347,4703,2644,4088,0,2237,2242,1615,627,2.575757576,1209,484,288,82,0,82,0,24,0,0.134146341,empty,mBC-0814-1
"F4,C4",5489,5693,3891,1802,3389,0,1770,1774,1277,497,2.569416499,937,2848,1330,373,0,373,0,75,0,0,empty,mBC-0814-1
"F4,C5",8434,9081,6004,3077,5342,0,2944,2950,2176,774,2.811369509,1599,1252,771,236,0,236,0,70,0,0,empty,mBC-0814-1
"F4,C6",6100,6566,4246,2320,3980,0,2219,2227,1580,647,2.442040185,1261,1452,1035,339,0,339,0,55,0,0,empty,mBC-0814-1
"F4,C7",7456,8165,5308,2857,4661,0,2528,2531,1879,652,2.88190184,1362,429,280,85,0,85,0,11,0,0,empty,mBC-0814-1
"F4,C8",5874,6216,4320,1896,3614,1,1930,1935,1373,562,2.443060498,1000,1186,852,232,0,232,0,55,0,0,empty,mBC-0814-1
"F4,C9",4721,5064,3415,1649,2902,0,1545,1552,1065,487,2.186858316,807,1126,721,177,0,177,0,47,0,0,empty,mBC-0814-1
"F4,C10",5768,6304,4235,2069,3592,0,1899,1901,1417,484,2.92768595,1015,978,615,185,0,185,0,41,0,0.054054054,empty,mBC-0814-1
"F4,C11",5041,5589,3551,2038,3194,0,1761,1762,1245,517,2.408123791,963,1493,1056,346,0,346,0,56,0,0,empty,mBC-0814-1
"F4,C12",8950,9481,6324,3157,5511,0,2992,2995,2150,845,2.544378698,1592,6573,2428,636,4,632,2,98,0,0.015822785,empty,mBC-0814-1
"F4,D1",4771,5207,3406,1801,3011,0,1596,1597,1129,468,2.412393162,867,308,160,48,0,48,0,13,0,0,empty,mBC-0814-1
"F4,D2",5495,5586,4075,1511,3281,0,1647,1651,1221,430,2.839534884,802,1572,1097,359,0,359,0,71,0,0.025069638,empty,mBC-0814-1
"F4,D3",650319,761769,432292,329477,446025,2,281074,281354,238178,43176,5.516444321,170075,81679,54206,15525,9,15516,2,1226,0,0.00328693,mm10,mBC-0814-1
"F4,D4",4899,5273,3523,1750,3055,0,1670,1670,1177,493,2.387423935,887,987,755,200,0,200,0,55,0,0,empty,mBC-0814-1
"F4,D5",4698,5012,3307,1705,2978,0,1604,1613,1135,478,2.374476987,869,7011,2557,791,2,789,2,119,0,0.001267427,empty,mBC-0814-1
"F4,D6",5654,6206,4089,2117,3499,0,1902,1902,1370,532,2.57518797,1003,1356,895,244,0,244,0,49,0,0,empty,mBC-0814-1
"F4,D7",6003,6203,4223,1980,3590,0,1876,1877,1353,524,2.582061069,965,2844,2157,562,0,562,0,86,0,0.040925267,empty,mBC-0814-1
"F4,D8",643596,746130,432822,313308,435041,0,271342,271643,221609,50034,4.429168166,161494,135390,88652,24794,15,24779,3,1706,0,0.002179265,mm10,mBC-0814-1
"F4,D9",3338,3687,2415,1272,2162,0,1155,1155,836,319,2.620689655,652,1340,965,259,1,258,1,49,0,0,empty,mBC-0814-1
"F4,D10",7151,7657,4899,2758,4571,0,2682,2684,1913,771,2.481193256,1494,953,731,234,1,233,1,51,0,0,empty,mBC-0814-1
"F4,D11",4503,4767,3167,1600,2851,0,1555,1557,1086,471,2.305732484,835,1745,1154,348,0,348,0,87,0,0,empty,mBC-0814-1
"F4,D12",6532,7099,4592,2507,4115,0,2267,2270,1633,637,2.563579278,1249,2474,1745,527,0,527,0,76,0,0,empty,mBC-0814-1
"F4,E1",5471,5741,3974,1767,3329,0,1722,1723,1238,485,2.55257732,901,1480,1175,313,1,312,1,48,0,0,empty,mBC-0814-1
"F4,E2",3779,3953,2770,1183,2389,0,1313,1318,925,393,2.353689567,666,1487,1079,336,0,336,0,50,0,0,empty,mBC-0814-1
"F4,E3",4264,4528,3188,1340,2518,0,1321,1324,953,371,2.568733154,634,1164,760,244,0,244,0,52,0,0,empty,mBC-0814-1
"F4,E4",3504,3770,2585,1185,2234,0,1186,1187,846,341,2.480938416,622,956,685,171,0,171,0,52,0,0,empty,mBC-0814-1
"F4,E5",3922,4053,2883,1170,2352,0,1195,1195,873,322,2.711180124,564,948,645,176,0,176,0,32,0,0,empty,mBC-0814-1
"F4,E6",4995,5182,3637,1545,3083,0,1585,1587,1116,471,2.369426752,832,1178,828,234,0,234,0,49,0,0,empty,mBC-0814-1
"F4,E7",5006,5206,3585,1621,2946,0,1538,1542,1089,453,2.40397351,771,20432,6767,2105,3,2102,1,210,0,0.038534729,empty,mBC-0814-1
"F4,E8",4910,5219,3547,1672,3027,0,1575,1578,1147,431,2.6612529,846,1606,1122,330,0,330,0,67,0,0,empty,mBC-0814-1
"F4,E9",3386,3579,2384,1195,2129,0,1144,1147,822,325,2.529230769,619,1322,898,281,0,281,0,59,0,0,empty,mBC-0814-1
"F4,E10",433129,510002,286579,223423,301787,2,191714,191973,153358,38615,3.971461867,116547,112440,82124,22818,15,22803,1,1662,0,0.000263123,mm10,mBC-0814-1
"F4,E11",4482,4996,3275,1721,2896,6,1613,1619,1137,482,2.358921162,845,1091,783,246,0,246,0,57,0,0,empty,mBC-0814-1
"F4,E12",4126,4523,2953,1570,2663,0,1426,1426,1013,413,2.452784504,753,945,655,185,0,185,0,35,0,0,empty,mBC-0814-1
"F4,F1",5178,5511,3702,1809,3181,5,1724,1731,1287,444,2.898648649,919,1581,1193,294,0,294,0,59,0,0.003401361,empty,mBC-0814-1
"F4,F2",6808,7381,4773,2608,4274,0,2306,2313,1623,690,2.352173913,1263,4107,1835,621,0,621,0,121,0,0.088566828,empty,mBC-0814-1
"F4,F3",729734,869145,481773,387372,502173,0,316110,316456,273549,42907,6.375393292,195506,57808,29217,8193,5,8188,1,1339,0,0.00097704,mm10,mBC-0814-1
"F4,F4",5967,6139,4185,1954,3578,0,1868,1874,1348,526,2.562737643,962,187,140,60,0,60,0,19,0,0,empty,mBC-0814-1
"F4,F5",5727,5893,4036,1857,3387,0,1794,1795,1260,535,2.355140187,925,763,542,188,0,188,0,36,0,0,empty,mBC-0814-1
"F4,F6",5327,5723,3769,1954,3292,0,1764,1769,1223,546,2.23992674,950,1012,535,190,0,190,0,63,0,0.010526316,empty,mBC-0814-1
"F4,F7",5013,5383,3647,1736,3187,0,1671,1674,1180,494,2.388663968,851,660,509,177,0,177,0,36,0,0,empty,mBC-0814-1
"F4,F8",6356,6781,4602,2179,3953,0,2102,2102,1493,609,2.451559934,1085,219,160,46,0,46,0,9,0,0.260869565,empty,mBC-0814-1
"F4,F9",6209,6806,4409,2397,4005,0,2155,2160,1561,599,2.606010017,1199,9427,3389,952,0,952,0,114,0,0.025210084,empty,mBC-0814-1
"F4,F10",7300,7603,5191,2412,4398,0,2285,2295,1647,648,2.541666667,1217,22017,6690,2108,8,2100,2,207,0,0.03,empty,mBC-0814-1
"F4,F11",4644,4895,3391,1504,2842,0,1554,1559,1107,452,2.449115044,773,894,516,168,0,168,0,32,0,0,empty,mBC-0814-1
"F4,F12",689847,784466,469053,315413,451534,2,273949,274294,236374,37920,6.233491561,159903,9115,6413,1787,1,1786,1,239,0,0,mm10,mBC-0814-1
"F4,G1",504359,587373,336378,250995,346117,1,213037,213283,177760,35523,5.004081862,127871,298353,214898,59546,34,59512,3,2987,0,0.000117623,mm10,mBC-0814-1
"F4,G2",6264,6705,4437,2268,3906,0,2088,2093,1450,643,2.255054432,1107,115,72,27,0,27,0,11,0,0,empty,mBC-0814-1
"F4,G3",5678,6083,3911,2172,3499,0,1966,1968,1381,587,2.352640545,1058,2361,1739,510,0,510,0,74,0,0.005882353,empty,mBC-0814-1
"F4,G4",5490,5808,3975,1833,3398,13,1759,1779,1244,535,2.325233645,903,0,0,0,0,0,0,0,0,0,empty,mBC-0814-1
"F4,G5",4842,5113,3421,1692,3024,0,1653,1659,1187,472,2.514830508,871,948,656,201,0,201,0,47,0,0,empty,mBC-0814-1
"F4,G6",9237,9805,6683,3122,5694,1,3013,3018,2154,864,2.493055556,1556,147,98,27,0,27,0,12,0,0,empty,mBC-0814-1
"F4,G7",5970,6364,4252,2112,3596,1,1896,1902,1366,536,2.548507463,989,37613,11038,3459,3,3456,1,314,0,0.075810185,empty,mBC-0814-1
"F4,G8",365604,438191,235589,202602,262067,0,174652,174811,107221,67590,1.586344134,109519,36822,25018,7330,7,7323,2,773,0,0.000955892,mm10,mBC-0814-1
"F4,G9",5561,5961,3963,1998,3555,0,1963,1964,1434,530,2.705660377,1036,2138,1412,437,0,437,0,89,0,0,empty,mBC-0814-1
"F4,G10",646423,712531,431118,281413,417887,1,256783,257063,194709,62354,3.122638483,149205,46865,33979,9474,8,9466,2,956,0,0.001478977,mm10,mBC-0814-1
"F4,G11",9948,10642,7226,3416,6207,0,3262,3264,2351,913,2.575027382,1728,1122,799,236,0,236,0,57,0,0,empty,mBC-0814-1
"F4,G12",4959,5516,3486,2030,3259,0,1816,1823,1268,555,2.284684685,1050,2010,1440,431,0,431,0,78,0,0,empty,mBC-0814-1
"F4,H1",4915,5181,3540,1641,2962,0,1645,1645,1194,451,2.647450111,821,791,574,187,0,187,0,42,0,0,empty,mBC-0814-1
"F4,H2",8792,9508,6413,3095,5575,0,3010,3016,2184,832,2.625,1619,2471,1776,511,0,511,0,99,0,0.037181996,empty,mBC-0814-1
"F4,H3",5580,5973,3995,1978,3536,0,1896,1901,1389,512,2.712890625,976,1192,698,248,0,248,0,53,0,0.02016129,empty,mBC-0814-1
"F4,H4",5840,6444,4125,2319,3678,0,2033,2035,1446,589,2.455008489,1133,106,64,17,0,17,0,4,0,0,empty,mBC-0814-1
"F4,H5",7104,7790,5051,2739,4401,1,2391,2395,1647,748,2.201871658,1323,2253,1414,398,0,398,0,69,0,0.037688442,empty,mBC-0814-1
"F4,H6",6498,7002,4745,2257,4107,0,2136,2139,1561,578,2.700692042,1144,1706,1231,386,0,386,0,85,0,0,empty,mBC-0814-1
"F4,H7",5654,6154,4154,2000,3656,0,1929,1936,1408,528,2.666666667,1019,1569,1082,315,0,315,0,60,0,0.117460317,empty,mBC-0814-1
"F4,H8",4833,5199,3415,1784,3062,0,1672,1675,1208,467,2.586723769,915,13553,4072,1347,1,1346,1,156,0,0.023774146,empty,mBC-0814-1
"F4,H9",4980,5321,3625,1696,3085,1,1659,1662,1223,439,2.785876993,837,1146,842,271,1,270,1,59,0,0,empty,mBC-0814-1
"F4,H10",3730,4081,2643,1438,2386,0,1316,1318,943,375,2.514666667,753,898,609,183,0,183,0,36,0,0,empty,mBC-0814-1
"F4,H11",4122,4544,2980,1564,2663,0,1446,1448,994,454,2.189427313,792,6,4,3,0,3,0,3,0,0,empty,mBC-0814-1
"F4,H12",3017,3173,2177,996,1867,0,1003,1005,767,238,3.222689076,534,925,592,183,0,183,0,48,0,0,empty,mBC-0814-1
"F5,A1",5374,5929,3812,2117,3387,0,1849,1853,1309,544,2.40625,991,1712,1140,288,0,288,0,68,0,0,empty,mBC-0814-1
"F5,A2",400600,459017,268039,190978,271952,2,168480,168659,130883,37776,3.464713045,99743,113854,83535,23678,17,23661,1,1846,0,4.22636E-05,mm10,mBC-0814-1
"F5,A3",4635,5064,3227,1837,2929,0,1621,1621,1140,481,2.37006237,885,1053,696,213,0,213,0,60,0,0,empty,mBC-0814-1
"F5,A4",5314,5777,3863,1914,3248,0,1711,1718,1221,497,2.456740443,879,1337,435,151,0,151,0,26,0,0,empty,mBC-0814-1
"F5,A5",488225,568421,327045,241376,337169,1,211111,211340,177876,33464,5.315443462,126123,279119,168432,47130,33,47097,3,2737,0,0.010765017,mm10,mBC-0814-1
"F5,A6",3737,4045,2659,1386,2382,0,1290,1290,927,363,2.553719008,696,2041,1481,411,0,411,0,76,0,0,empty,mBC-0814-1
"F5,A7",5388,5809,3934,1875,3435,0,1882,1887,1326,561,2.363636364,977,1842,1239,355,1,354,1,93,0,0.002824859,empty,mBC-0814-1
"F5,A8",2236,2491,1596,895,1473,0,813,814,546,268,2.037313433,459,2170,1571,449,1,448,1,91,0,0,empty,mBC-0814-1
"F5,A9",6235,6766,4531,2235,3899,0,2099,2105,1491,614,2.428338762,1146,7667,2213,639,1,638,1,91,0,0.031347962,empty,mBC-0814-1
"F5,A10",3473,3960,2399,1561,2302,0,1271,1271,894,377,2.371352785,732,168,55,15,0,15,0,9,0,0,empty,mBC-0814-1
"F5,A11",293638,339351,187941,151410,204047,0,131435,131590,99240,32350,3.067697063,80190,161716,112376,30525,17,30508,3,2105,0,0.003081159,mm10,mBC-0814-1
"F5,A12",208527,238103,139625,98478,145297,0,93099,93195,73316,19879,3.688113084,54321,266727,190130,52546,29,52517,2,2729,0,0.000514119,mm10,mBC-0814-1
"F5,B1",4831,5176,3428,1748,3007,0,1589,1589,1121,468,2.395299145,869,8700,3238,981,1,980,1,127,0,0.078571429,empty,mBC-0814-1
"F5,B2",4883,5293,3504,1789,3096,0,1661,1663,1173,490,2.393877551,913,569,351,97,0,97,0,29,0,0,empty,mBC-0814-1
"F5,B3",264433,306588,175608,130980,186091,5,119300,119415,92325,27090,3.408084164,72096,24213,16927,4888,1,4887,1,522,0,0,mm10,mBC-0814-1
"F5,B4",4068,4448,2909,1539,2627,3,1458,1466,1031,435,2.370114943,793,1436,1008,307,0,307,0,61,0,0,empty,mBC-0814-1
"F5,B5",335432,237047,127478,109569,169075,2,107284,107644,89478,18166,4.92557525,67504,277522,186642,51225,40,51185,8,2727,0,0.000312592,mm10,mBC-0814-1
"F5,B6",3861,4203,2681,1522,2479,0,1408,1412,1024,388,2.639175258,793,1397,832,277,0,277,0,61,0,0,empty,mBC-0814-1
"F5,B7",4619,5033,3294,1739,2965,0,1600,1600,1179,421,2.800475059,870,1008,689,216,0,216,0,59,0,0,empty,mBC-0814-1
"F5,B8",3530,3884,2560,1324,2268,0,1248,1249,877,372,2.357526882,662,1618,999,259,0,259,0,45,0,0.054054054,empty,mBC-0814-1
"F5,B9",4719,5014,3263,1751,2982,0,1632,1633,1146,487,2.353182752,874,1066,738,248,0,248,0,58,0,0,empty,mBC-0814-1
"F5,B10",4172,4187,2849,1338,2571,0,1391,1392,973,419,2.322195704,707,555,398,107,1,106,1,27,0,0,empty,mBC-0814-1
"F5,B11",6373,6858,4488,2370,4038,0,2180,2184,1575,609,2.586206897,1183,236,165,67,0,67,0,12,0,0,empty,mBC-0814-1
"F5,B12",5212,5594,3758,1836,3367,1,1870,1871,1324,547,2.42047532,979,1355,823,268,0,268,0,67,0,0.007462687,empty,mBC-0814-1
"F5,C1",5404,5786,3908,1878,3333,1,1751,1753,1236,517,2.390715667,913,915,640,196,0,196,0,43,0,0,empty,mBC-0814-1
"F5,C2",601639,688035,402374,285661,401237,1,250120,250428,197366,53062,3.719535638,147807,173698,127666,34937,5,34932,1,2114,0,8.58811E-05,mm10,mBC-0814-1
"F5,C3",5886,6385,4151,2234,3682,0,2031,2035,1479,556,2.660071942,1103,879,560,166,0,166,0,37,0,0,empty,mBC-0814-1
"F5,C4",5056,5459,3594,1865,3236,1,1733,1735,1308,427,3.06323185,912,22885,6843,2078,3,2075,1,189,0,0.160963855,empty,mBC-0814-1
"F5,C5",7030,7367,5007,2360,4381,0,2337,2338,1714,624,2.746794872,1239,2335,1694,529,0,529,0,106,0,0.007561437,empty,mBC-0814-1
"F5,C6",4968,5037,3608,1429,3111,0,1623,1623,1167,456,2.559210526,767,1402,989,288,0,288,0,65,0,0.003472222,empty,mBC-0814-1
"F5,C7",6727,7246,4750,2496,4211,0,2299,2301,1690,611,2.765957447,1273,826,704,178,0,178,0,31,0,0,empty,mBC-0814-1
"F5,C8",5173,5557,3786,1771,3304,0,1759,1763,1283,480,2.672916667,934,1776,1308,347,0,347,0,74,0,0.048991354,empty,mBC-0814-1
"F5,C9",4771,5091,3450,1641,2960,0,1616,1622,1166,456,2.557017544,856,1227,769,228,0,228,0,57,0,0,empty,mBC-0814-1
"F5,C10",5583,5925,3993,1932,3431,0,1841,1845,1339,506,2.646245059,943,1493,1025,292,0,292,0,54,0,0,empty,mBC-0814-1
"F5,C11",424380,501222,285993,215229,297618,0,186791,187001,140736,46265,3.041953961,112797,154401,108305,29752,14,29738,2,2014,0,0.000269016,mm10,mBC-0814-1
"F5,C12",519653,604415,344203,260212,353807,0,223329,223602,190060,33542,5.666328782,134966,151992,110000,30855,14,30841,1,1932,0,0.000324244,mm10,mBC-0814-1
"F5,D1",4371,4569,3097,1472,2703,0,1425,1428,1017,411,2.474452555,752,733,434,142,0,142,0,30,0,0.014084507,empty,mBC-0814-1
"F5,D2",4849,5194,3534,1660,2980,0,1541,1545,1139,406,2.805418719,804,2287,1757,543,0,543,0,85,0,0.046040516,empty,mBC-0814-1
"F5,D3",10678,11338,7724,3614,6679,0,3615,3621,2540,1081,2.349676226,1894,6281,2581,835,2,833,1,135,0,0.009603842,empty,mBC-0814-1
"F5,D4",4621,5022,3307,1715,2928,0,1619,1620,1158,462,2.506493506,863,3955,1849,557,2,555,2,97,0,0.055855856,empty,mBC-0814-1
"F5,D5",4338,4931,3034,1897,2906,0,1669,1675,1181,494,2.390688259,962,1947,1289,405,0,405,0,106,0,0,empty,mBC-0814-1
"F5,D6",4703,5061,3499,1562,2940,0,1587,1593,1212,381,3.181102362,814,880,551,182,0,182,0,48,0,0,empty,mBC-0814-1
"F5,D7",5738,6216,4099,2117,3631,0,1960,1966,1424,542,2.627306273,1026,2851,1936,583,0,583,0,113,0,0.001715266,empty,mBC-0814-1
"F5,D8",4713,4863,3334,1529,2810,0,1505,1510,1093,417,2.621103118,741,918,679,232,0,232,0,52,0,0,empty,mBC-0814-1
"F5,D9",3122,3554,2215,1339,2063,0,1172,1174,857,317,2.703470032,657,1564,858,243,0,243,0,59,0,0.008230453,empty,mBC-0814-1
"F5,D10",3724,4166,2660,1506,2464,0,1416,1418,1013,405,2.501234568,777,806,570,205,0,205,0,57,0,0,empty,mBC-0814-1
"F5,D11",3974,4232,2851,1381,2554,0,1380,1381,1010,371,2.722371968,730,1978,1397,418,2,416,2,121,0,0,empty,mBC-0814-1
"F5,D12",6191,6636,4511,2125,3834,0,2063,2067,1420,647,2.194744977,1096,2792,1978,550,0,550,0,110,0,0.014545455,empty,mBC-0814-1
"F5,E1",4835,5169,3494,1675,3004,0,1636,1636,1172,464,2.525862069,828,1196,821,245,0,245,0,80,0,0.048979592,empty,mBC-0814-1
"F5,E2",3502,3673,2510,1163,2179,0,1165,1165,858,307,2.794788274,580,989,724,208,0,208,0,58,0,0,empty,mBC-0814-1
"F5,E3",3332,3500,2452,1048,2055,0,1051,1051,771,280,2.753571429,547,1600,1218,343,0,343,0,59,0,0,empty,mBC-0814-1
"F5,E4",3031,3301,2144,1157,1955,0,1105,1105,814,291,2.797250859,612,943,551,187,0,187,0,53,0,0,empty,mBC-0814-1
"F5,E5",3611,4019,2595,1424,2279,0,1224,1225,904,321,2.816199377,669,7292,2212,701,1,700,1,87,0,0.068571429,empty,mBC-0814-1
"F5,E6",4520,4750,3183,1567,2713,0,1447,1451,1056,395,2.673417722,748,1285,885,275,0,275,0,62,0,0,empty,mBC-0814-1
"F5,E7",4371,4627,3117,1510,2726,1,1450,1455,1046,409,2.557457213,784,1830,1223,299,0,299,0,62,0,0.003344482,empty,mBC-0814-1
"F5,E8",4337,4633,3060,1573,2735,0,1432,1432,1032,400,2.58,788,1858,1350,370,0,370,0,81,0,0.051351351,empty,mBC-0814-1
"F5,E9",3243,3563,2353,1210,2065,4,1115,1119,814,305,2.668852459,597,1160,829,314,0,314,0,72,0,0,empty,mBC-0814-1
"F5,E10",3920,4373,2809,1564,2515,0,1391,1392,996,396,2.515151515,758,2255,1713,476,0,476,0,88,0,0,empty,mBC-0814-1
"F5,E11",4116,4258,3014,1244,2590,0,1332,1336,940,396,2.373737374,675,1634,1098,324,1,323,1,70,0,0,empty,mBC-0814-1
"F5,E12",3824,4053,2733,1320,2333,0,1268,1271,935,336,2.782738095,640,1477,1108,303,0,303,0,64,0,0,empty,mBC-0814-1
"F5,F1",4413,4586,3172,1414,2694,0,1433,1436,1009,427,2.362997658,742,1846,1418,389,0,389,0,72,0,0,empty,mBC-0814-1
"F5,F2",6206,6538,4455,2083,3761,0,2019,2024,1442,582,2.47766323,1040,2139,1555,459,0,459,0,122,0,0,empty,mBC-0814-1
"F5,F3",15007,16401,10817,5584,9592,0,4993,5001,3843,1158,3.31865285,2728,11146,7925,2226,3,2223,1,324,0,0.008996851,empty,mBC-0814-1
"F5,F4",581970,656642,396624,260018,388450,0,233510,233824,193517,40307,4.801076736,135249,64690,40084,11452,8,11444,2,981,0,0.001485495,mm10,mBC-0814-1
"F5,F5",562621,671022,368020,303002,393439,2,254084,254345,209347,44998,4.652362327,155346,214616,156635,43341,37,43304,5,2431,0,0.000808239,mm10,mBC-0814-1
"F5,F6",4863,5210,3403,1807,3019,0,1684,1688,1225,463,2.645788337,877,2059,1431,439,0,439,0,108,0,0,empty,mBC-0814-1
"F5,F7",4410,4886,3192,1694,2860,0,1546,1546,1156,390,2.964102564,830,442,302,93,0,93,0,35,0,0,empty,mBC-0814-1
"F5,F8",6610,6962,4812,2150,4044,0,2161,2164,1551,613,2.530179445,1105,237,170,58,0,58,0,17,0,0,empty,mBC-0814-1
"F5,F9",5310,5637,3888,1749,3299,0,1685,1687,1179,508,2.320866142,887,2101,1479,405,0,405,0,86,0,0.032098765,empty,mBC-0814-1
"F5,F10",6329,6949,4446,2503,3982,0,2169,2171,1506,665,2.264661654,1220,1644,1201,360,0,360,0,83,0,0.002777778,empty,mBC-0814-1
"F5,F11",4258,4520,3113,1407,2656,0,1373,1374,986,388,2.541237113,721,1459,1114,320,0,320,0,57,0,0,empty,mBC-0814-1
"F5,F12",4800,5120,3341,1779,2936,0,1679,1680,1170,510,2.294117647,897,175,132,39,0,39,0,15,0,0,empty,mBC-0814-1
"F5,G1",7138,7444,5074,2370,4424,0,2339,2341,1680,661,2.541603631,1199,2490,1666,503,0,503,0,136,0,0.02584493,empty,mBC-0814-1
"F5,G2",5611,6099,4090,2009,3549,0,1892,1899,1379,520,2.651923077,1007,630,465,123,0,123,0,26,0,0,empty,mBC-0814-1
"F5,G3",6242,6965,4374,2591,4131,0,2363,2369,1772,597,2.968174204,1328,1858,1321,405,0,405,0,110,0,0.024691358,empty,mBC-0814-1
"F5,G4",5048,5326,3580,1746,3168,0,1672,1672,1230,442,2.78280543,917,51,40,17,0,17,0,1,0,0,empty,mBC-0814-1
"F5,G5",4529,4869,3195,1674,2768,0,1520,1523,1061,462,2.296536797,802,1242,858,303,0,303,0,67,0,0,empty,mBC-0814-1
"F5,G6",642755,728601,439473,289128,426259,0,257389,257663,205659,52004,3.954676563,149881,18030,12666,3603,2,3601,1,398,0,0,mm10,mBC-0814-1
"F5,G7",5213,5621,3698,1923,3288,6,1775,1782,1289,493,2.614604462,937,2290,1508,501,0,501,0,121,0,0.007984032,empty,mBC-0814-1
"F5,G8",252164,281681,172093,109588,168366,1,101090,101188,74091,27097,2.734287929,58867,72483,43416,12060,7,12053,1,1187,0,0.004895047,mm10,mBC-0814-1
"F5,G9",404583,467461,267700,199761,276721,0,173068,173245,142479,30766,4.631053761,103421,307273,219337,59932,38,59894,5,2943,0,0.000317227,mm10,mBC-0814-1
"F5,G10",9042,9762,6533,3229,5816,0,3059,3069,2244,825,2.72,1613,3425,2319,654,0,654,0,156,0,0,empty,mBC-0814-1
"F5,G11",8919,9460,6491,2969,5560,0,2918,2920,2087,833,2.505402161,1566,1950,1356,403,0,403,0,86,0,0.019851117,empty,mBC-0814-1
"F5,G12",4241,4463,2956,1507,2745,0,1481,1483,1087,396,2.744949495,801,2650,1862,512,0,512,0,110,0,0.0234375,empty,mBC-0814-1
"F5,H1",4497,4989,3147,1842,2969,0,1698,1705,1188,517,2.29787234,950,936,706,222,0,222,0,55,0,0,empty,mBC-0814-1
"F5,H2",7518,8154,5372,2782,4834,0,2663,2667,1895,772,2.454663212,1427,3360,2278,727,0,727,0,145,0,0.03301238,empty,mBC-0814-1
"F5,H3",5893,6247,4242,2005,3715,0,2014,2016,1475,541,2.726432532,1079,2058,1452,453,0,453,0,100,0,0.015452539,empty,mBC-0814-1
"F5,H4",5569,5909,3929,1980,3460,0,1915,1922,1363,559,2.438282648,1002,856,183,73,0,73,0,20,0,0.178082192,empty,mBC-0814-1
"F5,H5",6250,6638,4387,2251,3967,0,2139,2142,1529,613,2.494290375,1161,1618,947,288,0,288,0,70,0,0,empty,mBC-0814-1
"F5,H6",6330,6625,4490,2135,3855,0,2060,2065,1527,538,2.838289963,1061,2427,1746,541,1,540,1,117,0,0.02037037,empty,mBC-0814-1
"F5,H7",5629,5951,4059,1892,3583,0,1936,1940,1372,568,2.415492958,1008,2290,1644,493,0,493,0,99,0,0,empty,mBC-0814-1
"F5,H8",4472,4924,3195,1729,2914,0,1593,1596,1121,475,2.36,897,1831,1280,391,0,391,0,94,0,0,empty,mBC-0814-1
"F5,H9",4654,4939,3341,1598,2879,0,1604,1608,1153,455,2.534065934,805,2006,1401,370,0,370,0,64,0,0.02972973,empty,mBC-0814-1
"F5,H10",3387,3631,2434,1197,2076,1,1098,1101,768,333,2.306306306,568,1022,721,178,0,178,0,39,0,0,empty,mBC-0814-1
"F5,H11",3851,4216,2722,1494,2530,0,1452,1453,1013,440,2.302272727,799,59,33,12,0,12,0,9,0,0,empty,mBC-0814-1
"F5,H12",303902,347128,203025,144103,208107,0,127133,127279,103070,24209,4.257507539,75541,172466,112061,31261,24,31237,2,2025,0,0.000544226,mm10,mBC-0814-1
"F6,A1",5038,5545,3591,1954,3259,0,1795,1795,1322,473,2.794926004,980,5499,3966,1183,0,1183,0,155,0,0.017751479,empty,mBC-0814-1
"F6,A2",5065,5415,3572,1843,3241,0,1742,1747,1324,423,3.130023641,970,4637,3405,1057,0,1057,0,165,0,0.000946074,empty,mBC-0814-1
"F6,A3",4206,4339,2955,1384,2594,0,1376,1380,1010,370,2.72972973,716,1745,1288,373,0,373,0,64,0,0,empty,mBC-0814-1
"F6,A4",4882,5274,3569,1705,3094,0,1660,1668,1186,482,2.460580913,876,1506,1154,286,2,284,1,40,0,0,empty,mBC-0814-1
"F6,A5",4426,4618,3184,1434,2767,0,1506,1513,1065,448,2.377232143,789,1967,1014,352,1,351,1,59,0,0,empty,mBC-0814-1
"F6,A6",237657,274412,157863,116549,165257,1,104571,104699,77495,27204,2.848661961,62851,11453,6257,1541,2,1539,1,266,0,0.001299545,mm10,mBC-0814-1
"F6,A7",4964,5422,3494,1928,3225,0,1773,1781,1283,498,2.576305221,1003,5449,2676,741,1,740,1,95,0,0.062162162,empty,mBC-0814-1
"F6,A8",1978,2240,1369,871,1323,0,746,746,524,222,2.36036036,430,1599,1232,364,0,364,0,73,0,0,empty,mBC-0814-1
"F6,A9",5852,6034,4292,1742,3634,1,1924,1929,1433,496,2.889112903,966,1212,806,227,0,227,0,54,0,0,empty,mBC-0814-1
"F6,A10",3134,3495,2265,1230,2139,0,1171,1174,850,324,2.62345679,660,218,174,70,0,70,0,12,0,0,empty,mBC-0814-1
"F6,A11",4362,4643,3060,1583,2749,0,1493,1502,1072,430,2.493023256,801,1800,1217,363,0,363,0,81,0,0,empty,mBC-0814-1
"F6,A12",4072,4492,2890,1602,2698,0,1499,1499,1128,371,3.040431267,825,3277,2272,749,1,748,1,162,0,0,empty,mBC-0814-1
"F6,B1",4339,4613,3153,1460,2770,0,1484,1486,1057,429,2.463869464,782,2657,1795,620,0,620,0,107,0,0.00483871,empty,mBC-0814-1
"F6,B2",484654,555462,327362,228100,331365,2,205043,205295,173488,31807,5.454396831,120437,48943,34898,9501,2,9499,1,909,0,0.002210759,mm10,mBC-0814-1
"F6,B3",3859,4292,2835,1457,2581,0,1461,1463,1073,390,2.751282051,793,2958,1794,583,0,583,0,82,0,0.084048027,empty,mBC-0814-1
"F6,B4",3804,4227,2640,1587,2512,0,1463,1467,1038,429,2.41958042,837,1673,1078,346,0,346,0,75,0,0.014450867,empty,mBC-0814-1
"F6,B5",4841,3831,2385,1446,2563,3,1484,1493,1065,428,2.488317757,865,748,467,166,0,166,0,44,0,0,empty,mBC-0814-1
"F6,B6",3649,3966,2586,1380,2303,3,1317,1321,931,390,2.387179487,692,1432,1101,351,0,351,0,62,0,0,empty,mBC-0814-1
"F6,B7",4465,4837,3192,1645,2912,8,1572,1585,1143,442,2.585972851,864,1101,839,255,1,254,1,45,0,0,empty,mBC-0814-1
"F6,B8",3406,3701,2463,1238,2219,8,1189,1199,893,306,2.918300654,657,942,617,184,0,184,0,43,0,0,empty,mBC-0814-1
"F6,B9",4510,5122,3186,1936,3048,0,1732,1734,1282,452,2.836283186,984,616,434,146,0,146,0,46,0,0,empty,mBC-0814-1
"F6,B10",506998,541751,337289,204462,329420,1,194103,194512,136607,57905,2.35915724,112768,7216,4740,1353,4,1349,1,182,0,0,mm10,mBC-0814-1
"F6,B11",6074,6704,4407,2297,3790,0,2047,2056,1454,602,2.415282392,1104,166,121,36,0,36,0,13,0,0,empty,mBC-0814-1
"F6,B12",4888,5386,3536,1850,3231,0,1764,1765,1264,501,2.522954092,968,2738,1247,389,0,389,0,67,0,0.05655527,empty,mBC-0814-1
"F6,C1",580157,663653,392744,270909,388437,2,239514,239732,189228,50504,3.746792333,140609,67224,48332,13308,9,13299,2,1154,0,0.001353485,mm10,mBC-0814-1
"F6,C2",487410,568005,323852,244153,333513,0,208229,208504,181318,27186,6.66953579,125172,339839,242812,65867,37,65830,1,3150,0,7.59532E-05,mm10,mBC-0814-1
"F6,C3",608590,705158,412818,292340,412985,0,254339,254607,210437,44170,4.764251755,150901,96093,67541,19288,10,19278,2,1435,0,0.000311236,mm10,mBC-0814-1
"F6,C4",4649,4891,3311,1580,2938,0,1553,1555,1157,398,2.907035176,802,3375,2493,687,0,687,0,117,0,0.013100437,empty,mBC-0814-1
"F6,C5",6484,6931,4577,2354,4083,0,2258,2259,1634,625,2.6144,1214,14035,4562,1391,1,1390,1,180,0,0,empty,mBC-0814-1
"F6,C6",4865,5222,3496,1726,3154,0,1713,1717,1276,441,2.893424036,907,1013,739,245,0,245,0,56,0,0,empty,mBC-0814-1
"F6,C7",6685,7078,4752,2326,4098,0,2195,2199,1572,627,2.507177033,1140,3201,1264,368,4,364,3,47,0,0.019230769,empty,mBC-0814-1
"F6,C8",4997,5056,3553,1503,3039,0,1548,1552,1124,428,2.626168224,789,17526,5375,1748,5,1743,2,179,0,0.000573723,empty,mBC-0814-1
"F6,C9",4289,4673,3058,1615,2742,0,1489,1493,1096,397,2.76070529,825,1036,694,245,1,244,1,52,0,0,empty,mBC-0814-1
"F6,C10",5171,5505,3819,1686,3235,0,1684,1684,1245,439,2.835990888,866,1588,1111,265,0,265,0,48,0,0,empty,mBC-0814-1
"F6,C11",4107,4499,3000,1499,2676,0,1451,1455,1060,395,2.683544304,806,1484,1050,317,0,317,0,64,0,0.003154574,empty,mBC-0814-1
"F6,C12",432946,496237,287036,209201,292083,0,179251,179486,150582,28904,5.209728757,107211,196312,143752,39469,18,39451,1,2373,0,0,mm10,mBC-0814-1
"F6,D1",387766,428318,261658,166660,256800,0,155508,155696,126555,29141,4.34285028,89961,9411,6673,1912,0,1912,0,295,0,0,mm10,mBC-0814-1
"F6,D2",4919,5265,3637,1628,3031,0,1581,1584,1135,449,2.527839644,813,7624,2539,740,1,739,1,122,0,0,empty,mBC-0814-1
"F6,D3",9713,10370,7028,3342,6089,0,3264,3272,2428,844,2.876777251,1696,2640,1775,545,0,545,0,122,0,0.033027523,empty,mBC-0814-1
"F6,D4",4127,4561,2897,1664,2697,1,1499,1501,1102,399,2.761904762,833,2648,1719,511,0,511,0,79,0,0,empty,mBC-0814-1
"F6,D5",4241,4905,2895,2010,2839,2,1621,1627,1159,468,2.476495726,967,2178,1526,469,0,469,0,99,0,0.002132196,empty,mBC-0814-1
"F6,D6",4252,4649,3095,1554,2725,0,1498,1499,1108,391,2.833759591,799,1755,922,266,0,266,0,54,0,0,empty,mBC-0814-1
"F6,D7",5767,6014,4073,1941,3449,0,1847,1849,1351,498,2.712851406,972,41833,14019,4441,10,4431,4,392,0,0.178289325,empty,mBC-0814-1
"F6,D8",4516,4999,3213,1786,2939,0,1603,1610,1205,405,2.975308642,889,1067,706,247,0,247,0,42,0,0.060728745,empty,mBC-0814-1
"F6,D9",2829,3045,1996,1049,1819,1,1018,1023,715,308,2.321428571,544,1550,1028,309,1,308,1,43,0,0.038961039,empty,mBC-0814-1
"F6,D10",3473,3811,2474,1337,2264,0,1273,1273,949,324,2.929012346,696,702,487,159,0,159,0,39,0,0,empty,mBC-0814-1
"F6,D11",3872,4393,2742,1651,2557,0,1440,1441,1097,344,3.188953488,854,2400,1719,465,0,465,0,105,0,0,empty,mBC-0814-1
"F6,D12",5624,6091,4029,2062,3479,0,1891,1891,1357,534,2.541198502,1025,2968,1958,559,0,559,0,94,0,0,empty,mBC-0814-1
"F6,E1",4656,4881,3399,1482,2910,2,1568,1572,1115,457,2.439824945,795,5589,4182,1143,1,1142,1,170,0,0.014886165,empty,mBC-0814-1
"F6,E2",3283,3645,2394,1251,2194,0,1176,1176,843,333,2.531531532,611,2947,2107,633,1,632,1,96,0,0,empty,mBC-0814-1
"F6,E3",3000,3082,2158,924,1847,1,989,990,724,266,2.721804511,496,2075,1459,450,1,449,1,80,0,0,empty,mBC-0814-1
"F6,E4",2902,3127,2013,1114,1842,0,1004,1005,736,269,2.73605948,564,2199,1576,433,1,432,1,76,0,0,empty,mBC-0814-1
"F6,E5",3355,3630,2420,1210,2119,1,1160,1164,834,330,2.527272727,619,819,512,163,0,163,0,33,0,0,empty,mBC-0814-1
"F6,E6",3959,4302,2908,1394,2506,1,1368,1371,1016,355,2.861971831,721,1494,1090,327,1,326,1,57,0,0,empty,mBC-0814-1
"F6,E7",4446,4849,3205,1644,2798,0,1533,1533,1093,440,2.484090909,821,1955,1397,424,0,424,0,70,0,0.004716981,empty,mBC-0814-1
"F6,E8",4046,4279,2880,1399,2527,0,1336,1338,943,395,2.387341772,697,1857,1345,352,0,352,0,73,0,0,empty,mBC-0814-1
"F6,E9",3072,3228,2191,1037,1868,0,1025,1027,761,266,2.860902256,511,1223,818,242,1,241,1,45,0,0,empty,mBC-0814-1
"F6,E10",3607,3973,2550,1423,2427,2,1332,1334,941,393,2.394402036,748,1292,897,289,0,289,0,77,0,0.069204152,empty,mBC-0814-1
"F6,E11",4025,4383,2902,1481,2557,0,1386,1388,991,397,2.496221662,757,1438,1070,316,0,316,0,64,0,0,empty,mBC-0814-1
"F6,E12",3695,3958,2613,1345,2362,0,1317,1320,933,387,2.410852713,724,995,698,189,0,189,0,54,0,0,empty,mBC-0814-1
"F6,F1",494586,561729,333997,227732,332459,2,203393,203623,169854,33769,5.029879475,119106,167082,111437,30742,28,30714,4,1969,0,0.006707039,mm10,mBC-0814-1
"F6,F2",6164,6453,4401,2052,3792,3,2045,2053,1476,577,2.558058925,1076,4221,3158,986,0,986,0,154,0,0,empty,mBC-0814-1
"F6,F3",4743,5137,3489,1648,2914,0,1544,1548,1102,446,2.470852018,798,3273,2444,788,0,788,0,126,0,0.015228426,empty,mBC-0814-1
"F6,F4",4866,5140,3529,1611,3060,0,1632,1632,1196,436,2.743119266,829,1178,822,226,0,226,0,40,0,0,empty,mBC-0814-1
"F6,F5",515180,563390,353981,209409,333744,2,198768,198988,163403,35585,4.591906702,112567,17008,11959,3221,2,3219,1,452,0,0,mm10,mBC-0814-1
"F6,F6",4636,4865,3325,1540,2844,0,1524,1524,1078,446,2.417040359,796,3198,1835,473,0,473,0,93,0,0.10359408,empty,mBC-0814-1
"F6,F7",4060,4276,2968,1308,2495,0,1298,1301,971,330,2.942424242,666,876,584,151,0,151,0,39,0,0,empty,mBC-0814-1
"F6,F8",5614,6081,4074,2007,3547,0,1945,1947,1414,533,2.652908068,1032,268,186,46,0,46,0,11,0,0,empty,mBC-0814-1
"F6,F9",568928,635278,391126,244152,373387,1,221373,221618,179009,42609,4.201201624,126644,304363,224744,62432,40,62392,3,2963,0,0.000368637,mm10,mBC-0814-1
"F6,F10",5634,5920,4158,1762,3473,0,1786,1786,1277,509,2.508840864,892,1135,799,241,1,240,1,55,0,0.029166667,empty,mBC-0814-1
"F6,F11",3810,4138,2764,1374,2369,0,1253,1261,898,363,2.473829201,646,1124,761,244,1,243,1,66,0,0,empty,mBC-0814-1
"F6,F12",434604,502196,294539,207657,296309,0,182801,183012,132439,50573,2.618768908,108858,4412,3325,936,0,936,0,132,0,0,empty,mBC-0814-1
"F6,G1",7303,7809,5298,2511,4642,0,2455,2456,1790,666,2.687687688,1215,7204,5295,1499,1,1498,1,226,0,0,empty,mBC-0814-1
"F6,G2",4933,5118,3515,1603,3058,0,1630,1630,1160,470,2.468085106,844,530,339,120,0,120,0,27,0,0,empty,mBC-0814-1
"F6,G3",412765,485489,273420,212069,288384,0,181092,181242,140903,40339,3.492972062,110058,400233,288747,81823,44,81779,4,3389,0,0.000293474,mm10,mBC-0814-1
"F6,G4",4821,4994,3407,1587,2942,0,1542,1548,1110,438,2.534246575,828,105,97,35,0,35,0,2,0,0,empty,mBC-0814-1
"F6,G5",4206,4502,3011,1491,2615,3,1407,1413,1002,411,2.437956204,731,1803,1183,355,1,354,1,60,0,0.014124294,empty,mBC-0814-1
"F6,G6",8160,8636,5933,2703,5060,1,2721,2725,1958,767,2.552803129,1382,198,145,52,0,52,0,13,0,0,empty,mBC-0814-1
"F6,G7",4786,5163,3579,1584,3106,1,1638,1649,1182,467,2.531049251,872,1947,1082,326,1,325,1,85,0,0.003076923,empty,mBC-0814-1
"F6,G8",6813,7320,4744,2576,4393,0,2517,2523,1750,773,2.263906856,1396,3319,2154,632,0,632,0,127,0,0,empty,mBC-0814-1
"F6,G9",4963,5492,3472,2020,3313,0,1866,1868,1332,536,2.485074627,1054,2688,1901,527,0,527,0,113,0,0.015180266,empty,mBC-0814-1
"F6,G10",12969,14047,9233,4814,8197,0,4383,4383,3226,1157,2.788245462,2389,5152,3402,967,0,967,0,185,0,0.016546019,empty,mBC-0814-1
"F6,G11",8745,9411,6393,3018,5441,0,2865,2876,2037,839,2.427890346,1508,1523,1057,335,0,335,0,72,0,0,empty,mBC-0814-1
"F6,G12",4159,4514,2857,1657,2720,0,1511,1511,1049,462,2.270562771,868,1934,1373,430,1,429,1,83,0,0.013986014,empty,mBC-0814-1
"F6,H1",4105,4428,2953,1475,2612,0,1463,1470,1082,388,2.788659794,745,1768,1313,363,0,363,0,77,0,0,empty,mBC-0814-1
"F6,H2",15452,16900,11159,5741,9826,0,5241,5256,3951,1305,3.027586207,2819,12376,8341,2485,3,2482,1,353,0,0.00443191,empty,mBC-0814-1
"F6,H3",4872,5285,3524,1761,3083,0,1682,1684,1190,494,2.408906883,884,3101,2227,634,0,634,0,102,0,0.029968454,empty,mBC-0814-1
"F6,H4",5327,5679,3815,1864,3409,0,1883,1888,1363,525,2.596190476,1026,98,48,28,0,28,0,12,0,0,empty,mBC-0814-1
"F6,H5",5880,6471,4199,2272,3734,2,2047,2050,1480,570,2.596491228,1134,1670,1087,284,0,284,0,69,0,0,empty,mBC-0814-1
"F6,H6",5969,6593,4254,2339,3803,0,2080,2086,1447,639,2.264475743,1134,3008,2190,685,0,685,0,116,0,0,empty,mBC-0814-1
"F6,H7",4569,4923,3295,1628,2920,0,1553,1555,1106,449,2.46325167,787,1517,1115,301,1,300,1,59,0,0,empty,mBC-0814-1
"F6,H8",4146,4458,2994,1464,2630,0,1389,1394,1000,394,2.538071066,738,11688,4191,1298,0,1298,0,185,0,0.026964561,empty,mBC-0814-1
"F6,H9",4620,4786,3335,1451,2854,0,1481,1484,1052,432,2.435185185,786,1913,1194,434,0,434,0,83,0,0.036866359,empty,mBC-0814-1
"F6,H10",3271,3580,2314,1266,2110,0,1163,1163,869,294,2.955782313,637,814,532,177,0,177,0,40,0,0,empty,mBC-0814-1
"F6,H11",3746,4252,2670,1582,2495,0,1412,1414,1017,397,2.561712846,784,44,24,13,0,13,0,6,0,0,empty,mBC-0814-1
"F6,H12",2488,2811,1709,1102,1739,0,1031,1031,770,261,2.950191571,602,1547,1090,288,1,287,1,64,0,0,empty,mBC-0814-1
"F7,A1",396670,467057,262808,204249,282407,0,181635,181834,138793,43041,3.224669501,110888,31980,21510,6173,2,6171,1,728,0,0.002268676,mm10,mBC-0814-1
"F7,A2",5960,6286,4246,2040,3654,0,1955,1955,1478,477,3.098532495,1011,1262,949,328,2,326,2,97,0,0,empty,mBC-0814-1
"F7,A3",4780,5325,3363,1962,3144,0,1694,1696,1231,465,2.647311828,966,675,516,197,0,197,0,55,0,0,empty,mBC-0814-1
"F7,A4",5862,6267,4345,1922,3572,0,1863,1871,1338,533,2.510318949,989,722,555,136,0,136,0,21,0,0,empty,mBC-0814-1
"F7,A5",15450,18573,9931,8642,10861,0,7194,7196,5930,1266,4.684044234,4438,24411,8091,2426,0,2426,0,239,0,0.039983512,empty,mBC-0814-1
"F7,A6",9050,10168,6245,3923,6247,0,3703,3713,2742,971,2.823892894,2140,14014,4292,1321,2,1319,1,146,0,0.072782411,empty,mBC-0814-1
"F7,A7",5941,6536,4242,2294,3841,0,2115,2117,1540,577,2.66897747,1131,1734,1247,393,0,393,0,81,0,0,empty,mBC-0814-1
"F7,A8",238661,284075,155633,128442,171470,0,110058,110199,92315,17884,5.161876538,67664,174455,124940,34122,21,34101,2,2144,0,0.000410545,mm10,mBC-0814-1
"F7,A9",7035,7635,5103,2532,4530,0,2445,2445,1770,675,2.622222222,1294,1582,1045,262,0,262,0,54,0,0.064885496,empty,mBC-0814-1
"F7,A10",3728,4080,2635,1445,2394,0,1337,1339,948,391,2.42455243,760,224,174,71,0,71,0,23,0,0.028169014,empty,mBC-0814-1
"F7,A11",5009,5409,3505,1904,3250,0,1824,1826,1303,523,2.491395793,996,2400,1590,489,1,488,1,100,0,0.004098361,empty,mBC-0814-1
"F7,A12",4935,5398,3483,1915,3239,0,1828,1833,1342,491,2.733197556,1009,2724,1823,520,0,520,0,142,0,0.001923077,empty,mBC-0814-1
"F7,B1",4991,5298,3574,1724,3115,0,1676,1679,1191,488,2.44057377,875,1339,934,271,1,270,1,72,0,0,empty,mBC-0814-1
"F7,B2",5365,5861,3708,2153,3333,0,1874,1876,1323,553,2.392405063,1034,325,253,73,1,72,1,32,0,0,empty,mBC-0814-1
"F7,B3",4251,4718,2949,1769,2860,0,1647,1648,1184,464,2.551724138,944,1170,727,209,0,209,0,53,0,0,empty,mBC-0814-1
"F7,B4",4678,5131,3318,1813,2991,0,1691,1691,1220,471,2.590233546,920,4503,1492,482,2,480,1,88,0,0,empty,mBC-0814-1
"F7,B5",4460,3019,1966,1053,2107,1,1123,1132,806,326,2.472392638,642,953,616,153,0,153,0,52,0,0,empty,mBC-0814-1
"F7,B6",4302,4589,3046,1543,2801,2,1555,1557,1163,394,2.95177665,848,1116,805,233,0,233,0,59,0,0,empty,mBC-0814-1
"F7,B7",614639,689665,422733,266932,408576,2,248487,248774,182589,66185,2.758767092,143998,7020,4926,1044,0,1044,0,179,0,0.000957854,mm10,mBC-0814-1
"F7,B8",4112,4280,3019,1261,2499,0,1351,1352,945,407,2.321867322,655,867,504,153,0,153,0,47,0,0.058823529,empty,mBC-0814-1
"F7,B9",417351,491903,277603,214300,292141,0,185427,185663,151641,34022,4.457145377,112919,35020,24602,7027,9,7018,1,710,0,0.000142491,mm10,mBC-0814-1
"F7,B10",4561,4603,3128,1475,2779,0,1473,1474,1007,467,2.156316916,769,459,251,82,0,82,0,21,0,0,empty,mBC-0814-1
"F7,B11",7009,7366,5006,2360,4304,0,2320,2322,1654,668,2.476047904,1226,311,217,63,0,63,0,12,0,0,empty,mBC-0814-1
"F7,B12",5651,6171,4029,2142,3677,0,2066,2069,1470,599,2.45409015,1109,869,567,143,0,143,0,47,0,0,empty,mBC-0814-1
"F7,C1",6040,6348,4386,1962,3731,0,1955,1962,1397,565,2.472566372,1014,717,486,162,0,162,0,41,0,0,empty,mBC-0814-1
"F7,C2",5876,6335,4216,2119,3640,0,2048,2054,1452,602,2.411960133,1098,2928,1459,426,0,426,0,101,0,0,empty,mBC-0814-1
"F7,C3",7668,7645,4818,2827,4148,1,2341,2344,1547,797,1.941028858,1305,52736,15324,4842,8,4834,1,415,0,0.133223004,empty,mBC-0814-1
"F7,C4",5848,6474,4107,2367,3814,0,2117,2120,1514,606,2.498349835,1182,1163,775,207,0,207,0,66,0,0.057971014,empty,mBC-0814-1
"F7,C5",597387,688553,390422,298131,403786,1,255307,255580,219350,36230,6.054374827,152784,193510,138848,37896,26,37870,3,2373,0,0.001188276,mm10,mBC-0814-1
"F7,C6",7195,7788,5121,2667,4588,0,2529,2535,1885,650,2.9,1376,1051,752,228,0,228,0,52,0,0,empty,mBC-0814-1
"F7,C7",8611,9281,6034,3247,5417,0,3068,3080,1971,1109,1.777276826,1685,4437,1203,386,1,385,1,66,0,0.005194805,empty,mBC-0814-1
"F7,C8",527778,613817,351622,262195,364455,0,228941,229165,199793,29372,6.802158518,137358,145770,106406,30042,15,30027,3,1976,0,0,mm10,mBC-0814-1
"F7,C9",4947,5311,3380,1931,3015,0,1698,1698,1250,448,2.790178571,893,1609,679,232,0,232,0,62,0,0,empty,mBC-0814-1
"F7,C10",5965,6492,4361,2131,3737,0,2011,2011,1459,552,2.643115942,1048,948,618,195,0,195,0,42,0,0.041025641,empty,mBC-0814-1
"F7,C11",4901,5448,3556,1892,3110,0,1680,1680,1228,452,2.716814159,914,2764,1481,427,1,426,1,68,0,0.011737089,empty,mBC-0814-1
"F7,C12",8666,9696,6142,3554,5534,7,3104,3115,2184,931,2.345864662,1750,1882,1305,373,0,373,0,80,0,0.013404826,empty,mBC-0814-1
"F7,D1",5056,5476,3645,1831,3269,0,1756,1759,1328,431,3.081206497,952,651,481,122,0,122,0,42,0,0,empty,mBC-0814-1
"F7,D2",824567,933183,562105,371078,539590,1,326943,327335,280149,47186,5.93712118,188560,211453,151499,42885,28,42857,2,2379,0,0.00014,mm10,mBC-0814-1
"F7,D3",11292,12528,8003,4525,7400,0,4059,4064,2956,1108,2.667870036,2263,1694,1106,374,0,374,0,84,0,0.034759358,empty,mBC-0814-1
"F7,D4",5857,6441,4195,2246,3828,0,2152,2156,1600,556,2.877697842,1170,1413,1092,274,0,274,0,75,0,0,empty,mBC-0814-1
"F7,D5",5087,5728,3594,2134,3364,0,1907,1908,1405,503,2.793240557,1068,4041,1855,538,1,537,1,130,0,0.04283054,empty,mBC-0814-1
"F7,D6",5072,5384,3673,1711,3145,1,1666,1667,1229,438,2.805936073,886,1286,907,264,1,263,1,58,0,0.152091255,empty,mBC-0814-1
"F7,D7",6221,6802,4412,2390,3960,0,2132,2136,1537,599,2.565943239,1171,2321,1705,501,0,501,0,102,0,0.007984032,empty,mBC-0814-1
"F7,D8",5181,5721,3721,2000,3306,0,1751,1753,1276,477,2.675052411,965,779,567,203,0,203,0,52,0,0,empty,mBC-0814-1
"F7,D9",3173,3514,2227,1287,2005,0,1101,1104,785,319,2.460815047,593,1377,956,227,0,227,0,46,0,0.057268722,empty,mBC-0814-1
"F7,D10",475464,555189,316677,238512,327915,1,204259,204493,173671,30822,5.634644085,122856,83931,61094,17411,9,17402,3,1402,0,0.000517182,mm10,mBC-0814-1
"F7,D11",622852,705687,418992,286695,412656,1,252849,253151,203588,49563,4.107660957,147702,231364,168369,46219,27,46192,2,2578,0,2.16488E-05,mm10,mBC-0814-1
"F7,D12",6679,7144,4747,2397,4166,0,2296,2306,1626,680,2.391176471,1204,2549,1678,536,0,536,0,121,0,0.001865672,empty,mBC-0814-1
"F7,E1",5355,5726,3854,1872,3290,0,1717,1717,1262,455,2.773626374,855,1323,840,244,0,244,0,69,0,0,empty,mBC-0814-1
"F7,E2",4006,4445,2822,1623,2583,0,1425,1431,987,444,2.222972973,800,910,719,209,0,209,0,61,0,0,empty,mBC-0814-1
"F7,E3",3533,3795,2634,1161,2273,0,1200,1202,867,335,2.588059701,608,783,563,179,0,179,0,59,0,0.061452514,empty,mBC-0814-1
"F7,E4",3474,3806,2570,1236,2218,2,1166,1171,847,324,2.614197531,620,1072,655,188,0,188,0,52,0,0.005319149,empty,mBC-0814-1
"F7,E5",3982,4300,2854,1446,2451,0,1290,1290,922,368,2.505434783,704,1043,783,204,0,204,0,37,0,0,empty,mBC-0814-1
"F7,E6",4915,5248,3532,1716,3082,0,1660,1661,1171,490,2.389795918,888,1446,1084,324,0,324,0,59,0,0.033950617,empty,mBC-0814-1
"F7,E7",490348,551568,335715,215853,324983,0,199632,199885,155419,44466,3.495232312,116156,17359,12381,3333,1,3332,1,416,0,0.00030012,mm10,mBC-0814-1
"F7,E8",545974,626670,369410,257260,369097,0,225356,225654,190199,35455,5.364518404,132618,257027,186445,51339,30,51309,2,2734,0,0.000370305,mm10,mBC-0814-1
"F7,E9",3583,3948,2521,1427,2400,0,1357,1357,980,377,2.599469496,767,1175,802,287,1,286,1,83,0,0.024475524,empty,mBC-0814-1
"F7,E10",4403,4716,3125,1591,2848,0,1577,1580,1117,463,2.412526998,835,1494,1038,341,0,341,0,85,0,0,empty,mBC-0814-1
"F7,E11",4542,4845,3225,1620,2903,0,1553,1555,1102,453,2.432671082,844,1500,982,313,0,313,0,84,0,0,empty,mBC-0814-1
"F7,E12",4269,4673,3044,1629,2799,0,1520,1522,1085,437,2.482837529,814,940,694,240,0,240,0,57,0,0,empty,mBC-0814-1
"F7,F1",4840,5177,3565,1612,3092,0,1660,1663,1234,429,2.876456876,825,3081,1612,448,0,448,0,73,0,0,empty,mBC-0814-1
"F7,F2",7126,7788,5151,2637,4558,0,2445,2445,1742,703,2.477951636,1366,1723,1069,333,0,333,0,100,0,0.009009009,empty,mBC-0814-1
"F7,F3",5501,5904,3985,1919,3476,0,1902,1904,1409,495,2.846464646,1008,1483,1118,268,0,268,0,77,0,0.007462687,empty,mBC-0814-1
"F7,F4",5914,6311,4176,2135,3697,0,2016,2025,1465,560,2.616071429,1102,180,130,46,0,46,0,18,0,0,empty,mBC-0814-1
"F7,F5",5460,5900,3897,2003,3413,0,1822,1825,1373,452,3.037610619,983,1050,776,232,0,232,0,72,0,0,empty,mBC-0814-1
"F7,F6",5559,6187,3868,2319,3656,0,2064,2074,1421,653,2.17611026,1172,1609,1134,360,0,360,0,107,0,0.091666667,empty,mBC-0814-1
"F7,F7",753641,864150,504986,359164,505026,0,313357,313721,254521,59200,4.299341216,184976,76101,54880,15228,5,15223,2,1279,0,0.001051041,mm10,mBC-0814-1
"F7,F8",6433,6970,4621,2349,4175,0,2304,2305,1642,663,2.476621418,1252,186,144,41,0,41,0,12,0,0,empty,mBC-0814-1
"F7,F9",5977,6563,4355,2208,3923,6,2141,2154,1564,590,2.650847458,1174,1878,1395,426,0,426,0,92,0,0.004694836,empty,mBC-0814-1
"F7,F10",834289,939135,569731,369404,542353,2,324968,325405,275339,50066,5.499520633,187766,159152,117518,32594,16,32578,1,2151,0,3.06956E-05,mm10,mBC-0814-1
"F7,F11",4523,4867,3259,1608,2846,0,1513,1514,1052,462,2.277056277,808,1547,1109,323,0,323,0,59,0,0,empty,mBC-0814-1
"F7,F12",5081,5716,3597,2119,3370,0,1952,1952,1382,570,2.424561404,1063,36,26,10,0,10,0,8,0,0,empty,mBC-0814-1
"F7,G1",450195,519253,302671,216582,310045,2,192368,192583,154742,37841,4.089268254,114184,118595,84522,23438,18,23420,1,1731,0,0.000683177,mm10,mBC-0814-1
"F7,G2",5960,6286,4349,1937,3775,0,2024,2028,1439,589,2.443123939,1060,698,287,95,0,95,0,30,0,0,empty,mBC-0814-1
"F7,G3",5330,5915,3818,2097,3471,0,1936,1940,1423,517,2.752417795,1082,2180,1605,462,0,462,0,102,0,0,empty,mBC-0814-1
"F7,G4",5486,5696,3951,1745,3379,0,1795,1795,1340,455,2.945054945,893,0,0,0,0,0,0,0,0,0,empty,mBC-0814-1
"F7,G5",4794,5159,3492,1667,3070,0,1656,1658,1212,446,2.717488789,890,1052,727,219,0,219,0,61,0,0,empty,mBC-0814-1
"F7,G6",9697,10209,6920,3289,5906,0,3122,3128,2270,858,2.645687646,1609,133,115,40,0,40,0,17,0,0,empty,mBC-0814-1
"F7,G7",407411,446955,276646,170309,269308,0,160394,160598,134084,26514,5.057101908,92380,18090,12677,3499,1,3498,1,507,0,0,mm10,mBC-0814-1
"F7,G8",374999,444164,244976,199188,265048,0,169107,169269,134509,34760,3.869649022,104323,297312,217884,61753,37,61716,3,2886,0,0.000388878,mm10,mBC-0814-1
"F7,G9",390043,461317,255413,205904,276833,0,180025,180212,144562,35650,4.055035063,110310,134957,93933,26145,18,26127,2,1809,0,0.000191373,mm10,mBC-0814-1
"F7,G10",10017,10740,7327,3413,6444,0,3502,3506,2594,912,2.844298246,1791,2793,2001,612,0,612,0,149,0,0,empty,mBC-0814-1
"F7,G11",9875,10563,7144,3419,6283,3,3318,3330,2407,923,2.60780065,1770,845,583,204,0,204,0,58,0,0,empty,mBC-0814-1
"F7,G12",422526,502269,270753,231516,305248,0,203993,204190,156858,47332,3.31399476,126986,43968,32378,9159,3,9156,2,866,0,0.000436872,mm10,mBC-0814-1
"F7,H1",4721,5082,3368,1714,2998,1,1644,1645,1161,484,2.398760331,889,2989,1118,347,0,347,0,63,0,0,empty,mBC-0814-1
"F7,H2",446685,501876,302099,199777,299447,1,182834,183035,144520,38515,3.752304297,107709,13981,9698,2731,0,2731,0,433,0,0.009520322,mm10,mBC-0814-1
"F7,H3",5888,6525,4206,2319,3867,1,2126,2133,1484,649,2.286594761,1176,1533,1153,351,0,351,0,74,0,0,empty,mBC-0814-1
"F7,H4",6041,6621,4341,2280,3854,0,2104,2105,1482,623,2.378812199,1144,97,76,28,0,28,0,11,0,0,empty,mBC-0814-1
"F7,H5",7034,7571,4976,2595,4319,0,2363,2366,1703,663,2.568627451,1248,1371,913,253,0,253,0,58,0,0.075098814,empty,mBC-0814-1
"F7,H6",6900,7366,5007,2359,4198,0,2223,2227,1604,623,2.574638844,1155,1666,1206,364,0,364,0,92,0,0.038461538,empty,mBC-0814-1
"F7,H7",5693,6122,4026,2096,3495,0,1826,1830,1312,518,2.532818533,1009,4029,1483,474,0,474,0,81,0,0.073839662,empty,mBC-0814-1
"F7,H8",4761,5274,3353,1921,3099,0,1719,1719,1247,472,2.641949153,964,2265,1568,442,0,442,0,102,0,0,empty,mBC-0814-1
"F7,H9",6257,6646,4425,2221,3937,0,2133,2136,1581,555,2.848648649,1135,4524,1586,507,1,506,1,97,0,0.0256917,empty,mBC-0814-1
"F7,H10",3967,4348,2838,1510,2550,0,1439,1439,1059,380,2.786842105,795,956,700,228,0,228,0,64,0,0,empty,mBC-0814-1
"F7,H11",4223,4552,3013,1539,2761,0,1581,1581,1144,437,2.61784897,838,65,40,18,0,18,0,9,0,0,empty,mBC-0814-1
"F7,H12",247827,290872,160821,130051,175103,0,110088,110209,91993,18216,5.050120773,67519,279724,193847,54418,45,54373,5,2913,0,0.000441396,mm10,mBC-0814-1
"F8,A1",5813,6391,4092,2299,3687,0,2089,2091,1450,641,2.262090484,1139,1154,868,248,0,248,0,58,0,0.060483871,empty,mBC-0814-1
"F8,A2",4495,4714,3318,1396,2748,0,1417,1418,1000,418,2.392344498,697,2801,1501,507,0,507,0,98,0,0.26035503,empty,mBC-0814-1
"F8,A3",4377,4628,3130,1498,2667,0,1413,1414,995,419,2.374701671,735,998,638,204,0,204,0,44,0,0,empty,mBC-0814-1
"F8,A4",5438,5882,4009,1873,3398,1,1781,1788,1243,545,2.280733945,936,389,252,82,0,82,0,25,0,0.012195122,empty,mBC-0814-1
"F8,A5",4649,4892,3392,1500,2852,0,1473,1474,1023,451,2.268292683,760,1402,1084,271,0,271,0,45,0,0.044280443,empty,mBC-0814-1
"F8,A6",3655,3768,2588,1180,2217,0,1189,1190,844,346,2.439306358,645,1079,784,257,0,257,0,44,0,0,empty,mBC-0814-1
"F8,A7",5023,5471,3600,1871,3246,5,1749,1759,1253,506,2.476284585,982,1642,1126,307,0,307,0,65,0,0.003257329,empty,mBC-0814-1
"F8,A8",2027,2235,1443,792,1301,0,730,730,496,234,2.11965812,392,1012,734,190,0,190,0,52,0,0,empty,mBC-0814-1
"F8,A9",6261,6668,4450,2218,3860,0,2084,2090,1456,634,2.296529968,1097,9751,3771,1176,1,1175,1,136,0,0.136170213,empty,mBC-0814-1
"F8,A10",3146,3417,2321,1096,2037,0,1147,1149,770,379,2.031662269,560,98,61,30,0,30,0,10,0,0,empty,mBC-0814-1
"F8,A11",4055,4370,2882,1488,2625,0,1395,1395,1040,355,2.929577465,743,1114,757,249,0,249,0,59,0,0,empty,mBC-0814-1
"F8,A12",3192,3413,2272,1141,1985,0,1040,1042,747,295,2.53220339,580,5803,2844,858,2,856,2,167,0,0.007009346,empty,mBC-0814-1
"F8,B1",4368,4717,3068,1649,2831,0,1519,1522,1071,451,2.374722838,856,974,587,186,0,186,0,58,0,0,empty,mBC-0814-1
"F8,B2",1268836,1450718,824979,625739,843347,0,532343,532880,439027,93853,4.677815307,320152,100063,72870,20765,10,20755,1,1587,0,0.000337268,mm10,mBC-0814-1
"F8,B3",4495,4880,3168,1712,2934,0,1672,1672,1222,450,2.715555556,891,1139,803,236,0,236,0,50,0,0,empty,mBC-0814-1
"F8,B4",346169,406905,228070,178835,243062,1,154183,154298,128836,25462,5.059932448,93681,117691,84353,24150,19,24131,2,1747,0,8.28809E-05,mm10,mBC-0814-1
"F8,B5",16006,10311,6570,3741,7348,0,3926,3948,3035,913,3.324205915,2314,6052,4245,1157,2,1155,1,183,0,0.000865801,empty,mBC-0814-1
"F8,B6",485217,537695,329354,208341,313190,0,184184,184397,154014,30383,5.069084686,106028,121029,84728,24166,9,24157,3,1928,0,0.001283272,mm10,mBC-0814-1
"F8,B7",535668,632665,355104,277561,374014,0,237936,238166,203118,35048,5.795423419,143797,236373,168722,47727,31,47696,5,2585,0,0.000482221,mm10,mBC-0814-1
"F8,B8",3608,3794,2653,1141,2204,0,1153,1155,815,340,2.397058824,582,972,714,231,0,231,0,50,0,0.034632035,empty,mBC-0814-1
"F8,B9",4293,4521,3097,1424,2648,0,1444,1446,1031,415,2.484337349,745,801,579,148,0,148,0,48,0,0,empty,mBC-0814-1
"F8,B10",4028,4113,2837,1276,2454,1,1300,1301,911,390,2.335897436,676,1890,839,242,0,242,0,31,0,0.260330579,empty,mBC-0814-1
"F8,B11",5806,6121,4138,1983,3595,0,1915,1924,1375,549,2.504553734,1015,147,91,30,0,30,0,7,0,0,empty,mBC-0814-1
"F8,B12",5043,5695,3578,2117,3322,0,1868,1870,1309,561,2.333333333,1074,1136,706,211,0,211,0,54,0,0,empty,mBC-0814-1
"F8,C1",5436,5750,4046,1704,3320,0,1719,1723,1225,498,2.459839357,863,496,329,99,0,99,0,24,0,0.070707071,empty,mBC-0814-1
"F8,C2",4903,5055,3531,1524,3013,0,1603,1603,1135,468,2.425213675,823,957,673,266,0,266,0,68,0,0,empty,mBC-0814-1
"F8,C3",576118,667814,379647,288167,394244,0,256766,256992,184159,72833,2.528510428,155041,16410,9927,2756,3,2753,1,341,0,0.002542681,mm10,mBC-0814-1
"F8,C4",9247,9918,6591,3327,5757,0,3046,3049,2214,835,2.651497006,1604,1843,1260,375,0,375,0,93,0,0.024,empty,mBC-0814-1
"F8,C5",560835,653767,370408,283359,385635,0,244845,245073,207358,37715,5.498024659,147562,189501,127691,35943,30,35913,3,2263,0,0.000389831,mm10,mBC-0814-1
"F8,C6",5916,6224,4170,2054,3759,0,2060,2060,1485,575,2.582608696,1088,1399,987,289,0,289,0,69,0,0.006920415,empty,mBC-0814-1
"F8,C7",6709,7225,4867,2358,4256,0,2261,2261,1661,600,2.768333333,1207,323,233,78,0,78,0,19,0,0,empty,mBC-0814-1
"F8,C8",612516,679182,421009,258173,399687,1,240383,240649,188762,51887,3.637943994,138493,18885,13401,3809,1,3808,1,447,0,0.00262605,mm10,mBC-0814-1
"F8,C9",4366,4594,3062,1532,2701,0,1483,1484,1022,462,2.212121212,780,10042,2195,707,1,706,1,87,0,0.04674221,empty,mBC-0814-1
"F8,C10",5613,6247,4040,2207,3556,0,1908,1909,1361,548,2.483576642,1072,1126,813,246,0,246,0,46,0,0,empty,mBC-0814-1
"F8,C11",4490,4925,3240,1685,2862,0,1603,1606,1154,452,2.553097345,839,1221,926,268,0,268,0,46,0,0,empty,mBC-0814-1
"F8,C12",7631,8174,5468,2706,4754,1,2487,2494,1751,743,2.35666218,1359,2155,1572,404,0,404,0,73,0,0.032178218,empty,mBC-0814-1
"F8,D1",4025,4408,2921,1487,2594,0,1412,1413,995,418,2.380382775,767,789,499,134,0,134,0,31,0,0,empty,mBC-0814-1
"F8,D2",5326,5709,3825,1884,3276,0,1696,1698,1237,461,2.68329718,886,19503,6233,1908,2,1906,2,201,0,0.039349423,empty,mBC-0814-1
"F8,D3",10076,10604,7280,3324,6293,0,3296,3306,2327,979,2.37691522,1733,2396,1646,486,0,486,0,92,0,0,empty,mBC-0814-1
"F8,D4",4341,4578,3142,1436,2734,1,1483,1488,1055,433,2.436489607,750,933,671,213,0,213,0,47,0,0,empty,mBC-0814-1
"F8,D5",3800,3988,2781,1207,2449,0,1311,1311,957,354,2.703389831,681,2442,1650,497,1,496,1,102,0,0,empty,mBC-0814-1
"F8,D6",4746,5230,3467,1763,2994,0,1595,1595,1124,471,2.38641189,878,1220,898,277,0,277,0,61,0,0,empty,mBC-0814-1
"F8,D7",14070,15410,9982,5428,8920,0,5029,5042,3588,1454,2.467675378,2744,2359,1573,473,1,472,1,85,0,0.01059322,empty,mBC-0814-1
"F8,D8",4891,5236,3427,1809,3066,0,1678,1680,1248,432,2.888888889,901,997,706,201,0,201,0,44,0,0,empty,mBC-0814-1
"F8,D9",2849,3036,2046,990,1778,0,961,961,680,281,2.419928826,506,1069,699,228,0,228,0,55,0,0.030701754,empty,mBC-0814-1
"F8,D10",364614,416857,246513,170344,249812,10,155826,155975,119627,36348,3.291157698,92448,27091,12690,3678,3,3675,1,421,0,0.066394558,mm10,mBC-0814-1
"F8,D11",3945,4130,2755,1375,2517,0,1378,1383,1007,376,2.678191489,759,25191,8033,2407,1,2406,1,263,0,0.011221945,empty,mBC-0814-1
"F8,D12",372342,424156,251041,173115,251297,0,153706,153873,128217,25656,4.997544434,90673,149781,105324,29849,16,29833,3,2049,0,0.000569839,mm10,mBC-0814-1
"F8,E1",4804,4992,3382,1610,2964,0,1579,1580,1134,446,2.542600897,842,1910,1294,369,0,369,0,74,0,0.016260163,empty,mBC-0814-1
"F8,E2",3376,3703,2417,1286,2096,0,1128,1128,813,315,2.580952381,620,748,465,157,1,156,1,45,0,0.038461538,empty,mBC-0814-1
"F8,E3",3541,3654,2571,1083,2156,0,1105,1106,773,333,2.321321321,550,1875,1145,366,1,365,1,55,0,0.01369863,empty,mBC-0814-1
"F8,E4",3076,3195,2157,1038,1926,0,1039,1039,735,304,2.417763158,554,659,440,144,0,144,0,40,0,0,empty,mBC-0814-1
"F8,E5",3598,3777,2631,1146,2242,0,1194,1196,840,356,2.359550562,595,1248,788,231,0,231,0,45,0,0,empty,mBC-0814-1
"F8,E6",4449,4687,3164,1523,2676,0,1410,1418,1058,360,2.938888889,734,951,632,176,0,176,0,50,0,0,empty,mBC-0814-1
"F8,E7",4294,4735,3133,1602,2656,1,1405,1408,1029,379,2.715039578,714,4032,1523,433,0,433,0,65,0,0.053117783,empty,mBC-0814-1
"F8,E8",4402,4472,3272,1200,2616,0,1339,1339,916,423,2.165484634,625,1750,1219,383,0,383,0,84,0,0,empty,mBC-0814-1
"F8,E9",2942,3089,2073,1016,1763,0,955,957,721,236,3.055084746,497,1263,910,273,0,273,0,69,0,0,empty,mBC-0814-1
"F8,E10",213107,267906,131465,136441,160799,0,115844,115943,50883,65060,0.782093452,74877,16500,10947,2869,0,2869,0,373,0,0.011153712,empty,mBC-0814-1
"F8,E11",4196,4461,3070,1391,2643,0,1424,1424,988,436,2.266055046,722,2008,1146,316,0,316,0,63,0,0.006329114,empty,mBC-0814-1
"F8,E12",3645,3693,2576,1117,2278,0,1228,1236,886,350,2.531428571,627,830,574,216,0,216,0,47,0,0,empty,mBC-0814-1
"F8,F1",4410,4625,3161,1464,2713,0,1425,1430,995,435,2.287356322,734,1275,917,272,1,271,1,56,0,0.007380074,empty,mBC-0814-1
"F8,F2",6572,7189,4701,2488,4156,0,2260,2261,1609,652,2.467791411,1196,2219,1565,495,1,494,1,97,0,0.012145749,empty,mBC-0814-1
"F8,F3",469712,542067,315087,226980,319523,0,197679,197893,166770,31123,5.358416605,117392,267848,191555,55128,25,55103,4,2907,0,3.62957E-05,mm10,mBC-0814-1
"F8,F4",9755,10889,6887,4002,6425,0,3636,3646,2746,900,3.051111111,2056,1197,816,209,0,209,0,41,0,0,empty,mBC-0814-1
"F8,F5",5145,5440,3661,1779,3142,0,1685,1689,1213,476,2.548319328,912,1070,757,234,0,234,0,51,0,0.004273504,empty,mBC-0814-1
"F8,F6",4360,4585,3069,1516,2679,2,1492,1494,1040,454,2.290748899,802,1707,1282,401,1,400,1,93,0,0,empty,mBC-0814-1
"F8,F7",4289,4565,3179,1386,2691,0,1406,1409,999,410,2.436585366,691,694,508,135,0,135,0,37,0,0,empty,mBC-0814-1
"F8,F8",673530,749695,457344,292351,435775,0,258895,259163,201784,57379,3.51668729,148564,25998,18435,5401,2,5399,1,528,0,0,mm10,mBC-0814-1
"F8,F9",7056,7353,5050,2303,4380,0,2333,2339,1617,722,2.239612188,1195,3560,2518,665,1,664,1,121,0,0.018072289,empty,mBC-0814-1
"F8,F10",6364,6774,4600,2174,4020,2,2123,2127,1508,619,2.436187399,1132,1335,964,310,0,310,0,61,0,0.003225806,empty,mBC-0814-1
"F8,F11",3951,3997,2811,1186,2330,0,1227,1235,866,369,2.346883469,641,863,482,114,0,114,0,28,0,0,empty,mBC-0814-1
"F8,F12",4560,5200,3317,1883,2930,0,1615,1615,1151,464,2.480603448,874,208,161,48,0,48,0,11,0,0,empty,mBC-0814-1
"F8,G1",564469,643508,382293,261215,379391,0,233197,233485,195192,38293,5.097328493,136629,166584,122351,34653,20,34633,1,2168,0,0,mm10,mBC-0814-1
"F8,G2",5958,6098,4155,1943,3525,0,1877,1881,1364,517,2.638297872,973,4101,1389,448,1,447,1,58,0,0.062639821,empty,mBC-0814-1
"F8,G3",4658,4952,3364,1588,2860,0,1560,1564,1087,477,2.278825996,831,2223,1490,472,0,472,0,97,0,0,empty,mBC-0814-1
"F8,G4",5316,5416,3861,1555,3166,6,1661,1673,1179,494,2.386639676,834,2,2,0,0,0,0,0,0,0,empty,mBC-0814-1
"F8,G5",4316,4870,3133,1737,2818,0,1579,1579,1116,463,2.410367171,870,1366,971,269,0,269,0,56,0,0,empty,mBC-0814-1
"F8,G6",8517,9027,6195,2832,5275,3,2679,2690,1882,808,2.329207921,1428,139,83,9,0,9,0,6,0,0,empty,mBC-0814-1
"F8,G7",5148,5529,3687,1842,3205,0,1730,1730,1220,510,2.392156863,884,2304,1468,466,1,465,1,92,0,0.049462366,empty,mBC-0814-1
"F8,G8",6610,7237,4510,2727,4137,3,2272,2283,1582,701,2.256776034,1323,2693,1900,584,0,584,0,128,0,0,empty,mBC-0814-1
"F8,G9",390788,466141,250024,216117,277309,0,184530,184703,128607,56096,2.29262336,115120,132569,94479,25908,20,25888,1,1931,0,0.000502163,mm10,mBC-0814-1
"F8,G10",8438,8982,6090,2892,5273,0,2833,2836,1941,895,2.168715084,1490,2590,1908,644,0,644,0,131,0,0.00310559,empty,mBC-0814-1
"F8,G11",8575,9058,6187,2871,5288,0,2804,2804,2034,770,2.641558442,1466,1338,982,310,0,310,0,66,0,0,empty,mBC-0814-1
"F8,G12",4491,4711,3228,1483,2802,0,1530,1530,1113,417,2.669064748,770,2445,1807,569,2,567,1,100,0,0,empty,mBC-0814-1
"F8,H1",4213,4484,3080,1404,2686,0,1402,1404,1001,403,2.483870968,739,596,395,151,0,151,0,44,0,0,empty,mBC-0814-1
"F8,H2",7701,8100,5547,2553,4755,0,2542,2546,1784,762,2.341207349,1316,3047,2225,699,0,699,0,132,0,0.015736767,empty,mBC-0814-1
"F8,H3",4808,5069,3421,1648,3100,0,1706,1708,1208,500,2.416,933,931,569,160,0,160,0,50,0,0,empty,mBC-0814-1
"F8,H4",4943,5211,3568,1643,3145,0,1685,1688,1249,439,2.845102506,887,113,55,25,0,25,0,14,0,0,empty,mBC-0814-1
"F8,H5",6289,6708,4503,2205,3869,1,2119,2127,1511,616,2.452922078,1132,1697,1149,326,1,325,1,65,0,0.061538462,empty,mBC-0814-1
"F8,H6",5968,6437,4228,2209,3770,0,2041,2044,1475,569,2.592267135,1082,6837,2881,792,0,792,0,127,0,0.027777778,empty,mBC-0814-1
"F8,H7",9527,10968,5876,5092,6568,1,4344,4348,2213,2135,1.036533958,2829,3684,1591,439,2,437,1,78,0,0,empty,mBC-0814-1
"F8,H8",3960,4287,2769,1518,2538,0,1377,1378,1003,375,2.674666667,759,1138,803,245,0,245,0,57,0,0,empty,mBC-0814-1
"F8,H9",4409,4632,3145,1487,2707,0,1417,1417,1042,375,2.778666667,743,1330,893,265,1,264,1,39,0,0.026515152,empty,mBC-0814-1
"F8,H10",3422,3698,2411,1287,2111,0,1137,1139,793,346,2.291907514,627,589,359,113,0,113,0,37,0,0,empty,mBC-0814-1
"F8,H11",3630,3929,2534,1395,2289,0,1275,1278,898,380,2.363157895,687,11,6,5,0,5,0,5,0,0,empty,mBC-0814-1
"F8,H12",2292,2444,1580,864,1403,0,799,799,581,218,2.665137615,406,1454,974,280,0,280,0,55,0,0.078571429,empty,mBC-0814-1
"F9,A1",5812,6175,4186,1989,3553,0,1898,1909,1390,519,2.67822736,997,1995,1382,408,0,408,0,82,0,0,empty,mBC-0814-1
"F9,A2",4841,5229,3416,1813,3015,0,1592,1595,1148,447,2.568232662,876,1689,1102,384,0,384,0,104,0,0.0234375,empty,mBC-0814-1
"F9,A3",4887,5357,3546,1811,3066,0,1721,1721,1229,492,2.49796748,926,1363,973,276,0,276,0,55,0,0.065217391,empty,mBC-0814-1
"F9,A4",540168,620599,364330,256269,365104,0,227923,228154,184348,43806,4.208281971,134893,24452,17605,4813,0,4813,0,499,0,0,mm10,mBC-0814-1
"F9,A5",5066,5271,3686,1585,3117,0,1632,1632,1166,466,2.502145923,828,1898,1342,412,0,412,0,74,0,0,empty,mBC-0814-1
"F9,A6",3777,3998,2705,1293,2307,0,1274,1274,881,393,2.24173028,670,5479,2105,632,1,631,1,96,0,0.031695721,empty,mBC-0814-1
"F9,A7",376252,430576,248135,182441,257653,0,163592,163843,114913,48930,2.348518291,98422,15567,11076,3203,1,3202,1,392,0,0.004996877,mm10,mBC-0814-1
"F9,A8",2132,2305,1479,826,1299,3,719,724,480,244,1.967213115,389,1634,1122,361,1,360,1,78,0,0.036111111,empty,mBC-0814-1
"F9,A9",7535,7975,5364,2611,4627,0,2532,2535,1854,681,2.72246696,1305,9791,3666,1164,1,1163,1,134,0,0.024075666,empty,mBC-0814-1
"F9,A10",3247,3507,2268,1239,2071,0,1172,1175,841,334,2.517964072,660,171,137,41,0,41,0,20,0,0,empty,mBC-0814-1
"F9,A11",208204,227992,140112,87880,137640,1,81778,81868,65078,16790,3.875997618,47280,36644,25698,7244,6,7238,1,797,0,0.00483559,mm10,mBC-0814-1
"F9,A12",3449,3750,2456,1294,2133,0,1110,1114,806,308,2.616883117,583,4188,2796,878,2,876,1,197,0,0,empty,mBC-0814-1
"F9,B1",4316,4547,3123,1424,2743,0,1484,1484,1048,436,2.403669725,791,1585,1153,294,0,294,0,82,0,0.003401361,empty,mBC-0814-1
"F9,B2",4936,5140,3490,1650,3095,0,1613,1614,1146,468,2.448717949,882,700,427,127,0,127,0,30,0,0.047244094,empty,mBC-0814-1
"F9,B3",3916,4320,2821,1499,2637,2,1443,1447,1008,439,2.296127563,813,2030,1403,440,1,439,1,76,0,0,empty,mBC-0814-1
"F9,B4",4856,5217,3456,1761,3073,0,1665,1673,1196,477,2.507337526,866,1764,1268,353,0,353,0,71,0,0.002832861,empty,mBC-0814-1
"F9,B5",3720,2392,1486,906,1735,4,970,978,704,274,2.569343066,584,1408,938,274,0,274,0,65,0,0.047445255,empty,mBC-0814-1
"F9,B6",3790,4136,2683,1453,2449,0,1364,1364,1001,363,2.757575758,757,1039,726,240,0,240,0,58,0,0,empty,mBC-0814-1
"F9,B7",5149,5434,3733,1701,3264,0,1769,1772,1263,509,2.481335953,905,1126,837,272,2,270,1,61,0,0,empty,mBC-0814-1
"F9,B8",3692,3828,2675,1153,2258,1,1189,1191,869,322,2.698757764,576,849,523,194,0,194,0,64,0,0.015463918,empty,mBC-0814-1
"F9,B9",4811,5339,3380,1959,3064,0,1699,1700,1219,481,2.534303534,973,19670,6023,1872,3,1869,2,211,0,0.080791867,empty,mBC-0814-1
"F9,B10",4013,4262,2838,1424,2567,0,1363,1368,920,448,2.053571429,728,470,288,107,0,107,0,30,0,0,empty,mBC-0814-1
"F9,B11",559289,635381,376313,259068,370005,2,227499,227752,179309,48443,3.701442933,133390,7154,5105,1338,1,1337,1,185,0,0,mm10,mBC-0814-1
"F9,B12",6180,5765,3780,1985,3394,0,1903,1911,1380,531,2.598870056,1018,20125,6023,1891,3,1888,1,205,0,0.02595339,empty,mBC-0814-1
"F9,C1",5555,5772,4116,1656,3429,0,1788,1790,1298,492,2.638211382,866,656,407,136,0,136,0,49,0,0,empty,mBC-0814-1
"F9,C2",5276,5720,3719,2001,3210,0,1722,1729,1229,500,2.458,947,1673,1215,400,0,400,0,102,0,0,empty,mBC-0814-1
"F9,C3",5857,6323,4285,2038,3662,10,1936,1949,1422,527,2.69829222,1008,445,236,75,0,75,0,26,0,0.226666667,empty,mBC-0814-1
"F9,C4",4763,4977,3492,1485,2928,0,1517,1522,1071,451,2.374722838,797,1777,1248,319,0,319,0,92,0,0,empty,mBC-0814-1
"F9,C5",7021,7398,5003,2395,4356,0,2315,2317,1668,649,2.570107858,1194,10842,4202,1223,1,1222,1,181,0,0.031914894,empty,mBC-0814-1
"F9,C6",5455,5725,3993,1732,3435,0,1825,1826,1325,501,2.644710579,921,1436,930,308,0,308,0,76,0,0.003246753,empty,mBC-0814-1
"F9,C7",7277,7768,5155,2613,4487,0,2406,2410,1733,677,2.559822747,1264,635,510,136,1,135,1,31,0,0.051851852,empty,mBC-0814-1
"F9,C8",551197,626594,363513,263081,369560,0,232331,232599,185340,47259,3.921792674,138366,233465,170430,47870,24,47846,4,2619,0,0.000271705,mm10,mBC-0814-1
"F9,C9",4619,5026,3343,1683,2892,2,1531,1538,1101,437,2.519450801,796,1520,883,296,0,296,0,72,0,0.057432432,empty,mBC-0814-1
"F9,C10",5883,6391,4328,2063,3682,0,1936,1936,1392,544,2.558823529,1005,1554,1184,303,0,303,0,65,0,0,empty,mBC-0814-1
"F9,C11",455709,540620,301217,239403,320807,1,204429,204645,168033,36612,4.5895608,125023,240999,171418,47667,21,47646,2,2628,0,0,mm10,mBC-0814-1
"F9,C12",8114,8900,5705,3195,5081,1,2775,2782,1941,841,2.307966706,1552,2690,1906,554,0,554,0,94,0,0,empty,mBC-0814-1
"F9,D1",4263,4507,3113,1394,2562,0,1359,1363,994,369,2.693766938,671,781,518,158,0,158,0,38,0,0,empty,mBC-0814-1
"F9,D2",5384,5561,3862,1699,3229,1,1691,1694,1231,463,2.6587473,874,2034,1437,406,0,406,0,88,0,0.012315271,empty,mBC-0814-1
"F9,D3",10730,11627,7692,3935,6831,0,3718,3732,2672,1060,2.520754717,2001,13268,4611,1400,5,1395,2,155,0,0.035125448,empty,mBC-0814-1
"F9,D4",4881,5347,3472,1875,3109,0,1690,1693,1191,502,2.37250996,923,895,569,251,0,251,0,78,0,0.011952191,empty,mBC-0814-1
"F9,D5",3927,4190,2682,1508,2492,0,1432,1434,1006,428,2.35046729,807,2279,1541,462,1,461,1,127,0,0,empty,mBC-0814-1
"F9,D6",4905,5239,3550,1689,3009,0,1600,1604,1140,464,2.456896552,831,1345,944,293,0,293,0,69,0,0,empty,mBC-0814-1
"F9,D7",6124,6627,4493,2134,3791,0,2019,2024,1410,614,2.296416938,1004,3683,2753,841,0,841,0,149,0,0.021403092,empty,mBC-0814-1
"F9,D8",5194,5576,3679,1897,3213,12,1725,1740,1245,495,2.515151515,907,1677,848,245,0,245,0,62,0,0.004081633,empty,mBC-0814-1
"F9,D9",3134,3268,2210,1058,1959,1,1078,1079,762,317,2.403785489,544,1663,1018,311,0,311,0,60,0,0.032154341,empty,mBC-0814-1
"F9,D10",3638,4002,2535,1467,2296,0,1287,1287,955,332,2.876506024,710,786,560,189,0,189,0,54,0,0,empty,mBC-0814-1
"F9,D11",426907,502071,281199,220872,298573,3,191749,191931,150284,41647,3.608519221,116283,176482,119446,33500,14,33486,2,2225,0,2.98632E-05,mm10,mBC-0814-1
"F9,D12",532072,624505,350832,273673,368307,0,234208,234454,196689,37765,5.208235138,142178,340317,241021,65614,31,65583,3,3265,0,0.000289709,mm10,mBC-0814-1
"F9,E1",5011,5138,3632,1506,3062,0,1557,1562,1099,463,2.373650108,789,7584,2801,780,1,779,1,123,0,0,empty,mBC-0814-1
"F9,E2",3273,3563,2322,1241,2154,0,1146,1146,801,345,2.32173913,655,1574,1167,411,0,411,0,79,0,0,empty,mBC-0814-1
"F9,E3",474901,547453,317935,229518,322721,2,202672,202903,149411,53492,2.793146639,120756,129884,95248,27091,14,27077,1,1823,0,0.000664771,mm10,mBC-0814-1
"F9,E4",3953,4202,2681,1521,2441,0,1394,1394,895,499,1.793587174,759,5424,2125,717,1,716,1,114,0,0.040502793,empty,mBC-0814-1
"F9,E5",3918,4310,2812,1498,2449,1,1309,1315,957,358,2.673184358,707,1442,1014,296,1,295,1,48,0,0.023728814,empty,mBC-0814-1
"F9,E6",4192,4628,3036,1592,2694,0,1487,1489,1076,413,2.605326877,807,1418,1025,273,0,273,0,60,0,0,empty,mBC-0814-1
"F9,E7",6086,6740,4440,2300,3851,0,2039,2042,1480,562,2.633451957,1091,11684,3873,1261,1,1260,1,157,0,0.11984127,empty,mBC-0814-1
"F9,E8",4714,4949,3432,1517,2877,0,1500,1503,1058,445,2.37752809,771,1862,1173,358,0,358,0,81,0,0,empty,mBC-0814-1
"F9,E9",323086,372820,214186,158634,221478,0,137863,137988,111828,26160,4.274770642,82217,198890,140641,39556,19,39537,4,2388,0,0.000531148,mm10,mBC-0814-1
"F9,E10",363023,428481,241715,186766,255500,0,161527,161714,134441,27273,4.929454039,97704,154785,105934,29746,15,29731,3,2077,0,6.72699E-05,mm10,mBC-0814-1
"F9,E11",3968,4168,2920,1248,2470,0,1284,1286,924,362,2.552486188,661,1270,876,295,1,294,1,76,0,0,empty,mBC-0814-1
"F9,E12",3996,4203,2793,1410,2403,0,1310,1310,931,379,2.45646438,704,1547,1085,394,0,394,0,77,0,0,empty,mBC-0814-1
"F9,F1",597259,676060,408082,267978,392868,1,231576,231817,201558,30259,6.661092568,134161,445457,324476,91964,49,91915,2,3786,0,0.000195833,mm10,mBC-0814-1
"F9,F2",6531,6994,4699,2295,4031,0,2168,2169,1590,579,2.74611399,1149,2432,1668,582,0,582,0,134,0,0.015463918,empty,mBC-0814-1
"F9,F3",5278,5632,3772,1860,3301,0,1785,1794,1296,498,2.602409639,950,2181,1474,486,1,485,1,104,0,0.022680412,empty,mBC-0814-1
"F9,F4",5121,5481,3693,1788,3219,0,1720,1722,1214,508,2.38976378,926,549,331,128,0,128,0,39,0,0,empty,mBC-0814-1
"F9,F5",5116,5255,3707,1548,3081,1,1638,1639,1182,457,2.58643326,815,1399,916,307,0,307,0,89,0,0,empty,mBC-0814-1
"F9,F6",4942,5253,3504,1749,3060,5,1631,1642,1135,507,2.238658777,881,2705,1668,569,0,569,0,140,0,0,empty,mBC-0814-1
"F9,F7",4589,4821,3314,1507,2806,0,1505,1509,1057,452,2.338495575,770,488,303,95,0,95,0,32,0,0,empty,mBC-0814-1
"F9,F8",6206,6717,4409,2308,3901,0,2103,2103,1508,595,2.534453782,1140,91,73,16,0,16,0,10,0,0,empty,mBC-0814-1
"F9,F9",5521,5851,4031,1820,3464,0,1861,1868,1310,558,2.347670251,934,1883,1369,391,0,391,0,83,0,0,empty,mBC-0814-1
"F9,F10",6567,6874,4788,2086,4058,0,2108,2113,1528,585,2.611965812,1036,1579,1198,361,0,361,0,83,0,0.005540166,empty,mBC-0814-1
"F9,F11",4243,4436,3052,1384,2606,0,1410,1416,1014,402,2.52238806,709,1980,1521,410,0,410,0,74,0,0,empty,mBC-0814-1
"F9,F12",401226,463753,268699,195054,276370,0,174703,174894,139400,35494,3.927424353,105253,2072,1163,350,1,349,1,60,0,0,empty,mBC-0814-1
"F9,G1",7240,7667,5149,2518,4526,0,2369,2373,1677,696,2.409482759,1280,4293,3216,840,2,838,1,189,0,0.050119332,empty,mBC-0814-1
"F9,G2",5592,5911,4057,1854,3500,1,1822,1825,1298,527,2.462998102,972,248,139,70,0,70,0,34,0,0.014285714,empty,mBC-0814-1
"F9,G3",4931,5331,3518,1813,3135,0,1749,1752,1232,520,2.369230769,936,2758,2054,595,0,595,0,125,0,0.006722689,empty,mBC-0814-1
"F9,G4",5141,5609,3676,1933,3175,0,1727,1729,1306,423,3.087470449,911,3,2,2,0,2,0,1,0,0,empty,mBC-0814-1
"F9,G5",454698,538582,301435,237147,317758,1,201030,201271,163722,37549,4.360222642,122779,222329,157193,44468,20,44448,2,2538,0,0.000427466,mm10,mBC-0814-1
"F9,G6",20942,23242,15013,8229,13591,0,7548,7551,5624,1927,2.918526207,4081,377,279,63,0,63,0,22,0,0,empty,mBC-0814-1
"F9,G7",7553,8379,5501,2878,5075,0,2777,2781,1978,803,2.463262765,1514,2714,1909,502,0,502,0,111,0,0,empty,mBC-0814-1
"F9,G8",7020,7696,4964,2732,4468,0,2479,2481,1724,757,2.277410832,1334,15523,5451,1759,5,1754,1,258,0,0.021664766,empty,mBC-0814-1
"F9,G9",5018,5555,3519,2036,3269,5,1821,1827,1288,539,2.38961039,1032,4425,2451,710,0,710,0,158,0,0.014084507,empty,mBC-0814-1
"F9,G10",8486,9080,5953,3127,5388,0,2887,2887,2081,806,2.581885856,1578,4068,2956,830,0,830,0,199,0,0,empty,mBC-0814-1
"F9,G11",355554,394028,251216,142812,226920,1,129355,129511,112023,17488,6.40570677,71712,29576,19993,5466,2,5464,1,581,0,0.001281113,mm10,mBC-0814-1
"F9,G12",4735,5173,3345,1828,3103,0,1760,1766,1303,463,2.81425486,955,3183,2300,608,0,608,0,125,0,0,empty,mBC-0814-1
"F9,H1",4318,4592,3081,1511,2667,0,1484,1488,1069,419,2.551312649,786,1092,764,196,0,196,0,61,0,0.005102041,empty,mBC-0814-1
"F9,H2",11532,12526,8040,4486,7398,0,4174,4178,3052,1126,2.710479574,2281,3046,2085,678,0,678,0,160,0,0,empty,mBC-0814-1
"F9,H3",5016,5414,3578,1836,3182,0,1719,1722,1237,485,2.550515464,885,1638,1011,305,1,304,1,89,0,0.006578947,empty,mBC-0814-1
"F9,H4",315775,352014,203565,148449,207576,1,132109,132236,85266,46970,1.815328933,78966,896,559,177,0,177,0,38,0,0,empty,mBC-0814-1
"F9,H5",6765,7216,4818,2398,4130,0,2207,2210,1564,646,2.421052632,1139,1837,1320,422,0,422,0,89,0,0,empty,mBC-0814-1
"F9,H6",472998,548874,313741,235133,325049,0,205084,205282,157067,48215,3.257637665,123885,270782,198023,56172,46,56126,2,2863,0,0.000142536,mm10,mBC-0814-1
"F9,H7",5125,5627,3617,2010,3317,0,1836,1836,1336,500,2.672,1017,2037,1421,478,1,477,1,89,0,0.002096436,empty,mBC-0814-1
"F9,H8",9881,10792,6866,3926,6520,0,3708,3720,2884,836,3.449760766,2061,1836,1272,450,0,450,0,116,0,0.004444444,empty,mBC-0814-1
"F9,H9",801490,909542,537244,372298,535599,0,330598,330958,256235,74723,3.429131593,197035,227425,166057,46893,23,46870,2,2647,0,0.00034137,mm10,mBC-0814-1
"F9,H10",3390,3669,2399,1270,2152,0,1172,1174,847,327,2.590214067,660,1142,732,211,0,211,0,45,0,0.004739336,empty,mBC-0814-1
"F9,H11",3493,3679,2479,1200,2274,0,1272,1272,922,350,2.634285714,665,64,41,21,0,21,0,13,0,0,empty,mBC-0814-1
"F9,H12",311077,356992,204796,152196,214878,0,134180,134324,104660,29664,3.528182309,80725,150896,106654,30133,19,30114,3,1878,0,0.00023245,mm10,mBC-0814-1
"F10,A1",6869,7536,4906,2630,4303,0,2360,2362,1688,674,2.504451039,1249,1931,1266,381,0,381,0,75,0,0.010498688,empty,mBC-0814-1
"F10,A2",472867,529504,312965,216539,310822,1,191781,192026,161233,30793,5.236027669,112270,142484,103583,30386,16,30370,4,2031,0,9.87817E-05,mm10,mBC-0814-1
"F10,A3",5424,5850,3905,1945,3471,0,1884,1889,1335,554,2.409747292,985,776,441,155,0,155,0,36,0,0,empty,mBC-0814-1
"F10,A4",6321,6869,4677,2192,3996,0,2168,2172,1556,616,2.525974026,1132,640,489,145,0,145,0,25,0,0.020689655,empty,mBC-0814-1
"F10,A5",5664,6033,4085,1948,3563,0,1949,1952,1419,533,2.662288931,1013,1967,1430,349,1,348,1,60,0,0.051724138,empty,mBC-0814-1
"F10,A6",6642,7201,4604,2597,4337,0,2518,2519,1849,670,2.759701493,1371,1315,870,258,0,258,0,58,0,0,empty,mBC-0814-1
"F10,A7",6519,6848,4711,2137,4043,0,2169,2172,1578,594,2.656565657,1101,1955,1452,424,0,424,0,85,0,0.049528302,empty,mBC-0814-1
"F10,A8",2579,2872,1725,1147,1716,0,1013,1014,740,274,2.700729927,570,2166,1570,466,1,465,1,88,0,0.002150538,empty,mBC-0814-1
"F10,A9",7601,7980,5419,2561,4728,0,2499,2508,1796,712,2.52247191,1332,1357,923,310,1,309,1,57,0,0,empty,mBC-0814-1
"F10,A10",318233,382273,205567,176706,230674,0,152744,152903,118051,34852,3.387208769,94677,12246,8248,2253,4,2249,2,311,0,0.002667852,mm10,mBC-0814-1
"F10,A11",328663,380848,218802,162046,226775,0,140418,140586,119360,21226,5.623292189,83839,213400,154046,43584,24,43560,1,2395,0,0.000895317,mm10,mBC-0814-1
"F10,A12",5388,5789,3808,1981,3434,0,1930,1932,1392,540,2.577777778,1011,3495,2305,665,0,665,0,153,0,0,empty,mBC-0814-1
"F10,B1",5561,6100,4022,2078,3577,0,1874,1882,1329,553,2.403254973,1015,1706,1212,382,0,382,0,76,0,0,empty,mBC-0814-1
"F10,B2",5574,5860,3827,2033,3504,0,1961,1962,1407,555,2.535135135,1091,478,346,116,0,116,0,30,0,0,empty,mBC-0814-1
"F10,B3",4471,4951,3183,1768,3017,0,1709,1712,1247,465,2.68172043,966,1077,766,236,0,236,0,52,0,0.012711864,empty,mBC-0814-1
"F10,B4",5014,5415,3515,1900,3187,0,1781,1783,1261,522,2.415708812,936,1346,1047,280,1,279,1,62,0,0.003584229,empty,mBC-0814-1
"F10,B5",4175,2828,1773,1055,2005,0,1118,1124,806,318,2.534591195,651,2835,1175,350,0,350,0,63,0,0.04,empty,mBC-0814-1
"F10,B6",4689,5033,3342,1691,2929,0,1603,1605,1128,477,2.364779874,856,3752,1698,479,1,478,1,74,0,0.008368201,empty,mBC-0814-1
"F10,B7",6240,6856,4501,2355,3990,0,2183,2187,1558,629,2.476947536,1174,1342,890,235,0,235,0,57,0,0,empty,mBC-0814-1
"F10,B8",471452,544783,315605,229178,322969,0,201632,201867,165567,36300,4.56107438,119993,118516,84866,24210,17,24193,3,1809,0,0.001033357,mm10,mBC-0814-1
"F10,B9",5659,6162,3982,2180,3595,0,2001,2001,1463,538,2.719330855,1088,1383,1011,278,0,278,0,61,0,0,empty,mBC-0814-1
"F10,B10",6359,5875,4006,1869,3475,0,1902,1910,1334,576,2.315972222,1010,46553,13355,4267,8,4259,2,412,0,0.08405729,empty,mBC-0814-1
"F10,B11",651531,742508,435930,306578,429440,1,264601,264946,210663,54283,3.880828252,156538,17185,12153,3449,1,3448,1,410,0,0,mm10,mBC-0814-1
"F10,B12",6170,6790,4286,2504,3965,0,2213,2214,1579,635,2.486614173,1230,1533,1002,280,1,279,1,63,0,0,empty,mBC-0814-1
"F10,C1",6225,6741,4518,2223,3906,1,2048,2054,1486,568,2.616197183,1108,805,606,192,0,192,0,36,0,0.005208333,empty,mBC-0814-1
"F10,C2",6470,6908,4448,2460,3960,0,2172,2175,1551,624,2.485576923,1176,17029,5204,1708,0,1708,0,165,0,0.088992974,empty,mBC-0814-1
"F10,C3",6968,7431,4914,2517,4404,0,2431,2433,1772,661,2.680786687,1307,12204,3395,1018,10,1008,2,105,0,0.098214286,empty,mBC-0814-1
"F10,C4",5978,6503,4271,2232,3793,0,2030,2030,1461,569,2.567662566,1104,1627,1244,363,0,363,0,77,0,0,empty,mBC-0814-1
"F10,C5",9494,10291,6810,3481,6200,0,3377,3384,2460,924,2.662337662,1879,1524,1031,336,0,336,0,67,0,0,empty,mBC-0814-1
"F10,C6",7044,7569,4983,2586,4615,0,2587,2589,1928,661,2.916792738,1358,3416,1736,531,1,530,1,86,0,0.016981132,empty,mBC-0814-1
"F10,C7",830831,945150,563920,381230,540647,1,323572,323941,273999,49942,5.486344159,187387,94722,66638,18705,11,18694,1,1431,0,0,mm10,mBC-0814-1
"F10,C8",6542,6891,4723,2168,4075,0,2167,2171,1544,627,2.462519936,1122,2541,1802,444,0,444,0,95,0,0,empty,mBC-0814-1
"F10,C9",5308,5885,3818,2067,3447,0,1868,1870,1284,586,2.19112628,1026,1251,916,302,0,302,0,53,0,0,empty,mBC-0814-1
"F10,C10",875027,998846,597138,401708,573440,0,350902,351334,265822,85512,3.108592946,203964,168716,125129,36512,21,36491,2,2338,0,8.22121E-05,mm10,mBC-0814-1
"F10,C11",5482,6110,3915,2195,3552,0,2032,2033,1417,616,2.300324675,1099,1797,1195,315,0,315,0,55,0,0.120634921,empty,mBC-0814-1
"F10,C12",9801,10524,7117,3407,5989,0,3165,3168,2255,913,2.469879518,1666,2698,1948,528,1,527,1,87,0,0.003795066,empty,mBC-0814-1
"F10,D1",1088716,1245882,717918,527964,726790,2,462890,463414,380586,82828,4.594895446,276442,92144,60881,17141,8,17133,2,1366,0,0.001225705,mm10,mBC-0814-1
"F10,D2",5832,6356,4292,2064,3639,1,1853,1861,1321,540,2.446296296,966,1917,1356,345,0,345,0,77,0,0,empty,mBC-0814-1
"F10,D3",12597,13675,9058,4617,7965,0,4325,4331,3065,1266,2.421011058,2319,3049,2131,552,0,552,0,101,0,0.005434783,empty,mBC-0814-1
"F10,D4",5191,5770,3616,2154,3356,0,1884,1886,1342,544,2.466911765,1031,2036,1414,406,0,406,0,80,0,0.041871921,empty,mBC-0814-1
"F10,D5",312900,371172,202089,169083,223538,0,148124,148289,114369,33920,3.371727594,91991,29841,20269,5828,1,5827,1,653,0,0.001201304,mm10,mBC-0814-1
"F10,D6",507117,580735,347556,233179,343444,0,211380,211627,165715,45912,3.609404949,123991,51293,34848,10130,2,10128,1,977,0,0.010169826,mm10,mBC-0814-1
"F10,D7",7044,7602,4955,2647,4393,0,2372,2374,1749,625,2.7984,1286,23063,7423,2273,3,2270,2,225,0,0.050220264,empty,mBC-0814-1
"F10,D8",5671,6303,4109,2194,3657,0,1952,1956,1405,551,2.549909256,1060,1283,920,246,0,246,0,51,0,0,empty,mBC-0814-1
"F10,D9",3619,3854,2589,1265,2258,0,1244,1247,855,392,2.181122449,674,1476,1060,323,0,323,0,53,0,0,empty,mBC-0814-1
"F10,D10",664677,772832,447714,325118,451235,0,280007,280356,238447,41909,5.689637071,166533,102946,75036,21416,10,21406,5,1627,0,0.004064281,mm10,mBC-0814-1
"F10,D11",407648,474465,270534,203931,284560,0,182189,182418,140211,42207,3.321984505,110272,43084,29830,8616,1,8615,1,865,0,0.003250145,mm10,mBC-0814-1
"F10,D12",7340,8061,5258,2803,4703,0,2579,2583,1829,754,2.425729443,1416,3258,2017,580,0,580,0,114,0,0,empty,mBC-0814-1
"F10,E1",5533,5902,4047,1855,3422,0,1738,1742,1204,538,2.237918216,921,1542,1071,307,0,307,0,69,0,0.022801303,empty,mBC-0814-1
"F10,E2",4194,4590,3052,1538,2727,2,1473,1476,1051,425,2.472941176,799,1359,1013,214,0,214,0,61,0,0.056074766,empty,mBC-0814-1
"F10,E3",3905,4275,2833,1442,2508,0,1361,1362,980,382,2.565445026,683,1511,1035,327,0,327,0,66,0,0,empty,mBC-0814-1
"F10,E4",3665,3783,2637,1146,2257,0,1236,1236,844,392,2.153061224,623,2440,1336,378,0,378,0,60,0,0.116402116,empty,mBC-0814-1
"F10,E5",4344,4632,3157,1475,2612,0,1305,1307,923,384,2.403645833,703,1341,983,277,0,277,0,46,0,0.003610108,empty,mBC-0814-1
"F10,E6",5006,5388,3680,1708,3164,0,1667,1671,1220,451,2.705099778,886,1487,939,269,0,269,0,47,0,0.033457249,empty,mBC-0814-1
"F10,E7",4905,5295,3593,1702,3109,1,1639,1642,1167,475,2.456842105,891,4623,1624,487,0,487,0,59,0,0.108829569,empty,mBC-0814-1
"F10,E8",5310,5664,3873,1791,3301,0,1690,1701,1211,490,2.471428571,876,2578,1847,579,0,579,0,92,0,0.001727116,empty,mBC-0814-1
"F10,E9",4062,4359,2895,1464,2484,0,1413,1414,1036,378,2.740740741,739,1077,754,215,0,215,0,63,0,0,empty,mBC-0814-1
"F10,E10",4693,5276,3307,1969,3025,0,1670,1675,1187,488,2.432377049,938,2148,1534,426,0,426,0,76,0,0.011737089,empty,mBC-0814-1
"F10,E11",4857,5197,3491,1706,3062,0,1652,1656,1184,472,2.508474576,860,1793,1318,382,1,381,1,71,0,0,empty,mBC-0814-1
"F10,E12",4766,5112,3441,1671,2991,0,1574,1580,1106,474,2.333333333,869,1272,900,225,1,224,1,43,0,0.035714286,empty,mBC-0814-1
"F10,F1",5460,5768,4013,1755,3370,0,1792,1795,1300,495,2.626262626,883,1278,944,311,1,310,1,60,0,0,empty,mBC-0814-1
"F10,F2",7449,8392,5222,3170,4733,0,2631,2640,1882,758,2.482849604,1475,2530,1816,492,1,491,1,105,0,0.00203666,empty,mBC-0814-1
"F10,F3",6091,6737,4312,2425,3810,0,2060,2068,1531,537,2.851024209,1146,7480,2933,1016,0,1016,0,158,0,0.085629921,empty,mBC-0814-1
"F10,F4",6356,6580,4582,1998,3891,0,2017,2020,1466,554,2.646209386,1042,569,423,138,0,138,0,31,0,0,empty,mBC-0814-1
"F10,F5",6360,6813,4572,2241,4020,0,2205,2206,1588,618,2.569579288,1189,1626,1279,337,0,337,0,51,0,0,empty,mBC-0814-1
"F10,F6",6399,6889,4401,2488,3971,0,2255,2257,1534,723,2.121715076,1199,69513,22784,7596,12,7584,4,588,0,0.149920886,empty,mBC-0814-1
"F10,F7",5368,5751,3840,1911,3437,0,1862,1862,1318,544,2.422794118,1008,1171,923,283,0,283,0,45,0,0,empty,mBC-0814-1
"F10,F8",7923,8260,5755,2505,4845,0,2605,2610,1907,703,2.712660028,1349,70,52,17,0,17,0,9,0,0,empty,mBC-0814-1
"F10,F9",6176,6528,4472,2056,3905,1,2107,2111,1504,607,2.477759473,1112,1709,1209,363,0,363,0,74,0,0,empty,mBC-0814-1
"F10,F10",7055,7502,5051,2451,4432,0,2373,2378,1703,675,2.522962963,1263,3742,1611,474,0,474,0,73,0,0.063291139,empty,mBC-0814-1
"F10,F11",5154,5407,3692,1715,3234,1,1717,1718,1229,489,2.513292434,872,2361,1794,488,0,488,0,75,0,0,empty,mBC-0814-1
"F10,F12",5462,6127,3874,2253,3531,1,1960,1965,1355,610,2.221311475,1096,66,47,29,0,29,0,11,0,0,empty,mBC-0814-1
"F10,G1",8715,9353,6270,3083,5441,0,2930,2933,2074,859,2.41443539,1550,4194,3076,907,0,907,0,161,0,0,empty,mBC-0814-1
"F10,G2",6610,7212,4764,2448,4265,0,2294,2298,1690,608,2.779605263,1239,587,339,89,0,89,0,16,0,0,empty,mBC-0814-1
"F10,G3",6125,6650,4372,2278,3839,0,2088,2092,1508,584,2.582191781,1123,2119,1371,409,0,409,0,104,0,0,empty,mBC-0814-1
"F10,G4",5810,6343,4180,2163,3641,0,1960,1961,1396,565,2.47079646,1044,6,2,2,0,2,0,1,0,0,empty,mBC-0814-1
"F10,G5",5783,6358,4178,2180,3638,0,2008,2014,1436,578,2.484429066,1106,1953,1374,436,0,436,0,71,0,0.059633028,empty,mBC-0814-1
"F10,G6",804155,919661,539803,379858,533071,2,328585,328931,262619,66312,3.960354084,193447,16102,11812,3313,1,3312,1,369,0,0,mm10,mBC-0814-1
"F10,G7",6376,6726,4602,2124,4095,0,2213,2217,1550,667,2.323838081,1169,2517,1753,473,0,473,0,96,0,0.006342495,empty,mBC-0814-1
"F10,G8",340444,388283,226665,161618,233798,0,146623,146806,120774,26032,4.639443762,87961,23589,13965,4017,3,4014,2,512,0,0.017438964,mm10,mBC-0814-1
"F10,G9",6398,6782,4515,2267,3976,0,2173,2177,1564,613,2.551386623,1145,2520,1786,499,0,499,0,113,0,0,empty,mBC-0814-1
"F10,G10",10615,11325,7660,3665,6773,0,3667,3673,2673,1000,2.673,1942,3931,2699,832,0,832,0,163,0,0.003605769,empty,mBC-0814-1
"F10,G11",10278,11155,7377,3778,6501,0,3524,3525,2534,991,2.557013118,1919,1585,1232,375,0,375,0,77,0,0.002666667,empty,mBC-0814-1
"F10,G12",485999,577682,317366,260316,347261,0,226704,226948,182035,44913,4.053058135,139716,134386,93797,26139,18,26121,2,1963,0,0.000153133,mm10,mBC-0814-1
"F10,H1",5383,5733,3943,1790,3373,0,1789,1798,1284,514,2.498054475,937,1028,787,242,0,242,0,50,0,0.004132231,empty,mBC-0814-1
"F10,H2",9405,10466,6709,3757,6126,0,3375,3377,2404,973,2.470709147,1882,4652,3305,930,0,930,0,172,0,0.009677419,empty,mBC-0814-1
"F10,H3",623050,716657,415415,301242,420234,2,262495,262793,218858,43935,4.981404347,156623,159348,114623,31413,24,31389,1,2090,0,6.37166E-05,mm10,mBC-0814-1
"F10,H4",6428,6917,4589,2328,4113,2,2281,2289,1609,680,2.366176471,1247,59,27,11,0,11,0,8,0,0,empty,mBC-0814-1
"F10,H5",7785,8388,5363,3025,4732,0,2624,2625,1831,794,2.30604534,1423,13793,4449,1387,2,1385,2,166,0,0.036101083,empty,mBC-0814-1
"F10,H6",7895,8733,5579,3154,5074,0,2815,2824,1986,838,2.369928401,1568,2993,2058,673,0,673,0,125,0,0.014858841,empty,mBC-0814-1
"F10,H7",6087,6382,4357,2025,3835,0,2024,2028,1409,619,2.276252019,1059,1975,1418,384,1,383,1,68,0,0.033942559,empty,mBC-0814-1
"F10,H8",5510,5888,3877,2011,3465,0,1887,1892,1353,539,2.510204082,1063,2069,1569,454,0,454,0,92,0,0,empty,mBC-0814-1
"F10,H9",6135,6625,4274,2351,3924,0,2110,2121,1529,592,2.58277027,1194,998,685,194,0,194,0,49,0,0.087628866,empty,mBC-0814-1
"F10,H10",4221,4683,2890,1793,2680,0,1556,1558,1074,484,2.219008264,875,1046,673,229,0,229,0,50,0,0.030567686,empty,mBC-0814-1
"F10,H11",310042,354470,206642,147828,214153,3,134312,134453,109243,25210,4.333320111,80160,538,424,151,0,151,0,19,0,0,empty,mBC-0814-1
"F10,H12",3575,4058,2456,1602,2401,0,1360,1365,981,384,2.5546875,803,1195,693,231,0,231,0,58,0,0,empty,mBC-0814-1
"F11,A1",6684,6225,4146,2079,3659,0,1980,1982,1452,530,2.739622642,1046,8406,2673,807,3,804,2,106,0,0.019900498,empty,mBC-0814-1
"F11,A2",5515,5969,3969,2000,3521,0,1835,1839,1328,511,2.598825832,978,1223,874,309,0,309,0,79,0,0.003236246,empty,mBC-0814-1
"F11,A3",5071,5490,3664,1826,3133,0,1692,1697,1169,528,2.214015152,887,991,592,166,0,166,0,52,0,0,empty,mBC-0814-1
"F11,A4",758665,808025,569772,238253,462143,1,237653,238008,188726,49282,3.829511789,124165,56701,40137,11466,5,11461,1,1008,0,0.000261757,mm10,mBC-0814-1
"F11,A5",5079,5511,3560,1951,3239,0,1766,1769,1278,491,2.602851324,948,10007,3160,994,2,992,1,136,0,0.052419355,empty,mBC-0814-1
"F11,A6",10694,11878,7567,4311,7215,0,4056,4064,3042,1022,2.976516634,2244,1278,934,224,0,224,0,53,0,0,empty,mBC-0814-1
"F11,A7",5765,6187,4186,2001,3623,0,1966,1968,1346,622,2.163987138,1005,2066,1475,474,0,474,0,85,0,0.002109705,empty,mBC-0814-1
"F11,A8",2606,2767,1850,917,1590,0,863,865,614,251,2.446215139,457,1193,823,267,0,267,0,63,0,0.003745318,empty,mBC-0814-1
"F11,A9",7141,7568,5103,2465,4386,0,2350,2353,1676,677,2.47562777,1242,10283,3451,1050,2,1048,1,132,0,0.11259542,empty,mBC-0814-1
"F11,A10",3765,3922,2725,1197,2354,0,1246,1247,883,364,2.425824176,649,249,178,48,0,48,0,14,0,0,empty,mBC-0814-1
"F11,A11",295290,342300,197619,144681,205590,1,127818,127957,107283,20674,5.189271549,76385,119365,83714,24008,16,23992,4,1679,0,0.000666889,mm10,mBC-0814-1
"F11,A12",4259,4701,3035,1666,2841,0,1537,1539,1112,427,2.604215457,854,3458,2538,820,1,819,1,177,0,0.017094017,empty,mBC-0814-1
"F11,B1",4889,5247,3496,1751,3121,0,1699,1704,1183,521,2.270633397,943,1048,644,234,0,234,0,57,0,0,empty,mBC-0814-1
"F11,B2",4899,5291,3486,1805,3072,1,1718,1723,1224,499,2.452905812,931,491,293,93,0,93,0,26,0,0.043010753,empty,mBC-0814-1
"F11,B3",4190,4545,2975,1570,2702,0,1459,1459,1079,380,2.839473684,796,897,639,228,0,228,0,41,0,0.01754386,empty,mBC-0814-1
"F11,B4",4482,4775,3228,1547,2801,0,1501,1502,1088,414,2.628019324,814,2735,1352,460,0,460,0,74,0,0.086956522,empty,mBC-0814-1
"F11,B5",379147,252360,145351,107009,181145,2,113707,114170,84361,29809,2.830051327,70333,10542,7148,2035,1,2034,1,277,0,0.004916421,mm10,mBC-0814-1
"F11,B6",4170,4415,2954,1461,2551,0,1379,1379,977,402,2.430348259,714,1496,940,222,0,222,0,50,0,0,empty,mBC-0814-1
"F11,B7",6002,6606,4425,2181,3790,0,2029,2031,1448,583,2.483704974,1057,816,596,189,0,189,0,49,0,0,empty,mBC-0814-1
"F11,B8",4015,4314,2829,1485,2459,0,1295,1297,914,383,2.386422977,698,3088,1022,316,0,316,0,54,0,0,empty,mBC-0814-1
"F11,B9",420212,486416,283652,202764,286628,0,175594,175785,147156,28629,5.140102693,104064,144746,102166,29419,19,29400,2,1945,0,6.80272E-05,mm10,mBC-0814-1
"F11,B10",4729,4816,3285,1531,2940,0,1549,1555,1090,465,2.344086022,815,475,338,73,0,73,0,21,0,0,empty,mBC-0814-1
"F11,B11",10318,11183,7360,3823,6645,0,3751,3754,2829,925,3.058378378,2020,192,130,37,0,37,0,11,0,0,empty,mBC-0814-1
"F11,B12",5621,6159,4021,2138,3692,0,2056,2056,1430,626,2.284345048,1136,1385,838,298,0,298,0,59,0,0,empty,mBC-0814-1
"F11,C1",5737,5938,4061,1877,3520,0,1853,1854,1308,546,2.395604396,957,1923,978,285,0,285,0,50,0,0.045614035,empty,mBC-0814-1
"F11,C2",6059,6488,4391,2097,3810,0,2071,2074,1473,601,2.450915141,1096,3605,1407,482,0,482,0,101,0,0.031120332,empty,mBC-0814-1
"F11,C3",6015,6535,4236,2299,3840,0,2127,2129,1564,565,2.768141593,1161,693,397,141,0,141,0,31,0,0,empty,mBC-0814-1
"F11,C4",5498,5746,3865,1881,3385,1,1787,1790,1343,447,3.004474273,952,1104,789,255,0,255,0,79,0,0.015686275,empty,mBC-0814-1
"F11,C5",543591,631500,363788,267712,371306,0,230125,230369,196610,33759,5.823928434,137775,139666,94601,27420,18,27402,5,1870,0,0.008174586,mm10,mBC-0814-1
"F11,C6",6116,6708,4411,2297,3964,0,2165,2170,1549,621,2.494363929,1176,1175,833,250,0,250,0,61,0,0.004,empty,mBC-0814-1
"F11,C7",7565,7987,5435,2552,4624,0,2458,2465,1757,708,2.481638418,1216,5438,1657,541,1,540,1,47,0,0.003703704,empty,mBC-0814-1
"F11,C8",5841,6198,4260,1938,3679,0,1956,1961,1397,564,2.476950355,1017,1919,1325,389,1,388,1,75,0,0,empty,mBC-0814-1
"F11,C9",4918,5289,3546,1743,3123,0,1710,1714,1229,485,2.534020619,909,982,674,203,0,203,0,59,0,0.064039409,empty,mBC-0814-1
"F11,C10",6209,6677,4423,2254,3851,5,2073,2082,1476,606,2.435643564,1118,1186,710,232,0,232,0,50,0,0,empty,mBC-0814-1
"F11,C11",938846,1115080,620092,494988,659879,3,429736,430176,341980,88196,3.877500113,262355,235156,163550,47446,22,47424,4,2770,0,0.002804487,mm10,mBC-0814-1
"F11,C12",8515,9329,6100,3229,5464,0,2998,2998,2148,850,2.527058824,1630,1835,1320,373,1,372,1,65,0,0,empty,mBC-0814-1
"F11,D1",4706,4978,3352,1626,2979,1,1595,1596,1144,452,2.530973451,885,2178,870,243,0,243,0,43,0,0,empty,mBC-0814-1
"F11,D2",592418,648464,414385,234079,380737,2,219974,220264,178273,41991,4.245504989,123164,88497,45608,13874,7,13867,2,1195,0,0.05826783,mm10,mBC-0814-1
"F11,D3",11304,12172,8099,4073,7259,1,3861,3865,2692,1173,2.294970162,2076,12076,4362,1239,4,1235,1,176,0,0.031578947,empty,mBC-0814-1
"F11,D4",5080,5443,3596,1847,3143,0,1723,1731,1208,523,2.309751434,941,1355,887,244,0,244,0,61,0,0,empty,mBC-0814-1
"F11,D5",4782,5097,3416,1681,3028,0,1656,1656,1199,457,2.623632385,910,2343,1671,449,0,449,0,111,0,0.002227171,empty,mBC-0814-1
"F11,D6",5147,5586,3673,1913,3331,0,1820,1824,1270,554,2.292418773,1003,1122,839,264,0,264,0,50,0,0,empty,mBC-0814-1
"F11,D7",590300,671789,398064,273725,392528,0,238623,238922,204395,34527,5.91985982,140512,218027,158835,45285,26,45259,2,2554,0,0.000375616,mm10,mBC-0814-1
"F11,D8",5348,5963,3866,2097,3454,0,1939,1947,1363,584,2.33390411,1053,1115,832,263,0,263,0,53,0,0,empty,mBC-0814-1
"F11,D9",3553,3875,2519,1356,2194,0,1180,1181,803,378,2.124338624,631,5569,2189,639,3,636,1,94,0,0.01572327,empty,mBC-0814-1
"F11,D10",3955,4235,2830,1405,2532,0,1396,1399,995,404,2.462871287,711,578,368,118,0,118,0,40,0,0,empty,mBC-0814-1
"F11,D11",4478,4813,3327,1486,2836,1,1549,1550,1114,436,2.555045872,812,1921,1409,462,0,462,0,116,0,0.012987013,empty,mBC-0814-1
"F11,D12",7189,7731,5249,2482,4537,0,2448,2452,1710,742,2.30458221,1259,3471,2427,676,0,676,0,119,0,0.026627219,empty,mBC-0814-1
"F11,E1",5447,5871,3907,1964,3321,0,1756,1759,1266,493,2.567951318,915,2599,1290,343,1,342,1,71,0,0.058479532,empty,mBC-0814-1
"F11,E2",3852,4169,2802,1367,2438,0,1269,1276,906,370,2.448648649,692,1076,703,227,0,227,0,43,0,0.083700441,empty,mBC-0814-1
"F11,E3",3591,3745,2575,1170,2219,6,1161,1168,839,329,2.550151976,584,1194,898,245,0,245,0,48,0,0,empty,mBC-0814-1
"F11,E4",3198,3457,2339,1118,2027,0,1066,1066,770,296,2.601351351,540,909,640,224,0,224,0,48,0,0,empty,mBC-0814-1
"F11,E5",561004,621374,380999,240375,367977,0,225125,225448,169851,55597,3.055038941,129560,45515,28585,8119,6,8113,1,863,0,0.016639961,mm10,mBC-0814-1
"F11,E6",578512,665352,390645,274707,387828,0,240901,241192,194749,46443,4.1932907,142407,193781,135197,37311,21,37290,1,2268,0,0.000482703,mm10,mBC-0814-1
"F11,E7",629752,708716,429251,279465,411772,0,246062,246325,197975,48350,4.094622544,142147,167390,120486,33661,19,33642,1,2264,0,0.000267523,mm10,mBC-0814-1
"F11,E8",4937,5244,3477,1767,3108,0,1663,1664,1184,480,2.466666667,936,1033,707,241,0,241,0,65,0,0,empty,mBC-0814-1
"F11,E9",3864,4047,2849,1198,2340,0,1207,1212,887,325,2.729230769,613,1629,1168,343,0,343,0,78,0,0,empty,mBC-0814-1
"F11,E10",4240,4452,3048,1404,2634,0,1447,1448,1021,427,2.391100703,748,1706,1167,349,0,349,0,81,0,0,empty,mBC-0814-1
"F11,E11",4716,5294,3336,1958,3041,0,1686,1687,1215,472,2.574152542,915,1918,1373,421,0,421,0,85,0,0,empty,mBC-0814-1
"F11,E12",4189,4526,3016,1510,2713,0,1477,1479,1045,434,2.407834101,789,1066,677,178,0,178,0,43,0,0,empty,mBC-0814-1
"F11,F1",6323,6959,4519,2440,4069,0,2256,2257,1447,810,1.786419753,1234,10270,3457,1069,2,1067,2,126,0,0.102155576,empty,mBC-0814-1
"F11,F2",6881,7655,4876,2779,4353,0,2439,2443,1687,756,2.231481481,1343,1944,1374,402,1,401,1,95,0,0.007481297,empty,mBC-0814-1
"F11,F3",5249,5729,3724,2005,3279,0,1821,1824,1313,511,2.569471624,967,1767,1351,435,0,435,0,86,0,0.03908046,empty,mBC-0814-1
"F11,F4",5547,5844,3993,1851,3504,0,1838,1842,1320,522,2.528735632,962,327,247,70,0,70,0,21,0,0,empty,mBC-0814-1
"F11,F5",5292,5794,3800,1994,3345,0,1766,1769,1291,478,2.70083682,947,1255,892,276,0,276,0,54,0,0,empty,mBC-0814-1
"F11,F6",5629,5904,4007,1897,3482,0,1850,1850,1281,569,2.251318102,973,1843,1300,372,1,371,1,72,0,0,empty,mBC-0814-1
"F11,F7",4893,5367,3519,1848,3136,0,1713,1713,1245,468,2.66025641,929,533,352,98,0,98,0,32,0,0,empty,mBC-0814-1
"F11,F8",6422,6698,4608,2090,3967,0,2059,2061,1466,595,2.463865546,1064,129,111,35,0,35,0,9,0,0,empty,mBC-0814-1
"F11,F9",5708,6119,4183,1936,3557,0,1899,1902,1338,564,2.372340426,957,1870,1382,384,0,384,0,85,0,0,empty,mBC-0814-1
"F11,F10",7011,7633,5175,2458,4422,0,2351,2352,1678,674,2.489614243,1209,1531,1202,400,0,400,0,70,0,0.0925,empty,mBC-0814-1
"F11,F11",4349,4664,3144,1520,2717,0,1463,1463,1032,431,2.394431555,758,1677,1240,393,1,392,1,70,0,0.089285714,empty,mBC-0814-1
"F11,F12",5116,5508,3604,1904,3260,0,1796,1799,1282,517,2.479690522,978,74,46,25,0,25,0,12,0,0,empty,mBC-0814-1
"F11,G1",7924,8584,5642,2942,5061,0,2740,2746,1940,806,2.406947891,1516,3221,2253,712,0,712,0,137,0,0.001404494,empty,mBC-0814-1
"F11,G2",6094,6526,4342,2184,3838,0,2083,2085,1521,564,2.696808511,1142,767,500,123,0,123,0,23,0,0,empty,mBC-0814-1
"F11,G3",5279,5639,3697,1942,3381,0,1894,1895,1325,570,2.324561404,1021,2071,1366,396,0,396,0,101,0,0,empty,mBC-0814-1
"F11,G4",5589,5986,3979,2007,3456,0,1834,1838,1304,534,2.441947566,986,2,1,1,0,1,0,1,0,0,empty,mBC-0814-1
"F11,G5",4765,5253,3429,1824,3065,3,1669,1673,1137,536,2.121268657,912,1221,781,247,0,247,0,69,0,0.020242915,empty,mBC-0814-1
"F11,G6",718192,838245,474068,364177,490302,0,312511,312894,266321,46573,5.718356129,187677,8868,6365,1864,1,1863,1,253,0,0.002147075,mm10,mBC-0814-1
"F11,G7",15126,18301,10900,7401,10969,0,6733,6746,4435,2311,1.919082648,3931,12752,6579,1867,2,1865,1,248,0,0.01233244,empty,mBC-0814-1
"F11,G8",7699,8427,5431,2996,5063,0,2864,2870,2060,810,2.543209877,1559,3864,2845,747,0,747,0,136,0,0.004016064,empty,mBC-0814-1
"F11,G9",5871,6525,4126,2399,3737,0,2097,2102,1488,614,2.423452769,1159,2821,1991,574,0,574,0,128,0,0.031358885,empty,mBC-0814-1
"F11,G10",9622,10245,6812,3433,5981,0,3193,3197,2292,905,2.532596685,1720,2843,2004,666,0,666,0,138,0,0.028528529,empty,mBC-0814-1
"F11,G11",9742,10439,7040,3399,6014,0,3180,3187,2314,873,2.650630011,1685,1571,1028,329,0,329,0,69,0,0,empty,mBC-0814-1
"F11,G12",4850,5155,3487,1668,3086,0,1684,1687,1235,452,2.732300885,886,1649,1209,333,1,332,1,76,0,0,empty,mBC-0814-1
"F11,H1",4789,5230,3430,1800,3101,0,1692,1695,1211,484,2.502066116,915,1101,863,201,0,201,0,45,0,0,empty,mBC-0814-1
"F11,H2",628559,738566,417189,321377,433676,0,273845,274153,229946,44207,5.201574411,165404,256908,185407,51777,22,51755,4,2729,0,0.000888803,mm10,mBC-0814-1
"F11,H3",5668,6199,4024,2175,3676,0,2049,2055,1533,522,2.936781609,1166,4715,1787,526,0,526,0,96,0,0.032319392,empty,mBC-0814-1
"F11,H4",431437,515045,281729,233316,304045,0,196237,196408,160059,36349,4.403394866,120973,8144,5863,1603,1,1602,1,212,0,0,mm10,mBC-0814-1
"F11,H5",638200,740943,426946,313997,430519,0,275387,275710,198963,76747,2.592453125,164575,114691,83505,23680,9,23671,2,1722,0,0.002154535,mm10,mBC-0814-1
"F11,H6",17402,19582,12326,7256,11511,0,6504,6509,5120,1389,3.686105112,3768,6900,4390,1356,0,1356,0,204,0,0.002949853,empty,mBC-0814-1
"F11,H7",5439,5937,3846,2091,3560,0,1927,1928,1369,559,2.4490161,1070,1247,757,257,0,257,0,55,0,0,empty,mBC-0814-1
"F11,H8",5038,5435,3611,1824,3128,0,1733,1734,1218,516,2.360465116,913,5341,2048,641,0,641,0,115,0,0.007800312,empty,mBC-0814-1
"F11,H9",5649,6053,4055,1998,3534,0,1898,1901,1410,491,2.871690428,1007,899,577,205,0,205,0,45,0,0,empty,mBC-0814-1
"F11,H10",4053,4388,2798,1590,2485,0,1337,1338,950,388,2.448453608,735,10301,3179,1033,2,1031,1,120,0,0.029097963,empty,mBC-0814-1
"F11,H11",4056,4405,2808,1597,2612,0,1465,1471,1072,399,2.686716792,807,99,56,19,0,19,0,3,0,0,empty,mBC-0814-1
"F11,H12",2937,3209,2051,1158,1893,0,1072,1075,742,333,2.228228228,590,851,521,200,0,200,0,61,0,0,empty,mBC-0814-1
"F12,A1",6367,7069,4596,2473,4176,0,2286,2288,1624,664,2.445783133,1247,2111,1372,387,0,387,0,81,0,0,empty,mBC-0814-1
"F12,A2",6806,7168,4815,2353,4225,0,2287,2292,1691,601,2.813643927,1198,1460,849,342,0,342,0,119,0,0.005847953,empty,mBC-0814-1
"F12,A3",5497,5798,3951,1847,3426,0,1863,1866,1308,558,2.344086022,970,2605,1228,354,0,354,0,69,0,0.005649718,empty,mBC-0814-1
"F12,A4",6351,6562,4605,1957,3852,1,1933,1936,1412,524,2.694656489,1009,805,504,157,0,157,0,30,0,0,empty,mBC-0814-1
"F12,A5",585385,672064,396453,275611,395062,0,241446,241706,198731,42975,4.624339732,142774,146240,104078,28104,18,28086,3,1932,0,0.001637827,mm10,mBC-0814-1
"F12,A6",4521,4910,3231,1679,2797,0,1541,1553,1104,449,2.458797327,800,1909,1383,364,0,364,0,66,0,0,empty,mBC-0814-1
"F12,A7",6668,7243,4773,2470,4198,0,2330,2333,1659,674,2.461424332,1252,2110,1455,443,0,443,0,96,0,0,empty,mBC-0814-1
"F12,A8",2673,3034,1924,1110,1827,0,1051,1053,758,295,2.569491525,592,1707,1219,359,2,357,1,73,0,0,empty,mBC-0814-1
"F12,A9",7691,8052,5539,2513,4695,0,2461,2471,1752,719,2.436717663,1310,2126,1562,370,0,370,0,74,0,0,empty,mBC-0814-1
"F12,A10",4836,5340,3314,2026,3173,0,1756,1758,1251,507,2.467455621,1002,493,352,118,0,118,0,27,0,0,empty,mBC-0814-1
"F12,A11",5543,6059,3957,2102,3616,0,2011,2014,1442,572,2.520979021,1084,2831,1899,659,0,659,0,134,0,0,empty,mBC-0814-1
"F12,A12",5422,5886,3808,2078,3512,1,1956,1960,1455,505,2.881188119,1064,3286,2359,786,1,785,1,209,0,0,empty,mBC-0814-1
"F12,B1",5476,5850,4012,1838,3484,0,1798,1803,1294,509,2.542239686,938,1662,1209,335,0,335,0,88,0,0,empty,mBC-0814-1
"F12,B2",5654,6089,3929,2160,3501,0,1888,1891,1323,568,2.329225352,1032,649,459,139,0,139,0,43,0,0.021582734,empty,mBC-0814-1
"F12,B3",5390,5794,3840,1954,3424,0,1922,1926,1348,578,2.332179931,1025,1329,997,287,0,287,0,62,0,0.027874564,empty,mBC-0814-1
"F12,B4",5213,5718,3662,2056,3355,0,1898,1898,1351,547,2.469835466,1019,9135,2985,952,1,951,1,128,0,0.118822292,empty,mBC-0814-1
"F12,B5",753740,505448,287326,218122,358968,5,224167,225084,171556,53528,3.204976835,139809,471387,301148,78124,61,78063,3,4250,0,0.000269013,mm10,mBC-0814-1
"F12,B6",4790,5039,3504,1535,3005,0,1569,1569,1116,453,2.463576159,800,1577,1096,302,0,302,0,71,0,0,empty,mBC-0814-1
"F12,B7",5597,6057,4015,2042,3503,0,1883,1890,1371,519,2.641618497,1021,1416,1063,240,0,240,0,60,0,0.004166667,empty,mBC-0814-1
"F12,B8",4457,4710,3246,1464,2772,0,1481,1485,1051,434,2.421658986,750,1928,1336,462,0,462,0,89,0,0.032467532,empty,mBC-0814-1
"F12,B9",694140,799800,470178,329622,463241,1,285359,285655,233338,52317,4.460079898,168766,105061,65113,18290,9,18281,1,1311,0,0.004759039,mm10,mBC-0814-1
"F12,B10",5274,5592,3636,1956,3423,0,1877,1877,1334,543,2.456721915,1058,277,158,70,0,70,0,28,0,0,empty,mBC-0814-1
"F12,B11",7691,8325,5569,2756,4973,0,2683,2685,1896,789,2.403041825,1463,229,137,47,0,47,0,15,0,0,empty,mBC-0814-1
"F12,B12",6161,6712,4373,2339,3917,0,2193,2199,1551,648,2.393518519,1176,1871,1378,410,0,410,0,81,0,0,empty,mBC-0814-1
"F12,C1",6465,7008,4628,2380,3931,0,2035,2037,1457,580,2.512068966,1074,2412,1037,303,0,303,0,56,0,0,empty,mBC-0814-1
"F12,C2",6442,6935,4554,2381,4021,0,2250,2251,1600,651,2.457757296,1197,2158,1503,436,0,436,0,97,0,0.002293578,empty,mBC-0814-1
"F12,C3",671361,787210,450400,336810,461305,0,292312,292634,239181,53453,4.474603858,175912,75853,51600,14553,8,14545,2,1151,0,0.000618769,mm10,mBC-0814-1
"F12,C4",6213,6607,4464,2143,3923,3,2166,2170,1626,544,2.988970588,1129,1229,716,223,0,223,0,81,0,0.004484305,empty,mBC-0814-1
"F12,C5",7987,8804,5721,3083,5101,4,2820,2828,2058,770,2.672727273,1486,1876,1353,446,0,446,0,118,0,0,empty,mBC-0814-1
"F12,C6",6115,6570,4350,2220,4016,0,2176,2177,1546,631,2.450079239,1214,945,608,200,0,200,0,63,0,0,empty,mBC-0814-1
"F12,C7",7876,8672,5504,3168,5039,0,2765,2769,1984,785,2.527388535,1550,308,211,86,0,86,0,30,0,0,empty,mBC-0814-1
"F12,C8",6421,6713,4657,2056,3930,1,2072,2075,1471,604,2.435430464,1039,2756,1870,557,0,557,0,110,0,0.016157989,empty,mBC-0814-1
"F12,C9",733327,841370,495107,346263,485913,1,296727,297052,260325,36727,7.088109565,174122,157652,114850,30870,22,30848,1,2107,0,0.001037344,mm10,mBC-0814-1
"F12,C10",6290,6879,4500,2379,4052,0,2265,2272,1597,675,2.365925926,1273,991,624,197,0,197,0,55,0,0,empty,mBC-0814-1
"F12,C11",5111,5579,3714,1865,3250,0,1772,1773,1255,518,2.422779923,917,2138,1399,411,1,410,1,74,0,0.034146341,empty,mBC-0814-1
"F12,C12",9745,10797,6890,3907,6170,0,3444,3451,2456,995,2.468341709,1920,2178,1575,392,0,392,0,80,0,0,empty,mBC-0814-1
"F12,D1",221719,228293,136631,91662,133243,0,79996,80078,62441,17637,3.540341328,46633,64167,40386,10865,11,10854,1,938,0,0.000644924,mm10,mBC-0814-1
"F12,D2",5797,6183,4293,1890,3564,0,1826,1830,1318,512,2.57421875,903,1840,1251,377,0,377,0,91,0,0,empty,mBC-0814-1
"F12,D3",12520,13486,8957,4529,8014,0,4322,4329,3138,1191,2.634760705,2325,2589,1761,545,0,545,0,121,0,0.001834862,empty,mBC-0814-1
"F12,D4",5513,5981,3928,2053,3378,0,1898,1901,1373,528,2.600378788,999,2111,1579,463,0,463,0,97,0,0,empty,mBC-0814-1
"F12,D5",5636,5969,4026,1943,3551,0,1935,1940,1402,538,2.605947955,1010,3056,1980,570,0,570,0,118,0,0.042105263,empty,mBC-0814-1
"F12,D6",5624,6291,4081,2210,3633,0,2014,2017,1434,583,2.459691252,1107,1267,853,279,0,279,0,67,0,0,empty,mBC-0814-1
"F12,D7",6909,7337,4983,2354,4226,0,2219,2223,1588,635,2.500787402,1148,2319,1593,490,0,490,0,101,0,0.051020408,empty,mBC-0814-1
"F12,D8",5719,6224,4086,2138,3497,1,1884,1885,1329,556,2.39028777,989,1277,732,233,0,233,0,55,0,0,empty,mBC-0814-1
"F12,D9",3895,4411,2752,1659,2560,0,1447,1449,1050,399,2.631578947,805,2031,1335,361,0,361,0,70,0,0,empty,mBC-0814-1
"F12,D10",4282,4467,3116,1351,2614,0,1360,1363,998,365,2.734246575,680,1431,939,291,0,291,0,63,0,0.010309278,empty,mBC-0814-1
"F12,D11",466792,547855,308956,238899,323837,1,204415,204656,166048,38608,4.300870286,123267,429671,315614,85557,57,85500,4,3575,0,7.01754E-05,mm10,mBC-0814-1
"F12,D12",7321,7936,5243,2693,4541,0,2487,2492,1771,721,2.45631068,1305,14945,5815,1722,1,1721,1,202,0,0.008715863,empty,mBC-0814-1
"F12,E1",5816,6043,4211,1832,3535,0,1810,1815,1299,516,2.51744186,912,2235,1480,430,0,430,0,88,0,0.002325581,empty,mBC-0814-1
"F12,E2",4204,4478,3145,1333,2677,0,1448,1451,1016,435,2.335632184,714,1348,955,278,1,277,1,78,0,0.036101083,empty,mBC-0814-1
"F12,E3",3878,4201,2838,1363,2398,0,1258,1258,920,338,2.721893491,635,1439,938,281,0,281,0,68,0,0,empty,mBC-0814-1
"F12,E4",556440,644670,380819,263851,375084,2,227205,227434,188720,38714,4.874722323,133338,268391,195022,55743,33,55710,6,2940,0,0.000502603,mm10,mBC-0814-1
"F12,E5",4171,4275,3017,1258,2470,1,1209,1210,876,334,2.622754491,609,973,581,192,0,192,0,41,0,0,empty,mBC-0814-1
"F12,E6",5124,5635,3789,1846,3181,0,1685,1687,1220,467,2.6124197,851,2012,1453,442,0,442,0,78,0,0.009049774,empty,mBC-0814-1
"F12,E7",5053,5531,3652,1879,3196,0,1740,1744,1219,525,2.321904762,971,1253,876,315,0,315,0,70,0,0,empty,mBC-0814-1
"F12,E8",5684,6085,4123,1962,3558,3,1874,1881,1395,486,2.87037037,997,2422,1513,424,0,424,0,85,0,0,empty,mBC-0814-1
"F12,E9",4066,4461,2957,1504,2594,0,1432,1432,1028,404,2.544554455,757,2194,1601,523,0,523,0,95,0,0.013384321,empty,mBC-0814-1
"F12,E10",4466,4810,3176,1634,2911,3,1607,1615,1126,489,2.302658487,888,2569,1739,435,1,434,1,103,0,0.041474654,empty,mBC-0814-1
"F12,E11",5050,5311,3687,1624,3165,0,1665,1669,1174,495,2.371717172,872,1630,1142,363,0,363,0,95,0,0.005509642,empty,mBC-0814-1
"F12,E12",4766,5138,3412,1726,2996,0,1615,1618,1163,455,2.556043956,870,1453,1041,300,0,300,0,62,0,0,empty,mBC-0814-1
"F12,F1",5332,5721,3891,1830,3366,0,1765,1767,1227,540,2.272222222,924,1865,1323,320,0,320,0,72,0,0,empty,mBC-0814-1
"F12,F2",7568,8276,5397,2879,4793,0,2588,2589,1916,673,2.846953938,1400,2058,1432,499,0,499,0,113,0,0,empty,mBC-0814-1
"F12,F3",610125,675580,413647,261933,394674,1,241086,241370,187336,54034,3.467002258,139462,18167,12813,3567,0,3567,0,503,0,0.000841043,mm10,mBC-0814-1
"F12,F4",6196,6609,4347,2262,3812,0,2057,2057,1506,551,2.733212341,1044,504,304,105,0,105,0,28,0,0,empty,mBC-0814-1
"F12,F5",5901,6246,4208,2038,3641,0,1978,1982,1406,576,2.440972222,1044,1710,1269,360,0,360,0,74,0,0,empty,mBC-0814-1
"F12,F6",5851,6269,4194,2075,3773,0,2052,2057,1484,573,2.589877836,1104,2100,1355,451,0,451,0,99,0,0,empty,mBC-0814-1
"F12,F7",5050,5308,3733,1575,3154,1,1712,1719,1203,516,2.331395349,872,550,348,134,0,134,0,43,0,0,empty,mBC-0814-1
"F12,F8",6988,7432,5062,2370,4319,0,2326,2329,1613,716,2.252793296,1175,372,310,80,0,80,0,23,0,0,empty,mBC-0814-1
"F12,F9",813588,924439,554217,370222,533956,1,320516,320953,254177,66776,3.806412484,186423,460260,337563,93843,50,93793,6,3796,0,0.000106618,mm10,mBC-0814-1
"F12,F10",7189,7808,5263,2545,4453,0,2387,2395,1710,685,2.496350365,1259,1590,1151,356,0,356,0,82,0,0.014044944,empty,mBC-0814-1
"F12,F11",5002,5290,3653,1637,3153,0,1672,1677,1211,466,2.598712446,864,1684,1154,292,0,292,0,69,0,0,empty,mBC-0814-1
"F12,F12",5548,6059,3842,2217,3613,6,1986,2000,1462,538,2.717472119,1165,212,123,48,0,48,0,13,0,0,empty,mBC-0814-1
"F12,G1",8616,9154,6177,2977,5368,1,2840,2844,1992,852,2.338028169,1467,6960,3588,1024,1,1023,1,184,0,0.056695992,empty,mBC-0814-1
"F12,G2",593626,683436,388310,295126,400154,2,252883,253130,204602,48528,4.216163864,151665,42273,30780,8230,6,8224,1,820,0,0,mm10,mBC-0814-1
"F12,G3",6043,6393,4278,2115,3695,0,2011,2019,1416,603,2.348258706,1030,2444,1595,449,0,449,0,112,0,0,empty,mBC-0814-1
"F12,G4",5975,6251,4402,1849,3581,4,1821,1830,1301,529,2.459357278,885,3,2,2,0,2,0,2,0,0,empty,mBC-0814-1
"F12,G5",5855,6174,4022,2152,3435,0,1860,1864,1316,548,2.401459854,989,37085,11157,3651,6,3645,3,325,0,0.072427984,empty,mBC-0814-1
"F12,G6",1389731,1615285,929702,685583,931404,2,588908,589558,477178,112380,4.246111408,351869,32259,22031,6257,4,6253,2,653,0,0.001119463,mm10,mBC-0814-1
"F12,G7",6602,7009,4639,2370,4084,0,2184,2187,1515,672,2.254464286,1203,3686,2232,678,0,678,0,124,0,0.067846608,empty,mBC-0814-1
"F12,G8",8990,9795,6402,3393,5652,0,3048,3055,2204,851,2.589894242,1670,4278,2584,768,1,767,1,176,0,0.001303781,empty,mBC-0814-1
"F12,G9",6648,7332,4754,2578,4270,0,2328,2333,1685,648,2.600308642,1271,3781,2806,815,1,814,1,176,0,0.028255528,empty,mBC-0814-1
"F12,G10",1429686,1618362,962502,655860,935387,1,588864,589473,435177,154296,2.82040364,346163,209698,149189,41835,18,41817,2,2544,0,0.000478274,mm10,mBC-0814-1
"F12,G11",10948,11818,7911,3907,6830,0,3641,3647,2625,1022,2.568493151,1919,1827,1306,367,0,367,0,86,0,0,empty,mBC-0814-1
"F12,G12",5796,6366,4109,2257,3675,0,2031,2037,1433,604,2.372516556,1117,3108,2293,600,0,600,0,117,0,0.026666667,empty,mBC-0814-1
"F12,H1",5492,5811,3828,1983,3405,0,1923,1926,1362,564,2.414893617,1037,20162,5464,1620,8,1612,3,170,0,0.015508685,empty,mBC-0814-1
"F12,H2",10180,11062,7231,3831,6283,0,3376,3385,2409,976,2.468237705,1789,4363,2925,817,1,816,1,162,0,0.008578431,empty,mBC-0814-1
"F12,H3",7014,7683,4797,2886,4401,0,2436,2439,1779,660,2.695454545,1371,23822,7289,2234,9,2225,4,241,0,0.127191011,empty,mBC-0814-1
"F12,H4",6401,7194,4497,2697,4048,0,2240,2245,1599,646,2.475232198,1233,37,28,16,0,16,0,11,0,0,empty,mBC-0814-1
"F12,H5",7505,8168,5360,2808,4704,0,2586,2596,1847,749,2.465954606,1396,2327,1575,437,0,437,0,70,0,0,empty,mBC-0814-1
"F12,H6",7666,8137,5492,2645,4719,0,2594,2596,1900,696,2.729885057,1348,3028,2111,658,0,658,0,140,0,0,empty,mBC-0814-1
"F12,H7",6402,6894,4558,2336,3941,0,2146,2148,1503,645,2.330232558,1119,5679,2265,648,1,647,1,102,0,0.055641422,empty,mBC-0814-1
"F12,H8",5127,5585,3688,1897,3287,0,1827,1833,1345,488,2.756147541,986,2911,1996,560,0,560,0,105,0,0.041071429,empty,mBC-0814-1
"F12,H9",6581,7007,4700,2307,4121,4,2210,2222,1613,609,2.648604269,1172,1187,845,221,0,221,0,49,0,0.004524887,empty,mBC-0814-1
"F12,H10",494707,565044,328611,236433,328009,1,199558,199772,166143,33629,4.940468048,120241,333238,216278,56887,41,56846,4,3338,0,0.000193505,mm10,mBC-0814-1
"F12,H11",4705,5238,3358,1880,3134,0,1734,1735,1246,489,2.54805726,965,22,10,4,0,4,0,4,0,0,empty,mBC-0814-1
"F12,H12",3597,3880,2515,1365,2319,0,1305,1310,930,380,2.447368421,725,1502,1089,327,0,327,0,82,0,0,empty,mBC-0814-1
"G1,A1",5556,6063,3994,2069,3584,0,1957,1961,1368,593,2.306913997,1060,987,713,195,0,195,0,40,0,0,empty,mBC-0814-1
"G1,A2",409961,458946,278385,180561,274003,0,164943,165148,122317,42831,2.855805375,95880,62835,44435,12981,9,12972,2,1114,0,0.001387604,mm10,mBC-0814-1
"G1,A3",4743,5240,3450,1790,3044,0,1693,1700,1200,500,2.4,924,1169,830,287,0,287,0,54,0,0,empty,mBC-0814-1
"G1,A4",601207,692331,403429,288902,406977,1,253077,253375,200123,53252,3.758037257,150342,39979,27972,7901,5,7896,2,789,0,0,mm10,mBC-0814-1
"G1,A5",4722,5190,3438,1752,3017,0,1660,1660,1198,462,2.593073593,887,1135,853,261,3,258,1,51,0,0,empty,mBC-0814-1
"G1,A6",3581,3818,2597,1221,2263,0,1243,1243,896,347,2.582132565,643,1010,635,200,0,200,0,43,0,0.005,empty,mBC-0814-1
"G1,A7",212440,241234,136497,104737,145111,1,90704,90841,73517,17324,4.243650427,54953,66392,48362,13491,10,13481,2,1184,0,0.001186856,mm10,mBC-0814-1
"G1,A8",2199,2349,1575,774,1397,0,768,772,542,230,2.356521739,402,1344,946,280,0,280,0,52,0,0,empty,mBC-0814-1
"G1,A9",6283,6733,4557,2176,3863,0,2055,2060,1533,527,2.908918406,1071,946,671,209,0,209,0,44,0,0,empty,mBC-0814-1
"G1,A10",3408,3711,2409,1302,2303,0,1275,1277,907,370,2.451351351,698,310,250,67,1,66,1,12,0,0,empty,mBC-0814-1
"G1,A11",4457,4719,3209,1510,2847,0,1534,1537,1117,420,2.65952381,793,1423,973,365,0,365,0,68,0,0,empty,mBC-0814-1
"G1,A12",4444,4811,3015,1796,2914,0,1650,1652,1255,397,3.161209068,918,2640,1961,449,0,449,0,111,0,0.028953229,empty,mBC-0814-1
"G1,B1",116130,141369,74374,66995,84577,0,56957,57011,36566,20445,1.788505747,35521,43690,31343,8957,10,8947,2,753,0,0.001453001,mm10,mBC-0814-1
"G1,B2",4779,5134,3293,1841,3119,1,1723,1731,1252,479,2.613778706,1003,502,319,96,0,96,0,20,0,0,empty,mBC-0814-1
"G1,B3",3903,4270,2722,1548,2598,0,1449,1450,1011,439,2.302961276,793,1030,680,187,0,187,0,37,0,0,empty,mBC-0814-1
"G1,B4",4517,4999,3276,1723,2955,0,1614,1616,1193,423,2.820330969,885,1031,726,236,1,235,1,45,0,0.072340426,empty,mBC-0814-1
"G1,B5",3597,2442,1508,934,1744,0,979,982,734,248,2.959677419,577,669,392,136,0,136,0,38,0,0,empty,mBC-0814-1
"G1,B6",3941,4246,2870,1376,2441,0,1318,1324,926,398,2.326633166,688,1591,1294,316,1,315,1,59,0,0,empty,mBC-0814-1
"G1,B7",4938,5218,3500,1718,3104,0,1654,1661,1245,416,2.992788462,893,731,538,159,0,159,0,43,0,0,empty,mBC-0814-1
"G1,B8",3743,3959,2692,1267,2326,0,1216,1218,927,291,3.18556701,626,666,362,141,0,141,0,40,0,0,empty,mBC-0814-1
"G1,B9",4825,5132,3426,1706,2980,0,1631,1635,1177,458,2.569868996,849,473,278,109,0,109,0,36,0,0.146788991,empty,mBC-0814-1
"G1,B10",4313,4430,3025,1405,2734,0,1456,1459,1044,415,2.515662651,775,484,327,93,0,93,0,17,0,0,empty,mBC-0814-1
"G1,B11",6499,6848,4721,2127,3838,0,2027,2027,1470,557,2.639138241,1021,139,57,15,0,15,0,6,0,0,empty,mBC-0814-1
"G1,B12",5041,5290,3597,1693,3225,0,1785,1787,1258,529,2.378071834,920,1389,842,242,2,240,2,49,0,0,empty,mBC-0814-1
"G1,C1",496768,567236,335625,231611,334734,0,204608,204832,169777,35055,4.843160747,119992,67085,46235,13072,9,13063,1,1159,0,7.65521E-05,mm10,mBC-0814-1
"G1,C2",5099,5609,3565,2044,3238,0,1794,1794,1277,517,2.470019342,984,1196,919,281,0,281,0,53,0,0,empty,mBC-0814-1
"G1,C3",7712,8369,5365,3004,4789,0,2613,2617,1721,896,1.920758929,1402,356,186,70,0,70,0,26,0,0.2,empty,mBC-0814-1
"G1,C4",5068,5307,3705,1602,3143,0,1656,1659,1212,447,2.711409396,836,759,507,219,0,219,0,50,0,0,empty,mBC-0814-1
"G1,C5",6958,7432,4993,2439,4318,0,2285,2288,1712,576,2.972222222,1212,1229,846,241,0,241,0,55,0,0.004149378,empty,mBC-0814-1
"G1,C6",586335,646249,398464,247785,388575,0,232799,233048,183219,49829,3.676955187,134072,35087,25232,7633,3,7630,1,771,0,0.001834862,mm10,mBC-0814-1
"G1,C7",6816,7416,4866,2550,4346,0,2346,2354,1651,703,2.348506401,1258,3024,939,295,0,295,0,38,0,0.122033898,empty,mBC-0814-1
"G1,C8",5470,5745,3961,1784,3341,0,1742,1743,1192,551,2.163339383,905,1411,974,275,0,275,0,59,0,0.007272727,empty,mBC-0814-1
"G1,C9",4620,4966,3272,1694,2880,0,1541,1547,1103,444,2.484234234,834,944,689,191,0,191,0,45,0,0,empty,mBC-0814-1
"G1,C10",609289,717020,408187,308833,422170,15,267504,267808,219196,48612,4.509092405,160862,79327,56386,16205,9,16196,1,1322,0,0,mm10,mBC-0814-1
"G1,C11",4526,4999,3214,1785,2907,0,1591,1591,1121,470,2.385106383,857,973,778,259,0,259,0,42,0,0,empty,mBC-0814-1
"G1,C12",602960,709629,397575,312054,415583,1,263009,263313,210960,52353,4.029568506,159489,219488,159601,45911,34,45877,5,2522,0,0.000283366,mm10,mBC-0814-1
"G1,D1",508237,585847,333781,252066,347668,0,218163,218440,177098,41342,4.283730831,130873,40459,27097,7322,5,7317,2,791,0,0,mm10,mBC-0814-1
"G1,D2",4965,5330,3661,1669,3130,0,1610,1613,1192,421,2.831353919,816,1171,765,278,0,278,0,64,0,0,empty,mBC-0814-1
"G1,D3",10454,11266,7373,3893,6687,0,3666,3676,2594,1082,2.3974122,1954,2410,1565,388,1,387,1,68,0,0,empty,mBC-0814-1
"G1,D4",4652,4991,3378,1613,2959,0,1610,1616,1206,410,2.941463415,859,1139,793,237,0,237,0,50,0,0,empty,mBC-0814-1
"G1,D5",4291,4473,2940,1533,2709,0,1488,1492,1103,389,2.835475578,814,1239,747,246,0,246,0,64,0,0,empty,mBC-0814-1
"G1,D6",5334,5581,3764,1817,3277,0,1817,1817,1332,485,2.746391753,946,7364,2289,658,1,657,1,89,0,0.112633181,empty,mBC-0814-1
"G1,D7",5985,6458,4283,2175,3690,0,1999,2003,1451,552,2.628623188,1035,1387,1024,294,0,294,0,61,0,0,empty,mBC-0814-1
"G1,D8",4892,5308,3491,1817,3099,4,1687,1692,1219,473,2.577167019,929,803,575,169,0,169,0,34,0,0,empty,mBC-0814-1
"G1,D9",3171,3529,2255,1274,2105,0,1169,1170,818,352,2.323863636,650,1028,624,192,1,191,1,34,0,0.078534031,empty,mBC-0814-1
"G1,D10",3820,4212,2688,1524,2483,0,1418,1418,994,424,2.344339623,799,815,638,185,0,185,0,33,0,0,empty,mBC-0814-1
"G1,D11",4120,4458,3041,1417,2598,1,1398,1402,1004,398,2.522613065,711,1318,897,281,0,281,0,69,0,0.007117438,empty,mBC-0814-1
"G1,D12",5959,6333,4319,2014,3767,0,1996,2000,1435,565,2.539823009,1035,3053,1951,596,0,596,0,101,0,0.015100671,empty,mBC-0814-1
"G1,E1",500369,571822,336438,235384,340534,0,210544,210788,176636,34152,5.172054345,124361,193379,131545,37542,28,37514,4,2210,0,2.66567E-05,mm10,mBC-0814-1
"G1,E2",3696,4073,2616,1457,2385,2,1298,1300,964,336,2.869047619,699,874,596,184,0,184,0,43,0,0,empty,mBC-0814-1
"G1,E3",3300,3556,2355,1201,2108,0,1194,1194,842,352,2.392045455,640,1357,918,222,2,220,1,41,0,0,empty,mBC-0814-1
"G1,E4",2955,3127,2164,963,1873,0,1011,1011,709,302,2.347682119,523,802,548,147,0,147,0,36,0,0.156462585,empty,mBC-0814-1
"G1,E5",3741,3933,2712,1221,2358,0,1260,1263,897,366,2.450819672,666,636,457,127,0,127,0,24,0,0,empty,mBC-0814-1
"G1,E6",4839,5147,3487,1660,2963,0,1563,1563,1161,402,2.888059701,794,1348,983,325,0,325,0,55,0,0,empty,mBC-0814-1
"G1,E7",4690,5002,3345,1657,2831,0,1480,1483,1103,380,2.902631579,778,3583,1659,443,0,443,0,73,0,0.040632054,empty,mBC-0814-1
"G1,E8",4615,5052,3375,1677,2909,0,1512,1517,1048,469,2.234541578,804,1197,937,272,0,272,0,56,0,0.007352941,empty,mBC-0814-1
"G1,E9",310785,345353,209619,135734,207708,0,126624,126776,103260,23516,4.3910529,73794,13063,9188,2654,3,2651,1,386,0,0.001131648,mm10,mBC-0814-1
"G1,E10",4158,4373,3055,1318,2582,0,1397,1399,968,431,2.245939675,695,1349,1037,271,0,271,0,58,0,0.007380074,empty,mBC-0814-1
"G1,E11",458048,532448,305924,226524,319043,0,200458,200715,152419,48296,3.155934239,119950,143651,98405,28130,25,28105,4,1981,0,0.003451343,mm10,mBC-0814-1
"G1,E12",3961,4369,2756,1613,2614,0,1447,1447,1057,390,2.71025641,813,671,463,163,0,163,0,43,0,0,empty,mBC-0814-1
"G1,F1",4640,5041,3314,1727,2965,0,1565,1565,1131,434,2.605990783,853,933,626,193,0,193,0,48,0,0.062176166,empty,mBC-0814-1
"G1,F2",6289,6868,4536,2332,4065,0,2183,2184,1583,601,2.633943428,1193,1305,911,293,0,293,0,75,0,0.006825939,empty,mBC-0814-1
"G1,F3",5263,5609,3836,1773,3309,0,1751,1753,1301,452,2.878318584,916,1379,976,315,0,315,0,64,0,0,empty,mBC-0814-1
"G1,F4",5318,5482,3780,1702,3356,0,1722,1726,1224,502,2.438247012,900,199,96,44,0,44,0,12,0,0,empty,mBC-0814-1
"G1,F5",4969,5213,3526,1687,3082,0,1661,1666,1180,486,2.427983539,883,937,668,211,0,211,0,40,0,0,empty,mBC-0814-1
"G1,F6",5320,5637,3816,1821,3293,5,1787,1795,1284,511,2.512720157,937,1372,961,281,0,281,0,69,0,0,empty,mBC-0814-1
"G1,F7",4319,4601,3035,1566,2669,0,1428,1431,1003,428,2.343457944,747,243,144,59,0,59,0,19,0,0,empty,mBC-0814-1
"G1,F8",6660,7127,4753,2374,4236,0,2317,2320,1709,611,2.79705401,1251,160,127,22,0,22,0,7,0,0,empty,mBC-0814-1
"G1,F9",5273,5611,3810,1801,3345,0,1794,1796,1275,521,2.447216891,948,1342,1046,292,0,292,0,54,0,0.054794521,empty,mBC-0814-1
"G1,F10",6622,7130,4823,2307,4256,0,2247,2249,1613,636,2.536163522,1193,1091,719,224,0,224,0,50,0,0.004464286,empty,mBC-0814-1
"G1,F11",4221,4539,3068,1471,2701,0,1429,1429,997,432,2.30787037,742,908,624,204,0,204,0,49,0,0.098039216,empty,mBC-0814-1
"G1,F12",490182,576876,326920,249956,337728,0,215585,215835,162387,53448,3.038224068,129896,12298,8234,2235,0,2235,0,273,0,0,mm10,mBC-0814-1
"G1,G1",7382,7733,5274,2459,4571,0,2438,2441,1773,668,2.654191617,1316,1696,1089,379,0,379,0,84,0,0,empty,mBC-0814-1
"G1,G2",5602,6038,4019,2019,3513,0,1857,1860,1356,504,2.69047619,1012,360,247,70,0,70,0,13,0,0,empty,mBC-0814-1
"G1,G3",5069,5581,3578,2003,3304,0,1874,1875,1347,528,2.551136364,1056,1841,1393,383,0,383,0,71,0,0,empty,mBC-0814-1
"G1,G4",5162,5519,3791,1728,3212,0,1721,1722,1245,477,2.610062893,853,1,1,1,0,1,0,1,0,0,empty,mBC-0814-1
"G1,G5",4792,5261,3417,1844,3093,0,1672,1672,1177,495,2.377777778,932,1081,804,220,0,220,0,41,0,0,empty,mBC-0814-1
"G1,G6",8567,8636,6231,2405,5143,0,2629,2634,1814,820,2.212195122,1322,125,56,26,0,26,0,10,0,0,empty,mBC-0814-1
"G1,G7",5313,5688,3760,1928,3397,0,1892,1895,1373,522,2.630268199,1014,1787,1086,304,0,304,0,61,0,0,empty,mBC-0814-1
"G1,G8",7743,8321,5323,2998,4894,0,2723,2723,1954,769,2.540962289,1486,84402,25054,8053,15,8038,4,574,0,0.122791739,empty,mBC-0814-1
"G1,G9",5476,6142,3855,2287,3563,0,2008,2011,1414,597,2.368509213,1142,1583,1037,356,0,356,0,77,0,0,empty,mBC-0814-1
"G1,G10",8904,9517,6375,3142,5674,0,3082,3084,2138,946,2.260042283,1644,7826,3033,1018,1,1017,1,151,0,0.117010816,empty,mBC-0814-1
"G1,G11",9186,10044,6606,3438,5860,0,3184,3192,2330,862,2.703016241,1746,1355,1023,317,0,317,0,64,0,0,empty,mBC-0814-1
"G1,G12",4647,4958,3354,1604,2863,0,1509,1513,1078,435,2.47816092,775,1127,840,271,0,271,0,62,0,0,empty,mBC-0814-1
"G1,H1",4595,5070,3326,1744,2930,0,1626,1627,1182,445,2.656179775,848,864,591,158,0,158,0,34,0,0,empty,mBC-0814-1
"G1,H2",7931,8694,5624,3070,5110,0,2779,2789,2018,771,2.617380026,1537,1762,1224,405,0,405,0,87,0,0,empty,mBC-0814-1
"G1,H3",5404,5897,3776,2121,3564,2,2007,2009,1455,554,2.626353791,1142,15033,3874,1203,3,1200,1,137,0,0.054166667,empty,mBC-0814-1
"G1,H4",5211,5729,3695,2034,3453,0,1882,1890,1364,526,2.593155894,1043,20,13,8,0,8,0,8,0,0,empty,mBC-0814-1
"G1,H5",6406,7096,4563,2533,4120,0,2232,2236,1550,686,2.259475219,1245,1380,864,308,0,308,0,49,0,0,empty,mBC-0814-1
"G1,H6",6208,6631,4437,2194,3959,0,2132,2134,1607,527,3.049335863,1116,1699,1188,355,0,355,0,72,0,0,empty,mBC-0814-1
"G1,H7",5268,5435,3700,1735,3267,0,1718,1726,1238,488,2.536885246,898,1381,946,312,0,312,0,47,0,0,empty,mBC-0814-1
"G1,H8",9119,10041,6309,3732,5980,0,3484,3485,2702,783,3.45083014,1987,4213,1769,497,1,496,1,72,0,0.094758065,empty,mBC-0814-1
"G1,H9",4862,5065,3393,1672,3009,0,1647,1652,1179,473,2.492600423,886,1137,821,261,0,261,0,41,0,0,empty,mBC-0814-1
"G1,H10",390029,450748,260423,190325,268734,0,167204,167377,132185,35192,3.756109343,100135,73081,53207,15578,6,15572,1,1287,0,0.001733881,mm10,mBC-0814-1
"G1,H11",3926,4218,2840,1378,2558,0,1386,1386,1009,377,2.676392573,722,28,18,10,0,10,0,5,0,0,empty,mBC-0814-1
"G1,H12",2656,2796,1854,942,1735,0,977,979,694,285,2.435087719,521,1424,935,275,0,275,0,55,0,0,empty,mBC-0814-1
"G2,A1",5579,6017,4018,1999,3627,0,1989,1995,1369,626,2.186900958,1065,2646,1749,512,0,512,0,92,0,0,empty,mBC-0814-1
"G2,A2",4812,5183,3428,1755,3105,0,1655,1660,1214,446,2.721973094,891,2101,1347,465,0,465,0,113,0,0.038709677,empty,mBC-0814-1
"G2,A3",4356,4796,3150,1646,2788,0,1536,1538,1101,437,2.519450801,842,1579,1083,337,0,337,0,80,0,0,empty,mBC-0814-1
"G2,A4",5449,5787,3996,1791,3383,0,1756,1756,1270,486,2.613168724,911,609,452,160,1,159,1,30,0,0.075471698,empty,mBC-0814-1
"G2,A5",4676,4811,3407,1404,2821,0,1458,1461,1059,402,2.634328358,688,1447,1003,272,0,272,0,57,0,0,empty,mBC-0814-1
"G2,A6",3822,4248,2798,1450,2425,0,1312,1313,960,353,2.719546742,714,1468,1048,301,0,301,0,56,0,0.096345515,empty,mBC-0814-1
"G2,A7",422340,496198,275839,220359,298183,0,196991,197202,123256,73946,1.666837963,120685,41462,19366,4949,2,4947,1,586,0,0.013341419,mm10,mBC-0814-1
"G2,A8",2273,2416,1632,784,1455,0,827,828,596,232,2.568965517,434,1143,769,243,1,242,1,66,0,0,empty,mBC-0814-1
"G2,A9",7798,7821,5463,2358,4613,0,2432,2438,1715,723,2.372060858,1235,5096,2180,625,0,625,0,112,0,0.0688,empty,mBC-0814-1
"G2,A10",3377,3538,2376,1162,2132,0,1170,1170,835,335,2.492537313,608,234,169,62,0,62,0,20,0,0,empty,mBC-0814-1
"G2,A11",332959,377539,218663,158876,224569,0,140500,140614,104584,36030,2.902692201,83727,113307,79206,22660,12,22648,3,1720,0,0.001236312,mm10,mBC-0814-1
"G2,A12",396250,442351,261876,180475,259327,1,154989,155203,137298,17905,7.668137392,91021,513334,378167,106376,61,106315,2,4036,0,9.40601E-06,mm10,mBC-0814-1
"G2,B1",384225,443966,256290,187676,264767,0,164100,164282,127069,37213,3.414640045,98479,166424,117367,33585,17,33568,2,2236,0,0.001698046,mm10,mBC-0814-1
"G2,B2",4826,5233,3397,1836,3038,0,1677,1679,1168,511,2.285714286,928,2449,876,274,1,273,1,58,0,0.032967033,empty,mBC-0814-1
"G2,B3",3738,4153,2664,1489,2442,0,1356,1358,949,409,2.320293399,759,1022,761,207,0,207,0,48,0,0,empty,mBC-0814-1
"G2,B4",4054,4407,2942,1465,2609,0,1409,1410,991,419,2.365155131,752,1179,699,197,1,196,1,74,0,0,empty,mBC-0814-1
"G2,B5",4144,2899,1799,1100,2016,0,1142,1143,815,328,2.484756098,654,1301,886,324,0,324,0,68,0,0.012345679,empty,mBC-0814-1
"G2,B6",3722,3784,2645,1139,2276,0,1193,1196,862,334,2.580838323,621,1211,754,232,0,232,0,57,0,0,empty,mBC-0814-1
"G2,B7",648041,746277,439165,307112,436408,0,265816,266076,216351,49725,4.350950226,156364,243191,177613,49370,28,49342,1,2639,0,6.08001E-05,mm10,mBC-0814-1
"G2,B8",3816,4225,2755,1470,2446,0,1289,1290,887,403,2.200992556,682,952,630,218,0,218,0,53,0,0,empty,mBC-0814-1
"G2,B9",4575,4960,3315,1645,2889,0,1621,1624,1187,437,2.71624714,838,642,430,176,0,176,0,72,0,0,empty,mBC-0814-1
"G2,B10",4134,4450,2841,1609,2669,0,1489,1491,1016,475,2.138947368,832,642,438,114,0,114,0,31,0,0,empty,mBC-0814-1
"G2,B11",6146,6433,4406,2027,3727,0,2006,2006,1434,572,2.506993007,1029,193,136,48,0,48,0,15,0,0,empty,mBC-0814-1
"G2,B12",5340,5516,3819,1697,3276,0,1766,1771,1249,522,2.392720307,914,1570,1070,316,0,316,0,73,0,0,empty,mBC-0814-1
"G2,C1",549510,637703,361212,276491,372218,1,236249,236531,177848,58683,3.030656238,142040,73394,52811,14546,4,14542,1,1275,0,0,mm10,mBC-0814-1
"G2,C2",5120,5578,3629,1949,3220,0,1759,1761,1250,511,2.446183953,970,1757,1262,368,0,368,0,92,0,0.057065217,empty,mBC-0814-1
"G2,C3",7683,8380,5506,2874,5016,0,2780,2785,2038,747,2.728246319,1518,740,556,158,0,158,0,46,0,0,empty,mBC-0814-1
"G2,C4",4929,5285,3573,1712,3114,0,1649,1649,1171,478,2.449790795,864,1531,1011,313,0,313,0,88,0,0.003194888,empty,mBC-0814-1
"G2,C5",6797,7458,4838,2620,4289,0,2361,2364,1698,666,2.54954955,1302,1383,866,265,0,265,0,74,0,0.026415094,empty,mBC-0814-1
"G2,C6",690888,773716,470823,302893,459962,0,275517,275869,233135,42734,5.455492114,158254,208791,150367,42314,20,42294,1,2397,0,0.00035466,mm10,mBC-0814-1
"G2,C7",7113,7679,4941,2738,4341,0,2337,2343,1672,671,2.491803279,1244,1599,790,226,0,226,0,33,0,0.008849558,empty,mBC-0814-1
"G2,C8",5300,5719,3769,1950,3358,0,1827,1829,1309,520,2.517307692,964,2317,1843,491,0,491,0,83,0,0.010183299,empty,mBC-0814-1
"G2,C9",4577,4861,3283,1578,2785,0,1481,1484,1014,470,2.157446809,777,1066,742,236,0,236,0,64,0,0,empty,mBC-0814-1
"G2,C10",5753,5958,4127,1831,3447,0,1784,1784,1327,457,2.903719912,891,1233,867,292,0,292,0,57,0,0,empty,mBC-0814-1
"G2,C11",4605,4984,3259,1725,2996,0,1624,1624,1199,425,2.821176471,878,1508,1084,313,0,313,0,63,0,0,empty,mBC-0814-1
"G2,C12",8146,8946,5887,3059,5097,1,2802,2807,1980,827,2.394195889,1523,1429,948,326,0,326,0,78,0,0.018404908,empty,mBC-0814-1
"G2,D1",4171,4314,2967,1347,2642,2,1374,1377,989,388,2.548969072,722,776,564,160,1,159,1,47,0,0,empty,mBC-0814-1
"G2,D2",5232,5690,3859,1831,3361,0,1756,1759,1264,495,2.553535354,936,1710,1230,374,0,374,0,89,0,0,empty,mBC-0814-1
"G2,D3",10487,11257,7470,3787,6510,0,3481,3488,2470,1018,2.42632613,1850,2153,1678,515,0,515,0,112,0,0,empty,mBC-0814-1
"G2,D4",4541,4893,3257,1636,2853,0,1582,1583,1086,497,2.185110664,831,2288,1511,410,0,410,0,83,0,0.017073171,empty,mBC-0814-1
"G2,D5",4100,4467,2877,1590,2599,0,1437,1440,1059,381,2.779527559,781,1983,1525,462,0,462,0,120,0,0.084415584,empty,mBC-0814-1
"G2,D6",4864,5198,3483,1715,3094,1,1691,1695,1187,508,2.336614173,930,977,682,181,0,181,0,47,0,0,empty,mBC-0814-1
"G2,D7",5790,6273,4119,2154,3610,0,1930,1933,1347,586,2.298634812,1044,3100,2104,616,2,614,1,130,0,0.001628664,empty,mBC-0814-1
"G2,D8",4856,5387,3426,1961,3086,0,1716,1717,1240,477,2.599580713,939,1069,728,234,0,234,0,57,0,0,empty,mBC-0814-1
"G2,D9",2699,2803,1901,902,1713,0,968,970,688,282,2.439716312,500,1145,807,232,0,232,0,49,0,0,empty,mBC-0814-1
"G2,D10",3631,3881,2667,1214,2275,0,1194,1196,876,320,2.7375,615,943,660,265,0,265,0,57,0,0,empty,mBC-0814-1
"G2,D11",3976,4136,2752,1384,2545,0,1369,1370,975,395,2.46835443,761,2233,1698,540,0,540,0,117,0,0.001851852,empty,mBC-0814-1
"G2,D12",6108,6644,4335,2309,3931,0,2190,2195,1554,641,2.424336973,1205,3107,2285,736,0,736,0,143,0,0.010869565,empty,mBC-0814-1
"G2,E1",4818,5076,3480,1596,3021,0,1590,1594,1137,457,2.487964989,820,7170,2917,806,3,803,2,120,0,0.056039851,empty,mBC-0814-1
"G2,E2",3530,3861,2547,1314,2270,0,1238,1238,900,338,2.662721893,690,1608,1200,356,0,356,0,78,0,0.008426966,empty,mBC-0814-1
"G2,E3",3305,3534,2323,1211,2104,0,1131,1133,831,302,2.751655629,608,1734,1244,384,0,384,0,77,0,0,empty,mBC-0814-1
"G2,E4",3039,3424,2186,1238,1995,0,1104,1104,802,302,2.655629139,626,1227,857,286,0,286,0,76,0,0,empty,mBC-0814-1
"G2,E5",4102,4184,3031,1153,2427,0,1208,1217,893,324,2.75617284,592,16204,4822,1675,3,1672,2,170,0,0.101076555,empty,mBC-0814-1
"G2,E6",4608,4827,3287,1540,2770,0,1475,1477,1062,415,2.559036145,766,1580,1011,313,0,313,0,60,0,0,empty,mBC-0814-1
"G2,E7",4399,4673,3238,1435,2735,1,1396,1401,1018,383,2.657963446,680,4341,1918,549,1,548,1,88,0,0.031021898,empty,mBC-0814-1
"G2,E8",4580,4881,3333,1548,2867,0,1504,1504,1072,432,2.481481481,794,2349,1713,505,0,505,0,85,0,0.013861386,empty,mBC-0814-1
"G2,E9",3076,3328,2152,1176,1947,0,1046,1046,765,281,2.722419929,559,1399,975,332,1,331,1,74,0,0.024169184,empty,mBC-0814-1
"G2,E10",3984,4380,2771,1609,2542,0,1392,1392,1015,377,2.692307692,789,1896,1341,425,0,425,0,102,0,0.004705882,empty,mBC-0814-1
"G2,E11",552012,621838,377577,244261,367651,3,219912,220152,171761,48391,3.549441012,126875,155276,109304,31004,19,30985,2,1955,0,0.000161368,mm10,mBC-0814-1
"G2,E12",3872,4177,2783,1394,2430,0,1333,1337,962,375,2.565333333,690,1089,776,282,0,282,0,67,0,0,empty,mBC-0814-1
"G2,F1",4349,4688,3106,1582,2811,0,1517,1517,1086,431,2.519721578,788,1630,1090,314,0,314,0,66,0,0,empty,mBC-0814-1
"G2,F2",693799,803018,470244,332774,469420,0,291411,291728,226829,64899,3.495107783,173368,274836,200770,57202,26,57176,1,2806,0,5.24696E-05,mm10,mBC-0814-1
"G2,F3",4929,5206,3499,1707,3071,0,1655,1657,1168,489,2.388548057,850,1932,1437,423,0,423,0,90,0,0,empty,mBC-0814-1
"G2,F4",5253,5701,3819,1882,3313,0,1735,1739,1307,432,3.025462963,902,725,482,152,0,152,0,38,0,0,empty,mBC-0814-1
"G2,F5",5048,5403,3696,1707,3081,0,1631,1638,1227,411,2.98540146,824,1149,696,258,0,258,0,81,0,0.015503876,empty,mBC-0814-1
"G2,F6",4723,5006,3264,1742,2984,0,1675,1677,1197,480,2.49375,919,2353,1649,460,0,460,0,123,0,0,empty,mBC-0814-1
"G2,F7",4390,4749,3203,1546,2769,13,1459,1472,1070,402,2.661691542,782,431,304,106,0,106,0,41,0,0,empty,mBC-0814-1
"G2,F8",6033,6474,4312,2162,3836,0,2025,2030,1444,586,2.464163823,1073,193,127,51,0,51,0,18,0,0,empty,mBC-0814-1
"G2,F9",619962,696042,415752,280290,406868,2,244438,244764,211315,33449,6.317528177,142502,485117,299137,85600,62,85538,8,3735,0,0.003109729,mm10,mBC-0814-1
"G2,F10",6800,7307,5005,2302,4208,3,2238,2246,1552,694,2.236311239,1142,1989,1413,399,0,399,0,97,0,0,empty,mBC-0814-1
"G2,F11",4088,4465,2938,1527,2602,0,1391,1391,993,398,2.494974874,733,1985,1522,396,0,396,0,69,0,0,empty,mBC-0814-1
"G2,F12",4656,5113,3246,1867,2947,0,1627,1628,1176,452,2.601769912,863,163,72,27,0,27,0,12,0,0,empty,mBC-0814-1
"G2,G1",402047,448560,276267,172293,269360,3,162717,162901,115578,47323,2.442321915,93359,70977,49860,14097,4,14093,1,1287,0,0.001419144,mm10,mBC-0814-1
"G2,G2",423557,489868,284156,205712,293794,1,185841,186045,147408,38637,3.815203044,111298,8861,6343,1722,2,1720,1,249,0,0,mm10,mBC-0814-1
"G2,G3",5244,5506,3613,1893,3206,0,1774,1778,1288,490,2.628571429,982,14801,5431,1708,2,1706,2,212,0,0.140679953,empty,mBC-0814-1
"G2,G4",4996,5121,3659,1462,3041,2,1549,1551,1089,462,2.357142857,779,17,9,4,0,4,0,3,0,0,empty,mBC-0814-1
"G2,G5",4580,5006,3180,1826,2861,0,1576,1583,1102,481,2.291060291,851,1283,739,280,1,279,1,85,0,0.010752688,empty,mBC-0814-1
"G2,G6",636917,701050,445257,255793,411002,1,240607,240926,178551,62375,2.862541082,136222,6645,3784,1041,0,1041,0,148,0,0.036503362,mm10,mBC-0814-1
"G2,G7",5212,5616,3857,1759,3319,0,1801,1803,1259,544,2.314338235,931,2681,1958,663,2,661,1,129,0,0,empty,mBC-0814-1
"G2,G8",24318,29931,15148,14783,17858,0,12169,12181,7560,4621,1.636009522,7842,65345,22527,7120,15,7105,5,687,0,0.068543279,empty,mBC-0814-1
"G2,G9",850951,991007,560907,430100,583865,1,372954,373344,291359,81985,3.553808624,225511,447980,319009,90246,51,90195,8,3708,0,0.000421309,mm10,mBC-0814-1
"G2,G10",9223,9814,6526,3288,5757,0,3124,3124,2243,881,2.545970488,1704,3463,2401,696,0,696,0,187,0,0.001436782,empty,mBC-0814-1
"G2,G11",9182,9781,6685,3096,5702,0,2980,2986,2155,831,2.593261131,1529,1729,1292,453,0,453,0,101,0,0.030905077,empty,mBC-0814-1
"G2,G12",4533,4803,3167,1636,2903,0,1628,1628,1150,478,2.405857741,842,2033,1514,458,1,457,1,97,0,0.039387309,empty,mBC-0814-1
"G2,H1",4550,4875,3240,1635,2877,0,1541,1548,1078,470,2.293617021,834,590,389,150,1,149,1,54,0,0.053691275,empty,mBC-0814-1
"G2,H2",502423,579739,340365,239374,345929,3,216370,216605,155657,60948,2.55393122,129976,39164,26021,6938,7,6931,2,830,0,0.002019911,mm10,mBC-0814-1
"G2,H3",5071,5487,3522,1965,3173,0,1718,1720,1248,472,2.644067797,956,1759,1233,333,0,333,0,73,0,0.027027027,empty,mBC-0814-1
"G2,H4",5215,5739,3747,1992,3409,0,1932,1932,1420,512,2.7734375,1049,321,239,58,0,58,0,16,0,0,empty,mBC-0814-1
"G2,H5",6229,6683,4341,2342,3980,0,2187,2191,1545,646,2.391640867,1205,1381,904,323,0,323,0,86,0,0.040247678,empty,mBC-0814-1
"G2,H6",6056,6766,4236,2530,3872,0,2131,2134,1555,579,2.68566494,1220,2270,1432,397,0,397,0,125,0,0,empty,mBC-0814-1
"G2,H7",5188,5548,3768,1780,3226,0,1717,1720,1149,571,2.012259194,917,3188,1820,486,1,485,1,79,0,0.01443299,empty,mBC-0814-1
"G2,H8",341203,388003,228914,159089,228123,2,136182,136333,114746,21587,5.315513967,80235,392249,279205,79546,63,79483,5,3607,0,0.000213882,mm10,mBC-0814-1
"G2,H9",5101,5335,3631,1704,3121,0,1700,1702,1179,523,2.254302103,882,2134,1224,324,0,324,0,63,0,0.012345679,empty,mBC-0814-1
"G2,H10",3378,3525,2418,1107,2108,0,1078,1079,765,314,2.436305732,568,778,566,202,0,202,0,57,0,0,empty,mBC-0814-1
"G2,H11",3723,4150,2677,1473,2421,5,1289,1297,910,387,2.351421189,736,39,31,21,0,21,0,11,0,0,empty,mBC-0814-1
"G2,H12",272497,313372,176502,136870,189032,0,119898,120019,94438,25581,3.691724327,72855,155188,109990,30474,23,30451,3,2067,0,0.000361236,mm10,mBC-0814-1
"G3,A1",5208,5681,3727,1954,3328,0,1782,1785,1236,549,2.25136612,922,972,639,214,0,214,0,49,0,0,empty,mBC-0814-1
"G3,A2",4735,4965,3441,1524,2962,0,1572,1572,1130,442,2.556561086,844,1541,1194,358,0,358,0,90,0,0.002793296,empty,mBC-0814-1
"G3,A3",4604,4930,3289,1641,2881,0,1567,1574,1123,451,2.490022173,814,1209,932,299,0,299,0,49,0,0,empty,mBC-0814-1
"G3,A4",5185,5459,3654,1805,3285,2,1748,1757,1236,521,2.372360845,915,578,315,84,0,84,0,21,0,0,empty,mBC-0814-1
"G3,A5",4457,4710,3196,1514,2809,0,1519,1521,1050,471,2.229299363,792,5748,2286,645,2,643,2,106,0,0.069984448,empty,mBC-0814-1
"G3,A6",3657,3805,2559,1246,2330,0,1242,1244,865,379,2.2823219,654,7719,2776,837,1,836,1,115,0,0.077751196,empty,mBC-0814-1
"G3,A7",5200,5593,3637,1956,3307,0,1809,1816,1313,503,2.610337972,991,1398,990,287,1,286,1,65,0,0.003496503,empty,mBC-0814-1
"G3,A8",1987,2201,1397,804,1293,0,699,699,511,188,2.718085106,412,1214,767,214,0,214,0,60,0,0,empty,mBC-0814-1
"G3,A9",431585,492847,286465,206382,294612,1,184744,184941,146887,38054,3.859962159,109766,13063,8095,2126,2,2124,1,362,0,0,mm10,mBC-0814-1
"G3,A10",2994,3098,2145,953,1868,0,997,997,757,240,3.154166667,520,122,82,20,0,20,0,12,0,0,empty,mBC-0814-1
"G3,A11",4336,4686,3119,1567,2716,0,1492,1493,1076,417,2.580335731,796,1539,1055,391,0,391,0,83,0,0.00511509,empty,mBC-0814-1
"G3,A12",3394,3628,2380,1248,2259,0,1233,1234,863,371,2.326145553,700,2934,2170,639,0,639,0,160,0,0,empty,mBC-0814-1
"G3,B1",4411,4938,3054,1884,2856,0,1588,1591,1127,464,2.42887931,892,9335,3087,851,1,850,1,118,0,0.112941176,empty,mBC-0814-1
"G3,B2",4682,4990,3313,1677,2952,0,1623,1626,1155,471,2.452229299,837,269,156,52,0,52,0,20,0,0,empty,mBC-0814-1
"G3,B3",419828,480242,276924,203318,286687,0,177102,177282,144175,33107,4.354819223,105689,192137,138885,37862,20,37842,2,2346,0,0.000634216,mm10,mBC-0814-1
"G3,B4",4204,4464,2956,1508,2670,11,1453,1467,1078,389,2.771208226,780,2374,925,327,0,327,0,74,0,0.021406728,empty,mBC-0814-1
"G3,B5",430554,295506,165616,129890,212762,1,133865,134359,102628,31731,3.234313447,83960,224022,113244,31173,42,31131,6,2367,0,0.025986958,mm10,mBC-0814-1
"G3,B6",3647,3868,2544,1324,2321,0,1248,1250,887,363,2.443526171,678,1037,654,190,0,190,0,59,0,0,empty,mBC-0814-1
"G3,B7",4936,5187,3541,1646,3175,0,1741,1747,1266,481,2.632016632,901,1942,1049,304,0,304,0,58,0,0,empty,mBC-0814-1
"G3,B8",3563,3837,2560,1277,2284,0,1230,1230,875,355,2.464788732,702,1045,754,170,0,170,0,42,0,0,empty,mBC-0814-1
"G3,B9",4188,4558,2972,1586,2748,0,1519,1522,1081,441,2.451247166,845,355,208,79,0,79,0,41,0,0,empty,mBC-0814-1
"G3,B10",3933,4153,2711,1442,2488,3,1368,1375,976,399,2.446115288,754,702,488,107,0,107,0,21,0,0,empty,mBC-0814-1
"G3,B11",7647,8286,5534,2752,4914,0,2751,2753,1984,769,2.579973992,1452,102,68,37,0,37,0,9,0,0,empty,mBC-0814-1
"G3,B12",4930,5413,3494,1919,3158,0,1750,1757,1280,477,2.683438155,939,932,634,227,1,226,1,49,0,0.013274336,empty,mBC-0814-1
"G3,C1",5284,5609,3807,1802,3310,0,1702,1705,1192,513,2.323586745,934,683,475,156,0,156,0,35,0,0,empty,mBC-0814-1
"G3,C2",5200,5480,3762,1718,3180,0,1695,1698,1208,490,2.465306122,871,1987,1458,443,2,441,1,91,0,0.009070295,empty,mBC-0814-1
"G3,C3",7408,7988,5267,2721,4767,0,2729,2735,2016,719,2.803894298,1474,593,386,112,0,112,0,31,0,0,empty,mBC-0814-1
"G3,C4",4537,5052,3215,1837,3026,0,1679,1682,1244,438,2.840182648,929,1118,833,262,1,261,1,68,0,0.030651341,empty,mBC-0814-1
"G3,C5",6736,7061,4783,2278,4189,0,2235,2239,1604,635,2.525984252,1189,1432,1104,285,1,284,1,74,0,0,empty,mBC-0814-1
"G3,C6",4930,5188,3539,1649,3241,0,1772,1784,1267,517,2.450676983,923,2746,1426,424,0,424,0,65,0,0.002358491,empty,mBC-0814-1
"G3,C7",6412,6930,4595,2335,4028,0,2184,2185,1559,626,2.490415335,1177,400,286,103,0,103,0,28,0,0,empty,mBC-0814-1
"G3,C8",4939,5357,3606,1751,3188,0,1710,1712,1239,473,2.619450317,907,1446,976,320,0,320,0,72,0,0,empty,mBC-0814-1
"G3,C9",4387,4688,3107,1581,2802,1,1492,1498,1087,411,2.644768856,823,1157,844,266,0,266,0,51,0,0,empty,mBC-0814-1
"G3,C10",5210,5615,3787,1828,3326,0,1750,1750,1258,492,2.556910569,925,1059,683,213,0,213,0,42,0,0.028169014,empty,mBC-0814-1
"G3,C11",4438,4935,3173,1762,2801,6,1560,1568,1130,438,2.579908676,863,1571,1162,315,0,315,0,61,0,0,empty,mBC-0814-1
"G3,C12",7621,8321,5267,3054,4902,0,2786,2791,1974,817,2.416156671,1578,2046,1405,410,0,410,0,69,0,0.041463415,empty,mBC-0814-1
"G3,D1",3935,4119,2712,1407,2482,0,1326,1329,970,359,2.701949861,722,692,359,103,0,103,0,38,0,0.058252427,empty,mBC-0814-1
"G3,D2",5075,5323,3672,1651,3041,0,1569,1573,1107,466,2.375536481,805,1562,1189,324,0,324,0,57,0,0,empty,mBC-0814-1
"G3,D3",9969,10664,7128,3536,6221,0,3363,3370,2385,985,2.421319797,1760,1782,1165,363,0,363,0,71,0,0.002754821,empty,mBC-0814-1
"G3,D4",4273,4581,2973,1608,2698,0,1482,1482,1083,399,2.714285714,813,4661,1938,636,1,635,1,96,0,0.048818898,empty,mBC-0814-1
"G3,D5",3978,4205,2780,1425,2530,0,1402,1402,1017,385,2.641558442,769,6821,2618,860,4,856,1,134,0,0,empty,mBC-0814-1
"G3,D6",4551,4900,3238,1662,2879,0,1597,1605,1155,450,2.566666667,860,759,510,199,0,199,0,49,0,0,empty,mBC-0814-1
"G3,D7",5390,5623,3954,1669,3319,0,1740,1749,1263,486,2.598765432,891,1627,1154,374,0,374,0,85,0,0,empty,mBC-0814-1
"G3,D8",9012,10351,6561,3790,6088,0,3422,3422,2628,794,3.309823678,1912,3688,2681,717,1,716,1,120,0,0.016759777,empty,mBC-0814-1
"G3,D9",2657,2685,1903,782,1668,0,880,880,605,275,2.2,433,770,496,153,0,153,0,31,0,0,empty,mBC-0814-1
"G3,D10",3532,3882,2489,1393,2261,0,1252,1256,907,349,2.598853868,685,956,753,227,0,227,0,37,0,0,empty,mBC-0814-1
"G3,D11",3924,4153,2751,1402,2512,4,1368,1378,971,407,2.385749386,745,2064,1485,403,0,403,0,112,0,0,empty,mBC-0814-1
"G3,D12",5772,6225,4101,2124,3710,0,2044,2050,1502,548,2.740875912,1114,2750,1904,578,1,577,1,112,0,0,empty,mBC-0814-1
"G3,E1",4727,5142,3354,1788,3022,0,1558,1561,1097,464,2.364224138,865,1650,1120,297,0,297,0,65,0,0,empty,mBC-0814-1
"G3,E2",3284,3591,2332,1259,2118,0,1123,1125,809,316,2.560126582,620,1278,855,261,0,261,0,62,0,0,empty,mBC-0814-1
"G3,E3",3256,3504,2305,1199,2066,0,1126,1128,817,311,2.627009646,611,1248,805,223,0,223,0,60,0,0.094170404,empty,mBC-0814-1
"G3,E4",2916,3093,2066,1027,1872,0,1068,1068,768,300,2.56,578,1126,772,247,0,247,0,47,0,0,empty,mBC-0814-1
"G3,E5",3565,3896,2600,1296,2279,0,1180,1181,832,349,2.383954155,630,949,674,188,0,188,0,37,0,0.058510638,empty,mBC-0814-1
"G3,E6",4342,4418,3120,1298,2617,0,1366,1370,965,405,2.382716049,696,1068,684,216,0,216,0,49,0,0,empty,mBC-0814-1
"G3,E7",4492,4817,3229,1588,2784,0,1446,1447,1011,436,2.318807339,785,1376,958,289,0,289,0,55,0,0,empty,mBC-0814-1
"G3,E8",4386,4744,3156,1588,2865,0,1558,1558,1145,413,2.772397094,849,1748,1219,358,0,358,0,81,0,0,empty,mBC-0814-1
"G3,E9",392014,461578,248923,212655,273955,0,182308,182499,132845,49654,2.675413864,112739,175711,125701,35569,12,35557,2,2247,0,0.000309362,mm10,mBC-0814-1
"G3,E10",3970,4260,2856,1404,2476,1,1310,1321,929,392,2.369897959,682,1732,1281,367,0,367,0,82,0,0.002724796,empty,mBC-0814-1
"G3,E11",3930,4391,2790,1601,2529,0,1392,1400,981,419,2.341288783,783,1612,1058,288,0,288,0,70,0,0,empty,mBC-0814-1
"G3,E12",3565,3760,2582,1178,2232,0,1234,1235,902,333,2.708708709,635,844,539,167,0,167,0,37,0,0,empty,mBC-0814-1
"G3,F1",4503,4796,3229,1567,2773,0,1484,1489,1068,421,2.536817102,774,1420,967,239,0,239,0,55,0,0,empty,mBC-0814-1
"G3,F2",648577,767081,419370,347711,450659,1,294799,295137,236195,58942,4.00724441,180493,195883,139586,39081,22,39059,2,2373,0,5.12046E-05,mm10,mBC-0814-1
"G3,F3",1103290,1269225,740783,528442,741011,0,459677,460171,386812,73359,5.272863589,272639,554777,399281,113305,57,113248,3,4404,0,0.000547471,mm10,mBC-0814-1
"G3,F4",5013,5222,3614,1608,3143,0,1671,1673,1213,460,2.636956522,848,499,344,113,0,113,0,23,0,0,empty,mBC-0814-1
"G3,F5",627843,755018,397824,357194,446205,2,307448,307753,194751,113002,1.723429674,192377,32528,19250,5373,4,5369,1,555,0,0.021605513,mm10,mBC-0814-1
"G3,F6",4569,4827,3280,1547,2834,13,1542,1558,1149,409,2.809290954,818,4115,2003,577,1,576,1,120,0,0.074652778,empty,mBC-0814-1
"G3,F7",4508,4919,3133,1786,2908,0,1555,1559,1124,435,2.583908046,857,808,563,171,0,171,0,33,0,0,empty,mBC-0814-1
"G3,F8",5998,6482,4319,2163,3828,0,2029,2030,1468,562,2.612099644,1094,171,136,46,0,46,0,12,0,0,empty,mBC-0814-1
"G3,F9",5098,5272,3647,1625,3169,0,1672,1675,1227,448,2.738839286,867,1537,1118,385,0,385,0,81,0,0.002597403,empty,mBC-0814-1
"G3,F10",1270578,1455631,857986,597645,847211,0,529573,530145,419814,110331,3.805041194,311204,254475,181956,50514,29,50485,2,2857,0,1.98079E-05,mm10,mBC-0814-1
"G3,F11",4566,4698,3221,1477,2826,0,1514,1518,1102,416,2.649038462,816,7161,2830,856,2,854,1,108,0,0.003512881,empty,mBC-0814-1
"G3,F12",4982,5695,3532,2163,3327,0,1890,1891,1399,492,2.843495935,1087,70,49,17,0,17,0,7,0,0,empty,mBC-0814-1
"G3,G1",6734,7069,4657,2412,4309,3,2362,2365,1724,641,2.689547582,1266,3614,2285,687,0,687,0,145,0,0.004366812,empty,mBC-0814-1
"G3,G2",5094,5562,3722,1840,3259,0,1753,1754,1257,497,2.52917505,937,678,287,93,0,93,0,22,0,0.139784946,empty,mBC-0814-1
"G3,G3",6194,6798,4318,2480,4062,0,2362,2363,1617,746,2.167560322,1339,2367,1730,486,0,486,0,86,0,0.002057613,empty,mBC-0814-1
"G3,G4",5042,5566,3628,1938,3210,0,1750,1750,1257,493,2.54969574,936,3,2,2,0,2,0,2,0,0,empty,mBC-0814-1
"G3,G5",4133,4382,2958,1424,2605,0,1424,1427,1017,410,2.480487805,751,1408,1004,227,0,227,0,50,0,0,empty,mBC-0814-1
"G3,G6",8273,8661,5860,2801,5115,0,2749,2752,2011,741,2.713900135,1418,50,20,14,0,14,0,9,0,0,empty,mBC-0814-1
"G3,G7",5069,5449,3594,1855,3274,0,1789,1791,1274,517,2.464216634,969,1432,921,314,0,314,0,75,0,0.01910828,empty,mBC-0814-1
"G3,G8",6725,7353,4765,2588,4336,0,2393,2403,1676,727,2.305364512,1322,2962,1831,532,0,532,0,120,0,0.003759398,empty,mBC-0814-1
"G3,G9",5092,5495,3571,1924,3291,0,1816,1817,1295,522,2.480842912,989,2221,1551,461,0,461,0,109,0,0.019522777,empty,mBC-0814-1
"G3,G10",16102,17485,10761,6724,10537,0,6215,6223,3957,2266,1.746248897,3571,30175,10329,3225,3,3222,2,314,0,0.134388579,empty,mBC-0814-1
"G3,G11",511284,586797,344101,242696,348089,0,214501,214769,170289,44480,3.828439748,127184,68676,47646,13381,6,13375,4,1158,0,0.000149533,mm10,mBC-0814-1
"G3,G12",4403,4697,3124,1573,2772,0,1518,1519,1076,443,2.428893905,780,1708,1223,395,0,395,0,77,0,0.027848101,empty,mBC-0814-1
"G3,H1",4428,4830,3086,1744,2878,0,1576,1580,1099,481,2.284823285,894,649,437,145,0,145,0,38,0,0.096551724,empty,mBC-0814-1
"G3,H2",8002,8499,5728,2771,5043,0,2762,2762,1977,785,2.518471338,1457,2042,1308,450,0,450,0,127,0,0.013333333,empty,mBC-0814-1
"G3,H3",4802,5134,3382,1752,3000,0,1611,1616,1137,479,2.373695198,889,1421,989,340,0,340,0,76,0,0,empty,mBC-0814-1
"G3,H4",431360,494462,286542,207920,292920,0,183370,183620,143648,39972,3.593715601,109301,6198,4154,1138,1,1137,1,163,0,0.009674582,mm10,mBC-0814-1
"G3,H5",6367,6768,4562,2206,3900,3,2122,2127,1522,605,2.515702479,1119,2234,1692,468,0,468,0,76,0,0.027777778,empty,mBC-0814-1
"G3,H6",5723,6137,4141,1996,3674,0,2001,2006,1467,539,2.721706865,1063,3300,1963,585,0,585,0,103,0,0,empty,mBC-0814-1
"G3,H7",5145,5420,3610,1810,3175,0,1765,1765,1279,486,2.631687243,924,7235,2574,799,0,799,0,106,0,0,empty,mBC-0814-1
"G3,H8",11741,13423,7951,5472,8119,0,5063,5065,3683,1382,2.664978292,2955,1415,1016,264,0,264,0,70,0,0,empty,mBC-0814-1
"G3,H9",4307,4553,3059,1494,2677,0,1451,1455,1042,413,2.523002421,769,2803,1462,501,0,501,0,62,0,0.185628743,empty,mBC-0814-1
"G3,H10",3541,3759,2482,1277,2143,0,1145,1145,832,313,2.658146965,613,643,464,152,0,152,0,38,0,0,empty,mBC-0814-1
"G3,H11",3570,3767,2631,1136,2256,0,1232,1232,888,344,2.581395349,635,38,28,20,0,20,0,4,0,0,empty,mBC-0814-1
"G3,H12",2332,2437,1583,854,1404,0,775,775,550,225,2.444444444,399,1231,779,239,0,239,0,58,0,0.108786611,empty,mBC-0814-1
"G4,A1",6381,6847,4568,2279,4051,0,2172,2172,1558,614,2.537459283,1167,7288,2899,934,0,934,0,124,0,0.014989293,empty,mBC-0814-1
"G4,A2",1732320,1959833,1157306,802527,1119224,3,699009,699866,559293,140573,3.978665889,411860,755881,554382,159909,106,159803,7,5220,0,0.000143927,mm10,mBC-0814-1
"G4,A3",5310,5716,3733,1983,3385,0,1851,1860,1345,515,2.611650485,1003,1020,710,234,0,234,0,48,0,0,empty,mBC-0814-1
"G4,A4",6046,6313,4408,1905,3661,0,1942,1945,1387,558,2.485663082,993,579,379,113,0,113,0,28,0,0,empty,mBC-0814-1
"G4,A5",5533,5949,3942,2007,3502,0,1893,1895,1322,573,2.307155323,1058,1433,1057,324,0,324,0,60,0,0,empty,mBC-0814-1
"G4,A6",4374,4654,3064,1590,2748,0,1468,1475,1036,439,2.359908884,805,2875,1474,456,0,456,0,66,0,0.046052632,empty,mBC-0814-1
"G4,A7",6078,6577,4350,2227,3937,0,2142,2143,1553,590,2.63220339,1142,1441,918,273,0,273,0,77,0,0,empty,mBC-0814-1
"G4,A8",2566,2870,1770,1100,1658,0,922,922,646,276,2.34057971,516,1483,1055,304,0,304,0,71,0,0,empty,mBC-0814-1
"G4,A9",7558,7911,5387,2524,4614,0,2462,2467,1778,689,2.580551524,1294,1934,1205,394,0,394,0,87,0,0,empty,mBC-0814-1
"G4,A10",3982,4354,2786,1568,2627,0,1473,1473,1038,435,2.386206897,807,103,80,31,0,31,0,15,0,0,empty,mBC-0814-1
"G4,A11",52631,59993,37276,22717,34981,0,20908,20936,15113,5823,2.595397561,11765,3821,2465,675,0,675,0,138,0,0.004444444,empty,mBC-0814-1
"G4,A12",449852,511807,299603,212204,298557,1,185712,185929,145694,40235,3.621076177,109730,341620,239470,67996,38,67958,5,3277,0,0.000367874,mm10,mBC-0814-1
"G4,B1",5530,5987,3982,2005,3462,0,1880,1884,1342,542,2.47601476,982,1343,893,306,0,306,0,67,0,0.029411765,empty,mBC-0814-1
"G4,B2",5364,5703,3727,1976,3276,0,1743,1743,1268,475,2.669473684,939,359,263,84,0,84,0,29,0,0,empty,mBC-0814-1
"G4,B3",4479,4956,3181,1775,2908,0,1647,1649,1139,510,2.233333333,888,1266,737,263,0,263,0,48,0,0,empty,mBC-0814-1
"G4,B4",5079,5470,3627,1843,3167,0,1672,1681,1245,436,2.855504587,895,1121,698,276,0,276,0,77,0,0,empty,mBC-0814-1
"G4,B5",4677,3391,2144,1247,2350,0,1364,1369,985,384,2.565104167,791,1210,832,274,0,274,0,58,0,0,empty,mBC-0814-1
"G4,B6",4792,5262,3470,1792,3061,0,1706,1712,1218,494,2.465587045,911,1285,871,306,0,306,0,61,0,0,empty,mBC-0814-1
"G4,B7",5781,6061,4210,1851,3520,0,1871,1872,1319,553,2.38517179,936,1268,932,299,0,299,0,71,0,0,empty,mBC-0814-1
"G4,B8",4378,4793,3054,1739,2773,0,1518,1524,1120,404,2.772277228,829,9791,3374,1064,0,1064,0,136,0,0.059210526,empty,mBC-0814-1
"G4,B9",520461,609773,346904,262869,357186,1,225527,225756,180201,45555,3.955679947,135974,48724,34494,9681,4,9677,1,965,0,0.001860081,mm10,mBC-0814-1
"G4,B10",5250,5574,3748,1826,3300,1,1766,1774,1253,521,2.404990403,952,354,216,85,0,85,0,22,0,0,empty,mBC-0814-1
"G4,B11",7030,7849,5027,2822,4585,0,2484,2490,1707,783,2.180076628,1394,105,77,35,0,35,0,12,0,0,empty,mBC-0814-1
"G4,B12",7099,7901,4896,3005,4613,0,2703,2704,1666,1038,1.605009634,1507,10514,3673,1139,1,1138,1,137,0,0.031634446,empty,mBC-0814-1
"G4,C1",15382,17167,10781,6386,9837,0,5650,5662,3936,1726,2.280417149,3138,1820,1368,362,0,362,0,67,0,0,empty,mBC-0814-1
"G4,C2",783151,910284,519057,391227,525663,1,336044,336426,247684,88742,2.791057222,201757,134050,95258,26656,17,26639,3,1921,0,0.000450467,mm10,mBC-0814-1
"G4,C3",6391,7109,4610,2499,4141,0,2348,2354,1718,636,2.701257862,1294,523,394,125,0,125,0,39,0,0,empty,mBC-0814-1
"G4,C4",6012,6350,4403,1947,3686,0,1932,1932,1413,519,2.722543353,1007,11923,3993,1296,1,1295,1,144,0,0.111196911,empty,mBC-0814-1
"G4,C5",8150,8760,5872,2888,4988,0,2679,2683,1925,758,2.539577836,1373,1218,903,269,0,269,0,71,0,0,empty,mBC-0814-1
"G4,C6",5826,6379,4161,2218,3750,0,2047,2047,1452,595,2.440336134,1098,1760,1209,305,0,305,0,83,0,0.003278689,empty,mBC-0814-1
"G4,C7",7798,8541,5574,2967,4909,0,2681,2681,1952,729,2.677640604,1474,286,184,56,0,56,0,18,0,0,empty,mBC-0814-1
"G4,C8",6105,6594,4374,2220,3835,0,2051,2052,1495,557,2.684021544,1071,2006,1439,450,1,449,1,83,0,0,empty,mBC-0814-1
"G4,C9",5111,5504,3739,1765,3216,0,1733,1736,1275,461,2.765726681,908,866,608,208,0,208,0,55,0,0,empty,mBC-0814-1
"G4,C10",6265,6628,4489,2139,3766,0,2045,2045,1528,517,2.955512573,1032,1182,799,253,0,253,0,58,0,0.031620553,empty,mBC-0814-1
"G4,C11",5188,5566,3722,1844,3275,0,1734,1737,1230,507,2.426035503,919,1709,1145,357,0,357,0,61,0,0.044817927,empty,mBC-0814-1
"G4,C12",9107,9953,6538,3415,5756,0,3155,3159,2263,896,2.525669643,1710,2257,1338,344,0,344,0,65,0,0,empty,mBC-0814-1
"G4,D1",5018,5337,3647,1690,3170,0,1680,1682,1188,494,2.4048583,872,418,275,78,0,78,0,29,0,0,empty,mBC-0814-1
"G4,D2",10229,11276,6998,4278,6473,2,3763,3771,2419,1352,1.789201183,2117,28958,9633,3094,3,3091,2,335,0,0.083791653,empty,mBC-0814-1
"G4,D3",12342,13030,8834,4196,7719,0,4127,4134,2903,1231,2.358245329,2193,2402,1547,516,0,516,0,107,0,0,empty,mBC-0814-1
"G4,D4",5457,5975,3805,2170,3392,0,1837,1840,1310,530,2.471698113,1043,1624,1148,343,0,343,0,94,0,0.002915452,empty,mBC-0814-1
"G4,D5",5388,5746,3825,1921,3431,0,1858,1858,1390,468,2.97008547,1033,2184,1489,445,0,445,0,93,0,0.024719101,empty,mBC-0814-1
"G4,D6",5606,6098,3979,2119,3475,2,1872,1874,1343,531,2.529190207,1035,1076,716,235,0,235,0,62,0,0,empty,mBC-0814-1
"G4,D7",6896,7701,4848,2853,4416,0,2434,2436,1757,679,2.587628866,1376,12175,4414,1306,1,1305,1,181,0,0.022988506,empty,mBC-0814-1
"G4,D8",5479,5982,3860,2122,3445,0,1871,1876,1304,572,2.27972028,1049,821,524,190,0,190,0,54,0,0,empty,mBC-0814-1
"G4,D9",3543,4024,2593,1431,2331,0,1260,1265,910,355,2.563380282,679,1083,776,249,0,249,0,52,0,0,empty,mBC-0814-1
"G4,D10",4175,4521,2961,1560,2648,0,1461,1466,1060,406,2.610837438,806,536,340,121,0,121,0,38,0,0,empty,mBC-0814-1
"G4,D11",5139,5278,3529,1749,3107,0,1657,1661,1178,483,2.438923395,884,26378,9857,3118,3,3115,1,339,0,0.184269663,empty,mBC-0814-1
"G4,D12",7574,8293,5241,3052,4776,0,2644,2652,1889,763,2.475753604,1507,3551,2366,650,1,649,1,119,0,0,empty,mBC-0814-1
"G4,E1",5855,6309,4228,2081,3666,0,1924,1926,1353,573,2.361256545,1046,13531,4252,1267,1,1266,1,156,0,0.028436019,empty,mBC-0814-1
"G4,E2",4143,4463,2885,1578,2605,0,1395,1395,1000,395,2.53164557,757,2964,1427,473,0,473,0,114,0,0.080338266,empty,mBC-0814-1
"G4,E3",4256,4492,3097,1395,2574,0,1346,1347,956,391,2.445012788,664,1472,1011,308,0,308,0,75,0,0.003246753,empty,mBC-0814-1
"G4,E4",3825,4073,2774,1299,2378,0,1243,1250,911,339,2.687315634,664,1108,721,195,0,195,0,56,0,0,empty,mBC-0814-1
"G4,E5",4035,4300,3027,1273,2489,0,1217,1217,886,331,2.67673716,588,966,748,198,0,198,0,35,0,0,empty,mBC-0814-1
"G4,E6",5248,5770,3765,2005,3279,0,1733,1734,1273,461,2.761388286,938,5078,1836,590,1,589,1,92,0,0.042444822,empty,mBC-0814-1
"G4,E7",5048,5437,3753,1684,3092,0,1623,1630,1151,479,2.402922756,829,1301,843,253,1,252,1,64,0,0,empty,mBC-0814-1
"G4,E8",5410,5904,3971,1933,3357,0,1743,1747,1250,497,2.515090543,933,1825,1247,350,0,350,0,81,0,0,empty,mBC-0814-1
"G4,E9",4156,4450,2949,1501,2536,0,1380,1383,992,391,2.537084399,740,5093,1852,580,0,580,0,107,0,0.029310345,empty,mBC-0814-1
"G4,E10",4645,5196,3286,1910,3046,0,1713,1718,1196,522,2.291187739,976,1175,750,259,0,259,0,81,0,0,empty,mBC-0814-1
"G4,E11",5009,5240,3578,1662,3018,0,1571,1571,1077,494,2.180161943,803,1801,1088,336,0,336,0,85,0,0,empty,mBC-0814-1
"G4,E12",4537,4809,3243,1566,2875,1,1550,1554,1078,476,2.264705882,827,877,603,181,0,181,0,57,0,0.08839779,empty,mBC-0814-1
"G4,F1",5248,5566,3700,1866,3299,0,1780,1780,1274,506,2.517786561,925,1386,1025,297,0,297,0,60,0,0.026936027,empty,mBC-0814-1
"G4,F2",7302,7845,5223,2622,4667,0,2545,2550,1862,688,2.706395349,1417,2199,1431,500,0,500,0,143,0,0,empty,mBC-0814-1
"G4,F3",6023,6675,4346,2329,3926,0,2115,2123,1572,551,2.852994555,1136,2156,1517,433,0,433,0,93,0,0.032332564,empty,mBC-0814-1
"G4,F4",6051,6220,4234,1986,3691,0,1956,1960,1400,560,2.5,1002,489,364,105,0,105,0,21,0,0,empty,mBC-0814-1
"G4,F5",5707,6137,4101,2036,3550,0,1995,1998,1428,570,2.505263158,1048,1581,1140,355,0,355,0,68,0,0,empty,mBC-0814-1
"G4,F6",5961,6391,4275,2116,3668,1,1988,1991,1474,517,2.85106383,1044,2792,1734,493,0,493,0,108,0,0.002028398,empty,mBC-0814-1
"G4,F7",4960,5312,3556,1756,3095,0,1682,1684,1200,484,2.479338843,872,585,401,127,0,127,0,38,0,0,empty,mBC-0814-1
"G4,F8",9307,10253,6563,3690,6023,3,3356,3367,2518,849,2.965842167,1880,335,259,91,0,91,0,15,0,0,empty,mBC-0814-1
"G4,F9",6167,6635,4476,2159,3949,0,2163,2164,1559,605,2.576859504,1165,2446,1803,559,0,559,0,103,0,0.025044723,empty,mBC-0814-1
"G4,F10",7325,7773,5437,2336,4564,0,2369,2372,1671,701,2.383737518,1232,1336,1035,335,0,335,0,86,0,0,empty,mBC-0814-1
"G4,F11",5073,5478,3647,1831,3144,0,1655,1659,1160,499,2.324649299,878,1264,800,284,0,284,0,68,0,0.003521127,empty,mBC-0814-1
"G4,F12",5490,5983,3928,2055,3461,0,1951,1951,1322,629,2.101748808,1062,141,99,35,0,35,0,14,0,0,empty,mBC-0814-1
"G4,G1",746946,854635,507629,347006,496809,2,306675,307069,207105,99964,2.071795847,180293,189142,136890,38142,20,38122,5,2445,0,0.000262316,mm10,mBC-0814-1
"G4,G2",6443,6782,4631,2151,3908,0,2071,2074,1477,597,2.474036851,1062,584,345,98,0,98,0,19,0,0,empty,mBC-0814-1
"G4,G3",5814,6502,4151,2351,3731,0,2061,2065,1536,529,2.903591682,1165,2156,1523,476,0,476,0,116,0,0,empty,mBC-0814-1
"G4,G4",5784,6107,4149,1958,3570,0,1903,1904,1357,547,2.480804388,1011,0,0,0,0,0,0,0,0,0,empty,mBC-0814-1
"G4,G5",5081,5410,3718,1692,3161,0,1693,1695,1191,504,2.363095238,895,1202,817,242,0,242,0,55,0,0.05785124,empty,mBC-0814-1
"G4,G6",9818,10228,7101,3127,6070,0,3235,3239,2330,909,2.563256326,1655,260,200,66,0,66,0,14,0,0,empty,mBC-0814-1
"G4,G7",6517,7083,4684,2399,4202,0,2309,2312,1692,620,2.729032258,1256,2707,1866,519,0,519,0,108,0,0.034682081,empty,mBC-0814-1
"G4,G8",427442,504510,281563,222947,297590,0,187802,188024,146039,41985,3.47836132,114919,434262,303293,86093,64,86029,4,3732,0,0.002720013,mm10,mBC-0814-1
"G4,G9",6578,7254,4721,2533,4304,0,2432,2439,1808,631,2.865293185,1347,3431,2575,693,0,693,0,144,0,0,empty,mBC-0814-1
"G4,G10",10758,11567,7613,3954,6738,0,3664,3669,2609,1060,2.461320755,1976,3141,2066,672,0,672,0,178,0,0,empty,mBC-0814-1
"G4,G11",10453,11314,7556,3758,6554,0,3483,3485,2498,987,2.530901722,1851,1551,933,278,0,278,0,86,0,0,empty,mBC-0814-1
"G4,G12",5588,6078,3957,2121,3542,0,1928,1928,1375,553,2.486437613,1022,18493,6013,1807,3,1804,2,255,0,0.004988914,empty,mBC-0814-1
"G4,H1",4910,5293,3582,1711,3090,0,1657,1661,1206,455,2.650549451,846,745,464,166,0,166,0,48,0,0,empty,mBC-0814-1
"G4,H2",709951,841344,466849,374495,490302,1,317704,318059,248730,69329,3.587676153,194397,234582,172156,48586,34,48552,3,2614,0,0.000432526,mm10,mBC-0814-1
"G4,H3",6177,6897,4415,2482,3931,0,2137,2144,1527,617,2.474878444,1213,1839,1344,379,0,379,0,89,0,0,empty,mBC-0814-1
"G4,H4",6335,6932,4517,2415,4052,0,2256,2263,1598,665,2.403007519,1234,58,34,12,0,12,0,8,0,0,empty,mBC-0814-1
"G4,H5",7439,8076,5359,2717,4598,0,2504,2507,1752,755,2.320529801,1359,1927,1226,330,1,329,1,70,0,0.012158055,empty,mBC-0814-1
"G4,H6",7079,7314,5122,2192,4305,7,2327,2334,1672,662,2.525679758,1158,2751,1951,551,1,550,1,105,0,0,empty,mBC-0814-1
"G4,H7",6106,6570,4361,2209,3851,0,2105,2107,1525,582,2.620274914,1113,1268,798,260,0,260,0,59,0,0,empty,mBC-0814-1
"G4,H8",5238,5660,3742,1918,3280,0,1825,1834,1272,562,2.263345196,953,2887,2172,602,0,602,0,109,0,0,empty,mBC-0814-1
"G4,H9",6399,7055,4563,2492,4130,0,2238,2238,1606,632,2.541139241,1232,1276,839,318,0,318,0,59,0,0,empty,mBC-0814-1
"G4,H10",4034,4658,2904,1754,2734,0,1530,1532,1109,423,2.621749409,884,995,753,226,0,226,0,45,0,0,empty,mBC-0814-1
"G4,H11",4570,5030,3257,1773,2910,0,1643,1645,1186,459,2.583877996,851,32,20,12,0,12,0,9,0,0,empty,mBC-0814-1
"G4,H12",3337,3746,2362,1384,2190,0,1248,1250,914,336,2.720238095,693,1192,838,279,0,279,0,69,0,0.043010753,empty,mBC-0814-1
"G5,A1",5963,6363,4325,2038,3631,0,1943,1945,1402,543,2.581952118,994,1073,765,220,0,220,0,41,0,0,empty,mBC-0814-1
"G5,A2",5985,6370,4169,2201,3702,0,2016,2019,1456,563,2.586145648,1092,1518,1033,414,0,414,0,89,0,0,empty,mBC-0814-1
"G5,A3",4902,5288,3520,1768,3099,0,1678,1678,1194,484,2.466942149,917,915,603,183,0,183,0,43,0,0,empty,mBC-0814-1
"G5,A4",838275,986698,539012,447686,569045,0,386288,386707,285070,101637,2.804785659,236251,34394,23602,6323,6,6317,3,731,0,0,mm10,mBC-0814-1
"G5,A5",5065,5410,3601,1809,3204,1,1737,1739,1250,489,2.556237219,889,1228,881,311,0,311,0,46,0,0,empty,mBC-0814-1
"G5,A6",5624,6186,3919,2267,3709,0,2133,2136,1502,634,2.369085174,1186,857,599,201,0,201,0,45,0,0.004975124,empty,mBC-0814-1
"G5,A7",5684,6349,4043,2306,3691,7,2091,2105,1510,595,2.537815126,1159,1475,1001,295,1,294,1,61,0,0,empty,mBC-0814-1
"G5,A8",2289,2541,1638,903,1503,0,812,814,567,247,2.295546559,446,1293,887,248,1,247,1,51,0,0.052631579,empty,mBC-0814-1
"G5,A9",6670,7144,4767,2377,4145,0,2258,2258,1639,619,2.647819063,1221,1821,1097,273,0,273,0,58,0,0,empty,mBC-0814-1
"G5,A10",3732,4037,2569,1468,2354,0,1342,1342,963,379,2.540897098,744,103,79,21,0,21,0,4,0,0,empty,mBC-0814-1
"G5,A11",5043,5389,3604,1785,3223,0,1687,1689,1242,447,2.77852349,916,1842,1214,350,1,349,1,81,0,0,empty,mBC-0814-1
"G5,A12",346321,399684,228469,171215,236001,0,148408,148619,118430,30189,3.922952069,89353,347812,250421,71017,47,70970,3,3325,0,0.000648161,mm10,mBC-0814-1
"G5,B1",4931,5289,3488,1801,3071,0,1643,1644,1174,470,2.49787234,892,6595,2448,777,0,777,0,106,0,0.03989704,empty,mBC-0814-1
"G5,B2",4893,5266,3436,1830,3069,0,1657,1657,1203,454,2.649779736,922,257,180,61,0,61,0,15,0,0,empty,mBC-0814-1
"G5,B3",4212,4660,2967,1693,2761,0,1546,1548,1124,424,2.650943396,859,808,463,175,0,175,0,39,0,0,empty,mBC-0814-1
"G5,B4",4521,4830,3227,1603,2900,0,1535,1540,1089,451,2.414634146,792,966,581,187,0,187,0,38,0,0.064171123,empty,mBC-0814-1
"G5,B5",4720,3453,2106,1347,2323,0,1343,1348,972,376,2.585106383,779,2237,1037,285,2,283,1,61,0,0,empty,mBC-0814-1
"G5,B6",4116,4513,2973,1540,2632,0,1471,1476,1008,468,2.153846154,772,836,544,197,0,197,0,38,0,0,empty,mBC-0814-1
"G5,B7",4881,5271,3496,1775,3050,0,1653,1657,1206,451,2.67405765,908,753,495,140,0,140,0,36,0,0,empty,mBC-0814-1
"G5,B8",366189,418489,246617,171872,249606,0,155497,155699,116873,38826,3.010173595,92224,19755,13938,4074,0,4074,0,429,0,0.004172803,mm10,mBC-0814-1
"G5,B9",5400,5861,3621,2240,3408,0,1949,1958,1409,549,2.566484517,1096,26212,8347,2567,3,2564,3,243,0,0.169656786,empty,mBC-0814-1
"G5,B10",4870,5140,3331,1809,3011,0,1687,1690,1180,510,2.31372549,914,498,361,77,0,77,0,20,0,0,empty,mBC-0814-1
"G5,B11",7335,7963,5303,2660,4638,0,2528,2530,1788,742,2.409703504,1350,273,190,50,0,50,0,16,0,0,empty,mBC-0814-1
"G5,B12",5811,6380,4072,2308,3692,1,2079,2081,1477,604,2.445364238,1160,882,586,202,0,202,0,48,0,0,empty,mBC-0814-1
"G5,C1",5713,5981,4043,1938,3490,0,1868,1875,1316,559,2.354203936,946,692,477,152,0,152,0,34,0,0,empty,mBC-0814-1
"G5,C2",5470,5831,3868,1963,3445,0,1907,1912,1365,547,2.495429616,1009,1484,1050,318,0,318,0,70,0,0,empty,mBC-0814-1
"G5,C3",5863,6411,4200,2211,3696,1,2053,2058,1498,560,2.675,1092,507,270,90,0,90,0,34,0,0,empty,mBC-0814-1
"G5,C4",5522,6126,3939,2187,3514,0,1923,1925,1395,530,2.632075472,1053,1125,791,265,0,265,0,82,0,0,empty,mBC-0814-1
"G5,C5",7396,7845,5283,2562,4599,5,2439,2445,1821,624,2.918269231,1286,1523,1142,355,0,355,0,74,0,0.045070423,empty,mBC-0814-1
"G5,C6",582760,634072,396391,237681,379085,0,226187,226408,191164,35244,5.424015435,128892,9202,6904,1922,1,1921,1,295,0,0,mm10,mBC-0814-1
"G5,C7",7205,7780,5078,2702,4430,0,2345,2352,1701,651,2.612903226,1268,2281,742,190,0,190,0,31,0,0,empty,mBC-0814-1
"G5,C8",5683,5910,4084,1826,3471,3,1832,1840,1285,555,2.315315315,957,1711,1083,334,0,334,0,66,0,0.041916168,empty,mBC-0814-1
"G5,C9",4849,5324,3502,1822,3108,0,1681,1684,1221,463,2.637149028,921,1257,904,284,0,284,0,54,0,0,empty,mBC-0814-1
"G5,C10",5616,6047,4079,1968,3533,0,1859,1864,1334,530,2.516981132,1012,956,727,206,0,206,0,44,0,0.067961165,empty,mBC-0814-1
"G5,C11",4825,5344,3423,1921,3101,0,1664,1675,1158,517,2.239845261,907,1250,949,264,0,264,0,56,0,0,empty,mBC-0814-1
"G5,C12",8590,9208,6217,2991,5318,0,2889,2889,2066,823,2.510328068,1528,1266,923,260,0,260,0,54,0,0,empty,mBC-0814-1
"G5,D1",4632,4957,3307,1650,2966,0,1614,1616,1180,436,2.706422018,857,549,459,91,0,91,0,24,0,0,empty,mBC-0814-1
"G5,D2",5117,5225,3789,1436,3020,0,1528,1531,1094,437,2.503432494,721,1022,747,218,0,218,0,64,0,0.041284404,empty,mBC-0814-1
"G5,D3",11251,12237,8007,4230,7139,0,3903,3918,2830,1088,2.601102941,2112,1102,690,225,0,225,0,70,0,0.031111111,empty,mBC-0814-1
"G5,D4",4816,5238,3438,1800,3143,0,1737,1740,1244,496,2.508064516,942,802,570,189,0,189,0,42,0,0,empty,mBC-0814-1
"G5,D5",4916,5496,3471,2025,3188,3,1743,1746,1304,442,2.950226244,943,1334,817,303,0,303,0,79,0,0.00660066,empty,mBC-0814-1
"G5,D6",5172,5722,3732,1990,3227,0,1709,1711,1246,465,2.679569892,950,1060,786,211,0,211,0,37,0,0,empty,mBC-0814-1
"G5,D7",406015,472146,264086,208060,280551,1,184630,184814,124944,59870,2.086921664,112679,25797,15893,4185,5,4180,2,520,0,0.001196172,mm10,mBC-0814-1
"G5,D8",5293,6040,3702,2338,3482,0,1957,1958,1450,508,2.854330709,1100,960,723,198,0,198,0,47,0,0,empty,mBC-0814-1
"G5,D9",402480,470652,267036,203616,277351,0,174094,174260,149195,25065,5.952323958,104898,130528,92987,25870,15,25855,4,1842,0,0.001392381,mm10,mBC-0814-1
"G5,D10",3754,4122,2685,1437,2426,0,1338,1341,968,373,2.595174263,720,851,554,151,1,150,1,36,0,0,empty,mBC-0814-1
"G5,D11",4431,4736,3233,1503,2763,1,1457,1458,1050,408,2.573529412,769,1914,1246,392,0,392,0,84,0,0,empty,mBC-0814-1
"G5,D12",6643,7262,4716,2546,4156,1,2287,2297,1626,671,2.423248882,1235,2226,1590,517,0,517,0,90,0,0,empty,mBC-0814-1
"G5,E1",5154,5412,3708,1704,3129,0,1666,1667,1201,466,2.577253219,841,9617,3000,920,2,918,1,102,0,0.027233115,empty,mBC-0814-1
"G5,E2",551943,650032,363427,286605,380117,1,244995,245296,184952,60344,3.064960891,149300,145918,103062,28835,21,28814,4,1872,0,0.000694107,mm10,mBC-0814-1
"G5,E3",3466,3527,2551,976,2111,4,1114,1120,829,291,2.848797251,524,1264,847,246,0,246,0,55,0,0,empty,mBC-0814-1
"G5,E4",3129,3349,2236,1113,1997,0,1103,1108,775,333,2.327327327,598,746,414,159,0,159,0,39,0,0.062893082,empty,mBC-0814-1
"G5,E5",3839,3962,2808,1154,2343,0,1196,1196,880,316,2.784810127,582,651,464,130,0,130,0,28,0,0,empty,mBC-0814-1
"G5,E6",197123,225216,131317,93899,131552,0,81681,81773,64176,17597,3.646985282,48642,36699,25787,7081,3,7078,1,770,0,0.00098898,mm10,mBC-0814-1
"G5,E7",4666,5026,3392,1634,2839,0,1503,1508,1072,436,2.458715596,798,979,692,222,0,222,0,47,0,0.036036036,empty,mBC-0814-1
"G5,E8",4729,5003,3448,1555,2927,3,1566,1569,1129,440,2.565909091,804,1545,1033,339,0,339,0,82,0,0,empty,mBC-0814-1
"G5,E9",3524,3911,2460,1451,2307,0,1325,1325,964,361,2.670360111,746,1079,784,233,0,233,0,59,0,0,empty,mBC-0814-1
"G5,E10",4142,4464,3027,1437,2604,2,1408,1412,1024,388,2.639175258,760,1169,845,278,0,278,0,58,0,0,empty,mBC-0814-1
"G5,E11",4674,5170,3296,1874,3020,0,1677,1678,1217,461,2.639913232,953,1545,1142,303,0,303,0,57,0,0,empty,mBC-0814-1
"G5,E12",5109,5554,3622,1932,3257,0,1854,1854,1399,455,3.074725275,981,749,593,207,0,207,0,45,0,0.038647343,empty,mBC-0814-1
"G5,F1",458751,531867,305971,225896,314423,2,197367,197590,165447,32143,5.147217123,118406,98271,67575,18693,10,18683,2,1466,0,0.001926885,mm10,mBC-0814-1
"G5,F2",6568,6967,4649,2318,4011,0,2190,2191,1593,598,2.663879599,1127,1732,1186,401,0,401,0,87,0,0.042394015,empty,mBC-0814-1
"G5,F3",15882,17851,11391,6460,10292,2,5605,5612,4401,1211,3.634186623,3110,7863,5448,1602,1,1601,1,256,0,0.001873829,empty,mBC-0814-1
"G5,F4",5648,5809,4094,1715,3526,0,1857,1864,1309,555,2.358558559,941,662,465,131,1,130,1,24,0,0,empty,mBC-0814-1
"G5,F5",5009,5204,3604,1600,3100,0,1649,1650,1194,456,2.618421053,871,1165,860,270,0,270,0,48,0,0.122222222,empty,mBC-0814-1
"G5,F6",5450,5833,3997,1836,3370,0,1823,1824,1327,497,2.670020121,976,1667,1056,336,0,336,0,77,0,0.008928571,empty,mBC-0814-1
"G5,F7",4677,4890,3402,1488,2856,0,1510,1516,1053,463,2.274298056,766,376,281,85,0,85,0,26,0,0,empty,mBC-0814-1
"G5,F8",6279,6818,4562,2256,3942,0,2101,2102,1509,593,2.544688027,1140,170,120,36,0,36,0,8,0,0,empty,mBC-0814-1
"G5,F9",5508,5921,3894,2027,3521,0,1914,1914,1383,531,2.604519774,1061,1637,1175,367,1,366,1,74,0,0.043715847,empty,mBC-0814-1
"G5,F10",6526,7046,4792,2254,4060,4,2147,2155,1586,569,2.787346221,1145,2846,935,312,0,312,0,56,0,0.041666667,empty,mBC-0814-1
"G5,F11",4314,4471,3146,1325,2607,0,1362,1366,939,427,2.199063232,670,1413,991,292,0,292,0,55,0,0,empty,mBC-0814-1
"G5,F12",4857,5330,3464,1866,3095,0,1730,1730,1232,498,2.473895582,944,58,18,5,0,5,0,4,0,0,empty,mBC-0814-1
"G5,G1",8142,8787,5819,2968,5072,0,2730,2734,1978,756,2.616402116,1476,2517,1747,563,0,563,0,128,0,0,empty,mBC-0814-1
"G5,G2",5671,6143,4050,2093,3568,0,1917,1917,1397,520,2.686538462,1027,406,307,70,1,69,1,22,0,0,empty,mBC-0814-1
"G5,G3",5293,5801,3722,2079,3309,0,1849,1854,1272,582,2.18556701,987,2032,1450,358,0,358,0,77,0,0,empty,mBC-0814-1
"G5,G4",5322,5515,3797,1718,3284,1,1736,1739,1219,520,2.344230769,911,3,3,2,0,2,0,2,0,0,empty,mBC-0814-1
"G5,G5",4803,5086,3395,1691,3006,0,1612,1614,1146,468,2.448717949,864,994,616,216,0,216,0,55,0,0,empty,mBC-0814-1
"G5,G6",8835,9330,6397,2933,5376,5,2833,2839,2060,779,2.644415918,1458,172,129,56,0,56,0,13,0,0,empty,mBC-0814-1
"G5,G7",5683,6066,3997,2069,3556,3,1945,1956,1405,551,2.549909256,1051,1985,1326,417,1,416,1,85,0,0,empty,mBC-0814-1
"G5,G8",7353,8036,5162,2874,4835,0,2727,2730,1983,747,2.654618474,1523,3269,2028,637,1,636,1,116,0,0.023584906,empty,mBC-0814-1
"G5,G9",5777,6142,4116,2026,3687,0,2028,2029,1452,577,2.516464471,1095,2476,1714,491,0,491,0,107,0,0.024439919,empty,mBC-0814-1
"G5,G10",1224028,1376854,819612,557242,797477,0,499318,499912,393994,105918,3.719802111,291381,193300,139012,38332,18,38314,3,2539,0,0.000339302,mm10,mBC-0814-1
"G5,G11",1490742,1697182,1001751,695431,975654,1,609286,609972,460456,149516,3.07964365,357889,238613,170060,47329,31,47298,2,2797,0,0.002219967,mm10,mBC-0814-1
"G5,G12",4803,5121,3438,1683,3118,0,1746,1746,1271,475,2.675789474,923,1781,1269,405,1,404,1,78,0,0.034653465,empty,mBC-0814-1
"G5,H1",5007,5468,3550,1918,3211,1,1719,1724,1251,473,2.644820296,918,383,268,97,0,97,0,31,0,0,empty,mBC-0814-1
"G5,H2",642108,771109,411127,359982,452620,0,303916,304263,239417,64846,3.692085865,189087,120009,84360,23622,23,23599,3,1679,0,0,mm10,mBC-0814-1
"G5,H3",6082,6443,4264,2179,3752,0,2066,2071,1514,557,2.718132855,1112,1367,942,312,0,312,0,62,0,0,empty,mBC-0814-1
"G5,H4",5880,6409,4161,2248,3796,0,2097,2101,1572,529,2.971644612,1139,43,32,11,0,11,0,8,0,0,empty,mBC-0814-1
"G5,H5",6705,7542,4749,2793,4229,0,2343,2343,1696,647,2.621329212,1302,1994,1506,337,0,337,0,65,0,0.005934718,empty,mBC-0814-1
"G5,H6",6554,7145,4654,2491,4137,0,2256,2264,1652,612,2.699346405,1226,2914,2086,580,0,580,0,100,0,0.006896552,empty,mBC-0814-1
"G5,H7",1323849,1442262,934824,507438,842550,4,492101,492727,334770,157957,2.11937426,276227,59081,30885,8892,1,8891,1,925,0,0.014171634,mm10,mBC-0814-1
"G5,H8",430903,486067,292568,193499,285728,1,174599,174836,128305,46531,2.757409039,102854,21284,14372,4104,0,4104,0,498,0,0,mm10,mBC-0814-1
"G5,H9",5707,6070,4044,2026,3546,0,1907,1908,1401,507,2.763313609,1005,944,693,192,1,191,1,38,0,0,empty,mBC-0814-1
"G5,H10",3609,3814,2514,1300,2171,0,1195,1197,853,344,2.479651163,632,976,668,173,0,173,0,36,0,0,empty,mBC-0814-1
"G5,H11",701698,815368,463836,351532,485873,1,318680,319016,191757,127259,1.506824665,194344,2085,805,217,2,215,1,29,0,0.004651163,empty,mBC-0814-1
"G5,H12",297051,342588,196833,145755,203532,1,125618,125752,108197,17555,6.163315295,75518,218221,157846,42956,20,42936,5,2426,0,0,mm10,mBC-0814-1
"G6,A1",4675,5030,3375,1655,3073,0,1669,1670,1140,530,2.150943396,869,1319,698,226,0,226,0,49,0,0,empty,mBC-0814-1
"G6,A2",4669,4963,3359,1604,2870,0,1518,1518,1118,400,2.795,807,1630,1109,296,0,296,0,75,0,0.016891892,empty,mBC-0814-1
"G6,A3",3843,3993,2668,1325,2381,0,1312,1318,941,377,2.49602122,708,773,553,162,0,162,0,34,0,0,empty,mBC-0814-1
"G6,A4",528115,594867,361312,233555,349002,0,213338,213547,169182,44365,3.813411473,123778,10469,7548,1910,3,1907,1,252,0,0.002621919,mm10,mBC-0814-1
"G6,A5",4290,4761,3093,1668,2752,0,1516,1518,1039,479,2.169102296,840,1186,781,251,0,251,0,50,0,0,empty,mBC-0814-1
"G6,A6",3608,3949,2576,1373,2268,2,1233,1235,878,357,2.459383754,684,1428,925,266,0,266,0,48,0,0.052631579,empty,mBC-0814-1
"G6,A7",4861,5298,3473,1825,3135,0,1727,1728,1307,421,3.104513064,907,1217,799,232,0,232,0,53,0,0.056034483,empty,mBC-0814-1
"G6,A8",1877,2032,1323,709,1176,0,645,646,450,196,2.295918367,346,1172,824,281,0,281,0,54,0,0.049822064,empty,mBC-0814-1
"G6,A9",5672,6276,4063,2213,3646,0,2002,2002,1435,567,2.530864198,1124,1699,1291,366,1,365,1,55,0,0,empty,mBC-0814-1
"G6,A10",3088,3289,2194,1095,1906,0,1053,1053,720,333,2.162162162,547,205,112,32,0,32,0,12,0,0,empty,mBC-0814-1
"G6,A11",3794,3962,2768,1194,2405,4,1252,1260,922,338,2.727810651,633,1498,992,320,1,319,1,68,0,0,empty,mBC-0814-1
"G6,A12",3145,3569,2228,1341,2060,0,1132,1134,837,297,2.818181818,648,8839,3294,949,1,948,1,161,0,0,empty,mBC-0814-1
"G6,B1",3982,4299,2782,1517,2608,0,1422,1425,964,461,2.091106291,788,1034,747,251,3,248,1,48,0,0.092741935,empty,mBC-0814-1
"G6,B2",4327,4610,2990,1620,2692,0,1474,1476,1036,440,2.354545455,798,1819,468,155,0,155,0,23,0,0,empty,mBC-0814-1
"G6,B3",3562,3818,2637,1181,2309,0,1259,1261,908,353,2.57223796,636,950,671,224,0,224,0,45,0,0,empty,mBC-0814-1
"G6,B4",3668,4031,2531,1500,2321,0,1310,1310,939,371,2.530997305,749,12573,3947,1197,0,1197,0,112,0,0.060985798,empty,mBC-0814-1
"G6,B5",8060,7545,4579,2966,4863,3,2880,2890,2320,570,4.070175439,1655,861,598,170,0,170,0,45,0,0.052941176,empty,mBC-0814-1
"G6,B6",3567,3791,2581,1210,2223,0,1187,1187,845,342,2.470760234,611,1391,992,290,0,290,0,50,0,0,empty,mBC-0814-1
"G6,B7",4417,4855,3166,1689,2865,0,1583,1584,1135,449,2.527839644,894,419,307,103,0,103,0,33,0,0.116504854,empty,mBC-0814-1
"G6,B8",3212,3574,2384,1190,2127,0,1128,1129,827,302,2.738410596,615,3213,1075,336,2,334,1,55,0,0.026946108,empty,mBC-0814-1
"G6,B9",4016,4227,2857,1370,2449,3,1324,1329,984,345,2.852173913,674,424,306,118,0,118,0,30,0,0,empty,mBC-0814-1
"G6,B10",252930,279698,161091,118607,172216,0,107439,107620,87634,19986,4.384769339,64146,22608,15810,4120,1,4119,1,522,0,0,mm10,mBC-0814-1
"G6,B11",396430,460131,264733,195398,270834,0,169857,170043,143054,26989,5.300455741,102043,10173,7409,2036,2,2034,1,249,0,0,mm10,mBC-0814-1
"G6,B12",420455,481318,287586,193732,286702,2,177485,177649,134081,43568,3.077511017,104542,38754,16064,4486,5,4481,2,482,0,0.006025441,mm10,mBC-0814-1
"G6,C1",5026,5236,3619,1617,3074,4,1571,1576,1129,447,2.525727069,829,703,412,149,0,149,0,26,0,0,empty,mBC-0814-1
"G6,C2",4694,5024,3362,1662,2903,0,1551,1553,1084,469,2.31130064,808,1384,906,316,0,316,0,78,0,0,empty,mBC-0814-1
"G6,C3",27601,30443,19903,10540,17669,0,9528,9546,7259,2287,3.17402711,5204,1867,1229,386,0,386,0,78,0,0.041450777,empty,mBC-0814-1
"G6,C4",4233,4568,3040,1528,2659,0,1442,1446,1056,390,2.707692308,730,1470,998,304,0,304,0,60,0,0.003289474,empty,mBC-0814-1
"G6,C5",634886,730182,431731,298451,426368,0,260835,261153,213615,47538,4.493563044,153373,161463,117463,34012,24,33988,3,2124,0,0.000323644,mm10,mBC-0814-1
"G6,C6",9142,10705,6467,4238,6405,0,3836,3841,2099,1742,1.204936854,2254,5211,2524,727,2,725,1,109,0,0.006896552,empty,mBC-0814-1
"G6,C7",529962,602767,353021,249746,351631,0,215518,215749,185292,30457,6.083724595,129170,40907,25735,6943,10,6933,1,901,0,0.002596279,mm10,mBC-0814-1
"G6,C8",4656,5124,3279,1845,3001,0,1634,1636,1159,477,2.429769392,915,1547,1016,328,0,328,0,65,0,0,empty,mBC-0814-1
"G6,C9",405744,468860,271108,197752,278574,1,174853,175069,140693,34376,4.09276821,104505,79458,58366,16666,14,16652,4,1336,0,0.00042037,mm10,mBC-0814-1
"G6,C10",5339,5662,3882,1780,3312,0,1761,1763,1310,453,2.89183223,933,990,705,171,0,171,0,35,0,0.023391813,empty,mBC-0814-1
"G6,C11",4070,4341,2870,1471,2522,0,1379,1379,994,385,2.581818182,721,1194,876,275,0,275,0,61,0,0,empty,mBC-0814-1
"G6,C12",7106,7563,5116,2447,4474,0,2486,2491,1767,724,2.440607735,1298,1648,1272,378,1,377,1,56,0,0,empty,mBC-0814-1
"G6,D1",3982,4049,2843,1206,2427,1,1273,1274,903,371,2.433962264,660,724,484,145,0,145,0,25,0,0.062068966,empty,mBC-0814-1
"G6,D2",4735,5020,3451,1569,2926,0,1519,1522,1118,404,2.767326733,793,1163,858,272,0,272,0,55,0,0,empty,mBC-0814-1
"G6,D3",9674,10392,6841,3551,6087,0,3277,3280,2323,957,2.42737722,1808,1489,938,276,1,275,1,79,0,0.003636364,empty,mBC-0814-1
"G6,D4",4054,4450,2775,1675,2544,0,1365,1365,968,397,2.438287154,767,1461,1060,253,0,253,0,61,0,0,empty,mBC-0814-1
"G6,D5",3648,3939,2474,1465,2266,0,1245,1247,915,332,2.756024096,694,2052,1255,437,0,437,0,93,0,0.027459954,empty,mBC-0814-1
"G6,D6",4307,4477,3128,1349,2669,0,1408,1409,1030,379,2.7176781,707,1316,1021,303,0,303,0,56,0,0.01980198,empty,mBC-0814-1
"G6,D7",5091,5421,3589,1832,3189,0,1747,1749,1255,494,2.54048583,935,1692,1187,358,0,358,0,73,0,0.030726257,empty,mBC-0814-1
"G6,D8",4266,4568,3074,1494,2662,0,1428,1431,1072,359,2.986072423,771,1091,695,176,0,176,0,39,0,0,empty,mBC-0814-1
"G6,D9",2584,2827,1834,993,1728,0,950,950,664,286,2.321678322,504,1272,841,238,0,238,0,51,0,0,empty,mBC-0814-1
"G6,D10",3564,3792,2528,1264,2231,0,1203,1203,830,373,2.225201072,617,567,452,139,0,139,0,32,0,0,empty,mBC-0814-1
"G6,D11",3525,3747,2480,1267,2205,0,1209,1212,900,312,2.884615385,636,1397,1029,283,1,282,1,72,0,0,empty,mBC-0814-1
"G6,D12",5435,5926,3864,2062,3418,6,1862,1875,1341,534,2.511235955,997,2205,1456,517,1,516,1,82,0,0,empty,mBC-0814-1
"G6,E1",4484,4750,3164,1586,2816,0,1495,1498,1067,431,2.475638051,832,1508,1018,311,0,311,0,56,0,0,empty,mBC-0814-1
"G6,E2",3118,3330,2202,1128,1937,1,1052,1053,739,314,2.353503185,562,1255,1008,317,0,317,0,58,0,0,empty,mBC-0814-1
"G6,E3",3220,3393,2408,985,1997,0,1036,1038,739,299,2.471571906,531,1642,1153,309,1,308,1,58,0,0.006493506,empty,mBC-0814-1
"G6,E4",2740,2989,2002,987,1740,5,963,970,679,291,2.333333333,505,767,537,196,0,196,0,46,0,0.112244898,empty,mBC-0814-1
"G6,E5",3374,3468,2478,990,2031,0,1059,1059,784,275,2.850909091,520,668,490,156,0,156,0,34,0,0,empty,mBC-0814-1
"G6,E6",3997,4140,2891,1249,2456,0,1246,1247,880,367,2.397820163,641,1568,1140,313,0,313,0,64,0,0.073482428,empty,mBC-0814-1
"G6,E7",4004,4179,2982,1197,2328,0,1161,1162,762,400,1.905,563,647,435,137,1,136,1,29,0,0,empty,mBC-0814-1
"G6,E8",527916,599907,357383,242524,351958,1,215613,215844,151855,63989,2.373142259,125753,142412,101393,27991,18,27973,3,1986,0,0.002109177,mm10,mBC-0814-1
"G6,E9",2636,2833,1888,945,1668,0,903,909,655,254,2.578740157,481,1117,872,262,0,262,0,57,0,0,empty,mBC-0814-1
"G6,E10",345576,411858,227175,184683,245467,0,158466,158653,131532,27121,4.849821172,97341,130308,94323,27531,8,27523,3,1887,0,0.000508665,mm10,mBC-0814-1
"G6,E11",3639,3949,2597,1352,2366,0,1282,1284,910,374,2.43315508,693,1271,702,239,0,239,0,55,0,0,empty,mBC-0814-1
"G6,E12",3530,3740,2483,1257,2282,0,1267,1267,919,348,2.640804598,683,1069,699,204,1,203,1,45,0,0.142857143,empty,mBC-0814-1
"G6,F1",428639,487626,288323,199303,289111,0,178601,178809,149013,29796,5.001107531,105443,55177,34779,9624,10,9614,1,1090,0,0.001768255,mm10,mBC-0814-1
"G6,F2",481820,535123,332123,203000,316713,2,188999,189220,147913,41307,3.580821653,108371,47480,32592,9569,4,9565,2,959,0,0.002195504,mm10,mBC-0814-1
"G6,F3",4485,5043,3252,1791,2877,0,1549,1553,1106,447,2.474272931,823,1430,1028,316,0,316,0,64,0,0,empty,mBC-0814-1
"G6,F4",4842,5037,3396,1641,2984,0,1595,1598,1102,496,2.221774194,873,447,346,123,0,123,0,16,0,0,empty,mBC-0814-1
"G6,F5",4803,5170,3462,1708,2983,0,1597,1602,1161,441,2.632653061,836,828,581,211,0,211,0,46,0,0,empty,mBC-0814-1
"G6,F6",528785,609684,352126,257558,357539,0,222711,222941,175832,47109,3.732450275,133206,235331,171235,48134,28,48106,1,2751,0,4.15749E-05,mm10,mBC-0814-1
"G6,F7",3960,4307,2818,1489,2544,0,1377,1377,991,386,2.567357513,758,596,447,162,0,162,0,29,0,0,empty,mBC-0814-1
"G6,F8",5490,5873,3951,1922,3390,5,1858,1863,1323,540,2.45,990,59,42,20,0,20,0,9,0,0,empty,mBC-0814-1
"G6,F9",4973,5208,3693,1515,3059,0,1600,1602,1114,488,2.282786885,784,1565,1221,378,0,378,0,70,0,0,empty,mBC-0814-1
"G6,F10",5711,6195,4122,2073,3645,0,1951,1959,1365,594,2.297979798,1077,1352,939,314,0,314,0,68,0,0,empty,mBC-0814-1
"G6,F11",3563,3893,2493,1400,2314,0,1304,1304,925,379,2.440633245,704,1193,700,224,0,224,0,40,0,0.013392857,empty,mBC-0814-1
"G6,F12",4272,4589,3051,1538,2697,0,1510,1513,1047,466,2.246781116,831,85,70,23,0,23,0,5,0,0,empty,mBC-0814-1
"G6,G1",602621,684098,405917,278181,400502,0,244569,244827,197844,46983,4.210969925,142791,205286,148296,42657,24,42633,2,2348,0,0.000492576,mm10,mBC-0814-1
"G6,G2",4904,5282,3531,1751,3148,0,1640,1640,1113,527,2.111954459,888,351,223,64,0,64,0,18,0,0.109375,empty,mBC-0814-1
"G6,G3",4457,4782,3189,1593,2842,0,1577,1581,1110,471,2.356687898,855,1769,1279,325,0,325,0,60,0,0,empty,mBC-0814-1
"G6,G4",4408,4756,3166,1590,2788,0,1469,1473,1046,427,2.449648712,777,9,2,2,0,2,0,2,0,0,empty,mBC-0814-1
"G6,G5",4251,4527,3083,1444,2704,1,1457,1463,1023,440,2.325,769,13829,3893,1235,1,1234,1,153,0,0.075364668,empty,mBC-0814-1
"G6,G6",507879,588628,333432,255196,346478,3,221761,221994,183801,38193,4.812426361,133251,8131,5714,1717,0,1717,0,241,0,0.004076878,mm10,mBC-0814-1
"G6,G7",4684,5077,3342,1735,3027,0,1621,1625,1177,448,2.627232143,882,2155,1539,386,0,386,0,88,0,0.067357513,empty,mBC-0814-1
"G6,G8",6050,6542,4348,2194,3897,0,2112,2119,1490,629,2.368839428,1187,2773,1909,564,0,564,0,111,0,0,empty,mBC-0814-1
"G6,G9",4645,4981,3348,1633,2924,0,1578,1580,1131,449,2.518930958,815,1867,1361,421,0,421,0,92,0,0,empty,mBC-0814-1
"G6,G10",11727,12617,8378,4239,7422,0,3984,3987,2927,1060,2.761320755,2174,3565,2427,651,1,650,1,123,0,0.033846154,empty,mBC-0814-1
"G6,G11",8090,8421,5697,2724,4941,0,2633,2642,1877,765,2.453594771,1419,1634,1213,385,0,385,0,68,0,0.036363636,empty,mBC-0814-1
"G6,G12",357907,424396,232842,191554,256543,0,166589,166777,131140,35637,3.679883267,102686,106396,75452,21031,12,21019,1,1639,0,0.001236976,mm10,mBC-0814-1
"G6,H1",3663,3860,2644,1216,2325,0,1228,1228,884,344,2.569767442,618,822,522,147,0,147,0,35,0,0.034013605,empty,mBC-0814-1
"G6,H2",407984,461802,282278,179524,275744,0,165616,165788,126754,39034,3.247271609,96146,40174,28127,7847,6,7841,1,855,0,0.001530417,mm10,mBC-0814-1
"G6,H3",4488,4913,3186,1727,2858,0,1606,1606,1110,496,2.237903226,858,1464,1006,271,0,271,0,71,0,0,empty,mBC-0814-1
"G6,H4",4705,5017,3332,1685,2946,0,1593,1595,1117,478,2.336820084,871,145,115,36,0,36,0,9,0,0,empty,mBC-0814-1
"G6,H5",6143,6561,4546,2015,3785,2,2013,2021,1471,550,2.674545455,1033,2079,1505,462,0,462,0,62,0,0,empty,mBC-0814-1
"G6,H6",5339,5566,3892,1674,3281,0,1705,1707,1251,456,2.743421053,878,1988,1307,347,0,347,0,87,0,0.008645533,empty,mBC-0814-1
"G6,H7",4822,5207,3453,1754,3023,1,1622,1625,1182,443,2.668171558,846,5032,1687,561,1,560,1,90,0,0.0125,empty,mBC-0814-1
"G6,H8",3753,4091,2612,1479,2375,0,1293,1296,919,377,2.437665782,719,1995,1448,370,0,370,0,60,0,0.035135135,empty,mBC-0814-1
"G6,H9",4626,4788,3339,1449,2830,0,1456,1463,1082,381,2.839895013,765,1433,902,302,0,302,0,61,0,0.082781457,empty,mBC-0814-1
"G6,H10",3156,3408,2208,1200,1963,0,1080,1080,742,338,2.195266272,618,826,584,202,0,202,0,51,0,0,empty,mBC-0814-1
"G6,H11",3303,3527,2353,1174,2112,0,1146,1146,814,332,2.451807229,623,43,28,19,0,19,0,11,0,0,empty,mBC-0814-1
"G6,H12",2333,2420,1668,752,1427,0,766,766,563,203,2.773399015,397,1378,1036,279,0,279,0,66,0,0,empty,mBC-0814-1
"G7,A1",5352,5713,3863,1850,3450,0,1889,1890,1316,574,2.292682927,960,913,664,234,0,234,0,63,0,0,empty,mBC-0814-1
"G7,A2",4623,4887,3295,1592,2905,0,1550,1551,1116,435,2.565517241,813,1379,1046,325,0,325,0,72,0,0,empty,mBC-0814-1
"G7,A3",4722,4953,3334,1619,2939,2,1583,1585,1156,429,2.694638695,837,787,552,177,0,177,0,44,0,0.016949153,empty,mBC-0814-1
"G7,A4",755831,869542,504558,364984,505852,2,318870,319231,252343,66888,3.772619902,189910,34147,24435,7083,6,7077,2,748,0,0,mm10,mBC-0814-1
"G7,A5",4477,4813,3288,1525,2867,0,1523,1527,1046,481,2.174636175,806,1253,812,237,0,237,0,45,0,0,empty,mBC-0814-1
"G7,A6",8369,9316,5821,3495,5612,0,3309,3315,2430,885,2.745762712,1858,1421,986,299,0,299,0,45,0,0,empty,mBC-0814-1
"G7,A7",447878,530711,295906,234805,316141,0,201282,201533,163390,38143,4.283616915,122621,207367,151975,42458,30,42428,4,2551,0,0.00035354,mm10,mBC-0814-1
"G7,A8",2067,2260,1472,788,1283,0,723,723,476,247,1.927125506,359,1475,1018,322,0,322,0,51,0,0.065217391,empty,mBC-0814-1
"G7,A9",6102,6540,4411,2129,3871,0,2105,2109,1484,625,2.3744,1142,1574,1077,269,0,269,0,53,0,0.003717472,empty,mBC-0814-1
"G7,A10",109612,125402,74825,50577,75254,1,45425,45482,36768,8714,4.21941703,26626,4612,3313,921,0,921,0,128,0,0,empty,mBC-0814-1
"G7,A11",272552,312932,182366,130566,187830,0,115682,115832,89143,26689,3.340065195,68666,196563,140970,39681,34,39647,3,2248,0,0.000277448,mm10,mBC-0814-1
"G7,A12",3222,3305,2309,996,2057,0,1088,1090,808,282,2.865248227,567,3229,2110,650,1,649,1,151,0,0.01540832,empty,mBC-0814-1
"G7,B1",4300,4571,2984,1587,2680,0,1440,1442,1057,385,2.745454545,791,23420,7573,2505,3,2502,1,218,0,0.159472422,empty,mBC-0814-1
"G7,B2",4540,4820,3188,1632,2859,0,1500,1503,1074,429,2.503496503,834,306,152,55,0,55,0,15,0,0,empty,mBC-0814-1
"G7,B3",3545,3741,2522,1219,2254,0,1182,1182,820,362,2.26519337,631,756,469,177,0,177,0,38,0,0,empty,mBC-0814-1
"G7,B4",4294,4600,2881,1719,2726,0,1547,1547,946,601,1.574043261,868,30364,9042,2958,7,2951,3,313,0,0.050830227,empty,mBC-0814-1
"G7,B5",222711,154839,87869,66970,111159,2,71055,71303,59276,12027,4.928577368,44196,6783,4247,1028,0,1028,0,188,0,0,mm10,mBC-0814-1
"G7,B6",3751,4126,2595,1531,2411,0,1342,1342,917,425,2.157647059,752,1088,796,271,0,271,0,51,0,0,empty,mBC-0814-1
"G7,B7",4896,5236,3552,1684,3063,2,1620,1623,1154,469,2.460554371,842,979,669,205,0,205,0,47,0,0.082926829,empty,mBC-0814-1
"G7,B8",3640,3765,2585,1180,2287,0,1258,1261,953,308,3.094155844,662,863,601,199,0,199,0,40,0,0,empty,mBC-0814-1
"G7,B9",4352,4752,3161,1591,2804,0,1546,1548,1126,422,2.668246445,818,1997,924,271,1,270,1,50,0,0,empty,mBC-0814-1
"G7,B10",4086,4310,2834,1476,2522,0,1377,1377,941,436,2.158256881,722,394,289,81,0,81,0,17,0,0,empty,mBC-0814-1
"G7,B11",6083,6535,4386,2149,3733,0,1959,1965,1406,559,2.515205725,1048,165,119,49,0,49,0,11,0,0,empty,mBC-0814-1
"G7,B12",5261,5882,3730,2152,3386,0,1908,1911,1372,539,2.545454545,1018,858,595,190,0,190,0,38,0,0,empty,mBC-0814-1
"G7,C1",5297,5551,3821,1730,3204,0,1642,1644,1165,479,2.432150313,805,1089,815,173,0,173,0,31,0,0,empty,mBC-0814-1
"G7,C2",5034,5383,3628,1755,3122,0,1701,1701,1255,446,2.813901345,905,1463,1038,350,0,350,0,82,0,0.028571429,empty,mBC-0814-1
"G7,C3",5771,6286,4059,2227,3649,0,2017,2017,1458,559,2.60822898,1082,569,382,116,0,116,0,29,0,0,empty,mBC-0814-1
"G7,C4",4546,4728,3259,1469,2778,0,1503,1506,1098,408,2.691176471,734,1360,838,241,0,241,0,63,0,0.01659751,empty,mBC-0814-1
"G7,C5",6593,6878,4757,2121,4081,0,2161,2163,1581,582,2.716494845,1109,1757,1343,380,3,377,2,66,0,0.058355438,empty,mBC-0814-1
"G7,C6",5099,5467,3673,1794,3198,0,1640,1642,1195,447,2.673378076,872,2822,1736,450,0,450,0,62,0,0,empty,mBC-0814-1
"G7,C7",6624,7040,4800,2240,3979,0,2097,2097,1536,561,2.737967914,1057,268,179,47,0,47,0,11,0,0.085106383,empty,mBC-0814-1
"G7,C8",5267,5596,3830,1766,3243,0,1661,1662,1160,502,2.310756972,860,1335,922,294,1,293,1,76,0,0,empty,mBC-0814-1
"G7,C9",4673,4850,3329,1521,2883,0,1585,1585,1108,477,2.322851153,831,1135,832,235,0,235,0,37,0,0,empty,mBC-0814-1
"G7,C10",5547,6054,3984,2070,3538,0,1904,1904,1386,518,2.675675676,1024,1273,906,247,0,247,0,42,0,0.060728745,empty,mBC-0814-1
"G7,C11",4477,4721,3177,1544,2775,0,1496,1501,1040,461,2.255965293,759,858,596,191,0,191,0,43,0,0,empty,mBC-0814-1
"G7,C12",8037,8533,5625,2908,4916,0,2617,2620,1837,783,2.346104725,1435,1798,1251,319,2,317,1,58,0,0,empty,mBC-0814-1
"G7,D1",4216,4487,2910,1577,2570,0,1385,1387,974,413,2.358353511,763,401,289,83,0,83,0,21,0,0,empty,mBC-0814-1
"G7,D2",5157,5622,3764,1858,3258,0,1689,1691,1239,452,2.741150442,899,3419,2016,671,0,671,0,87,0,0.113263785,empty,mBC-0814-1
"G7,D3",10372,11387,7310,4077,6653,0,3737,3744,2620,1124,2.330960854,2061,2033,1273,366,0,366,0,79,0,0.019125683,empty,mBC-0814-1
"G7,D4",4152,4458,2899,1559,2631,0,1429,1431,1013,418,2.423444976,783,1642,1258,319,0,319,0,60,0,0,empty,mBC-0814-1
"G7,D5",3615,3812,2503,1309,2279,0,1236,1236,910,326,2.791411043,658,2146,1331,398,1,397,1,86,0,0.007556675,empty,mBC-0814-1
"G7,D6",5303,5869,3743,2126,3337,0,1851,1856,1378,478,2.882845188,1048,6808,2903,882,0,882,0,115,0,0.051020408,empty,mBC-0814-1
"G7,D7",5208,5726,3648,2078,3409,0,1876,1878,1369,509,2.689587426,1065,2171,1476,430,0,430,0,85,0,0.023255814,empty,mBC-0814-1
"G7,D8",4518,4859,3248,1611,2867,5,1526,1531,1097,434,2.52764977,814,965,633,135,0,135,0,32,0,0,empty,mBC-0814-1
"G7,D9",2970,3020,2100,920,1803,0,953,955,683,272,2.511029412,486,1090,719,201,0,201,0,33,0,0,empty,mBC-0814-1
"G7,D10",3836,4266,2735,1531,2447,1,1367,1368,940,428,2.196261682,737,882,580,155,0,155,0,34,0,0,empty,mBC-0814-1
"G7,D11",3840,4109,2751,1358,2375,0,1266,1270,873,397,2.198992443,652,1683,1179,383,0,383,0,83,0,0.010443864,empty,mBC-0814-1
"G7,D12",5919,6237,4187,2050,3727,0,2025,2030,1451,579,2.506044905,1095,3213,2403,654,0,654,0,100,0,0.001529052,empty,mBC-0814-1
"G7,E1",4911,5283,3493,1790,3039,0,1598,1599,1163,436,2.667431193,887,1528,1151,381,0,381,0,55,0,0.026246719,empty,mBC-0814-1
"G7,E2",3248,3397,2351,1046,2033,0,1133,1133,842,291,2.89347079,544,934,697,225,1,224,1,50,0,0,empty,mBC-0814-1
"G7,E3",3504,3645,2607,1038,2101,0,1057,1057,768,289,2.657439446,525,1271,837,225,0,225,0,49,0,0.026666667,empty,mBC-0814-1
"G7,E4",3102,3274,2194,1080,1906,0,1014,1015,739,276,2.677536232,558,724,509,159,0,159,0,39,0,0.006289308,empty,mBC-0814-1
"G7,E5",3534,3893,2568,1325,2292,0,1212,1217,868,349,2.487106017,673,634,420,126,0,126,0,25,0,0,empty,mBC-0814-1
"G7,E6",4345,4654,3136,1518,2679,0,1406,1409,1014,395,2.567088608,723,1075,805,216,0,216,0,45,0,0,empty,mBC-0814-1
"G7,E7",668259,756835,454071,302764,439498,0,269851,270145,208798,61347,3.403556816,157132,131378,94797,26973,13,26960,2,1808,0,0.000445104,mm10,mBC-0814-1
"G7,E8",4683,4837,3263,1574,2767,0,1410,1413,973,440,2.211363636,723,18139,6387,1928,4,1924,2,177,0,0.254158004,empty,mBC-0814-1
"G7,E9",2904,2941,2142,799,1785,0,935,941,689,252,2.734126984,437,1222,896,270,0,270,0,57,0,0,empty,mBC-0814-1
"G7,E10",379876,452695,251740,200955,270802,2,172926,173153,146399,26754,5.472041564,105520,122047,87527,24909,9,24900,2,1815,0,0,mm10,mBC-0814-1
"G7,E11",3933,4180,2724,1456,2432,0,1320,1323,914,409,2.234718826,717,1590,932,294,0,294,0,65,0,0,empty,mBC-0814-1
"G7,E12",3641,3989,2580,1409,2344,0,1278,1278,920,358,2.569832402,684,1184,890,215,0,215,0,41,0,0,empty,mBC-0814-1
"G7,F1",4579,5073,3236,1837,2814,0,1549,1553,1068,485,2.202061856,811,1600,1076,339,1,338,1,58,0,0,empty,mBC-0814-1
"G7,F2",6334,7024,4528,2496,4041,1,2236,2248,1661,587,2.829642249,1206,2412,1354,468,0,468,0,84,0,0.057692308,empty,mBC-0814-1
"G7,F3",4592,5077,3334,1743,2976,0,1597,1599,1107,492,2.25,870,1670,1264,375,0,375,0,69,0,0,empty,mBC-0814-1
"G7,F4",5508,5844,4075,1769,3467,0,1839,1844,1309,535,2.446728972,930,295,198,42,0,42,0,13,0,0,empty,mBC-0814-1
"G7,F5",4852,5073,3509,1564,2947,0,1556,1556,1112,444,2.504504505,797,3002,1295,399,1,398,1,55,0,0,empty,mBC-0814-1
"G7,F6",4635,4972,3352,1620,2923,0,1488,1497,1077,420,2.564285714,765,1922,1371,402,0,402,0,78,0,0,empty,mBC-0814-1
"G7,F7",4294,4549,3193,1356,2718,0,1457,1459,1028,431,2.385150812,707,419,281,69,0,69,0,18,0,0,empty,mBC-0814-1
"G7,F8",5741,6003,4178,1825,3495,6,1769,1777,1276,501,2.546906188,891,18,9,7,0,7,0,4,0,0,empty,mBC-0814-1
"G7,F9",5583,5810,4006,1804,3260,0,1738,1739,1259,480,2.622916667,875,6082,2346,722,2,720,1,118,0,0.002777778,empty,mBC-0814-1
"G7,F10",6735,7235,4974,2261,4195,0,2138,2145,1535,610,2.516393443,1101,1505,1004,272,1,271,1,64,0,0,empty,mBC-0814-1
"G7,F11",4135,4405,2968,1437,2624,0,1413,1420,1024,396,2.585858586,752,1401,1032,276,0,276,0,51,0,0,empty,mBC-0814-1
"G7,F12",4579,4930,3236,1694,2792,0,1548,1551,1106,445,2.485393258,830,30,20,5,0,5,0,3,0,0,empty,mBC-0814-1
"G7,G1",7059,7663,5106,2557,4500,0,2399,2403,1689,714,2.365546218,1307,2404,1719,507,0,507,0,102,0,0.023668639,empty,mBC-0814-1
"G7,G2",5663,6024,3997,2027,3505,0,1895,1895,1379,516,2.67248062,999,663,489,147,0,147,0,27,0,0,empty,mBC-0814-1
"G7,G3",354052,411824,235993,175831,246793,1,156426,156600,127368,29232,4.357142857,94544,29751,20879,5907,5,5902,2,627,0,0.000338868,mm10,mBC-0814-1
"G7,G4",5035,5366,3718,1648,3064,0,1614,1618,1099,519,2.117533719,826,1,0,0,0,0,0,0,0,0,empty,mBC-0814-1
"G7,G5",4135,4516,3055,1461,2648,0,1389,1390,986,404,2.440594059,711,1209,872,234,0,234,0,63,0,0.072649573,empty,mBC-0814-1
"G7,G6",8499,9000,6299,2701,5287,0,2712,2715,1951,764,2.553664921,1338,47,19,14,0,14,0,8,0,0,empty,mBC-0814-1
"G7,G7",5247,5617,3762,1855,3275,1,1745,1749,1247,502,2.484063745,939,2142,1461,409,0,409,0,78,0,0.068459658,empty,mBC-0814-1
"G7,G8",637370,747571,411975,335596,447136,1,297665,297961,232088,65873,3.523264463,183150,62077,43913,12493,0,12493,0,1302,0,0.003121748,mm10,mBC-0814-1
"G7,G9",4695,5126,3418,1708,2973,0,1607,1609,1155,454,2.544052863,821,2321,1589,519,0,519,0,95,0,0,empty,mBC-0814-1
"G7,G10",8563,8816,6128,2688,5168,0,2710,2717,1925,792,2.430555556,1351,2724,1892,510,0,510,0,119,0,0,empty,mBC-0814-1
"G7,G11",8959,9717,6394,3323,5678,3,3024,3029,2110,919,2.295973885,1617,7257,2449,746,1,745,1,69,0,0.016107383,empty,mBC-0814-1
"G7,G12",4195,4357,2962,1395,2649,0,1468,1470,1015,455,2.230769231,797,2525,1835,524,0,524,0,90,0,0.015267176,empty,mBC-0814-1
"G7,H1",4374,4832,3118,1714,2792,0,1522,1529,1060,469,2.260127932,852,311,221,72,0,72,0,29,0,0.055555556,empty,mBC-0814-1
"G7,H2",7511,8103,5300,2803,4749,1,2549,2552,1771,781,2.267605634,1393,3174,2107,628,0,628,0,121,0,0.015923567,empty,mBC-0814-1
"G7,H3",5070,5374,3559,1815,3124,0,1764,1764,1280,484,2.644628099,923,2090,1532,384,0,384,0,59,0,0,empty,mBC-0814-1
"G7,H4",5012,5647,3524,2123,3271,0,1780,1780,1271,509,2.497053045,976,739,131,40,0,40,0,7,0,0,empty,mBC-0814-1
"G7,H5",6622,7167,4755,2412,4036,0,2201,2206,1552,654,2.373088685,1118,1432,1103,321,0,321,0,58,0,0,empty,mBC-0814-1
"G7,H6",5629,6081,4072,2009,3590,0,1922,1923,1427,496,2.877016129,1055,1921,1299,417,0,417,0,82,0,0.007194245,empty,mBC-0814-1
"G7,H7",478486,534840,322498,212342,317162,1,191645,191890,164289,27601,5.952284338,111366,189014,135155,37868,29,37839,1,2326,0,0.000554983,mm10,mBC-0814-1
"G7,H8",304434,347011,205709,141302,207525,0,127786,127970,100776,27194,3.70581746,76102,73829,41760,11926,10,11916,3,1170,0,0.012588117,mm10,mBC-0814-1
"G7,H9",4358,4604,3105,1499,2748,1,1435,1438,1012,426,2.375586854,806,1494,801,250,2,248,1,51,0,0,empty,mBC-0814-1
"G7,H10",3300,3544,2365,1179,2048,3,1164,1171,833,338,2.464497041,612,1028,699,192,1,191,1,46,0,0,empty,mBC-0814-1
"G7,H11",3544,3770,2490,1280,2230,0,1209,1214,844,370,2.281081081,632,95,80,19,0,19,0,4,0,0,empty,mBC-0814-1
"G7,H12",2319,2532,1582,950,1502,0,841,841,578,263,2.197718631,472,1117,693,228,1,227,1,50,0,0,empty,mBC-0814-1
"G8,A1",5770,6016,4152,1864,3623,0,1951,1953,1371,582,2.355670103,985,5663,1991,693,1,692,1,113,0,0.043352601,empty,mBC-0814-1
"G8,A2",4815,5099,3512,1587,3084,0,1665,1669,1191,478,2.491631799,892,994,652,268,0,268,0,67,0,0,empty,mBC-0814-1
"G8,A3",493954,584999,323002,261997,345500,0,224801,225007,184420,40587,4.54381945,137775,31889,22148,6292,9,6283,1,748,0,0.003342352,mm10,mBC-0814-1
"G8,A4",5771,5958,4181,1777,3464,0,1781,1786,1272,514,2.474708171,894,467,314,102,0,102,0,19,0,0.12745098,empty,mBC-0814-1
"G8,A5",4913,5282,3557,1725,3155,0,1660,1662,1177,485,2.426804124,889,987,743,219,0,219,0,52,0,0,empty,mBC-0814-1
"G8,A6",5998,6577,4244,2333,3782,0,2073,2076,1500,576,2.604166667,1100,1071,675,226,0,226,0,66,0,0,empty,mBC-0814-1
"G8,A7",5390,5826,3873,1953,3391,0,1821,1824,1360,464,2.931034483,980,1124,697,234,0,234,0,67,0,0,empty,mBC-0814-1
"G8,A8",2356,2573,1636,937,1514,0,845,846,622,224,2.776785714,443,959,643,180,0,180,0,57,0,0,empty,mBC-0814-1
"G8,A9",6977,7439,5047,2392,4330,2,2346,2350,1733,617,2.808752026,1205,2494,1163,360,0,360,0,58,0,0,empty,mBC-0814-1
"G8,A10",232467,263562,153702,109860,157571,0,97953,98060,75697,22363,3.384921522,58145,7855,5154,1535,1,1534,1,228,0,0,mm10,mBC-0814-1
"G8,A11",4342,4817,3107,1710,2822,0,1544,1548,1121,427,2.62529274,827,1483,998,370,0,370,0,87,0,0,empty,mBC-0814-1
"G8,A12",3368,3676,2383,1293,2232,0,1239,1239,870,369,2.357723577,686,20426,6269,2024,3,2021,2,260,0,0.065809005,empty,mBC-0814-1
"G8,B1",4514,4905,3187,1718,2920,6,1574,1584,1107,477,2.320754717,883,1393,1023,250,0,250,0,59,0,0.008,empty,mBC-0814-1
"G8,B2",174174,216243,107746,108497,129355,0,91982,92063,51876,40187,1.290865205,59120,7523,2942,894,2,892,1,131,0,0.011210762,empty,mBC-0814-1
"G8,B3",3939,4408,2727,1681,2568,0,1424,1428,996,432,2.305555556,797,1681,860,268,0,268,0,51,0,0.085820896,empty,mBC-0814-1
"G8,B4",4123,4487,2958,1529,2700,0,1473,1473,1052,421,2.498812352,810,1246,811,262,0,262,0,52,0,0.030534351,empty,mBC-0814-1
"G8,B5",18009,13789,8701,5088,9213,0,5196,5211,4126,1085,3.802764977,3003,10579,4410,1320,2,1318,2,188,0,0.037936267,empty,mBC-0814-1
"G8,B6",4143,4513,2925,1588,2665,1,1539,1540,1052,488,2.155737705,845,1084,720,215,1,214,1,50,0,0.046728972,empty,mBC-0814-1
"G8,B7",5054,5515,3602,1913,3212,0,1723,1723,1242,481,2.582120582,900,3496,1487,391,0,391,0,68,0,0,empty,mBC-0814-1
"G8,B8",566301,639164,388576,250588,373810,3,224071,224363,177967,46396,3.835826364,129410,81677,58716,17009,9,17000,1,1325,0,5.88235E-05,mm10,mBC-0814-1
"G8,B9",422438,493352,282373,210979,288450,0,178831,179058,139524,39534,3.529215359,107377,125958,91363,25742,14,25728,1,1781,0,0.001282649,mm10,mBC-0814-1
"G8,B10",305376,329224,198083,131141,203061,0,124329,124559,94094,30465,3.088593468,72929,7717,5447,1612,0,1612,0,210,0,0,mm10,mBC-0814-1
"G8,B11",6355,6673,4521,2152,3920,0,2118,2120,1515,605,2.504132231,1119,152,98,27,0,27,0,10,0,0,empty,mBC-0814-1
"G8,B12",5168,5647,3635,2012,3323,0,1816,1818,1290,528,2.443181818,1031,1025,752,220,0,220,0,44,0,0,empty,mBC-0814-1
"G8,C1",5455,5908,3930,1978,3410,0,1848,1852,1286,566,2.272084806,997,716,497,161,0,161,0,33,0,0,empty,mBC-0814-1
"G8,C2",500566,558397,346397,212000,327130,0,193504,193784,156862,36922,4.248469747,111106,33134,23298,6514,4,6510,1,716,0,0,mm10,mBC-0814-1
"G8,C3",636674,728882,430173,298709,423087,1,259152,259426,214060,45366,4.718511661,152436,86155,59905,17054,4,17050,2,1407,0,0,mm10,mBC-0814-1
"G8,C4",10918,11944,8010,3934,6956,0,3717,3728,2727,1001,2.724275724,2020,2934,1703,473,0,473,0,76,0,0,empty,mBC-0814-1
"G8,C5",8333,8924,5917,3007,5260,0,2920,2920,2134,786,2.715012723,1567,1158,819,274,1,273,1,69,0,0,empty,mBC-0814-1
"G8,C6",5473,5801,3850,1951,3492,0,1883,1884,1369,515,2.658252427,1019,746,552,221,0,221,0,62,0,0,empty,mBC-0814-1
"G8,C7",8894,9655,6224,3431,5687,0,3217,3220,2455,765,3.209150327,1757,322,251,83,0,83,0,20,0,0,empty,mBC-0814-1
"G8,C8",5390,5648,3911,1737,3350,0,1723,1726,1205,521,2.312859885,900,1724,1240,311,0,311,0,69,0,0,empty,mBC-0814-1
"G8,C9",434529,485602,296108,189494,287188,0,172831,173043,137730,35313,3.900263359,100470,37761,19901,5925,7,5918,4,591,0,0,mm10,mBC-0814-1
"G8,C10",6005,6572,4417,2155,3680,0,1977,1983,1419,564,2.515957447,1047,1052,790,235,0,235,0,53,0,0,empty,mBC-0814-1
"G8,C11",4695,5252,3393,1859,2992,0,1665,1665,1210,455,2.659340659,878,1006,685,223,0,223,0,52,0,0,empty,mBC-0814-1
"G8,C12",472214,556547,307389,249158,327137,0,215107,215325,162003,53322,3.038201868,131765,32492,22931,6816,4,6812,1,770,0,0.0002936,mm10,mBC-0814-1
"G8,D1",4099,4421,2928,1493,2660,0,1509,1512,1104,408,2.705882353,815,714,454,122,0,122,0,32,0,0,empty,mBC-0814-1
"G8,D2",5452,6072,3982,2090,3408,0,1764,1769,1272,497,2.559356137,928,1646,1076,358,1,357,1,75,0,0.005602241,empty,mBC-0814-1
"G8,D3",1470223,1679903,989528,690375,964801,2,602041,602749,487040,115709,4.209179926,355740,259256,187767,54525,29,54496,2,2857,0,0.00031195,mm10,mBC-0814-1
"G8,D4",4382,4863,3123,1740,2859,0,1562,1563,1119,444,2.52027027,869,1272,890,294,0,294,0,71,0,0.06122449,empty,mBC-0814-1
"G8,D5",286188,332205,187878,144327,199898,0,127642,127745,90375,37370,2.41838373,77541,77743,56513,16387,11,16376,1,1276,0,0.000427455,mm10,mBC-0814-1
"G8,D6",4980,5462,3644,1818,3143,0,1671,1674,1188,486,2.444444444,892,1051,774,211,1,210,1,49,0,0,empty,mBC-0814-1
"G8,D7",18346,19801,12774,7027,11401,0,6436,6443,4524,1919,2.357477853,3499,2693,1639,526,0,526,0,96,0,0.005703422,empty,mBC-0814-1
"G8,D8",4433,4719,3202,1517,2798,0,1505,1509,1056,453,2.331125828,778,804,568,182,0,182,0,37,0,0,empty,mBC-0814-1
"G8,D9",2816,3009,1989,1020,1766,0,947,948,655,293,2.235494881,521,1072,692,187,0,187,0,38,0,0,empty,mBC-0814-1
"G8,D10",3654,3959,2617,1342,2324,0,1304,1307,942,365,2.580821918,689,700,392,137,0,137,0,38,0,0,empty,mBC-0814-1
"G8,D11",4206,4475,3023,1452,2567,0,1370,1371,970,401,2.418952618,738,1489,1046,385,1,384,1,107,0,0.057291667,empty,mBC-0814-1
"G8,D12",789786,964171,468916,495255,569849,9,415757,416167,202792,213375,0.950401875,270708,48305,31231,8410,5,8405,3,1011,0,0.003212374,empty,mBC-0814-1
"G8,E1",5011,5475,3566,1909,3114,0,1614,1615,1122,493,2.275862069,887,12418,3984,1237,1,1236,1,154,0,0.046925566,empty,mBC-0814-1
"G8,E2",3273,3497,2348,1149,2162,0,1190,1191,832,359,2.317548747,655,1203,838,251,0,251,0,54,0,0.003984064,empty,mBC-0814-1
"G8,E3",3554,3825,2565,1260,2206,2,1175,1179,807,372,2.169354839,613,1408,991,325,0,325,0,53,0,0,empty,mBC-0814-1
"G8,E4",3042,3353,2229,1124,1972,1,1094,1095,764,331,2.3081571,574,1069,623,230,0,230,0,41,0,0.039130435,empty,mBC-0814-1
"G8,E5",3802,3901,2829,1072,2242,1,1170,1174,859,315,2.726984127,567,1036,739,237,0,237,0,45,0,0.088607595,empty,mBC-0814-1
"G8,E6",4361,4898,3148,1750,2710,0,1428,1433,1040,393,2.646310433,775,1095,730,267,0,267,0,61,0,0,empty,mBC-0814-1
"G8,E7",4559,4800,3315,1485,2820,0,1490,1490,1069,421,2.539192399,733,998,616,230,0,230,0,59,0,0.073913043,empty,mBC-0814-1
"G8,E8",4648,4932,3260,1672,2863,0,1482,1484,1091,393,2.776081425,823,1118,800,266,0,266,0,57,0,0,empty,mBC-0814-1
"G8,E9",3174,3361,2234,1127,1976,0,1083,1085,764,321,2.380062305,577,1810,1352,368,0,368,0,73,0,0,empty,mBC-0814-1
"G8,E10",4360,4731,3077,1654,2824,0,1581,1581,1139,442,2.576923077,876,1977,1428,449,0,449,0,82,0,0,empty,mBC-0814-1
"G8,E11",546679,621041,366834,254207,366697,2,225353,225637,171215,54422,3.146062254,132673,153702,111454,31605,25,31580,2,2166,0,0.000284991,mm10,mBC-0814-1
"G8,E12",3871,4246,2700,1546,2470,0,1363,1363,960,403,2.382133995,772,847,627,195,1,194,1,52,0,0,empty,mBC-0814-1
"G8,F1",17921,19963,12690,7273,11709,0,6457,6462,5191,1271,4.084185681,3592,16686,10371,3019,1,3018,1,474,0,0.004970179,empty,mBC-0814-1
"G8,F2",624366,718745,423887,294858,420093,2,257919,258200,215189,43011,5.003115482,152490,198353,136349,41717,32,41685,2,2417,0,0.003262564,mm10,mBC-0814-1
"G8,F3",5043,5519,3609,1910,3255,0,1819,1819,1322,497,2.659959759,990,1361,998,322,10,312,2,59,0,0.019230769,empty,mBC-0814-1
"G8,F4",915261,1055953,608050,447903,626217,4,409894,410359,266361,143998,1.849754858,245288,13698,8858,2510,1,2509,1,333,0,0.008768434,mm10,mBC-0814-1
"G8,F5",5010,5339,3616,1723,3099,0,1676,1676,1207,469,2.573560768,869,910,651,200,0,200,0,54,0,0,empty,mBC-0814-1
"G8,F6",4520,4787,3208,1579,2904,0,1543,1544,1153,391,2.948849105,839,1574,1140,348,0,348,0,66,0,0.037356322,empty,mBC-0814-1
"G8,F7",4448,4711,3230,1481,2815,1,1511,1513,1072,441,2.430839002,784,483,296,112,0,112,0,33,0,0,empty,mBC-0814-1
"G8,F8",705034,808706,472054,336652,471891,0,295501,295837,235287,60550,3.885829893,174976,17392,11603,3443,4,3439,1,393,0,0,mm10,mBC-0814-1
"G8,F9",14395,15071,10489,4582,8857,0,4664,4669,3319,1350,2.458518519,2384,3207,2209,647,0,647,0,122,0,0.00927357,empty,mBC-0814-1
"G8,F10",596599,691754,398652,293102,409307,1,265727,266032,173259,92773,1.867558449,159165,32201,17487,4606,5,4601,3,622,0,0.021734406,mm10,mBC-0814-1
"G8,F11",470060,551578,312445,239133,326149,0,205684,205937,171580,34357,4.994033239,124338,91458,65292,18840,10,18830,1,1569,0,0.000637281,mm10,mBC-0814-1
"G8,F12",4728,5158,3289,1869,3010,0,1667,1669,1209,460,2.62826087,918,158,132,50,0,50,0,8,0,0,empty,mBC-0814-1
"G8,G1",7371,8094,5211,2883,4709,0,2563,2567,1801,766,2.351174935,1395,3374,2273,697,0,697,0,140,0,0,empty,mBC-0814-1
"G8,G2",5761,5880,4163,1717,3485,0,1813,1813,1279,534,2.395131086,876,451,310,117,1,116,1,27,0,0.043103448,empty,mBC-0814-1
"G8,G3",4871,5393,3470,1923,3148,0,1706,1711,1201,510,2.354901961,933,1251,868,320,0,320,0,79,0,0.028125,empty,mBC-0814-1
"G8,G4",5237,5484,3702,1782,3189,0,1719,1721,1235,486,2.541152263,904,1,1,1,0,1,0,1,0,0,empty,mBC-0814-1
"G8,G5",327187,383434,211663,171771,227836,0,147085,147244,121314,25930,4.67851909,90070,106072,74294,21219,21,21198,1,1577,0,0.001085008,mm10,mBC-0814-1
"G8,G6",724653,796313,498873,297440,462868,8,275931,276299,215927,60372,3.576608361,156935,765,586,177,0,177,0,32,0,0,empty,mBC-0814-1
"G8,G7",5259,5718,3745,1973,3403,0,1814,1816,1248,568,2.197183099,994,2179,1571,437,0,437,0,85,0,0,empty,mBC-0814-1
"G8,G8",6911,7468,4899,2569,4333,0,2382,2386,1667,719,2.318497914,1266,2251,1545,544,2,542,1,124,0,0.036900369,empty,mBC-0814-1
"G8,G9",294809,349740,188183,161557,211777,0,143555,143683,104466,39217,2.663793763,89493,20672,15016,4131,0,4131,0,486,0,0.006051803,mm10,mBC-0814-1
"G8,G10",8721,9507,6354,3153,5602,0,3040,3044,2133,911,2.341383095,1606,2988,2081,601,0,601,0,133,0,0,empty,mBC-0814-1
"G8,G11",467580,537490,309147,228343,315525,2,194552,194772,164503,30269,5.434702171,115912,149296,107854,30692,14,30678,2,2058,0,0.000423756,mm10,mBC-0814-1
"G8,G12",447740,517585,301775,215810,309757,0,186404,186634,155734,30900,5.039935275,111543,291692,215539,62189,37,62152,7,3017,0,0.000740121,mm10,mBC-0814-1
"G8,H1",4420,4809,3167,1642,2829,0,1529,1534,1087,447,2.431767338,859,695,489,150,0,150,0,38,0,0,empty,mBC-0814-1
"G8,H2",464040,543437,307616,235821,321031,0,204114,204349,170815,33534,5.093785412,124028,146532,99611,28382,21,28361,2,2028,0,0.002327139,mm10,mBC-0814-1
"G8,H3",5328,5819,3808,2011,3380,0,1868,1870,1334,536,2.48880597,1019,1584,1049,334,0,334,0,74,0,0,empty,mBC-0814-1
"G8,H4",5267,5911,3745,2166,3503,0,1896,1900,1335,565,2.362831858,1057,14,11,10,0,10,0,6,0,0,empty,mBC-0814-1
"G8,H5",6563,7115,4662,2453,4093,1,2240,2241,1577,664,2.375,1188,2288,1645,485,0,485,0,90,0,0.022680412,empty,mBC-0814-1
"G8,H6",6306,6811,4368,2443,4039,0,2224,2229,1595,634,2.515772871,1231,3890,1984,697,0,697,0,113,0,0.081779053,empty,mBC-0814-1
"G8,H7",5300,5701,3793,1908,3410,0,1848,1854,1293,561,2.304812834,994,1168,830,283,0,283,0,59,0,0.056537102,empty,mBC-0814-1
"G8,H8",4156,4482,3038,1444,2645,0,1404,1410,1024,386,2.652849741,751,1193,738,279,0,279,0,92,0,0.028673835,empty,mBC-0814-1
"G8,H9",5073,5233,3588,1645,3091,1,1654,1657,1205,452,2.665929204,853,1036,603,196,0,196,0,45,0,0,empty,mBC-0814-1
"G8,H10",3399,3660,2500,1160,2134,0,1182,1184,829,355,2.335211268,651,743,438,155,0,155,0,40,0,0.006451613,empty,mBC-0814-1
"G8,H11",3832,4339,2789,1550,2582,0,1450,1450,1059,391,2.708439898,791,67,33,23,0,23,0,11,0,0,empty,mBC-0814-1
"G8,H12",2369,2537,1610,927,1482,0,826,828,599,229,2.615720524,460,1144,718,233,0,233,0,47,0,0,empty,mBC-0814-1
"G9,A1",5682,5953,4136,1817,3586,0,1958,1959,1328,631,2.10459588,958,6507,2623,834,3,831,2,130,0,0.039711191,empty,mBC-0814-1
"G9,A2",408346,470811,269207,201604,279156,0,174712,174893,146638,28255,5.189807114,105124,159588,114226,35002,21,34981,3,2348,0,0.003916412,mm10,mBC-0814-1
"G9,A3",4484,4855,3196,1659,2797,0,1547,1559,1051,508,2.068897638,787,1247,888,320,0,320,0,67,0,0.003125,empty,mBC-0814-1
"G9,A4",5498,5997,4023,1974,3470,0,1831,1836,1310,526,2.490494297,957,439,345,106,0,106,0,27,0,0.009433962,empty,mBC-0814-1
"G9,A5",505533,589888,338692,251196,348747,1,217537,217754,175001,42753,4.093303394,130223,170303,123068,36704,20,36684,1,2304,0,2.72598E-05,mm10,mBC-0814-1
"G9,A6",3630,3935,2619,1316,2263,0,1212,1216,834,382,2.183246073,651,1779,1373,479,0,479,0,79,0,0,empty,mBC-0814-1
"G9,A7",5321,5724,3799,1925,3338,0,1847,1847,1337,510,2.621568627,986,6851,2742,959,0,959,0,157,0,0.020855057,empty,mBC-0814-1
"G9,A8",176810,209892,114759,95133,126795,0,82220,82280,62049,20231,3.067025851,50483,126567,90186,27349,9,27340,2,1961,0,0.000365764,mm10,mBC-0814-1
"G9,A9",571768,659627,373131,286496,386079,0,247513,247768,196599,51169,3.842150521,148185,203183,139790,43065,29,43036,4,2524,0,0.000278836,mm10,mBC-0814-1
"G9,A10",3239,3339,2309,1030,2047,0,1135,1135,812,323,2.513931889,577,159,106,49,0,49,0,13,0,0.020408163,empty,mBC-0814-1
"G9,A11",4430,4592,3114,1478,2809,0,1512,1514,1078,436,2.472477064,806,2389,1661,523,0,523,0,103,0,0.001912046,empty,mBC-0814-1
"G9,A12",296914,342350,186601,155749,205208,0,136699,136833,89462,47371,1.888539402,84147,138578,98787,29261,16,29245,2,2198,0,0.003351,mm10,mBC-0814-1
"G9,B1",4719,4906,3479,1427,2901,0,1535,1539,1136,403,2.818858561,755,1673,1227,402,1,401,1,94,0,0,empty,mBC-0814-1
"G9,B2",483546,546865,313687,233178,324237,0,201158,201398,163653,37745,4.33575308,120875,42429,30085,8995,3,8992,2,912,0,0,mm10,mBC-0814-1
"G9,B3",3686,4099,2638,1461,2367,0,1336,1338,960,378,2.53968254,726,1639,1034,349,1,348,1,66,0,0,empty,mBC-0814-1
"G9,B4",5737,6214,4088,2126,3638,0,1999,1999,1452,547,2.654478976,1072,2030,1365,411,0,411,0,93,0,0.00729927,empty,mBC-0814-1
"G9,B5",3459,2252,1419,833,1638,0,902,911,646,265,2.437735849,532,1002,654,232,0,232,0,58,0,0,empty,mBC-0814-1
"G9,B6",3549,3829,2488,1341,2289,0,1276,1278,883,395,2.235443038,671,1685,1208,346,0,346,0,64,0,0,empty,mBC-0814-1
"G9,B7",5162,5405,3779,1626,3163,0,1644,1644,1176,468,2.512820513,817,1203,868,287,0,287,0,67,0,0,empty,mBC-0814-1
"G9,B8",3546,3638,2558,1080,2179,0,1113,1113,802,311,2.578778135,551,1102,768,270,1,269,1,57,0,0,empty,mBC-0814-1
"G9,B9",4871,5298,3393,1905,3183,0,1783,1785,1270,515,2.466019417,982,7577,2627,866,2,864,2,129,0,0.003472222,empty,mBC-0814-1
"G9,B10",3921,3966,2814,1152,2394,0,1205,1208,852,356,2.393258427,607,3374,965,312,0,312,0,51,0,0.105769231,empty,mBC-0814-1
"G9,B11",8191,8904,5785,3119,5167,0,2885,2887,2210,677,3.264401773,1571,88,30,20,0,20,0,14,0,0.1,empty,mBC-0814-1
"G9,B12",5078,5434,3517,1917,3205,0,1795,1796,1268,528,2.401515152,969,1457,898,293,0,293,0,63,0,0.051194539,empty,mBC-0814-1
"G9,C1",5496,5713,3921,1792,3326,0,1736,1736,1212,524,2.312977099,907,830,654,211,0,211,0,41,0,0.042654028,empty,mBC-0814-1
"G9,C2",4919,5304,3515,1789,3171,0,1727,1727,1244,483,2.575569358,937,1952,1463,487,1,486,1,101,0,0.047325103,empty,mBC-0814-1
"G9,C3",5710,6191,4132,2059,3659,0,1980,1982,1423,559,2.545617174,1044,593,418,159,0,159,0,40,0,0,empty,mBC-0814-1
"G9,C4",4849,5037,3490,1547,2965,0,1553,1559,1124,435,2.583908046,824,4172,1897,620,1,619,1,122,0,0.040387722,empty,mBC-0814-1
"G9,C5",610591,692439,410453,281986,408167,0,254374,254695,183836,70859,2.594391679,151504,20742,14478,4477,3,4474,1,536,0,0.001564595,mm10,mBC-0814-1
"G9,C6",483977,539903,329025,210878,325993,0,198387,198591,156559,42032,3.724757328,114750,32019,21937,6766,6,6760,2,739,0,0.009615385,mm10,mBC-0814-1
"G9,C7",6739,7179,4880,2299,4181,0,2267,2268,1663,605,2.748760331,1172,364,196,80,0,80,0,26,0,0,empty,mBC-0814-1
"G9,C8",5361,5661,3861,1800,3332,0,1714,1717,1218,499,2.440881764,869,2101,1418,454,1,453,1,109,0,0,empty,mBC-0814-1
"G9,C9",4496,4970,3289,1681,2839,0,1556,1556,1117,439,2.544419134,820,1473,820,270,0,270,0,69,0,0.074074074,empty,mBC-0814-1
"G9,C10",5612,6130,3954,2176,3521,0,1878,1881,1334,547,2.438756856,1003,1118,781,229,0,229,0,53,0,0,empty,mBC-0814-1
"G9,C11",4371,4605,3148,1457,2751,1,1521,1526,1077,449,2.398663697,776,1446,988,292,0,292,0,65,0,0,empty,mBC-0814-1
"G9,C12",7883,8520,5757,2763,4931,0,2648,2650,1924,726,2.650137741,1387,2168,1553,470,0,470,0,99,0,0,empty,mBC-0814-1
"G9,D1",4168,4459,2994,1465,2610,0,1417,1417,1051,366,2.871584699,748,769,488,157,0,157,0,40,0,0,empty,mBC-0814-1
"G9,D2",5107,5300,3721,1579,3117,5,1611,1617,1166,451,2.585365854,809,1735,1259,414,1,413,1,93,0,0,empty,mBC-0814-1
"G9,D3",484417,548538,325937,222601,327854,0,202669,202869,157559,45310,3.477355992,119768,24078,14847,4575,1,4574,1,574,0,0.00218627,mm10,mBC-0814-1
"G9,D4",4217,4648,2990,1658,2722,0,1505,1505,1074,431,2.49187935,810,1445,965,312,0,312,0,74,0,0,empty,mBC-0814-1
"G9,D5",216096,254568,137937,116631,154070,1,99660,99758,78883,20875,3.778826347,62238,206204,149322,45837,25,45812,2,2630,0,0.000109142,mm10,mBC-0814-1
"G9,D6",4703,5245,3299,1946,3010,1,1654,1655,1221,434,2.813364055,935,1727,1118,349,0,349,0,67,0,0.031518625,empty,mBC-0814-1
"G9,D7",5476,5760,3949,1811,3403,0,1832,1833,1301,532,2.445488722,934,3402,2503,742,0,742,0,143,0,0.017520216,empty,mBC-0814-1
"G9,D8",4820,5140,3532,1608,2956,1,1576,1578,1148,430,2.669767442,794,1064,768,263,0,263,0,58,0,0.034220532,empty,mBC-0814-1
"G9,D9",3225,3397,2217,1180,2051,0,1123,1124,818,306,2.673202614,599,1562,947,254,1,253,1,54,0,0,empty,mBC-0814-1
"G9,D10",3547,3845,2575,1270,2293,0,1284,1284,917,367,2.498637602,664,749,542,185,0,185,0,45,0,0,empty,mBC-0814-1
"G9,D11",3931,4209,2869,1340,2509,0,1287,1288,923,365,2.528767123,665,2363,1686,533,0,533,0,110,0,0,empty,mBC-0814-1
"G9,D12",6011,6188,4218,1970,3648,0,1939,1945,1344,601,2.236272879,1002,3678,2507,768,1,767,1,136,0,0.002607562,empty,mBC-0814-1
"G9,E1",4903,5206,3488,1718,3081,0,1635,1637,1203,434,2.771889401,854,4901,2027,670,2,668,1,120,0,0.02994012,empty,mBC-0814-1
"G9,E2",413289,492341,271237,221104,293178,0,189239,189448,161045,28403,5.669999648,115905,127770,92675,28235,12,28223,1,1951,0,0.001310987,mm10,mBC-0814-1
"G9,E3",3579,3738,2703,1035,2149,0,1095,1097,765,332,2.304216867,544,1465,945,351,0,351,0,78,0,0.002849003,empty,mBC-0814-1
"G9,E4",3050,3276,2193,1083,1899,0,1001,1004,733,271,2.704797048,524,1489,1017,270,0,270,0,70,0,0,empty,mBC-0814-1
"G9,E5",3813,4174,2821,1353,2408,0,1299,1299,889,410,2.168292683,691,1225,851,303,0,303,0,59,0,0,empty,mBC-0814-1
"G9,E6",4239,4502,3049,1453,2618,0,1412,1417,1017,400,2.5425,720,1178,843,286,2,284,1,55,0,0,empty,mBC-0814-1
"G9,E7",4435,4728,3217,1511,2725,0,1457,1461,1051,410,2.563414634,761,1211,900,303,0,303,0,75,0,0,empty,mBC-0814-1
"G9,E8",4434,4655,3303,1352,2739,0,1407,1409,978,431,2.269141531,696,4264,2038,603,0,603,0,91,0,0.048092869,empty,mBC-0814-1
"G9,E9",2761,2929,1946,983,1756,0,954,961,691,270,2.559259259,529,1283,939,292,0,292,0,80,0,0,empty,mBC-0814-1
"G9,E10",388562,463499,257188,206311,276284,0,178156,178350,142689,35661,4.001261883,109021,69814,49734,14329,6,14323,1,1413,0,0.002164351,mm10,mBC-0814-1
"G9,E11",3816,4040,2773,1267,2425,0,1354,1356,984,372,2.64516129,706,1714,1216,391,0,391,0,85,0,0,empty,mBC-0814-1
"G9,E12",3697,4002,2642,1360,2345,0,1253,1253,828,425,1.948235294,656,1088,832,266,0,266,0,51,0,0,empty,mBC-0814-1
"G9,F1",4622,5004,3401,1603,2852,0,1545,1546,1111,435,2.554022989,766,1352,856,275,0,275,0,64,0,0.072727273,empty,mBC-0814-1
"G9,F2",6192,6776,4464,2312,3836,0,2086,2086,1490,596,2.5,1089,1964,1329,425,1,424,1,114,0,0,empty,mBC-0814-1
"G9,F3",4616,4806,3272,1534,2818,0,1508,1508,1110,398,2.788944724,781,1609,1168,363,0,363,0,87,0,0,empty,mBC-0814-1
"G9,F4",5121,5489,3640,1849,3205,1,1789,1795,1275,520,2.451923077,921,592,411,108,0,108,0,22,0,0,empty,mBC-0814-1
"G9,F5",5269,5564,3676,1888,3175,0,1714,1718,1261,457,2.759299781,914,7003,2630,847,0,847,0,132,0,0.011806375,empty,mBC-0814-1
"G9,F6",4651,4843,3299,1544,2864,0,1499,1502,1097,405,2.708641975,786,1962,1383,408,0,408,0,115,0,0,empty,mBC-0814-1
"G9,F7",4317,4829,3090,1739,2881,0,1568,1570,1119,451,2.481152993,892,2618,1104,385,0,385,0,67,0,0,empty,mBC-0814-1
"G9,F8",456914,527321,305865,221456,312480,1,195025,195255,157273,37982,4.140724554,115884,16567,10941,3341,3,3338,2,414,0,0,mm10,mBC-0814-1
"G9,F9",6362,6676,4483,2193,3923,0,2151,2154,1573,581,2.707401033,1126,3098,2255,767,1,766,1,133,0,0,empty,mBC-0814-1
"G9,F10",6507,6820,4660,2160,4052,0,2131,2137,1567,570,2.749122807,1114,1965,1452,418,0,418,0,95,0,0.023923445,empty,mBC-0814-1
"G9,F11",4036,4185,2892,1293,2484,0,1300,1305,912,393,2.320610687,665,1429,857,280,0,280,0,69,0,0,empty,mBC-0814-1
"G9,F12",4614,5083,3181,1902,2902,0,1602,1604,1124,480,2.341666667,881,185,106,51,0,51,0,14,0,0,empty,mBC-0814-1
"G9,G1",7157,7532,5184,2348,4478,0,2368,2376,1695,681,2.488986784,1213,3041,2153,627,0,627,0,133,0,0.033492823,empty,mBC-0814-1
"G9,G2",5554,5812,4047,1765,3396,0,1745,1747,1270,477,2.662473795,856,844,556,184,0,184,0,31,0,0,empty,mBC-0814-1
"G9,G3",513446,581794,350044,231750,342419,1,207890,208163,167884,40279,4.168028005,121917,61871,44039,13642,7,13635,1,1261,0,0.000220022,mm10,mBC-0814-1
"G9,G4",4876,5187,3505,1682,3022,0,1556,1560,1130,430,2.627906977,846,54,46,19,0,19,0,6,0,0,empty,mBC-0814-1
"G9,G5",4667,4919,3359,1560,2819,0,1537,1542,1083,459,2.359477124,770,1656,1225,316,0,316,0,86,0,0,empty,mBC-0814-1
"G9,G6",16043,17447,11522,5925,10043,0,5535,5539,4041,1498,2.697596796,2949,231,145,55,0,55,0,17,0,0,empty,mBC-0814-1
"G9,G7",4885,5340,3508,1832,3139,0,1705,1710,1200,510,2.352941176,942,2569,1888,644,0,644,0,124,0,0,empty,mBC-0814-1
"G9,G8",6589,7164,4582,2582,4275,0,2394,2397,1776,621,2.859903382,1350,3379,2215,704,0,704,0,171,0,0.044034091,empty,mBC-0814-1
"G9,G9",4933,5201,3476,1725,3072,0,1674,1676,1232,444,2.774774775,902,2612,1809,600,0,600,0,151,0,0.02,empty,mBC-0814-1
"G9,G10",531880,595042,362769,232273,352648,0,215402,215620,158274,57346,2.75998326,124965,39577,25336,7864,3,7861,2,841,0,0.00445236,mm10,mBC-0814-1
"G9,G11",566016,648467,378851,269616,380799,4,235135,235413,201276,34137,5.89612444,138811,127486,88688,26816,20,26796,2,1906,0,0.001455441,mm10,mBC-0814-1
"G9,G12",438493,516396,290205,226191,308888,0,192410,192617,159598,33019,4.833520094,116811,491681,358383,110247,42,110205,4,4144,0,0.000117962,mm10,mBC-0814-1
"G9,H1",4425,4768,3154,1614,2798,0,1521,1522,1069,453,2.3598234,841,724,431,177,0,177,0,47,0,0,empty,mBC-0814-1
"G9,H2",7734,8388,5442,2946,4994,0,2745,2747,1942,805,2.41242236,1546,3479,2620,854,1,853,1,172,0,0.001172333,empty,mBC-0814-1
"G9,H3",4862,5195,3429,1766,3074,0,1712,1714,1236,478,2.585774059,881,5069,2025,706,2,704,2,103,0,0.017045455,empty,mBC-0814-1
"G9,H4",433943,501286,287263,214023,294289,0,184316,184537,154334,30203,5.109889746,110883,5114,3662,1058,1,1057,1,160,0,0.01986755,mm10,mBC-0814-1
"G9,H5",6662,7288,4745,2543,4210,0,2350,2352,1673,679,2.463917526,1263,2482,1704,448,0,448,0,95,0,0.024553571,empty,mBC-0814-1
"G9,H6",5774,6216,4172,2044,3656,0,1953,1959,1416,543,2.607734807,1086,2456,1732,547,0,547,0,124,0,0.009140768,empty,mBC-0814-1
"G9,H7",4972,5390,3559,1831,3151,0,1693,1698,1208,490,2.465306122,954,1537,1035,338,0,338,0,67,0,0.017751479,empty,mBC-0814-1
"G9,H8",4066,4550,2896,1654,2613,0,1414,1417,1022,395,2.587341772,809,2290,1615,554,1,553,1,130,0,0.01084991,empty,mBC-0814-1
"G9,H9",4566,4569,3280,1289,2671,0,1371,1373,992,381,2.603674541,641,1435,942,297,0,297,0,66,0,0,empty,mBC-0814-1
"G9,H10",3501,3706,2537,1169,2209,0,1162,1164,812,352,2.306818182,619,1192,844,249,0,249,0,56,0,0,empty,mBC-0814-1
"G9,H11",3714,4035,2669,1366,2390,0,1358,1358,983,375,2.621333333,721,31,22,18,0,18,0,7,0,0,empty,mBC-0814-1
"G9,H12",2243,2534,1525,1009,1525,0,889,890,643,247,2.603238866,517,9772,2995,999,1,998,1,123,0,0.051102204,empty,mBC-0814-1
"G10,A1",501260,594265,331354,262911,351405,0,223905,224144,184637,39507,4.673526211,136005,216732,146899,40898,25,40873,5,2365,0,0.000880777,mm10,mBC-0814-1
"G10,A2",5736,6275,4085,2190,3614,0,1939,1939,1429,510,2.801960784,1075,1427,1035,327,2,325,1,95,0,0.070769231,empty,mBC-0814-1
"G10,A3",5453,5834,3852,1982,3377,0,1859,1861,1329,532,2.498120301,995,17682,5249,1631,6,1625,3,161,0,0.089230769,empty,mBC-0814-1
"G10,A4",558707,624649,383465,241184,364940,0,222205,222482,169038,53444,3.162899484,128444,7239,4900,1294,1,1293,1,177,0,0.010054138,mm10,mBC-0814-1
"G10,A5",5238,5782,3790,1992,3357,0,1851,1851,1314,537,2.446927374,986,2977,1341,403,0,403,0,59,0,0.034739454,empty,mBC-0814-1
"G10,A6",6884,7686,4885,2801,4539,0,2532,2541,1884,657,2.867579909,1388,1209,774,239,1,238,1,51,0,0.004201681,empty,mBC-0814-1
"G10,A7",6309,6904,4560,2344,3884,6,2070,2077,1434,643,2.230171073,1073,5298,2394,746,1,745,1,90,0,0.005369128,empty,mBC-0814-1
"G10,A8",2614,2850,1861,989,1719,0,928,928,610,318,1.918238994,503,1507,1063,322,0,322,0,76,0,0,empty,mBC-0814-1
"G10,A9",8846,9467,6295,3172,5514,0,3032,3037,2154,883,2.439411099,1646,1758,1092,301,1,300,1,70,0,0,empty,mBC-0814-1
"G10,A10",3992,4287,2834,1453,2475,0,1330,1330,931,399,2.333333333,709,187,123,42,0,42,0,15,0,0,empty,mBC-0814-1
"G10,A11",4951,5222,3565,1657,3149,0,1660,1660,1195,465,2.569892473,860,2191,1570,511,0,511,0,99,0,0,empty,mBC-0814-1
"G10,A12",442144,496463,294229,202234,289778,0,176460,176676,147888,28788,5.137140475,103385,421212,299089,83907,42,83865,4,3576,0,0.000465033,mm10,mBC-0814-1
"G10,B1",5439,5802,3971,1831,3375,0,1781,1783,1309,474,2.761603376,926,1465,983,295,1,294,1,74,0,0.006802721,empty,mBC-0814-1
"G10,B2",537020,623536,352131,271405,369478,0,233717,233998,191119,42879,4.457170177,141804,72676,52270,14453,5,14448,1,1174,0,0,mm10,mBC-0814-1
"G10,B3",4308,4627,3095,1532,2768,0,1517,1524,1085,439,2.471526196,800,778,555,212,0,212,0,60,0,0,empty,mBC-0814-1
"G10,B4",4412,4697,3226,1471,2767,12,1488,1502,1035,467,2.21627409,744,1396,1031,285,0,285,0,56,0,0.042105263,empty,mBC-0814-1
"G10,B5",4245,2843,1806,1037,1983,0,1111,1120,770,350,2.2,627,1475,1099,285,2,283,1,60,0,0,empty,mBC-0814-1
"G10,B6",4186,4620,2902,1718,2790,0,1562,1565,1101,464,2.372844828,904,1294,947,262,0,262,0,59,0,0.003816794,empty,mBC-0814-1
"G10,B7",5594,5856,4032,1824,3454,0,1867,1867,1355,512,2.646484375,938,1405,1005,303,0,303,0,56,0,0.099009901,empty,mBC-0814-1
"G10,B8",666937,758802,447628,311174,443046,0,271888,272201,221847,50354,4.405747309,159311,147277,105813,28924,22,28902,3,1880,0,0.000138399,mm10,mBC-0814-1
"G10,B9",485948,568272,324170,244102,332195,1,205774,206021,176090,29931,5.883198022,123878,88295,64109,17779,10,17769,2,1390,0,0.000168833,mm10,mBC-0814-1
"G10,B10",4843,5145,3450,1695,3019,4,1607,1621,1131,490,2.308163265,845,687,466,163,0,163,0,31,0,0,empty,mBC-0814-1
"G10,B11",7211,7467,5177,2290,4347,0,2262,2276,1530,746,2.050938338,1184,253,213,67,0,67,0,12,0,0,empty,mBC-0814-1
"G10,B12",551106,652516,354728,297788,387862,1,258068,258351,185220,73131,2.532715264,161101,25273,13255,3713,0,3713,0,441,0,0.015351468,mm10,mBC-0814-1
"G10,C1",6114,6603,4440,2163,3874,0,2044,2050,1485,565,2.628318584,1090,980,741,202,0,202,0,43,0,0,empty,mBC-0814-1
"G10,C2",6109,6480,4346,2134,3768,1,2065,2070,1469,601,2.444259567,1111,1777,1324,404,0,404,0,84,0,0.03960396,empty,mBC-0814-1
"G10,C3",8277,9150,5824,3326,5286,0,2949,2957,2175,782,2.781329923,1625,880,462,139,0,139,0,41,0,0,empty,mBC-0814-1
"G10,C4",601553,676553,408534,268019,397592,3,241131,241424,184083,57341,3.210320713,140080,152841,113645,32397,21,32376,3,2078,0,0.000154435,mm10,mBC-0814-1
"G10,C5",7948,8402,5728,2674,4919,0,2637,2643,1875,768,2.44140625,1375,1866,1383,359,0,359,0,82,0,0,empty,mBC-0814-1
"G10,C6",6118,6415,4386,2029,3886,6,2051,2064,1513,551,2.745916515,1079,2124,810,261,0,261,0,62,0,0.01532567,empty,mBC-0814-1
"G10,C7",8476,9273,6114,3159,5290,0,2864,2867,2068,799,2.588235294,1548,304,209,70,0,70,0,24,0,0,empty,mBC-0814-1
"G10,C8",6127,6561,4474,2087,3787,0,1974,1974,1445,529,2.731568998,1023,1416,954,303,0,303,0,64,0,0.00330033,empty,mBC-0814-1
"G10,C9",5244,5519,3750,1769,3171,0,1681,1684,1265,419,3.019093079,888,927,614,200,0,200,0,47,0,0.01,empty,mBC-0814-1
"G10,C10",6837,7367,5006,2361,4219,0,2246,2253,1565,688,2.274709302,1155,1916,1021,314,1,313,1,59,0,0,empty,mBC-0814-1
"G10,C11",5121,5508,3700,1808,3189,0,1755,1760,1293,467,2.768736617,912,1757,1352,399,0,399,0,70,0,0,empty,mBC-0814-1
"G10,C12",9296,9838,6632,3206,5727,0,3116,3116,2179,937,2.325506937,1664,1857,1391,379,0,379,0,76,0,0.023746702,empty,mBC-0814-1
"G10,D1",5259,5574,3839,1735,3189,0,1676,1680,1219,461,2.644251627,859,501,344,118,0,118,0,29,0,0,empty,mBC-0814-1
"G10,D2",5898,6079,4298,1781,3570,0,1809,1811,1308,503,2.600397614,914,2040,1349,395,0,395,0,91,0,0.017721519,empty,mBC-0814-1
"G10,D3",12181,13091,8665,4426,7541,0,4105,4110,2942,1168,2.518835616,2149,1983,1214,414,1,413,1,96,0,0,empty,mBC-0814-1
"G10,D4",5144,5767,3646,2121,3229,0,1758,1759,1225,534,2.294007491,958,1231,888,289,0,289,0,75,0,0,empty,mBC-0814-1
"G10,D5",5007,5324,3484,1840,3083,0,1727,1730,1198,532,2.251879699,930,17264,4725,1450,3,1447,1,186,0,0.05390463,empty,mBC-0814-1
"G10,D6",5487,5813,3976,1837,3431,0,1841,1843,1343,500,2.686,951,1212,868,250,1,249,1,51,0,0,empty,mBC-0814-1
"G10,D7",6525,6985,4654,2331,4051,0,2232,2233,1605,628,2.555732484,1179,5334,2719,759,0,759,0,135,0,0.013175231,empty,mBC-0814-1
"G10,D8",5408,5763,3867,1896,3398,0,1833,1833,1295,538,2.407063197,977,893,600,203,0,203,0,48,0,0,empty,mBC-0814-1
"G10,D9",3402,3526,2484,1042,2029,0,1087,1089,777,312,2.490384615,548,881,578,186,0,186,0,55,0,0,empty,mBC-0814-1
"G10,D10",4304,4520,3181,1339,2563,0,1357,1357,963,394,2.444162437,672,982,587,140,0,140,0,33,0,0,empty,mBC-0814-1
"G10,D11",4718,5115,3398,1717,2997,1,1614,1621,1135,486,2.335390947,871,2529,1887,586,0,586,0,124,0,0.027303754,empty,mBC-0814-1
"G10,D12",7122,7682,5159,2523,4410,0,2384,2389,1660,729,2.277091907,1248,3549,2574,769,1,768,1,137,0,0,empty,mBC-0814-1
"G10,E1",5555,5671,3967,1704,3217,0,1688,1691,1207,484,2.493801653,844,2392,1825,518,0,518,0,92,0,0,empty,mBC-0814-1
"G10,E2",3975,4238,2827,1411,2454,0,1323,1329,980,349,2.808022923,706,1605,1148,308,0,308,0,57,0,0,empty,mBC-0814-1
"G10,E3",3982,4234,2895,1339,2382,0,1260,1263,866,397,2.181360202,626,1360,1009,283,0,283,0,49,0,0,empty,mBC-0814-1
"G10,E4",3348,3805,2360,1445,2157,0,1240,1240,850,390,2.179487179,685,858,593,206,0,206,0,45,0,0,empty,mBC-0814-1
"G10,E5",4218,4464,3019,1445,2612,0,1408,1409,1012,397,2.549118388,742,930,671,195,0,195,0,50,0,0,empty,mBC-0814-1
"G10,E6",4986,5256,3593,1663,3039,0,1579,1584,1120,464,2.413793103,819,1866,1389,391,1,390,1,74,0,0.012820513,empty,mBC-0814-1
"G10,E7",5034,5383,3642,1741,3101,0,1600,1600,1132,468,2.418803419,865,1629,1163,308,0,308,0,55,0,0,empty,mBC-0814-1
"G10,E8",5255,5601,3777,1824,3205,0,1684,1686,1239,447,2.771812081,892,2444,1755,455,0,455,0,73,0,0,empty,mBC-0814-1
"G10,E9",3567,3831,2499,1332,2272,0,1232,1232,910,322,2.826086957,669,1874,1490,444,1,443,1,68,0,0.088036117,empty,mBC-0814-1
"G10,E10",4451,4856,3190,1666,2868,0,1520,1523,1078,445,2.42247191,838,1928,1295,375,0,375,0,75,0,0,empty,mBC-0814-1
"G10,E11",4718,5011,3397,1614,2987,0,1629,1631,1131,500,2.262,872,1647,1175,324,1,323,1,64,0,0.009287926,empty,mBC-0814-1
"G10,E12",4571,4873,3209,1664,2781,0,1515,1518,1071,447,2.395973154,811,1301,842,249,0,249,0,55,0,0,empty,mBC-0814-1
"G10,F1",5179,5498,3746,1752,3242,0,1730,1730,1227,503,2.439363817,898,1411,1033,243,0,243,0,44,0,0,empty,mBC-0814-1
"G10,F2",837424,969996,565695,404301,557863,0,349159,349516,274060,75456,3.632050466,206881,248475,181438,51878,23,51855,2,2640,0,1.92845E-05,mm10,mBC-0814-1
"G10,F3",5887,6273,4286,1987,3602,0,1910,1916,1372,544,2.522058824,1001,1893,1342,414,0,414,0,82,0,0.043478261,empty,mBC-0814-1
"G10,F4",5844,6225,4216,2009,3718,0,1986,1990,1443,547,2.638025594,1088,497,367,131,0,131,0,30,0,0,empty,mBC-0814-1
"G10,F5",2573376,2844359,1767327,1077032,1599055,2,992774,994027,777739,216288,3.595849053,569154,124244,76906,21580,15,21565,2,1940,0,0.005193601,mm10,mBC-0814-1
"G10,F6",5593,5958,3969,1989,3399,0,1782,1789,1314,475,2.766315789,956,1803,1212,354,0,354,0,80,0,0,empty,mBC-0814-1
"G10,F7",5005,5292,3575,1717,3136,0,1693,1693,1170,523,2.23709369,909,916,682,194,1,193,1,28,0,0,empty,mBC-0814-1
"G10,F8",6895,7429,5037,2392,4283,0,2250,2260,1634,626,2.610223642,1201,357,310,89,0,89,0,14,0,0,empty,mBC-0814-1
"G10,F9",5956,6435,4322,2113,3693,0,1937,1942,1358,584,2.325342466,1031,1812,1236,373,0,373,0,78,0,0,empty,mBC-0814-1
"G10,F10",7095,7760,5109,2651,4509,2,2438,2443,1720,723,2.378976487,1312,1817,1137,366,1,365,1,75,0,0.101369863,empty,mBC-0814-1
"G10,F11",4805,5026,3466,1560,3035,0,1606,1609,1115,494,2.25708502,832,1265,845,260,0,260,0,49,0,0,empty,mBC-0814-1
"G10,F12",5433,5816,3815,2001,3292,0,1824,1826,1291,535,2.413084112,974,157,136,37,0,37,0,7,0,0,empty,mBC-0814-1
"G10,G1",8542,9170,6224,2946,5331,0,2901,2905,2093,812,2.577586207,1533,3667,2760,744,1,743,1,134,0,0,empty,mBC-0814-1
"G10,G2",6376,6719,4516,2203,3900,0,2100,2103,1513,590,2.56440678,1092,361,259,84,0,84,0,21,0,0,empty,mBC-0814-1
"G10,G3",9993,11083,7135,3948,6498,0,3688,3693,2703,990,2.73030303,2033,4737,2251,684,1,683,1,123,0,0.035139092,empty,mBC-0814-1
"G10,G4",5994,6193,4334,1859,3539,0,1822,1826,1313,513,2.559454191,910,3,1,1,0,1,0,1,0,0,empty,mBC-0814-1
"G10,G5",576928,684952,374604,310348,400491,0,263018,263327,194108,69219,2.804258946,162354,43995,25289,6605,3,6602,1,794,0,0.004392608,mm10,mBC-0814-1
"G10,G6",696652,794643,465816,328827,463855,0,293181,293564,213782,79782,2.679576847,173440,3911,2931,823,1,822,1,121,0,0.00486618,empty,mBC-0814-1
"G10,G7",6345,6695,4450,2245,3991,0,2184,2184,1534,650,2.36,1189,32987,10587,3488,5,3483,1,330,0,0.12833764,empty,mBC-0814-1
"G10,G8",7981,8625,5709,2916,5086,0,2834,2837,2038,799,2.55068836,1510,3207,2231,666,0,666,0,128,0,0.022522523,empty,mBC-0814-1
"G10,G9",6212,6608,4410,2198,3868,0,2129,2132,1516,616,2.461038961,1078,17811,6478,1940,2,1938,2,232,0,0.160990712,empty,mBC-0814-1
"G10,G10",9854,10458,7182,3276,6127,0,3249,3254,2251,1003,2.244267198,1714,3356,2425,736,0,736,0,135,0,0,empty,mBC-0814-1
"G10,G11",10463,10995,7518,3477,6506,0,3488,3497,2595,902,2.876940133,1800,2126,1246,415,0,415,0,82,0,0,empty,mBC-0814-1
"G10,G12",5461,5890,3870,2020,3394,0,1874,1878,1312,566,2.318021201,1007,9576,3705,1090,1,1089,1,158,0,0.054178145,empty,mBC-0814-1
"G10,H1",5059,5538,3507,2031,3196,0,1778,1778,1286,492,2.613821138,973,4566,1697,520,0,520,0,84,0,0,empty,mBC-0814-1
"G10,H2",8727,9560,6232,3328,5507,1,3017,3018,2122,896,2.368303571,1584,4149,3101,938,0,938,0,158,0,0.006396588,empty,mBC-0814-1
"G10,H3",6369,6565,4642,1923,3824,0,1997,2000,1376,624,2.205128205,1018,1651,1100,347,0,347,0,91,0,0,empty,mBC-0814-1
"G10,H4",5944,6398,4251,2147,3696,0,1997,2002,1390,612,2.27124183,1083,277,226,51,0,51,0,11,0,0,empty,mBC-0814-1
"G10,H5",864294,1000564,583238,417326,571743,2,355092,355545,280953,74592,3.766529923,211287,217382,157438,43608,23,43585,3,2466,0,0.000550648,mm10,mBC-0814-1
"G10,H6",7686,8108,5485,2623,4730,0,2617,2619,1870,749,2.496662216,1367,8529,3691,1096,2,1094,1,151,0,0.006398537,empty,mBC-0814-1
"G10,H7",5969,6136,4270,1866,3570,0,1866,1866,1333,533,2.500938086,922,1607,1165,347,0,347,0,55,0,0,empty,mBC-0814-1
"G10,H8",4929,5298,3491,1807,3110,0,1689,1693,1208,485,2.490721649,905,2007,1333,409,0,409,0,98,0,0.004889976,empty,mBC-0814-1
"G10,H9",5456,5931,3998,1933,3437,1,1825,1828,1260,568,2.218309859,974,1690,1162,302,0,302,0,60,0,0,empty,mBC-0814-1
"G10,H10",3949,4340,2814,1526,2565,0,1474,1474,1019,455,2.23956044,798,1270,877,293,0,293,0,62,0,0.003412969,empty,mBC-0814-1
"G10,H11",4381,4692,3080,1612,2730,0,1504,1506,1091,415,2.628915663,819,107,79,27,0,27,0,6,0,0,empty,mBC-0814-1
"G10,H12",3027,3383,2059,1324,1993,0,1164,1166,809,357,2.266106443,656,1559,1027,306,1,305,1,58,0,0.052459016,empty,mBC-0814-1
"G11,A1",5579,6111,3984,2127,3463,0,1860,1860,1332,528,2.522727273,999,1579,1162,280,0,280,0,52,0,0,empty,mBC-0814-1
"G11,A2",4707,5051,3381,1670,3044,0,1634,1635,1191,444,2.682432432,897,1253,956,292,0,292,0,61,0,0,empty,mBC-0814-1
"G11,A3",4568,4993,3218,1775,2917,0,1614,1618,1158,460,2.517391304,913,730,498,161,0,161,0,33,0,0.031055901,empty,mBC-0814-1
"G11,A4",594183,687431,401420,286011,400599,0,247947,248242,213153,35089,6.074638776,146643,55999,40340,11590,4,11586,1,979,0,0.001726221,mm10,mBC-0814-1
"G11,A5",4506,5020,3260,1760,2934,0,1576,1578,1127,451,2.498891353,888,1393,976,314,0,314,0,40,0,0,empty,mBC-0814-1
"G11,A6",3662,3989,2648,1341,2316,0,1239,1239,867,372,2.330645161,660,1430,1003,334,0,334,0,57,0,0,empty,mBC-0814-1
"G11,A7",5307,5881,3847,2034,3478,0,1836,1841,1339,502,2.667330677,1028,2132,1548,396,1,395,1,58,0,0.032911392,empty,mBC-0814-1
"G11,A8",2198,2625,1484,1141,1488,0,879,879,632,247,2.558704453,519,5632,1950,599,0,599,0,72,0,0.03672788,empty,mBC-0814-1
"G11,A9",6184,6648,4456,2192,3740,0,2004,2005,1424,581,2.450946644,1034,1549,1000,347,0,347,0,62,0,0.023054755,empty,mBC-0814-1
"G11,A10",3357,3538,2358,1180,2126,0,1182,1182,813,369,2.203252033,643,136,76,18,0,18,0,9,0,0,empty,mBC-0814-1
"G11,A11",4274,4650,3075,1575,2785,0,1541,1541,1131,410,2.758536585,816,1894,1308,397,0,397,0,64,0,0,empty,mBC-0814-1
"G11,A12",348957,381810,237788,144022,225794,1,136402,136524,104703,31821,3.290374281,77824,53239,36284,10023,8,10015,1,1031,0,0.000798802,mm10,mBC-0814-1
"G11,B1",4290,4676,3014,1662,2739,0,1499,1499,1088,411,2.647201946,824,1061,726,220,0,220,0,50,0,0,empty,mBC-0814-1
"G11,B2",4849,5178,3358,1820,3024,0,1680,1680,1177,503,2.339960239,890,644,490,144,0,144,0,26,0,0.104166667,empty,mBC-0814-1
"G11,B3",3654,3972,2597,1375,2407,0,1344,1345,967,378,2.558201058,733,2818,1199,384,0,384,0,58,0,0.052083333,empty,mBC-0814-1
"G11,B4",4192,4423,3005,1418,2573,0,1358,1361,930,431,2.157772622,699,1298,825,214,0,214,0,40,0,0,empty,mBC-0814-1
"G11,B5",3731,2432,1574,858,1730,0,1013,1021,717,304,2.358552632,571,1683,1201,358,0,358,0,44,0,0.055865922,empty,mBC-0814-1
"G11,B6",3794,4000,2736,1264,2378,0,1280,1284,924,360,2.566666667,664,19029,5720,1809,11,1798,3,193,0,0.023915462,empty,mBC-0814-1
"G11,B7",546587,620620,372791,247829,362309,1,217683,217930,181868,36062,5.043203372,126009,184152,132211,37850,11,37839,2,2176,0,0.000290705,mm10,mBC-0814-1
"G11,B8",3729,3865,2685,1180,2305,0,1220,1222,833,389,2.141388175,640,1051,763,229,0,229,0,31,0,0,empty,mBC-0814-1
"G11,B9",4370,4785,3113,1672,2781,0,1500,1505,1134,371,3.056603774,814,671,508,165,0,165,0,42,0,0,empty,mBC-0814-1
"G11,B10",4050,4169,2863,1306,2520,0,1334,1335,958,377,2.541114058,702,436,298,63,0,63,0,13,0,0,empty,mBC-0814-1
"G11,B11",6427,6988,4602,2386,3990,1,2164,2176,1523,653,2.332312404,1135,175,134,31,0,31,0,11,0,0,empty,mBC-0814-1
"G11,B12",5380,5990,3883,2107,3403,7,1895,1903,1337,566,2.362190813,1020,815,528,166,0,166,0,35,0,0,empty,mBC-0814-1
"G11,C1",5503,5727,4043,1684,3331,0,1662,1662,1204,458,2.628820961,799,343,249,49,0,49,0,14,0,0,empty,mBC-0814-1
"G11,C2",517544,611876,337445,274431,357739,1,230288,230529,194193,36336,5.344369221,140357,120142,87036,23868,13,23855,2,1791,0,8.38399E-05,mm10,mBC-0814-1
"G11,C3",5704,6054,4191,1863,3533,0,1914,1922,1330,592,2.246621622,997,687,473,138,0,138,0,36,0,0,empty,mBC-0814-1
"G11,C4",4731,4931,3425,1506,2948,0,1532,1537,1112,425,2.616470588,797,884,643,192,4,188,1,35,0,0.037234043,empty,mBC-0814-1
"G11,C5",6803,7234,4916,2318,4159,3,2217,2223,1615,608,2.65625,1164,1279,911,285,0,285,0,46,0,0,empty,mBC-0814-1
"G11,C6",5853,6387,4195,2192,3836,1,2076,2080,1518,562,2.701067616,1140,1026,756,239,0,239,0,45,0,0,empty,mBC-0814-1
"G11,C7",7077,7705,5098,2607,4394,0,2386,2388,1693,695,2.435971223,1288,341,257,71,0,71,0,16,0,0,empty,mBC-0814-1
"G11,C8",5213,5508,3744,1764,3284,6,1718,1730,1219,511,2.385518591,908,2537,1812,518,0,518,0,80,0,0,empty,mBC-0814-1
"G11,C9",4553,4730,3268,1462,2742,0,1496,1503,1037,466,2.225321888,747,5354,2020,613,0,613,0,70,0,0.024469821,empty,mBC-0814-1
"G11,C10",5578,6094,4112,1982,3567,0,1945,1950,1403,547,2.564899452,1021,1013,789,258,0,258,0,40,0,0,empty,mBC-0814-1
"G11,C11",4629,4975,3313,1662,2959,0,1648,1649,1186,463,2.561555076,860,2136,1577,394,0,394,0,64,0,0,empty,mBC-0814-1
"G11,C12",8137,8699,5828,2871,5080,0,2800,2804,2027,777,2.608751609,1488,1836,1334,342,0,342,0,64,0,0,empty,mBC-0814-1
"G11,D1",4376,4579,3118,1461,2663,0,1429,1429,1029,400,2.5725,735,697,560,156,0,156,0,18,0,0.147435897,empty,mBC-0814-1
"G11,D2",5476,5647,4026,1621,3328,0,1654,1661,1184,477,2.482180294,814,1102,848,260,0,260,0,47,0,0.061538462,empty,mBC-0814-1
"G11,D3",10388,11102,7407,3695,6427,0,3454,3467,2472,995,2.484422111,1845,2274,1539,480,0,480,0,79,0,0.020833333,empty,mBC-0814-1
"G11,D4",4368,4675,3124,1551,2725,1,1478,1479,1046,433,2.415704388,752,1109,738,230,0,230,0,55,0,0,empty,mBC-0814-1
"G11,D5",3735,3976,2568,1408,2431,0,1383,1386,997,389,2.562982005,802,1684,1248,372,0,372,0,69,0,0.043010753,empty,mBC-0814-1
"G11,D6",5175,5525,3787,1738,3178,0,1699,1708,1213,495,2.450505051,886,911,622,218,0,218,0,36,0,0,empty,mBC-0814-1
"G11,D7",5644,5956,4058,1898,3441,0,1838,1842,1320,522,2.528735632,961,2381,1704,514,0,514,0,73,0,0,empty,mBC-0814-1
"G11,D8",4702,4973,3319,1654,2901,0,1550,1553,1156,397,2.911838791,810,1132,719,230,0,230,0,44,0,0,empty,mBC-0814-1
"G11,D9",2884,2966,2115,851,1753,0,946,948,662,286,2.314685315,472,1523,1032,266,0,266,0,48,0,0,empty,mBC-0814-1
"G11,D10",4362,4918,3163,1755,2870,0,1640,1642,1221,421,2.90023753,893,945,563,191,0,191,0,36,0,0,empty,mBC-0814-1
"G11,D11",4022,4233,2988,1245,2481,0,1332,1334,971,363,2.674931129,654,1961,1454,425,0,425,0,79,0,0,empty,mBC-0814-1
"G11,D12",6379,6933,4550,2383,3994,0,2188,2192,1537,655,2.346564885,1200,3179,2237,675,0,675,0,106,0,0.01037037,empty,mBC-0814-1
"G11,E1",508829,570534,346538,223996,336810,0,204836,205056,148376,56680,2.617784051,119110,41779,29572,8373,1,8372,1,886,0,0.001194458,mm10,mBC-0814-1
"G11,E2",3587,3899,2652,1247,2275,0,1219,1222,846,376,2.25,654,1161,825,242,0,242,0,47,0,0.016528926,empty,mBC-0814-1
"G11,E3",3596,3795,2563,1232,2155,0,1118,1118,796,322,2.472049689,568,1276,855,260,1,259,1,46,0,0,empty,mBC-0814-1
"G11,E4",3125,3371,2269,1102,1969,0,1007,1009,715,294,2.431972789,538,2741,1190,358,0,358,0,40,0,0.189944134,empty,mBC-0814-1
"G11,E5",13987,15080,10176,4904,8577,0,4324,4333,3427,906,3.782560706,2373,4408,3274,969,0,969,0,155,0,0,empty,mBC-0814-1
"G11,E6",4421,4859,3234,1625,2861,0,1503,1508,1079,429,2.515151515,791,1276,912,265,0,265,0,51,0,0,empty,mBC-0814-1
"G11,E7",4517,4731,3265,1466,2751,0,1428,1430,999,431,2.317865429,727,1716,1187,333,0,333,0,52,0,0,empty,mBC-0814-1
"G11,E8",4472,4570,3274,1296,2688,0,1386,1386,989,397,2.491183879,660,1437,1000,333,0,333,0,59,0,0.03003003,empty,mBC-0814-1
"G11,E9",3485,3713,2510,1203,2225,0,1139,1141,817,324,2.521604938,607,1474,941,295,2,293,1,63,0,0,empty,mBC-0814-1
"G11,E10",303757,352535,199521,153014,212664,1,138805,138940,85156,53784,1.583296148,84299,13875,9486,2614,1,2613,1,367,0,0.011098354,mm10,mBC-0814-1
"G11,E11",4055,4221,2956,1265,2439,0,1280,1280,888,392,2.265306122,628,1193,789,255,0,255,0,53,0,0,empty,mBC-0814-1
"G11,E12",3853,4031,2691,1340,2376,0,1303,1305,927,378,2.452380952,682,15059,3934,1359,2,1357,1,152,0,0.019896831,empty,mBC-0814-1
"G11,F1",4599,4820,3349,1471,2822,0,1470,1472,1073,399,2.689223058,725,7394,2595,809,0,809,0,96,0,0.05315204,empty,mBC-0814-1
"G11,F2",6674,7048,4847,2201,4020,0,2101,2102,1557,545,2.856880734,1106,1639,1061,379,0,379,0,74,0,0,empty,mBC-0814-1
"G11,F3",5111,5471,3732,1739,3169,2,1700,1702,1236,466,2.652360515,887,1386,1004,266,0,266,0,64,0,0,empty,mBC-0814-1
"G11,F4",5281,5653,3691,1962,3359,0,1860,1862,1344,518,2.594594595,996,659,456,108,0,108,0,22,0,0,empty,mBC-0814-1
"G11,F5",4856,5099,3536,1563,3031,0,1596,1602,1143,459,2.490196078,822,1340,998,286,0,286,0,54,0,0,empty,mBC-0814-1
"G11,F6",4948,5074,3537,1537,2976,0,1594,1596,1110,486,2.283950617,823,1725,1024,302,0,302,0,55,0,0.059602649,empty,mBC-0814-1
"G11,F7",1477098,1671744,1009815,661929,972435,5,604446,605137,451741,153396,2.944933375,352617,95818,58345,16798,10,16788,1,1484,0,0.003633548,mm10,mBC-0814-1
"G11,F8",5876,6269,4153,2116,3689,0,2024,2028,1461,567,2.576719577,1081,156,115,33,0,33,0,7,0,0,empty,mBC-0814-1
"G11,F9",5190,5387,3726,1661,3191,0,1671,1677,1198,479,2.501043841,851,1596,965,277,0,277,0,58,0,0,empty,mBC-0814-1
"G11,F10",661571,754913,452384,302529,441016,0,268043,268299,207137,61162,3.386694353,156523,119085,86343,24505,18,24487,3,1614,0,0.000653408,mm10,mBC-0814-1
"G11,F11",4090,4375,2986,1389,2586,0,1403,1403,1019,384,2.653645833,743,1042,751,235,2,233,1,46,0,0,empty,mBC-0814-1
"G11,F12",4622,4933,3266,1667,2841,0,1559,1562,1115,447,2.494407159,819,102,87,34,0,34,0,6,0,0.088235294,empty,mBC-0814-1
"G11,G1",440542,501577,297266,204311,297877,1,182919,183130,136974,46156,2.967631511,107758,145047,100705,28514,19,28495,3,2152,0,0.000175469,mm10,mBC-0814-1
"G11,G2",5607,6026,4003,2023,3504,0,1870,1873,1318,555,2.374774775,1027,278,207,67,0,67,0,13,0,0,empty,mBC-0814-1
"G11,G3",5033,5316,3666,1650,3050,0,1608,1608,1149,459,2.503267974,832,1815,1237,364,0,364,0,57,0,0,empty,mBC-0814-1
"G11,G4",5552,6053,3955,2098,3508,0,1876,1881,1351,530,2.549056604,1033,85,73,20,0,20,0,1,0,0,empty,mBC-0814-1
"G11,G5",4425,4958,3205,1753,2950,0,1664,1666,1154,512,2.25390625,907,2379,1307,378,1,377,1,60,0,0,empty,mBC-0814-1
"G11,G6",8658,9152,6153,2999,5353,0,2810,2814,1979,835,2.37005988,1491,134,96,29,0,29,0,11,0,0,empty,mBC-0814-1
"G11,G7",5330,5623,3825,1798,3225,0,1675,1675,1195,480,2.489583333,855,1715,1269,377,0,377,0,57,0,0,empty,mBC-0814-1
"G11,G8",6460,7236,4493,2743,4232,0,2351,2358,1673,685,2.442335766,1333,2810,1900,587,0,587,0,102,0,0.001703578,empty,mBC-0814-1
"G11,G9",4733,5153,3323,1830,3087,0,1712,1713,1204,509,2.365422397,898,2440,1615,493,0,493,0,85,0,0.09127789,empty,mBC-0814-1
"G11,G10",8500,9079,6119,2960,5338,0,2849,2862,2018,844,2.390995261,1492,2103,1484,410,0,410,0,81,0,0.004878049,empty,mBC-0814-1
"G11,G11",9193,9526,6699,2827,5487,0,2883,2884,2069,815,2.538650307,1401,1144,699,244,0,244,0,48,0,0,empty,mBC-0814-1
"G11,G12",4185,4587,3023,1564,2674,0,1408,1410,991,419,2.365155131,743,2067,1538,431,0,431,0,75,0,0.041763341,empty,mBC-0814-1
"G11,H1",462361,535925,313159,222766,315692,1,192291,192502,162410,30092,5.397115512,114742,110918,80795,22630,13,22617,1,1687,0,8.84291E-05,mm10,mBC-0814-1
"G11,H2",7905,8330,5704,2626,4888,0,2691,2692,1915,777,2.464607465,1411,2879,2018,617,0,617,0,104,0,0,empty,mBC-0814-1
"G11,H3",5006,5327,3624,1703,3145,0,1709,1709,1218,491,2.480651731,881,1229,738,218,0,218,0,49,0,0,empty,mBC-0814-1
"G11,H4",5158,5485,3724,1761,3237,0,1756,1758,1249,509,2.453831041,892,37,25,12,0,12,0,5,0,0,empty,mBC-0814-1
"G11,H5",6882,7556,4978,2578,4314,0,2348,2352,1651,701,2.355206847,1267,2058,1374,415,0,415,0,62,0,0.007228916,empty,mBC-0814-1
"G11,H6",5890,6324,4111,2213,3718,0,2064,2064,1476,588,2.510204082,1126,1591,1094,349,0,349,0,73,0,0,empty,mBC-0814-1
"G11,H7",5118,5538,3628,1910,3250,0,1765,1766,1239,527,2.351043643,956,1325,888,268,1,267,1,42,0,0,empty,mBC-0814-1
"G11,H8",4227,4481,2975,1506,2634,0,1426,1430,1005,425,2.364705882,762,1386,918,290,0,290,0,65,0,0.079310345,empty,mBC-0814-1
"G11,H9",4373,4420,3145,1275,2578,0,1336,1338,936,402,2.328358209,629,1804,1297,358,0,358,0,52,0,0,empty,mBC-0814-1
"G11,H10",3383,3609,2428,1181,2086,0,1125,1125,799,326,2.450920245,591,1013,755,229,0,229,0,46,0,0,empty,mBC-0814-1
"G11,H11",3688,4031,2549,1482,2365,5,1315,1322,940,382,2.460732984,733,406,192,58,0,58,0,8,0,0,empty,mBC-0814-1
"G11,H12",2412,2539,1649,890,1516,0,850,850,614,236,2.601694915,456,1192,832,285,0,285,0,44,0,0.049122807,empty,mBC-0814-1
"G12,A1",6581,7165,4617,2548,4179,0,2298,2299,1622,677,2.395864106,1289,2305,1335,435,1,434,1,87,0,0.039170507,empty,mBC-0814-1
"G12,A2",6059,6532,4390,2142,3752,0,2040,2045,1482,563,2.632326821,1051,1155,675,259,0,259,0,103,0,0,empty,mBC-0814-1
"G12,A3",5501,5949,3870,2079,3442,0,1849,1855,1296,559,2.31842576,1008,1239,888,242,0,242,0,51,0,0,empty,mBC-0814-1
"G12,A4",736840,855939,492491,363448,495543,2,313148,313499,249956,63543,3.933651228,187500,62289,43095,12385,10,12375,1,1067,0,0.002585859,mm10,mBC-0814-1
"G12,A5",5489,5969,3913,2056,3511,0,1934,1934,1426,508,2.807086614,1011,1349,902,245,0,245,0,57,0,0,empty,mBC-0814-1
"G12,A6",4304,4737,3126,1611,2794,0,1505,1505,1072,433,2.475750577,814,6021,2270,745,0,745,0,85,0,0.087248322,empty,mBC-0814-1
"G12,A7",6319,6678,4460,2218,3974,0,2203,2203,1563,640,2.4421875,1198,2071,1478,408,0,408,0,99,0,0,empty,mBC-0814-1
"G12,A8",2460,2750,1735,1015,1643,0,898,898,643,255,2.521568627,509,1454,1073,315,0,315,0,79,0,0,empty,mBC-0814-1
"G12,A9",7254,7376,5289,2087,4325,0,2254,2262,1606,656,2.448170732,1127,1664,1238,297,0,297,0,56,0,0.063973064,empty,mBC-0814-1
"G12,A10",4573,4935,3278,1657,2870,0,1574,1574,1105,469,2.356076759,827,428,335,89,0,89,0,21,0,0.08988764,empty,mBC-0814-1
"G12,A11",5605,6129,3986,2143,3561,0,1948,1956,1396,560,2.492857143,1085,2346,1641,483,2,481,1,94,0,0,empty,mBC-0814-1
"G12,A12",4744,5074,3410,1664,3001,0,1670,1673,1227,446,2.751121076,876,3745,2730,815,1,814,1,196,0,0.004914005,empty,mBC-0814-1
"G12,B1",5403,5674,3778,1896,3372,0,1866,1866,1301,565,2.302654867,954,2921,1765,558,0,558,0,93,0,0.003584229,empty,mBC-0814-1
"G12,B2",5174,5503,3560,1943,3274,0,1824,1829,1289,540,2.387037037,1003,356,236,53,0,53,0,21,0,0,empty,mBC-0814-1
"G12,B3",4789,5121,3402,1719,3019,0,1688,1690,1196,494,2.421052632,905,1370,1119,287,0,287,0,49,0,0,empty,mBC-0814-1
"G12,B4",4753,5197,3375,1822,3093,0,1733,1735,1217,518,2.349420849,963,1112,818,217,0,217,0,59,0,0.041474654,empty,mBC-0814-1
"G12,B5",4714,3288,2036,1252,2338,0,1292,1304,981,323,3.037151703,788,1275,901,280,0,280,0,63,0,0.060714286,empty,mBC-0814-1
"G12,B6",4774,5295,3407,1888,3120,0,1761,1766,1230,536,2.294776119,947,3410,1342,387,3,384,2,73,0,0,empty,mBC-0814-1
"G12,B7",745383,846431,503851,342580,494536,2,310127,310416,247791,62625,3.956742515,182037,16613,11243,3288,5,3283,1,452,0,0.001522997,mm10,mBC-0814-1
"G12,B8",4332,4622,3129,1493,2725,0,1433,1434,1036,398,2.603015075,769,758,491,143,0,143,0,40,0,0,empty,mBC-0814-1
"G12,B9",5498,6067,3833,2234,3561,0,1977,1979,1434,545,2.631192661,1125,972,627,216,0,216,0,66,0,0,empty,mBC-0814-1
"G12,B10",5145,5518,3651,1867,3262,0,1756,1760,1214,546,2.223443223,948,6716,2137,655,0,655,0,66,0,0.015267176,empty,mBC-0814-1
"G12,B11",7391,7897,5273,2624,4525,1,2465,2468,1767,701,2.520684736,1296,346,251,70,0,70,0,14,0,0,empty,mBC-0814-1
"G12,B12",6109,6608,4379,2229,3900,0,2143,2145,1511,634,2.383280757,1142,1250,832,245,0,245,0,53,0,0,empty,mBC-0814-1
"G12,C1",6172,6656,4528,2128,3889,0,2041,2042,1430,612,2.336601307,1083,536,415,136,0,136,0,37,0,0,empty,mBC-0814-1
"G12,C2",6057,6345,4408,1937,3763,0,1974,1976,1399,577,2.424610052,1011,2519,1678,483,0,483,0,109,0,0.022774327,empty,mBC-0814-1
"G12,C3",6617,7341,4806,2535,4134,0,2247,2249,1601,648,2.470679012,1229,957,573,158,0,158,0,39,0,0,empty,mBC-0814-1
"G12,C4",5903,6487,4272,2215,3833,0,2079,2081,1520,561,2.709447415,1113,1633,1107,334,0,334,0,83,0,0.02994012,empty,mBC-0814-1
"G12,C5",8281,8535,5839,2696,4896,0,2623,2630,1878,752,2.497340426,1339,27675,9110,2986,3,2983,3,285,0,0.157224271,empty,mBC-0814-1
"G12,C6",6066,6569,4298,2271,3876,0,2089,2090,1517,573,2.647469459,1122,1583,1079,352,0,352,0,83,0,0.011363636,empty,mBC-0814-1
"G12,C7",7802,8442,5562,2880,4809,0,2612,2615,1923,692,2.778901734,1406,363,235,85,0,85,0,13,0,0,empty,mBC-0814-1
"G12,C8",6059,6312,4370,1942,3738,0,1961,1968,1386,582,2.381443299,1014,1714,1145,303,1,302,1,74,0,0,empty,mBC-0814-1
"G12,C9",5146,5534,3755,1779,3303,0,1786,1790,1242,548,2.266423358,967,1288,909,280,0,280,0,66,0,0,empty,mBC-0814-1
"G12,C10",6383,6772,4619,2153,3845,0,2007,2012,1458,554,2.631768953,1019,1072,712,209,1,208,1,53,0,0,empty,mBC-0814-1
"G12,C11",5232,5825,3765,2060,3344,0,1860,1862,1335,527,2.533206831,1028,1571,1066,346,0,346,0,55,0,0,empty,mBC-0814-1
"G12,C12",9219,9878,6713,3165,5735,0,3086,3092,2208,884,2.497737557,1654,2431,1714,515,2,513,2,99,0,0.013645224,empty,mBC-0814-1
"G12,D1",5162,5582,3722,1860,3275,0,1753,1756,1223,533,2.294559099,934,843,636,157,0,157,0,39,0,0.01910828,empty,mBC-0814-1
"G12,D2",5565,6058,4051,2007,3430,0,1778,1783,1298,485,2.67628866,948,1772,1327,367,0,367,0,86,0,0,empty,mBC-0814-1
"G12,D3",12246,13123,8725,4398,7694,0,4221,4227,3011,1216,2.476151316,2240,2359,1564,484,0,484,0,111,0,0,empty,mBC-0814-1
"G12,D4",5505,6301,3839,2462,3597,0,2039,2042,1453,589,2.466893039,1193,4860,2072,666,2,664,1,110,0,0.012048193,empty,mBC-0814-1
"G12,D5",5436,5817,3891,1926,3475,0,1905,1906,1377,529,2.603024575,975,10041,3744,1148,2,1146,2,166,0,0.054973822,empty,mBC-0814-1
"G12,D6",5493,6053,3900,2153,3501,0,1922,1924,1376,548,2.510948905,1078,1100,632,206,0,206,0,54,0,0.019417476,empty,mBC-0814-1
"G12,D7",6864,7356,4901,2455,4288,11,2300,2316,1597,719,2.221140473,1228,2348,1695,494,0,494,0,94,0,0.006072874,empty,mBC-0814-1
"G12,D8",5380,5719,3890,1829,3333,0,1780,1785,1299,486,2.672839506,936,1027,663,253,0,253,0,55,0,0.003952569,empty,mBC-0814-1
"G12,D9",3714,4097,2643,1454,2337,0,1317,1317,912,405,2.251851852,689,1114,671,206,0,206,0,46,0,0,empty,mBC-0814-1
"G12,D10",4267,4662,2987,1675,2703,0,1505,1512,1081,431,2.50812065,835,1343,853,241,0,241,0,53,0,0,empty,mBC-0814-1
"G12,D11",531105,627572,353329,274243,368210,2,233004,233282,186754,46528,4.013798143,141031,463020,338102,91868,58,91810,3,3744,0,0.000435682,mm10,mBC-0814-1
"G12,D12",7436,7769,5272,2497,4580,0,2514,2523,1753,770,2.276623377,1296,4581,3333,898,1,897,1,135,0,0,empty,mBC-0814-1
"G12,E1",5553,5773,4043,1730,3408,0,1750,1751,1250,501,2.49500998,870,1277,859,233,0,233,0,60,0,0,empty,mBC-0814-1
"G12,E2",4182,4536,3057,1479,2647,0,1438,1441,1045,396,2.638888889,748,3416,1632,540,0,540,0,112,0,0.166666667,empty,mBC-0814-1
"G12,E3",3793,4311,2661,1650,2473,0,1397,1401,966,435,2.220689655,784,1305,866,293,1,292,1,66,0,0.020547945,empty,mBC-0814-1
"G12,E4",3425,3652,2414,1238,2139,0,1174,1176,835,341,2.448680352,637,727,507,181,0,181,0,52,0,0.066298343,empty,mBC-0814-1
"G12,E5",4333,4531,3062,1469,2607,0,1395,1395,1025,370,2.77027027,739,1204,824,232,0,232,0,47,0,0,empty,mBC-0814-1
"G12,E6",5277,5545,3782,1763,3242,6,1700,1706,1189,517,2.299806576,912,1604,1159,369,0,369,0,87,0,0.005420054,empty,mBC-0814-1
"G12,E7",5021,5443,3667,1776,3100,0,1662,1666,1208,458,2.637554585,864,1533,1011,314,0,314,0,69,0,0.003184713,empty,mBC-0814-1
"G12,E8",716773,820019,485630,334389,476749,1,295544,295851,233902,61949,3.775718736,173048,149468,101882,29324,10,29314,1,2021,0,0.000648154,mm10,mBC-0814-1
"G12,E9",3772,4143,2668,1475,2362,0,1314,1317,974,343,2.839650146,696,1813,1413,442,1,441,1,76,0,0.004535147,empty,mBC-0814-1
"G12,E10",4703,5257,3442,1815,3092,0,1735,1737,1262,475,2.656842105,954,1877,1394,427,0,427,0,86,0,0,empty,mBC-0814-1
"G12,E11",4503,4754,3291,1463,2854,0,1523,1523,1096,427,2.566744731,812,1490,1016,278,0,278,0,73,0,0,empty,mBC-0814-1
"G12,E12",4590,5100,3331,1769,2991,0,1671,1671,1230,441,2.789115646,921,1436,935,276,0,276,0,55,0,0,empty,mBC-0814-1
"G12,F1",5178,5451,3675,1776,3194,0,1715,1716,1239,477,2.597484277,901,9041,3025,923,3,920,2,133,0,0.02826087,empty,mBC-0814-1
"G12,F2",7332,7927,5324,2603,4535,0,2424,2427,1738,689,2.522496372,1329,1865,1292,456,0,456,0,109,0,0.002192982,empty,mBC-0814-1
"G12,F3",5748,6144,4078,2066,3525,0,1884,1891,1347,544,2.476102941,1000,3647,1668,500,0,500,0,110,0,0.01,empty,mBC-0814-1
"G12,F4",6172,6411,4489,1922,3743,0,1924,1930,1413,517,2.733075435,968,1545,820,282,0,282,0,49,0,0.042553191,empty,mBC-0814-1
"G12,F5",6082,6388,4343,2045,3672,0,2032,2041,1449,592,2.447635135,1065,22582,6268,1939,5,1934,3,209,0,0.024819028,empty,mBC-0814-1
"G12,F6",15214,18182,10338,7844,10786,0,6679,6686,5561,1125,4.943111111,4060,4145,2825,883,0,883,0,142,0,0.00792752,empty,mBC-0814-1
"G12,F7",4886,5288,3614,1674,3085,0,1615,1617,1168,449,2.601336303,843,688,464,153,0,153,0,46,0,0,empty,mBC-0814-1
"G12,F8",6972,7729,4895,2834,4435,7,2443,2451,1750,701,2.496433666,1390,318,208,78,0,78,0,14,0,0,empty,mBC-0814-1
"G12,F9",6551,7116,4750,2366,4082,0,2150,2156,1544,612,2.522875817,1142,2597,1959,547,1,546,1,101,0,0,empty,mBC-0814-1
"G12,F10",7649,7896,5441,2455,4525,0,2390,2390,1765,625,2.824,1215,28190,8265,2668,6,2662,3,235,0,0.126972201,empty,mBC-0814-1
"G12,F11",575414,652240,384747,267493,380595,1,231738,231998,194143,37855,5.128595958,135949,282803,197768,58411,31,58380,3,2910,0,0.000102775,mm10,mBC-0814-1
"G12,F12",5372,5859,3919,1940,3416,0,1876,1878,1338,540,2.477777778,993,202,151,33,0,33,0,13,0,0,empty,mBC-0814-1
"G12,G1",8781,9592,6369,3223,5436,0,2894,2904,2027,877,2.311288483,1493,2818,1943,606,2,604,1,140,0,0,empty,mBC-0814-1
"G12,G2",6614,6909,4703,2206,3971,0,2102,2103,1502,601,2.499168053,1092,1098,527,157,0,157,0,33,0,0.01910828,empty,mBC-0814-1
"G12,G3",5880,6281,4160,2121,3689,0,2079,2082,1411,671,2.102831595,1129,3078,1849,551,0,551,0,107,0,0.023593466,empty,mBC-0814-1
"G12,G4",5833,6267,4303,1964,3617,5,1974,1980,1424,556,2.561151079,1005,10,4,2,0,2,0,2,0,0,empty,mBC-0814-1
"G12,G5",5076,5500,3696,1804,3177,0,1735,1740,1256,484,2.595041322,897,1219,815,249,0,249,0,63,0,0.052208835,empty,mBC-0814-1
"G12,G6",741600,839323,506861,332462,486515,0,292396,292764,252541,40223,6.278522239,170149,8194,5858,1785,0,1785,0,231,0,0,mm10,mBC-0814-1
"G12,G7",6158,6660,4441,2219,3939,0,2106,2107,1453,654,2.221712538,1083,2479,1735,537,0,537,0,116,0,0,empty,mBC-0814-1
"G12,G8",8418,9091,5953,3138,5320,0,3021,3024,2180,844,2.582938389,1635,3405,2378,622,0,622,0,132,0,0.012861736,empty,mBC-0814-1
"G12,G9",750133,866948,490362,376586,506933,0,319861,320222,265943,54279,4.899555998,193960,356603,252934,70869,44,70825,3,3453,0,0.001341334,mm10,mBC-0814-1
"G12,G10",861788,976848,580699,396149,564720,0,348012,348419,280345,68074,4.118238975,203973,239635,168667,48039,29,48010,5,2693,0,0.000749844,mm10,mBC-0814-1
"G12,G11",10579,11187,7659,3528,6562,0,3427,3433,2380,1053,2.260208927,1793,1673,1248,334,0,334,0,79,0,0,empty,mBC-0814-1
"G12,G12",5447,5892,3840,2052,3512,0,1980,1980,1466,514,2.852140078,1085,2714,2006,586,1,585,1,103,0,0,empty,mBC-0814-1
"G12,H1",5044,5434,3650,1784,3170,0,1724,1724,1213,511,2.373776908,902,4357,1832,513,1,512,1,82,0,0.00390625,empty,mBC-0814-1
"G12,H2",848340,975006,573028,401978,560830,1,343126,343553,294372,49181,5.985482198,202332,330438,233528,66776,42,66734,4,3285,0,0.000734258,mm10,mBC-0814-1
"G12,H3",6622,7303,4679,2624,4207,0,2303,2306,1656,650,2.547692308,1281,1613,1092,332,0,332,0,74,0,0.036144578,empty,mBC-0814-1
"G12,H4",6324,6768,4454,2314,3883,0,2078,2080,1505,575,2.617391304,1121,93,49,25,0,25,0,12,0,0,empty,mBC-0814-1
"G12,H5",7567,8305,5363,2942,4656,0,2515,2523,1785,738,2.418699187,1378,3180,2331,597,0,597,0,96,0,0.051926298,empty,mBC-0814-1
"G12,H6",7146,7509,5135,2374,4377,0,2330,2331,1697,634,2.676656151,1242,2396,1700,500,0,500,0,112,0,0.002,empty,mBC-0814-1
"G12,H7",5976,6518,4252,2266,3874,0,2116,2118,1461,657,2.223744292,1205,1977,1303,400,1,399,1,68,0,0,empty,mBC-0814-1
"G12,H8",5160,5637,3685,1952,3248,0,1783,1783,1284,499,2.573146293,988,1363,866,330,0,330,0,90,0,0,empty,mBC-0814-1
"G12,H9",6945,7381,5035,2346,4273,0,2312,2314,1674,640,2.615625,1194,1499,1140,334,0,334,0,57,0,0.131736527,empty,mBC-0814-1
"G12,H10",4236,4495,3083,1412,2646,0,1434,1435,1043,392,2.660714286,747,1107,829,262,0,262,0,50,0,0.011450382,empty,mBC-0814-1
"G12,H11",4708,5183,3369,1814,3042,0,1680,1680,1182,498,2.373493976,949,68,59,26,0,26,0,8,0,0,empty,mBC-0814-1
"G12,H12",3323,3595,2326,1269,2123,0,1172,1172,818,354,2.310734463,628,1303,904,304,0,304,0,72,0,0,empty,mBC-0814-1
"H1,A1",6297,6882,4445,2437,4001,0,2153,2158,1559,599,2.602671119,1200,1394,999,330,1,329,1,75,0,0,empty,mBC-0814-1
"H1,A2",6316,6850,4539,2311,3997,0,2113,2115,1556,559,2.783542039,1139,1594,1086,362,0,362,0,97,0,0,empty,mBC-0814-1
"H1,A3",5093,5388,3661,1727,3140,0,1703,1706,1200,506,2.371541502,904,1194,874,257,0,257,0,61,0,0,empty,mBC-0814-1
"H1,A4",5884,6226,4309,1917,3689,0,1896,1902,1381,521,2.650671785,998,791,416,122,0,122,0,28,0,0,empty,mBC-0814-1
"H1,A5",7834,8801,5498,3303,5123,0,2907,2911,2232,679,3.28718704,1611,2139,1601,428,0,428,0,81,0,0.01635514,empty,mBC-0814-1
"H1,A6",4350,4550,3057,1493,2680,0,1466,1473,1088,385,2.825974026,779,1636,1155,356,0,356,0,74,0,0.028089888,empty,mBC-0814-1
"H1,A7",447086,528305,297022,231283,313737,0,199401,199637,166517,33120,5.027687198,121670,106891,76331,20955,10,20945,2,1705,0,0.000525185,mm10,mBC-0814-1
"H1,A8",2614,2829,1808,1021,1669,0,934,934,618,316,1.955696203,512,2035,1532,419,0,419,0,82,0,0.085918854,empty,mBC-0814-1
"H1,A9",7510,7982,5450,2532,4683,0,2522,2524,1848,676,2.733727811,1325,1347,989,312,0,312,0,66,0,0,empty,mBC-0814-1
"H1,A10",447606,528337,292830,235507,312326,8,200182,200402,168630,31772,5.307503462,122223,18425,12860,3433,0,3433,0,424,0,0,mm10,mBC-0814-1
"H1,A11",391632,450398,262537,187861,265686,1,161583,161773,135548,26225,5.168655863,96175,222124,159390,44365,28,44337,3,2520,0,0.000541309,mm10,mBC-0814-1
"H1,A12",5152,5639,3717,1922,3248,4,1776,1785,1292,493,2.620689655,939,3418,2318,675,0,675,0,176,0,0.022222222,empty,mBC-0814-1
"H1,B1",5499,5920,3850,2070,3389,0,1852,1857,1351,506,2.669960474,984,1022,731,254,0,254,0,66,0,0,empty,mBC-0814-1
"H1,B2",4982,5229,3502,1727,3030,0,1664,1664,1175,489,2.402862986,860,800,307,103,0,103,0,30,0,0.077669903,empty,mBC-0814-1
"H1,B3",6298,7243,4371,2872,4302,0,2519,2528,1827,701,2.606276748,1477,1832,939,296,0,296,0,57,0,0.067567568,empty,mBC-0814-1
"H1,B4",4822,5294,3408,1886,3180,0,1770,1770,1299,471,2.757961783,986,6489,2341,756,0,756,0,102,0,0.009259259,empty,mBC-0814-1
"H1,B5",4933,3891,2227,1664,2618,0,1562,1569,1185,384,3.0859375,968,1083,733,230,0,230,0,72,0,0,empty,mBC-0814-1
"H1,B6",4790,5104,3443,1661,3042,0,1669,1669,1178,491,2.399185336,923,1299,938,259,0,259,0,57,0,0.023166023,empty,mBC-0814-1
"H1,B7",5222,5658,3735,1923,3302,0,1775,1777,1281,496,2.58266129,968,1043,716,210,0,210,0,52,0,0,empty,mBC-0814-1
"H1,B8",4146,4433,2998,1435,2620,0,1413,1413,993,420,2.364285714,738,1020,691,235,0,235,0,49,0,0,empty,mBC-0814-1
"H1,B9",5602,6130,4011,2119,3546,0,1967,1970,1417,553,2.56238698,1058,593,323,167,0,167,0,65,0,0,empty,mBC-0814-1
"H1,B10",5197,5570,3658,1912,3304,0,1808,1810,1251,559,2.237924866,981,519,259,85,0,85,0,22,0,0.011764706,empty,mBC-0814-1
"H1,B11",7720,8201,5558,2643,4718,0,2474,2478,1742,736,2.366847826,1314,313,177,71,0,71,0,17,0,0,empty,mBC-0814-1
"H1,B12",5832,6321,4067,2254,3656,1,2009,2012,1370,642,2.133956386,1109,1300,769,212,1,211,1,51,0,0,empty,mBC-0814-1
"H1,C1",6019,6439,4347,2092,3829,0,2022,2024,1438,586,2.453924915,1075,849,526,149,0,149,0,37,0,0,empty,mBC-0814-1
"H1,C2",5683,6168,3968,2200,3481,0,1902,1905,1308,597,2.190954774,1025,1636,1181,391,0,391,0,103,0,0.035805627,empty,mBC-0814-1
"H1,C3",6500,6752,4646,2106,3908,0,2067,2071,1475,596,2.474832215,1079,418,280,96,0,96,0,28,0,0,empty,mBC-0814-1
"H1,C4",5883,6367,4308,2059,3745,0,1974,1977,1459,518,2.816602317,1045,1384,873,296,0,296,0,81,0,0.057432432,empty,mBC-0814-1
"H1,C5",8694,9263,5996,3267,5545,0,3100,3104,2303,801,2.875156055,1735,1480,1082,410,0,410,0,84,0,0,empty,mBC-0814-1
"H1,C6",7352,7931,5133,2798,4771,0,2612,2616,1870,746,2.506702413,1450,868,589,190,0,190,0,64,0,0.005263158,empty,mBC-0814-1
"H1,C7",7779,8412,5505,2907,4880,0,2634,2640,1849,791,2.337547408,1419,2120,934,245,0,245,0,36,0,0.032653061,empty,mBC-0814-1
"H1,C8",6197,6608,4451,2157,3811,0,1987,1994,1397,597,2.340033501,1049,1910,1446,470,0,470,0,89,0,0.061702128,empty,mBC-0814-1
"H1,C9",5368,5905,3889,2016,3416,0,1857,1860,1384,476,2.907563025,985,1316,958,263,0,263,0,65,0,0,empty,mBC-0814-1
"H1,C10",6344,6600,4693,1907,3859,0,1994,1996,1438,558,2.577060932,993,1809,1213,355,0,355,0,61,0,0.050704225,empty,mBC-0814-1
"H1,C11",4991,5624,3552,2072,3258,0,1828,1834,1338,496,2.697580645,1041,1325,980,280,0,280,0,56,0,0,empty,mBC-0814-1
"H1,C12",9047,9870,6435,3435,5669,1,3102,3112,2157,955,2.258638743,1679,2392,1604,467,0,467,0,90,0,0,empty,mBC-0814-1
"H1,D1",5137,5640,3652,1988,3355,0,1815,1818,1323,495,2.672727273,992,495,223,70,0,70,0,22,0,0,empty,mBC-0814-1
"H1,D2",5173,5499,3773,1726,3164,0,1612,1614,1173,441,2.659863946,850,1281,879,272,0,272,0,89,0,0,empty,mBC-0814-1
"H1,D3",1237437,1473062,793293,679769,856671,1,577229,577792,446496,131296,3.400682427,356739,128093,92277,25974,13,25961,3,1943,0,0.000847425,mm10,mBC-0814-1
"H1,D4",5340,5823,3778,2045,3401,0,1904,1908,1352,556,2.431654676,1058,1397,892,287,0,287,0,63,0,0,empty,mBC-0814-1
"H1,D5",5704,6265,4045,2220,3670,0,2042,2047,1440,607,2.3723229,1123,2139,1539,494,0,494,0,106,0,0,empty,mBC-0814-1
"H1,D6",5208,5625,3765,1860,3277,0,1723,1729,1190,539,2.207792208,900,5226,2393,686,1,685,1,98,0,0.033576642,empty,mBC-0814-1
"H1,D7",7191,7774,5145,2629,4512,0,2422,2428,1785,643,2.776049767,1314,2815,1715,537,0,537,0,109,0,0.00744879,empty,mBC-0814-1
"H1,D8",389467,460026,263643,196383,269600,0,167560,167753,133170,34583,3.850735911,100186,89087,64042,17387,6,17381,2,1359,0,0,mm10,mBC-0814-1
"H1,D9",512045,620630,330393,290237,366222,1,243759,243961,182788,61173,2.988050284,152422,152783,107712,30700,21,30679,2,1938,0,0.000586721,mm10,mBC-0814-1
"H1,D10",581676,687199,389899,297300,402554,1,256011,256308,200007,56301,3.552459104,154845,124764,83947,25386,14,25372,3,1654,0,0.001615955,mm10,mBC-0814-1
"H1,D11",4706,5129,3272,1857,3012,0,1642,1646,1182,464,2.547413793,937,2802,2008,570,2,568,1,132,0,0,empty,mBC-0814-1
"H1,D12",7083,7969,5048,2921,4604,0,2565,2568,1797,771,2.3307393,1390,7452,3257,1021,3,1018,1,144,0,0.014734774,empty,mBC-0814-1
"H1,E1",5991,6449,4328,2121,3798,0,2077,2079,1482,597,2.48241206,1122,1280,924,272,0,272,0,63,0,0,empty,mBC-0814-1
"H1,E2",577600,650820,397156,253664,382117,0,231213,231475,172840,58635,2.947727467,134617,22073,15267,4195,1,4194,1,524,0,0.000238436,mm10,mBC-0814-1
"H1,E3",3727,3958,2750,1208,2387,0,1270,1270,916,354,2.587570621,633,1109,726,255,0,255,0,64,0,0,empty,mBC-0814-1
"H1,E4",3277,3561,2387,1174,2057,0,1108,1110,766,344,2.226744186,611,921,641,195,0,195,0,51,0,0,empty,mBC-0814-1
"H1,E5",4026,4275,2976,1299,2466,0,1273,1275,900,375,2.4,659,1120,611,198,0,198,0,37,0,0,empty,mBC-0814-1
"H1,E6",1120794,1260430,769600,490830,727697,1,444025,444573,351646,92927,3.784110108,257627,115377,75958,21235,19,21216,4,1706,0,0.004524887,mm10,mBC-0814-1
"H1,E7",5222,5709,3747,1962,3330,3,1777,1780,1259,521,2.416506718,976,1497,980,319,0,319,0,63,0,0.028213166,empty,mBC-0814-1
"H1,E8",4940,5074,3629,1445,3019,0,1540,1540,1123,417,2.693045564,772,1441,973,284,1,283,1,65,0,0.074204947,empty,mBC-0814-1
"H1,E9",3993,4311,2875,1436,2476,0,1316,1318,949,369,2.571815718,707,2106,1599,519,0,519,0,80,0,0.013487476,empty,mBC-0814-1
"H1,E10",4364,4680,3118,1562,2778,0,1507,1507,1020,487,2.094455852,786,1027,722,228,0,228,0,72,0,0.048245614,empty,mBC-0814-1
"H1,E11",4924,5365,3583,1782,3146,0,1685,1687,1198,489,2.449897751,893,1481,961,294,0,294,0,79,0,0,empty,mBC-0814-1
"H1,E12",5729,6204,4074,2130,3707,0,2081,2081,1494,587,2.545144804,1122,1015,640,182,0,182,0,45,0,0,empty,mBC-0814-1
"H1,F1",5012,5430,3625,1805,3208,0,1729,1730,1232,498,2.473895582,906,925,630,194,0,194,0,66,0,0,empty,mBC-0814-1
"H1,F2",6866,7157,4954,2203,4195,0,2216,2216,1638,578,2.833910035,1096,1918,1313,414,0,414,0,105,0,0,empty,mBC-0814-1
"H1,F3",1361962,1583211,918809,664402,913080,2,579719,580374,424709,155665,2.728352552,348880,347609,229581,66005,54,65951,8,3275,0,0.001349487,mm10,mBC-0814-1
"H1,F4",6288,6300,4368,1932,3780,0,1962,1967,1428,539,2.649350649,997,574,402,127,0,127,0,24,0,0,empty,mBC-0814-1
"H1,F5",5374,5795,3889,1906,3336,0,1805,1805,1309,496,2.639112903,934,1073,828,246,0,246,0,65,0,0.008130081,empty,mBC-0814-1
"H1,F6",6121,6674,4307,2367,3884,0,2147,2150,1521,629,2.418124006,1179,2021,1326,407,0,407,0,91,0,0.049140049,empty,mBC-0814-1
"H1,F7",765710,889535,515561,373974,519755,0,323961,324328,276262,48066,5.747555445,192894,69898,49785,14685,8,14677,2,1231,0,0.000545071,mm10,mBC-0814-1
"H1,F8",6843,7319,4979,2340,4142,0,2170,2177,1593,584,2.727739726,1078,186,117,37,0,37,0,13,0,0,empty,mBC-0814-1
"H1,F9",6085,6570,4444,2126,3804,2,1996,2000,1470,530,2.773584906,1057,1500,1023,287,0,287,0,71,0,0.003484321,empty,mBC-0814-1
"H1,F10",501505,581392,340515,240877,340265,2,211454,211678,172020,39658,4.337586363,124896,52847,33209,9297,6,9291,1,908,0,0.000645786,mm10,mBC-0814-1
"H1,F11",4605,5036,3337,1699,2938,0,1571,1576,1107,469,2.360341151,837,1967,792,274,0,274,0,74,0,0.010948905,empty,mBC-0814-1
"H1,F12",656545,732818,444265,288553,423933,1,260439,260754,211598,49156,4.30462202,151425,1012,716,227,0,227,0,45,0,0,empty,mBC-0814-1
"H1,G1",566715,658531,367343,291188,388983,2,255705,255994,179873,76121,2.362987875,156177,19986,13613,3477,4,3473,2,501,0,0.007486323,mm10,mBC-0814-1
"H1,G2",8499,8486,5215,3271,4456,0,2555,2560,1796,764,2.35078534,1388,11179,3691,1198,1,1197,1,127,0,0.175438596,empty,mBC-0814-1
"H1,G3",5613,6202,4075,2127,3597,0,1962,1965,1402,563,2.490230906,1037,2575,1848,541,0,541,0,109,0,0.03142329,empty,mBC-0814-1
"H1,G4",5680,6007,4038,1969,3368,0,1790,1792,1284,508,2.527559055,888,14,11,4,0,4,0,1,0,0,empty,mBC-0814-1
"H1,G5",261839,295462,177410,118052,170732,0,105791,105880,76488,29392,2.602340773,61393,4740,2890,701,0,701,0,140,0,0.001426534,empty,mBC-0814-1
"H1,G6",9910,10456,7255,3201,6143,0,3238,3240,2307,933,2.47266881,1687,218,160,48,0,48,0,15,0,0,empty,mBC-0814-1
"H1,G7",6256,6755,4594,2161,3967,11,2076,2087,1512,575,2.629565217,1100,2010,1422,440,0,440,0,90,0,0,empty,mBC-0814-1
"H1,G8",8614,9611,6022,3589,5550,0,3090,3094,2156,938,2.298507463,1726,9296,3930,1213,1,1212,1,181,0,0.04620462,empty,mBC-0814-1
"H1,G9",501687,587608,333863,253745,346502,0,218233,218490,179623,38867,4.621478375,132091,155056,109668,31074,14,31060,2,2107,0,0,mm10,mBC-0814-1
"H1,G10",10124,10740,7332,3408,6333,0,3415,3424,2449,975,2.511794872,1814,2548,1819,514,0,514,0,137,0,0,empty,mBC-0814-1
"H1,G11",10529,11374,7693,3681,6608,0,3533,3539,2500,1039,2.406159769,1843,1260,877,264,0,264,0,74,0,0,empty,mBC-0814-1
"H1,G12",5399,5784,3844,1940,3543,1,1952,1956,1440,516,2.790697674,1073,1855,1298,329,0,329,0,83,0,0,empty,mBC-0814-1
"H1,H1",495116,584810,324448,260362,344119,2,220571,220811,171866,48945,3.511410767,136249,184887,113318,30176,19,30157,5,2503,0,0.000198959,mm10,mBC-0814-1
"H1,H2",652002,781868,431277,350591,456475,0,292379,292682,237390,55292,4.293387832,179554,282691,205969,57976,31,57945,6,2950,0,3.45155E-05,mm10,mBC-0814-1
"H1,H3",6327,6758,4511,2247,3900,0,2138,2142,1590,552,2.880434783,1140,1328,919,252,0,252,0,84,0,0,empty,mBC-0814-1
"H1,H4",5977,6496,4222,2274,3902,0,2123,2129,1491,638,2.336990596,1200,307,210,79,0,79,0,18,0,0,empty,mBC-0814-1
"H1,H5",6751,7328,4914,2414,4236,4,2308,2313,1660,653,2.542113323,1206,1427,1003,300,1,299,1,63,0,0,empty,mBC-0814-1
"H1,H6",7611,8193,5426,2767,4723,0,2601,2604,1879,725,2.591724138,1393,2059,1394,430,0,430,0,102,0,0.027906977,empty,mBC-0814-1
"H1,H7",6069,6489,4403,2086,3896,0,2094,2094,1507,587,2.567291312,1150,1569,1167,325,0,325,0,60,0,0,empty,mBC-0814-1
"H1,H8",5232,5698,3670,2028,3268,0,1832,1839,1311,528,2.482954545,987,2015,1453,450,0,450,0,102,0,0.006666667,empty,mBC-0814-1
"H1,H9",6418,7018,4594,2424,4147,0,2272,2274,1640,634,2.586750789,1219,1212,867,256,0,256,0,53,0,0,empty,mBC-0814-1
"H1,H10",542066,617183,362592,254591,357763,0,218574,218834,180833,38001,4.758637931,128991,145067,103014,28373,13,28360,2,1871,0,0.000211566,mm10,mBC-0814-1
"H1,H11",4624,5169,3243,1926,3063,0,1696,1700,1170,530,2.20754717,992,217,120,41,0,41,0,10,0,0,empty,mBC-0814-1
"H1,H12",449982,529686,299390,230296,312938,0,197603,197790,156292,41498,3.766253795,120231,178824,129506,35780,25,35755,4,2159,0,0.000251713,mm10,mBC-0814-1
"H2,A1",4857,5257,3516,1741,3088,0,1666,1668,1230,438,2.808219178,889,1566,1137,295,0,295,0,52,0,0,empty,mBC-0814-1
"H2,A2",4594,4972,3329,1643,2973,0,1619,1619,1222,397,3.078085642,877,1176,821,260,0,260,0,74,0,0,empty,mBC-0814-1
"H2,A3",4028,4309,2888,1421,2532,0,1365,1365,958,407,2.353808354,736,1026,704,194,0,194,0,46,0,0,empty,mBC-0814-1
"H2,A4",666198,770952,454239,316713,451507,1,277633,277997,221629,56368,3.93182302,163383,53809,38990,10681,9,10672,1,953,0,0,mm10,mBC-0814-1
"H2,A5",4227,4408,3087,1321,2606,0,1327,1333,965,368,2.622282609,677,1174,895,230,0,230,0,52,0,0.02173913,empty,mBC-0814-1
"H2,A6",3281,3484,2368,1116,2038,0,1153,1153,812,341,2.381231672,599,1732,1211,359,0,359,0,59,0,0.036211699,empty,mBC-0814-1
"H2,A7",454610,518438,305335,213103,312380,0,194581,194828,145251,49577,2.92980616,116475,2933,1894,464,0,464,0,108,0,0.0625,empty,mBC-0814-1
"H2,A8",1812,1935,1269,666,1174,0,666,666,474,192,2.46875,376,1084,763,237,1,236,1,59,0,0,empty,mBC-0814-1
"H2,A9",5716,6143,4095,2048,3594,0,1894,1901,1439,462,3.114718615,1025,1673,1114,318,0,318,0,60,0,0,empty,mBC-0814-1
"H2,A10",3070,3387,2130,1257,2011,0,1114,1117,760,357,2.128851541,644,309,253,59,0,59,0,10,0,0,empty,mBC-0814-1
"H2,A11",4275,4626,3103,1523,2745,0,1487,1489,1048,441,2.376417234,764,3180,2301,678,0,678,0,105,0,0.001474926,empty,mBC-0814-1
"H2,A12",3327,3621,2347,1274,2158,0,1206,1209,908,301,3.016611296,641,2565,1715,490,1,489,1,136,0,0,empty,mBC-0814-1
"H2,B1",4216,4527,2986,1541,2647,0,1440,1440,1029,411,2.503649635,745,27916,8112,2455,4,2451,1,272,0,0.044879641,empty,mBC-0814-1
"H2,B2",4216,4719,2955,1764,2691,0,1479,1482,1023,459,2.22875817,804,228,134,69,0,69,0,24,0,0,empty,mBC-0814-1
"H2,B3",272370,319351,177590,141761,195763,0,128438,128571,101938,26633,3.827507228,78296,17481,12450,3245,2,3243,1,426,0,0.002466852,mm10,mBC-0814-1
"H2,B4",3502,3824,2402,1422,2265,0,1263,1265,901,364,2.475274725,732,3245,1431,497,1,496,1,76,0,0.016129032,empty,mBC-0814-1
"H2,B5",3008,2059,1266,793,1471,0,835,836,578,258,2.240310078,494,970,602,179,0,179,0,35,0,0.044692737,empty,mBC-0814-1
"H2,B6",348662,402685,232491,170194,241432,1,149640,149828,123413,26415,4.672080257,89384,128157,90153,26245,17,26228,2,1792,0,0.000152509,mm10,mBC-0814-1
"H2,B7",4814,5113,3524,1589,2931,0,1519,1520,1094,426,2.568075117,781,1369,1056,308,0,308,0,49,0,0,empty,mBC-0814-1
"H2,B8",3317,3674,2383,1291,2138,1,1136,1137,806,331,2.435045317,638,1579,1211,361,0,361,0,57,0,0.016620499,empty,mBC-0814-1
"H2,B9",4003,4296,2853,1443,2629,0,1431,1433,1020,413,2.469733656,787,808,548,176,0,176,0,53,0,0,empty,mBC-0814-1
"H2,B10",3869,4064,2597,1467,2497,0,1410,1412,949,463,2.049676026,786,11410,3578,1108,0,1108,0,118,0,0.005415162,empty,mBC-0814-1
"H2,B11",6554,7061,4627,2434,4145,0,2237,2242,1639,603,2.718076285,1181,268,220,63,0,63,0,14,0,0,empty,mBC-0814-1
"H2,B12",4532,4760,3241,1519,2842,0,1535,1536,1121,415,2.701204819,769,881,490,184,0,184,0,46,0,0.016304348,empty,mBC-0814-1
"H2,C1",4794,5163,3431,1732,3076,0,1666,1678,1162,516,2.251937984,878,635,422,130,1,129,1,30,0,0,empty,mBC-0814-1
"H2,C2",4360,4848,3136,1712,2782,0,1554,1554,1138,416,2.735576923,843,1472,987,291,0,291,0,71,0,0,empty,mBC-0814-1
"H2,C3",6791,7316,4893,2423,4414,4,2373,2382,1807,575,3.142608696,1268,265,193,43,0,43,0,17,0,0,empty,mBC-0814-1
"H2,C4",529459,596076,355420,240656,354406,0,213277,213515,186916,26599,7.027181473,124638,217669,157520,42722,18,42704,1,2410,0,0,mm10,mBC-0814-1
"H2,C5",6231,6810,4392,2418,4013,0,2209,2214,1626,588,2.765306122,1248,1431,1094,325,0,325,0,66,0,0,empty,mBC-0814-1
"H2,C6",4889,5200,3468,1732,3144,0,1714,1720,1201,519,2.314065511,941,1270,885,293,0,293,0,64,0,0.023890785,empty,mBC-0814-1
"H2,C7",590950,706335,382467,323868,417411,1,274809,275112,227899,47213,4.827039163,168630,38770,27533,7476,6,7470,1,738,0,0.001606426,mm10,mBC-0814-1
"H2,C8",4671,4922,3322,1600,2901,0,1523,1525,1034,491,2.105906314,811,1646,1079,285,0,285,0,57,0,0.021052632,empty,mBC-0814-1
"H2,C9",3887,4128,2859,1269,2544,0,1371,1373,949,424,2.238207547,735,875,629,178,0,178,0,49,0,0,empty,mBC-0814-1
"H2,C10",5003,5186,3632,1554,3095,0,1623,1627,1206,421,2.864608076,838,856,554,148,0,148,0,28,0,0,empty,mBC-0814-1
"H2,C11",4220,4509,2947,1562,2609,0,1422,1422,974,448,2.174107143,786,667,462,147,0,147,0,35,0,0,empty,mBC-0814-1
"H2,C12",344705,396959,230033,166926,237225,4,148265,148392,116920,31472,3.715048297,89182,27569,16659,4212,1,4211,1,549,0,0.01448587,mm10,mBC-0814-1
"H2,D1",3880,4083,2748,1335,2442,0,1349,1349,990,359,2.757660167,711,408,236,66,0,66,0,18,0,0,empty,mBC-0814-1
"H2,D2",4521,4889,3234,1655,2843,0,1501,1506,1099,407,2.7002457,801,1448,1051,281,3,278,1,75,0,0.003597122,empty,mBC-0814-1
"H2,D3",332921,391348,219285,172063,233611,2,148072,148246,115197,33049,3.485642531,89996,76991,51378,13890,10,13880,1,1271,0,0.001008646,mm10,mBC-0814-1
"H2,D4",3828,4004,2749,1255,2439,0,1317,1319,884,435,2.032183908,720,2075,1568,457,1,456,1,66,0,0.002192982,empty,mBC-0814-1
"H2,D5",3621,3757,2650,1107,2245,0,1206,1207,859,348,2.468390805,590,1898,1378,418,0,418,0,88,0,0,empty,mBC-0814-1
"H2,D6",4254,4481,3085,1396,2710,0,1521,1523,1081,442,2.445701357,766,955,658,173,0,173,0,49,0,0,empty,mBC-0814-1
"H2,D7",570010,641980,385566,256414,378410,1,229856,230137,175029,55108,3.176108732,133893,133519,97612,27315,19,27296,1,1748,0,0.000366354,mm10,mBC-0814-1
"H2,D8",4222,4508,2981,1527,2631,0,1436,1437,999,438,2.280821918,759,903,641,198,0,198,0,36,0,0.080808081,empty,mBC-0814-1
"H2,D9",2656,2867,1914,953,1671,0,867,869,611,258,2.368217054,479,1258,901,233,0,233,0,43,0,0.034334764,empty,mBC-0814-1
"H2,D10",3558,3838,2469,1369,2400,0,1362,1367,1013,354,2.861581921,759,506,356,100,0,100,0,23,0,0,empty,mBC-0814-1
"H2,D11",3587,3851,2508,1343,2269,0,1222,1228,851,377,2.25729443,677,1865,1394,365,0,365,0,88,0,0.079452055,empty,mBC-0814-1
"H2,D12",5634,5922,4028,1894,3505,1,1878,1882,1322,560,2.360714286,951,3358,2335,618,0,618,0,101,0,0,empty,mBC-0814-1
"H2,E1",4404,4709,3173,1536,2802,0,1492,1492,1090,402,2.711442786,787,1110,675,237,0,237,0,70,0,0.004219409,empty,mBC-0814-1
"H2,E2",2989,3172,2152,1020,1944,0,1065,1065,758,307,2.469055375,572,6668,2499,722,3,719,2,90,0,0.052851182,empty,mBC-0814-1
"H2,E3",466279,527922,314842,213080,314988,1,195126,195351,151639,43712,3.469047401,114302,61759,43845,12192,4,12188,1,1130,0,0,mm10,mBC-0814-1
"H2,E4",2811,2891,2028,863,1702,0,883,884,633,251,2.521912351,452,993,670,246,0,246,0,55,0,0.004065041,empty,mBC-0814-1
"H2,E5",3328,3736,2382,1354,2245,0,1225,1225,863,362,2.383977901,701,1059,707,213,0,213,0,28,0,0.084507042,empty,mBC-0814-1
"H2,E6",4034,4225,2873,1352,2411,0,1296,1298,953,345,2.762318841,629,1493,1084,324,0,324,0,51,0,0,empty,mBC-0814-1
"H2,E7",3892,4309,2806,1503,2497,0,1284,1285,930,355,2.61971831,722,1458,1099,285,0,285,0,57,0,0,empty,mBC-0814-1
"H2,E8",4131,4214,2982,1232,2519,0,1303,1307,941,366,2.571038251,645,1817,1360,391,0,391,0,72,0,0,empty,mBC-0814-1
"H2,E9",2628,3034,1857,1177,1789,0,1043,1047,742,305,2.432786885,596,9500,3096,917,2,915,2,86,0,0.101639344,empty,mBC-0814-1
"H2,E10",3645,3869,2680,1189,2249,0,1198,1200,829,371,2.234501348,579,1439,1041,315,0,315,0,81,0,0,empty,mBC-0814-1
"H2,E11",3704,4045,2616,1429,2448,0,1343,1344,978,366,2.672131148,726,1879,1287,314,0,314,0,54,0,0.022292994,empty,mBC-0814-1
"H2,E12",3383,3634,2426,1208,2170,0,1205,1205,868,337,2.575667656,611,548,401,127,0,127,0,42,0,0,empty,mBC-0814-1
"H2,F1",3937,4357,2803,1554,2556,0,1388,1390,940,450,2.088888889,770,1486,1034,319,1,318,1,60,0,0.003144654,empty,mBC-0814-1
"H2,F2",744241,854532,500480,354052,500865,2,308893,309250,267501,41749,6.407363051,182737,507057,288892,83064,78,82986,11,3794,0,0.003470465,mm10,mBC-0814-1
"H2,F3",4466,4855,3121,1734,2969,0,1650,1650,1232,418,2.947368421,896,1579,1030,325,0,325,0,68,0,0.043076923,empty,mBC-0814-1
"H2,F4",5020,5348,3543,1805,3195,0,1731,1738,1280,458,2.794759825,885,727,507,156,0,156,0,30,0,0,empty,mBC-0814-1
"H2,F5",4374,4579,3099,1480,2717,0,1438,1440,1046,394,2.654822335,782,1644,686,207,0,207,0,48,0,0,empty,mBC-0814-1
"H2,F6",4486,4788,3159,1629,2877,0,1592,1595,1184,411,2.880778589,856,1392,933,336,1,335,1,73,0,0,empty,mBC-0814-1
"H2,F7",3883,4229,2729,1500,2578,0,1402,1407,991,416,2.382211538,744,891,660,195,1,194,1,35,0,0,empty,mBC-0814-1
"H2,F8",5335,5787,3824,1963,3444,2,1879,1882,1378,504,2.734126984,1025,87,59,10,0,10,0,5,0,0,empty,mBC-0814-1
"H2,F9",4774,4983,3334,1649,2934,0,1565,1565,1144,421,2.717339667,804,1593,1020,331,0,331,0,76,0,0.003021148,empty,mBC-0814-1
"H2,F10",5858,6306,4265,2041,3642,0,1890,1894,1326,568,2.334507042,1020,1287,960,248,0,248,0,51,0,0.032258065,empty,mBC-0814-1
"H2,F11",3867,4226,2815,1411,2457,0,1293,1295,911,384,2.372395833,702,1587,1232,339,0,339,0,56,0,0,empty,mBC-0814-1
"H2,F12",4059,4327,2844,1483,2637,0,1419,1421,963,458,2.102620087,783,70,57,29,0,29,0,8,0,0,empty,mBC-0814-1
"H2,G1",6217,6361,4444,1917,3866,0,2029,2032,1451,581,2.497418244,1038,2641,1852,573,1,572,1,117,0,0,empty,mBC-0814-1
"H2,G2",5050,5355,3606,1749,3139,0,1693,1698,1185,513,2.30994152,880,414,321,94,0,94,0,21,0,0,empty,mBC-0814-1
"H2,G3",4263,4591,3047,1544,2725,0,1540,1542,1102,440,2.504545455,809,1820,1295,373,0,373,0,79,0,0,empty,mBC-0814-1
"H2,G4",4521,4805,3205,1600,2851,6,1529,1539,1075,464,2.316810345,864,1,1,1,0,1,0,1,0,0,empty,mBC-0814-1
"H2,G5",4244,4669,3005,1664,2763,0,1551,1555,1095,460,2.380434783,879,1500,1046,310,0,310,0,52,0,0,empty,mBC-0814-1
"H2,G6",7350,7856,5325,2531,4591,0,2428,2430,1741,689,2.526850508,1224,133,91,48,1,47,1,16,0,0,empty,mBC-0814-1
"H2,G7",4731,5137,3392,1745,3044,0,1679,1679,1196,483,2.476190476,887,2071,1534,436,1,435,1,76,0,0.027586207,empty,mBC-0814-1
"H2,G8",6018,6542,4266,2276,3933,0,2180,2182,1574,608,2.588815789,1190,7517,2932,924,0,924,0,144,0,0.064935065,empty,mBC-0814-1
"H2,G9",353157,413183,230637,182546,249777,0,161527,161678,124467,37211,3.344898014,98595,164052,113550,31766,13,31753,2,2065,0,0.000692848,mm10,mBC-0814-1
"H2,G10",7765,8287,5565,2722,4892,2,2564,2572,1751,821,2.132764921,1340,3224,2278,643,0,643,0,122,0,0,empty,mBC-0814-1
"H2,G11",7786,8027,5671,2356,4779,0,2551,2562,1805,757,2.384412153,1287,1486,1090,360,0,360,0,75,0,0,empty,mBC-0814-1
"H2,G12",3910,4245,2762,1483,2503,0,1360,1362,966,396,2.439393939,714,1447,1039,328,0,328,0,63,0,0,empty,mBC-0814-1
"H2,H1",3929,4182,2822,1360,2563,0,1396,1397,1031,366,2.816939891,749,727,544,166,0,166,0,31,0,0,empty,mBC-0814-1
"H2,H2",6776,7019,4815,2204,4179,0,2219,2224,1607,617,2.604538088,1156,2648,1827,560,0,560,0,113,0,0.010714286,empty,mBC-0814-1
"H2,H3",417370,485134,278965,206169,290169,0,182538,182742,138935,43807,3.171525099,109868,73231,51571,14811,8,14803,1,1245,0,0.001080862,mm10,mBC-0814-1
"H2,H4",4754,5056,3370,1686,3101,5,1716,1722,1253,469,2.671641791,889,11,7,3,0,3,0,2,0,0,empty,mBC-0814-1
"H2,H5",5766,6314,4121,2193,3648,0,1981,1982,1419,563,2.520426288,1071,2986,1632,479,0,479,0,68,0,0,empty,mBC-0814-1
"H2,H6",5656,6066,4011,2055,3562,0,1936,1936,1466,470,3.119148936,995,2704,1504,507,0,507,0,94,0,0.08086785,empty,mBC-0814-1
"H2,H7",4571,4794,3250,1544,2793,0,1466,1466,1083,383,2.82767624,740,1842,1350,395,0,395,0,67,0,0,empty,mBC-0814-1
"H2,H8",3884,4166,2696,1470,2463,0,1333,1336,982,354,2.774011299,752,1985,1451,509,1,508,1,88,0,0.011811024,empty,mBC-0814-1
"H2,H9",4260,4500,3084,1416,2600,2,1398,1405,995,410,2.426829268,728,1006,704,223,0,223,0,37,0,0,empty,mBC-0814-1
"H2,H10",3169,3253,2228,1025,1861,0,997,1002,737,265,2.781132075,510,931,667,234,0,234,0,33,0,0,empty,mBC-0814-1
"H2,H11",3269,3450,2317,1133,2091,0,1139,1139,815,324,2.515432099,581,47,28,13,0,13,0,5,0,0,empty,mBC-0814-1
"H2,H12",2371,2513,1670,843,1533,0,864,866,589,277,2.126353791,475,1113,627,206,0,206,0,47,0,0,empty,mBC-0814-1
"H3,A1",5039,5432,3712,1720,3172,2,1683,1690,1162,528,2.200757576,858,1334,834,269,0,269,0,61,0,0,empty,mBC-0814-1
"H3,A2",4140,4444,2985,1459,2572,0,1355,1357,986,371,2.657681941,690,1653,1173,403,0,403,0,84,0,0,empty,mBC-0814-1
"H3,A3",4311,4707,3026,1681,2813,0,1555,1558,1066,492,2.166666667,864,1291,818,193,1,192,1,42,0,0,empty,mBC-0814-1
"H3,A4",5102,5398,3643,1755,3067,0,1610,1612,1140,472,2.415254237,824,363,225,75,0,75,0,15,0,0,empty,mBC-0814-1
"H3,A5",4271,4655,3022,1633,2700,0,1453,1453,1005,448,2.243303571,769,1556,1124,367,0,367,0,60,0,0,empty,mBC-0814-1
"H3,A6",3243,3430,2287,1143,2082,0,1173,1177,812,365,2.224657534,635,1721,1332,327,2,325,1,59,0,0,empty,mBC-0814-1
"H3,A7",4823,5199,3417,1782,3018,0,1640,1642,1193,449,2.65701559,884,3332,1439,478,0,478,0,77,0,0.054393305,empty,mBC-0814-1
"H3,A8",1849,1908,1293,615,1150,0,649,649,452,197,2.294416244,328,1228,803,249,0,249,0,61,0,0,empty,mBC-0814-1
"H3,A9",5660,6043,4214,1829,3522,0,1911,1912,1301,611,2.129296236,999,1492,1030,309,0,309,0,64,0,0,empty,mBC-0814-1
"H3,A10",2867,3193,2019,1174,1814,0,1002,1004,705,299,2.357859532,554,123,71,23,0,23,0,8,0,0,empty,mBC-0814-1
"H3,A11",3904,4034,2781,1253,2401,2,1256,1258,904,354,2.553672316,674,1825,1393,447,0,447,0,75,0,0.017897092,empty,mBC-0814-1
"H3,A12",3124,3242,2246,996,1895,0,991,993,740,253,2.924901186,500,2668,1879,563,0,563,0,130,0,0.014209591,empty,mBC-0814-1
"H3,B1",4048,4427,2904,1523,2565,0,1400,1400,1000,400,2.5,750,1205,837,229,0,229,0,62,0,0,empty,mBC-0814-1
"H3,B2",4476,4816,3190,1626,2863,0,1508,1515,1030,485,2.12371134,801,259,147,60,0,60,0,21,0,0,empty,mBC-0814-1
"H3,B3",3964,4331,2781,1550,2517,0,1414,1414,1046,368,2.842391304,787,970,669,198,0,198,0,33,0,0,empty,mBC-0814-1
"H3,B4",899978,1029368,604898,424470,606867,0,379229,379594,300578,79016,3.804014377,225018,201771,146604,42120,26,42094,3,2435,0,0.000593909,mm10,mBC-0814-1
"H3,B5",3322,2235,1408,827,1555,1,855,866,619,247,2.506072874,514,960,614,185,0,185,0,45,0,0,empty,mBC-0814-1
"H3,B6",3398,3600,2461,1139,2115,0,1137,1142,816,326,2.503067485,589,927,661,205,0,205,0,44,0,0.043902439,empty,mBC-0814-1
"H3,B7",4560,4905,3304,1601,2850,0,1513,1515,1060,455,2.32967033,795,1298,852,207,0,207,0,41,0,0.043478261,empty,mBC-0814-1
"H3,B8",3431,3693,2472,1221,2182,0,1201,1201,846,355,2.383098592,649,541,347,115,0,115,0,43,0,0,empty,mBC-0814-1
"H3,B9",4052,4420,2822,1598,2596,0,1459,1462,1042,420,2.480952381,817,680,513,122,0,122,0,41,0,0,empty,mBC-0814-1
"H3,B10",3557,3728,2501,1227,2295,1,1240,1243,869,374,2.323529412,659,293,213,65,0,65,0,17,0,0,empty,mBC-0814-1
"H3,B11",6496,7275,4556,2719,4306,6,2413,2422,1742,680,2.561764706,1342,148,73,20,0,20,0,11,0,0,empty,mBC-0814-1
"H3,B12",4703,5192,3407,1785,3049,0,1659,1661,1170,491,2.382892057,926,858,636,188,0,188,0,47,0,0,empty,mBC-0814-1
"H3,C1",4919,5195,3589,1606,2976,0,1595,1595,1171,424,2.761792453,815,602,449,148,0,148,0,32,0,0,empty,mBC-0814-1
"H3,C2",4546,4823,3220,1603,2870,0,1513,1519,1063,456,2.331140351,813,5151,2093,599,0,599,0,108,0,0.015025042,empty,mBC-0814-1
"H3,C3",6808,7584,4758,2826,4468,0,2534,2536,1866,670,2.785074627,1415,171,83,34,0,34,0,14,0,0.088235294,empty,mBC-0814-1
"H3,C4",4226,4460,3029,1431,2609,0,1357,1357,1024,333,3.075075075,699,1031,775,260,0,260,0,59,0,0.026923077,empty,mBC-0814-1
"H3,C5",592918,671700,389931,281769,394585,0,245901,246155,193229,52926,3.65092771,146355,158996,110669,32230,23,32207,3,2181,0,0.00403639,mm10,mBC-0814-1
"H3,C6",4537,4623,3202,1421,2871,0,1537,1541,1079,462,2.335497835,795,963,601,232,0,232,0,58,0,0.017241379,empty,mBC-0814-1
"H3,C7",6090,6418,4336,2082,3690,0,1992,1993,1438,555,2.590990991,1024,309,230,48,0,48,0,14,0,0,empty,mBC-0814-1
"H3,C8",4507,5042,3300,1742,2930,1,1571,1574,1110,464,2.392241379,845,1729,1216,385,0,385,0,62,0,0,empty,mBC-0814-1
"H3,C9",4143,4515,2934,1581,2596,0,1453,1457,1014,443,2.288939052,765,848,560,185,0,185,0,43,0,0.037837838,empty,mBC-0814-1
"H3,C10",5103,5464,3673,1791,3141,0,1642,1645,1170,475,2.463157895,887,1041,779,198,0,198,0,38,0,0,empty,mBC-0814-1
"H3,C11",4144,4505,2887,1618,2673,3,1490,1493,1053,440,2.393181818,844,1160,808,228,0,228,0,60,0,0.00877193,empty,mBC-0814-1
"H3,C12",7320,7736,5212,2524,4423,2,2344,2349,1660,689,2.409288824,1220,1907,1451,376,2,374,1,69,0,0,empty,mBC-0814-1
"H3,D1",3777,4096,2743,1353,2361,0,1275,1280,942,338,2.786982249,656,466,283,81,0,81,0,17,0,0,empty,mBC-0814-1
"H3,D2",4846,5185,3498,1687,3055,0,1619,1623,1135,488,2.325819672,856,1622,1237,352,0,352,0,79,0,0,empty,mBC-0814-1
"H3,D3",9487,10131,6611,3520,5915,0,3192,3195,2263,932,2.428111588,1717,1340,892,283,0,283,0,62,0,0.017667845,empty,mBC-0814-1
"H3,D4",4664,4931,3329,1602,2982,0,1703,1704,1235,469,2.63326226,869,1142,830,289,0,289,0,63,0,0.003460208,empty,mBC-0814-1
"H3,D5",3316,3518,2344,1174,2126,0,1191,1193,844,349,2.418338109,659,2386,1461,427,0,427,0,88,0,0.025761124,empty,mBC-0814-1
"H3,D6",4601,5187,3184,2003,3010,0,1720,1722,1226,496,2.471774194,994,1676,1227,326,0,326,0,58,0,0.012269939,empty,mBC-0814-1
"H3,D7",483518,553828,322535,231293,327325,1,202887,203108,169711,33397,5.081624098,120929,238423,167809,48101,22,48079,1,2576,0,0.000353585,mm10,mBC-0814-1
"H3,D8",4859,5411,3409,2002,3171,0,1801,1806,1303,503,2.590457256,1028,585,388,119,0,119,0,31,0,0.050420168,empty,mBC-0814-1
"H3,D9",2655,2869,1899,970,1668,3,923,926,642,284,2.26056338,475,1393,851,288,0,288,0,54,0,0.104166667,empty,mBC-0814-1
"H3,D10",3333,3639,2348,1291,2198,0,1214,1216,877,339,2.587020649,655,659,500,159,0,159,0,33,0,0,empty,mBC-0814-1
"H3,D11",3450,3696,2499,1197,2191,3,1169,1174,860,314,2.738853503,636,1509,1085,319,0,319,0,77,0,0.037617555,empty,mBC-0814-1
"H3,D12",5371,5878,3857,2021,3369,2,1832,1836,1286,550,2.338181818,1004,2306,1709,482,0,482,0,101,0,0.039419087,empty,mBC-0814-1
"H3,E1",4220,4413,3079,1334,2629,0,1369,1376,1008,368,2.739130435,695,1425,912,312,0,312,0,70,0,0,empty,mBC-0814-1
"H3,E2",3302,3535,2413,1122,2063,1,1072,1077,788,289,2.726643599,563,899,614,187,0,187,0,56,0,0.016042781,empty,mBC-0814-1
"H3,E3",3107,3392,2250,1142,2015,1,1042,1048,747,301,2.481727575,569,960,639,214,0,214,0,49,0,0.070093458,empty,mBC-0814-1
"H3,E4",2512,2807,1755,1052,1623,0,921,926,644,282,2.283687943,523,947,669,182,0,182,0,42,0,0.005494505,empty,mBC-0814-1
"H3,E5",3469,3747,2518,1229,2181,0,1160,1161,851,310,2.74516129,611,851,617,198,0,198,0,38,0,0,empty,mBC-0814-1
"H3,E6",3948,4185,2840,1345,2438,0,1255,1257,882,375,2.352,660,1418,978,309,0,309,0,70,0,0,empty,mBC-0814-1
"H3,E7",4069,4216,2996,1220,2454,0,1269,1271,892,379,2.353562005,615,972,669,229,0,229,0,54,0,0.004366812,empty,mBC-0814-1
"H3,E8",4166,4433,3036,1397,2614,0,1394,1396,1001,395,2.534177215,720,1734,1219,371,0,371,0,72,0,0,empty,mBC-0814-1
"H3,E9",2653,2883,1779,1104,1717,0,949,954,704,250,2.816,557,1126,788,208,0,208,0,41,0,0,empty,mBC-0814-1
"H3,E10",565940,644273,385952,258321,377683,0,228909,229165,193214,35951,5.374370671,133743,194826,138754,39996,24,39972,2,2350,0,0.000275193,mm10,mBC-0814-1
"H3,E11",3588,3872,2562,1310,2348,0,1272,1276,935,341,2.741935484,682,1572,1010,315,0,315,0,58,0,0.006349206,empty,mBC-0814-1
"H3,E12",3261,3560,2369,1191,2135,0,1184,1190,838,352,2.380681818,631,1351,769,237,0,237,0,36,0,0,empty,mBC-0814-1
"H3,F1",4092,4318,3003,1315,2585,0,1357,1359,939,420,2.235714286,710,1626,1150,363,0,363,0,58,0,0,empty,mBC-0814-1
"H3,F2",627509,723088,419387,303701,423096,0,264884,265201,215527,49674,4.338829166,157883,143527,101278,29976,13,29963,3,2060,0,0.00133498,mm10,mBC-0814-1
"H3,F3",4701,5368,3308,2060,3082,0,1716,1719,1234,485,2.544329897,991,996,603,235,0,235,0,63,0,0,empty,mBC-0814-1
"H3,F4",5111,5378,3623,1755,3133,0,1703,1703,1186,517,2.294003868,903,385,208,56,0,56,0,19,0,0,empty,mBC-0814-1
"H3,F5",4681,4994,3394,1600,2886,0,1510,1510,1096,414,2.647342995,786,1944,978,332,1,331,1,57,0,0,empty,mBC-0814-1
"H3,F6",4115,4310,2982,1328,2546,0,1364,1369,973,396,2.457070707,684,1610,1091,376,0,376,0,80,0,0.037234043,empty,mBC-0814-1
"H3,F7",4618,4838,3187,1651,2764,1,1510,1513,1024,489,2.09406953,799,19337,5423,1688,4,1684,2,167,0,0.143705463,empty,mBC-0814-1
"H3,F8",5432,5637,3885,1752,3272,0,1743,1746,1254,492,2.548780488,883,137,91,33,1,32,1,8,0,0,empty,mBC-0814-1
"H3,F9",4914,5369,3537,1832,3065,1,1653,1656,1220,436,2.798165138,889,1957,1392,430,0,430,0,78,0,0.041860465,empty,mBC-0814-1
"H3,F10",6108,6534,4414,2120,3925,0,2143,2144,1545,599,2.579298831,1136,1444,964,312,0,312,0,62,0,0,empty,mBC-0814-1
"H3,F11",3620,3788,2601,1187,2235,0,1194,1194,840,354,2.372881356,583,1224,783,242,0,242,0,52,0,0.037190083,empty,mBC-0814-1
"H3,F12",1297003,1474339,885909,588430,854106,1,529125,529740,371893,157847,2.356034641,311662,18166,12377,3520,2,3518,1,391,0,0,mm10,mBC-0814-1
"H3,G1",6588,7013,4781,2232,4179,0,2265,2272,1650,622,2.652733119,1189,2684,1906,539,0,539,0,96,0,0,empty,mBC-0814-1
"H3,G2",5092,5422,3505,1917,3088,0,1666,1666,1165,501,2.325349301,892,351,221,71,0,71,0,16,0,0,empty,mBC-0814-1
"H3,G3",345553,384836,234370,150466,231083,0,139336,139490,112214,27276,4.114019651,81239,18660,13925,3854,3,3851,1,511,0,0.003895092,mm10,mBC-0814-1
"H3,G4",4872,5141,3545,1596,3068,11,1620,1632,1161,471,2.464968153,861,0,0,0,0,0,0,0,0,0,empty,mBC-0814-1
"H3,G5",4045,4526,2926,1600,2651,0,1493,1493,1045,448,2.332589286,835,1111,785,264,0,264,0,61,0,0,empty,mBC-0814-1
"H3,G6",7709,8408,5522,2886,4812,0,2554,2560,1886,674,2.798219585,1400,587,226,74,0,74,0,13,0,0.013513514,empty,mBC-0814-1
"H3,G7",550280,602056,380770,221286,359116,7,212746,212999,157501,55498,2.837958125,119374,58751,34537,10169,9,10160,3,967,0,0.00246063,mm10,mBC-0814-1
"H3,G8",347664,408170,227652,180518,244192,0,156859,157035,128553,28482,4.513482199,95368,128292,92281,26488,18,26470,2,1803,0,0.000151114,mm10,mBC-0814-1
"H3,G9",4519,4936,3210,1726,2942,0,1612,1618,1157,461,2.509761388,897,2189,1606,525,0,525,0,110,0,0,empty,mBC-0814-1
"H3,G10",12020,13273,8635,4638,7703,0,4175,4181,3113,1068,2.914794007,2260,4039,2855,821,1,820,1,147,0,0,empty,mBC-0814-1
"H3,G11",1056396,1192306,703419,488887,693466,0,429953,430431,366246,64185,5.706099556,252747,251208,179512,50582,19,50563,5,2784,0,0.000494433,mm10,mBC-0814-1
"H3,G12",4044,4469,2884,1585,2528,0,1387,1392,1001,391,2.560102302,764,3705,1679,493,2,491,1,94,0,0,empty,mBC-0814-1
"H3,H1",4006,4147,2859,1288,2478,0,1337,1339,931,408,2.281862745,679,789,514,184,0,184,0,37,0,0.076086957,empty,mBC-0814-1
"H3,H2",6801,7439,4886,2553,4288,0,2315,2322,1707,615,2.775609756,1224,2241,1604,509,1,508,1,105,0,0.031496063,empty,mBC-0814-1
"H3,H3",529133,590227,357997,232230,347388,5,212002,212230,166077,46153,3.598400971,123539,22957,16391,4573,1,4572,1,530,0,0,mm10,mBC-0814-1
"H3,H4",4898,5207,3473,1734,3053,0,1651,1654,1176,478,2.460251046,885,117,83,25,0,25,0,8,0,0,empty,mBC-0814-1
"H3,H5",5988,6214,4256,1958,3612,0,1931,1933,1380,553,2.495479204,991,2595,1867,549,0,549,0,82,0,0,empty,mBC-0814-1
"H3,H6",5486,5824,3921,1903,3375,0,1831,1834,1364,470,2.90212766,971,2318,1531,472,0,472,0,89,0,0.008474576,empty,mBC-0814-1
"H3,H7",4438,4733,3186,1547,2882,0,1554,1559,1085,474,2.289029536,824,1611,1120,323,0,323,0,66,0,0.009287926,empty,mBC-0814-1
"H3,H8",3871,4255,2766,1489,2434,0,1316,1317,952,365,2.608219178,696,1695,1168,321,0,321,0,90,0,0.00623053,empty,mBC-0814-1
"H3,H9",4160,4337,2984,1353,2516,0,1312,1313,908,405,2.241975309,674,8973,3344,958,0,958,0,112,0,0.009394572,empty,mBC-0814-1
"H3,H10",2962,3139,2111,1028,1856,0,1038,1040,756,284,2.661971831,541,1098,848,260,0,260,0,41,0,0.046153846,empty,mBC-0814-1
"H3,H11",318725,378371,208883,169488,225847,1,143572,143732,117224,26508,4.422212162,88115,7761,4993,1513,0,1513,0,208,0,0,mm10,mBC-0814-1
"H3,H12",1944,2027,1383,644,1243,0,709,709,519,190,2.731578947,357,1243,876,267,1,266,1,53,0,0,empty,mBC-0814-1
"H4,A1",6602,7281,4707,2574,4285,0,2292,2293,1648,645,2.55503876,1276,1002,624,194,0,194,0,51,0,0,empty,mBC-0814-1
"H4,A2",7540,8307,5399,2908,4912,0,2694,2703,1994,709,2.812411848,1499,1220,931,306,1,305,1,95,0,0.016393443,empty,mBC-0814-1
"H4,A3",5730,6264,4077,2187,3483,0,1903,1903,1395,508,2.746062992,989,734,554,150,0,150,0,39,0,0,empty,mBC-0814-1
"H4,A4",7063,7450,4939,2511,4186,0,2293,2294,1609,685,2.348905109,1238,20102,5941,1928,4,1924,2,206,0,0.111746362,empty,mBC-0814-1
"H4,A5",399419,458209,265695,192514,277108,0,175115,175294,145062,30232,4.798293199,104848,13796,10122,2878,1,2877,1,403,0,0,mm10,mBC-0814-1
"H4,A6",7742,8685,5439,3246,5213,0,2947,2947,2190,757,2.892998679,1666,1561,956,289,0,289,0,69,0,0.051903114,empty,mBC-0814-1
"H4,A7",6568,7024,4699,2325,4174,1,2234,2237,1556,681,2.284875184,1193,875,494,157,0,157,0,64,0,0.031847134,empty,mBC-0814-1
"H4,A8",2785,3204,1940,1264,1866,0,1029,1036,764,272,2.808823529,589,2445,1086,343,2,341,1,70,0,0.008797654,empty,mBC-0814-1
"H4,A9",8062,8842,5842,3000,5005,0,2653,2659,1913,746,2.564343164,1411,1227,816,261,0,261,0,59,0,0,empty,mBC-0814-1
"H4,A10",4401,5022,3071,1951,2959,0,1700,1703,1237,466,2.654506438,973,154,112,32,0,32,0,13,0,0,empty,mBC-0814-1
"H4,A11",7488,8218,5480,2738,4797,0,2557,2565,1844,721,2.557558946,1376,1775,1174,366,0,366,0,87,0,0,empty,mBC-0814-1
"H4,A12",6320,6723,4535,2188,4015,0,2245,2254,1719,535,3.213084112,1171,2748,1922,617,0,617,0,148,0,0.004862237,empty,mBC-0814-1
"H4,B1",374109,412291,260438,151853,246928,0,144494,144665,104665,40000,2.616625,82537,34821,14693,4719,5,4714,2,459,0,0.199618159,mm10,mBC-0814-1
"H4,B2",5907,6546,4000,2546,3691,0,2047,2050,1434,616,2.327922078,1174,775,449,139,0,139,0,30,0,0.208633094,empty,mBC-0814-1
"H4,B3",6053,6864,4292,2572,4094,0,2327,2332,1757,575,3.055652174,1331,777,575,196,0,196,0,45,0,0.142857143,empty,mBC-0814-1
"H4,B4",5642,6168,3996,2172,3557,0,2009,2013,1447,566,2.556537102,1076,676,474,148,0,148,0,48,0,0,empty,mBC-0814-1
"H4,B5",8963,8136,5021,3115,5256,0,3052,3060,2332,728,3.203296703,1754,830,578,197,0,197,0,62,0,0,empty,mBC-0814-1
"H4,B6",4904,5419,3485,1934,3300,0,1848,1850,1334,516,2.585271318,1025,1224,809,276,0,276,0,48,0,0,empty,mBC-0814-1
"H4,B7",5672,6034,4091,1943,3597,0,1941,1943,1458,485,3.006185567,1025,803,593,229,0,229,0,59,0,0.096069869,empty,mBC-0814-1
"H4,B8",538424,628492,360396,268096,370887,1,232014,232276,187478,44798,4.184963614,138486,120005,81728,23821,15,23806,3,1781,0,0.000126019,mm10,mBC-0814-1
"H4,B9",5999,6507,4361,2146,3890,0,2089,2091,1568,523,2.998087954,1138,686,505,172,0,172,0,49,0,0,empty,mBC-0814-1
"H4,B10",5467,6011,3872,2139,3483,0,1980,1981,1372,609,2.252873563,1061,184,102,44,0,44,0,14,0,0,empty,mBC-0814-1
"H4,B11",8948,9659,6423,3236,5730,0,3125,3134,2361,773,3.054333765,1712,144,70,27,0,27,0,9,0,0,empty,mBC-0814-1
"H4,B12",6189,6746,4353,2393,3916,0,2136,2140,1517,623,2.434991974,1158,1055,733,209,1,208,1,50,0,0,empty,mBC-0814-1
"H4,C1",9330,10087,6737,3350,5849,0,3119,3124,2179,945,2.305820106,1684,929,653,177,0,177,0,43,0,0.101694915,empty,mBC-0814-1
"H4,C2",1164350,1312968,791874,521094,762396,1,471607,472215,372293,99922,3.725836152,275294,53764,36106,10690,11,10679,3,1075,0,0.001591909,mm10,mBC-0814-1
"H4,C3",6135,6801,4336,2465,4015,0,2234,2241,1603,638,2.512539185,1253,659,454,153,0,153,0,30,0,0.130718954,empty,mBC-0814-1
"H4,C4",693634,799367,448166,351201,467829,1,304328,304659,236793,67866,3.48912563,183148,87302,60924,17597,12,17585,4,1446,0,0,mm10,mBC-0814-1
"H4,C5",8421,9024,5975,3049,5223,0,2852,2857,2062,795,2.593710692,1521,1324,931,301,0,301,0,70,0,0,empty,mBC-0814-1
"H4,C6",6145,6633,4274,2359,3990,0,2169,2171,1543,628,2.457006369,1184,944,460,153,0,153,0,47,0,0,empty,mBC-0814-1
"H4,C7",640716,743018,436687,306331,434586,1,268612,268895,213629,55266,3.865468824,158660,25659,18111,5275,3,5272,1,603,0,0,mm10,mBC-0814-1
"H4,C8",6654,7066,4711,2355,4107,9,2194,2205,1557,648,2.402777778,1152,1177,726,224,0,224,0,67,0,0,empty,mBC-0814-1
"H4,C9",751048,853557,507153,346404,493157,2,302034,302400,249299,53101,4.694808007,176507,115987,80564,23900,11,23889,2,1789,0,0.000627904,mm10,mBC-0814-1
"H4,C10",6172,6733,4443,2290,3947,0,2162,2168,1538,630,2.441269841,1182,710,510,184,0,184,0,42,0,0,empty,mBC-0814-1
"H4,C11",5283,5717,3730,1987,3328,0,1868,1869,1386,483,2.869565217,1034,1301,1001,291,0,291,0,61,0,0,empty,mBC-0814-1
"H4,C12",9514,10397,6824,3573,5985,4,3266,3278,2373,905,2.622099448,1734,1414,954,305,1,304,1,70,0,0.016447368,empty,mBC-0814-1
"H4,D1",5820,6572,4140,2432,3819,9,2112,2121,1502,619,2.426494346,1182,514,360,110,0,110,0,26,0,0,empty,mBC-0814-1
"H4,D2",5375,5665,3934,1731,3381,0,1766,1771,1244,527,2.360531309,917,1092,687,212,0,212,0,64,0,0,empty,mBC-0814-1
"H4,D3",12709,13927,9154,4773,8135,0,4462,4470,3121,1349,2.313565604,2419,1413,1036,333,0,333,0,76,0,0,empty,mBC-0814-1
"H4,D4",5601,6247,3995,2252,3740,0,2133,2137,1524,613,2.486133768,1208,1637,979,329,0,329,0,77,0,0.048632219,empty,mBC-0814-1
"H4,D5",6512,7229,4581,2648,4270,0,2420,2422,1766,656,2.692073171,1351,2698,1310,421,0,421,0,96,0,0.002375297,empty,mBC-0814-1
"H4,D6",5773,6295,4153,2142,3668,1,1972,1979,1441,538,2.678438662,1057,863,616,180,0,180,0,47,0,0.038888889,empty,mBC-0814-1
"H4,D7",669128,773336,443284,330052,449281,1,281895,282205,242641,39564,6.132873319,167566,217199,155705,45035,27,45008,3,2656,0,0.004621401,mm10,mBC-0814-1
"H4,D8",5737,6221,4048,2173,3671,0,2034,2039,1458,581,2.509466437,1161,2876,991,294,0,294,0,50,0,0,empty,mBC-0814-1
"H4,D9",4250,4766,3001,1765,2732,0,1553,1553,1080,473,2.283298097,877,1130,837,250,0,250,0,56,0,0,empty,mBC-0814-1
"H4,D10",4889,5507,3468,2039,3254,0,1887,1890,1388,502,2.764940239,1030,551,291,70,0,70,0,38,0,0,empty,mBC-0814-1
"H4,D11",5384,5905,3823,2082,3389,0,1844,1847,1355,492,2.754065041,1004,1480,1007,380,0,380,0,102,0,0,empty,mBC-0814-1
"H4,D12",595984,705204,390589,314615,416334,0,268083,268340,224153,44187,5.07282685,164559,162615,103606,30762,21,30741,4,2009,0,0.001236134,mm10,mBC-0814-1
"H4,E1",643836,737080,431276,305804,432277,0,270008,270286,210015,60271,3.484511623,159669,128394,92062,27020,13,27007,1,1823,0,0.000222165,mm10,mBC-0814-1
"H4,E2",4378,4693,3155,1538,2861,0,1609,1609,1189,420,2.830952381,848,708,484,199,1,198,1,62,0,0,empty,mBC-0814-1
"H4,E3",666509,768103,451634,316469,444168,0,268471,268749,229598,39151,5.864422365,156989,237694,173449,51411,27,51384,2,2845,0,0.000136229,mm10,mBC-0814-1
"H4,E4",602333,697364,401258,296106,408610,0,260167,260476,209815,50661,4.141548726,155053,81415,57490,17089,4,17085,1,1499,0,0.000819432,mm10,mBC-0814-1
"H4,E5",3991,4198,2923,1275,2464,0,1246,1249,875,374,2.339572193,654,946,694,207,0,207,0,39,0,0,empty,mBC-0814-1
"H4,E6",5385,5893,3902,1991,3404,7,1841,1853,1355,498,2.720883534,999,1000,755,243,0,243,0,54,0,0,empty,mBC-0814-1
"H4,E7",25569,26220,17097,9123,15420,0,8635,8648,6469,2179,2.968793024,4810,7553,4788,1469,0,1469,0,199,0,0.020422056,empty,mBC-0814-1
"H4,E8",5649,6084,4159,1925,3552,0,1892,1894,1373,521,2.635316699,979,1676,1176,355,0,355,0,71,0,0.011267606,empty,mBC-0814-1
"H4,E9",4498,5036,3107,1929,2959,0,1650,1656,1224,432,2.833333333,940,1248,740,265,1,264,1,58,0,0.102272727,empty,mBC-0814-1
"H4,E10",4972,5308,3605,1703,3132,0,1718,1720,1190,530,2.245283019,904,8779,2792,860,0,860,0,112,0,0.013953488,empty,mBC-0814-1
"H4,E11",5135,5611,3670,1941,3285,0,1786,1789,1336,453,2.949227373,959,985,673,227,0,227,0,58,0,0.017621145,empty,mBC-0814-1
"H4,E12",5063,5562,3548,2014,3215,0,1786,1789,1337,452,2.957964602,986,902,572,217,1,216,1,49,0,0,empty,mBC-0814-1
"H4,F1",5371,5683,3926,1757,3400,1,1792,1801,1282,519,2.470134875,928,1215,895,243,0,243,0,53,0,0,empty,mBC-0814-1
"H4,F2",7389,7985,5370,2615,4735,0,2587,2587,1848,739,2.50067659,1365,1756,1167,362,0,362,0,109,0,0.027624309,empty,mBC-0814-1
"H4,F3",644925,746051,431335,314716,437067,1,272006,272338,230916,41422,5.574718748,161983,207508,146863,43087,30,43057,4,2501,0,0,mm10,mBC-0814-1
"H4,F4",6705,7101,4870,2231,4216,0,2255,2255,1614,641,2.517940718,1138,462,328,95,0,95,0,21,0,0,empty,mBC-0814-1
"H4,F5",6072,6716,4468,2248,3854,0,2100,2104,1568,536,2.925373134,1139,1079,713,240,0,240,0,57,0,0,empty,mBC-0814-1
"H4,F6",6593,7110,4744,2366,4104,1,2238,2239,1679,560,2.998214286,1182,1003,599,221,0,221,0,75,0,0,empty,mBC-0814-1
"H4,F7",5093,5645,3726,1919,3313,0,1766,1772,1251,521,2.401151631,938,605,418,140,0,140,0,32,0,0,empty,mBC-0814-1
"H4,F8",7460,7966,5464,2502,4676,1,2522,2528,1824,704,2.590909091,1293,95,64,25,0,25,0,8,0,0,empty,mBC-0814-1
"H4,F9",6780,7489,4897,2592,4369,0,2317,2319,1712,607,2.820428336,1268,1812,1223,427,0,427,0,74,0,0.035128806,empty,mBC-0814-1
"H4,F10",7760,8276,5623,2653,4826,0,2559,2563,1844,719,2.564673157,1346,1046,699,225,0,225,0,69,0,0.022222222,empty,mBC-0814-1
"H4,F11",5307,5651,3920,1731,3226,0,1700,1700,1256,444,2.828828829,837,1258,893,255,0,255,0,48,0,0,empty,mBC-0814-1
"H4,F12",5868,6546,4207,2339,3800,0,2138,2145,1550,595,2.605042017,1202,156,65,9,0,9,0,7,0,0,empty,mBC-0814-1
"H4,G1",8742,9627,6337,3290,5598,0,3044,3045,2185,860,2.540697674,1626,2006,1354,443,0,443,0,115,0,0.036117381,empty,mBC-0814-1
"H4,G2",6920,7489,4921,2568,4308,6,2316,2326,1681,645,2.60620155,1292,308,239,52,0,52,0,22,0,0,empty,mBC-0814-1
"H4,G3",6250,6868,4442,2426,3972,0,2224,2231,1527,704,2.169034091,1180,1833,1247,412,0,412,0,101,0,0,empty,mBC-0814-1
"H4,G4",6247,6597,4401,2196,3846,0,2057,2062,1433,629,2.278219396,1109,0,0,0,0,0,0,0,0,0,empty,mBC-0814-1
"H4,G5",5677,6255,3988,2267,3665,0,2052,2056,1484,572,2.594405594,1149,3763,1355,462,0,462,0,87,0,0.067099567,empty,mBC-0814-1
"H4,G6",10039,10631,7394,3237,6191,0,3190,3197,2336,861,2.713124274,1627,203,163,77,0,77,0,18,0,0,empty,mBC-0814-1
"H4,G7",7236,7816,5095,2721,4619,0,2502,2512,1778,734,2.422343324,1378,3541,1901,568,0,568,0,108,0,0.035211268,empty,mBC-0814-1
"H4,G8",9681,10675,6860,3815,6208,0,3501,3506,2458,1048,2.345419847,1921,2779,1993,652,0,652,0,121,0,0,empty,mBC-0814-1
"H4,G9",7492,8423,5255,3168,4843,0,2740,2748,1971,777,2.536679537,1522,1775,1182,404,0,404,0,108,0,0.002475248,empty,mBC-0814-1
"H4,G10",760369,871842,512602,359240,510468,12,314708,315078,257081,57997,4.43266031,186278,234885,165375,48922,33,48889,3,2793,0,0.000245454,mm10,mBC-0814-1
"H4,G11",11188,11914,7916,3998,7069,0,3844,3850,2842,1008,2.819444444,2068,2634,1179,376,0,376,0,82,0,0.042553191,empty,mBC-0814-1
"H4,G12",5592,5874,4055,1819,3512,0,1909,1910,1393,517,2.694390716,973,1278,854,291,0,291,0,88,0,0.085910653,empty,mBC-0814-1
"H4,H1",5369,5733,3843,1890,3386,4,1833,1843,1285,558,2.302867384,989,410,275,83,0,83,0,32,0,0,empty,mBC-0814-1
"H4,H2",10771,12081,7555,4526,7015,0,4057,4069,2805,1264,2.21914557,2348,7709,3007,1004,1,1003,1,159,0,0.105682951,empty,mBC-0814-1
"H4,H3",7055,7728,4981,2747,4465,0,2448,2449,1792,657,2.727549467,1323,7418,2379,739,1,738,1,124,0,0.010840108,empty,mBC-0814-1
"H4,H4",6747,7368,4725,2643,4335,0,2421,2423,1749,674,2.59495549,1322,298,147,64,0,64,0,11,0,0.140625,empty,mBC-0814-1
"H4,H5",7498,8106,5394,2712,4753,0,2597,2599,1815,784,2.31505102,1392,1342,942,322,0,322,0,58,0,0,empty,mBC-0814-1
"H4,H6",8059,8726,5693,3033,5044,0,2810,2813,2037,776,2.625,1481,1994,1386,456,0,456,0,99,0,0,empty,mBC-0814-1
"H4,H7",6432,6878,4641,2237,4102,0,2199,2201,1553,648,2.396604938,1176,1267,874,275,0,275,0,57,0,0,empty,mBC-0814-1
"H4,H8",448349,529019,294411,234608,312551,1,200901,201091,165149,35942,4.594875077,122889,189571,120486,35930,30,35900,5,2281,0,0.012005571,mm10,mBC-0814-1
"H4,H9",6292,6735,4513,2222,3920,0,2126,2127,1487,640,2.3234375,1102,739,463,162,0,162,0,42,0,0,empty,mBC-0814-1
"H4,H10",4408,4670,3116,1554,2697,3,1477,1480,1015,465,2.182795699,763,1031,729,193,0,193,0,40,0,0.031088083,empty,mBC-0814-1
"H4,H11",5143,5832,3728,2104,3385,0,1917,1923,1387,536,2.587686567,1087,31,19,9,0,9,0,7,0,0,empty,mBC-0814-1
"H4,H12",4156,4664,2899,1765,2809,0,1601,1603,1185,418,2.83492823,957,904,665,189,0,189,0,51,0,0.005291005,empty,mBC-0814-1
"H5,A1",5363,5750,3786,1964,3353,0,1804,1804,1260,544,2.316176471,994,1223,769,216,0,216,0,45,0,0,empty,mBC-0814-1
"H5,A2",4614,4926,3382,1544,2950,0,1601,1601,1135,466,2.435622318,815,1820,1168,369,0,369,0,71,0,0.037940379,empty,mBC-0814-1
"H5,A3",4427,4728,3194,1534,2760,0,1482,1485,1045,440,2.375,769,1082,748,169,0,169,0,38,0,0.01183432,empty,mBC-0814-1
"H5,A4",6020,6152,4495,1657,3531,0,1797,1800,1243,557,2.231597846,834,777,513,147,0,147,0,21,0,0,empty,mBC-0814-1
"H5,A5",4503,4852,3252,1600,2939,0,1599,1602,1136,466,2.43776824,859,1448,1026,282,1,281,1,56,0,0.010676157,empty,mBC-0814-1
"H5,A6",3302,3549,2400,1149,2143,0,1159,1161,863,298,2.895973154,610,1506,901,257,0,257,0,50,0,0.062256809,empty,mBC-0814-1
"H5,A7",5108,5537,3663,1874,3200,0,1784,1788,1265,523,2.41873805,911,1596,1101,308,0,308,0,56,0,0.019480519,empty,mBC-0814-1
"H5,A8",2040,2324,1471,853,1397,0,802,805,561,244,2.299180328,485,1445,1045,272,0,272,0,40,0,0,empty,mBC-0814-1
"H5,A9",6561,7027,4713,2314,4146,0,2212,2219,1612,607,2.65568369,1188,1623,1123,377,0,377,0,57,0,0,empty,mBC-0814-1
"H5,A10",3459,3774,2389,1385,2204,0,1266,1270,884,386,2.29015544,717,1293,537,134,0,134,0,23,0,0,empty,mBC-0814-1
"H5,A11",4197,4572,2946,1626,2734,2,1512,1514,1054,460,2.291304348,833,1979,1462,436,0,436,0,69,0,0,empty,mBC-0814-1
"H5,A12",3200,3399,2254,1145,2070,0,1127,1127,823,304,2.707236842,610,3136,2218,663,0,663,0,107,0,0.006033183,empty,mBC-0814-1
"H5,B1",4314,4614,3145,1469,2681,0,1439,1441,1039,402,2.584577114,743,1551,1035,337,0,337,0,76,0,0.026706231,empty,mBC-0814-1
"H5,B2",4474,4699,3165,1534,2755,0,1479,1481,1015,466,2.178111588,788,503,294,110,0,110,0,22,0,0,empty,mBC-0814-1
"H5,B3",4161,4451,2931,1520,2632,0,1470,1473,1089,384,2.8359375,803,1435,839,228,0,228,0,49,0,0,empty,mBC-0814-1
"H5,B4",332005,391617,220321,171296,236242,0,149533,149700,123714,25986,4.760794274,91329,109422,74420,21100,17,21083,2,1625,0,0.000237158,mm10,mBC-0814-1
"H5,B5",3475,2407,1472,935,1707,0,975,979,660,319,2.068965517,579,1266,945,272,0,272,0,48,0,0,empty,mBC-0814-1
"H5,B6",3509,3928,2494,1434,2296,0,1309,1309,933,376,2.481382979,725,1286,867,277,1,276,1,54,0,0.025362319,empty,mBC-0814-1
"H5,B7",4798,5038,3457,1581,2918,0,1572,1572,1128,444,2.540540541,763,5872,2104,627,2,625,2,78,0,0.0432,empty,mBC-0814-1
"H5,B8",3403,3673,2482,1191,2208,0,1158,1158,837,321,2.607476636,620,867,570,166,1,165,1,39,0,0,empty,mBC-0814-1
"H5,B9",41366,52952,25606,27346,32139,9,23307,23342,10472,12870,0.813675214,15240,2900,1456,412,0,412,0,81,0,0,empty,mBC-0814-1
"H5,B10",3954,4223,2786,1437,2591,0,1397,1405,972,433,2.244803695,796,480,345,104,2,102,1,24,0,0,empty,mBC-0814-1
"H5,B11",406371,460827,277167,183660,269880,2,164253,164448,132871,31577,4.20784115,95342,6325,3889,1094,1,1093,1,166,0,0,mm10,mBC-0814-1
"H5,B12",4773,5270,3394,1876,3101,0,1699,1705,1180,525,2.247619048,939,1068,675,214,0,214,0,29,0,0.03271028,empty,mBC-0814-1
"H5,C1",4934,5127,3606,1521,3014,0,1533,1537,1092,445,2.453932584,789,862,552,197,0,197,0,40,0,0,empty,mBC-0814-1
"H5,C2",4758,5270,3416,1854,3011,0,1712,1715,1246,469,2.656716418,931,1421,925,307,0,307,0,53,0,0.052117264,empty,mBC-0814-1
"H5,C3",626172,713105,425143,287962,414777,1,251088,251417,215788,35629,6.056526986,146739,64571,43371,12037,7,12030,1,1136,0,0.000665004,mm10,mBC-0814-1
"H5,C4",4818,5001,3503,1498,2952,0,1505,1512,1117,395,2.827848101,771,1548,878,204,0,204,0,41,0,0,empty,mBC-0814-1
"H5,C5",6475,6826,4699,2127,3956,1,2109,2115,1536,579,2.652849741,1092,1453,1021,283,0,283,0,60,0,0,empty,mBC-0814-1
"H5,C6",4887,5215,3562,1653,3063,1,1601,1605,1145,460,2.489130435,809,1292,898,301,2,299,2,55,0,0,empty,mBC-0814-1
"H5,C7",6745,7073,4800,2273,4181,3,2211,2222,1591,631,2.521394612,1176,505,268,92,0,92,0,23,0,0,empty,mBC-0814-1
"H5,C8",4849,5228,3544,1684,3126,3,1659,1664,1155,509,2.269155206,848,2241,1432,405,0,405,0,76,0,0.002469136,empty,mBC-0814-1
"H5,C9",4282,4478,3120,1358,2645,0,1398,1406,978,428,2.285046729,704,1243,754,212,1,211,1,49,0,0.004739336,empty,mBC-0814-1
"H5,C10",5188,5390,3776,1614,3177,0,1700,1707,1198,509,2.353634578,836,9939,3266,971,1,970,1,126,0,0.01443299,empty,mBC-0814-1
"H5,C11",4354,4603,3110,1493,2759,3,1513,1518,1072,446,2.403587444,815,1728,1205,347,0,347,0,49,0,0,empty,mBC-0814-1
"H5,C12",7691,8473,5355,3118,4883,2,2690,2694,1934,760,2.544736842,1513,1767,1213,354,0,354,0,68,0,0,empty,mBC-0814-1
"H5,D1",3943,4456,2811,1645,2545,0,1375,1376,1010,366,2.759562842,772,640,519,119,2,117,1,21,0,0,empty,mBC-0814-1
"H5,D2",4912,5206,3696,1510,3036,0,1530,1530,1072,458,2.340611354,741,2124,1540,443,1,442,1,78,0,0,empty,mBC-0814-1
"H5,D3",9778,10275,6898,3377,6015,0,3232,3234,2274,960,2.36875,1669,2163,1482,447,0,447,0,92,0,0.049217002,empty,mBC-0814-1
"H5,D4",4139,4555,3015,1540,2712,0,1451,1454,1026,428,2.397196262,794,1433,1089,317,0,317,0,58,0,0.056782334,empty,mBC-0814-1
"H5,D5",3925,4191,2800,1391,2421,0,1292,1292,945,347,2.723342939,661,1629,975,295,0,295,0,62,0,0.010169492,empty,mBC-0814-1
"H5,D6",4662,5247,3347,1900,3028,0,1639,1642,1186,456,2.600877193,921,1017,576,214,0,214,0,37,0,0,empty,mBC-0814-1
"H5,D7",5214,5566,3737,1829,3208,0,1748,1756,1289,467,2.760171306,923,3240,2300,581,0,581,0,82,0,0,empty,mBC-0814-1
"H5,D8",4529,4966,3272,1694,2916,0,1620,1623,1195,428,2.792056075,881,937,668,210,2,208,1,38,0,0,empty,mBC-0814-1
"H5,D9",2983,3278,2111,1167,1890,0,1020,1020,723,297,2.434343434,571,1856,1229,339,0,339,0,61,0,0,empty,mBC-0814-1
"H5,D10",3457,3526,2499,1027,2094,0,1095,1095,796,299,2.662207358,513,6678,1974,644,0,644,0,82,0,0.01552795,empty,mBC-0814-1
"H5,D11",3812,4210,2787,1423,2445,0,1341,1341,976,365,2.673972603,690,2026,1444,423,0,423,0,84,0,0,empty,mBC-0814-1
"H5,D12",5869,6450,4221,2229,3696,0,1934,1937,1361,576,2.362847222,1060,5132,2328,763,1,762,1,126,0,0.002624672,empty,mBC-0814-1
"H5,E1",427759,477118,291901,185217,284860,1,171551,171747,139079,32668,4.257346639,99060,56148,39757,10775,13,10762,3,1048,0,0,mm10,mBC-0814-1
"H5,E2",3587,3803,2585,1218,2279,0,1207,1209,829,380,2.181578947,623,2127,1615,427,0,427,0,65,0,0.00234192,empty,mBC-0814-1
"H5,E3",3239,3645,2347,1298,2125,1,1138,1142,788,354,2.225988701,643,1534,1115,337,0,337,0,51,0,0,empty,mBC-0814-1
"H5,E4",2788,3060,1955,1105,1790,6,969,982,726,256,2.8359375,536,1064,627,188,0,188,0,36,0,0,empty,mBC-0814-1
"H5,E5",3635,3762,2637,1125,2259,0,1192,1194,858,336,2.553571429,594,1373,973,257,0,257,0,37,0,0,empty,mBC-0814-1
"H5,E6",4303,4727,3225,1502,2690,0,1368,1368,990,378,2.619047619,713,7064,2116,704,1,703,1,93,0,0,empty,mBC-0814-1
"H5,E7",4044,4397,2938,1459,2534,0,1330,1330,954,376,2.537234043,690,1396,902,258,0,258,0,51,0,0,empty,mBC-0814-1
"H5,E8",4336,4661,3148,1513,2686,0,1409,1414,1032,382,2.701570681,720,1379,925,289,0,289,0,57,0,0.079584775,empty,mBC-0814-1
"H5,E9",3110,3365,2238,1127,1954,0,1058,1062,762,300,2.54,549,1173,874,305,0,305,0,64,0,0,empty,mBC-0814-1
"H5,E10",3718,4052,2676,1376,2355,0,1262,1266,919,347,2.648414986,673,1718,1339,358,0,358,0,60,0,0.044692737,empty,mBC-0814-1
"H5,E11",3895,4203,2865,1338,2460,0,1288,1289,926,363,2.550964187,677,1363,951,236,0,236,0,47,0,0,empty,mBC-0814-1
"H5,E12",3605,3855,2562,1293,2249,0,1261,1261,932,329,2.832826748,654,471,339,92,0,92,0,25,0,0,empty,mBC-0814-1
"H5,F1",4265,4427,3154,1273,2566,0,1348,1350,959,391,2.452685422,646,1269,906,266,0,266,0,46,0,0,empty,mBC-0814-1
"H5,F2",6443,7156,4639,2517,4086,0,2248,2252,1675,577,2.902946274,1213,1909,1430,382,0,382,0,71,0,0.041884817,empty,mBC-0814-1
"H5,F3",9788,10596,7041,3555,6270,0,3229,3234,2372,862,2.751740139,1739,6228,4422,1210,1,1209,1,176,0,0,empty,mBC-0814-1
"H5,F4",4845,5218,3459,1759,3080,0,1701,1702,1218,484,2.516528926,903,434,313,90,0,90,0,21,0,0,empty,mBC-0814-1
"H5,F5",4733,5023,3390,1633,2957,0,1548,1548,1111,437,2.542334096,837,14583,4578,1435,6,1429,1,153,0,0.088173548,empty,mBC-0814-1
"H5,F6",911974,1144521,574816,569705,679143,1,487670,488111,225144,262967,0.856168264,312372,79479,54005,14724,5,14719,4,1487,0,0.000747333,empty,mBC-0814-1
"H5,F7",4135,4562,2927,1635,2628,0,1419,1421,1043,378,2.759259259,796,501,356,98,0,98,0,21,0,0,empty,mBC-0814-1
"H5,F8",5539,5497,4088,1409,3284,0,1715,1722,1200,522,2.298850575,800,235,148,35,0,35,0,5,0,0,empty,mBC-0814-1
"H5,F9",5101,5398,3702,1696,3219,0,1712,1717,1259,458,2.748908297,920,1617,1155,322,0,322,0,64,0,0,empty,mBC-0814-1
"H5,F10",5723,6191,4221,1970,3694,0,1981,1982,1385,597,2.319932998,1052,1475,1034,310,0,310,0,56,0,0,empty,mBC-0814-1
"H5,F11",3850,4175,2761,1414,2474,0,1334,1338,955,383,2.493472585,712,1201,816,283,0,283,0,55,0,0,empty,mBC-0814-1
"H5,F12",4439,4911,3078,1833,2853,0,1624,1627,1115,512,2.177734375,902,3052,719,209,0,209,0,27,0,0,empty,mBC-0814-1
"H5,G1",8828,9810,6286,3524,5703,3,3071,3082,2320,762,3.044619423,1700,4033,2594,778,1,777,1,134,0,0,empty,mBC-0814-1
"H5,G2",5305,5772,3807,1965,3360,0,1862,1866,1369,497,2.754527163,974,420,255,62,0,62,0,17,0,0,empty,mBC-0814-1
"H5,G3",4765,5153,3447,1706,3015,0,1622,1622,1169,453,2.580573951,880,1893,1420,415,0,415,0,82,0,0.002409639,empty,mBC-0814-1
"H5,G4",5015,5446,3712,1734,3155,2,1649,1653,1175,478,2.458158996,866,49,34,11,0,11,0,1,0,0,empty,mBC-0814-1
"H5,G5",428678,477369,287240,190129,283939,2,174695,174894,129431,45463,2.846952467,102264,73094,26266,8125,12,8113,3,758,0,0.111056329,mm10,mBC-0814-1
"H5,G6",7984,8518,5782,2736,4997,0,2667,2676,1876,800,2.345,1423,237,148,47,0,47,0,9,0,0,empty,mBC-0814-1
"H5,G7",5278,5533,3701,1832,3232,0,1725,1731,1227,504,2.43452381,921,65116,19070,5919,10,5909,1,502,0,0.11592486,empty,mBC-0814-1
"H5,G8",6416,6967,4548,2419,4112,0,2240,2240,1589,651,2.440860215,1236,18332,6293,1890,3,1887,1,222,0,0.02808691,empty,mBC-0814-1
"H5,G9",4743,5121,3404,1717,2998,0,1646,1649,1190,459,2.592592593,882,6367,2736,851,3,848,3,118,0,0.010613208,empty,mBC-0814-1
"H5,G10",8482,9036,6067,2969,5327,0,2837,2839,1999,840,2.379761905,1528,2600,1825,605,1,604,1,108,0,0.039735099,empty,mBC-0814-1
"H5,G11",8266,8732,5941,2791,5133,0,2712,2721,1909,812,2.350985222,1407,9777,3157,921,1,920,1,117,0,0.011956522,empty,mBC-0814-1
"H5,G12",4392,4652,3030,1622,2672,0,1464,1464,1040,424,2.452830189,781,1691,1190,340,0,340,0,72,0,0,empty,mBC-0814-1
"H5,H1",4281,4582,3113,1469,2659,0,1414,1414,989,425,2.327058824,733,919,616,126,0,126,0,28,0,0.134920635,empty,mBC-0814-1
"H5,H2",7856,8132,5296,2836,4719,0,2612,2617,1851,766,2.416449086,1412,7484,3937,1112,0,1112,0,144,0,0.035971223,empty,mBC-0814-1
"H5,H3",4762,5035,3415,1620,2926,0,1537,1537,1122,415,2.703614458,805,1903,1444,354,0,354,0,50,0,0,empty,mBC-0814-1
"H5,H4",521848,588938,354488,234450,347216,0,213341,213619,161066,52553,3.064829791,124092,2807,1786,499,0,499,0,65,0,0.008016032,empty,mBC-0814-1
"H5,H5",6196,6718,4451,2267,3855,0,2071,2072,1456,616,2.363636364,1071,2115,1431,372,0,372,0,70,0,0,empty,mBC-0814-1
"H5,H6",5748,6207,4069,2138,3663,0,1994,1996,1423,573,2.483420593,1097,2599,1877,518,0,518,0,84,0,0.036679537,empty,mBC-0814-1
"H5,H7",4993,5546,3532,2014,3241,0,1799,1803,1264,539,2.345083488,996,2050,1498,383,0,383,0,63,0,0,empty,mBC-0814-1
"H5,H8",340269,389645,231260,158385,232253,2,142954,143115,98878,44237,2.235187739,84454,85829,57460,16993,6,16987,1,1341,0,0.00447401,mm10,mBC-0814-1
"H5,H9",4500,4825,3125,1700,2816,0,1515,1518,1079,439,2.45785877,825,1594,1047,293,0,293,0,46,0,0,empty,mBC-0814-1
"H5,H10",3059,3392,2204,1188,1963,7,1040,1047,789,258,3.058139535,570,873,644,194,0,194,0,35,0,0.072164948,empty,mBC-0814-1
"H5,H11",3416,3729,2376,1353,2247,0,1262,1262,937,325,2.883076923,699,120,96,38,0,38,0,3,0,0,empty,mBC-0814-1
"H5,H12",2256,2516,1605,911,1529,0,860,863,640,223,2.869955157,488,1154,714,224,0,224,0,47,0,0,empty,mBC-0814-1
"H6,A1",5311,5667,3776,1891,3390,0,1878,1884,1323,561,2.35828877,1033,1037,801,244,0,244,0,70,0,0,empty,mBC-0814-1
"H6,A2",512763,577707,336937,240770,337487,0,211558,211809,174876,36933,4.734952482,124586,142719,99734,28537,13,28524,3,1998,0,0.00115692,mm10,mBC-0814-1
"H6,A3",4515,4822,3248,1574,2858,0,1519,1524,1101,423,2.602836879,811,945,689,196,0,196,0,53,0,0,empty,mBC-0814-1
"H6,A4",5498,6068,3918,2150,3500,0,1919,1920,1378,542,2.542435424,1060,403,225,77,1,76,1,20,0,0,empty,mBC-0814-1
"H6,A5",4491,4737,3323,1414,2742,0,1432,1434,1028,406,2.532019704,699,1254,817,265,0,265,0,61,0,0.049056604,empty,mBC-0814-1
"H6,A6",3815,3944,2723,1221,2337,0,1265,1265,920,345,2.666666667,644,1368,774,213,0,213,0,56,0,0,empty,mBC-0814-1
"H6,A7",5497,5994,3861,2133,3474,0,1875,1876,1331,545,2.442201835,1075,22975,7061,2249,4,2245,3,248,0,0.096213808,empty,mBC-0814-1
"H6,A8",2198,2361,1559,802,1406,0,793,795,578,217,2.66359447,402,1787,1224,295,0,295,0,62,0,0.006779661,empty,mBC-0814-1
"H6,A9",7566,8319,5474,2845,4832,0,2685,2687,1999,688,2.905523256,1428,1623,1042,314,0,314,0,67,0,0.108280255,empty,mBC-0814-1
"H6,A10",364075,428125,237025,191100,253728,1,165407,165568,126160,39408,3.20138043,101064,26442,17757,4885,4,4881,1,536,0,0.001639008,mm10,mBC-0814-1
"H6,A11",345334,404583,226893,177690,240067,0,151793,151945,123838,28107,4.405948696,91816,188111,129442,35398,24,35374,3,2165,0,0.001413468,mm10,mBC-0814-1
"H6,A12",668493,766027,447474,318553,448292,0,276296,276630,231314,45316,5.104466414,164367,800861,556656,154338,112,154226,10,4789,0,0.000797531,mm10,mBC-0814-1
"H6,B1",4580,4844,3256,1588,2863,0,1532,1535,1081,454,2.381057269,831,1574,1071,337,0,337,0,80,0,0,empty,mBC-0814-1
"H6,B2",4755,4991,3259,1732,2974,0,1616,1616,1126,490,2.297959184,870,249,150,53,0,53,0,18,0,0,empty,mBC-0814-1
"H6,B3",4194,4682,2949,1733,2811,0,1575,1576,1127,449,2.510022272,902,1081,774,208,0,208,0,42,0,0,empty,mBC-0814-1
"H6,B4",410214,496051,260144,235907,295559,0,198066,198265,147305,50960,2.890600471,124095,146344,102477,28889,12,28877,3,2025,0,0,mm10,mBC-0814-1
"H6,B5",3600,2498,1464,1034,1757,0,1041,1045,750,295,2.542372881,636,3570,1361,428,1,427,1,68,0,0.044496487,empty,mBC-0814-1
"H6,B6",4110,4458,2896,1562,2600,0,1437,1440,994,446,2.228699552,765,1545,1034,361,0,361,0,66,0,0,empty,mBC-0814-1
"H6,B7",629599,705784,421894,283890,412285,1,254731,255058,199211,55847,3.567085072,147659,99429,66337,17703,22,17681,5,1440,0,0.000226232,mm10,mBC-0814-1
"H6,B8",3695,3835,2686,1149,2243,0,1190,1190,879,311,2.826366559,596,743,566,197,0,197,0,55,0,0,empty,mBC-0814-1
"H6,B9",4659,5017,3344,1673,2977,0,1640,1645,1208,437,2.764302059,881,713,492,160,0,160,0,46,0,0,empty,mBC-0814-1
"H6,B10",4184,4284,2916,1368,2644,0,1422,1428,1017,411,2.474452555,755,390,259,85,0,85,0,27,0,0,empty,mBC-0814-1
"H6,B11",8580,9439,5982,3457,5620,0,3206,3208,2392,816,2.931372549,1755,260,189,72,0,72,0,15,0,0,empty,mBC-0814-1
"H6,B12",5152,5590,3704,1886,3295,0,1818,1818,1295,523,2.476099426,983,1110,717,228,0,228,0,55,0,0,empty,mBC-0814-1
"H6,C1",5050,5423,3669,1754,3203,0,1686,1692,1193,499,2.390781563,888,694,468,155,0,155,0,39,0,0,empty,mBC-0814-1
"H6,C2",5202,5559,3715,1844,3280,0,1813,1813,1333,480,2.777083333,935,1516,1133,305,2,303,1,83,0,0,empty,mBC-0814-1
"H6,C3",26151,28307,19146,9161,16394,0,8564,8586,6518,2068,3.151837524,4582,2257,1593,439,1,438,1,91,0,0.00456621,empty,mBC-0814-1
"H6,C4",4967,5469,3582,1887,3190,0,1746,1746,1235,511,2.416829746,948,1000,672,220,0,220,0,63,0,0,empty,mBC-0814-1
"H6,C5",7827,8644,5441,3203,5040,4,2789,2797,2122,675,3.143703704,1541,1783,1262,384,1,383,1,88,0,0.005221932,empty,mBC-0814-1
"H6,C6",5073,5599,3616,1983,3293,0,1902,1907,1385,522,2.653256705,1049,1070,757,216,0,216,0,66,0,0,empty,mBC-0814-1
"H6,C7",7158,7498,5197,2301,4303,0,2311,2317,1654,663,2.494720965,1149,589,432,137,0,137,0,32,0,0,empty,mBC-0814-1
"H6,C8",5109,5287,3610,1677,3147,3,1667,1672,1183,489,2.419222904,855,2125,1495,387,0,387,0,82,0,0.041343669,empty,mBC-0814-1
"H6,C9",4532,4783,3259,1524,2783,0,1468,1474,1048,426,2.460093897,758,808,582,210,1,209,1,49,0,0,empty,mBC-0814-1
"H6,C10",5452,5901,3951,1950,3320,0,1815,1818,1320,498,2.65060241,981,875,700,194,0,194,0,40,0,0.005154639,empty,mBC-0814-1
"H6,C11",4374,4589,3122,1467,2690,0,1423,1423,1009,414,2.437198068,745,1146,836,278,1,277,1,67,0,0.010830325,empty,mBC-0814-1
"H6,C12",8152,8878,5674,3204,5036,0,2805,2813,2044,769,2.657997399,1562,2124,1364,407,1,406,1,73,0,0,empty,mBC-0814-1
"H6,D1",4461,4738,3130,1608,2719,0,1494,1495,1093,402,2.718905473,782,810,510,156,0,156,0,36,0,0,empty,mBC-0814-1
"H6,D2",4895,5130,3544,1586,2922,0,1528,1528,1113,415,2.681927711,787,2333,1719,472,0,472,0,95,0,0.023305085,empty,mBC-0814-1
"H6,D3",1118215,1325081,735035,590046,772958,2,502171,502775,401978,100797,3.987995674,307508,140641,101476,27238,8,27230,1,1967,0,7.34484E-05,mm10,mBC-0814-1
"H6,D4",4454,4652,3220,1432,2837,0,1512,1514,1083,431,2.512761021,755,2051,1406,384,0,384,0,78,0,0,empty,mBC-0814-1
"H6,D5",4602,5041,3312,1729,3037,0,1723,1723,1260,463,2.721382289,934,2142,1589,385,1,384,1,89,0,0,empty,mBC-0814-1
"H6,D6",4672,5072,3334,1738,2921,0,1593,1597,1124,473,2.376321353,836,1125,857,247,0,247,0,65,0,0,empty,mBC-0814-1
"H6,D7",5575,5948,4105,1843,3451,0,1817,1819,1286,533,2.412757974,946,2033,1453,454,0,454,0,92,0,0,empty,mBC-0814-1
"H6,D8",4588,5149,3254,1895,2911,0,1625,1625,1170,455,2.571428571,866,842,468,166,0,166,0,41,0,0.024096386,empty,mBC-0814-1
"H6,D9",3294,3574,2375,1199,2093,0,1131,1136,803,333,2.411411411,614,2134,1574,395,0,395,0,62,0,0.020253165,empty,mBC-0814-1
"H6,D10",3534,3826,2545,1281,2252,0,1242,1248,889,359,2.47632312,652,1454,1162,279,2,277,1,49,0,0.007220217,empty,mBC-0814-1
"H6,D11",4101,4421,2922,1499,2497,0,1322,1322,961,361,2.662049861,707,2043,1487,457,1,456,1,118,0,0,empty,mBC-0814-1
"H6,D12",6005,6530,4279,2251,3836,0,2115,2117,1480,637,2.323390895,1158,3342,2438,701,1,700,1,122,0,0,empty,mBC-0814-1
"H6,E1",4778,5022,3466,1556,2982,0,1555,1556,1097,459,2.389978214,802,1871,1311,394,0,394,0,78,0,0,empty,mBC-0814-1
"H6,E2",3537,3596,2539,1057,2101,0,1087,1087,790,297,2.65993266,513,854,579,168,0,168,0,55,0,0,empty,mBC-0814-1
"H6,E3",3215,3369,2383,986,2013,0,1066,1068,761,307,2.478827362,527,1342,1002,315,0,315,0,67,0,0,empty,mBC-0814-1
"H6,E4",2837,3042,2092,950,1807,0,962,964,692,272,2.544117647,459,1084,690,198,0,198,0,53,0,0,empty,mBC-0814-1
"H6,E5",3345,3358,2423,935,1984,0,990,993,696,297,2.343434343,489,1060,819,236,0,236,0,61,0,0,empty,mBC-0814-1
"H6,E6",4368,4595,3202,1393,2667,0,1384,1385,992,393,2.524173028,703,1382,965,243,0,243,0,53,0,0.041152263,empty,mBC-0814-1
"H6,E7",3917,4191,2900,1291,2489,0,1307,1309,972,337,2.884272997,687,1161,827,226,0,226,0,53,0,0,empty,mBC-0814-1
"H6,E8",4299,4615,3137,1478,2714,0,1453,1457,1049,408,2.571078431,776,1861,1308,328,0,328,0,63,0,0,empty,mBC-0814-1
"H6,E9",3178,3379,2185,1194,2029,0,1092,1095,818,277,2.953068592,625,1746,1041,322,1,321,1,72,0,0,empty,mBC-0814-1
"H6,E10",3889,4235,2713,1522,2452,0,1370,1372,998,374,2.668449198,751,1462,1051,328,0,328,0,68,0,0.00304878,empty,mBC-0814-1
"H6,E11",4110,4533,2922,1611,2618,0,1401,1401,972,429,2.265734266,749,1119,783,252,0,252,0,55,0,0,empty,mBC-0814-1
"H6,E12",487805,566949,328891,238058,334215,1,208441,208679,164590,44089,3.733130713,124249,127081,88551,25032,14,25018,1,1724,0,0,mm10,mBC-0814-1
"H6,F1",4270,4491,3073,1418,2639,0,1353,1355,985,370,2.662162162,728,1428,845,270,2,268,1,60,0,0,empty,mBC-0814-1
"H6,F2",6037,6236,4341,1895,3701,0,1964,1964,1462,502,2.912350598,990,2073,1454,442,0,442,0,91,0,0.070135747,empty,mBC-0814-1
"H6,F3",4668,4965,3316,1649,2914,0,1615,1616,1187,429,2.766899767,847,1953,1392,424,1,423,1,95,0,0.009456265,empty,mBC-0814-1
"H6,F4",5301,5572,3724,1848,3335,0,1785,1794,1325,469,2.825159915,976,314,205,78,0,78,0,25,0,0,empty,mBC-0814-1
"H6,F5",4885,5192,3561,1631,3063,0,1626,1630,1136,494,2.299595142,869,1035,763,193,0,193,0,59,0,0.082901554,empty,mBC-0814-1
"H6,F6",5326,5763,3777,1986,3319,0,1805,1808,1280,528,2.424242424,976,4677,2252,632,1,631,1,115,0,0.025356577,empty,mBC-0814-1
"H6,F7",692430,805621,464731,340890,473085,0,297254,297601,256212,41389,6.190340429,177153,109318,77573,20947,5,20942,2,1601,0,0,mm10,mBC-0814-1
"H6,F8",6568,6989,4635,2354,4120,0,2200,2202,1623,579,2.803108808,1197,211,148,53,0,53,0,8,0,0,empty,mBC-0814-1
"H6,F9",5026,5461,3667,1794,3198,0,1717,1719,1246,473,2.634249471,902,2252,1631,430,1,429,1,95,0,0,empty,mBC-0814-1
"H6,F10",6025,6119,4391,1728,3635,0,1858,1863,1322,541,2.443622921,909,1659,1045,303,0,303,0,77,0,0.0330033,empty,mBC-0814-1
"H6,F11",478977,531177,324600,206577,312808,0,190055,190279,141761,48518,2.921822829,109648,50987,35340,9686,8,9678,2,982,0,0,mm10,mBC-0814-1
"H6,F12",4742,5034,3338,1696,3045,0,1688,1691,1235,456,2.708333333,870,166,137,26,0,26,0,12,0,0,empty,mBC-0814-1
"H6,G1",7799,8253,5648,2605,4790,0,2568,2575,1805,770,2.344155844,1289,5409,3218,901,3,898,1,160,0,0.006681514,empty,mBC-0814-1
"H6,G2",5491,5696,3896,1800,3362,0,1793,1794,1301,493,2.638945233,930,449,293,70,0,70,0,25,0,0,empty,mBC-0814-1
"H6,G3",4719,5116,3304,1812,3005,0,1684,1686,1190,496,2.399193548,931,1817,1213,391,0,391,0,99,0,0,empty,mBC-0814-1
"H6,G4",5267,5743,3753,1990,3299,0,1820,1824,1288,536,2.402985075,1003,0,0,0,0,0,0,0,0,0,empty,mBC-0814-1
"H6,G5",506869,600843,333942,266901,351114,0,222099,222352,191692,30660,6.252185258,134989,240989,176098,47883,34,47849,5,2671,0,0.000397082,mm10,mBC-0814-1
"H6,G6",8300,8550,5942,2608,5015,6,2587,2601,1878,723,2.597510373,1322,687,257,89,0,89,0,17,0,0,empty,mBC-0814-1
"H6,G7",5099,5303,3687,1616,3202,0,1719,1723,1210,513,2.358674464,883,3077,1816,535,0,535,0,101,0,0.001869159,empty,mBC-0814-1
"H6,G8",758661,875568,503921,371647,514681,1,326333,326665,250145,76520,3.269014637,195961,235979,167823,46384,32,46352,4,2842,0,0.00021574,mm10,mBC-0814-1
"H6,G9",5390,5564,3792,1772,3376,1,1837,1840,1339,501,2.672654691,946,43253,14508,4547,13,4534,4,462,0,0.094397883,empty,mBC-0814-1
"H6,G10",10469,11450,7506,3944,6652,0,3567,3579,2574,1005,2.56119403,1917,10015,4076,1311,1,1310,1,210,0,0.063358779,empty,mBC-0814-1
"H6,G11",8814,9338,6232,3106,5589,0,2918,2925,2078,847,2.453364817,1574,1713,1326,421,0,421,0,78,0,0,empty,mBC-0814-1
"H6,G12",4659,5116,3358,1758,3069,0,1703,1708,1234,474,2.603375527,907,1738,1169,374,1,373,1,98,0,0.075067024,empty,mBC-0814-1
"H6,H1",4456,4714,3183,1531,2798,0,1518,1521,1116,405,2.755555556,798,1237,803,191,1,190,1,47,0,0,empty,mBC-0814-1
"H6,H2",10144,10858,7233,3625,6345,2,3382,3387,2492,895,2.784357542,1755,5214,3510,1049,0,1049,0,205,0,0,empty,mBC-0814-1
"H6,H3",5416,5801,3804,1997,3421,0,1887,1895,1357,538,2.522304833,1075,1498,1061,325,0,325,0,73,0,0.027692308,empty,mBC-0814-1
"H6,H4",467302,556317,309747,246570,326543,0,209054,209290,167468,41822,4.004303955,127894,4715,3107,876,0,876,0,139,0,0,empty,mBC-0814-1
"H6,H5",6208,6693,4531,2162,3781,0,2005,2010,1428,582,2.453608247,1046,1945,1408,422,0,422,0,81,0,0.018957346,empty,mBC-0814-1
"H6,H6",985626,1136789,659968,476821,664989,1,420664,421142,327108,94034,3.478614118,251125,236241,171520,47682,34,47648,4,2737,0,0.000335796,mm10,mBC-0814-1
"H6,H7",5146,5463,3689,1774,3206,0,1690,1693,1185,508,2.332677165,900,1916,1318,367,0,367,0,81,0,0.016348774,empty,mBC-0814-1
"H6,H8",4415,4681,3173,1508,2773,3,1542,1550,1141,409,2.789731051,827,1800,1201,393,1,392,1,96,0,0,empty,mBC-0814-1
"H6,H9",4610,4915,3290,1625,2891,0,1579,1579,1110,469,2.36673774,835,2109,1267,352,0,352,0,58,0,0.028409091,empty,mBC-0814-1
"H6,H10",587607,691074,386940,304134,399996,1,257587,257887,198801,59086,3.364604136,156413,109864,76913,21543,11,21532,1,1581,0,0,mm10,mBC-0814-1
"H6,H11",3660,4137,2626,1511,2449,0,1437,1441,1050,391,2.685421995,788,49,33,15,0,15,0,7,0,0,empty,mBC-0814-1
"H6,H12",2667,2752,1905,847,1702,0,928,928,688,240,2.866666667,491,1306,872,289,0,289,0,67,0,0.027681661,empty,mBC-0814-1
"H7,A1",5504,5687,3912,1775,3411,0,1811,1811,1298,513,2.530214425,963,6007,2024,665,1,664,1,94,0,0,empty,mBC-0814-1
"H7,A2",4987,5155,3600,1555,3066,0,1601,1603,1155,448,2.578125,834,1623,1158,333,0,333,0,92,0,0.018018018,empty,mBC-0814-1
"H7,A3",4633,4948,3364,1584,2829,0,1507,1511,1050,461,2.277657267,772,1303,729,236,0,236,0,45,0,0,empty,mBC-0814-1
"H7,A4",6032,6634,4373,2261,3748,0,2005,2009,1430,579,2.469775475,1067,432,243,67,0,67,0,20,0,0,empty,mBC-0814-1
"H7,A5",4816,5249,3430,1819,3003,0,1631,1635,1142,493,2.31643002,883,1793,1094,345,1,344,1,62,0,0.023255814,empty,mBC-0814-1
"H7,A6",3811,4232,2779,1453,2437,0,1288,1288,919,369,2.490514905,713,1439,1023,332,0,332,0,72,0,0.039156627,empty,mBC-0814-1
"H7,A7",5610,6353,4103,2250,3677,0,1986,1990,1464,526,2.783269962,1103,1726,1151,364,0,364,0,87,0,0,empty,mBC-0814-1
"H7,A8",2125,2302,1507,795,1379,0,716,716,508,208,2.442307692,373,1345,932,257,0,257,0,81,0,0,empty,mBC-0814-1
"H7,A9",6357,6811,4590,2221,3922,0,2072,2072,1489,583,2.554030875,1073,1306,891,251,0,251,0,59,0,0,empty,mBC-0814-1
"H7,A10",3539,3836,2499,1337,2239,0,1235,1235,843,392,2.150510204,657,159,111,30,0,30,0,9,0,0,empty,mBC-0814-1
"H7,A11",4582,4727,3269,1458,2740,0,1423,1424,1013,411,2.464720195,722,1749,1292,417,0,417,0,88,0,0.002398082,empty,mBC-0814-1
"H7,A12",316471,360196,210748,149448,213676,0,129893,130022,112028,17994,6.225853062,76866,411042,301735,85938,48,85890,4,3791,0,6.98568E-05,mm10,mBC-0814-1
"H7,B1",4544,4764,3247,1517,2876,0,1574,1577,1111,466,2.384120172,828,1721,1096,350,0,350,0,89,0,0.045714286,empty,mBC-0814-1
"H7,B2",5196,5292,3532,1760,3165,0,1742,1743,1214,529,2.29489603,930,1198,520,150,0,150,0,31,0,0.04,empty,mBC-0814-1
"H7,B3",4019,4092,2898,1194,2474,0,1315,1317,953,364,2.618131868,627,967,640,204,0,204,0,41,0,0,empty,mBC-0814-1
"H7,B4",4204,4473,3029,1444,2630,0,1463,1464,1017,447,2.275167785,738,955,595,186,0,186,0,56,0,0,empty,mBC-0814-1
"H7,B5",4888,3804,2273,1531,2560,0,1536,1537,1115,422,2.642180095,896,796,529,174,0,174,0,48,0,0.040229885,empty,mBC-0814-1
"H7,B6",4037,4389,2968,1421,2623,0,1411,1415,1017,398,2.555276382,745,1735,1008,324,0,324,0,73,0,0.015432099,empty,mBC-0814-1
"H7,B7",4934,5252,3645,1607,3105,10,1646,1658,1207,451,2.676274945,873,887,650,157,0,157,0,57,0,0,empty,mBC-0814-1
"H7,B8",3786,4048,2759,1289,2298,0,1226,1226,889,337,2.637982196,639,1167,759,282,1,281,1,50,0,0,empty,mBC-0814-1
"H7,B9",450395,535349,292330,243019,316932,1,208018,208230,156219,52011,3.003576167,128842,71164,51287,14226,6,14220,1,1142,0,0.000281294,mm10,mBC-0814-1
"H7,B10",322083,361224,208624,152600,221915,1,136874,137116,109342,27774,3.936847411,82258,38293,27560,7787,7,7780,1,759,0,0.001413882,mm10,mBC-0814-1
"H7,B11",6459,6910,4703,2207,3973,0,2116,2119,1484,635,2.337007874,1108,215,169,45,0,45,0,7,0,0,empty,mBC-0814-1
"H7,B12",5530,5900,4028,1872,3454,0,1878,1883,1346,537,2.506517691,947,975,605,202,0,202,0,54,0,0.00990099,empty,mBC-0814-1
"H7,C1",570161,643726,391913,251813,377767,7,227658,227924,161588,66336,2.435902074,131874,40974,26572,7865,6,7859,1,745,0,0.00190864,mm10,mBC-0814-1
"H7,C2",5093,5566,3641,1925,3250,0,1752,1752,1225,527,2.324478178,962,1301,843,326,0,326,0,80,0,0,empty,mBC-0814-1
"H7,C3",5864,6263,4230,2033,3667,0,2038,2041,1488,553,2.690777577,1037,655,503,138,0,138,0,34,0,0,empty,mBC-0814-1
"H7,C4",5177,5617,3751,1866,3182,0,1712,1712,1259,453,2.779249448,882,1244,793,222,0,222,0,65,0,0.031531532,empty,mBC-0814-1
"H7,C5",789183,900460,528742,371718,522021,1,323389,323724,270583,53141,5.09179353,190562,168073,118315,33264,24,33240,3,2099,0,0.000511432,mm10,mBC-0814-1
"H7,C6",6438,6940,4579,2361,4149,2,2283,2292,1652,640,2.58125,1236,944,660,253,0,253,0,55,0,0,empty,mBC-0814-1
"H7,C7",728738,838139,495666,342473,484740,1,294298,294586,246345,48241,5.106548372,173230,49876,34865,9798,5,9793,3,906,0,0.002042275,mm10,mBC-0814-1
"H7,C8",5137,5520,3592,1928,3202,0,1698,1700,1207,493,2.448275862,929,5590,2471,732,0,732,0,112,0,0.024590164,empty,mBC-0814-1
"H7,C9",4816,5319,3482,1837,2991,0,1641,1644,1159,485,2.389690722,891,1328,876,195,0,195,0,67,0,0.082051282,empty,mBC-0814-1
"H7,C10",5926,6242,4350,1892,3522,0,1795,1795,1318,477,2.763102725,902,1009,660,182,0,182,0,37,0,0,empty,mBC-0814-1
"H7,C11",4507,4906,3161,1745,2927,0,1602,1602,1121,481,2.330561331,885,1446,999,295,0,295,0,64,0,0.023728814,empty,mBC-0814-1
"H7,C12",8037,8463,5758,2705,4898,0,2635,2640,1886,754,2.50132626,1369,1530,1187,350,0,350,0,56,0,0,empty,mBC-0814-1
"H7,D1",4363,4789,3080,1709,2816,0,1565,1573,1128,445,2.534831461,885,729,448,164,0,164,0,28,0,0,empty,mBC-0814-1
"H7,D2",5486,6074,4067,2007,3485,1,1830,1831,1319,512,2.576171875,984,1713,1271,373,1,372,1,81,0,0,empty,mBC-0814-1
"H7,D3",10702,11472,7656,3816,6649,0,3549,3554,2589,965,2.682901554,1850,2017,1483,487,0,487,0,93,0,0.002053388,empty,mBC-0814-1
"H7,D4",4598,4920,3256,1664,2896,0,1556,1557,1147,410,2.797560976,804,1665,1339,379,0,379,0,68,0,0,empty,mBC-0814-1
"H7,D5",282800,324394,184704,139690,194359,0,121593,121708,100352,21356,4.699007305,73512,137184,97877,27215,13,27202,3,1834,0,0,mm10,mBC-0814-1
"H7,D6",4976,5591,3582,2009,3196,0,1747,1754,1245,509,2.445972495,953,1309,908,235,0,235,0,47,0,0.076595745,empty,mBC-0814-1
"H7,D7",5721,5926,4147,1779,3456,10,1792,1802,1306,496,2.633064516,917,2510,1787,492,0,492,0,114,0,0.018292683,empty,mBC-0814-1
"H7,D8",532992,620689,344279,276410,363127,1,232495,232705,195770,36935,5.300392582,142203,195524,125841,33576,27,33549,3,2456,0,0.000357686,mm10,mBC-0814-1
"H7,D9",3181,3500,2273,1227,2026,0,1136,1136,801,335,2.391044776,635,1212,771,245,0,245,0,55,0,0.004081633,empty,mBC-0814-1
"H7,D10",465408,537269,311612,225657,319110,1,202390,202585,156654,45931,3.410637696,120716,17794,12204,3610,2,3608,1,447,0,0.000554324,mm10,mBC-0814-1
"H7,D11",4049,4447,2863,1584,2592,0,1423,1425,1025,400,2.5625,783,1991,1362,384,1,383,1,107,0,0,empty,mBC-0814-1
"H7,D12",6312,6861,4502,2359,4002,1,2232,2239,1592,647,2.460587326,1190,3315,2290,690,0,690,0,130,0,0.001449275,empty,mBC-0814-1
"H7,E1",4923,5068,3554,1514,3013,0,1604,1612,1124,488,2.303278689,827,1358,944,312,0,312,0,73,0,0.012820513,empty,mBC-0814-1
"H7,E2",379177,446702,248046,198656,266821,0,174730,174911,135503,39408,3.438464271,107195,27255,17715,4839,1,4838,1,512,0,0,mm10,mBC-0814-1
"H7,E3",3518,3871,2518,1353,2191,0,1155,1159,813,346,2.349710983,630,1176,826,266,0,266,0,56,0,0,empty,mBC-0814-1
"H7,E4",3168,3467,2298,1169,1972,0,1065,1065,785,280,2.803571429,577,1417,929,302,0,302,0,66,0,0,empty,mBC-0814-1
"H7,E5",3691,3952,2723,1229,2340,1,1195,1199,849,350,2.425714286,650,1176,736,218,0,218,0,49,0,0,empty,mBC-0814-1
"H7,E6",4613,4901,3323,1578,2795,0,1428,1432,972,460,2.113043478,732,1137,796,271,0,271,0,68,0,0.077490775,empty,mBC-0814-1
"H7,E7",5602,5766,4213,1553,3338,0,1673,1678,1187,491,2.417515275,823,1577,1128,328,0,328,0,53,0,0.00304878,empty,mBC-0814-1
"H7,E8",5001,5181,3655,1526,3057,0,1552,1556,1091,465,2.346236559,789,1927,1312,423,0,423,0,90,0,0,empty,mBC-0814-1
"H7,E9",3242,3462,2295,1167,2002,0,1099,1099,799,300,2.663333333,596,1369,870,286,0,286,0,61,0,0,empty,mBC-0814-1
"H7,E10",3883,4347,2757,1590,2575,0,1496,1500,1070,430,2.488372093,824,1819,1248,347,0,347,0,75,0,0.002881844,empty,mBC-0814-1
"H7,E11",4146,4287,2908,1379,2551,0,1374,1381,989,392,2.522959184,726,1202,786,277,0,277,0,66,0,0.003610108,empty,mBC-0814-1
"H7,E12",4022,4226,2830,1396,2450,0,1332,1334,991,343,2.889212828,708,1072,556,196,0,196,0,50,0,0,empty,mBC-0814-1
"H7,F1",4520,4780,3284,1496,2806,0,1483,1489,1057,432,2.446759259,758,1516,1028,291,0,291,0,66,0,0.003436426,empty,mBC-0814-1
"H7,F2",6260,6807,4417,2390,4041,0,2189,2192,1586,606,2.617161716,1205,2116,1511,469,0,469,0,110,0,0.02771855,empty,mBC-0814-1
"H7,F3",4928,5145,3497,1648,3069,0,1645,1645,1192,453,2.631346578,850,1887,1216,363,0,363,0,97,0,0.03030303,empty,mBC-0814-1
"H7,F4",5628,5996,3969,2027,3481,0,1875,1878,1374,504,2.726190476,1012,129,59,33,0,33,0,18,0,0,empty,mBC-0814-1
"H7,F5",5137,5354,3631,1723,3132,0,1735,1740,1209,531,2.276836158,889,1142,757,237,0,237,0,61,0,0,empty,mBC-0814-1
"H7,F6",4728,5073,3366,1707,3010,0,1650,1650,1162,488,2.381147541,896,1773,1207,368,1,367,1,94,0,0.038147139,empty,mBC-0814-1
"H7,F7",4280,4762,3108,1654,2785,1,1501,1504,1120,384,2.916666667,808,757,528,169,0,169,0,38,0,0,empty,mBC-0814-1
"H7,F8",640667,756500,420817,335683,444175,1,287673,287955,229230,58725,3.903448276,174514,19471,13828,4107,3,4104,1,448,0,0.0041423,mm10,mBC-0814-1
"H7,F9",561325,646970,375872,271098,381114,0,237677,237920,181486,56434,3.215898217,141293,140153,92921,26658,20,26638,4,1843,0,0.000262782,mm10,mBC-0814-1
"H7,F10",6643,6999,4839,2160,4083,0,2142,2144,1522,622,2.446945338,1108,1457,1038,313,0,313,0,62,0,0,empty,mBC-0814-1
"H7,F11",510521,592045,338292,253753,348712,1,220261,220504,168964,51540,3.27830811,132116,219141,144766,42520,22,42498,4,2423,0,0.000635324,mm10,mBC-0814-1
"H7,F12",4896,5428,3396,2032,3141,0,1753,1754,1221,533,2.290806754,984,72,63,7,0,7,0,6,0,0,empty,mBC-0814-1
"H7,G1",7177,7652,5249,2403,4452,0,2302,2306,1691,615,2.749593496,1160,3311,1899,618,1,617,1,158,0,0.006482982,empty,mBC-0814-1
"H7,G2",5558,5901,3948,1953,3363,0,1740,1742,1218,524,2.324427481,893,531,434,129,0,129,0,27,0,0,empty,mBC-0814-1
"H7,G3",5303,5674,3818,1856,3228,0,1755,1758,1250,508,2.460629921,910,2142,1474,466,0,466,0,92,0,0.034334764,empty,mBC-0814-1
"H7,G4",5220,5423,3793,1630,3146,0,1645,1654,1187,467,2.541755889,850,7,3,3,0,3,0,3,0,0,empty,mBC-0814-1
"H7,G5",4619,4897,3230,1667,2832,1,1487,1493,1087,406,2.677339901,800,1265,881,245,0,245,0,58,0,0,empty,mBC-0814-1
"H7,G6",9017,9460,6523,2937,5483,0,2885,2888,2040,848,2.405660377,1479,259,207,59,0,59,0,17,0,0,empty,mBC-0814-1
"H7,G7",5927,6133,4103,2030,3490,0,1868,1873,1344,529,2.540642722,990,78585,22308,7137,9,7128,3,609,0,0.154320988,empty,mBC-0814-1
"H7,G8",7142,7764,5101,2663,4520,0,2520,2523,1856,667,2.782608696,1328,3695,2499,844,0,844,0,177,0,0.001184834,empty,mBC-0814-1
"H7,G9",388915,461457,248624,212833,274859,0,182199,182337,131563,50774,2.591149013,113127,179098,125425,35282,23,35259,2,2236,0,0.000141808,mm10,mBC-0814-1
"H7,G10",630114,710434,424354,286080,418056,0,256412,256659,208341,48318,4.311871352,149704,181139,130166,37798,17,37781,3,2287,0,0,mm10,mBC-0814-1
"H7,G11",9425,10124,6724,3400,5837,0,3089,3096,2230,866,2.575057737,1659,1742,1236,381,0,381,0,84,0,0,empty,mBC-0814-1
"H7,G12",4612,5059,3270,1789,3029,0,1698,1699,1203,496,2.425403226,929,2034,1367,421,0,421,0,97,0,0,empty,mBC-0814-1
"H7,H1",4423,4877,3110,1767,2854,0,1568,1572,1113,459,2.424836601,868,853,624,205,1,204,1,52,0,0,empty,mBC-0814-1
"H7,H2",7812,8721,5531,3190,4883,1,2690,2694,1918,776,2.471649485,1423,3612,2548,723,0,723,0,137,0,0,empty,mBC-0814-1
"H7,H3",5287,5671,3758,1913,3268,0,1764,1764,1240,524,2.366412214,929,1682,1149,321,0,321,0,89,0,0.003115265,empty,mBC-0814-1
"H7,H4",5257,5708,3785,1923,3314,0,1780,1786,1257,529,2.376181474,980,29,24,18,0,18,0,10,0,0,empty,mBC-0814-1
"H7,H5",6730,7284,4735,2549,4131,0,2262,2267,1576,691,2.280752533,1252,2288,1501,431,0,431,0,71,0,0.023201856,empty,mBC-0814-1
"H7,H6",577289,660956,386254,274702,386720,0,235981,236255,193596,42659,4.538221712,140382,368551,265809,75013,46,74967,5,3322,0,0.000373498,mm10,mBC-0814-1
"H7,H7",5538,6195,3923,2272,3622,0,1976,1980,1419,561,2.529411765,1096,2227,1605,446,0,446,0,74,0,0.056053812,empty,mBC-0814-1
"H7,H8",4355,4932,3112,1820,2790,5,1608,1613,1183,430,2.751162791,858,1700,1263,382,0,382,0,91,0,0.007853403,empty,mBC-0814-1
"H7,H9",4797,5146,3448,1698,2966,0,1566,1572,1132,440,2.572727273,835,1905,1011,349,0,349,0,57,0,0.071633238,empty,mBC-0814-1
"H7,H10",4042,4118,2586,1532,2375,0,1337,1341,912,429,2.125874126,747,84307,25730,8539,15,8524,3,678,0,0.08212107,empty,mBC-0814-1
"H7,H11",3919,4465,2705,1760,2528,0,1424,1427,977,450,2.171111111,831,48,28,3,0,3,0,1,0,0,empty,mBC-0814-1
"H7,H12",2715,2903,1930,973,1738,0,904,906,651,255,2.552941176,494,2007,1513,431,1,430,1,76,0,0,empty,mBC-0814-1
"H8,A1",5662,6098,4085,2013,3621,0,1978,1979,1434,545,2.631192661,1052,1575,1138,328,0,328,0,68,0,0,empty,mBC-0814-1
"H8,A2",5391,5955,3834,2121,3451,0,1833,1834,1355,479,2.828810021,997,1122,799,305,0,305,0,82,0,0.026229508,empty,mBC-0814-1
"H8,A3",4705,4881,3439,1442,2787,0,1447,1450,1058,392,2.698979592,700,951,597,196,0,196,0,46,0,0,empty,mBC-0814-1
"H8,A4",5501,5953,4054,1899,3419,0,1787,1793,1275,518,2.461389961,910,2685,1032,331,0,331,0,34,0,0.069486405,empty,mBC-0814-1
"H8,A5",5001,5327,3554,1773,3172,0,1730,1732,1242,490,2.534693878,947,1052,691,206,1,205,1,53,0,0.004878049,empty,mBC-0814-1
"H8,A6",3872,4188,2772,1416,2422,0,1310,1310,913,397,2.299748111,668,1167,799,228,0,228,0,47,0,0.030701754,empty,mBC-0814-1
"H8,A7",5582,5958,4024,1934,3492,0,1910,1910,1373,537,2.55679702,980,1001,768,232,0,232,0,62,0,0,empty,mBC-0814-1
"H8,A8",239109,285633,159318,126315,171220,0,108607,108735,87491,21244,4.118386368,66239,139004,101597,28825,15,28810,3,1937,0,0.000104131,mm10,mBC-0814-1
"H8,A9",6992,7576,4896,2680,4376,0,2323,2330,1669,661,2.524962179,1342,40152,12412,3917,2,3915,2,353,0,0.107024266,empty,mBC-0814-1
"H8,A10",3712,4094,2641,1453,2367,0,1322,1322,949,373,2.544235925,733,162,94,31,0,31,0,10,0,0,empty,mBC-0814-1
"H8,A11",4933,5320,3478,1842,3046,9,1678,1690,1174,516,2.275193798,897,1923,1310,382,1,381,1,79,0,0,empty,mBC-0814-1
"H8,A12",4015,4245,2890,1355,2542,0,1383,1385,1001,384,2.606770833,713,2749,1880,614,0,614,0,147,0,0.034201954,empty,mBC-0814-1
"H8,B1",4658,5080,3302,1778,3029,0,1693,1697,1197,500,2.394,981,1267,918,295,1,294,1,63,0,0,empty,mBC-0814-1
"H8,B2",701728,810536,457259,353277,470476,0,296422,296764,236350,60414,3.912172675,179801,69389,49559,14033,9,14024,2,1182,0,0.001853965,mm10,mBC-0814-1
"H8,B3",3895,4297,2846,1451,2531,0,1381,1384,963,421,2.287410926,716,1167,837,260,0,260,0,49,0,0,empty,mBC-0814-1
"H8,B4",4329,4758,3049,1709,2733,0,1526,1526,1080,446,2.421524664,829,1331,1001,279,0,279,0,52,0,0,empty,mBC-0814-1
"H8,B5",727897,520037,288774,231263,367977,3,233345,234198,187715,46483,4.038358109,145981,221067,153652,42824,36,42788,6,2501,0,0.001542489,mm10,mBC-0814-1
"H8,B6",4230,4563,3006,1557,2629,5,1413,1420,996,424,2.349056604,752,1342,979,227,0,227,0,42,0,0.083700441,empty,mBC-0814-1
"H8,B7",4909,5241,3473,1768,3074,0,1641,1642,1245,397,3.136020151,868,789,574,171,0,171,0,52,0,0,empty,mBC-0814-1
"H8,B8",3765,3997,2753,1244,2349,0,1239,1239,908,331,2.743202417,630,647,359,120,1,119,1,40,0,0,empty,mBC-0814-1
"H8,B9",4630,4972,3366,1606,2884,0,1544,1547,1072,475,2.256842105,806,680,452,129,0,129,0,47,0,0,empty,mBC-0814-1
"H8,B10",4202,4315,2985,1330,2640,3,1397,1403,972,431,2.255220418,710,356,254,85,0,85,0,26,0,0.047058824,empty,mBC-0814-1
"H8,B11",6561,6834,4719,2115,3982,0,2111,2114,1539,575,2.676521739,1136,156,128,44,0,44,0,11,0,0,empty,mBC-0814-1
"H8,B12",5362,5789,3877,1912,3291,1,1768,1775,1243,532,2.336466165,932,3637,1300,363,1,362,1,65,0,0,empty,mBC-0814-1
"H8,C1",5684,5954,4046,1908,3405,0,1777,1781,1272,509,2.499017682,927,748,449,153,0,153,0,39,0,0,empty,mBC-0814-1
"H8,C2",5598,6044,4007,2037,3468,1,1916,1919,1363,556,2.451438849,1009,1278,891,278,0,278,0,84,0,0,empty,mBC-0814-1
"H8,C3",7524,8253,5338,2915,4793,0,2697,2699,2014,685,2.940145985,1478,610,406,108,0,108,0,34,0,0,empty,mBC-0814-1
"H8,C4",546291,635840,360052,275788,374231,0,235747,235989,182489,53500,3.411009346,141840,271106,197248,56027,28,55999,2,2864,0,0,mm10,mBC-0814-1
"H8,C5",7251,7760,5187,2573,4534,0,2400,2403,1693,710,2.384507042,1280,1356,972,271,1,270,1,67,0,0.014814815,empty,mBC-0814-1
"H8,C6",5228,5671,3629,2042,3394,0,1862,1864,1327,537,2.47113594,1029,1236,931,281,0,281,0,67,0,0,empty,mBC-0814-1
"H8,C7",7262,7878,5219,2659,4566,0,2415,2423,1765,658,2.682370821,1286,334,231,82,0,82,0,23,0,0,empty,mBC-0814-1
"H8,C8",5525,6058,3893,2165,3558,0,1939,1941,1379,562,2.453736655,1070,1225,848,277,2,275,1,69,0,0,empty,mBC-0814-1
"H8,C9",4835,5275,3343,1932,3146,0,1787,1789,1298,491,2.643584521,1007,915,659,162,0,162,0,51,0,0,empty,mBC-0814-1
"H8,C10",5639,6011,4116,1895,3382,0,1726,1728,1211,517,2.342359768,875,850,454,133,0,133,0,44,0,0,empty,mBC-0814-1
"H8,C11",4693,4969,3274,1695,2929,0,1581,1583,1172,411,2.851581509,885,804,521,186,1,185,1,41,0,0.021621622,empty,mBC-0814-1
"H8,C12",8090,8981,5702,3279,5187,0,2912,2912,1998,914,2.185995624,1628,1941,1389,346,0,346,0,74,0,0,empty,mBC-0814-1
"H8,D1",4334,4506,3128,1378,2697,0,1427,1429,963,466,2.066523605,723,487,276,78,0,78,0,26,0,0,empty,mBC-0814-1
"H8,D2",1302938,1458087,900888,557199,833832,7,497064,497637,406365,91272,4.452241651,283456,408971,294135,83626,48,83578,2,3751,0,0.000167508,mm10,mBC-0814-1
"H8,D3",11104,12221,7884,4337,7162,0,3906,3913,2783,1130,2.462831858,2170,2237,1586,474,1,473,1,106,0,0,empty,mBC-0814-1
"H8,D4",4600,5091,3245,1846,2965,0,1630,1630,1210,420,2.880952381,898,999,644,221,0,221,0,56,0,0.085972851,empty,mBC-0814-1
"H8,D5",4859,5149,3541,1608,3027,0,1640,1642,1190,452,2.632743363,848,1691,1146,349,0,349,0,91,0,0.042979943,empty,mBC-0814-1
"H8,D6",4778,4991,3484,1507,2928,0,1531,1536,1130,406,2.783251232,822,917,581,206,1,205,1,47,0,0.009756098,empty,mBC-0814-1
"H8,D7",11067,12036,7883,4153,7085,7,4035,4047,2873,1174,2.447189097,2175,2207,1464,442,0,442,0,98,0,0,empty,mBC-0814-1
"H8,D8",4955,5429,3452,1977,3071,0,1691,1691,1174,517,2.270793037,928,1278,686,208,0,208,0,55,0,0.014423077,empty,mBC-0814-1
"H8,D9",3124,3391,2194,1197,1980,0,1095,1098,782,316,2.474683544,572,1147,772,207,1,206,1,40,0,0,empty,mBC-0814-1
"H8,D10",3701,4146,2605,1541,2403,0,1316,1321,953,368,2.589673913,744,593,391,138,0,138,0,48,0,0,empty,mBC-0814-1
"H8,D11",523849,613504,349152,264352,358433,0,224754,225019,185824,39195,4.741012884,134672,243032,178723,48638,30,48608,4,2740,0,6.17182E-05,mm10,mBC-0814-1
"H8,D12",675725,870020,402226,467794,511697,0,381864,382222,203346,178876,1.136798676,253523,111648,66135,17934,21,17913,5,1656,0,0.004131078,mm10,mBC-0814-1
"H8,E1",5007,5171,3692,1479,3043,1,1547,1552,1093,459,2.381263617,755,1416,1040,344,1,343,1,74,0,0,empty,mBC-0814-1
"H8,E2",3766,3888,2650,1238,2261,0,1201,1201,839,362,2.317679558,626,16296,4968,1677,2,1675,2,176,0,0.064477612,empty,mBC-0814-1
"H8,E3",3439,3703,2506,1197,2162,0,1158,1163,846,317,2.668769716,611,1070,818,247,0,247,0,65,0,0.068825911,empty,mBC-0814-1
"H8,E4",3001,3280,2199,1081,1944,0,1038,1038,747,291,2.567010309,558,985,710,205,0,205,0,39,0,0,empty,mBC-0814-1
"H8,E5",3730,3920,2753,1167,2267,0,1175,1177,848,329,2.577507599,582,537,354,112,0,112,0,25,0,0,empty,mBC-0814-1
"H8,E6",4417,4737,3201,1536,2724,0,1460,1462,1057,405,2.609876543,756,1015,692,203,0,203,0,68,0,0.009852217,empty,mBC-0814-1
"H8,E7",4533,4975,3262,1713,2794,0,1457,1460,1055,405,2.604938272,795,1002,742,187,0,187,0,45,0,0.042780749,empty,mBC-0814-1
"H8,E8",4772,4904,3410,1494,2874,0,1512,1514,1081,433,2.496535797,751,1420,947,294,0,294,0,57,0,0,empty,mBC-0814-1
"H8,E9",363619,428374,242418,185956,252706,0,161018,161206,125770,35436,3.549215487,97445,211480,151749,44009,27,43982,6,2447,0,0.00072757,mm10,mBC-0814-1
"H8,E10",4120,4599,2968,1631,2673,0,1454,1456,1024,432,2.37037037,824,2475,1260,402,0,402,0,83,0,0.037313433,empty,mBC-0814-1
"H8,E11",4417,4738,3185,1553,2761,0,1461,1461,1036,425,2.437647059,774,16385,5259,1636,6,1630,3,206,0,0.102453988,empty,mBC-0814-1
"H8,E12",448984,530140,300129,230011,313043,0,196971,197206,163537,33669,4.857198016,118610,156414,111218,31772,20,31752,2,2018,0,0.000220459,mm10,mBC-0814-1
"H8,F1",528239,612963,354013,258950,360267,0,226330,226622,191811,34811,5.510068656,135013,146783,96594,27181,24,27157,3,1867,0,0.000994219,mm10,mBC-0814-1
"H8,F2",731904,853775,489345,364430,495912,5,313576,313950,261097,52853,4.940060167,187817,181890,122040,35667,12,35655,2,2105,0,0.001542561,mm10,mBC-0814-1
"H8,F3",5087,5391,3587,1804,3198,0,1769,1775,1288,487,2.64476386,962,1510,950,344,0,344,0,86,0,0,empty,mBC-0814-1
"H8,F4",6862,7359,4858,2501,4393,1,2377,2384,1749,635,2.754330709,1294,465,305,121,0,121,0,25,0,0,empty,mBC-0814-1
"H8,F5",4939,5227,3577,1650,3055,0,1651,1651,1195,456,2.620614035,840,842,610,167,0,167,0,44,0,0.011976048,empty,mBC-0814-1
"H8,F6",5212,5551,3722,1829,3156,0,1745,1748,1230,518,2.374517375,912,1636,1193,367,0,367,0,101,0,0,empty,mBC-0814-1
"H8,F7",7938,9189,5337,3852,5358,0,3250,3253,1528,1725,0.885797101,1936,1254,578,161,0,161,0,41,0,0.02484472,empty,mBC-0814-1
"H8,F8",6165,6603,4266,2337,3928,0,2138,2142,1463,679,2.154639175,1196,130,60,20,0,20,0,9,0,0,empty,mBC-0814-1
"H8,F9",13981,15351,10050,5301,8824,0,4780,4793,3419,1374,2.488355167,2535,4339,3331,915,0,915,0,137,0,0,empty,mBC-0814-1
"H8,F10",6427,6845,4554,2291,4049,0,2126,2128,1553,575,2.700869565,1181,1577,1206,317,0,317,0,82,0,0,empty,mBC-0814-1
"H8,F11",4516,4756,3210,1546,2725,0,1452,1456,1024,432,2.37037037,748,783,552,220,0,220,0,49,0,0.018181818,empty,mBC-0814-1
"H8,F12",4810,5308,3437,1871,3081,1,1679,1684,1160,524,2.213740458,974,84,31,13,0,13,0,10,0,0,empty,mBC-0814-1
"H8,G1",415710,473688,280878,192810,280427,0,170801,170980,142013,28967,4.902578797,100766,188807,137460,38237,24,38213,1,2513,0,0.000837411,mm10,mBC-0814-1
"H8,G2",5777,5826,4139,1687,3381,0,1778,1779,1252,527,2.375711575,858,412,349,116,0,116,0,20,0,0,empty,mBC-0814-1
"H8,G3",5168,5689,3690,1999,3301,0,1753,1759,1225,534,2.294007491,968,1884,1329,364,1,363,1,89,0,0,empty,mBC-0814-1
"H8,G4",5054,5366,3592,1774,3187,0,1717,1719,1185,534,2.219101124,910,23,20,10,0,10,0,2,0,0,empty,mBC-0814-1
"H8,G5",4734,5020,3486,1534,2926,0,1557,1557,1061,496,2.139112903,772,1353,950,250,0,250,0,55,0,0,empty,mBC-0814-1
"H8,G6",8995,9559,6554,3005,5575,0,2875,2885,2090,795,2.628930818,1474,50,41,21,0,21,0,9,0,0,empty,mBC-0814-1
"H8,G7",5547,5978,3968,2010,3511,0,1898,1900,1301,599,2.171953255,1008,1703,1138,319,0,319,0,84,0,0.015673981,empty,mBC-0814-1
"H8,G8",8261,9340,5703,3637,5430,0,3156,3159,2260,899,2.513904338,1824,3113,2136,657,0,657,0,144,0,0,empty,mBC-0814-1
"H8,G9",5716,6229,4070,2159,3659,0,2039,2041,1460,581,2.512908778,1049,2941,2200,606,0,606,0,104,0,0,empty,mBC-0814-1
"H8,G10",544372,613059,367687,245372,360674,1,220419,220647,178844,41803,4.278257541,128096,148881,109849,31709,14,31695,3,1987,0,0,mm10,mBC-0814-1
"H8,G11",9339,9868,6756,3112,5746,0,3090,3092,2184,908,2.405286344,1580,3502,1467,400,0,400,0,95,0,0,empty,mBC-0814-1
"H8,G12",537566,614471,355031,259440,365569,1,232233,232526,174237,58289,2.989191786,138895,57903,40440,11426,8,11418,1,1086,0,0.00779471,mm10,mBC-0814-1
"H8,H1",4701,4968,3388,1580,2915,0,1590,1590,1147,443,2.589164786,812,6800,2346,673,0,673,0,90,0,0.089153046,empty,mBC-0814-1
"H8,H2",678184,747678,474625,273053,434458,0,253674,253999,196502,57497,3.417604397,143416,57120,35416,9875,7,9868,1,1027,0,0.004864208,mm10,mBC-0814-1
"H8,H3",5589,5899,4022,1877,3525,0,1905,1909,1361,548,2.483576642,997,1590,1097,354,0,354,0,72,0,0,empty,mBC-0814-1
"H8,H4",5557,5846,3941,1905,3381,0,1829,1834,1306,528,2.473484848,925,1504,478,151,0,151,0,24,0,0.052980132,empty,mBC-0814-1
"H8,H5",6689,7189,4726,2463,4117,0,2256,2258,1626,632,2.57278481,1180,9376,3380,1059,1,1058,1,108,0,0.259924386,empty,mBC-0814-1
"H8,H6",576828,639387,396254,243133,374055,0,223295,223525,167259,56266,2.97264778,128674,47014,34205,9564,9,9555,3,934,0,0,mm10,mBC-0814-1
"H8,H7",5565,6007,3882,2125,3523,0,1961,1963,1422,541,2.628465804,1060,1543,1135,307,1,306,1,58,0,0,empty,mBC-0814-1
"H8,H8",11473,13202,7854,5348,7876,0,4731,4736,3530,1206,2.927031509,2742,1948,1314,347,0,347,0,76,0,0,empty,mBC-0814-1
"H8,H9",6260,6814,4334,2480,3936,0,2175,2181,1560,621,2.512077295,1205,1079,786,233,1,232,1,55,0,0,empty,mBC-0814-1
"H8,H10",3605,4091,2537,1554,2303,0,1299,1299,938,361,2.59833795,737,853,575,177,0,177,0,48,0,0,empty,mBC-0814-1
"H8,H11",469256,563425,308910,254515,332021,3,212047,212289,164350,47939,3.428315151,130567,7021,5054,1346,0,1346,0,192,0,0,mm10,mBC-0814-1
"H8,H12",2707,2953,1978,975,1733,0,937,940,641,299,2.143812709,491,4997,1967,624,2,622,2,103,0,0.04340836,empty,mBC-0814-1
"H9,A1",5490,6009,3970,2039,3476,0,1867,1871,1310,561,2.335115865,1012,1297,943,251,0,251,0,49,0,0.011952191,empty,mBC-0814-1
"H9,A2",4894,5223,3562,1661,3048,0,1624,1630,1181,449,2.630289532,869,1593,1147,312,0,312,0,74,0,0,empty,mBC-0814-1
"H9,A3",4604,4946,3332,1614,2891,0,1548,1551,1088,463,2.349892009,828,1064,629,219,0,219,0,44,0,0.00456621,empty,mBC-0814-1
"H9,A4",5449,5758,3958,1800,3296,0,1730,1739,1243,496,2.506048387,857,298,190,80,0,80,0,19,0,0,empty,mBC-0814-1
"H9,A5",4652,5003,3330,1673,2879,0,1557,1560,1069,491,2.177189409,786,2151,1127,333,0,333,0,57,0,0,empty,mBC-0814-1
"H9,A6",3619,3856,2570,1286,2263,0,1238,1239,880,359,2.451253482,666,767,517,133,0,133,0,42,0,0.007518797,empty,mBC-0814-1
"H9,A7",5112,5679,3591,2088,3385,0,1876,1885,1317,568,2.318661972,1021,1023,711,201,0,201,0,56,0,0,empty,mBC-0814-1
"H9,A8",2309,2393,1635,758,1414,0,793,793,571,222,2.572072072,403,1498,728,231,0,231,0,57,0,0,empty,mBC-0814-1
"H9,A9",6039,6311,4417,1894,3685,0,1948,1948,1419,529,2.68241966,985,1642,1152,398,1,397,1,74,0,0,empty,mBC-0814-1
"H9,A10",3275,3659,2302,1357,2074,0,1129,1134,802,332,2.415662651,626,195,140,51,0,51,0,11,0,0,empty,mBC-0814-1
"H9,A11",316328,370070,205073,164997,221779,2,142792,142940,117393,25547,4.595177516,87360,107879,76178,21879,10,21869,1,1590,0,0.000731629,mm10,mBC-0814-1
"H9,A12",3544,3693,2520,1173,2222,0,1216,1218,885,333,2.657657658,655,1592,985,391,1,390,1,120,0,0.005128205,empty,mBC-0814-1
"H9,B1",506155,577926,334974,242952,341200,0,210701,210922,172694,38228,4.517474103,125252,222165,154595,45078,32,45046,3,2527,0,0.001087777,mm10,mBC-0814-1
"H9,B2",4756,5112,3326,1786,3066,0,1665,1667,1210,457,2.647702407,914,391,194,60,0,60,0,23,0,0,empty,mBC-0814-1
"H9,B3",4233,4647,3009,1638,2723,0,1516,1522,1123,399,2.814536341,803,1101,748,227,0,227,0,46,0,0.092511013,empty,mBC-0814-1
"H9,B4",852073,1006180,558285,447895,595869,0,384447,384869,294397,90472,3.254012291,236450,190423,132283,37768,19,37749,3,2329,0,0.000794723,mm10,mBC-0814-1
"H9,B5",3429,2333,1483,850,1676,0,943,945,649,296,2.192567568,546,575,290,111,0,111,0,38,0,0,empty,mBC-0814-1
"H9,B6",10714,13659,6284,7375,8047,0,5663,5665,1770,3895,0.454428755,3892,2982,1454,348,0,348,0,59,0,0,empty,mBC-0814-1
"H9,B7",5135,5568,3670,1898,3297,2,1777,1788,1254,534,2.348314607,971,986,681,204,0,204,0,44,0,0.024509804,empty,mBC-0814-1
"H9,B8",3541,3795,2520,1275,2282,1,1250,1256,894,362,2.46961326,687,1052,673,219,1,218,1,45,0,0,empty,mBC-0814-1
"H9,B9",356818,413832,238869,174963,245224,0,151743,151926,126997,24929,5.094347948,90735,40214,28000,8024,6,8018,1,916,0,0.000498878,mm10,mBC-0814-1
"H9,B10",3979,4047,2840,1207,2492,1,1295,1302,960,342,2.807017544,674,6933,2410,737,0,737,0,76,0,0.029850746,empty,mBC-0814-1
"H9,B11",7097,7557,5042,2515,4419,0,2347,2347,1699,648,2.62191358,1267,160,107,41,0,41,0,19,0,0,empty,mBC-0814-1
"H9,B12",5051,5435,3553,1882,3200,0,1799,1802,1259,543,2.318600368,958,815,460,160,0,160,0,44,0,0,empty,mBC-0814-1
"H9,C1",5303,5545,3833,1712,3221,0,1701,1701,1232,469,2.626865672,905,430,241,87,0,87,0,27,0,0,empty,mBC-0814-1
"H9,C2",5153,5424,3645,1779,3122,2,1689,1694,1148,546,2.102564103,880,1580,1153,305,1,304,1,62,0,0,empty,mBC-0814-1
"H9,C3",5833,6236,4142,2094,3647,0,1988,1990,1462,528,2.768939394,1050,425,294,90,0,90,0,26,0,0,empty,mBC-0814-1
"H9,C4",453645,490829,313107,177722,292700,0,170670,170872,136170,34702,3.923981327,95893,12518,8866,2582,0,2582,0,388,0,0,mm10,mBC-0814-1
"H9,C5",6802,7377,4796,2581,4251,0,2281,2285,1678,607,2.764415157,1248,1268,923,290,0,290,0,67,0,0.037931034,empty,mBC-0814-1
"H9,C6",5415,5609,3845,1764,3408,0,1840,1842,1362,480,2.8375,950,985,679,245,0,245,0,63,0,0,empty,mBC-0814-1
"H9,C7",6899,7113,4780,2333,4146,0,2211,2217,1538,679,2.265095729,1126,5554,1676,523,4,519,1,66,0,0.04238921,empty,mBC-0814-1
"H9,C8",5241,5370,3761,1609,3132,0,1632,1637,1164,473,2.460887949,826,1619,1139,333,0,333,0,60,0,0,empty,mBC-0814-1
"H9,C9",4473,4792,3195,1597,2788,0,1490,1493,1084,409,2.650366748,812,1217,754,261,1,260,1,54,0,0.057692308,empty,mBC-0814-1
"H9,C10",6363,6723,4633,2090,3855,3,2004,2016,1413,603,2.343283582,1044,5244,2046,618,0,618,0,75,0,0.053398058,empty,mBC-0814-1
"H9,C11",396138,467827,262045,205782,277835,1,174151,174356,147985,26371,5.611656744,105877,239257,172705,49962,27,49935,2,2839,0,0.000400521,mm10,mBC-0814-1
"H9,C12",7998,8686,5648,3038,5067,0,2798,2801,1979,822,2.407542579,1559,1734,1147,331,0,331,0,71,0,0.01510574,empty,mBC-0814-1
"H9,D1",4128,4367,2901,1466,2647,0,1421,1422,993,429,2.314685315,765,509,314,117,1,116,1,33,0,0,empty,mBC-0814-1
"H9,D2",5087,5350,3769,1581,3087,0,1571,1573,1079,494,2.184210526,809,1442,1106,355,1,354,1,66,0,0.02259887,empty,mBC-0814-1
"H9,D3",10105,10783,7258,3525,6242,1,3366,3374,2374,1000,2.374,1755,2220,1532,477,0,477,0,98,0,0.006289308,empty,mBC-0814-1
"H9,D4",4042,4257,2871,1386,2513,0,1364,1366,938,428,2.191588785,699,1137,774,262,0,262,0,53,0,0,empty,mBC-0814-1
"H9,D5",3800,4178,2686,1492,2447,4,1369,1373,956,417,2.292565947,721,1997,1388,416,0,416,0,84,0,0.110576923,empty,mBC-0814-1
"H9,D6",4764,5288,3400,1888,3097,0,1761,1762,1290,472,2.733050847,943,989,710,207,0,207,0,49,0,0,empty,mBC-0814-1
"H9,D7",451975,517731,292381,225350,304124,0,194318,194524,160883,33641,4.782348919,117194,157556,111025,31157,19,31138,3,2106,0,0.000931338,mm10,mBC-0814-1
"H9,D8",5189,5860,3733,2127,3388,0,1885,1885,1316,569,2.312829525,1018,741,523,157,0,157,0,40,0,0,empty,mBC-0814-1
"H9,D9",2862,3177,2010,1167,1887,0,1058,1059,759,300,2.53,608,1460,1007,277,0,277,0,46,0,0,empty,mBC-0814-1
"H9,D10",4347,4793,3150,1643,2766,0,1539,1543,1117,426,2.622065728,821,669,494,150,0,150,0,32,0,0,empty,mBC-0814-1
"H9,D11",3784,4164,2755,1409,2436,0,1313,1313,954,359,2.657381616,701,1722,1231,414,0,414,0,101,0,0,empty,mBC-0814-1
"H9,D12",5979,6474,4188,2286,3752,0,2085,2088,1407,681,2.066079295,1142,3032,1943,643,0,643,0,111,0,0.026438569,empty,mBC-0814-1
"H9,E1",5250,5802,3874,1928,3347,0,1747,1747,1255,492,2.550813008,935,1309,872,263,0,263,0,68,0,0.003802281,empty,mBC-0814-1
"H9,E2",3379,3541,2454,1087,2141,0,1136,1139,799,340,2.35,578,1009,707,208,0,208,0,52,0,0,empty,mBC-0814-1
"H9,E3",3310,3471,2417,1054,2040,0,1096,1097,775,322,2.406832298,523,986,666,214,0,214,0,46,0,0,empty,mBC-0814-1
"H9,E4",2940,3057,2094,963,1757,13,915,930,659,271,2.431734317,478,896,617,173,0,173,0,37,0,0,empty,mBC-0814-1
"H9,E5",3708,3934,2669,1265,2266,0,1181,1181,821,360,2.280555556,618,1067,671,191,0,191,0,31,0,0.005235602,empty,mBC-0814-1
"H9,E6",4485,4802,3327,1475,2802,0,1499,1503,1038,465,2.232258065,774,1243,939,265,0,265,0,44,0,0.067924528,empty,mBC-0814-1
"H9,E7",4274,4614,3119,1495,2640,0,1374,1374,1015,359,2.82729805,754,7682,2645,757,0,757,0,92,0,0.005284016,empty,mBC-0814-1
"H9,E8",4535,4809,3324,1485,2721,1,1405,1412,1018,394,2.583756345,705,1812,1406,439,0,439,0,66,0,0.029612756,empty,mBC-0814-1
"H9,E9",3112,3156,2182,974,1832,0,965,967,677,290,2.334482759,510,1528,1199,369,0,369,0,66,0,0,empty,mBC-0814-1
"H9,E10",391903,466077,258340,207737,276801,1,176275,176472,143633,32839,4.373854259,107294,262881,192349,56230,31,56199,3,2669,0,0.000284703,mm10,mBC-0814-1
"H9,E11",3799,3955,2771,1184,2394,0,1246,1246,892,354,2.519774011,624,1166,848,308,0,308,0,52,0,0.051948052,empty,mBC-0814-1
"H9,E12",473595,535428,320238,215190,318017,0,197510,197734,153092,44642,3.429326643,116160,11358,7921,2416,2,2414,1,313,0,0.001657001,mm10,mBC-0814-1
"H9,F1",4466,4812,3226,1586,2759,3,1514,1519,1086,433,2.508083141,763,3224,1191,352,1,351,1,56,0,0.028490028,empty,mBC-0814-1
"H9,F2",6171,6541,4514,2027,3806,0,1983,1986,1450,536,2.705223881,1022,1421,947,277,1,276,1,72,0,0,empty,mBC-0814-1
"H9,F3",4859,5094,3491,1603,3051,0,1615,1621,1167,454,2.570484581,839,1484,1131,332,0,332,0,72,0,0,empty,mBC-0814-1
"H9,F4",5013,5344,3552,1792,3157,0,1694,1694,1208,486,2.485596708,860,610,403,137,1,136,1,31,0,0,empty,mBC-0814-1
"H9,F5",7699,8575,5674,2901,4924,0,2696,2697,2092,605,3.45785124,1435,2921,2152,658,1,657,1,104,0,0.01217656,empty,mBC-0814-1
"H9,F6",4443,4559,3160,1399,2723,0,1432,1435,1028,407,2.525798526,738,1954,1441,372,0,372,0,81,0,0.018817204,empty,mBC-0814-1
"H9,F7",4177,4477,3050,1427,2646,0,1416,1423,954,469,2.034115139,739,505,317,90,0,90,0,23,0,0,empty,mBC-0814-1
"H9,F8",50598,62683,30852,31831,37816,0,27226,27248,13665,13583,1.006036958,17664,1562,662,204,1,203,1,38,0,0,empty,mBC-0814-1
"H9,F9",10465,11592,7553,4039,6782,0,3797,3801,2837,964,2.942946058,2071,2578,1793,546,0,546,0,106,0,0.027472527,empty,mBC-0814-1
"H9,F10",6143,6815,4434,2381,3955,2,2098,2100,1476,624,2.365384615,1141,1168,820,264,0,264,0,65,0,0,empty,mBC-0814-1
"H9,F11",4314,4682,3075,1607,2706,0,1482,1489,1066,423,2.520094563,792,1102,768,230,0,230,0,43,0,0,empty,mBC-0814-1
"H9,F12",4513,4907,3257,1650,2905,0,1629,1630,1147,483,2.374741201,885,62,48,18,0,18,0,2,0,0,empty,mBC-0814-1
"H9,G1",7111,7784,5080,2704,4552,0,2458,2459,1699,760,2.235526316,1342,3451,2565,733,0,733,0,135,0,0.02728513,empty,mBC-0814-1
"H9,G2",5501,5664,3962,1702,3401,0,1850,1852,1366,486,2.810699588,932,212,161,52,0,52,0,14,0,0,empty,mBC-0814-1
"H9,G3",4647,5149,3321,1828,3068,0,1718,1718,1300,418,3.110047847,936,1851,1279,292,0,292,0,72,0,0.017123288,empty,mBC-0814-1
"H9,G4",5206,5608,3780,1828,3202,0,1753,1755,1260,495,2.545454545,880,163,122,32,0,32,0,5,0,0,empty,mBC-0814-1
"H9,G5",4345,4650,3089,1561,2786,0,1544,1544,1077,467,2.30620985,809,1105,807,243,1,242,1,54,0,0,empty,mBC-0814-1
"H9,G6",15606,16725,11088,5637,9802,0,5365,5371,3983,1388,2.869596542,2899,260,161,77,0,77,0,23,0,0,empty,mBC-0814-1
"H9,G7",5072,5400,3614,1786,3155,0,1714,1714,1200,514,2.33463035,896,1917,1416,431,0,431,0,71,0,0,empty,mBC-0814-1
"H9,G8",6586,7299,4687,2612,4277,0,2371,2377,1659,718,2.310584958,1295,3360,2242,684,3,681,2,127,0,0,empty,mBC-0814-1
"H9,G9",4978,5425,3515,1910,3078,0,1722,1723,1226,497,2.466800805,921,2623,1876,585,1,584,1,117,0,0.022260274,empty,mBC-0814-1
"H9,G10",8562,9000,6117,2883,5252,0,2748,2756,1950,806,2.419354839,1449,2960,1748,524,0,524,0,133,0,0,empty,mBC-0814-1
"H9,G11",8799,9153,6316,2837,5457,0,2882,2884,2104,780,2.697435897,1470,1181,779,265,0,265,0,53,0,0,empty,mBC-0814-1
"H9,G12",4398,4744,3177,1567,2861,0,1511,1513,1087,426,2.551643192,827,1751,1271,426,0,426,0,87,0,0,empty,mBC-0814-1
"H9,H1",519607,605112,348272,256840,356661,1,223515,223769,182504,41265,4.422731128,133801,72550,52379,14976,11,14965,2,1232,0,0.000133645,mm10,mBC-0814-1
"H9,H2",7460,7893,5264,2629,4758,0,2604,2610,1852,758,2.443271768,1369,2419,1706,542,0,542,0,106,0,0,empty,mBC-0814-1
"H9,H3",5157,5459,3602,1857,3199,0,1701,1702,1212,490,2.473469388,929,1261,882,198,0,198,0,45,0,0.01010101,empty,mBC-0814-1
"H9,H4",5430,5746,3897,1849,3335,0,1796,1798,1247,551,2.263157895,925,172,97,34,0,34,0,14,0,0,empty,mBC-0814-1
"H9,H5",6640,7236,4854,2382,4153,0,2214,2218,1581,637,2.481946625,1182,1922,1365,386,0,386,0,66,0,0,empty,mBC-0814-1
"H9,H6",6059,6529,4263,2266,3890,1,2158,2161,1522,639,2.381846635,1180,14368,5199,1707,2,1705,1,209,0,0.078592375,empty,mBC-0814-1
"H9,H7",4846,5255,3434,1821,3142,0,1683,1690,1190,500,2.38,912,5059,2006,591,3,588,1,78,0,0.115646259,empty,mBC-0814-1
"H9,H8",452968,515783,305422,210361,303688,1,185395,185633,147531,38102,3.87200147,109321,134443,94767,27622,19,27603,2,1976,0,0.000652103,mm10,mBC-0814-1
"H9,H9",4252,4514,3082,1432,2653,0,1425,1429,1039,390,2.664102564,748,1127,770,233,0,233,0,45,0,0,empty,mBC-0814-1
"H9,H10",3565,3867,2616,1251,2231,0,1220,1222,867,355,2.442253521,626,2535,947,290,1,289,1,49,0,0.055363322,empty,mBC-0814-1
"H9,H11",3881,4095,2660,1435,2399,0,1314,1317,946,371,2.549865229,696,10,8,2,0,2,0,2,0,0,empty,mBC-0814-1
"H9,H12",2294,2523,1552,971,1503,0,886,886,640,246,2.601626016,508,1417,974,254,0,254,0,64,0,0.066929134,empty,mBC-0814-1
"H10,A1",5975,6087,4175,1912,3717,0,1943,1947,1341,606,2.212871287,988,9885,3037,996,0,996,0,128,0,0.063253012,empty,mBC-0814-1
"H10,A2",4794,5117,3430,1687,3071,0,1645,1647,1156,491,2.354378819,880,7921,2844,955,2,953,1,135,0,0.034627492,empty,mBC-0814-1
"H10,A3",4633,5049,3284,1765,2954,0,1569,1573,1124,449,2.503340757,879,838,636,196,0,196,0,51,0,0,empty,mBC-0814-1
"H10,A4",5980,6231,4304,1927,3620,0,1892,1894,1333,561,2.376114082,972,457,343,96,0,96,0,20,0,0,empty,mBC-0814-1
"H10,A5",4926,5279,3469,1810,3145,0,1715,1718,1212,506,2.395256917,961,1100,754,254,0,254,0,60,0,0,empty,mBC-0814-1
"H10,A6",454508,512265,302772,209493,301282,0,184717,184911,151025,33886,4.456855338,108466,163915,118915,34235,15,34220,2,2180,0,0.00075979,mm10,mBC-0814-1
"H10,A7",5477,5875,3912,1963,3396,1,1836,1840,1339,501,2.672654691,955,1234,739,239,0,239,0,70,0,0.008368201,empty,mBC-0814-1
"H10,A8",2106,2264,1457,807,1343,0,743,745,518,227,2.281938326,409,1683,1102,335,0,335,0,69,0,0,empty,mBC-0814-1
"H10,A9",1086203,1213932,727621,486311,701682,2,426144,426605,356341,70264,5.071459069,246977,290021,200679,56357,31,56326,4,3024,0,0.000603629,mm10,mBC-0814-1
"H10,A10",3280,3416,2344,1072,2033,2,1146,1148,807,341,2.366568915,576,120,95,44,0,44,0,17,0,0,empty,mBC-0814-1
"H10,A11",4384,4578,3071,1507,2746,0,1456,1462,1023,439,2.330296128,777,2422,1750,530,1,529,1,92,0,0,empty,mBC-0814-1
"H10,A12",516650,600432,338483,261949,355589,0,230901,231129,153147,77982,1.963876279,140549,101903,71213,19431,17,19414,1,1684,0,0.001184712,mm10,mBC-0814-1
"H10,B1",4362,4686,3092,1594,2811,5,1478,1485,1019,466,2.186695279,806,1773,1340,338,0,338,0,67,0,0,empty,mBC-0814-1
"H10,B2",4884,5293,3390,1903,3090,0,1724,1724,1228,496,2.475806452,956,580,473,164,0,164,0,29,0,0,empty,mBC-0814-1
"H10,B3",4094,4525,2879,1646,2590,0,1432,1432,1011,421,2.401425178,802,1540,976,239,0,239,0,50,0,0,empty,mBC-0814-1
"H10,B4",371916,429810,246018,183792,257335,0,160672,160825,127130,33695,3.772963348,96889,137715,96206,27322,22,27300,1,1795,0,0.00021978,mm10,mBC-0814-1
"H10,B5",298871,208181,121057,87124,148416,0,91234,91549,70680,20869,3.386841727,55956,34499,22666,6501,5,6496,1,690,0,0.00523399,mm10,mBC-0814-1
"H10,B6",3756,3936,2735,1201,2330,0,1216,1216,823,393,2.094147583,650,1619,1161,343,0,343,0,68,0,0,empty,mBC-0814-1
"H10,B7",5362,5612,3918,1694,3288,0,1703,1704,1240,464,2.672413793,880,1015,746,232,0,232,0,55,0,0,empty,mBC-0814-1
"H10,B8",4399,4862,3174,1688,2944,0,1603,1607,1159,448,2.587053571,914,803,594,201,1,200,1,43,0,0.03,empty,mBC-0814-1
"H10,B9",4795,5093,3383,1710,3010,0,1615,1617,1204,413,2.915254237,863,996,719,194,0,194,0,66,0,0,empty,mBC-0814-1
"H10,B10",4106,4333,2762,1571,2679,0,1491,1496,1030,466,2.210300429,851,565,322,72,0,72,0,22,0,0,empty,mBC-0814-1
"H10,B11",8577,9484,5960,3524,5552,0,3124,3128,2364,764,3.094240838,1767,18,14,10,0,10,0,3,0,0,empty,mBC-0814-1
"H10,B12",5399,5838,3906,1932,3451,0,1879,1882,1334,548,2.434306569,1027,1046,685,182,0,182,0,40,0,0,empty,mBC-0814-1
"H10,C1",619393,717318,402524,314794,419074,0,266847,267157,224011,43146,5.191929727,160368,102643,75668,20960,10,20950,1,1623,0,0,mm10,mBC-0814-1
"H10,C2",5245,5446,3711,1735,3154,1,1712,1715,1230,485,2.536082474,858,2059,1532,418,1,417,1,86,0,0.021582734,empty,mBC-0814-1
"H10,C3",5996,6470,4351,2119,3741,0,2020,2026,1463,563,2.598579041,1044,469,287,75,0,75,0,26,0,0,empty,mBC-0814-1
"H10,C4",5224,5435,3708,1727,3367,0,1779,1779,1352,427,3.166276347,970,1466,1127,360,0,360,0,82,0,0,empty,mBC-0814-1
"H10,C5",7202,7671,5111,2560,4409,0,2377,2377,1736,641,2.708268331,1259,1669,1177,365,0,365,0,81,0,0,empty,mBC-0814-1
"H10,C6",5366,5579,3921,1658,3338,0,1795,1801,1282,519,2.470134875,911,1009,742,197,0,197,0,54,0,0.010152284,empty,mBC-0814-1
"H10,C7",7042,7530,5102,2428,4419,1,2339,2343,1659,684,2.425438596,1235,547,422,114,0,114,0,26,0,0,empty,mBC-0814-1
"H10,C8",5509,5839,3955,1884,3417,0,1813,1814,1318,496,2.657258065,925,1277,943,335,0,335,0,78,0,0,empty,mBC-0814-1
"H10,C9",4644,4975,3231,1744,2936,0,1641,1641,1162,479,2.425887265,879,11597,4219,1297,1,1296,1,154,0,0,empty,mBC-0814-1
"H10,C10",8234,8881,5931,2950,5104,0,2717,2719,1988,731,2.719562244,1406,1004,670,232,0,232,0,54,0,0,empty,mBC-0814-1
"H10,C11",4695,5078,3395,1683,2995,0,1609,1611,1130,481,2.349272349,827,1542,1115,378,0,378,0,72,0,0.005291005,empty,mBC-0814-1
"H10,C12",8416,9254,6065,3189,5361,0,2959,2961,2039,922,2.211496746,1598,1798,1245,365,0,365,0,74,0,0,empty,mBC-0814-1
"H10,D1",520041,599295,346388,252907,353093,2,217739,217991,165815,52176,3.177993714,129471,165605,117696,34054,8,34046,2,2035,0,5.87441E-05,mm10,mBC-0814-1
"H10,D2",5457,5641,3978,1663,3324,0,1689,1691,1195,496,2.409274194,819,1118,812,261,0,261,0,69,0,0,empty,mBC-0814-1
"H10,D3",10584,11515,7557,3958,6729,0,3679,3688,2585,1103,2.343608341,2004,2669,1838,541,0,541,0,84,0,0.086876155,empty,mBC-0814-1
"H10,D4",4318,4630,3100,1530,2683,0,1444,1449,1031,418,2.466507177,762,1497,1042,329,0,329,0,73,0,0,empty,mBC-0814-1
"H10,D5",4748,5328,3365,1963,3174,0,1824,1827,1187,640,1.8546875,1019,8479,3889,1194,1,1193,1,161,0,0.021793797,empty,mBC-0814-1
"H10,D6",5294,5615,3858,1757,3369,0,1801,1804,1309,495,2.644444444,915,719,523,193,0,193,0,44,0,0,empty,mBC-0814-1
"H10,D7",6192,6769,4383,2386,3908,0,2093,2100,1510,590,2.559322034,1182,6613,2548,824,0,824,0,136,0,0.007281553,empty,mBC-0814-1
"H10,D8",5110,5521,3680,1841,3153,0,1682,1685,1242,443,2.803611738,867,1104,793,241,0,241,0,47,0,0,empty,mBC-0814-1
"H10,D9",3101,3290,2094,1196,1990,0,1126,1129,814,315,2.584126984,599,1177,904,217,0,217,0,33,0,0,empty,mBC-0814-1
"H10,D10",3682,3986,2640,1346,2344,0,1254,1258,957,301,3.179401993,666,869,549,153,1,152,1,41,0,0,empty,mBC-0814-1
"H10,D11",4100,4398,2952,1446,2551,0,1387,1390,978,412,2.373786408,712,2515,1870,562,1,561,1,110,0,0,empty,mBC-0814-1
"H10,D12",6037,6521,4259,2262,3858,1,2112,2114,1543,571,2.702276708,1159,4521,3394,848,1,847,1,130,0,0.016528926,empty,mBC-0814-1
"H10,E1",4952,5080,3591,1489,2881,0,1452,1455,1039,416,2.497596154,668,1908,1322,346,0,346,0,66,0,0,empty,mBC-0814-1
"H10,E2",3706,3932,2710,1222,2268,0,1193,1195,841,354,2.375706215,606,2251,1042,304,0,304,0,61,0,0.039473684,empty,mBC-0814-1
"H10,E3",3603,3813,2591,1222,2239,0,1164,1166,841,325,2.587692308,599,1727,1251,369,0,369,0,66,0,0.021680217,empty,mBC-0814-1
"H10,E4",3191,3481,2342,1139,2048,0,1096,1098,797,301,2.647840532,584,1149,850,282,1,281,1,57,0,0,empty,mBC-0814-1
"H10,E5",3933,4303,2907,1396,2439,0,1247,1252,885,367,2.411444142,642,1002,694,201,0,201,0,42,0,0,empty,mBC-0814-1
"H10,E6",4807,5173,3422,1751,2890,0,1522,1526,1076,450,2.391111111,803,1358,926,262,0,262,0,60,0,0,empty,mBC-0814-1
"H10,E7",5358,5545,3792,1753,3334,0,1730,1736,1240,496,2.5,882,1058,797,200,0,200,0,47,0,0,empty,mBC-0814-1
"H10,E8",5342,5631,3811,1820,3174,0,1642,1647,1143,504,2.267857143,842,7856,3032,998,0,998,0,119,0,0.109218437,empty,mBC-0814-1
"H10,E9",3050,3240,2137,1103,1909,0,1015,1017,733,284,2.580985915,556,1834,1401,381,0,381,0,68,0,0,empty,mBC-0814-1
"H10,E10",502222,588494,332391,256103,348241,0,218914,219188,184824,34364,5.378419276,132316,241598,175925,49589,29,49560,2,2609,0,0.000242131,mm10,mBC-0814-1
"H10,E11",4075,4133,3012,1121,2456,0,1256,1258,911,347,2.625360231,607,1266,854,280,0,280,0,68,0,0,empty,mBC-0814-1
"H10,E12",3669,3823,2576,1247,2249,0,1208,1209,847,362,2.339779006,617,1128,830,243,0,243,0,53,0,0,empty,mBC-0814-1
"H10,F1",4856,5311,3372,1939,3054,0,1677,1680,1178,502,2.346613546,927,1572,1148,342,0,342,0,69,0,0,empty,mBC-0814-1
"H10,F2",6608,6982,4672,2310,4055,0,2183,2185,1589,596,2.666107383,1136,1890,1259,379,0,379,0,94,0,0,empty,mBC-0814-1
"H10,F3",5045,5605,3620,1985,3157,0,1749,1749,1219,530,2.3,962,1655,1179,402,0,402,0,72,0,0,empty,mBC-0814-1
"H10,F4",5380,5866,3885,1981,3297,0,1752,1752,1275,477,2.672955975,907,1256,482,147,0,147,0,21,0,0,empty,mBC-0814-1
"H10,F5",5519,5933,3978,1955,3558,0,1893,1896,1405,491,2.861507128,1017,1070,751,236,0,236,0,49,0,0.004237288,empty,mBC-0814-1
"H10,F6",547208,630102,359476,270626,369556,1,232773,232991,201280,31711,6.347324272,139327,224862,161870,46695,28,46667,5,2629,0,0.000385712,mm10,mBC-0814-1
"H10,F7",4769,4982,3528,1454,2971,0,1534,1535,1100,435,2.528735632,753,395,277,81,0,81,0,24,0,0,empty,mBC-0814-1
"H10,F8",6051,6270,4294,1976,3702,0,1984,1990,1395,595,2.344537815,1021,185,100,48,0,48,0,9,0,0,empty,mBC-0814-1
"H10,F9",5630,6089,4101,1988,3511,0,1854,1858,1328,530,2.505660377,963,1833,1139,327,0,327,0,69,0,0.01529052,empty,mBC-0814-1
"H10,F10",7768,7978,5179,2799,4438,0,2408,2415,1687,728,2.317307692,1283,24382,8130,2594,3,2591,3,238,0,0.17753763,empty,mBC-0814-1
"H10,F11",492381,557820,330741,227079,331594,0,206262,206475,136146,70329,1.935844389,123616,11556,8198,2057,0,2057,0,274,0,0,mm10,mBC-0814-1
"H10,F12",4814,5279,3340,1939,3116,0,1718,1721,1195,526,2.271863118,978,66,27,10,0,10,0,2,0,0,empty,mBC-0814-1
"H10,G1",535811,601171,363552,237619,355125,0,214137,214348,173241,41107,4.214391709,124437,187637,127484,35062,21,35041,3,2200,0,0.001398362,mm10,mBC-0814-1
"H10,G2",462062,529286,312251,217035,313464,0,191638,191789,159797,31992,4.994904976,113074,29573,20290,5582,4,5578,2,613,0,0.007708856,mm10,mBC-0814-1
"H10,G3",5127,5513,3660,1853,3252,0,1768,1776,1197,579,2.067357513,960,2740,1839,466,0,466,0,80,0,0,empty,mBC-0814-1
"H10,G4",46379,53714,33385,20329,31466,0,18206,18224,14270,3954,3.609003541,10385,59,42,4,0,4,0,2,0,0,empty,mBC-0814-1
"H10,G5",4663,5086,3236,1850,2938,0,1619,1623,1157,466,2.482832618,930,1270,884,248,0,248,0,49,0,0,empty,mBC-0814-1
"H10,G6",8924,9470,6603,2867,5482,0,2821,2824,1996,828,2.410628019,1425,197,153,34,0,34,0,11,0,0,empty,mBC-0814-1
"H10,G7",5334,5603,3843,1760,3328,0,1782,1782,1239,543,2.281767956,926,1813,1137,354,1,353,1,73,0,0.033994334,empty,mBC-0814-1
"H10,G8",6856,7345,4895,2450,4314,0,2410,2415,1676,739,2.267929635,1276,3183,2297,657,0,657,0,137,0,0.00152207,empty,mBC-0814-1
"H10,G9",4817,5116,3452,1664,2963,0,1589,1589,1132,457,2.47702407,812,4389,1942,613,0,613,0,123,0,0,empty,mBC-0814-1
"H10,G10",8837,9389,6363,3026,5476,0,2933,2935,2078,857,2.424737456,1553,2877,2115,635,1,634,1,127,0,0.020504732,empty,mBC-0814-1
"H10,G11",383419,432048,256244,175804,258706,0,160789,160948,128511,32437,3.961864537,94999,7306,4145,1109,1,1108,1,186,0,0.014440433,mm10,mBC-0814-1
"H10,G12",4730,4889,3490,1399,2813,0,1499,1500,1078,422,2.55450237,707,2068,1486,450,0,450,0,95,0,0,empty,mBC-0814-1
"H10,H1",4556,4935,3213,1722,2862,0,1555,1557,1076,481,2.237006237,840,784,589,178,0,178,0,50,0,0,empty,mBC-0814-1
"H10,H2",8295,8780,5915,2865,5126,0,2726,2729,1956,773,2.530401035,1428,3396,2459,653,0,653,0,130,0,0.032159265,empty,mBC-0814-1
"H10,H3",5002,5364,3555,1809,3171,3,1730,1737,1241,496,2.502016129,928,1546,1120,321,0,321,0,72,0,0,empty,mBC-0814-1
"H10,H4",470576,551316,314630,236686,325327,0,206370,206580,160481,46099,3.481225189,124593,6442,4541,1361,1,1360,1,176,0,0.001470588,mm10,mBC-0814-1
"H10,H5",6885,7346,4843,2503,4312,1,2355,2362,1668,694,2.403458213,1255,5878,2897,880,0,880,0,120,0,0.05,empty,mBC-0814-1
"H10,H6",6417,6644,4690,1954,3958,0,2045,2052,1501,551,2.724137931,1019,1826,1298,379,0,379,0,91,0,0,empty,mBC-0814-1
"H10,H7",5503,5847,4000,1847,3524,0,1913,1919,1324,595,2.225210084,972,1319,1012,231,0,231,0,52,0,0.008658009,empty,mBC-0814-1
"H10,H8",373849,430308,246689,183619,253344,1,158265,158427,133350,25077,5.317621725,94821,173090,117695,33577,19,33558,3,2195,0,0.003128911,mm10,mBC-0814-1
"H10,H9",4646,4986,3282,1704,2955,0,1621,1622,1172,450,2.604444444,874,1093,712,237,0,237,0,50,0,0,empty,mBC-0814-1
"H10,H10",3500,3863,2485,1378,2280,0,1261,1262,897,365,2.457534247,714,1105,765,231,1,230,1,40,0,0,empty,mBC-0814-1
"H10,H11",313387,370055,204479,165576,224183,0,146391,146509,97330,49179,1.979096769,90269,1343,826,196,0,196,0,47,0,0,empty,mBC-0814-1
"H10,H12",2433,2594,1690,904,1572,4,893,900,642,258,2.488372093,493,1078,723,257,0,257,0,61,0,0.011673152,empty,mBC-0814-1
"H11,A1",5352,5753,3893,1860,3426,0,1826,1835,1317,518,2.542471042,947,1300,897,230,0,230,0,51,0,0,empty,mBC-0814-1
"H11,A2",5369,5820,3855,1965,3528,0,1906,1914,1408,506,2.782608696,1055,833,591,182,0,182,0,59,0,0,empty,mBC-0814-1
"H11,A3",4582,4863,3222,1641,2888,0,1574,1576,1146,430,2.665116279,815,698,429,159,0,159,0,34,0,0,empty,mBC-0814-1
"H11,A4",5269,5503,3745,1758,3267,0,1692,1693,1223,470,2.60212766,871,551,408,131,0,131,0,28,0,0.106870229,empty,mBC-0814-1
"H11,A5",4559,4826,3287,1539,2894,0,1597,1598,1148,450,2.551111111,843,1041,712,174,0,174,0,42,0,0.005747126,empty,mBC-0814-1
"H11,A6",3719,4049,2626,1423,2388,0,1315,1315,914,401,2.279301746,692,722,525,165,0,165,0,37,0,0.036363636,empty,mBC-0814-1
"H11,A7",5314,5933,3729,2204,3492,0,1927,1931,1351,580,2.329310345,1071,1201,775,262,0,262,0,67,0,0.011450382,empty,mBC-0814-1
"H11,A8",2180,2359,1500,859,1434,0,803,803,567,236,2.402542373,438,1364,998,291,0,291,0,70,0,0.013745704,empty,mBC-0814-1
"H11,A9",7585,8438,5376,3062,4952,0,2795,2799,2068,731,2.829001368,1527,1435,985,291,0,291,0,58,0,0.058419244,empty,mBC-0814-1
"H11,A10",3597,4017,2545,1472,2356,1,1312,1319,952,367,2.59400545,736,136,97,24,0,24,0,6,0,0,empty,mBC-0814-1
"H11,A11",4622,4917,3303,1614,2951,0,1608,1608,1184,424,2.79245283,843,1870,1393,399,1,398,1,84,0,0,empty,mBC-0814-1
"H11,A12",4475,4879,3176,1703,2938,0,1566,1571,1186,385,3.080519481,901,2657,2088,585,0,585,0,138,0,0,empty,mBC-0814-1
"H11,B1",460385,524179,312384,211795,312542,2,190402,190626,149081,41545,3.588422193,111334,138396,102148,29964,15,29949,2,1874,0,0.00016695,mm10,mBC-0814-1
"H11,B2",4541,5074,3162,1912,2987,0,1653,1655,1100,555,1.981981982,934,745,404,113,0,113,0,28,0,0,empty,mBC-0814-1
"H11,B3",4095,4510,2869,1641,2725,3,1515,1524,1094,430,2.544186047,875,1053,756,250,0,250,0,52,0,0.024,empty,mBC-0814-1
"H11,B4",4320,4662,3170,1492,2829,0,1589,1591,1117,474,2.356540084,813,867,564,210,0,210,0,57,0,0,empty,mBC-0814-1
"H11,B5",3779,2438,1518,920,1752,0,1011,1015,726,289,2.512110727,580,793,530,175,0,175,0,46,0,0.017142857,empty,mBC-0814-1
"H11,B6",488019,555931,329691,226240,330949,1,202486,202714,171541,31173,5.502871074,118937,102526,74837,21825,8,21817,1,1621,0,0,mm10,mBC-0814-1
"H11,B7",548547,638795,368877,269918,379694,1,234503,234764,203003,31761,6.39158087,139879,145197,105049,29281,13,29268,1,1896,0,0,mm10,mBC-0814-1
"H11,B8",3588,4051,2598,1453,2380,0,1280,1280,913,367,2.48773842,697,2035,757,248,0,248,0,51,0,0,empty,mBC-0814-1
"H11,B9",4632,5012,3314,1698,3037,0,1652,1652,1236,416,2.971153846,891,703,436,151,0,151,0,46,0,0,empty,mBC-0814-1
"H11,B10",4441,4632,3017,1615,2818,0,1576,1579,1102,477,2.310272537,849,580,426,130,0,130,0,33,0,0,empty,mBC-0814-1
"H11,B11",6658,7131,4731,2400,4225,0,2301,2308,1663,645,2.578294574,1251,926,349,87,0,87,0,17,0,0,empty,mBC-0814-1
"H11,B12",518819,603157,347206,255951,358207,0,219007,219292,178393,40899,4.361793687,130606,295018,216811,59814,42,59772,2,3002,0,0,mm10,mBC-0814-1
"H11,C1",5473,5919,3978,1941,3484,0,1842,1848,1320,528,2.5,1000,978,793,233,0,233,0,39,0,0,empty,mBC-0814-1
"H11,C2",5175,5656,3726,1930,3291,0,1797,1801,1321,480,2.752083333,954,1325,956,311,0,311,0,85,0,0.041800643,empty,mBC-0814-1
"H11,C3",5660,5979,4085,1894,3565,0,1902,1908,1373,535,2.56635514,979,485,265,89,0,89,0,30,0,0,empty,mBC-0814-1
"H11,C4",4965,5318,3588,1730,3111,0,1673,1673,1223,450,2.717777778,850,1089,794,234,0,234,0,52,0,0,empty,mBC-0814-1
"H11,C5",7044,7559,5019,2540,4434,0,2387,2389,1742,647,2.692426584,1219,12567,4120,1281,3,1278,3,169,0,0.043035994,empty,mBC-0814-1
"H11,C6",5242,5549,3659,1890,3371,1,1839,1846,1320,526,2.509505703,991,1362,962,274,0,274,0,56,0,0.003649635,empty,mBC-0814-1
"H11,C7",670087,761789,456061,305728,445289,0,271357,271693,234946,36747,6.393610363,156926,41379,30031,8410,3,8407,1,878,0,0.000118948,mm10,mBC-0814-1
"H11,C8",5400,5886,3809,2077,3471,0,1920,1920,1401,519,2.699421965,1048,1181,696,214,0,214,0,61,0,0.028037383,empty,mBC-0814-1
"H11,C9",4553,4982,3251,1731,2864,0,1546,1549,1102,447,2.465324385,809,636,340,117,0,117,0,45,0,0.068376068,empty,mBC-0814-1
"H11,C10",5442,5933,3900,2033,3442,0,1892,1896,1327,569,2.332161687,998,956,655,154,0,154,0,36,0,0.006493506,empty,mBC-0814-1
"H11,C11",4489,4804,3240,1564,2933,0,1608,1609,1145,464,2.467672414,877,1295,925,319,1,318,1,58,0,0,empty,mBC-0814-1
"H11,C12",582218,671321,393581,277740,395894,0,245262,245498,171458,74040,2.315748244,146109,106055,75475,21547,15,21532,2,1535,0,0.00074308,mm10,mBC-0814-1
"H11,D1",1141243,1283976,773793,510183,761671,6,468842,469376,366518,102858,3.56333975,274843,74538,48246,13364,6,13358,1,1297,0,0.007561012,mm10,mBC-0814-1
"H11,D2",4837,5238,3531,1707,3022,0,1570,1572,1117,455,2.454945055,818,1391,949,281,1,280,1,64,0,0.071428571,empty,mBC-0814-1
"H11,D3",10569,11199,7601,3598,6579,0,3556,3561,2574,987,2.607902736,1828,2638,1813,490,0,490,0,92,0,0.044897959,empty,mBC-0814-1
"H11,D4",4766,5049,3386,1663,2973,0,1631,1636,1155,481,2.401247401,866,636,468,141,1,140,1,53,0,0,empty,mBC-0814-1
"H11,D5",4499,5120,3161,1959,3067,0,1700,1702,1238,464,2.668103448,967,1557,1106,371,0,371,0,83,0,0,empty,mBC-0814-1
"H11,D6",4895,5233,3508,1725,3026,0,1620,1627,1137,490,2.320408163,833,864,559,189,0,189,0,45,0,0,empty,mBC-0814-1
"H11,D7",5854,6267,4246,2021,3807,0,2101,2103,1536,567,2.708994709,1128,2265,1508,425,0,425,0,90,0,0,empty,mBC-0814-1
"H11,D8",4725,5032,3379,1653,2915,0,1558,1563,1133,430,2.634883721,801,979,685,196,0,196,0,35,0,0,empty,mBC-0814-1
"H11,D9",2981,3224,2077,1147,1893,0,1056,1056,775,281,2.758007117,548,940,606,143,0,143,0,32,0,0,empty,mBC-0814-1
"H11,D10",4213,4742,3008,1734,2757,1,1523,1527,1123,404,2.77970297,843,635,470,131,0,131,0,27,0,0,empty,mBC-0814-1
"H11,D11",3986,4412,2844,1568,2639,0,1465,1469,1033,436,2.369266055,782,1634,1143,396,0,396,0,102,0,0,empty,mBC-0814-1
"H11,D12",5988,6512,4302,2210,3826,8,2107,2117,1461,656,2.227134146,1108,4488,2565,753,0,753,0,124,0,0.022576361,empty,mBC-0814-1
"H11,E1",4935,5119,3542,1577,3052,0,1597,1599,1150,449,2.561247216,796,1140,817,250,0,250,0,58,0,0,empty,mBC-0814-1
"H11,E2",3551,3753,2523,1230,2249,0,1214,1216,868,348,2.494252874,623,600,394,128,0,128,0,42,0,0,empty,mBC-0814-1
"H11,E3",359421,420201,242758,177443,252913,0,159747,159937,119151,40786,2.921370078,94737,68475,48892,14048,2,14046,1,1295,0,0.000142389,mm10,mBC-0814-1
"H11,E4",2821,3201,1992,1209,1933,0,1082,1082,768,314,2.445859873,593,909,712,213,0,213,0,46,0,0.107981221,empty,mBC-0814-1
"H11,E5",19281,20532,13989,6543,11937,0,6065,6082,4896,1186,4.128161889,3228,5668,3960,1093,0,1093,0,158,0,0,empty,mBC-0814-1
"H11,E6",395682,440923,267026,173897,263529,0,161572,161752,133650,28102,4.755889261,94096,13549,10432,2401,1,2400,1,328,0,0,mm10,mBC-0814-1
"H11,E7",4637,4803,3233,1570,2747,1,1462,1463,1015,448,2.265625,748,59282,18166,5575,9,5566,4,479,0,0.097736256,empty,mBC-0814-1
"H11,E8",4662,4988,3306,1682,2940,0,1583,1584,1111,473,2.348837209,828,1905,1207,364,1,363,1,70,0,0,empty,mBC-0814-1
"H11,E9",4108,4473,2963,1510,2699,0,1503,1505,1067,438,2.436073059,811,2372,1759,459,0,459,0,72,0,0,empty,mBC-0814-1
"H11,E10",3929,4431,2798,1633,2679,0,1492,1496,1038,458,2.266375546,875,1783,653,225,0,225,0,74,0,0.075555556,empty,mBC-0814-1
"H11,E11",4378,4600,3063,1537,2728,0,1442,1444,1061,383,2.770234987,753,36333,9960,3110,7,3103,4,284,0,0.079278118,empty,mBC-0814-1
"H11,E12",3919,4308,2740,1568,2550,0,1452,1452,1027,425,2.416470588,805,354,234,85,0,85,0,32,0,0,empty,mBC-0814-1
"H11,F1",4502,4761,3311,1450,2803,0,1470,1470,1064,406,2.620689655,759,1608,888,220,2,218,1,49,0,0.151376147,empty,mBC-0814-1
"H11,F2",6573,7031,4792,2239,4212,0,2274,2278,1654,624,2.650641026,1176,3341,1643,490,1,489,1,110,0,0.028629857,empty,mBC-0814-1
"H11,F3",5173,5509,3680,1829,3300,0,1823,1825,1316,509,2.58546169,979,882,575,189,0,189,0,51,0,0.010582011,empty,mBC-0814-1
"H11,F4",5806,6024,4110,1914,3546,0,1890,1894,1354,540,2.507407407,1003,1511,703,172,0,172,0,36,0,0.087209302,empty,mBC-0814-1
"H11,F5",5335,5577,3747,1830,3323,0,1757,1762,1279,483,2.648033126,936,1098,734,232,0,232,0,52,0,0,empty,mBC-0814-1
"H11,F6",5433,5738,3861,1877,3423,0,1866,1871,1299,572,2.270979021,955,1796,1046,322,0,322,0,86,0,0,empty,mBC-0814-1
"H11,F7",4537,4817,3280,1537,2889,0,1524,1529,1086,443,2.451467269,819,1031,464,161,1,160,1,39,0,0,empty,mBC-0814-1
"H11,F8",5868,6191,4346,1845,3672,0,1900,1910,1384,526,2.631178707,961,333,181,52,0,52,0,13,0,0,empty,mBC-0814-1
"H11,F9",5230,5455,3731,1724,3268,0,1741,1743,1248,495,2.521212121,897,1538,984,269,0,269,0,71,0,0,empty,mBC-0814-1
"H11,F10",6493,6775,4662,2113,3966,1,2058,2059,1482,577,2.568457539,1078,1614,1060,305,0,305,0,66,0,0,empty,mBC-0814-1
"H11,F11",4194,4514,3030,1484,2700,0,1453,1460,1025,435,2.356321839,769,1659,940,296,0,296,0,57,0,0,empty,mBC-0814-1
"H11,F12",435377,506393,295210,211183,301587,2,188947,189202,137630,51572,2.668696192,112681,5531,3863,1101,0,1101,0,149,0,0.003633061,mm10,mBC-0814-1
"H11,G1",7262,7637,5017,2620,4653,0,2523,2528,1821,707,2.575671853,1359,5039,2605,797,2,795,1,122,0,0.066666667,empty,mBC-0814-1
"H11,G2",5586,5992,4027,1965,3491,0,1896,1897,1351,546,2.474358974,972,149,83,35,0,35,0,13,0,0,empty,mBC-0814-1
"H11,G3",5163,5512,3734,1778,3304,0,1766,1767,1281,486,2.635802469,934,4232,2192,678,0,678,0,100,0,0.029498525,empty,mBC-0814-1
"H11,G4",5431,5876,3952,1924,3406,0,1799,1801,1267,534,2.372659176,963,30,20,7,0,7,0,2,0,0,empty,mBC-0814-1
"H11,G5",486343,580313,315795,264518,345858,0,225531,225790,187444,38346,4.888228238,139172,122612,87979,24911,14,24897,3,1758,0,0.000361489,mm10,mBC-0814-1
"H11,G6",8872,9594,6520,3074,5781,0,3022,3026,2269,757,2.997357992,1624,118,57,27,0,27,0,7,0,0,empty,mBC-0814-1
"H11,G7",5283,5613,3777,1836,3388,0,1869,1869,1286,583,2.205831904,972,1786,1252,397,0,397,0,89,0,0,empty,mBC-0814-1
"H11,G8",284929,324407,189407,135000,197805,1,123975,124110,97235,26875,3.618046512,74331,13950,9677,2569,4,2565,1,411,0,0.004288499,mm10,mBC-0814-1
"H11,G9",318770,372143,211550,160593,226004,0,145636,145760,109451,36309,3.014431684,88334,19958,14417,4071,1,4070,1,500,0,0.003685504,mm10,mBC-0814-1
"H11,G10",8975,9584,6454,3130,5661,0,3047,3052,2158,894,2.413870246,1653,1992,1370,413,0,413,0,119,0,0,empty,mBC-0814-1
"H11,G11",8913,9686,6455,3231,5755,0,3126,3128,2287,841,2.719381688,1655,994,663,177,0,177,0,51,0,0.04519774,empty,mBC-0814-1
"H11,G12",4579,5090,3299,1791,2973,0,1638,1641,1158,483,2.397515528,902,1527,1022,328,0,328,0,74,0,0.00304878,empty,mBC-0814-1
"H11,H1",4476,4755,3144,1611,2800,0,1524,1526,1106,420,2.633333333,816,736,528,171,0,171,0,39,0,0.116959064,empty,mBC-0814-1
"H11,H2",7720,8394,5538,2856,4966,0,2706,2707,1959,748,2.618983957,1415,9782,4009,1252,5,1247,2,178,0,0.012028869,empty,mBC-0814-1
"H11,H3",517268,600350,341088,259262,356052,0,224636,224877,175011,49866,3.509625797,135612,139117,99236,27122,8,27114,1,1870,0,0,mm10,mBC-0814-1
"H11,H4",5383,5742,3792,1950,3414,0,1838,1844,1313,531,2.472693032,952,114,73,25,0,25,0,9,0,0,empty,mBC-0814-1
"H11,H5",6648,7113,4696,2417,4126,0,2294,2294,1622,672,2.413690476,1227,2148,1512,425,0,425,0,71,0,0.014117647,empty,mBC-0814-1
"H11,H6",602809,705085,398450,306635,417108,2,265991,266226,206592,59634,3.464332428,160660,214826,156303,44303,22,44281,3,2375,0,0.000564576,mm10,mBC-0814-1
"H11,H7",5141,5426,3711,1715,3312,1,1806,1810,1300,510,2.549019608,931,1649,1167,331,0,331,0,58,0,0.039274924,empty,mBC-0814-1
"H11,H8",4331,4728,3091,1637,2793,1,1561,1564,1147,417,2.75059952,833,1655,1199,382,0,382,0,84,0,0,empty,mBC-0814-1
"H11,H9",4783,5113,3457,1656,3047,0,1642,1642,1163,479,2.427974948,857,1025,681,220,0,220,0,47,0,0.059090909,empty,mBC-0814-1
"H11,H10",504763,593081,324285,268796,349618,1,228078,228320,188956,39364,4.800223555,139428,127950,91288,25538,15,25523,2,1794,0,0.001292951,mm10,mBC-0814-1
"H11,H11",273239,306614,184009,122605,186762,0,114284,114417,77566,36851,2.104854685,67502,346,220,54,0,54,0,15,0,0,empty,mBC-0814-1
"H11,H12",3018,3331,2057,1274,2011,0,1182,1183,831,352,2.360795455,675,682,477,138,0,138,0,48,0,0,empty,mBC-0814-1
"H12,A1",4163,4615,3067,1548,3146,0,1703,1706,1150,556,2.068345324,949,842,605,210,1,209,1,53,0,0,empty,mBC-0814-1
"H12,A2",408934,466158,272696,193462,305501,2,188356,188585,146815,41770,3.514843189,111478,77317,53246,15140,6,15134,2,1341,0,0.00072684,mm10,mBC-0814-1
"H12,A3",344235,413071,226808,186263,270128,0,172010,172193,143265,28928,4.952468197,106259,135197,95121,26541,23,26518,4,1859,0,0.000603364,mm10,mBC-0814-1
"H12,A4",4307,4636,3151,1485,3233,0,1745,1751,1211,540,2.242592593,924,274,167,47,0,47,0,12,0,0,empty,mBC-0814-1
"H12,A5",3627,3889,2589,1300,2630,0,1412,1420,1015,405,2.50617284,742,1297,709,226,0,226,0,48,0,0,empty,mBC-0814-1
"H12,A6",7698,8700,5376,3324,6034,0,3567,3571,2738,833,3.286914766,2055,1150,863,189,0,189,0,51,0,0.058201058,empty,mBC-0814-1
"H12,A7",1184784,1373075,798040,575035,923917,0,579007,579646,473338,106308,4.452515333,344415,465900,337968,93775,61,93714,3,3981,0,0.000490855,mm10,mBC-0814-1
"H12,A8",1817,2006,1271,735,1424,0,828,828,592,236,2.508474576,469,1054,738,179,0,179,0,62,0,0.005586592,empty,mBC-0814-1
"H12,A9",5721,6294,4076,2218,4223,0,2365,2365,1685,680,2.477941176,1273,1497,985,276,0,276,0,61,0,0.032608696,empty,mBC-0814-1
"H12,A10",249815,294606,165907,128699,201842,1,127831,127950,96975,30975,3.130750605,77620,11606,7408,2106,3,2103,2,273,0,0,mm10,mBC-0814-1
"H12,A11",3799,4128,2677,1451,2891,1,1589,1590,1122,468,2.397435897,867,1722,1328,419,0,419,0,91,0,0.007159905,empty,mBC-0814-1
"H12,A12",3540,3890,2575,1315,2563,0,1375,1377,981,396,2.477272727,744,2030,1293,419,0,419,0,137,0,0,empty,mBC-0814-1
"H12,B1",307186,343099,206939,136160,234815,1,143661,143813,106598,37215,2.864382641,84298,22474,15566,4351,3,4348,1,540,0,0.00298988,mm10,mBC-0814-1
"H12,B2",3843,4194,2733,1461,2921,0,1627,1633,1205,428,2.815420561,899,406,267,72,0,72,0,19,0,0,empty,mBC-0814-1
"H12,B3",3149,3417,2256,1161,2297,0,1291,1297,907,390,2.325641026,673,1011,659,183,0,183,0,50,0,0.081967213,empty,mBC-0814-1
"H12,B4",3385,3601,2461,1140,2450,0,1320,1322,898,424,2.117924528,685,4973,1461,504,0,504,0,86,0,0.067460317,empty,mBC-0814-1
"H12,B5",2889,1948,1230,718,1514,0,846,852,620,232,2.672413793,484,654,392,136,0,136,0,29,0,0,empty,mBC-0814-1
"H12,B6",3162,3394,2234,1160,2292,0,1301,1301,890,411,2.165450122,692,1261,909,305,0,305,0,52,0,0,empty,mBC-0814-1
"H12,B7",4175,4559,2994,1565,3030,0,1614,1620,1194,426,2.802816901,865,723,543,212,1,211,1,50,0,0,empty,mBC-0814-1
"H12,B8",273111,302009,189998,112011,206771,6,119417,119546,94239,25307,3.723831351,67647,37922,25029,7068,3,7065,1,735,0,0.010474168,mm10,mBC-0814-1
"H12,B9",319598,377603,212319,165284,256551,0,160993,161138,133054,28084,4.737715425,98106,67612,46912,13520,6,13514,1,1165,0,0,mm10,mBC-0814-1
"H12,B10",3532,3747,2458,1289,2515,0,1383,1390,961,429,2.24009324,739,226,131,44,0,44,0,22,0,0.022727273,empty,mBC-0814-1
"H12,B11",370554,416808,252326,164482,283031,1,172162,172344,132027,40317,3.274722822,100512,1547,932,271,0,271,0,54,0,0,empty,mBC-0814-1
"H12,B12",3960,4357,2793,1564,2953,0,1623,1623,1124,499,2.25250501,925,1066,717,195,0,195,0,48,0,0,empty,mBC-0814-1
"H12,C1",4357,4527,3082,1445,3100,0,1605,1606,1170,436,2.683486239,880,652,486,152,0,152,0,30,0,0,empty,mBC-0814-1
"H12,C2",4046,4486,2863,1623,3046,0,1670,1674,1190,484,2.458677686,970,2063,1495,467,0,467,0,86,0,0.019271949,empty,mBC-0814-1
"H12,C3",403540,476556,274716,201840,324007,0,202253,202464,154863,47601,3.253356022,121089,38446,28145,8290,6,8284,1,790,0,0.000120715,mm10,mBC-0814-1
"H12,C4",3836,4069,2790,1279,2835,0,1527,1528,1132,396,2.858585859,796,1199,867,280,0,280,0,76,0,0,empty,mBC-0814-1
"H12,C5",5463,5942,3923,2019,3984,0,2153,2157,1617,540,2.994444444,1164,1104,786,245,0,245,0,62,0,0,empty,mBC-0814-1
"H12,C6",4038,4172,2843,1329,2887,8,1528,1538,1088,450,2.417777778,789,936,688,216,0,216,0,60,0,0,empty,mBC-0814-1
"H12,C7",6128,6714,4396,2318,4391,0,2438,2443,1737,706,2.460339943,1352,1070,483,137,1,136,1,35,0,0,empty,mBC-0814-1
"H12,C8",4205,4447,3083,1364,2993,0,1550,1553,1088,465,2.339784946,756,2667,1438,442,0,442,0,82,0,0,empty,mBC-0814-1
"H12,C9",3603,3845,2622,1223,2562,0,1365,1365,952,413,2.305084746,697,743,413,159,0,159,0,39,0,0,empty,mBC-0814-1
"H12,C10",4058,4414,2968,1446,2992,0,1574,1577,1083,494,2.192307692,862,799,592,184,0,184,0,32,0,0.092391304,empty,mBC-0814-1
"H12,C11",3354,3621,2369,1252,2436,0,1312,1315,951,364,2.612637363,704,5878,2442,680,3,677,2,97,0,0.005908419,empty,mBC-0814-1
"H12,C12",428160,499839,286634,213205,338184,0,212209,212431,172151,40280,4.273857994,127665,135846,94380,26920,22,26898,2,1855,0,0,mm10,mBC-0814-1
"H12,D1",3141,3336,2285,1051,2296,0,1207,1207,863,344,2.50872093,611,429,267,112,0,112,0,25,0,0,empty,mBC-0814-1
"H12,D2",474465,547658,323055,224603,372080,0,226424,226667,194516,32151,6.050076203,133110,187426,135629,38037,22,38015,3,2333,0,0.000157832,mm10,mBC-0814-1
"H12,D3",7810,8471,5611,2860,5766,0,3135,3141,2280,861,2.648083624,1680,2507,1728,545,0,545,0,103,0,0.036697248,empty,mBC-0814-1
"H12,D4",3413,3652,2408,1244,2517,0,1373,1373,986,387,2.547803618,739,1026,718,231,0,231,0,58,0,0,empty,mBC-0814-1
"H12,D5",342345,389354,232026,157328,266858,1,160501,160636,127088,33548,3.788243711,94710,112651,80223,23043,13,23030,3,1593,0,0.000477638,mm10,mBC-0814-1
"H12,D6",3616,3959,2663,1296,2582,3,1356,1360,1009,351,2.874643875,733,1098,801,275,0,275,0,58,0,0,empty,mBC-0814-1
"H12,D7",4427,4657,3182,1475,3176,0,1715,1718,1256,462,2.718614719,902,1798,1233,409,0,409,0,82,0,0,empty,mBC-0814-1
"H12,D8",3654,3941,2619,1322,2648,0,1444,1446,1030,416,2.475961538,762,1524,736,256,0,256,0,57,0,0,empty,mBC-0814-1
"H12,D9",2687,2911,1896,1015,1978,0,1097,1099,792,307,2.57980456,633,5797,2026,564,2,562,1,80,0,0,empty,mBC-0814-1
"H12,D10",2786,3193,1940,1253,2144,0,1200,1200,864,336,2.571428571,688,777,516,136,0,136,0,29,0,0,empty,mBC-0814-1
"H12,D11",356919,398288,243203,155085,271256,0,160192,160327,140714,19613,7.174527099,92294,107457,77079,21040,17,21023,4,1686,0,0.001759977,mm10,mBC-0814-1
"H12,D12",5113,5512,3634,1878,3582,0,1973,1977,1419,558,2.543010753,1049,4199,3022,890,0,890,0,119,0,0,empty,mBC-0814-1
"H12,E1",5022,5258,3676,1582,3111,0,1614,1617,1159,458,2.530567686,776,1062,689,193,0,193,0,49,0,0,empty,mBC-0814-1
"H12,E2",2921,3187,2100,1087,2144,0,1165,1169,841,328,2.56402439,626,687,458,161,0,161,0,54,0,0,empty,mBC-0814-1
"H12,E3",2488,2634,1811,823,1789,0,966,969,703,266,2.642857143,497,1014,683,228,0,228,0,50,0,0.004385965,empty,mBC-0814-1
"H12,E4",2523,2807,1838,969,1795,0,987,988,750,238,3.151260504,514,768,391,136,0,136,0,47,0,0.007352941,empty,mBC-0814-1
"H12,E5",2657,2820,1955,865,1935,0,984,984,701,283,2.477031802,515,788,583,159,0,159,0,34,0,0,empty,mBC-0814-1
"H12,E6",838012,969444,564965,404479,639563,1,404733,405151,318554,86597,3.678580089,240780,173058,124780,34217,25,34192,1,2451,0,0.000584932,mm10,mBC-0814-1
"H12,E7",376122,428179,251082,177097,288478,0,182620,182805,147241,35564,4.140169835,108247,12315,8636,2311,2,2309,1,353,0,0.006063231,mm10,mBC-0814-1
"H12,E8",3617,3854,2659,1195,2554,1,1358,1360,980,380,2.578947368,686,2208,1569,425,0,425,0,79,0,0,empty,mBC-0814-1
"H12,E9",2332,2413,1670,743,1669,1,917,919,662,257,2.575875486,479,655,452,161,0,161,0,58,0,0,empty,mBC-0814-1
"H12,E10",252837,289337,170082,119255,193388,1,120320,120465,95401,25064,3.806295883,71715,13524,9645,2593,5,2588,3,373,0,0.005409583,mm10,mBC-0814-1
"H12,E11",3915,4333,2864,1469,2716,0,1476,1477,1026,451,2.274944568,775,614,363,132,0,132,0,53,0,0.007575758,empty,mBC-0814-1
"H12,E12",3151,3329,2267,1062,2251,0,1204,1206,880,326,2.699386503,592,1069,763,162,0,162,0,37,0,0,empty,mBC-0814-1
"H12,F1",3435,3649,2506,1143,2519,0,1310,1312,963,349,2.759312321,681,1407,916,253,0,253,0,44,0,0.035573123,empty,mBC-0814-1
"H12,F2",5082,5367,3709,1658,3628,0,1960,1963,1428,535,2.669158879,983,1538,1121,336,0,336,0,82,0,0,empty,mBC-0814-1
"H12,F3",4387,4836,3180,1656,3128,0,1709,1713,1208,505,2.392079208,908,1657,1326,368,0,368,0,76,0,0,empty,mBC-0814-1
"H12,F4",4051,4334,2956,1378,2953,0,1597,1597,1149,448,2.564732143,839,610,370,93,0,93,0,24,0,0,empty,mBC-0814-1
"H12,F5",3869,4074,2777,1297,2687,0,1426,1429,1047,382,2.740837696,717,1035,786,241,0,241,0,54,0,0,empty,mBC-0814-1
"H12,F6",4225,4523,3039,1484,3070,0,1657,1659,1191,468,2.544871795,868,1251,850,300,0,300,0,72,0,0,empty,mBC-0814-1
"H12,F7",3405,3630,2430,1200,2499,0,1394,1398,992,406,2.443349754,725,685,452,145,0,145,0,37,0,0,empty,mBC-0814-1
"H12,F8",440241,504329,295032,209297,341597,0,213494,213673,171125,42548,4.021928175,126133,7132,4775,1316,1,1315,1,200,0,0,mm10,mBC-0814-1
"H12,F9",4219,4540,3117,1423,3004,0,1592,1592,1150,442,2.601809955,798,1664,1231,315,0,315,0,67,0,0,empty,mBC-0814-1
"H12,F10",4754,5158,3487,1671,3480,0,1840,1847,1313,534,2.458801498,973,1131,867,281,0,281,0,58,0,0,empty,mBC-0814-1
"H12,F11",322899,373948,216129,157819,256094,0,159763,159920,117423,42497,2.763089159,95364,91688,59195,16831,16,16815,3,1386,0,0.002735653,mm10,mBC-0814-1
"H12,F12",3693,4068,2642,1426,2759,0,1534,1536,1025,511,2.005870841,865,118,80,32,0,32,0,7,0,0,empty,mBC-0814-1
"H12,G1",5605,5877,3998,1879,4008,0,2139,2140,1563,577,2.708838821,1125,1972,1287,412,1,411,1,111,0,0.03163017,empty,mBC-0814-1
"H12,G2",4472,4754,3217,1537,3129,0,1733,1736,1227,509,2.410609037,864,487,379,122,0,122,0,25,0,0,empty,mBC-0814-1
"H12,G3",3934,4192,2866,1326,2797,0,1524,1527,1172,355,3.301408451,755,1698,1243,401,0,401,0,91,0,0.034912718,empty,mBC-0814-1
"H12,G4",4072,4305,2942,1363,2838,0,1545,1550,1095,455,2.406593407,781,35,30,13,0,13,0,1,0,0,empty,mBC-0814-1
"H12,G5",406565,489290,261437,227853,331012,0,219544,219769,176749,43020,4.108530916,136456,118929,79966,22622,6,22616,1,1671,0,0.001238062,mm10,mBC-0814-1
"H12,G6",7637,8170,5582,2588,5302,0,2695,2696,1948,748,2.604278075,1420,86,30,20,0,20,0,15,0,0,empty,mBC-0814-1
"H12,G7",3996,4224,2846,1378,2912,0,1535,1539,1068,471,2.267515924,807,2039,1291,381,2,379,1,72,0,0,empty,mBC-0814-1
"H12,G8",5620,6279,3976,2303,4176,0,2298,2299,1649,650,2.536923077,1312,3157,2197,670,0,670,0,133,0,0,empty,mBC-0814-1
"H12,G9",4488,4980,3180,1800,3326,0,1836,1838,1296,542,2.391143911,1023,2090,1499,423,1,422,1,100,0,0,empty,mBC-0814-1
"H12,G10",7145,7686,5170,2516,5167,0,2730,2730,1944,786,2.473282443,1396,2752,1909,596,0,596,0,146,0,0,empty,mBC-0814-1
"H12,G11",7461,8073,5487,2586,5368,0,2875,2883,2088,795,2.626415094,1500,1938,1135,308,0,308,0,72,0,0.003246753,empty,mBC-0814-1
"H12,G12",338886,401015,223792,177223,276132,1,174394,174571,142525,32046,4.44751295,106863,196156,136234,38235,21,38214,2,2455,0,0.001465432,mm10,mBC-0814-1
"H12,H1",3355,3616,2449,1167,2402,0,1309,1311,966,345,2.8,670,821,565,213,0,213,0,41,0,0,empty,mBC-0814-1
"H12,H2",6273,6823,4497,2326,4653,0,2542,2550,1858,692,2.684971098,1370,3382,2274,730,0,730,0,138,0,0,empty,mBC-0814-1
"H12,H3",4160,4510,2988,1522,3016,0,1612,1616,1176,440,2.672727273,873,1974,1429,388,0,388,0,85,0,0,empty,mBC-0814-1
"H12,H4",338298,386355,229268,157087,248188,0,152817,152995,117510,35485,3.311540087,90474,1664,1053,298,0,298,0,56,0,0,empty,mBC-0814-1
"H12,H5",4983,5237,3546,1691,3503,0,1897,1902,1293,609,2.123152709,1011,1948,1294,415,0,415,0,71,0,0.009638554,empty,mBC-0814-1
"H12,H6",4806,5188,3413,1775,3546,0,1953,1957,1411,546,2.584249084,1056,18353,5955,1926,6,1920,3,204,0,0.147916667,empty,mBC-0814-1
"H12,H7",3986,4290,2842,1448,2915,0,1590,1590,1107,483,2.291925466,854,978,726,187,0,187,0,42,0,0,empty,mBC-0814-1
"H12,H8",3375,3839,2324,1515,2639,0,1497,1498,1050,448,2.34375,889,1257,760,254,0,254,0,75,0,0,empty,mBC-0814-1
"H12,H9",4226,4428,3040,1388,3014,0,1575,1578,1183,395,2.994936709,815,1248,786,210,1,209,1,37,0,0.052631579,empty,mBC-0814-1
"H12,H10",2822,2964,2040,924,1995,0,1075,1075,754,321,2.348909657,559,1302,1054,330,0,330,0,51,0,0,empty,mBC-0814-1
"H12,H11",3081,3317,2246,1071,2269,0,1234,1234,897,337,2.661721068,655,52,38,9,0,9,0,4,0,0,empty,mBC-0814-1
"H12,H12",2284,2424,1635,789,1645,0,890,895,634,261,2.429118774,470,995,660,222,0,222,0,55,0,0,empty,mBC-0814-1
