well id,# of raw HiC read pairs,# of uniquely mapped HiC read pairs,# of uniquely mapped nonwalk HiC read pairs,# of uniquely mapped walk HiC read pairs,# of dedup HiC read pairs,# of HiC contacts hg38,# of HiC contacts mm10,# of HiC contacts,# of HiC cis-contacts,# of HiC trans-contacts,# of HiC cis:trans,# of HiC walk contacts,# of raw RNA reads,# of uniquely mapped RNA reads,# of unique RNA molecules,# of unique RNA molecules hg38,# of unique RNA molecules mm10,# of genes hg38,# of genes mm10,% of mitochondrial mRNA molecules hg38,% of mitochondrial mRNA molecules mm10,species,library
"A1,A1",6396,7235,4816,2419,3505,1806,0,1811,1171,640,1.8296875,1052,1115,206,67,65,2,25,1,0.046153846,0,empty,CD-0722-1
"A1,A2",9070,10040,6569,3471,4822,2463,0,2471,1586,885,1.792090395,1448,2032,479,179,176,3,71,2,0.022727273,0,empty,CD-0722-1
"A1,A3",5886,6449,4345,2104,3105,1522,0,1524,1012,512,1.9765625,892,1074,315,107,104,3,29,1,0.086538462,0,empty,CD-0722-1
"A1,A4",761998,888628,573538,315090,406010,219260,6,219530,180399,39131,4.610130076,128269,9419,1585,537,527,10,150,2,0.036053131,0,hg38,CD-0722-1
"A1,A5",975115,1144145,707009,437136,530667,307183,1,307488,230885,76603,3.014046447,183718,48815,26216,7442,7432,10,1228,3,0.014262648,0,hg38,CD-0722-1
"A1,A6",10002,11245,7510,3735,5464,2793,1,2807,1931,876,2.2043379,1604,3375,989,324,318,6,104,2,0.053459119,0,empty,CD-0722-1
"A1,A7",6740,7602,5011,2591,3678,1915,0,1919,1262,657,1.920852359,1133,1580,439,145,144,1,43,1,0.104166667,0,empty,CD-0722-1
"A1,A8",4020,4588,3040,1548,2228,1114,0,1116,756,360,2.1,649,1864,365,180,179,1,63,1,0.039106145,0,empty,CD-0722-1
"A1,A9",6553,7226,4943,2283,3489,1723,0,1725,1140,585,1.948717949,976,2276,463,171,170,1,65,1,0.011764706,0,empty,CD-0722-1
"A1,A10",6514,7058,4947,2111,3416,1594,0,1596,1009,587,1.71890971,868,419,124,34,34,0,15,0,0,0,empty,CD-0722-1
"A1,A11",5880,6474,4546,1928,3266,1560,0,1562,1039,523,1.986615679,899,1305,331,143,143,0,57,0,0.034965035,0,empty,CD-0722-1
"A1,A12",7644,8208,5871,2337,3878,1768,0,1768,1152,616,1.87012987,955,3621,740,223,222,1,78,1,0.135135135,0,empty,CD-0722-1
"A1,B1",6735,7487,4920,2567,3567,1826,0,1835,1149,686,1.674927114,1055,1357,363,137,137,0,38,0,0.080291971,0,empty,CD-0722-1
"A1,B2",7525,8349,5092,3257,4119,2256,0,2259,1361,898,1.5155902,1404,484,73,29,25,4,14,1,0,0,empty,CD-0722-1
"A1,B3",5224,6028,3907,2121,2937,1492,0,1497,949,548,1.731751825,903,1367,327,94,93,1,40,1,0.043010753,0,empty,CD-0722-1
"A1,B4",6508,7418,4674,2744,3721,2043,0,2044,1340,704,1.903409091,1196,1324,318,110,108,2,55,1,0.111111111,0,empty,CD-0722-1
"A1,B5",6550,3425,2043,1382,2215,1187,1,1203,787,416,1.891826923,791,1032,275,58,58,0,25,0,0.017241379,0,empty,CD-0722-1
"A1,B6",7151,8079,5237,2842,3880,2062,1,2068,1318,750,1.757333333,1192,1445,427,124,115,9,34,2,0.147826087,0,empty,CD-0722-1
"A1,B7",828915,963321,629479,333842,444083,237999,0,238221,186269,51952,3.585405759,138909,97974,13505,4617,4502,115,879,6,0.047756553,0,hg38,CD-0722-1
"A1,B8",634681,696963,489153,207810,326274,158985,1,159183,124726,34457,3.619757959,88127,52527,9027,2619,2573,46,547,3,0.010104936,0,hg38,CD-0722-1
"A1,B9",569229,639556,430790,208766,296248,149328,1,149483,115106,34377,3.348343369,85513,30694,3185,1097,1064,33,271,4,0.037593985,0,hg38,CD-0722-1
"A1,B10",4883,5321,3455,1866,2615,1281,0,1284,825,459,1.797385621,771,362,48,28,28,0,14,0,0,0,empty,CD-0722-1
"A1,B11",9890,11169,7338,3831,5225,2816,1,2822,1612,1210,1.332231405,1631,242,82,43,42,1,21,1,0.023809524,0,empty,CD-0722-1
"A1,B12",5803,6322,4275,2047,3058,1529,0,1530,933,597,1.56281407,884,1621,399,137,132,5,33,1,0.075757576,0,empty,CD-0722-1
"A1,C1",11782,12868,8914,3954,6087,2925,0,2929,1819,1110,1.638738739,1608,1004,165,59,59,0,24,0,0.050847458,0,empty,CD-0722-1
"A1,C2",9733,10540,7140,3400,5023,2533,0,2540,1589,951,1.670872766,1424,1866,534,146,143,3,40,2,0.034965035,0,empty,CD-0722-1
"A1,C3",10539,11832,7816,4016,5693,2836,0,2838,1787,1051,1.700285442,1636,1019,117,63,62,1,34,1,0,0,empty,CD-0722-1
"A1,C4",457492,528787,341552,187235,248374,132123,2,132270,99775,32495,3.07047238,78283,112020,15712,5013,4925,88,923,4,0.059695431,0,hg38,CD-0722-1
"A1,C5",9376,10325,7063,3262,5056,2507,0,2512,1672,840,1.99047619,1394,1792,365,141,139,2,64,1,0.050359712,0,empty,CD-0722-1
"A1,C6",705086,824503,524553,299950,392125,212512,2,212771,168248,44523,3.778900793,127326,92352,11002,3488,3382,106,785,6,0.073329391,0,hg38,CD-0722-1
"A1,C7",10889,12261,7882,4379,5825,3180,0,3180,1965,1215,1.617283951,1827,627,83,45,45,0,25,0,0.066666667,0,empty,CD-0722-1
"A1,C8",11657,13126,8702,4424,6170,3074,0,3075,2031,1044,1.945402299,1775,2510,508,173,173,0,75,0,0.063583815,0,empty,CD-0722-1
"A1,C9",7783,8790,5838,2952,4199,2084,14,2101,1391,710,1.95915493,1182,1502,307,126,124,2,44,1,0.161290323,0,empty,CD-0722-1
"A1,C10",9575,10325,7255,3070,4951,2399,0,2404,1531,873,1.753722795,1321,2203,485,190,182,8,63,1,0.098901099,0,empty,CD-0722-1
"A1,C11",8228,9180,6189,2991,4527,2252,0,2254,1480,774,1.912144703,1290,1993,405,173,167,6,61,2,0.089820359,0,empty,CD-0722-1
"A1,C12",11633,12218,8782,3436,5755,2654,0,2660,1786,874,2.043478261,1383,1900,478,175,175,0,55,0,0.154285714,0,empty,CD-0722-1
"A1,D1",10013,10937,7525,3412,5168,2667,0,2671,1672,999,1.673673674,1479,809,238,70,70,0,28,0,0.028571429,0,empty,CD-0722-1
"A1,D2",8467,9052,6601,2451,4360,2024,0,2026,1324,702,1.886039886,1060,3375,846,296,288,8,87,2,0.059027778,0,empty,CD-0722-1
"A1,D3",7424,8232,5451,2781,3925,1967,0,1970,1305,665,1.962406015,1133,1378,321,117,115,2,42,2,0.156521739,0,empty,CD-0722-1
"A1,D4",5848,6672,4342,2330,3195,1638,0,1642,1078,564,1.911347518,963,1494,488,143,142,1,41,1,0.042253521,0,empty,CD-0722-1
"A1,D5",6966,7643,5224,2419,3688,1786,1,1796,1166,630,1.850793651,1007,1687,394,130,125,5,62,1,0.208,0,empty,CD-0722-1
"A1,D6",10948,11979,7986,3993,5679,2963,0,2969,1906,1063,1.79303857,1645,1728,506,142,141,1,44,1,0.078014184,0,empty,CD-0722-1
"A1,D7",6017,6439,4526,1913,3056,1419,0,1422,934,488,1.913934426,803,2504,575,148,147,1,45,1,0.006802721,0,empty,CD-0722-1
"A1,D8",6927,7678,5148,2530,3735,1839,0,1839,1162,677,1.716395864,1045,1472,379,136,135,1,55,1,0.022222222,0,empty,CD-0722-1
"A1,D9",392114,455455,290516,164939,212805,114512,1,114640,91340,23300,3.920171674,68273,128710,20757,6910,6764,146,1281,5,0.047604967,0,hg38,CD-0722-1
"A1,D10",6882,7821,5069,2752,3622,1871,0,1873,1121,752,1.490691489,1112,825,140,67,67,0,17,0,0,0,empty,CD-0722-1
"A1,D11",7616,8089,5775,2314,3956,1917,0,1921,1250,671,1.862891207,1055,3166,868,302,300,2,93,1,0.07,0,empty,CD-0722-1
"A1,D12",656302,762639,490367,272272,353816,190292,4,190499,145942,44557,3.275400049,112781,124551,20347,6396,6273,123,1094,6,0.064881237,0,hg38,CD-0722-1
"A1,E1",11667,12800,8678,4122,6052,3067,0,3073,1900,1173,1.619778346,1720,2262,480,176,171,5,78,2,0.023391813,0,empty,CD-0722-1
"A1,E2",581692,657241,447421,209820,308309,151688,0,151852,116400,35452,3.283312648,86690,156778,16679,5736,5534,202,1016,6,0.096494398,0,hg38,CD-0722-1
"A1,E3",506491,593788,383270,210518,277911,148890,2,149037,116399,32638,3.566364361,87581,153417,22229,7226,7073,153,1264,6,0.063480843,0,hg38,CD-0722-1
"A1,E4",8109,9169,6085,3084,4424,2217,0,2219,1426,793,1.798234552,1269,2421,725,228,224,4,96,2,0.09375,0,empty,CD-0722-1
"A1,E5",7421,8108,5611,2497,3991,1912,6,1926,1224,702,1.743589744,1079,1481,408,132,131,1,46,1,0,0,empty,CD-0722-1
"A1,E6",12129,13038,9069,3969,6220,3035,0,3039,1916,1123,1.706144256,1702,3233,818,239,239,0,71,0,0.129707113,0,empty,CD-0722-1
"A1,E7",10969,11641,8319,3322,5623,2567,1,2571,1723,848,2.031839623,1412,3532,818,295,293,2,84,1,0.122866894,0,empty,CD-0722-1
"A1,E8",9128,9961,6862,3099,4677,2207,0,2213,1463,750,1.950666667,1216,3379,997,347,339,8,77,2,0.103244838,0,empty,CD-0722-1
"A1,E9",447601,559995,304859,255136,261099,177804,1,177964,132105,45859,2.88067773,109536,9296,999,391,381,10,118,2,0.236220472,0,hg38,CD-0722-1
"A1,E10",6925,7341,5216,2125,3593,1686,0,1693,1102,591,1.86463621,921,1724,445,163,162,1,58,1,0.092592593,0,empty,CD-0722-1
"A1,E11",1045561,1149435,795371,354064,532576,263757,2,264072,215378,48694,4.423091141,149185,194797,23299,7774,7555,219,1348,7,0.025545996,0,hg38,CD-0722-1
"A1,E12",1150377,1275605,887939,387666,590013,290305,3,290636,233880,56756,4.120797801,163720,86151,9544,3216,3125,91,667,5,0.06112,0,hg38,CD-0722-1
"A1,F1",10287,10701,7646,3055,5181,2477,3,2483,1595,888,1.796171171,1343,1924,452,152,152,0,56,0,0.006578947,0,empty,CD-0722-1
"A1,F2",8884,10123,6518,3605,4739,2389,0,2389,1563,826,1.892251816,1438,3643,771,262,260,2,99,2,0.123076923,0,empty,CD-0722-1
"A1,F3",8136,8999,6169,2830,4295,2026,0,2033,1347,686,1.963556851,1139,2401,626,233,231,2,91,2,0.086580087,0,empty,CD-0722-1
"A1,F4",12068,13260,9060,4200,6244,2967,0,2974,1939,1035,1.873429952,1692,748,156,79,78,1,31,1,0.012820513,0,empty,CD-0722-1
"A1,F5",9724,10377,7340,3037,4951,2271,0,2275,1482,793,1.868852459,1280,2176,512,188,182,6,64,2,0.098901099,0,empty,CD-0722-1
"A1,F6",1749219,2031313,1312343,718970,928389,506495,6,506974,409704,97270,4.212028375,299726,257047,43078,14112,13854,258,2166,13,0.066695539,0,hg38,CD-0722-1
"A1,F7",825777,1032915,587044,445871,478813,298580,0,298838,236210,62628,3.77163569,187887,20565,7249,2195,2178,17,523,2,0.04040404,0,hg38,CD-0722-1
"A1,F8",11664,11991,8794,3197,5671,2780,0,2781,1338,1443,0.927234927,1468,444,98,23,23,0,10,0,0,0,empty,CD-0722-1
"A1,F9",7758,8539,5898,2641,4117,1992,0,1996,1294,702,1.843304843,1082,2640,633,228,228,0,65,0,0.065789474,0,empty,CD-0722-1
"A1,F10",10377,11418,7840,3578,5455,2650,0,2661,1683,978,1.720858896,1519,1764,447,143,139,4,51,1,0.09352518,0,empty,CD-0722-1
"A1,F11",7598,8561,5763,2798,4070,1944,0,1951,1283,668,1.920658683,1105,1447,177,96,94,2,40,1,0.117021277,0,empty,CD-0722-1
"A1,F12",8741,9708,6365,3343,4459,2181,0,2187,1395,792,1.761363636,1268,148,9,7,7,0,6,0,0,0,empty,CD-0722-1
"A1,G1",10044,10892,7596,3296,5275,2532,0,2539,1643,896,1.833705357,1403,2623,589,250,247,3,89,2,0.048582996,0,empty,CD-0722-1
"A1,G2",1498715,1779733,1058779,720954,826829,493495,2,493980,401741,92239,4.355435336,301413,67517,14925,4685,4636,49,907,4,0.060396894,0,hg38,CD-0722-1
"A1,G3",10717,11498,7928,3570,5534,2800,0,2805,1765,1040,1.697115385,1537,2221,464,205,203,2,81,1,0.088669951,0,empty,CD-0722-1
"A1,G4",19076,21836,13996,7840,10305,5658,0,5662,3526,2136,1.650749064,3294,263,32,20,19,1,17,1,0.105263158,0,empty,CD-0722-1
"A1,G5",6804,7765,5036,2729,3660,1860,0,1866,1147,719,1.59527121,1094,1703,370,125,125,0,52,0,0.128,0,empty,CD-0722-1
"A1,G6",9611,10685,7206,3479,5111,2516,0,2524,1609,915,1.758469945,1475,249,16,12,12,0,10,0,0,0,empty,CD-0722-1
"A1,G7",8113,9002,6086,2916,4238,2055,1,2059,1317,742,1.774932615,1131,2341,589,192,186,6,73,2,0.021505376,0,empty,CD-0722-1
"A1,G8",5299,6214,3942,2272,2955,1499,0,1499,938,561,1.67201426,893,1712,387,164,163,1,54,1,0.036809816,0,empty,CD-0722-1
"A1,G9",6843,7584,4992,2592,3680,1830,1,1837,1188,649,1.830508475,1106,2082,530,195,192,3,86,2,0.088541667,0,empty,CD-0722-1
"A1,G10",8044,9048,6093,2955,4395,2256,0,2257,1435,822,1.745742092,1308,3123,818,261,255,6,96,2,0.058823529,0,empty,CD-0722-1
"A1,G11",7995,8582,6115,2467,4215,1959,1,1966,1225,741,1.65317139,1112,1409,274,104,104,0,55,0,0.086538462,0,empty,CD-0722-1
"A1,G12",6719,7244,4977,2267,3609,1773,0,1776,1096,680,1.611764706,1073,2087,522,180,180,0,62,0,0.122222222,0,empty,CD-0722-1
"A1,H1",7137,7897,5305,2592,3713,1792,6,1803,1226,577,2.124783362,1037,1117,158,71,66,5,29,1,0,0,empty,CD-0722-1
"A1,H2",8247,9447,6039,3408,4370,2245,0,2253,1394,859,1.622817229,1369,2255,673,220,217,3,60,3,0.064516129,0,empty,CD-0722-1
"A1,H3",6676,7258,4994,2264,3427,1735,0,1741,1154,587,1.96592845,955,1886,411,137,136,1,51,1,0.029411765,0,empty,CD-0722-1
"A1,H4",10031,11107,7510,3597,5168,2515,0,2519,1682,837,2.009557945,1387,264,40,26,26,0,15,0,0.153846154,0,empty,CD-0722-1
"A1,H5",10648,11496,7953,3543,5454,2730,0,2735,1699,1036,1.63996139,1490,1945,517,155,155,0,51,0,0.032258065,0,empty,CD-0722-1
"A1,H6",6508,7309,4680,2629,3454,1859,0,1863,1265,598,2.115384615,1077,1694,388,139,133,6,49,1,0.060150376,0,empty,CD-0722-1
"A1,H7",7463,8076,5693,2383,3891,1843,1,1844,1198,646,1.854489164,1043,1858,498,175,168,7,54,2,0.19047619,0,empty,CD-0722-1
"A1,H8",13117,15294,9243,6051,7332,4295,0,4295,2935,1360,2.158088235,2558,2172,402,150,146,4,45,2,0,0,empty,CD-0722-1
"A1,H9",6467,6983,5049,1934,3371,1524,0,1525,1032,493,2.093306288,838,1174,271,107,106,1,32,1,0.037735849,0,empty,CD-0722-1
"A1,H10",624120,731063,463367,267696,336219,184712,1,184890,143522,41368,3.469396635,110488,90265,12447,4248,4145,103,787,7,0.048974668,0,hg38,CD-0722-1
"A1,H11",6997,8018,4925,3093,3796,2266,4,2272,1329,943,1.409331919,1340,45,3,2,1,1,1,1,0,0,empty,CD-0722-1
"A1,H12",6160,6866,4485,2381,3263,1693,0,1695,1096,599,1.829716194,992,1682,444,160,159,1,45,1,0.226415094,0,empty,CD-0722-1
"A2,A1",6181,6939,4521,2418,3328,1756,0,1756,1175,581,2.022375215,988,1575,266,112,111,1,24,1,0.009009009,0,empty,CD-0722-1
"A2,A2",9139,10259,6778,3481,4895,2552,0,2553,1640,913,1.796276013,1449,1969,553,200,197,3,62,2,0.035532995,0,empty,CD-0722-1
"A2,A3",5276,5790,4006,1784,2808,1420,0,1420,937,483,1.939958592,768,751,162,61,61,0,16,0,0.245901639,0,empty,CD-0722-1
"A2,A4",9988,11134,7467,3667,5183,2593,1,2595,1643,952,1.725840336,1496,875,117,60,59,1,30,1,0.033898305,0,empty,CD-0722-1
"A2,A5",421535,465283,324434,140849,219472,106037,1,106164,78313,27851,2.811855948,59333,22166,3789,1111,1087,24,271,3,0.049678013,0,hg38,CD-0722-1
"A2,A6",6722,7734,5077,2657,3730,1952,0,1956,1266,690,1.834782609,1102,2651,710,254,252,2,80,1,0.035714286,0,empty,CD-0722-1
"A2,A7",520648,594917,396522,198395,278133,143436,0,143569,112242,31327,3.582915696,82933,105880,15972,5148,5047,101,946,3,0.045967902,0,hg38,CD-0722-1
"A2,A8",3674,4121,2772,1349,1972,992,0,992,668,324,2.061728395,564,2023,537,173,172,1,53,1,0.052325581,0,empty,CD-0722-1
"A2,A9",6036,6715,4702,2013,3220,1529,0,1531,996,535,1.861682243,826,1734,359,111,108,3,44,2,0.074074074,0,empty,CD-0722-1
"A2,A10",6537,7049,5074,1975,3352,1610,0,1610,1068,542,1.970479705,842,277,56,32,32,0,19,0,0,0,empty,CD-0722-1
"A2,A11",5883,6471,4440,2031,3165,1524,0,1527,1051,476,2.207983193,834,1332,181,72,70,2,31,2,0.028571429,0,empty,CD-0722-1
"A2,A12",7517,7996,5615,2381,3807,1843,0,1847,1233,614,2.008143322,1009,2965,705,248,244,4,69,1,0.024590164,0,empty,CD-0722-1
"A2,B1",585984,655370,448843,206527,304558,152036,2,152212,119725,32487,3.685320282,86449,29211,6464,1968,1939,29,424,3,0.014440433,0,hg38,CD-0722-1
"A2,B2",6921,7388,4845,2543,3594,1888,0,1892,1178,714,1.649859944,1076,691,126,46,46,0,19,0,0.02173913,0,empty,CD-0722-1
"A2,B3",5576,6180,4156,2024,2943,1509,0,1510,961,549,1.750455373,882,1657,435,147,146,1,38,1,0.068493151,0,empty,CD-0722-1
"A2,B4",6376,7440,4674,2766,3555,1886,1,1889,1206,683,1.765739385,1141,1474,439,158,157,1,52,1,0.108280255,0,empty,CD-0722-1
"A2,B5",6135,3332,1965,1367,2192,1166,0,1178,742,436,1.701834862,795,851,241,69,68,1,21,1,0.014705882,0,empty,CD-0722-1
"A2,B6",378986,462330,263790,198540,219468,143201,0,143288,95740,47548,2.013544208,88117,1965,636,207,206,1,61,1,0.126213592,0,hg38,CD-0722-1
"A2,B7",756626,886104,568480,317624,408972,221708,2,221957,175635,46322,3.791610898,129817,108699,17896,5580,5489,91,1098,6,0.059755875,0,hg38,CD-0722-1
"A2,B8",4747,5161,3621,1540,2572,1216,0,1218,803,415,1.934939759,669,1378,327,109,109,0,37,0,0.009174312,0,empty,CD-0722-1
"A2,B9",9077,10015,6842,3173,4809,2471,0,2477,1514,963,1.572170301,1413,977,252,88,86,2,31,2,0.174418605,0,empty,CD-0722-1
"A2,B10",4771,4924,3410,1514,2508,1244,0,1247,798,449,1.777282851,698,495,40,19,18,1,9,1,0.055555556,0,empty,CD-0722-1
"A2,B11",9548,10432,7087,3345,4969,2649,0,2651,1478,1173,1.26001705,1491,218,24,12,12,0,8,0,0.083333333,0,empty,CD-0722-1
"A2,B12",5852,6381,4360,2021,3086,1523,2,1526,992,534,1.857677903,878,1742,341,89,88,1,38,1,0.022727273,0,empty,CD-0722-1
"A2,C1",11857,12877,9108,3769,6062,2866,0,2871,1820,1051,1.73168411,1575,1133,244,82,81,1,32,1,0.382716049,0,empty,CD-0722-1
"A2,C2",9170,10540,6657,3883,4960,2631,0,2636,1634,1002,1.630738523,1529,2036,542,145,145,0,48,0,0.131034483,0,empty,CD-0722-1
"A2,C3",11028,12494,8172,4322,5953,3034,0,3040,1976,1064,1.857142857,1751,894,174,51,50,1,20,1,0.3,0,empty,CD-0722-1
"A2,C4",6242,6850,4719,2131,3285,1605,0,1605,1035,570,1.815789474,905,1898,428,152,147,5,52,2,0.102040816,0,empty,CD-0722-1
"A2,C5",519284,654177,358058,296119,306787,197897,0,198082,155171,42911,3.616112419,126529,9358,3256,904,899,5,266,2,0.051167964,0,hg38,CD-0722-1
"A2,C6",7763,8382,5763,2619,4144,2131,0,2133,1405,728,1.929945055,1175,2219,517,183,176,7,58,2,0.085227273,0,empty,CD-0722-1
"A2,C7",10184,11772,7288,4484,5522,3044,0,3050,1866,1184,1.576013514,1776,517,145,60,59,1,24,1,0.152542373,0,empty,CD-0722-1
"A2,C8",637235,745218,472180,273038,344456,189950,1,190137,148563,41574,3.573459374,111890,141554,23996,7773,7615,158,1414,6,0.06671044,0,hg38,CD-0722-1
"A2,C9",7803,9037,5740,3297,4181,2155,0,2156,1441,715,2.015384615,1281,1471,358,147,146,1,40,1,0.006849315,0,empty,CD-0722-1
"A2,C10",9190,10156,6962,3194,4841,2390,0,2392,1551,841,1.844233056,1377,1716,310,137,136,1,50,1,0,0,empty,CD-0722-1
"A2,C11",1006980,1134044,783246,350798,521198,254805,2,255110,202280,52830,3.828885103,144133,84893,18941,6181,6138,43,1052,4,0.032258065,0,hg38,CD-0722-1
"A2,C12",649565,734583,493846,240737,336395,170236,4,170435,134456,35979,3.737068846,97792,70333,11923,3854,3781,73,783,5,0.040729966,0,hg38,CD-0722-1
"A2,D1",9582,10755,7107,3648,5092,2680,0,2682,1660,1022,1.624266145,1531,796,113,53,53,0,22,0,0.169811321,0,empty,CD-0722-1
"A2,D2",7885,8818,6083,2735,4161,1988,0,1991,1238,753,1.644090305,1080,3424,756,302,301,1,83,1,0.019933555,0,empty,CD-0722-1
"A2,D3",7483,8311,5546,2765,4007,2077,0,2081,1373,708,1.939265537,1180,1530,280,99,98,1,47,1,0.040816327,0,empty,CD-0722-1
"A2,D4",5654,6142,4219,1923,2989,1516,0,1516,990,526,1.882129278,826,1201,390,140,140,0,42,0,0.085714286,0,empty,CD-0722-1
"A2,D5",6636,7433,4880,2553,3561,1794,0,1798,1184,614,1.928338762,1020,1715,466,118,117,1,58,1,0.042735043,0,empty,CD-0722-1
"A2,D6",9614,10884,6890,3994,5155,2820,1,2824,1724,1100,1.567272727,1700,1158,287,87,86,1,42,1,0,0,empty,CD-0722-1
"A2,D7",5390,6000,4044,1956,2841,1395,2,1398,928,470,1.974468085,801,2002,548,184,182,2,50,2,0.06043956,0,empty,CD-0722-1
"A2,D8",6548,7302,4864,2438,3551,1758,0,1763,1123,640,1.7546875,1060,1197,268,98,97,1,42,1,0,0,empty,CD-0722-1
"A2,D9",3904,4425,2909,1516,2172,1085,0,1085,719,366,1.964480874,661,1729,441,187,184,3,63,2,0.065217391,0,empty,CD-0722-1
"A2,D10",6265,7088,4596,2492,3233,1646,0,1648,1009,639,1.579029734,964,1056,216,82,81,1,34,1,0.012345679,0,empty,CD-0722-1
"A2,D11",1115105,1268603,843458,425145,579826,304057,2,304465,245419,59046,4.156403482,174212,252178,36399,11315,11058,257,2006,9,0.031651293,0,hg38,CD-0722-1
"A2,D12",541636,582916,424424,158492,271684,122593,0,122742,93521,29221,3.200472263,66182,85059,14490,4349,4274,75,783,5,0.02292934,0,hg38,CD-0722-1
"A2,E1",11979,13279,8851,4428,6314,3226,0,3233,2043,1190,1.716806723,1822,2505,496,173,172,1,78,1,0.075581395,0,empty,CD-0722-1
"A2,E2",8393,9287,6245,3042,4415,2111,0,2111,1369,742,1.845013477,1210,1855,419,162,160,2,61,2,0.00625,0,empty,CD-0722-1
"A2,E3",5821,6521,4459,2062,3078,1521,1,1522,1027,495,2.074747475,870,2400,576,245,240,5,75,3,0.075,0,empty,CD-0722-1
"A2,E4",7894,8733,5937,2796,4092,1964,0,1967,1268,699,1.814020029,1100,2664,566,219,212,7,93,2,0.070754717,0,empty,CD-0722-1
"A2,E5",6735,7258,5125,2133,3414,1565,0,1567,1020,547,1.864716636,830,1574,408,155,149,6,47,2,0.087248322,0,empty,CD-0722-1
"A2,E6",11598,13023,8739,4284,6041,3131,0,3139,2005,1134,1.768077601,1742,3025,676,246,243,3,69,2,0.041152263,0,empty,CD-0722-1
"A2,E7",10814,11869,8223,3646,5734,2721,0,2727,1785,942,1.894904459,1542,2980,709,230,229,1,76,1,0.122270742,0,empty,CD-0722-1
"A2,E8",9034,10043,6801,3242,4680,2162,0,2165,1412,753,1.875166003,1228,2811,597,159,159,0,48,0,0.031446541,0,empty,CD-0722-1
"A2,E9",501221,609702,363854,245848,284420,164729,3,164912,135462,29450,4.599728353,101528,141954,29927,9787,9644,143,1506,3,0.06968063,0,hg38,CD-0722-1
"A2,E10",6877,7613,5123,2490,3689,1746,0,1749,1171,578,2.025951557,1020,2301,475,166,164,2,69,2,0.048780488,0,empty,CD-0722-1
"A2,E11",7921,8927,5860,3067,4212,2152,0,2155,1385,770,1.798701299,1259,1405,300,105,105,0,57,0,0.114285714,0,empty,CD-0722-1
"A2,E12",8517,9827,6453,3374,4641,2337,2,2340,1518,822,1.846715328,1376,2355,446,172,169,3,78,2,0.076923077,0,empty,CD-0722-1
"A2,F1",9668,10425,7302,3123,4996,2401,0,2401,1575,826,1.906779661,1330,2024,555,178,174,4,54,1,0.057471264,0,empty,CD-0722-1
"A2,F2",490695,600924,341589,259335,283230,176327,2,176487,133952,42535,3.149218291,110538,139303,43094,13689,13588,101,1856,7,0.064763026,0,hg38,CD-0722-1
"A2,F3",7756,8573,5738,2835,4102,2016,0,2020,1288,732,1.759562842,1185,2892,787,300,298,2,98,1,0.100671141,0,empty,CD-0722-1
"A2,F4",11551,12425,8720,3705,5864,2893,2,2909,1875,1034,1.813346228,1579,705,76,28,28,0,17,0,0,0,empty,CD-0722-1
"A2,F5",8918,9714,6665,3049,4582,2174,0,2181,1377,804,1.712686567,1232,1770,425,132,130,2,43,1,0.007692308,0,empty,CD-0722-1
"A2,F6",8891,10102,6480,3622,4875,2528,1,2534,1600,934,1.713062099,1517,2770,691,250,248,2,97,1,0.100806452,0,empty,CD-0722-1
"A2,F7",10773,11975,8063,3912,5704,2856,0,2859,1875,984,1.905487805,1612,1198,344,119,116,3,42,2,0.120689655,0,empty,CD-0722-1
"A2,F8",6690,7357,4998,2359,3575,1766,0,1769,1134,635,1.785826772,1009,195,80,23,23,0,10,0,0.130434783,0,empty,CD-0722-1
"A2,F9",7770,8354,5799,2555,3992,1894,0,1899,1273,626,2.033546326,1042,2616,472,182,181,1,63,1,0.005524862,0,empty,CD-0722-1
"A2,F10",836496,979275,617101,362174,451143,266581,3,266823,182371,84452,2.159463364,155482,22190,1393,506,487,19,127,5,0.256673511,0,hg38,CD-0722-1
"A2,F11",7414,7875,5763,2112,3751,1723,0,1725,1108,617,1.795786062,913,1414,293,93,92,1,32,1,0.152173913,0,empty,CD-0722-1
"A2,F12",8739,9689,6441,3248,4635,2291,0,2291,1544,747,2.066934404,1351,299,44,14,14,0,10,0,0.071428571,0,empty,CD-0722-1
"A2,G1",9566,10580,7173,3407,5103,2433,4,2442,1615,827,1.952841596,1444,2511,505,227,226,1,103,1,0.088495575,0,empty,CD-0722-1
"A2,G2",5534,5962,3965,1997,2868,1452,0,1455,940,515,1.825242718,842,367,80,50,50,0,26,0,0,0,empty,CD-0722-1
"A2,G3",10209,11062,7669,3393,5182,2594,1,2597,1551,1046,1.482791587,1440,2414,564,165,165,0,66,0,0.133333333,0,empty,CD-0722-1
"A2,G4",4323401,5013016,3199787,1813229,2192068,1313061,14,1314300,959513,354787,2.704476207,768460,166,29,17,17,0,13,0,0.294117647,0,empty,CD-0722-1
"A2,G5",6293,7014,4623,2391,3317,1694,0,1695,1126,569,1.978910369,944,1611,537,170,169,1,61,1,0.106508876,0,empty,CD-0722-1
"A2,G6",8842,9417,6786,2631,4377,2110,0,2110,1416,694,2.040345821,1122,198,53,23,23,0,10,0,0,0,empty,CD-0722-1
"A2,G7",7453,8137,5716,2421,3983,1849,0,1852,1249,603,2.071310116,1024,2187,444,191,188,3,79,2,0.074468085,0,empty,CD-0722-1
"A2,G8",392484,443152,298998,144154,209801,102317,2,102427,82793,19634,4.216817765,58497,90276,26869,8585,8509,76,1408,4,0.01927371,0,hg38,CD-0722-1
"A2,G9",6646,7309,5026,2283,3417,1611,0,1613,1070,543,1.97053407,902,2163,532,208,204,4,65,1,0.073529412,0,empty,CD-0722-1
"A2,G10",644377,745274,482764,262510,345632,184538,0,184726,144940,39786,3.642989996,108454,140091,20185,6726,6612,114,1243,4,0.044010889,0,hg38,CD-0722-1
"A2,G11",7999,8699,6017,2682,4212,2011,1,2020,1322,698,1.893982808,1143,1561,381,119,118,1,47,1,0.076271186,0,empty,CD-0722-1
"A2,G12",6555,7267,4943,2324,3541,1763,0,1768,1075,693,1.551226551,1021,1825,402,148,148,0,50,0,0.067567568,0,empty,CD-0722-1
"A2,H1",6378,7093,4759,2334,3348,1633,0,1641,1042,599,1.739565943,916,1123,271,86,85,1,22,1,0.047058824,0,empty,CD-0722-1
"A2,H2",13815,15264,10213,5051,7350,3665,0,3673,2696,977,2.759467758,2119,2408,658,235,233,2,67,1,0.064377682,0,empty,CD-0722-1
"A2,H3",6198,6875,4672,2203,3281,1648,0,1653,1054,599,1.759599332,935,1488,307,108,108,0,52,0,0.018518519,0,empty,CD-0722-1
"A2,H4",9577,10542,7139,3403,4874,2414,0,2422,1592,830,1.918072289,1347,302,126,45,45,0,15,0,0,0,empty,CD-0722-1
"A2,H5",10100,10955,7598,3357,5106,2483,2,2494,1597,897,1.780379041,1394,1695,372,134,132,2,38,1,0.053030303,0,empty,CD-0722-1
"A2,H6",6134,6717,4582,2135,3049,1510,0,1511,1019,492,2.071138211,832,1810,314,102,100,2,50,1,0.03,0,empty,CD-0722-1
"A2,H7",7303,8144,5496,2648,3894,1884,0,1886,1223,663,1.844645551,1122,1974,458,172,171,1,49,1,0.152046784,0,empty,CD-0722-1
"A2,H8",13544,14968,10037,4931,7209,3731,0,3741,2724,1017,2.678466077,2149,1412,340,139,138,1,46,1,0.02173913,0,empty,CD-0722-1
"A2,H9",1493001,1701025,1126699,574326,769215,404725,0,405200,329346,75854,4.341840905,233786,235033,30229,10000,9759,241,1702,4,0.056768111,0,hg38,CD-0722-1
"A2,H10",8387,9583,6283,3300,4613,2441,0,2443,1658,785,2.112101911,1363,887,114,45,45,0,26,0,0.044444444,0,empty,CD-0722-1
"A2,H11",6930,8018,4735,3283,3810,2290,0,2292,1311,981,1.336391437,1396,44,2,2,2,0,2,0,0,0,empty,CD-0722-1
"A2,H12",6551,7334,4744,2590,3506,1918,0,1918,1299,619,2.098546042,1114,1488,215,103,100,3,52,2,0.03,0,empty,CD-0722-1
"A3,A1",6900,7613,5021,2592,3671,1890,1,1891,1272,619,2.054927302,1068,1559,335,145,144,1,48,1,0.041666667,0,empty,CD-0722-1
"A3,A2",1217382,1387942,922968,464974,635686,336801,4,337192,282442,54750,5.158757991,192370,213102,29238,10304,10082,222,1650,9,0.067942868,0,hg38,CD-0722-1
"A3,A3",6560,7110,4862,2248,3277,1560,0,1564,1037,527,1.967741935,833,909,229,112,110,2,46,1,0.009090909,0,empty,CD-0722-1
"A3,A4",12242,13417,9187,4230,6328,3084,0,3094,2008,1086,1.848987109,1726,1074,217,74,74,0,37,0,0.067567568,0,empty,CD-0722-1
"A3,A5",9570,10410,7160,3250,5076,2476,0,2477,1550,927,1.67206041,1386,2644,561,209,209,0,71,0,0.09569378,0,empty,CD-0722-1
"A3,A6",10020,11349,7468,3881,5400,2776,0,2776,1941,835,2.324550898,1575,3064,767,293,291,2,105,2,0.020618557,0,empty,CD-0722-1
"A3,A7",7020,7685,5161,2524,3727,1955,5,1961,1240,721,1.719833564,1091,1719,321,100,98,2,46,1,0.051020408,0,empty,CD-0722-1
"A3,A8",4416,5000,3342,1658,2356,1191,0,1194,783,411,1.905109489,670,2324,496,193,188,5,73,1,0.026595745,0,empty,CD-0722-1
"A3,A9",7206,7935,5676,2259,3775,1777,0,1777,1226,551,2.225045372,937,2527,606,224,219,5,66,2,0.205479452,0,empty,CD-0722-1
"A3,A10",369272,412266,286892,125374,195225,93434,0,93510,75538,17972,4.203093701,52207,12089,1663,636,622,14,149,2,0.028938907,0,hg38,CD-0722-1
"A3,A11",6588,7162,5013,2149,3542,1684,0,1689,1096,593,1.848229342,945,1675,515,199,198,1,72,1,0.090909091,0,empty,CD-0722-1
"A3,A12",8981,9689,6884,2805,4520,2109,1,2117,1350,767,1.760104302,1165,3853,892,283,282,1,91,1,0.09929078,0,empty,CD-0722-1
"A3,B1",626508,749337,455218,294119,352682,208541,8,208747,163159,45588,3.578990085,126981,7913,1573,463,459,4,172,2,0.015250545,0,hg38,CD-0722-1
"A3,B2",8512,9069,5959,3110,4507,2369,0,2372,1455,917,1.586695747,1393,708,121,60,55,5,27,2,0.072727273,0,empty,CD-0722-1
"A3,B3",6192,6969,4576,2393,3291,1661,3,1664,1069,595,1.796638655,992,1196,252,102,98,4,45,1,0.112244898,0,empty,CD-0722-1
"A3,B4",6959,7694,5041,2653,3744,1979,2,1982,1297,685,1.893430657,1144,1781,317,138,136,2,68,1,0.022058824,0,empty,CD-0722-1
"A3,B5",8168,4823,2881,1942,2917,1586,0,1596,1114,482,2.31120332,1022,836,69,34,34,0,26,0,0.029411765,0,empty,CD-0722-1
"A3,B6",8302,9561,6141,3420,4376,2283,0,2283,1436,847,1.695395514,1320,1728,426,140,139,1,45,1,0.014388489,0,empty,CD-0722-1
"A3,B7",8031,8880,6151,2729,4168,2043,0,2048,1347,701,1.921540656,1127,1143,151,65,64,1,24,1,0.125,0,empty,CD-0722-1
"A3,B8",430940,471407,330872,140535,219975,105329,1,105432,85676,19756,4.336707836,57860,52533,10155,3635,3575,60,735,3,0.033846154,0,hg38,CD-0722-1
"A3,B9",10377,11362,7681,3681,5309,2731,0,2733,1741,992,1.755040323,1536,1007,305,140,140,0,51,0,0.042857143,0,empty,CD-0722-1
"A3,B10",5960,6124,4127,1997,3234,1649,1,1666,1066,600,1.776666667,1003,426,100,49,49,0,15,0,0.020408163,0,empty,CD-0722-1
"A3,B11",14037,15995,10258,5737,7666,4132,0,4138,2499,1639,1.524710189,2491,279,65,37,37,0,22,0,0.054054054,0,empty,CD-0722-1
"A3,B12",6626,7531,4862,2669,3577,1800,0,1802,1156,646,1.789473684,1046,2045,683,179,179,0,55,0,0.173184358,0,empty,CD-0722-1
"A3,C1",13562,14763,10370,4393,7005,3405,0,3408,2209,1199,1.842368641,1874,1107,200,56,56,0,30,0,0,0,empty,CD-0722-1
"A3,C2",11061,12452,8161,4291,5834,3023,0,3029,1944,1085,1.791705069,1739,2919,1023,293,293,0,70,0,0.088737201,0,empty,CD-0722-1
"A3,C3",1181497,1465965,862018,603947,674814,407919,5,408303,329475,78828,4.179669661,252475,8551,1027,353,343,10,135,2,0.055393586,0,hg38,CD-0722-1
"A3,C4",7363,8075,5536,2539,3881,1871,0,1874,1168,706,1.654390935,1081,1646,355,138,137,1,49,1,0.124087591,0,empty,CD-0722-1
"A3,C5",728907,866117,539035,327082,406453,238807,1,239057,167065,71992,2.320605067,143421,23884,5179,1678,1670,8,388,2,0.046107784,0,hg38,CD-0722-1
"A3,C6",10137,11558,7474,4084,5683,2944,1,2951,1972,979,2.014300306,1754,1873,570,241,240,1,89,1,0.133333333,0,empty,CD-0722-1
"A3,C7",11915,13788,8561,5227,6523,3585,2,3594,2178,1416,1.538135593,2128,540,103,33,32,1,18,1,0.03125,0,empty,CD-0722-1
"A3,C8",13257,14389,9864,4525,6838,3405,0,3410,2246,1164,1.929553265,1850,2965,681,254,252,2,79,1,0.126984127,0,empty,CD-0722-1
"A3,C9",8974,10211,6702,3509,4844,2411,3,2416,1534,882,1.739229025,1428,1938,415,136,136,0,40,0,0.117647059,0,empty,CD-0722-1
"A3,C10",1370023,1542110,1046669,495441,705677,360157,2,360599,284345,76254,3.728919139,206002,145218,25017,8134,7987,147,1398,7,0.053336672,0,hg38,CD-0722-1
"A3,C11",1768593,2073726,1305818,767908,946029,530340,5,530855,432294,98561,4.386055336,319657,134293,18766,6222,6081,141,1240,4,0.049333991,0,hg38,CD-0722-1
"A3,C12",12510,13841,9309,4532,6677,3258,0,3267,2131,1136,1.875880282,1893,2325,540,194,191,3,60,1,0.178010471,0,empty,CD-0722-1
"A3,D1",798893,939917,582736,357181,437422,247356,4,247606,208485,39121,5.329234938,148674,61837,10677,3377,3313,64,646,3,0.032598853,0,hg38,CD-0722-1
"A3,D2",814467,899693,630035,269658,414536,199758,3,200001,155634,44367,3.507877477,110894,238956,41939,13823,13587,236,1959,8,0.055935821,0,hg38,CD-0722-1
"A3,D3",850820,1005665,623983,381682,465414,261822,3,262059,208323,53736,3.876786512,156734,16640,6173,1964,1954,10,540,3,0.060900716,0,hg38,CD-0722-1
"A3,D4",7187,8191,5334,2857,4064,2010,0,2012,1330,682,1.950146628,1233,1753,465,172,169,3,54,2,0.106508876,0,empty,CD-0722-1
"A3,D5",7745,8469,5893,2576,4013,1972,0,1974,1273,701,1.815977175,1079,2060,452,187,187,0,77,0,0.026737968,0,empty,CD-0722-1
"A3,D6",689629,789077,518206,270871,366514,192124,1,192341,145495,46846,3.105814797,112545,111902,14892,4795,4695,100,975,6,0.029179979,0,hg38,CD-0722-1
"A3,D7",6494,7316,4955,2361,3371,1629,0,1629,1080,549,1.967213115,903,1963,460,148,148,0,61,0,0.108108108,0,empty,CD-0722-1
"A3,D8",7513,8257,5656,2601,4026,1940,0,1942,1228,714,1.719887955,1108,1578,380,137,137,0,58,0,0.072992701,0,empty,CD-0722-1
"A3,D9",4959,5330,3769,1561,2600,1224,0,1224,851,373,2.28150134,669,1827,367,132,130,2,57,1,0.092307692,0,empty,CD-0722-1
"A3,D10",835963,971072,627455,343617,448774,238927,4,239196,185913,53283,3.489161646,141717,68280,9340,3343,3278,65,646,4,0.046674802,0,hg38,CD-0722-1
"A3,D11",600688,695164,448203,246961,323200,174163,1,174370,146727,27643,5.307926057,103043,168397,27890,8947,8793,154,1500,8,0.06311839,0,hg38,CD-0722-1
"A3,D12",11223,12371,8308,4063,5820,2863,0,2868,1861,1007,1.848063555,1645,3734,895,333,329,4,96,2,0.030395137,0,empty,CD-0722-1
"A3,E1",12672,13516,9452,4064,6522,3254,0,3259,2061,1198,1.720367279,1770,2808,395,190,186,4,99,1,0.037634409,0,empty,CD-0722-1
"A3,E2",9652,10982,7111,3871,5281,2714,0,2715,1720,995,1.728643216,1587,2428,420,163,160,3,50,2,0.13125,0,empty,CD-0722-1
"A3,E3",6822,7530,5276,2254,3647,1746,0,1750,1117,633,1.764612954,967,3128,869,262,260,2,98,2,0.015384615,0,empty,CD-0722-1
"A3,E4",9080,10074,6716,3358,4766,2346,0,2352,1476,876,1.684931507,1332,2982,452,192,187,5,92,2,0.037433155,0,empty,CD-0722-1
"A3,E5",8197,8797,6341,2456,4360,2000,0,2002,1253,749,1.672897196,1147,1648,491,185,183,2,72,2,0.043715847,0,empty,CD-0722-1
"A3,E6",13546,14827,10205,4622,6959,3483,0,3492,2195,1297,1.692367001,1908,3412,845,296,293,3,88,2,0.136518771,0,empty,CD-0722-1
"A3,E7",12401,13543,9414,4129,6425,3063,0,3066,2036,1030,1.976699029,1698,3106,721,269,261,8,101,2,0.045977011,0,empty,CD-0722-1
"A3,E8",10559,11391,8141,3250,5384,2595,0,2603,1686,917,1.838604144,1390,2499,540,200,198,2,69,1,0.212121212,0,empty,CD-0722-1
"A3,E9",6105,6777,4608,2169,3271,1588,0,1594,1056,538,1.962825279,916,2703,500,195,192,3,83,1,0.0625,0,empty,CD-0722-1
"A3,E10",8009,9034,5997,3037,4306,2074,8,2082,1370,712,1.924157303,1242,1980,418,163,161,2,58,1,0.180124224,0,empty,CD-0722-1
"A3,E11",9291,10126,6907,3219,4859,2422,0,2425,1565,860,1.819767442,1372,2680,560,201,201,0,65,0,0.059701493,0,empty,CD-0722-1
"A3,E12",9541,10470,7079,3391,5098,2514,0,2518,1639,879,1.864618885,1440,2171,480,192,182,10,68,2,0.027472527,0,empty,CD-0722-1
"A3,F1",11684,12861,8749,4112,6032,2884,0,2893,1843,1050,1.755238095,1673,2599,816,286,285,1,79,1,0.052631579,0,empty,CD-0722-1
"A3,F2",948092,1090665,717133,373532,502771,271177,6,271508,218893,52615,4.160277487,158097,252957,38311,12985,12665,320,2091,8,0.060481642,0,hg38,CD-0722-1
"A3,F3",8786,10011,6459,3552,4662,2311,0,2314,1522,792,1.921717172,1377,3339,837,298,291,7,103,2,0.137457045,0,empty,CD-0722-1
"A3,F4",14100,15027,10386,4641,7175,3471,2,3477,2207,1270,1.737795276,1955,811,131,51,47,4,31,1,0.042553191,0,empty,CD-0722-1
"A3,F5",823726,940280,611152,329128,430764,234266,3,234541,185290,49251,3.762157114,136776,117984,23329,7633,7488,145,1280,7,0.032986111,0,hg38,CD-0722-1
"A3,F6",10415,11608,7677,3931,5629,2967,0,2972,1884,1088,1.731617647,1732,3785,813,308,303,5,109,2,0.02310231,0,empty,CD-0722-1
"A3,F7",1070167,1286110,789447,496663,587841,336886,0,337201,273596,63605,4.301485732,203140,46894,7693,2587,2547,40,586,4,0.067923047,0,hg38,CD-0722-1
"A3,F8",9519,10473,7261,3212,5013,2443,0,2448,1625,823,1.974483597,1343,197,73,29,29,0,13,0,0,0,empty,CD-0722-1
"A3,F9",9237,10363,7020,3343,4906,2385,0,2385,1576,809,1.948084054,1328,3133,939,353,349,4,86,1,0.126074499,0,empty,CD-0722-1
"A3,F10",11970,12758,9100,3658,6017,2747,1,2755,1771,984,1.799796748,1468,1992,469,183,182,1,64,1,0.038461538,0,empty,CD-0722-1
"A3,F11",666594,741153,513430,227723,344716,168755,1,168949,129129,39820,3.24281768,94706,117967,11319,3982,3850,132,800,5,0.058961039,0,hg38,CD-0722-1
"A3,F12",10373,11301,7624,3677,5561,2780,0,2788,1806,982,1.83910387,1623,245,70,36,34,2,12,1,0.323529412,0,empty,CD-0722-1
"A3,G1",11674,12491,8910,3581,6123,2913,0,2915,1896,1019,1.860647694,1602,3164,866,362,360,2,123,2,0.055555556,0,empty,CD-0722-1
"A3,G2",6577,7331,4744,2587,3462,1767,0,1768,1094,674,1.623145401,1028,405,90,37,36,1,13,1,0,0,empty,CD-0722-1
"A3,G3",13416,14554,10142,4412,6924,3432,0,3433,2176,1257,1.731105807,1841,3229,724,250,243,7,96,3,0.020576132,0,empty,CD-0722-1
"A3,G4",21754,23740,15628,8112,11478,6269,0,6281,3829,2452,1.561582382,3650,311,43,28,28,0,16,0,0.107142857,0,empty,CD-0722-1
"A3,G5",7448,8137,5562,2575,4002,1948,0,1949,1254,695,1.804316547,1125,2094,551,210,208,2,74,1,0.158653846,0,empty,CD-0722-1
"A3,G6",11167,12273,8342,3931,5686,2779,0,2782,1783,999,1.784784785,1598,219,29,20,19,1,10,1,0.263157895,0,empty,CD-0722-1
"A3,G7",671291,744904,518513,226391,348770,167212,2,167405,131185,36220,3.621893981,93577,177872,32488,10386,10204,182,1601,5,0.040670325,0,hg38,CD-0722-1
"A3,G8",6386,7109,4635,2474,3426,1729,4,1734,1141,593,1.924114671,1033,1917,487,185,181,4,59,2,0.049723757,0,empty,CD-0722-1
"A3,G9",7755,8562,5836,2726,4050,1987,0,1991,1306,685,1.906569343,1115,2355,571,236,236,0,78,0,0.021186441,0,empty,CD-0722-1
"A3,G10",8891,9713,6671,3042,4676,2347,0,2347,1532,815,1.879754601,1315,2719,652,278,276,2,101,1,0.170289855,0,empty,CD-0722-1
"A3,G11",9276,10171,6963,3208,4946,2399,0,2401,1551,850,1.824705882,1354,1877,520,180,180,0,66,0,0.033333333,0,empty,CD-0722-1
"A3,G12",7727,8748,5778,2970,4051,2095,0,2097,1332,765,1.741176471,1160,2444,663,243,243,0,66,0,0.090534979,0,empty,CD-0722-1
"A3,H1",7596,8352,5654,2698,4099,1986,0,1993,1280,713,1.795231417,1159,1118,273,91,90,1,43,1,0.1,0,empty,CD-0722-1
"A3,H2",951084,1116544,704088,412456,513795,285423,2,285701,222603,63098,3.527893119,170608,186343,27480,9281,9101,180,1523,7,0.068893528,0,hg38,CD-0722-1
"A3,H3",821651,977985,603673,374312,452239,255341,1,255620,199938,55682,3.590711541,154739,146552,18099,5909,5776,133,1244,6,0.05367036,0,hg38,CD-0722-1
"A3,H4",775903,869826,592935,276891,399574,198191,1,198388,155355,43033,3.610136407,113265,3565,735,205,198,7,51,2,0.03030303,0,hg38,CD-0722-1
"A3,H5",11958,13088,8814,4274,6090,2979,1,2985,1909,1076,1.774163569,1697,1987,525,169,169,0,56,0,0.076923077,0,empty,CD-0722-1
"A3,H6",6800,7583,4981,2602,3653,1901,0,1902,1238,664,1.864457831,1106,1811,457,189,187,2,54,1,0.080213904,0,empty,CD-0722-1
"A3,H7",8302,8867,6239,2628,4332,2075,0,2078,1381,697,1.981348637,1147,2392,611,251,250,1,78,1,0.084,0,empty,CD-0722-1
"A3,H8",9152,10512,6750,3762,4967,2640,0,2642,1706,936,1.822649573,1573,1917,429,140,137,3,53,1,0.102189781,0,empty,CD-0722-1
"A3,H9",8494,9353,6364,2989,4434,2105,0,2109,1454,655,2.219847328,1153,1396,260,98,98,0,35,0,0.091836735,0,empty,CD-0722-1
"A3,H10",6578,7150,4912,2238,3400,1649,0,1655,1067,588,1.81462585,936,1203,209,97,96,1,39,1,0.020833333,0,empty,CD-0722-1
"A3,H11",7621,9139,5226,3913,4512,2786,0,2789,1525,1264,1.206487342,1714,100,14,12,12,0,7,0,0,0,empty,CD-0722-1
"A3,H12",6823,7417,4998,2419,3620,1873,0,1877,1230,647,1.901081917,1056,1629,255,81,80,1,44,1,0.05,0,empty,CD-0722-1
"A4,A1",6893,7451,5113,2338,3614,1815,0,1816,1183,633,1.868878357,1016,1538,317,92,92,0,35,0,0.119565217,0,empty,CD-0722-1
"A4,A2",10309,11307,7725,3582,5433,2633,6,2644,1663,981,1.69520897,1524,2800,619,232,225,7,67,2,0.151111111,0,empty,CD-0722-1
"A4,A3",6556,7312,4840,2472,3380,1658,5,1663,1094,569,1.922671353,948,1376,278,104,103,1,32,1,0.097087379,0,empty,CD-0722-1
"A4,A4",12156,13601,9158,4443,6143,3059,0,3061,1924,1137,1.692172383,1732,1310,467,137,136,1,45,1,0.014705882,0,empty,CD-0722-1
"A4,A5",637419,717624,485148,232476,332545,168326,0,168522,129000,39522,3.264004858,96683,173751,21124,6884,6695,189,1206,8,0.062135922,0,hg38,CD-0722-1
"A4,A6",7747,8801,5817,2984,4169,2177,0,2178,1462,716,2.041899441,1233,3538,800,280,278,2,116,1,0.021582734,0,empty,CD-0722-1
"A4,A7",6959,7796,5199,2597,3716,1891,0,1895,1259,636,1.979559748,1062,1729,323,124,124,0,51,0,0.032258065,0,empty,CD-0722-1
"A4,A8",381483,472334,276446,195888,223472,138895,0,139019,96688,42331,2.284094399,85533,44239,11647,3690,3641,49,695,4,0.040098874,0,hg38,CD-0722-1
"A4,A9",7027,7754,5285,2469,3714,1867,0,1870,1194,676,1.766272189,1085,2006,498,214,210,4,57,2,0.195238095,0,empty,CD-0722-1
"A4,A10",7407,7873,5712,2161,3751,1807,0,1818,1145,673,1.701337296,961,458,97,34,33,1,19,1,0.03030303,0,empty,CD-0722-1
"A4,A11",577176,691901,418198,273703,324029,200035,4,200250,152330,47920,3.178839733,117954,22257,8460,2388,2381,7,566,2,0.01301974,0,hg38,CD-0722-1
"A4,A12",8517,9119,6438,2681,4277,2018,0,2027,1305,722,1.807479224,1121,3578,710,294,289,5,85,2,0.079584775,0,empty,CD-0722-1
"A4,B1",7471,8186,5466,2720,3918,1978,0,1983,1248,735,1.697959184,1146,1596,255,91,89,2,33,2,0,0,empty,CD-0722-1
"A4,B2",8639,9471,6055,3416,4543,2451,0,2454,1451,1003,1.44666002,1442,686,203,77,76,1,22,1,0.184210526,0,empty,CD-0722-1
"A4,B3",6040,6743,4478,2265,3225,1638,0,1641,1050,591,1.776649746,952,1398,152,81,81,0,34,0,0,0,empty,CD-0722-1
"A4,B4",6897,7694,5128,2566,3687,1888,0,1890,1171,719,1.628650904,1064,1711,390,155,151,4,68,2,0.198675497,0,empty,CD-0722-1
"A4,B5",7411,3998,2414,1584,2620,1375,0,1387,886,501,1.768463074,904,1037,255,87,87,0,26,0,0.252873563,0,empty,CD-0722-1
"A4,B6",7861,8936,5605,3331,4282,2312,0,2316,1497,819,1.827838828,1412,1892,455,129,125,4,38,2,0.008,0,empty,CD-0722-1
"A4,B7",7934,8780,6119,2661,4108,1918,0,1918,1303,615,2.118699187,1054,1251,251,109,108,1,42,1,0.018518519,0,empty,CD-0722-1
"A4,B8",5472,5975,4215,1760,2915,1417,0,1417,932,485,1.921649485,769,1507,388,170,166,4,56,1,0.018072289,0,empty,CD-0722-1
"A4,B9",10326,11180,7625,3555,5244,2691,3,2698,1622,1076,1.507434944,1482,1009,324,105,105,0,40,0,0.114285714,0,empty,CD-0722-1
"A4,B10",5189,5616,3821,1795,2761,1322,1,1329,839,490,1.712244898,770,673,132,58,55,3,23,2,0,0,empty,CD-0722-1
"A4,B11",10898,12312,7906,4406,5756,3100,0,3101,1712,1389,1.232541397,1833,294,35,23,22,1,13,1,0,0,empty,CD-0722-1
"A4,B12",6638,7331,4763,2568,3564,1836,0,1837,1189,648,1.834876543,1085,1679,429,150,147,3,52,2,0.074829932,0,empty,CD-0722-1
"A4,C1",13743,14636,10430,4206,6916,3276,0,3280,2056,1224,1.679738562,1787,985,218,79,78,1,38,1,0.025641026,0,empty,CD-0722-1
"A4,C2",879795,1037642,643427,394215,471425,267125,1,267403,219189,48214,4.546169162,160344,154909,30288,9781,9622,159,1605,7,0.034712118,0,hg38,CD-0722-1
"A4,C3",11753,13004,8949,4055,6219,3019,0,3026,1978,1048,1.88740458,1692,1061,230,67,67,0,30,0,0.044776119,0,empty,CD-0722-1
"A4,C4",7131,7664,5396,2268,3602,1701,1,1709,1089,620,1.756451613,953,1802,395,137,136,1,66,1,0.161764706,0,empty,CD-0722-1
"A4,C5",10808,12138,8110,4028,5766,2881,0,2887,1913,974,1.964065708,1673,1895,409,143,142,1,58,1,0.133802817,0,empty,CD-0722-1
"A4,C6",9771,10609,7268,3341,5098,2554,0,2559,1738,821,2.116930572,1439,2303,657,229,229,0,88,0,0.07860262,0,empty,CD-0722-1
"A4,C7",11792,13551,8572,4979,6349,3484,0,3484,1994,1490,1.338255034,2068,600,158,70,68,2,26,2,0.205882353,0,empty,CD-0722-1
"A4,C8",12925,14392,9753,4639,6807,3352,0,3353,2198,1155,1.903030303,1902,3158,769,269,266,3,93,2,0.041353383,0,empty,CD-0722-1
"A4,C9",9155,10601,6731,3870,4908,2485,0,2487,1660,827,2.007255139,1506,1522,386,177,174,3,49,2,0.137931034,0,empty,CD-0722-1
"A4,C10",10551,11763,7943,3820,5443,2691,0,2698,1777,921,1.929424539,1518,2763,478,164,163,1,68,1,0.073619632,0,empty,CD-0722-1
"A4,C11",9688,10445,7302,3143,4835,2325,0,2329,1447,882,1.640589569,1285,2240,609,215,212,3,61,2,0.127358491,0,empty,CD-0722-1
"A4,C12",930077,1109243,672356,436887,506871,308929,8,309233,210918,98315,2.14532879,186225,33244,13767,3991,3980,11,694,3,0.017336683,0,hg38,CD-0722-1
"A4,D1",13309,15126,9443,5683,7239,4101,0,4103,2599,1504,1.728058511,2440,1012,241,54,52,2,22,1,0.346153846,0,empty,CD-0722-1
"A4,D2",10215,11153,7871,3282,5142,2384,0,2387,1528,859,1.778812573,1296,3169,767,265,261,4,93,2,0.030651341,0,empty,CD-0722-1
"A4,D3",8635,9562,6256,3306,4564,2259,0,2266,1451,815,1.780368098,1316,1557,302,113,112,1,55,1,0.035714286,0,empty,CD-0722-1
"A4,D4",6422,7077,4863,2214,3277,1598,0,1598,1014,584,1.73630137,879,1781,482,166,166,0,54,0,0,0,empty,CD-0722-1
"A4,D5",7468,8131,5624,2507,3935,1901,0,1909,1248,661,1.888048411,1061,2030,396,142,137,5,50,2,0.131386861,0,empty,CD-0722-1
"A4,D6",11165,12498,8141,4357,5841,3074,0,3080,1893,1187,1.594776748,1784,2224,398,134,133,1,53,1,0.060150376,0,empty,CD-0722-1
"A4,D7",6347,6925,4857,2068,3302,1544,0,1552,1035,517,2.001934236,832,2280,550,164,163,1,52,1,0,0,empty,CD-0722-1
"A4,D8",8436,9089,6394,2695,4295,2047,0,2049,1390,659,2.109256449,1134,1532,374,114,113,1,49,1,0.10619469,0,empty,CD-0722-1
"A4,D9",4209,4451,3148,1303,2201,1026,0,1028,651,377,1.726790451,586,2187,460,170,169,1,66,1,0.076923077,0,empty,CD-0722-1
"A4,D10",8297,9077,6160,2917,4323,2209,0,2215,1390,825,1.684848485,1297,935,158,37,36,1,14,1,0,0,empty,CD-0722-1
"A4,D11",8916,9829,6734,3095,4674,2216,0,2219,1515,704,2.151988636,1279,3512,839,294,293,1,108,1,0.044368601,0,empty,CD-0722-1
"A4,D12",11420,12942,8492,4450,5891,2942,0,2946,1927,1019,1.891069676,1685,3610,858,332,329,3,111,2,0.018237082,0,empty,CD-0722-1
"A4,E1",13049,14299,9821,4478,6840,3401,0,3410,2149,1261,1.704203013,1955,3151,529,214,208,6,88,2,0.211538462,0,empty,CD-0722-1
"A4,E2",9587,10682,7010,3672,5069,2484,0,2490,1504,986,1.52535497,1433,2670,617,202,198,4,70,2,0.121212121,0,empty,CD-0722-1
"A4,E3",6973,7786,5270,2516,3700,1809,0,1811,1115,696,1.602011494,1055,3495,998,338,337,1,87,1,0.080118694,0,empty,CD-0722-1
"A4,E4",590692,664234,453233,211001,307857,150473,1,150659,112122,38537,2.909463632,86227,193801,24061,7879,7648,231,1387,7,0.036480126,0,hg38,CD-0722-1
"A4,E5",8615,9410,6521,2889,4393,2054,0,2057,1367,690,1.98115942,1178,1900,446,121,118,3,50,1,0.016949153,0,empty,CD-0722-1
"A4,E6",831766,965560,624004,341556,434245,234541,3,234793,183365,51428,3.565470172,137530,140434,21701,7154,7022,132,1306,6,0.050412988,0,hg38,CD-0722-1
"A4,E7",12153,13015,9171,3844,6049,2858,2,2864,1800,1064,1.691729323,1567,3996,963,332,332,0,90,0,0.081325301,0,empty,CD-0722-1
"A4,E8",10546,11337,8134,3203,5297,2456,0,2460,1658,802,2.067331671,1304,2960,611,226,223,3,72,1,0.076233184,0,empty,CD-0722-1
"A4,E9",6219,7001,4725,2276,3239,1607,0,1607,1098,509,2.157170923,882,3199,753,265,263,2,86,1,0.068441065,0,empty,CD-0722-1
"A4,E10",7924,8532,6056,2476,4099,1977,0,1981,1257,724,1.736187845,1085,2421,635,201,201,0,66,0,0,0,empty,CD-0722-1
"A4,E11",735736,829483,559508,269975,382373,195430,2,195663,150240,45423,3.307575457,111525,304888,33009,10926,10636,290,1775,10,0.047292215,0,hg38,CD-0722-1
"A4,E12",9730,10846,7257,3589,5047,2512,0,2517,1609,908,1.772026432,1420,1999,355,165,161,4,57,2,0.055900621,0,empty,CD-0722-1
"A4,F1",662601,731980,506442,225538,338315,166494,2,166712,131722,34990,3.764561303,94369,51796,12567,3880,3829,51,718,3,0.016975712,0,hg38,CD-0722-1
"A4,F2",9328,9942,6815,3127,4708,2284,0,2287,1496,791,1.891276865,1272,3598,761,349,343,6,114,2,0.096209913,0,empty,CD-0722-1
"A4,F3",8722,9758,6527,3231,4628,2282,1,2287,1489,798,1.865914787,1352,3348,822,289,279,10,95,3,0.096774194,0,empty,CD-0722-1
"A4,F4",4290953,5000697,3170297,1830400,2162004,1286629,64,1288109,1029101,259008,3.973240209,758895,170647,27750,9254,9123,131,1556,6,0.091088458,0,hg38,CD-0722-1
"A4,F5",11112,11700,8326,3374,5450,2503,0,2510,1621,889,1.823397075,1344,2545,676,255,252,3,86,1,0.111111111,0,empty,CD-0722-1
"A4,F6",9973,11274,7399,3875,5225,2647,0,2655,1652,1003,1.647058824,1587,3565,858,324,320,4,98,1,0.09375,0,empty,CD-0722-1
"A4,F7",12773,14246,9754,4492,6451,3082,0,3084,1964,1120,1.753571429,1720,1340,219,101,99,2,45,1,0.151515152,0,empty,CD-0722-1
"A4,F8",8249,9174,6321,2853,4334,2070,1,2078,1313,765,1.716339869,1153,354,27,16,12,4,7,2,0,0,empty,CD-0722-1
"A4,F9",873918,1027041,645996,381045,469822,262277,2,262524,207847,54677,3.801360718,155845,307031,42926,14349,14031,318,2037,8,0.059154729,0,hg38,CD-0722-1
"A4,F10",12356,13735,9371,4364,6267,2920,0,2921,1898,1023,1.855327468,1624,1728,496,151,150,1,44,1,0.04,0,empty,CD-0722-1
"A4,F11",8736,9407,6653,2754,4431,2049,0,2056,1340,716,1.87150838,1122,2326,341,116,113,3,42,2,0.079646018,0,empty,CD-0722-1
"A4,F12",10101,10925,7561,3364,5002,2385,0,2395,1572,823,1.910085055,1347,161,17,9,9,0,4,0,0,0,empty,CD-0722-1
"A4,G1",11384,12249,8637,3612,5815,2699,0,2703,1745,958,1.821503132,1494,3446,839,300,296,4,110,2,0.050675676,0,empty,CD-0722-1
"A4,G2",6642,7270,4750,2520,3358,1704,0,1704,1097,607,1.807248764,994,442,105,33,33,0,20,0,0.090909091,0,empty,CD-0722-1
"A4,G3",12149,12986,9088,3898,6107,3034,0,3040,1839,1201,1.53122398,1602,3382,566,195,194,1,79,1,0.082474227,0,empty,CD-0722-1
"A4,G4",1136189,1319023,847158,471865,596583,337341,12,337675,255141,82534,3.091344173,198131,680,105,33,32,1,18,1,0,0,empty,CD-0722-1
"A4,G5",7712,8334,5785,2549,3897,1907,0,1909,1224,685,1.786861314,1069,2224,704,231,231,0,75,0,0.021645022,0,empty,CD-0722-1
"A4,G6",11111,12602,8327,4275,5703,2838,0,2840,1812,1028,1.762645914,1650,254,35,15,13,2,12,1,0,0,empty,CD-0722-1
"A4,G7",8838,9651,6741,2910,4586,2118,0,2120,1442,678,2.126843658,1138,3385,742,291,284,7,110,1,0.038732394,0,empty,CD-0722-1
"A4,G8",6103,6561,4558,2003,3101,1461,0,1463,926,537,1.724394786,822,2480,415,170,169,1,56,1,0.059171598,0,empty,CD-0722-1
"A4,G9",7915,8587,5790,2797,4026,1973,0,1975,1276,699,1.82546495,1112,2865,763,286,281,5,78,3,0.138790036,0,empty,CD-0722-1
"A4,G10",9134,10059,6867,3192,4691,2294,0,2299,1476,823,1.793438639,1273,3042,723,280,269,11,100,2,0.044609665,0,empty,CD-0722-1
"A4,G11",1372020,1516055,1050343,465712,687116,341313,3,341695,270569,71126,3.804080083,191164,136269,13346,4399,4242,157,999,5,0.030174446,0,hg38,CD-0722-1
"A4,G12",7853,8899,5797,3102,4155,2138,0,2141,1302,839,1.551847437,1239,2536,765,257,252,5,67,2,0.099206349,0,empty,CD-0722-1
"A4,H1",723710,850546,527662,322884,394212,220337,2,220548,178353,42195,4.226875222,133233,93203,16377,5154,5066,88,958,4,0.052309514,0,hg38,CD-0722-1
"A4,H2",9252,10165,6824,3341,4742,2396,0,2398,1569,829,1.892641737,1323,2543,704,263,262,1,73,1,0.08778626,0,empty,CD-0722-1
"A4,H3",617514,703832,460804,243028,326113,171975,1,172150,138451,33699,4.108460192,100845,80986,14842,4673,4582,91,853,5,0.025316456,0,hg38,CD-0722-1
"A4,H4",11300,12383,8456,3927,5595,2706,0,2708,1697,1011,1.678536103,1521,279,50,30,29,1,15,1,0.310344828,0,empty,CD-0722-1
"A4,H5",12322,13618,9140,4478,6214,3117,0,3121,2008,1113,1.804132974,1796,2180,574,216,206,10,56,2,0.033980583,0,empty,CD-0722-1
"A4,H6",627256,736119,462038,274081,341230,188993,2,189210,154775,34435,4.49470016,113346,164133,20513,6457,6253,204,1227,7,0.024628178,0,hg38,CD-0722-1
"A4,H7",8633,9649,6321,3328,4740,2341,3,2349,1570,779,2.015404365,1377,2440,671,223,223,0,73,0,0.080717489,0,empty,CD-0722-1
"A4,H8",8852,9955,6490,3465,4610,2342,0,2348,1423,925,1.538378378,1365,2340,678,211,211,0,51,0,0.156398104,0,empty,CD-0722-1
"A4,H9",7224,7934,5591,2343,3666,1695,0,1697,1130,567,1.992945326,937,1783,459,161,160,1,36,1,0,0,empty,CD-0722-1
"A4,H10",7138,8088,5435,2653,3819,1885,0,1889,1274,615,2.071544715,1077,1763,472,156,156,0,39,0,0.192307692,0,empty,CD-0722-1
"A4,H11",715499,839516,528968,310548,388168,212461,0,212709,168568,44141,3.81885322,128226,3028,331,99,97,2,33,1,0.06185567,0,empty,CD-0722-1
"A4,H12",6550,7099,4703,2396,3385,1723,0,1728,1142,586,1.948805461,986,1645,312,105,104,1,37,1,0.028846154,0,empty,CD-0722-1
"A5,A1",510673,585829,388924,196905,278197,141896,4,142024,107778,34246,3.147170472,82553,153561,20578,7171,7020,151,1193,6,0.064102564,0,hg38,CD-0722-1
"A5,A2",9433,10310,6867,3443,5066,2574,0,2578,1608,970,1.657731959,1460,1842,442,175,175,0,66,0,0.022857143,0,empty,CD-0722-1
"A5,A3",5593,6062,4246,1816,2895,1427,0,1427,907,520,1.744230769,799,1794,369,151,149,2,43,1,0.026845638,0,empty,CD-0722-1
"A5,A4",10300,11071,7870,3201,5310,2533,1,2540,1595,945,1.687830688,1379,656,100,45,45,0,30,0,0.088888889,0,empty,CD-0722-1
"A5,A5",8407,9062,6285,2777,4465,2166,0,2168,1411,757,1.863936592,1231,2693,637,222,218,4,62,2,0.197247706,0,empty,CD-0722-1
"A5,A6",6920,7832,5150,2682,3839,2028,0,2028,1305,723,1.804979253,1145,2565,609,201,200,1,82,1,0.135,0,empty,CD-0722-1
"A5,A7",490111,564026,367350,196676,265351,141259,1,141389,111759,29630,3.771819102,82516,56257,9618,3224,3155,69,663,4,0.023771791,0,hg38,CD-0722-1
"A5,A8",3849,4328,2869,1459,2053,1048,0,1050,731,319,2.29153605,616,112742,9517,3348,3224,124,697,6,0.030397022,0,empty,CD-0722-1
"A5,A9",6513,7124,4931,2193,3524,1708,0,1709,1112,597,1.862646566,980,1662,245,112,111,1,50,1,0.072072072,0,empty,CD-0722-1
"A5,A10",6538,7081,5019,2062,3419,1637,0,1638,1026,612,1.676470588,892,491,124,44,44,0,17,0,0.022727273,0,empty,CD-0722-1
"A5,A11",5908,6514,4549,1965,3216,1543,6,1550,1046,504,2.075396825,844,1758,414,175,174,1,61,1,0.045977011,0,empty,CD-0722-1
"A5,A12",1082739,1198481,830102,368379,546779,269432,4,269788,219343,50445,4.348161364,151968,464514,42856,14645,14115,530,2388,11,0.059865391,0,hg38,CD-0722-1
"A5,B1",6705,7382,5073,2309,3468,1788,1,1792,1110,682,1.627565982,1021,1301,230,101,99,2,34,1,0.03030303,0,empty,CD-0722-1
"A5,B2",7053,7843,4838,3005,3808,2048,6,2058,1278,780,1.638461538,1193,696,176,61,60,1,25,1,0.333333333,0,empty,CD-0722-1
"A5,B3",5301,5830,3861,1969,2825,1456,0,1457,955,502,1.902390438,825,1327,229,68,67,1,34,1,0.044776119,0,empty,CD-0722-1
"A5,B4",6133,6854,4578,2276,3310,1645,0,1647,1056,591,1.78680203,962,1618,354,126,122,4,47,2,0.196721311,0,empty,CD-0722-1
"A5,B5",7708,5040,3067,1973,2973,1579,0,1584,1066,518,2.057915058,996,849,211,96,96,0,17,0,0.177083333,0,empty,CD-0722-1
"A5,B6",6790,7770,4976,2794,3741,1996,0,2000,1245,755,1.649006623,1173,1660,445,132,131,1,47,1,0.030534351,0,empty,CD-0722-1
"A5,B7",6931,7567,5225,2342,3587,1702,0,1707,1101,606,1.816831683,962,1596,297,89,89,0,27,0,0.02247191,0,empty,CD-0722-1
"A5,B8",4856,5255,3786,1469,2554,1179,0,1179,778,401,1.940149626,646,1411,224,95,95,0,44,0,0.073684211,0,empty,CD-0722-1
"A5,B9",8935,10186,6636,3550,4780,2473,0,2473,1564,909,1.720572057,1421,1040,216,87,86,1,20,1,0.069767442,0,empty,CD-0722-1
"A5,B10",545511,580112,373765,206347,283948,147929,33,149016,110915,38101,2.911078449,89361,23746,2508,845,815,30,213,3,0.060122699,0,hg38,CD-0722-1
"A5,B11",544943,619668,404813,214855,286950,151454,8,151623,118400,33223,3.563796165,88269,19325,2956,1103,1091,12,236,2,0.019248396,0,hg38,CD-0722-1
"A5,B12",5757,6366,4252,2114,3192,1645,0,1648,1091,557,1.958707361,950,1701,282,97,96,1,47,1,0.010416667,0,empty,CD-0722-1
"A5,C1",12066,13136,9000,4136,6121,2904,0,2911,1845,1066,1.730769231,1586,972,219,95,95,0,36,0,0.094736842,0,empty,CD-0722-1
"A5,C2",9571,10415,7016,3399,4910,2477,0,2478,1501,977,1.536335722,1390,1775,538,169,168,1,62,1,0.101190476,0,empty,CD-0722-1
"A5,C3",10306,11155,7694,3461,5450,2647,0,2654,1756,898,1.95545657,1517,802,224,89,89,0,27,0,0.08988764,0,empty,CD-0722-1
"A5,C4",6113,6564,4621,1943,3248,1528,0,1529,993,536,1.85261194,858,1920,335,140,135,5,50,2,0.096296296,0,empty,CD-0722-1
"A5,C5",649378,749239,479503,269736,350536,191300,0,191491,154090,37401,4.119943317,113732,175423,21821,7231,7026,205,1314,11,0.044548819,0,hg38,CD-0722-1
"A5,C6",7488,8499,5590,2909,4246,2178,0,2182,1439,743,1.936742934,1252,1953,563,196,196,0,56,0,0.025510204,0,empty,CD-0722-1
"A5,C7",10000,11011,7225,3786,5381,2876,0,2876,1690,1186,1.424957841,1667,416,82,49,48,1,19,1,0.270833333,0,empty,CD-0722-1
"A5,C8",609088,687572,461742,225830,323903,166050,2,166240,129221,37019,3.490666955,95647,128497,20610,6661,6519,142,1196,4,0.05138825,0,hg38,CD-0722-1
"A5,C9",7881,9224,5660,3564,4352,2274,0,2278,1482,796,1.861809045,1438,1699,437,165,165,0,43,0,0.157575758,0,empty,CD-0722-1
"A5,C10",9346,10400,7119,3281,4863,2348,0,2352,1531,821,1.864799026,1320,2114,438,166,164,2,67,2,0.115853659,0,empty,CD-0722-1
"A5,C11",7982,8785,5893,2892,4220,2045,0,2049,1301,748,1.739304813,1170,2227,504,182,180,2,48,2,0.072222222,0,empty,CD-0722-1
"A5,C12",11389,12231,8622,3609,5870,2808,0,2811,1889,922,2.048806941,1549,2281,429,164,161,3,61,2,0.01863354,0,empty,CD-0722-1
"A5,D1",9879,11087,7277,3810,5333,2796,0,2798,1709,1089,1.56932966,1632,735,94,53,53,0,26,0,0.075471698,0,empty,CD-0722-1
"A5,D2",8489,9121,6514,2607,4406,2055,0,2056,1318,738,1.785907859,1109,2936,872,293,289,4,88,2,0.003460208,0,empty,CD-0722-1
"A5,D3",7428,8040,5490,2550,3951,1975,0,1977,1328,649,2.046224961,1096,1091,185,93,91,2,38,1,0.010989011,0,empty,CD-0722-1
"A5,D4",6054,6603,4659,1944,3333,1631,0,1631,1096,535,2.048598131,911,1431,205,84,83,1,34,1,0.024096386,0,empty,CD-0722-1
"A5,D5",6760,7561,5006,2555,3621,1793,4,1797,1185,612,1.93627451,1023,1682,352,158,156,2,54,1,0.134615385,0,empty,CD-0722-1
"A5,D6",10058,11071,7189,3882,5172,2769,12,2786,1709,1077,1.586815227,1606,2003,517,190,188,2,63,2,0,0,empty,CD-0722-1
"A5,D7",5370,5854,4067,1787,2791,1332,0,1333,868,465,1.866666667,727,2364,442,181,178,3,60,2,0.095505618,0,empty,CD-0722-1
"A5,D8",6679,7184,4990,2194,3563,1732,0,1733,1178,555,2.122522523,959,1529,361,134,128,6,53,2,0.0078125,0,empty,CD-0722-1
"A5,D9",3727,4147,2786,1361,2017,965,0,965,635,330,1.924242424,569,1359,287,116,114,2,48,2,0.201754386,0,empty,CD-0722-1
"A5,D10",6531,7209,4877,2332,3404,1689,0,1690,1088,602,1.80730897,975,924,167,55,55,0,16,0,0,0,empty,CD-0722-1
"A5,D11",7502,8460,5620,2840,3977,1931,0,1931,1292,639,2.021909233,1054,3272,986,331,328,3,89,1,0.146341463,0,empty,CD-0722-1
"A5,D12",9513,10630,7243,3387,5030,2409,0,2412,1570,842,1.864608076,1326,3317,650,263,255,8,101,3,0.070588235,0,empty,CD-0722-1
"A5,E1",633618,723830,471122,252708,334320,178829,1,179003,144399,34604,4.172899087,103534,132424,24279,7939,7822,117,1398,7,0.066862695,0,hg38,CD-0722-1
"A5,E2",8758,9641,6434,3207,4585,2241,0,2245,1366,879,1.55403868,1288,2169,530,184,184,0,64,0,0.010869565,0,empty,CD-0722-1
"A5,E3",5858,6351,4444,1907,3035,1449,0,1449,951,498,1.909638554,789,2742,769,264,264,0,83,0,0.117424242,0,empty,CD-0722-1
"A5,E4",8261,9390,6061,3329,4357,2163,0,2167,1386,781,1.774647887,1252,2155,537,183,178,5,84,1,0.04494382,0,empty,CD-0722-1
"A5,E5",7261,7872,5600,2272,3685,1691,0,1692,1117,575,1.942608696,903,1503,471,166,162,4,57,1,0.043209877,0,empty,CD-0722-1
"A5,E6",11977,13148,8931,4217,6271,3212,0,3218,2044,1174,1.741056218,1803,3702,1064,370,361,9,103,2,0.149584488,0,empty,CD-0722-1
"A5,E7",10637,11814,7949,3865,5701,2735,0,2741,1784,957,1.86415883,1577,2905,728,243,239,4,75,1,0.10460251,0,empty,CD-0722-1
"A5,E8",8907,9671,6807,2864,4572,2079,0,2085,1333,752,1.772606383,1138,3436,962,312,309,3,78,2,0.03236246,0,empty,CD-0722-1
"A5,E9",365654,420560,276264,144296,197969,102010,1,102133,76547,25586,2.991753303,59801,99078,16876,5812,5711,101,1033,6,0.068114166,0,hg38,CD-0722-1
"A5,E10",7149,8101,5387,2714,3820,1842,0,1844,1195,649,1.841294299,1085,2693,709,222,221,1,68,1,0.108597285,0,empty,CD-0722-1
"A5,E11",8108,8978,6017,2961,4357,2180,3,2185,1408,777,1.812097812,1252,2444,592,238,237,1,68,1,0.109704641,0,empty,CD-0722-1
"A5,E12",8535,9619,6358,3261,4574,2271,0,2274,1463,811,1.803945746,1310,1936,370,142,138,4,58,2,0.086956522,0,empty,CD-0722-1
"A5,F1",10069,10721,7494,3227,5101,2420,0,2425,1573,852,1.846244131,1296,2315,581,186,184,2,68,2,0.076086957,0,empty,CD-0722-1
"A5,F2",8074,8730,5962,2768,4245,2083,0,2084,1320,764,1.727748691,1203,2787,632,290,286,4,98,2,0.181818182,0,empty,CD-0722-1
"A5,F3",7849,8417,5856,2561,4070,1933,0,1935,1258,677,1.858197932,1089,3200,830,253,250,3,86,1,0.124,0,empty,CD-0722-1
"A5,F4",707468,851314,490515,360799,398441,257430,9,257622,176278,81344,2.167068253,157108,1772,175,60,58,2,43,2,0.120689655,0,empty,CD-0722-1
"A5,F5",9678,10262,7259,3003,4854,2253,0,2257,1491,766,1.946475196,1224,2112,570,215,214,1,69,1,0.014018692,0,empty,CD-0722-1
"A5,F6",9410,10726,6855,3871,5015,2604,5,2616,1747,869,2.010356732,1536,2826,678,248,241,7,85,2,0.116182573,0,empty,CD-0722-1
"A5,F7",979654,1196368,701091,495277,550874,347670,7,348030,246774,101256,2.437129652,210833,31134,11450,3699,3687,12,688,2,0.025223759,0,hg38,CD-0722-1
"A5,F8",6911,7771,5224,2547,3732,1818,0,1820,1163,657,1.770167428,1067,164,23,4,4,0,3,0,0.25,0,empty,CD-0722-1
"A5,F9",7970,8758,6054,2704,4054,1897,1,1901,1293,608,2.126644737,1056,2856,514,196,193,3,61,1,0.025906736,0,empty,CD-0722-1
"A5,F10",10526,11406,8019,3387,5338,2507,3,2518,1686,832,2.026442308,1347,1743,479,174,173,1,34,1,0.063583815,0,empty,CD-0722-1
"A5,F11",7516,8132,5573,2559,3937,1898,1,1900,1313,587,2.236797274,1094,1558,251,84,84,0,40,0,0.047619048,0,empty,CD-0722-1
"A5,F12",726484,833377,543631,289746,380607,198270,1,198494,151587,46907,3.23164986,116667,5671,657,249,247,2,70,1,0.113360324,0,hg38,CD-0722-1
"A5,G1",193127,255368,121415,133953,125650,94260,0,94323,56759,37564,1.510994569,61611,3846,1146,385,384,1,136,1,0.0546875,0,hg38,CD-0722-1
"A5,G2",5635,6070,3966,2104,2854,1472,1,1473,977,496,1.969758065,830,309,108,41,41,0,15,0,0,0,empty,CD-0722-1
"A5,G3",10046,11157,7541,3616,5383,2795,1,2799,1740,1059,1.64305949,1573,2471,525,167,166,1,75,1,0.084337349,0,empty,CD-0722-1
"A5,G4",610999,652544,484033,168511,305054,126921,1,127131,100087,27044,3.700894838,67573,4783,404,159,153,6,43,2,0.058823529,0,hg38,CD-0722-1
"A5,G5",6717,7224,5021,2203,3463,1730,0,1731,1115,616,1.810064935,933,2023,312,120,118,2,52,2,0.025423729,0,empty,CD-0722-1
"A5,G6",9643,10450,7329,3121,4947,2393,6,2404,1613,791,2.039190898,1319,248,68,27,27,0,13,0,0.555555556,0,empty,CD-0722-1
"A5,G7",8091,8941,6194,2747,4225,2003,0,2006,1301,705,1.845390071,1129,2719,565,245,240,5,82,2,0.120833333,0,empty,CD-0722-1
"A5,G8",5869,6575,4284,2291,3178,1556,0,1556,985,571,1.725043783,914,1991,429,161,161,0,54,0,0.142857143,0,empty,CD-0722-1
"A5,G9",6749,7351,5116,2235,3459,1679,0,1681,1098,583,1.883361921,931,2372,510,202,199,3,64,1,0.095477387,0,empty,CD-0722-1
"A5,G10",8134,8936,6149,2787,4255,2085,0,2088,1365,723,1.887966805,1155,2599,602,245,245,0,93,0,0.024489796,0,empty,CD-0722-1
"A5,G11",8261,8759,6425,2334,4291,2021,0,2026,1312,714,1.837535014,1055,1273,328,141,141,0,59,0,0.070921986,0,empty,CD-0722-1
"A5,G12",6414,7404,4838,2566,3582,1818,0,1826,1197,629,1.903020668,1081,2427,552,199,196,3,50,1,0.219387755,0,empty,CD-0722-1
"A5,H1",6442,6994,4820,2174,3333,1607,0,1607,1074,533,2.015009381,928,1242,288,84,84,0,32,0,0,0,empty,CD-0722-1
"A5,H2",7778,8629,5845,2784,4042,1989,3,1997,1276,721,1.769764216,1137,2186,425,129,126,3,48,1,0.079365079,0,empty,CD-0722-1
"A5,H3",565355,679679,395763,283916,319829,204838,0,204990,150814,54176,2.783778795,124542,5073,774,256,251,5,86,2,0.075697211,0,hg38,CD-0722-1
"A5,H4",9499,10713,7043,3670,5052,2499,0,2506,1628,878,1.854214123,1473,226,20,14,12,2,9,2,0,0,empty,CD-0722-1
"A5,H5",10570,11641,7620,4021,5521,2773,0,2775,1788,987,1.811550152,1635,2037,566,219,212,7,55,2,0.018867925,0,empty,CD-0722-1
"A5,H6",1181785,1410775,885016,525759,647828,364666,1,365079,303227,61852,4.902460713,217186,99273,20588,6646,6553,93,1243,3,0.070959866,0,hg38,CD-0722-1
"A5,H7",7031,7519,5315,2204,3767,1749,1,1751,1168,583,2.003430532,958,2394,586,202,201,1,54,1,0.069651741,0,empty,CD-0722-1
"A5,H8",13644,15303,10248,5055,7338,3768,0,3774,2634,1140,2.310526316,2161,2089,368,135,129,6,56,2,0.015503876,0,empty,CD-0722-1
"A5,H9",6062,6586,4685,1901,3185,1436,0,1436,976,460,2.12173913,792,1222,314,98,97,1,30,1,0.113402062,0,empty,CD-0722-1
"A5,H10",5948,6519,4429,2090,3173,1585,0,1587,1070,517,2.069632495,916,1124,252,103,102,1,44,1,0.039215686,0,empty,CD-0722-1
"A5,H11",6621,7488,4724,2764,3535,2129,0,2132,1194,938,1.272921109,1208,74,16,6,4,2,3,1,0,0,empty,CD-0722-1
"A5,H12",601775,700413,438705,261708,328517,183428,6,183620,149993,33627,4.460493056,109952,142111,20255,6794,6655,139,1150,5,0.081893313,0,hg38,CD-0722-1
"A6,A1",508936,619592,369189,250403,285457,167119,1,167286,137779,29507,4.669366591,102693,78029,11026,3763,3656,107,763,6,0.061816193,0,hg38,CD-0722-1
"A6,A2",6508,7216,4804,2412,3392,1725,0,1726,1058,668,1.583832335,988,1137,288,109,108,1,35,1,0.259259259,0,empty,CD-0722-1
"A6,A3",305898,336969,234749,102220,155762,75456,0,75523,56805,18718,3.034779357,42299,14627,1959,598,583,15,158,2,0.032590051,0,hg38,CD-0722-1
"A6,A4",7372,8229,5622,2607,3821,1885,0,1886,1228,658,1.866261398,1044,463,87,47,46,1,25,1,0.065217391,0,empty,CD-0722-1
"A6,A5",6117,6664,4556,2108,3206,1566,4,1575,1017,558,1.822580645,906,1101,151,57,57,0,33,0,0.070175439,0,empty,CD-0722-1
"A6,A6",16338,19098,12370,6728,9027,4718,0,4720,3527,1193,2.956412406,2789,1427,409,170,167,3,61,2,0.023952096,0,empty,CD-0722-1
"A6,A7",525640,629621,389678,239943,285995,160204,1,160314,127103,33211,3.827135588,96081,100801,12827,4349,4262,87,896,5,0.065227593,0,hg38,CD-0722-1
"A6,A8",2539,2766,1915,851,1376,708,0,708,478,230,2.07826087,394,1178,333,129,128,1,34,1,0.1015625,0,empty,CD-0722-1
"A6,A9",5036,5662,3844,1818,2617,1315,0,1315,852,463,1.840172786,727,955,176,74,74,0,43,0,0.040540541,0,empty,CD-0722-1
"A6,A10",5326,5720,4094,1626,2722,1315,0,1315,839,476,1.762605042,699,229,29,21,21,0,12,0,0,0,empty,CD-0722-1
"A6,A11",4432,4664,3318,1346,2286,1089,0,1091,724,367,1.972752044,582,1014,210,89,86,3,31,1,0.011627907,0,empty,CD-0722-1
"A6,A12",5986,6516,4522,1994,2901,1376,0,1377,884,493,1.793103448,760,2398,692,244,242,2,72,2,0.066115702,0,empty,CD-0722-1
"A6,B1",4963,5563,3654,1909,2609,1357,0,1357,819,538,1.522304833,787,911,251,94,90,4,34,1,0.111111111,0,empty,CD-0722-1
"A6,B2",5619,6178,3763,2415,2907,1505,0,1509,907,602,1.506644518,937,444,109,51,49,2,19,2,0.408163265,0,empty,CD-0722-1
"A6,B3",4154,4586,3034,1552,2140,1111,0,1113,721,392,1.839285714,633,770,168,61,61,0,18,0,0.06557377,0,empty,CD-0722-1
"A6,B4",4740,5411,3384,2027,2549,1344,0,1349,808,541,1.493530499,802,1182,222,90,89,1,48,1,0.06741573,0,empty,CD-0722-1
"A6,B5",4698,2413,1422,991,1600,881,0,887,574,313,1.833865815,590,594,134,52,51,1,14,1,0.31372549,0,empty,CD-0722-1
"A6,B6",5249,5688,3810,1878,2741,1434,0,1434,907,527,1.721062619,825,868,195,93,92,1,28,1,0.032608696,0,empty,CD-0722-1
"A6,B7",5069,5324,3808,1516,2615,1254,0,1256,833,423,1.969267139,701,493,72,29,28,1,16,1,0.142857143,0,empty,CD-0722-1
"A6,B8",3684,4090,2746,1344,1877,882,0,883,549,334,1.643712575,503,767,131,52,52,0,20,0,0,0,empty,CD-0722-1
"A6,B9",6908,7765,4968,2797,3606,1844,0,1849,1164,685,1.699270073,1115,588,147,56,54,2,28,2,0.055555556,0,empty,CD-0722-1
"A6,B10",3611,3893,2517,1376,1898,963,0,967,615,352,1.747159091,588,383,43,22,22,0,14,0,0,0,empty,CD-0722-1
"A6,B11",8286,9590,6009,3581,4411,2447,0,2448,1377,1071,1.285714286,1496,99,7,6,6,0,6,0,0,0,empty,CD-0722-1
"A6,B12",1386996,1697226,998082,699144,773758,461907,3,462346,365807,96539,3.789214722,286936,278200,42705,13981,13714,267,2185,6,0.064532594,0,hg38,CD-0722-1
"A6,C1",8533,9427,6560,2867,4224,2024,0,2025,1272,753,1.689243028,1089,543,72,42,42,0,16,0,0,0,empty,CD-0722-1
"A6,C2",7151,7758,5249,2509,3620,1822,0,1822,1146,676,1.695266272,1027,1163,232,98,98,0,31,0,0.112244898,0,empty,CD-0722-1
"A6,C3",638299,759989,478084,281905,345444,193793,1,193967,152539,41428,3.682026649,115773,2753,436,126,126,0,53,0,0.03968254,0,hg38,CD-0722-1
"A6,C4",7896,8844,6081,2763,4022,1929,2,1937,1198,739,1.621109608,1084,1379,317,127,124,3,52,2,0.161290323,0,empty,CD-0722-1
"A6,C5",537120,638444,398060,240384,291727,162569,1,162723,129209,33514,3.855373874,98023,53691,6687,2271,2227,44,569,3,0.067804221,0,hg38,CD-0722-1
"A6,C6",5822,6518,4214,2304,3264,1703,0,1706,1118,588,1.901360544,1063,1093,284,111,110,1,42,1,0.163636364,0,empty,CD-0722-1
"A6,C7",1158565,1378038,853384,524654,618431,349125,3,349474,283588,65886,4.304222445,211014,31516,4899,1585,1562,23,310,3,0.089628681,0,hg38,CD-0722-1
"A6,C8",413207,471366,306258,165108,217488,118620,4,118730,94169,24561,3.83408656,68395,8282,1293,457,450,7,163,3,0.033333333,0,hg38,CD-0722-1
"A6,C9",6006,6847,4433,2414,3077,1546,0,1550,952,598,1.591973244,949,1075,237,118,118,0,41,0,0.033898305,0,empty,CD-0722-1
"A6,C10",7235,7934,5417,2517,3641,1808,0,1812,1196,616,1.941558442,1015,1090,327,137,136,1,45,1,0.029411765,0,empty,CD-0722-1
"A6,C11",6557,6957,4861,2096,3277,1591,0,1591,979,612,1.599673203,876,1303,298,104,104,0,44,0,0.086538462,0,empty,CD-0722-1
"A6,C12",921371,1128368,640477,487891,512301,337912,8,338178,249338,88840,2.806596128,206655,4527,345,136,132,4,54,1,0.022727273,0,hg38,CD-0722-1
"A6,D1",7171,8123,5257,2866,3806,2023,0,2025,1194,831,1.436823105,1187,686,104,41,38,3,16,2,0.105263158,0,empty,CD-0722-1
"A6,D2",6305,6853,4897,1956,3287,1504,0,1507,930,577,1.611785095,831,2035,658,218,218,0,77,0,0.04587156,0,empty,CD-0722-1
"A6,D3",5344,5898,4068,1830,2813,1410,0,1412,926,486,1.905349794,792,868,102,61,61,0,42,0,0.049180328,0,empty,CD-0722-1
"A6,D4",461842,551479,341856,209623,252371,142192,1,142374,110619,31755,3.483514407,85381,86548,12294,4165,4060,105,782,4,0.065024631,0,hg38,CD-0722-1
"A6,D5",4825,5426,3657,1769,2584,1292,0,1296,825,471,1.751592357,744,940,188,56,55,1,31,1,0.018181818,0,empty,CD-0722-1
"A6,D6",7610,8411,5537,2874,3915,2095,0,2097,1276,821,1.554202192,1187,1623,376,154,153,1,44,1,0.058823529,0,empty,CD-0722-1
"A6,D7",444832,507494,336190,171304,232548,121643,2,121779,94165,27614,3.410045629,70560,78295,14385,4601,4536,65,819,5,0.083333333,0,hg38,CD-0722-1
"A6,D8",532769,632649,392404,240245,289728,162809,1,162981,129193,33788,3.82363561,98096,52869,7427,2438,2367,71,542,3,0.040980144,0,hg38,CD-0722-1
"A6,D9",2833,3131,2133,998,1514,729,0,729,487,242,2.012396694,426,1297,411,116,116,0,49,0,0.146551724,0,empty,CD-0722-1
"A6,D10",5156,5959,3826,2133,2777,1435,0,1436,900,536,1.679104478,849,730,196,77,76,1,17,1,0.197368421,0,empty,CD-0722-1
"A6,D11",5549,6105,4196,1909,2808,1372,1,1375,900,475,1.894736842,746,1781,283,149,148,1,77,1,0.108108108,0,empty,CD-0722-1
"A6,D12",7217,7861,5489,2372,3592,1753,0,1753,1121,632,1.773734177,942,2092,429,168,166,2,59,1,0.126506024,0,empty,CD-0722-1
"A6,E1",8689,9590,6465,3125,4432,2166,0,2170,1355,815,1.662576687,1270,2007,420,175,170,5,72,4,0.011764706,0,empty,CD-0722-1
"A6,E2",6390,7401,4678,2723,3381,1727,0,1734,1027,707,1.45261669,1040,1456,298,105,104,1,45,1,0.019230769,0,empty,CD-0722-1
"A6,E3",4321,4705,3381,1324,2186,996,0,999,647,352,1.838068182,540,1909,477,196,191,5,60,1,0.089005236,0,empty,CD-0722-1
"A6,E4",417857,470854,319171,151683,216848,109874,1,109999,81959,28040,2.922931526,63175,39151,7080,2352,2308,44,507,4,0.041594454,0,hg38,CD-0722-1
"A6,E5",5201,5582,4025,1557,2631,1234,0,1235,785,450,1.744444444,650,861,108,46,46,0,31,0,0.043478261,0,empty,CD-0722-1
"A6,E6",8932,10080,6717,3363,4628,2354,0,2360,1531,829,1.846803378,1358,1933,480,164,164,0,54,0,0.024390244,0,empty,CD-0722-1
"A6,E7",1080834,1256132,812720,443412,566186,310274,6,310638,250933,59705,4.202880831,181626,143360,17341,5545,5407,138,1220,4,0.039023488,0,hg38,CD-0722-1
"A6,E8",6920,7801,5173,2628,3570,1735,0,1735,1083,652,1.661042945,979,1730,505,153,151,2,48,1,0.013245033,0,empty,CD-0722-1
"A6,E9",4232,4856,3184,1672,2297,1121,0,1121,707,414,1.707729469,657,1833,468,171,171,0,64,0,0.052631579,0,empty,CD-0722-1
"A6,E10",477489,547542,362786,184756,250675,130180,0,130321,100179,30142,3.323568443,75714,56189,7172,2215,2156,59,546,4,0.028756957,0,hg38,CD-0722-1
"A6,E11",733093,844545,564122,280423,383372,199763,2,199990,162027,37963,4.268024129,114900,126642,16238,5352,5214,138,1032,7,0.080935942,0,hg38,CD-0722-1
"A6,E12",470425,547392,351744,195648,251957,135296,0,135416,104322,31094,3.355052422,80712,50759,5301,1915,1852,63,405,5,0.09287257,0,hg38,CD-0722-1
"A6,F1",7348,7917,5425,2492,3713,1793,0,1796,1147,649,1.767334361,1000,1350,218,89,88,1,33,1,0,0,empty,CD-0722-1
"A6,F2",6307,7084,4717,2367,3345,1699,0,1699,1151,548,2.100364964,977,1594,371,159,158,1,64,1,0.164556962,0,empty,CD-0722-1
"A6,F3",5588,6062,4250,1812,2895,1368,0,1370,950,420,2.261904762,771,1260,207,78,76,2,39,2,0.052631579,0,empty,CD-0722-1
"A6,F4",8794,9534,6715,2819,4513,2134,4,2144,1395,749,1.862483311,1239,455,135,55,53,2,24,2,0.037735849,0,empty,CD-0722-1
"A6,F5",6874,7503,5141,2362,3523,1650,1,1656,1068,588,1.816326531,964,1302,356,117,114,3,36,2,0.00877193,0,empty,CD-0722-1
"A6,F6",6716,7251,4879,2372,3402,1702,0,1704,1090,614,1.7752443,944,1992,533,173,172,1,60,1,0.058139535,0,empty,CD-0722-1
"A6,F7",7979,8948,5939,3009,4256,2104,0,2108,1354,754,1.795755968,1247,1017,345,91,91,0,38,0,0.153846154,0,empty,CD-0722-1
"A6,F8",5265,5718,4014,1704,2648,1291,0,1291,832,459,1.812636166,710,82,12,8,8,0,7,0,0,0,empty,CD-0722-1
"A6,F9",5855,6296,4395,1901,2889,1309,3,1314,862,452,1.907079646,731,1803,463,192,190,2,52,1,0.152631579,0,empty,CD-0722-1
"A6,F10",7313,7943,5645,2298,3710,1724,0,1726,1096,630,1.73968254,925,1159,356,123,123,0,40,0,0.032520325,0,empty,CD-0722-1
"A6,F11",5747,6354,4361,1993,2910,1369,0,1369,876,493,1.776876268,744,1341,238,97,95,2,35,2,0.021052632,0,empty,CD-0722-1
"A6,F12",6142,6789,4511,2278,3159,1575,0,1575,1018,557,1.827648115,878,96,29,10,10,0,5,0,0,0,empty,CD-0722-1
"A6,G1",603439,710915,441429,269486,324093,189770,2,189957,143477,46480,3.086854561,112312,72685,14409,4662,4574,88,941,3,0.033887188,0,hg38,CD-0722-1
"A6,G2",4204,4468,3005,1463,2132,1103,0,1108,682,426,1.600938967,608,235,63,41,41,0,24,0,0.024390244,0,empty,CD-0722-1
"A6,G3",7572,8289,5572,2717,3944,2026,0,2026,1226,800,1.5325,1166,1795,353,143,140,3,60,1,0.057142857,0,empty,CD-0722-1
"A6,G4",13327,14885,9718,5167,7023,3837,0,3839,2316,1523,1.520682863,2241,155,19,13,13,0,12,0,0.076923077,0,empty,CD-0722-1
"A6,G5",5075,5491,3670,1821,2618,1332,0,1332,900,432,2.083333333,776,1231,231,100,94,6,36,1,0.223404255,0,empty,CD-0722-1
"A6,G6",6991,7873,5333,2540,3627,1728,0,1730,1187,543,2.186003683,983,139,53,19,19,0,9,0,0,0,empty,CD-0722-1
"A6,G7",5877,6366,4531,1835,2937,1329,0,1332,845,487,1.735112936,749,1578,300,127,126,1,60,1,0.023809524,0,empty,CD-0722-1
"A6,G8",4120,4650,3134,1516,2182,1075,0,1077,707,370,1.910810811,629,1149,135,72,70,2,38,1,0.014285714,0,empty,CD-0722-1
"A6,G9",435758,521456,317015,204441,239074,138157,1,138293,109049,29244,3.72893585,83928,9032,1424,437,431,6,129,1,0.041763341,0,hg38,CD-0722-1
"A6,G10",5929,6609,4371,2238,3053,1550,0,1550,965,585,1.64957265,883,1665,320,154,153,1,70,1,0.130718954,0,empty,CD-0722-1
"A6,G11",5966,6379,4528,1851,2961,1332,0,1335,890,445,2,739,780,205,83,83,0,41,0,0.060240964,0,empty,CD-0722-1
"A6,G12",464481,533975,351712,182263,248237,128168,2,128342,96975,31367,3.091624956,74982,113172,13599,4731,4617,114,904,7,0.064544076,0,hg38,CD-0722-1
"A6,H1",4973,5295,3716,1579,2454,1131,0,1133,744,389,1.912596401,630,634,175,57,57,0,22,0,0.122807018,0,empty,CD-0722-1
"A6,H2",6020,6689,4440,2249,3080,1516,0,1516,980,536,1.828358209,883,1462,405,159,155,4,51,2,0.116129032,0,empty,CD-0722-1
"A6,H3",4751,5250,3469,1781,2507,1235,0,1242,815,427,1.908665105,761,1145,200,69,68,1,34,1,0.029411765,0,empty,CD-0722-1
"A6,H4",7155,7900,5280,2620,3688,1839,0,1844,1223,621,1.969404187,1060,99,25,18,18,0,12,0,0,0,empty,CD-0722-1
"A6,H5",7867,8649,5836,2813,3975,2000,1,2005,1289,716,1.80027933,1149,1077,161,69,62,7,35,2,0.016129032,0,empty,CD-0722-1
"A6,H6",4499,4893,3246,1647,2183,1147,0,1149,739,410,1.802439024,646,1297,316,113,112,1,40,1,0.125,0,empty,CD-0722-1
"A6,H7",5654,6312,4287,2025,2944,1411,1,1414,927,487,1.90349076,827,1034,212,86,86,0,36,0,0.093023256,0,empty,CD-0722-1
"A6,H8",5755,6470,4254,2216,2960,1442,0,1442,939,503,1.866799205,841,1305,242,106,105,1,41,1,0.057142857,0,empty,CD-0722-1
"A6,H9",4715,5217,3594,1623,2441,1110,0,1112,666,446,1.493273543,648,799,206,77,76,1,26,1,0.223684211,0,empty,CD-0722-1
"A6,H10",4263,4720,3262,1458,2079,983,2,986,635,351,1.809116809,539,780,139,44,44,0,20,0,0.022727273,0,empty,CD-0722-1
"A6,H11",625547,734388,464013,270375,332126,180456,5,180657,140332,40325,3.480024799,107880,2363,401,120,115,5,32,1,0.043478261,0,hg38,CD-0722-1
"A6,H12",367554,424774,267201,157573,198228,110151,0,110268,96873,13395,7.232026876,65348,50277,5451,1688,1630,58,413,7,0.035582822,0,hg38,CD-0722-1
"A7,A1",7596,8376,5605,2771,4064,2112,0,2116,1378,738,1.867208672,1177,1998,262,97,97,0,42,0,0.195876289,0,empty,CD-0722-1
"A7,A2",11745,12967,8690,4277,6195,3217,1,3222,2026,1196,1.693979933,1848,2942,762,230,227,3,84,2,0.079295154,0,empty,CD-0722-1
"A7,A3",6832,7431,5065,2366,3557,1697,0,1697,1114,583,1.910806175,970,1375,258,132,132,0,47,0,0.015151515,0,empty,CD-0722-1
"A7,A4",12927,14503,9727,4776,6843,3448,0,3452,2192,1260,1.73968254,2009,1224,366,122,122,0,45,0,0.12295082,0,empty,CD-0722-1
"A7,A5",10886,11812,8236,3576,5659,2715,1,2733,1773,960,1.846875,1519,2912,580,230,227,3,83,2,0.026431718,0,empty,CD-0722-1
"A7,A6",15886,18141,11918,6223,8819,4612,0,4618,3226,1392,2.317528736,2663,3231,731,274,272,2,90,2,0.066176471,0,empty,CD-0722-1
"A7,A7",7929,8773,5886,2887,4276,2259,1,2261,1453,808,1.798267327,1335,1625,349,136,135,1,57,1,0.074074074,0,empty,CD-0722-1
"A7,A8",4658,5245,3551,1694,2512,1261,0,1263,837,426,1.964788732,724,2264,481,183,181,2,68,2,0.165745856,0,empty,CD-0722-1
"A7,A9",602620,688451,460882,227569,320974,163992,2,164160,125113,39047,3.204164212,94273,79645,8012,2716,2642,74,622,4,0.052990159,0,hg38,CD-0722-1
"A7,A10",8735,9461,6731,2730,4498,2147,0,2152,1410,742,1.900269542,1166,488,40,29,28,1,22,1,0,0,empty,CD-0722-1
"A7,A11",7637,8443,5906,2537,4077,1952,3,1957,1325,632,2.096518987,1081,2318,531,216,214,2,73,1,0.121495327,0,empty,CD-0722-1
"A7,A12",9357,10072,7123,2949,4771,2244,3,2253,1489,764,1.94895288,1172,4260,1216,431,426,5,110,1,0.075117371,0,empty,CD-0722-1
"A7,B1",8202,9226,6039,3187,4416,2235,0,2240,1412,828,1.70531401,1319,1692,419,151,151,0,52,0,0.026490066,0,empty,CD-0722-1
"A7,B2",9279,10083,6553,3530,4776,2550,0,2552,1624,928,1.75,1486,902,69,42,42,0,25,0,0.023809524,0,empty,CD-0722-1
"A7,B3",7890,8825,5864,2961,4270,2178,0,2181,1478,703,2.102418208,1275,1979,449,172,170,2,49,2,0.041176471,0,empty,CD-0722-1
"A7,B4",7863,8865,5761,3104,4439,2406,0,2409,1575,834,1.888489209,1389,2166,462,173,171,2,64,1,0.122807018,0,empty,CD-0722-1
"A7,B5",8670,5071,3079,1992,3225,1715,0,1723,1139,584,1.950342466,1119,911,170,78,78,0,28,0,0.012820513,0,empty,CD-0722-1
"A7,B6",9169,10013,6805,3208,4746,2425,0,2432,1528,904,1.690265487,1371,1844,631,230,225,5,61,2,0.022222222,0,empty,CD-0722-1
"A7,B7",8581,9396,6475,2921,4441,2117,0,2119,1390,729,1.906721536,1184,1476,349,110,107,3,31,1,0.186915888,0,empty,CD-0722-1
"A7,B8",6121,6604,4638,1966,3144,1497,0,1500,1011,489,2.067484663,785,1548,251,110,110,0,51,0,0.072727273,0,empty,CD-0722-1
"A7,B9",662245,754465,501747,252718,348634,179570,1,179786,133939,45847,2.921434336,104236,33500,4459,1399,1353,46,316,2,0.080561715,0,hg38,CD-0722-1
"A7,B10",6152,6844,4372,2472,3249,1606,0,1614,1052,562,1.871886121,960,746,126,55,55,0,22,0,0.072727273,0,empty,CD-0722-1
"A7,B11",500069,526566,398616,127950,254116,112714,2,112830,82164,30666,2.679319116,57560,400,171,74,74,0,20,0,0.013513514,0,empty,CD-0722-1
"A7,B12",7523,8285,5673,2612,4023,2028,0,2034,1302,732,1.778688525,1156,1804,340,126,125,1,43,1,0.016,0,empty,CD-0722-1
"A7,C1",14420,15792,10992,4800,7337,3459,0,3468,2193,1275,1.72,1927,1312,293,91,91,0,31,0,0.065934066,0,empty,CD-0722-1
"A7,C2",12018,12826,8963,3863,6079,3089,0,3092,2019,1073,1.881640261,1671,2983,814,252,249,3,66,2,0.152610442,0,empty,CD-0722-1
"A7,C3",17393,19130,13046,6084,9429,4852,0,4852,3319,1533,2.165035877,2722,1157,241,94,92,2,32,1,0.054347826,0,empty,CD-0722-1
"A7,C4",8586,9300,6404,2896,4489,2001,123,2126,1368,758,1.80474934,1233,3171,575,227,218,9,76,2,0.04587156,0,empty,CD-0722-1
"A7,C5",12834,14352,9337,5015,6947,3554,0,3556,2406,1150,2.092173913,2080,2498,541,207,205,2,92,2,0.12195122,0,empty,CD-0722-1
"A7,C6",9921,10515,7482,3033,5121,2522,0,2525,1684,841,2.002378121,1328,2615,544,211,209,2,95,1,0.014354067,0,empty,CD-0722-1
"A7,C7",13556,15753,9808,5945,7261,4012,0,4018,2459,1559,1.577293137,2434,785,123,49,48,1,25,1,0.0625,0,empty,CD-0722-1
"A7,C8",849865,984247,641805,342442,454089,246648,5,246891,193803,53088,3.650599005,143342,145875,19735,6836,6675,161,1279,5,0.043146067,0,hg38,CD-0722-1
"A7,C9",10006,11543,7474,4069,5475,2787,0,2790,1746,1044,1.672413793,1670,2411,697,185,184,1,64,1,0.125,0,empty,CD-0722-1
"A7,C10",11364,12392,8642,3750,5939,2865,0,2870,1805,1065,1.694835681,1566,2335,531,188,187,1,69,1,0.096256684,0,empty,CD-0722-1
"A7,C11",9995,10812,7495,3317,5234,2583,0,2584,1656,928,1.784482759,1452,2266,538,230,229,1,73,1,0.056768559,0,empty,CD-0722-1
"A7,C12",13852,15250,10424,4826,7240,3484,1,3488,2270,1218,1.863711002,1966,2902,699,233,222,11,58,1,0.081081081,0,empty,CD-0722-1
"A7,D1",14620,17678,10493,7185,8477,4946,1,4951,3250,1701,1.9106408,3056,972,159,67,66,1,42,1,0.03030303,0,empty,CD-0722-1
"A7,D2",10721,11621,8216,3405,5471,2560,0,2564,1607,957,1.679205852,1349,3725,1003,387,387,0,128,0,0.025839793,0,empty,CD-0722-1
"A7,D3",9768,10906,7253,3653,5184,2664,0,2670,1748,922,1.895878525,1535,2200,533,183,173,10,65,2,0.052023121,0,empty,CD-0722-1
"A7,D4",7582,8723,5732,2991,4129,2075,1,2078,1345,733,1.834924966,1184,1955,472,165,153,12,52,2,0.130718954,0,empty,CD-0722-1
"A7,D5",716705,828617,538026,290591,386815,205790,0,205990,156158,49832,3.133689196,122083,93931,10991,3542,3427,115,725,4,0.07878611,0,hg38,CD-0722-1
"A7,D6",537474,660661,374968,285693,310887,195342,0,195485,146888,48597,3.02257341,122544,6610,1741,477,475,2,167,1,0.067368421,0,hg38,CD-0722-1
"A7,D7",7056,8056,5231,2825,3784,1890,0,1891,1205,686,1.756559767,1089,2828,702,244,244,0,68,0,0.204918033,0,empty,CD-0722-1
"A7,D8",8415,9401,6279,3122,4464,2175,0,2175,1391,784,1.774234694,1276,1879,494,141,139,2,55,1,0.035971223,0,empty,CD-0722-1
"A7,D9",217990,278369,146444,131925,134990,94286,1,94339,62286,32053,1.943219043,59609,4139,1122,343,332,11,161,2,0.153614458,0,hg38,CD-0722-1
"A7,D10",8690,10026,6492,3534,4724,2512,0,2518,1637,881,1.858115778,1454,984,131,55,54,1,16,1,0,0,empty,CD-0722-1
"A7,D11",1388231,1640149,1026519,613630,750121,431406,3,431881,334701,97180,3.444134596,255472,297030,51730,16915,16609,306,2337,8,0.059184779,0,hg38,CD-0722-1
"A7,D12",12325,13421,9307,4114,6381,3098,0,3106,1983,1123,1.765805877,1706,4086,889,335,329,6,117,2,0.075987842,0,empty,CD-0722-1
"A7,E1",14510,15592,10755,4837,7564,3792,0,3797,2431,1366,1.779648609,2105,3224,483,230,225,5,104,2,0.128888889,0,empty,CD-0722-1
"A7,E2",10903,11754,8074,3680,5582,2735,0,2740,1789,951,1.881177708,1531,2765,604,220,219,1,67,1,0.187214612,0,empty,CD-0722-1
"A7,E3",7316,8139,5585,2554,3929,1923,0,1928,1233,695,1.774100719,1104,3758,1015,321,318,3,108,2,0.044025157,0,empty,CD-0722-1
"A7,E4",10394,11399,7776,3623,5413,2667,0,2670,1687,983,1.716174975,1496,3619,767,296,293,3,102,1,0.19112628,0,empty,CD-0722-1
"A7,E5",8589,9673,6625,3048,4615,2206,0,2206,1463,743,1.969044415,1286,1404,352,165,164,1,60,1,0.073170732,0,empty,CD-0722-1
"A7,E6",15241,16922,11501,5421,7915,3967,5,3978,2518,1460,1.724657534,2262,3567,685,254,245,9,101,2,0.057142857,0,empty,CD-0722-1
"A7,E7",654187,742530,495698,246832,341491,174688,3,174916,136853,38063,3.595433886,101499,164714,22882,7754,7573,181,1336,5,0.071041859,0,hg38,CD-0722-1
"A7,E8",11244,12426,8621,3805,5804,2689,0,2690,1821,869,2.095512083,1488,2945,520,169,162,7,68,2,0.117283951,0,empty,CD-0722-1
"A7,E9",7229,7760,5481,2279,3658,1726,0,1735,1201,534,2.24906367,938,2867,628,244,242,2,94,2,0.128099174,0,empty,CD-0722-1
"A7,E10",725396,830485,546196,284289,387335,202641,0,202836,147981,54855,2.69767569,119114,98469,19460,6521,6402,119,1126,5,0.054358013,0,hg38,CD-0722-1
"A7,E11",10440,11424,7882,3542,5338,2664,0,2664,1691,973,1.737923947,1488,3340,687,249,248,1,77,1,0.084677419,0,empty,CD-0722-1
"A7,E12",10748,12189,7975,4214,5883,2988,0,2996,1934,1062,1.821092279,1787,2540,527,207,205,2,65,2,0.019512195,0,empty,CD-0722-1
"A7,F1",12572,13743,9345,4398,6423,3133,0,3133,2026,1107,1.830171635,1794,2906,835,294,294,0,81,0,0.047619048,0,empty,CD-0722-1
"A7,F2",2165298,2491259,1597369,893890,1133393,637684,7,638379,511753,126626,4.041452782,378223,401533,60337,20180,19767,413,2818,11,0.05822836,0,hg38,CD-0722-1
"A7,F3",748799,889654,548529,341125,411092,229423,0,229627,178621,51006,3.501960554,139522,224709,34098,11458,11197,261,1890,6,0.044029651,0,hg38,CD-0722-1
"A7,F4",15108,16565,11413,5152,7828,3698,0,3699,2459,1240,1.983064516,2032,646,98,60,60,0,36,0,0.066666667,0,empty,CD-0722-1
"A7,F5",11699,12513,8802,3711,5977,2792,0,2803,1882,921,2.043431053,1532,3047,588,193,192,1,77,1,0.057291667,0,empty,CD-0722-1
"A7,F6",2062605,2351694,1550565,801129,1067393,579351,2,579946,475210,104736,4.537217385,337960,319753,38311,12846,12524,322,2083,12,0.021798148,0,hg38,CD-0722-1
"A7,F7",13623,15390,10235,5155,7330,3680,0,3682,2420,1262,1.917591125,2123,1752,221,80,76,4,50,3,0.039473684,0,empty,CD-0722-1
"A7,F8",8921,10041,6757,3284,4581,2206,3,2209,1476,733,2.013642565,1220,326,34,22,21,1,14,1,0,0,empty,CD-0722-1
"A7,F9",9484,10535,7269,3266,4937,2358,0,2361,1534,827,1.854897219,1261,3577,851,281,276,5,87,2,0.119565217,0,empty,CD-0722-1
"A7,F10",12580,14001,9677,4324,6636,3201,0,3206,2082,1124,1.852313167,1804,2191,625,226,224,2,60,2,0.035714286,0,empty,CD-0722-1
"A7,F11",879808,994274,677935,316339,455288,229667,4,229960,187626,42334,4.43204044,129327,202587,21948,7940,7696,244,1480,5,0.054703742,0,hg38,CD-0722-1
"A7,F12",10962,12230,8157,4073,5818,2958,1,2963,1914,1049,1.824594852,1726,253,33,19,19,0,14,0,0.052631579,0,empty,CD-0722-1
"A7,G1",12359,13260,9334,3926,6398,3057,0,3067,2054,1013,2.027640671,1691,4045,789,320,312,8,119,2,0.108974359,0,empty,CD-0722-1
"A7,G2",6953,7892,4892,3000,3788,2027,1,2031,1279,752,1.700797872,1246,607,160,72,72,0,23,0,0.25,0,empty,CD-0722-1
"A7,G3",13086,14438,9719,4719,6839,3464,0,3467,2136,1331,1.604808415,1943,2870,796,319,316,3,125,2,0.041139241,0,empty,CD-0722-1
"A7,G4",23060,25986,16918,9068,12261,6736,0,6741,4154,2587,1.605720912,3815,280,34,24,24,0,19,0,0.041666667,0,empty,CD-0722-1
"A7,G5",8113,8907,5936,2971,4287,2129,0,2131,1385,746,1.856568365,1246,1931,591,262,258,4,85,2,0.104651163,0,empty,CD-0722-1
"A7,G6",11565,12404,8843,3561,5748,2660,0,2662,1775,887,2.001127396,1452,204,16,12,12,0,8,0,0,0,empty,CD-0722-1
"A7,G7",9922,10757,7519,3238,5116,2353,1,2362,1580,782,2.020460358,1302,3077,767,251,246,5,98,2,0.105691057,0,empty,CD-0722-1
"A7,G8",6910,7949,5230,2719,3716,1797,1,1798,1185,613,1.933115824,1054,2445,531,217,216,1,67,1,0.009259259,0,empty,CD-0722-1
"A7,G9",8597,9869,6354,3515,4711,2382,0,2387,1475,912,1.617324561,1444,2643,700,221,220,1,78,1,0.172727273,0,empty,CD-0722-1
"A7,G10",10395,11373,7747,3626,5453,2723,0,2724,1767,957,1.846394984,1562,3009,733,316,313,3,115,2,0.076677316,0,empty,CD-0722-1
"A7,G11",10076,11005,7780,3225,5259,2502,0,2502,1682,820,2.051219512,1362,1945,495,209,205,4,68,1,0.024390244,0,empty,CD-0722-1
"A7,G12",8234,9227,6122,3105,4428,2269,0,2271,1408,863,1.631517961,1301,2890,724,241,239,2,72,1,0.071129707,0,empty,CD-0722-1
"A7,H1",8356,8976,6150,2826,4379,2141,0,2142,1430,712,2.008426966,1201,1651,287,109,106,3,46,3,0.132075472,0,empty,CD-0722-1
"A7,H2",1004193,1195079,740218,454861,546748,305544,3,305832,242554,63278,3.833148962,185080,225229,36695,11880,11637,243,1802,9,0.071238292,0,hg38,CD-0722-1
"A7,H3",8079,9206,6024,3182,4393,2206,0,2209,1468,741,1.981106613,1298,1987,342,139,137,2,51,2,0.072992701,0,empty,CD-0722-1
"A7,H4",11912,12812,8964,3848,6115,2939,0,2944,1951,993,1.964753273,1615,389,68,28,28,0,13,0,0,0,empty,CD-0722-1
"A7,H5",13065,14454,9772,4682,6662,3244,0,3248,2087,1161,1.797588286,1884,2558,561,192,190,2,54,1,0.057894737,0,empty,CD-0722-1
"A7,H6",667447,777287,500878,276409,362249,193174,1,193384,147915,45469,3.253095516,114354,146521,23194,7551,7403,148,1302,7,0.054707551,0,hg38,CD-0722-1
"A7,H7",9253,9925,6969,2956,4732,2237,2,2241,1470,771,1.906614786,1175,2302,601,275,274,1,103,1,0.047445255,0,empty,CD-0722-1
"A7,H8",9419,10525,6971,3554,5066,2595,0,2598,1667,931,1.790547798,1508,2651,556,224,224,0,77,0,0.049107143,0,empty,CD-0722-1
"A7,H9",10011,11181,7647,3534,5294,2654,0,2656,1853,803,2.307596513,1494,1405,278,105,105,0,41,0,0.19047619,0,empty,CD-0722-1
"A7,H10",6905,7778,5187,2591,3701,1826,0,1830,1199,631,1.900158479,1076,1536,398,146,145,1,42,1,0.165517241,0,empty,CD-0722-1
"A7,H11",8699,10022,6187,3835,4814,2805,1,2809,1528,1281,1.192818111,1684,125,23,10,10,0,8,0,0,0,empty,CD-0722-1
"A7,H12",7715,8724,5660,3064,4188,2223,0,2227,1457,770,1.892207792,1305,2412,327,123,121,2,43,1,0.157024793,0,empty,CD-0722-1
"A8,A1",6886,7599,5096,2503,3758,1979,0,1984,1284,700,1.834285714,1153,1616,176,83,82,1,36,1,0.109756098,0,empty,CD-0722-1
"A8,A2",3960453,4614012,2946483,1667529,2050423,1180847,14,1182122,981120,201002,4.881145461,694531,444401,80820,27734,27321,413,3475,7,0.053365543,0,hg38,CD-0722-1
"A8,A3",6288,6843,4701,2142,3297,1602,0,1603,1024,579,1.768566494,889,1026,126,39,39,0,21,0,0.128205128,0,empty,CD-0722-1
"A8,A4",11834,12886,8945,3941,6175,3045,0,3049,1910,1139,1.67690957,1693,1073,109,66,63,3,36,1,0,0,empty,CD-0722-1
"A8,A5",552891,619793,418884,200909,294761,150802,2,150998,119707,31291,3.825604806,85342,122267,20434,6844,6712,132,1151,3,0.086412396,0,hg38,CD-0722-1
"A8,A6",7120,7929,5352,2577,3961,1981,1,1986,1302,684,1.903508772,1098,3169,752,249,246,3,89,2,0.130081301,0,empty,CD-0722-1
"A8,A7",1397400,1624265,1042538,581727,758167,418067,3,418512,352261,66251,5.317066912,246438,331942,40904,13828,13482,346,2037,8,0.073950452,0,hg38,CD-0722-1
"A8,A8",4000,4567,3027,1540,2307,1162,0,1163,778,385,2.020779221,684,2064,381,183,179,4,70,2,0.106145251,0,empty,CD-0722-1
"A8,A9",6342,6956,4852,2104,3484,1717,0,1719,1137,582,1.953608247,935,2347,591,178,176,2,61,2,0.085227273,0,empty,CD-0722-1
"A8,A10",6795,7405,5273,2132,3664,1738,0,1740,1068,672,1.589285714,965,522,154,61,59,2,25,2,0.186440678,0,empty,CD-0722-1
"A8,A11",485837,547134,374401,172733,258681,125977,3,126171,99629,26542,3.753635747,71412,202152,23613,7776,7560,216,1364,7,0.058201058,0,hg38,CD-0722-1
"A8,A12",674509,800833,496523,304310,372496,211148,1,211388,164442,46946,3.50279044,127273,83158,26933,8184,8151,33,1417,5,0.074714759,0,hg38,CD-0722-1
"A8,B1",6955,8021,5136,2885,3819,2036,0,2038,1270,768,1.653645833,1192,1278,203,100,99,1,47,1,0.202020202,0,empty,CD-0722-1
"A8,B2",8258,8833,5753,3080,4267,2268,0,2268,1448,820,1.765853659,1297,840,236,67,67,0,18,0,0,0,empty,CD-0722-1
"A8,B3",5537,6027,4079,1948,3030,1495,0,1495,932,563,1.655417407,849,1721,478,171,168,3,58,1,0.119047619,0,empty,CD-0722-1
"A8,B4",6237,7007,4634,2373,3475,1801,1,1806,1158,648,1.787037037,1017,1635,349,159,158,1,62,1,0.170886076,0,empty,CD-0722-1
"A8,B5",11986,9843,5869,3974,5429,2984,0,2994,2098,896,2.341517857,1946,1172,276,108,108,0,38,0,0.074074074,0,empty,CD-0722-1
"A8,B6",7451,8421,5414,3007,4121,2147,0,2152,1337,815,1.640490798,1308,1990,433,144,142,2,37,1,0.147887324,0,empty,CD-0722-1
"A8,B7",7712,8506,5907,2599,4164,2001,1,2003,1284,719,1.78581363,1129,1695,499,135,133,2,45,2,0.007518797,0,empty,CD-0722-1
"A8,B8",5123,5680,3877,1803,2763,1360,0,1361,879,482,1.823651452,757,1152,209,95,95,0,47,0,0.031578947,0,empty,CD-0722-1
"A8,B9",9732,10853,7163,3690,5195,2677,0,2682,1751,931,1.880773362,1571,1027,275,89,88,1,34,1,0.125,0,empty,CD-0722-1
"A8,B10",5673,5796,3970,1826,2973,1485,1,1501,955,546,1.749084249,849,585,81,41,41,0,22,0,0.024390244,0,empty,CD-0722-1
"A8,B11",10068,11280,7169,4111,5520,3067,0,3074,1763,1311,1.344774981,1808,231,32,19,19,0,11,0,0,0,empty,CD-0722-1
"A8,B12",727267,873369,529537,343832,416076,240055,1,240290,197509,42781,4.616745752,146238,80366,13251,4217,4148,69,905,2,0.046769527,0,hg38,CD-0722-1
"A8,C1",13441,14547,10232,4315,6998,3286,0,3293,2098,1195,1.755648536,1803,1049,303,114,114,0,49,0,0.228070175,0,empty,CD-0722-1
"A8,C2",10965,12336,8091,4245,5876,3020,0,3021,1905,1116,1.706989247,1773,2732,727,208,205,3,81,2,0.068292683,0,empty,CD-0722-1
"A8,C3",11297,12402,8530,3872,6126,2972,3,2984,1870,1114,1.678635548,1694,1221,310,89,88,1,41,1,0.056818182,0,empty,CD-0722-1
"A8,C4",6655,7107,5034,2073,3501,1654,0,1659,1114,545,2.044036697,884,2382,469,193,191,2,67,1,0.057591623,0,empty,CD-0722-1
"A8,C5",1020227,1264600,741578,523022,595887,361198,3,361530,290504,71026,4.090107848,224035,37101,11806,3792,3762,30,760,3,0.100478469,0,hg38,CD-0722-1
"A8,C6",8195,8728,5968,2760,4490,2223,0,2223,1510,713,2.117812062,1240,1993,528,224,223,1,93,1,0.013452915,0,empty,CD-0722-1
"A8,C7",11389,13068,8352,4716,6348,3488,0,3492,2081,1411,1.474840539,2058,488,67,45,45,0,26,0,0.022222222,0,empty,CD-0722-1
"A8,C8",12273,13418,9282,4136,6417,3176,0,3182,2086,1096,1.903284672,1768,3246,846,318,317,1,110,1,0.085173502,0,empty,CD-0722-1
"A8,C9",656946,782115,486824,295291,369436,204473,0,204650,156294,48356,3.232153197,124274,103728,13076,4461,4358,103,827,5,0.078017439,0,hg38,CD-0722-1
"A8,C10",10319,11376,7751,3625,5579,2695,0,2695,1712,983,1.741607325,1588,2476,556,243,240,3,72,1,0.0375,0,empty,CD-0722-1
"A8,C11",9422,10402,7051,3351,4930,2345,0,2350,1523,827,1.841596131,1336,2220,490,215,214,1,92,1,0.046728972,0,empty,CD-0722-1
"A8,C12",11733,12704,8944,3760,6179,2902,1,2911,1927,984,1.958333333,1586,2399,615,228,220,8,70,2,0.009090909,0,empty,CD-0722-1
"A8,D1",1277563,1412963,980160,432803,656497,323126,0,323480,246548,76932,3.204752249,183002,50917,7254,2337,2286,51,492,4,0.062117235,0,hg38,CD-0722-1
"A8,D2",9824,10786,7442,3344,5192,2506,0,2509,1584,925,1.712432432,1331,3178,641,301,300,1,96,1,0.066666667,0,empty,CD-0722-1
"A8,D3",736558,837494,558507,278987,396430,206066,1,206275,151169,55106,2.743240301,119072,83777,12108,3935,3855,80,781,3,0.072892348,0,hg38,CD-0722-1
"A8,D4",6017,6645,4531,2114,3254,1585,0,1586,1040,546,1.904761905,876,1401,180,51,49,2,35,1,0.020408163,0,empty,CD-0722-1
"A8,D5",7372,8392,5545,2847,4068,2043,0,2045,1267,778,1.628534704,1223,2138,362,139,133,6,67,2,0.030075188,0,empty,CD-0722-1
"A8,D6",11059,12702,8029,4673,5958,3187,0,3190,1945,1245,1.562248996,1882,1932,454,150,149,1,54,1,0.120805369,0,empty,CD-0722-1
"A8,D7",6252,6633,4666,1967,3278,1523,0,1523,1035,488,2.120901639,844,2779,526,149,147,2,62,1,0.020408163,0,empty,CD-0722-1
"A8,D8",7323,8100,5369,2731,3995,1975,0,1986,1282,704,1.821022727,1188,1579,501,167,166,1,62,1,0.012048193,0,empty,CD-0722-1
"A8,D9",4196,4472,3154,1318,2240,1055,0,1058,735,323,2.275541796,582,2090,520,189,187,2,74,1,0.016042781,0,empty,CD-0722-1
"A8,D10",7306,8396,5324,3072,3913,2020,0,2025,1219,806,1.512406948,1164,909,253,100,100,0,31,0,0.08,0,empty,CD-0722-1
"A8,D11",482877,592355,339246,253109,283332,182350,3,182500,128617,53883,2.38696806,112463,5749,1236,410,397,13,135,3,0.052896725,0,hg38,CD-0722-1
"A8,D12",10778,12146,8046,4100,5819,2884,0,2892,1866,1026,1.81871345,1677,2734,490,231,227,4,91,2,0.158590308,0,empty,CD-0722-1
"A8,E1",12419,13578,9107,4471,6562,3304,0,3310,2176,1134,1.918871252,1890,2936,709,265,261,4,103,2,0.049808429,0,empty,CD-0722-1
"A8,E2",9447,10369,6979,3390,4980,2440,0,2446,1556,890,1.748314607,1415,2509,545,179,174,5,61,2,0.017241379,0,empty,CD-0722-1
"A8,E3",6698,7686,5113,2573,3597,1720,0,1728,1082,646,1.674922601,995,3045,887,292,290,2,93,1,0.024137931,0,empty,CD-0722-1
"A8,E4",8854,9904,6615,3289,4790,2321,3,2324,1515,809,1.872682324,1310,2804,551,210,209,1,94,1,0.019138756,0,empty,CD-0722-1
"A8,E5",8180,8660,6426,2234,4173,1876,0,1882,1221,661,1.84720121,971,1421,334,151,149,2,49,1,0.080536913,0,empty,CD-0722-1
"A8,E6",12558,13712,9292,4420,6830,3411,0,3411,2182,1229,1.775427177,1959,3451,806,307,305,2,100,2,0.02295082,0,empty,CD-0722-1
"A8,E7",11524,12635,8545,4090,6212,3059,0,3066,1977,1089,1.815426997,1745,2964,792,304,302,2,103,1,0.119205298,0,empty,CD-0722-1
"A8,E8",10362,11454,7940,3514,5389,2538,0,2538,1632,906,1.801324503,1409,2947,649,210,209,1,81,1,0.043062201,0,empty,CD-0722-1
"A8,E9",5607,6304,4077,2227,3047,1575,0,1577,1017,560,1.816071429,903,2920,807,288,281,7,89,2,0.053380783,0,empty,CD-0722-1
"A8,E10",7791,8597,5780,2817,4204,2037,0,2037,1345,692,1.943641618,1153,3229,684,248,245,3,79,2,0.048979592,0,empty,CD-0722-1
"A8,E11",1558111,1790115,1173963,616152,830377,445877,4,446344,342657,103687,3.304724797,259143,344623,44163,14492,14124,368,2293,7,0.04375531,0,hg38,CD-0722-1
"A8,E12",761506,889411,570392,319019,419001,223711,1,223965,174034,49931,3.485489976,132923,118305,14935,5123,4983,140,956,3,0.041340558,0,hg38,CD-0722-1
"A8,F1",11268,12267,8430,3837,5851,2850,8,2864,1812,1052,1.72243346,1616,2559,727,271,266,5,73,3,0.07518797,0,empty,CD-0722-1
"A8,F2",9053,9631,6664,2967,4749,2243,0,2247,1404,843,1.665480427,1278,3660,783,341,338,3,131,2,0.050295858,0,empty,CD-0722-1
"A8,F3",8406,9357,6249,3108,4608,2267,0,2272,1510,762,1.981627297,1331,2778,682,224,219,5,93,2,0.02739726,0,empty,CD-0722-1
"A8,F4",13374,14074,9772,4302,6809,3148,0,3153,2049,1104,1.855978261,1804,818,209,93,92,1,35,1,0.108695652,0,empty,CD-0722-1
"A8,F5",1047929,1156023,819193,336830,528351,256977,2,257269,198791,58478,3.399415165,141859,82107,11485,3520,3433,87,767,3,0.018351296,0,hg38,CD-0722-1
"A8,F6",10172,11595,7440,4155,5575,3002,0,3002,1996,1006,1.984095427,1756,3528,687,274,270,4,105,2,0.074074074,0,empty,CD-0722-1
"A8,F7",860783,979818,660615,319203,455691,228328,1,228606,173605,55001,3.156397156,131886,62244,6894,2174,2112,62,513,4,0.075757576,0,hg38,CD-0722-1
"A8,F8",12804,14575,9650,4925,6973,3502,0,3506,2506,1000,2.506,2059,133,17,12,11,1,8,1,0.181818182,0,empty,CD-0722-1
"A8,F9",8492,8875,6396,2479,4399,2094,0,2097,1417,680,2.083823529,1108,3442,658,259,257,2,79,2,0.050583658,0,empty,CD-0722-1
"A8,F10",11561,12530,8765,3765,6100,2848,0,2850,1884,966,1.950310559,1561,2224,726,217,215,2,58,1,0.097674419,0,empty,CD-0722-1
"A8,F11",852065,969287,649119,320168,451153,237478,0,237734,194519,43215,4.501191716,135811,71111,8854,2888,2818,70,648,3,0.033711852,0,hg38,CD-0722-1
"A8,F12",9689,10184,7282,2902,4814,2272,0,2274,1525,749,2.036048064,1199,134,22,20,20,0,12,0,0,0,empty,CD-0722-1
"A8,G1",11350,12380,8589,3791,6003,2911,1,2913,1897,1016,1.867125984,1656,3150,653,290,288,2,120,1,0.128472222,0,empty,CD-0722-1
"A8,G2",6388,6829,4587,2242,3276,1647,0,1649,1037,612,1.694444444,934,632,159,59,59,0,23,0,0,0,empty,CD-0722-1
"A8,G3",13214,14412,9654,4758,7106,3614,0,3617,2272,1345,1.689219331,2071,3589,786,298,292,6,107,2,0.078767123,0,empty,CD-0722-1
"A8,G4",1035367,1205387,776668,428719,562447,311520,7,311797,242902,68895,3.525684012,183242,282,22,15,15,0,13,0,0.266666667,0,empty,CD-0722-1
"A8,G5",7364,8172,5492,2680,3945,1956,0,1959,1266,693,1.826839827,1119,2510,524,199,197,2,69,2,0.060913706,0,empty,CD-0722-1
"A8,G6",10423,11579,8007,3572,5480,2609,0,2613,1720,893,1.926091825,1467,195,51,16,15,1,8,1,0,0,empty,CD-0722-1
"A8,G7",8546,9193,6477,2716,4390,1998,0,2006,1333,673,1.980683507,1078,3143,822,268,263,5,99,2,0.045627376,0,empty,CD-0722-1
"A8,G8",590244,718055,412132,305923,342205,218159,0,218309,167970,50339,3.336776654,134419,37706,22091,6495,6481,14,984,2,0.008794939,0,hg38,CD-0722-1
"A8,G9",7611,8652,5643,3009,4070,2054,0,2055,1290,765,1.68627451,1183,2774,668,249,245,4,80,3,0.167346939,0,empty,CD-0722-1
"A8,G10",8866,9945,6683,3262,4796,2398,0,2405,1595,810,1.969135802,1390,2830,728,285,285,0,101,0,0.112280702,0,empty,CD-0722-1
"A8,G11",968990,1124468,730452,394016,521335,283505,5,283830,227348,56482,4.025140753,164417,56126,12242,3737,3697,40,771,4,0.030565323,0,hg38,CD-0722-1
"A8,G12",7405,8043,5508,2535,3910,1944,0,1945,1274,671,1.898658718,1045,2477,633,208,206,2,85,1,0.009708738,0,empty,CD-0722-1
"A8,H1",6649,7110,5013,2097,3520,1652,0,1658,1046,612,1.709150327,886,1435,240,109,108,1,46,1,0.064814815,0,empty,CD-0722-1
"A8,H2",9243,10508,6947,3561,5010,2534,0,2539,1589,950,1.672631579,1451,2523,577,224,223,1,87,1,0.040358744,0,empty,CD-0722-1
"A8,H3",626638,715563,469763,245800,339127,178027,1,178192,137211,40981,3.348161343,104785,52998,9972,3201,3153,48,637,4,0.037107517,0,hg38,CD-0722-1
"A8,H4",10532,11587,7811,3776,5522,2676,0,2685,1729,956,1.808577406,1525,349,71,31,31,0,11,0,0,0,empty,CD-0722-1
"A8,H5",954717,1122730,710023,412707,521721,286682,3,286994,218178,68816,3.170454545,171642,110002,20988,6800,6723,77,1185,5,0.049531459,0,hg38,CD-0722-1
"A8,H6",6041,6556,4491,2065,3203,1617,0,1617,1071,546,1.961538462,927,2297,484,121,119,2,43,1,0.134453782,0,empty,CD-0722-1
"A8,H7",7911,8923,5991,2932,4274,2054,0,2056,1324,732,1.808743169,1181,1699,381,151,150,1,65,1,0.106666667,0,empty,CD-0722-1
"A8,H8",8295,9622,6082,3540,4592,2425,0,2427,1521,906,1.678807947,1465,2896,626,233,229,4,76,2,0.113537118,0,empty,CD-0722-1
"A8,H9",7091,7892,5285,2607,3788,1857,0,1857,1245,612,2.034313725,1044,1294,237,104,104,0,39,0,0.028846154,0,empty,CD-0722-1
"A8,H10",6892,7455,5165,2290,3638,1783,0,1786,1184,602,1.966777409,996,1515,345,132,131,1,45,1,0.030534351,0,empty,CD-0722-1
"A8,H11",7371,8482,5205,3277,4089,2390,0,2392,1292,1100,1.174545455,1467,78,15,11,11,0,10,0,0,0,empty,CD-0722-1
"A8,H12",6301,7015,4634,2381,3425,1765,0,1768,1217,551,2.208711434,1030,2141,470,167,167,0,53,0,0.041916168,0,empty,CD-0722-1
"A9,A1",6322,6828,4594,2234,3250,1716,0,1718,1128,590,1.911864407,943,1324,159,65,65,0,33,0,0.015384615,0,empty,CD-0722-1
"A9,A2",8967,9677,6808,2869,4646,2270,0,2272,1418,854,1.660421546,1255,1401,432,192,192,0,55,0,0.010416667,0,empty,CD-0722-1
"A9,A3",5635,6201,4175,2026,2945,1454,0,1454,928,526,1.764258555,807,857,220,65,65,0,28,0,0.092307692,0,empty,CD-0722-1
"A9,A4",10905,11806,8359,3447,5642,2733,0,2733,1724,1009,1.708622398,1444,744,138,61,61,0,21,0,0.016393443,0,empty,CD-0722-1
"A9,A5",8250,9254,6206,3048,4329,2061,0,2064,1407,657,2.141552511,1173,2402,459,167,167,0,52,0,0.083832335,0,empty,CD-0722-1
"A9,A6",12402,14290,9374,4916,6782,3489,0,3496,2472,1024,2.4140625,2014,2494,758,248,245,3,80,2,0.053061224,0,empty,CD-0722-1
"A9,A7",6340,7259,4748,2511,3493,1811,1,1814,1169,645,1.812403101,1053,1545,339,112,111,1,42,1,0.018018018,0,empty,CD-0722-1
"A9,A8",3882,4421,2826,1595,2141,1100,0,1102,733,369,1.986449864,674,1764,466,147,144,3,57,1,0.041666667,0,empty,CD-0722-1
"A9,A9",6378,7178,4813,2365,3445,1697,1,1700,1163,537,2.165735568,948,1928,394,141,140,1,44,1,0.014285714,0,empty,CD-0722-1
"A9,A10",6365,7033,4865,2168,3333,1628,0,1634,1082,552,1.960144928,895,475,122,48,47,1,22,1,0,0,empty,CD-0722-1
"A9,A11",5478,5758,4066,1692,2841,1303,0,1305,903,402,2.246268657,676,2723,361,139,130,9,49,2,0.046153846,0,empty,CD-0722-1
"A9,A12",7319,8043,5493,2550,3836,1841,0,1844,1230,614,2.003257329,1071,27331,2786,902,863,39,240,4,0.106604867,0,empty,CD-0722-1
"A9,B1",1710560,1953854,1288789,665065,878101,468082,2,468645,387667,80978,4.787312603,269922,270494,50763,16863,16603,260,2411,10,0.06878275,0,hg38,CD-0722-1
"A9,B2",7754,8468,5294,3174,4136,2244,0,2244,1414,830,1.703614458,1390,520,31,19,19,0,12,0,0.052631579,0,empty,CD-0722-1
"A9,B3",5341,5752,4000,1752,2767,1374,0,1379,896,483,1.855072464,745,1272,331,95,95,0,38,0,0.010526316,0,empty,CD-0722-1
"A9,B4",6100,6732,4440,2292,3287,1716,0,1719,1084,635,1.707086614,1037,1392,303,107,105,2,44,1,0.133333333,0,empty,CD-0722-1
"A9,B5",6735,3658,2167,1491,2377,1275,0,1280,828,452,1.831858407,840,923,206,84,83,1,25,1,0.108433735,0,empty,CD-0722-1
"A9,B6",7412,7942,5343,2599,3756,2002,0,2003,1265,738,1.714092141,1168,1919,538,192,192,0,53,0,0.0625,0,empty,CD-0722-1
"A9,B7",7198,7888,5500,2388,3810,1784,0,1786,1137,649,1.75192604,989,1425,328,134,134,0,30,0,0.156716418,0,empty,CD-0722-1
"A9,B8",4741,5143,3635,1508,2478,1114,1,1116,749,367,2.040871935,615,1343,272,85,83,2,32,1,0.072289157,0,empty,CD-0722-1
"A9,B9",8858,9898,6603,3295,4673,2473,0,2475,1479,996,1.484939759,1383,680,133,61,61,0,24,0,0.016393443,0,empty,CD-0722-1
"A9,B10",4779,5129,3411,1718,2534,1213,1,1221,781,440,1.775,704,585,159,59,59,0,18,0,0.254237288,0,empty,CD-0722-1
"A9,B11",9911,11238,7182,4056,5268,2845,0,2846,1571,1275,1.232156863,1704,291,37,18,18,0,11,0,0,0,empty,CD-0722-1
"A9,B12",5814,6440,4468,1972,2995,1430,0,1430,928,502,1.848605578,791,12469,1289,419,412,7,90,2,0.089805825,0,empty,CD-0722-1
"A9,C1",628559,690157,484052,206105,314734,149171,2,149330,113621,35709,3.181858915,83113,29825,4333,1432,1388,44,305,4,0.060518732,0,hg38,CD-0722-1
"A9,C2",802298,904069,614949,289120,410840,207258,2,207498,158547,48951,3.238891953,118341,120672,13000,4346,4221,125,906,6,0.052357261,0,hg38,CD-0722-1
"A9,C3",827276,988103,610844,377259,452425,254317,6,254565,199856,54709,3.653073535,154362,74115,8902,2963,2889,74,652,6,0.061266874,0,hg38,CD-0722-1
"A9,C4",6201,6985,4573,2412,3283,1546,1,1552,1010,542,1.863468635,906,1480,447,151,147,4,49,2,0.020408163,0,empty,CD-0722-1
"A9,C5",9664,10717,7164,3553,5021,2515,0,2515,1670,845,1.976331361,1431,1481,332,112,110,2,48,1,0.118181818,0,empty,CD-0722-1
"A9,C6",8082,8674,6017,2657,4142,2016,0,2019,1323,696,1.900862069,1096,1595,297,109,108,1,42,1,0.074074074,0,empty,CD-0722-1
"A9,C7",10532,12112,7596,4516,5772,3185,1,3193,1907,1286,1.482892691,1876,464,145,67,67,0,25,0,0.28358209,0,empty,CD-0722-1
"A9,C8",1431771,1576327,1112316,464011,717799,347076,5,347485,276033,71452,3.863194872,192921,89716,21276,6733,6650,83,1149,5,0.022556391,0,hg38,CD-0722-1
"A9,C9",7798,8686,5903,2783,4098,2006,0,2008,1302,706,1.844192635,1147,1581,365,155,147,8,39,2,0.156462585,0,empty,CD-0722-1
"A9,C10",9632,10479,7313,3166,4921,2356,1,2364,1527,837,1.82437276,1315,1862,295,116,114,2,41,1,0.122807018,0,empty,CD-0722-1
"A9,C11",8355,9104,6236,2868,4277,2057,0,2059,1379,680,2.027941176,1124,3054,416,180,179,1,61,1,0.134078212,0,empty,CD-0722-1
"A9,C12",11348,12338,8493,3845,5753,2751,0,2753,1817,936,1.941239316,1526,16126,1702,620,594,26,131,4,0.117845118,0,empty,CD-0722-1
"A9,D1",9887,11051,7098,3953,5274,2818,0,2821,1759,1062,1.656308851,1702,978,301,66,66,0,23,0,0,0,empty,CD-0722-1
"A9,D2",9139,9770,7108,2662,4663,2142,0,2145,1410,735,1.918367347,1128,2859,800,275,272,3,98,2,0.106617647,0,empty,CD-0722-1
"A9,D3",7668,8334,5751,2583,3964,1951,1,1956,1291,665,1.941353383,1101,1270,190,93,88,5,36,1,0.034090909,0,empty,CD-0722-1
"A9,D4",6552,7232,4953,2279,3419,1664,0,1666,1143,523,2.185468451,950,1127,156,63,63,0,29,0,0,0,empty,CD-0722-1
"A9,D5",6995,7395,5271,2124,3518,1698,0,1698,1121,577,1.942807626,904,1461,227,101,100,1,50,1,0.04,0,empty,CD-0722-1
"A9,D6",9991,11464,7218,4246,5318,2832,0,2838,1769,1069,1.654817587,1725,1845,413,137,134,3,41,1,0.089552239,0,empty,CD-0722-1
"A9,D7",5731,6249,4282,1967,2867,1338,0,1343,873,470,1.857446809,746,2046,382,148,147,1,49,1,0,0,empty,CD-0722-1
"A9,D8",7062,7803,5216,2587,3679,1819,0,1821,1258,563,2.234458259,1037,918,222,92,89,3,39,2,0.02247191,0,empty,CD-0722-1
"A9,D9",383223,454852,278226,176626,215653,129629,0,129752,86220,43532,1.980611964,78637,23455,5825,1785,1757,28,410,3,0.042686397,0,hg38,CD-0722-1
"A9,D10",7193,7705,5367,2338,3551,1741,0,1742,1131,611,1.85106383,940,838,178,49,49,0,18,0,0,0,empty,CD-0722-1
"A9,D11",7660,8173,5741,2432,3963,1852,0,1856,1194,662,1.803625378,1010,4461,896,335,328,7,93,2,0.173780488,0,empty,CD-0722-1
"A9,D12",10128,11363,7608,3755,5321,2688,0,2692,1749,943,1.854718982,1532,11890,1254,463,443,20,135,3,0.121896163,0,empty,CD-0722-1
"A9,E1",11991,13169,8840,4329,6190,3150,0,3152,1985,1167,1.700942588,1788,2799,608,192,191,1,74,1,0.09947644,0,empty,CD-0722-1
"A9,E2",806535,1019021,567568,451453,476548,301833,1,302102,232542,69560,3.343041978,191897,7571,2582,825,822,3,250,1,0.060827251,0,hg38,CD-0722-1
"A9,E3",6209,6949,4745,2204,3323,1609,0,1611,1036,575,1.80173913,891,1935,450,198,198,0,67,0,0.02020202,0,empty,CD-0722-1
"A9,E4",8188,8920,6093,2827,4404,2216,0,2218,1416,802,1.765586035,1262,2442,480,197,192,5,88,2,0.03125,0,empty,CD-0722-1
"A9,E5",7436,8275,5628,2647,3959,1887,0,1888,1219,669,1.822122571,1102,1173,300,120,120,0,42,0,0.141666667,0,empty,CD-0722-1
"A9,E6",12093,13309,8994,4315,6258,3160,0,3163,2083,1080,1.928703704,1785,3024,573,212,209,3,66,2,0.076555024,0,empty,CD-0722-1
"A9,E7",694149,795538,520133,275405,364351,194130,2,194330,152798,41532,3.679042666,112145,127451,20448,6784,6680,104,1167,5,0.061077844,0,hg38,CD-0722-1
"A9,E8",1106070,1226618,862527,364091,558571,273293,6,273625,223546,50079,4.46386709,150935,107952,15607,4921,4809,112,1061,6,0.016843419,0,hg38,CD-0722-1
"A9,E9",5479,6083,3976,2107,2931,1508,1,1523,972,551,1.764065336,905,2477,600,224,223,1,84,1,0.085201794,0,empty,CD-0722-1
"A9,E10",6962,7567,5238,2329,3581,1719,0,1729,1086,643,1.688958009,924,1954,509,156,155,1,48,1,0.148387097,0,empty,CD-0722-1
"A9,E11",8151,8992,6246,2746,4324,2142,0,2144,1312,832,1.576923077,1192,3389,529,177,174,3,57,1,0.068965517,0,empty,CD-0722-1
"A9,E12",9787,10730,7322,3408,5151,2589,3,2595,1659,936,1.772435897,1428,4313,577,206,202,4,67,1,0.069306931,0,empty,CD-0722-1
"A9,F1",10955,11945,8057,3888,5550,2674,0,2676,1704,972,1.75308642,1531,1994,376,137,135,2,47,1,0,0,empty,CD-0722-1
"A9,F2",476750,511434,372665,138769,240945,103730,5,103893,74486,29407,2.532934335,56603,124324,30335,10236,10093,143,1421,5,0.026553057,0,hg38,CD-0722-1
"A9,F3",7977,8937,5908,3029,4140,2022,0,2029,1293,736,1.756793478,1195,2242,346,139,137,2,58,1,0.094890511,0,empty,CD-0722-1
"A9,F4",876675,1010744,648836,361908,465550,254597,6,254868,197233,57635,3.422104624,149555,28130,3455,1132,1099,33,277,3,0.041856233,0,hg38,CD-0722-1
"A9,F5",685156,757048,524413,232635,345420,166616,3,166828,125059,41769,2.994062582,94296,112013,14192,4900,4762,138,901,3,0.054178916,0,hg38,CD-0722-1
"A9,F6",8743,9803,6470,3333,4754,2475,0,2476,1623,853,1.902696366,1474,3505,832,273,272,1,74,1,0.165441176,0,empty,CD-0722-1
"A9,F7",11430,12561,8645,3916,6055,2988,0,2996,1935,1061,1.823751178,1704,1180,168,81,80,1,32,1,0.125,0,empty,CD-0722-1
"A9,F8",7384,8321,5596,2725,3871,1904,1,1910,1234,676,1.825443787,1081,149,23,14,14,0,9,0,0.071428571,0,empty,CD-0722-1
"A9,F9",8216,9326,6298,3028,4305,2110,0,2117,1390,727,1.911966988,1216,2644,493,188,183,5,54,2,0.038251366,0,empty,CD-0722-1
"A9,F10",11185,12116,8566,3550,5647,2604,0,2607,1721,886,1.942437923,1427,2082,422,156,154,2,51,1,0.012987013,0,empty,CD-0722-1
"A9,F11",7938,8579,6077,2502,3989,1842,0,1843,1238,605,2.046280992,1039,2707,388,166,165,1,43,1,0.03030303,0,empty,CD-0722-1
"A9,F12",8931,9887,6660,3227,4552,2206,0,2210,1436,774,1.855297158,1269,959,93,42,39,3,14,2,0,0,empty,CD-0722-1
"A9,G1",10308,11423,7748,3675,5321,2542,0,2544,1622,922,1.759219089,1446,3051,519,187,186,1,92,1,0.086021505,0,empty,CD-0722-1
"A9,G2",5650,6207,3982,2225,3016,1593,1,1594,979,615,1.591869919,944,378,94,35,35,0,15,0,0.114285714,0,empty,CD-0722-1
"A9,G3",12346,13302,9291,4011,6294,3149,0,3153,2019,1134,1.78042328,1669,2307,611,200,198,2,71,2,0.075757576,0,empty,CD-0722-1
"A9,G4",19061,21519,13825,7694,10130,5662,6,5682,3385,2297,1.473661297,3275,159,24,18,18,0,14,0,0.111111111,0,empty,CD-0722-1
"A9,G5",6729,7457,5037,2420,3582,1809,0,1811,1202,609,1.973727422,1034,1869,441,181,180,1,54,1,0.138888889,0,empty,CD-0722-1
"A9,G6",10023,10795,7729,3066,5031,2378,4,2383,1595,788,2.024111675,1280,173,60,16,16,0,7,0,0.25,0,empty,CD-0722-1
"A9,G7",8270,8815,6419,2396,4182,1900,0,1900,1262,638,1.978056426,994,2533,465,200,197,3,61,1,0.152284264,0,empty,CD-0722-1
"A9,G8",5964,6563,4535,2028,3027,1467,0,1471,948,523,1.812619503,836,1786,395,144,144,0,51,0,0.013888889,0,empty,CD-0722-1
"A9,G9",618721,766172,434886,331286,359822,227998,1,228174,176820,51354,3.443159248,141799,18674,5800,1715,1704,11,500,3,0.057511737,0,hg38,CD-0722-1
"A9,G10",8039,8937,6003,2934,4314,2139,0,2142,1344,798,1.684210526,1230,2591,609,236,236,0,75,0,0.050847458,0,empty,CD-0722-1
"A9,G11",606313,675905,468499,207406,313565,150716,3,150903,118359,32544,3.636891593,84359,37789,13941,4379,4355,24,797,2,0.060619977,0,hg38,CD-0722-1
"A9,G12",635969,749906,460463,289443,352675,202502,2,202730,153593,49137,3.125811507,122929,259414,41654,13948,13701,247,2079,8,0.055981315,0,hg38,CD-0722-1
"A9,H1",6493,7135,4812,2323,3364,1645,1,1648,1071,577,1.856152513,913,1012,155,60,60,0,22,0,0.15,0,empty,CD-0722-1
"A9,H2",8172,8939,6095,2844,4239,2063,0,2069,1367,702,1.947293447,1154,2381,486,184,182,2,62,1,0.137362637,0,empty,CD-0722-1
"A9,H3",6507,7281,4769,2512,3429,1773,1,1774,1135,639,1.776212833,1045,1350,206,87,84,3,33,2,0,0,empty,CD-0722-1
"A9,H4",10127,11234,7428,3806,5164,2525,3,2536,1615,921,1.753528773,1485,254,61,27,26,1,11,1,0,0,empty,CD-0722-1
"A9,H5",10849,12035,8053,3982,5642,2834,0,2836,1826,1010,1.807920792,1637,1957,510,174,174,0,46,0,0.040229885,0,empty,CD-0722-1
"A9,H6",5857,6361,4403,1958,2985,1455,0,1457,947,510,1.856862745,810,1743,453,146,145,1,43,1,0.068965517,0,empty,CD-0722-1
"A9,H7",7411,8055,5637,2418,3905,1832,0,1837,1181,656,1.800304878,1047,1768,277,113,111,2,46,2,0.036036036,0,empty,CD-0722-1
"A9,H8",8012,8765,5958,2807,4089,1998,0,1999,1294,705,1.835460993,1115,1941,275,111,107,4,31,1,0.205607477,0,empty,CD-0722-1
"A9,H9",6651,7097,5142,1955,3407,1554,0,1554,1014,540,1.877777778,856,1387,358,154,150,4,42,2,0.04,0,empty,CD-0722-1
"A9,H10",5756,6286,4332,1954,2876,1356,1,1360,879,481,1.827442827,746,1452,356,138,137,1,40,1,0.197080292,0,empty,CD-0722-1
"A9,H11",6832,8007,4733,3274,3942,2413,0,2414,1378,1036,1.33011583,1496,68,2,2,2,0,2,0,0,0,empty,CD-0722-1
"A9,H12",5708,6301,4142,2159,3127,1631,0,1633,1096,537,2.040968343,975,9952,1023,361,350,11,98,3,0.034285714,0,empty,CD-0722-1
"A10,A1",592745,693443,443439,250004,327968,177331,4,177510,132939,44571,2.982634448,105793,100558,10444,3447,3339,108,733,5,0.056903264,0,hg38,CD-0722-1
"A10,A2",8499,9142,6238,2904,4416,2243,0,2245,1429,816,1.75122549,1293,1664,327,124,122,2,57,1,0.098360656,0,empty,CD-0722-1
"A10,A3",5750,6248,4271,1977,2992,1465,2,1469,972,497,1.955734406,791,527,88,27,27,0,20,0,0.037037037,0,empty,CD-0722-1
"A10,A4",10796,11496,8045,3451,5544,2676,0,2678,1706,972,1.755144033,1462,944,213,75,71,4,32,2,0.028169014,0,empty,CD-0722-1
"A10,A5",8047,8916,6003,2913,4241,2070,0,2071,1280,791,1.618204804,1173,2884,443,177,177,0,55,0,0.062146893,0,empty,CD-0722-1
"A10,A6",6386,7466,4706,2760,3591,1936,0,1938,1210,728,1.662087912,1135,3373,790,286,283,3,88,1,0.060070671,0,empty,CD-0722-1
"A10,A7",6144,6613,4585,2028,3208,1632,0,1632,1054,578,1.823529412,908,1655,278,107,99,8,43,1,0.101010101,0,empty,CD-0722-1
"A10,A8",3609,4011,2762,1249,1992,955,0,959,627,332,1.888554217,520,2694,662,176,174,2,63,2,0.063218391,0,empty,CD-0722-1
"A10,A9",6380,7135,4810,2325,3367,1663,0,1664,1087,577,1.883882149,949,1986,406,149,146,3,59,2,0.068493151,0,empty,CD-0722-1
"A10,A10",6141,6982,4651,2331,3243,1572,0,1578,997,581,1.716006885,912,349,92,37,37,0,14,0,0,0,empty,CD-0722-1
"A10,A11",5667,6201,4351,1850,2952,1403,1,1408,912,496,1.838709677,756,1964,350,147,140,7,44,2,0.164285714,0,empty,CD-0722-1
"A10,A12",7142,7793,5403,2390,3703,1780,1,1783,1115,668,1.669161677,991,6339,1059,372,358,14,108,2,0.075418994,0,empty,CD-0722-1
"A10,B1",6611,7189,4996,2193,3426,1711,0,1711,1123,588,1.909863946,939,1371,339,134,133,1,43,1,0.097744361,0,empty,CD-0722-1
"A10,B2",7976,8796,5425,3371,4154,2257,0,2258,1457,801,1.81897628,1357,604,128,50,50,0,22,0,0.2,0,empty,CD-0722-1
"A10,B3",4977,5493,3663,1830,2659,1329,0,1331,828,503,1.64612326,747,1501,331,154,151,3,54,2,0.026490066,0,empty,CD-0722-1
"A10,B4",5569,6182,4140,2042,3100,1609,0,1612,1035,577,1.793760832,925,1286,368,147,146,1,52,1,0.020547945,0,empty,CD-0722-1
"A10,B5",6529,3615,2064,1551,2348,1283,0,1299,786,513,1.532163743,846,979,141,59,59,0,20,0,0.118644068,0,empty,CD-0722-1
"A10,B6",148424,188564,97225,91339,95103,67712,1,67767,49371,18396,2.683789954,43656,2451,763,227,226,1,60,1,0.026548673,0,hg38,CD-0722-1
"A10,B7",7165,7568,5425,2143,3655,1753,1,1757,1183,574,2.06097561,947,1501,403,169,169,0,35,0,0.047337278,0,empty,CD-0722-1
"A10,B8",4747,5138,3591,1547,2427,1132,0,1137,744,393,1.893129771,599,1244,220,92,91,1,43,1,0.065934066,0,empty,CD-0722-1
"A10,B9",8607,9507,6331,3176,4534,2360,0,2365,1405,960,1.463541667,1361,732,134,52,52,0,26,0,0.038461538,0,empty,CD-0722-1
"A10,B10",4587,4938,3325,1613,2516,1224,1,1235,796,439,1.813211845,707,446,116,49,48,1,17,1,0,0,empty,CD-0722-1
"A10,B11",9312,10382,6853,3529,4987,2733,0,2736,1605,1131,1.419098143,1611,330,44,26,25,1,11,1,0,0,empty,CD-0722-1
"A10,B12",5848,6489,4392,2097,3071,1480,0,1480,1001,479,2.089770355,851,2661,449,145,142,3,51,2,0.147887324,0,empty,CD-0722-1
"A10,C1",12213,13085,9129,3956,6212,3027,0,3032,1930,1102,1.751361162,1658,1006,223,80,80,0,30,0,0,0,empty,CD-0722-1
"A10,C2",10153,11293,7528,3765,5268,2638,0,2640,1669,971,1.71884655,1505,2073,580,205,205,0,58,0,0.146341463,0,empty,CD-0722-1
"A10,C3",10296,11306,7882,3424,5398,2651,0,2659,1705,954,1.78721174,1450,1017,206,76,74,2,35,1,0.283783784,0,empty,CD-0722-1
"A10,C4",6258,6693,4673,2020,3125,1420,1,1425,890,535,1.663551402,808,1972,608,152,147,5,58,2,0.054421769,0,empty,CD-0722-1
"A10,C5",9045,10368,6633,3735,4822,2428,5,2433,1566,867,1.806228374,1432,2141,366,124,123,1,57,1,0.032520325,0,empty,CD-0722-1
"A10,C6",7495,8153,5457,2696,4090,2048,0,2049,1296,753,1.721115538,1244,2020,315,135,134,1,61,1,0.074626866,0,empty,CD-0722-1
"A10,C7",866111,1049191,635011,414180,480881,277170,5,277463,218922,58541,3.739635469,168980,15979,3127,977,963,14,244,2,0.053997923,0,hg38,CD-0722-1
"A10,C8",1194484,1330202,921131,409071,612823,303259,6,303620,233494,70126,3.329635228,171243,178316,24587,7972,7794,178,1415,6,0.074416218,0,hg38,CD-0722-1
"A10,C9",7629,8367,5717,2650,3964,1969,0,1969,1298,671,1.93442623,1095,1833,237,91,91,0,34,0,0.285714286,0,empty,CD-0722-1
"A10,C10",9437,10243,7094,3149,4830,2331,0,2339,1496,843,1.774614472,1293,2274,399,167,163,4,65,2,0.098159509,0,empty,CD-0722-1
"A10,C11",8305,9199,6161,3038,4457,2168,1,2176,1317,859,1.533178114,1278,2542,592,211,211,0,69,0,0.08056872,0,empty,CD-0722-1
"A10,C12",11296,12291,8367,3924,5754,2767,1,2775,1847,928,1.990301724,1538,3418,704,237,236,1,62,1,0.131355932,0,empty,CD-0722-1
"A10,D1",9689,10867,7071,3796,5065,2612,0,2626,1620,1006,1.610337972,1496,854,142,48,47,1,19,1,0.127659574,0,empty,CD-0722-1
"A10,D2",9301,10143,7082,3061,4836,2239,0,2245,1442,803,1.795765878,1259,3638,1050,390,384,6,112,2,0.075520833,0,empty,CD-0722-1
"A10,D3",7137,8047,5249,2798,3909,2041,0,2043,1318,725,1.817931034,1200,1576,252,99,99,0,46,0,0.121212121,0,empty,CD-0722-1
"A10,D4",6085,6667,4671,1996,3212,1550,0,1550,1056,494,2.137651822,846,1162,282,115,115,0,38,0,0.095652174,0,empty,CD-0722-1
"A10,D5",6485,7232,4759,2473,3394,1696,0,1697,1093,604,1.809602649,989,2010,523,188,185,3,70,1,0.124324324,0,empty,CD-0722-1
"A10,D6",10038,11330,7189,4141,5257,2828,0,2834,1768,1066,1.658536585,1672,2324,540,224,222,2,61,2,0.135135135,0,empty,CD-0722-1
"A10,D7",5912,6554,4457,2097,3111,1496,3,1501,945,556,1.699640288,837,3542,1069,323,321,2,80,1,0.024922118,0,empty,CD-0722-1
"A10,D8",6621,7116,4878,2238,3463,1694,0,1694,1097,597,1.837520938,961,1770,454,145,144,1,47,1,0.048611111,0,empty,CD-0722-1
"A10,D9",3525,3847,2643,1204,1870,889,0,890,565,325,1.738461538,474,1846,320,127,123,4,60,3,0.130081301,0,empty,CD-0722-1
"A10,D10",7197,8081,5286,2795,3797,1929,0,1933,1215,718,1.692200557,1194,864,194,68,68,0,17,0,0.073529412,0,empty,CD-0722-1
"A10,D11",7560,8201,5767,2434,3872,1836,0,1836,1186,650,1.824615385,1014,3376,721,240,236,4,94,1,0.038135593,0,empty,CD-0722-1
"A10,D12",9972,11228,7472,3756,5345,2688,0,2695,1709,986,1.73326572,1559,2917,569,203,197,6,75,2,0.025380711,0,empty,CD-0722-1
"A10,E1",11598,12549,8718,3831,5895,2915,0,2917,1823,1094,1.666361974,1627,3568,650,246,241,5,90,2,0.062240664,0,empty,CD-0722-1
"A10,E2",719439,889469,513784,375685,416384,252895,1,253135,189767,63368,2.994681858,159671,35911,10194,3201,3178,23,650,3,0.072057898,0,hg38,CD-0722-1
"A10,E3",514674,594885,394078,200807,277350,143964,3,144142,104901,39241,2.673249917,83759,190750,25065,8180,7993,187,1451,8,0.060177655,0,hg38,CD-0722-1
"A10,E4",875450,1053332,640825,412507,480858,273136,6,273476,219061,54415,4.025746577,166965,125517,29434,9859,9768,91,1526,5,0.061732187,0,hg38,CD-0722-1
"A10,E5",7254,7612,5479,2133,3654,1660,0,1665,1050,615,1.707317073,905,1516,309,141,140,1,48,1,0.107142857,0,empty,CD-0722-1
"A10,E6",11774,12889,8855,4034,6115,3051,0,3060,1921,1139,1.686567164,1703,3569,567,216,211,5,68,2,0.194312796,0,empty,CD-0722-1
"A10,E7",10558,11633,7907,3726,5516,2658,0,2663,1733,930,1.86344086,1507,3008,646,234,233,1,75,1,0.055793991,0,empty,CD-0722-1
"A10,E8",737130,804835,577655,227180,371490,175758,4,175960,138746,37214,3.728328049,95451,75436,14583,4666,4604,62,864,2,0.031494353,0,hg38,CD-0722-1
"A10,E9",512143,587124,385659,201465,273873,143327,4,143485,107517,35968,2.989240436,83532,184115,21422,6885,6673,212,1309,6,0.042709426,0,hg38,CD-0722-1
"A10,E10",6926,7768,5209,2559,3696,1774,0,1784,1137,647,1.757341577,1017,2097,453,149,146,3,58,1,0.034246575,0,empty,CD-0722-1
"A10,E11",7706,8314,5607,2707,4101,2028,0,2028,1294,734,1.762942779,1171,2555,685,271,267,4,69,2,0.112359551,0,empty,CD-0722-1
"A10,E12",8022,8797,5976,2821,4221,2122,0,2123,1325,798,1.660401003,1214,2364,456,155,153,2,62,1,0.045751634,0,empty,CD-0722-1
"A10,F1",683926,797817,498138,299679,369476,208951,3,209175,166873,42302,3.944801664,124840,121657,25811,8189,8097,92,1359,4,0.067185377,0,hg38,CD-0722-1
"A10,F2",7957,8741,5813,2928,4190,1989,0,1992,1319,673,1.959881129,1166,3100,712,272,266,6,100,2,0.056390977,0,empty,CD-0722-1
"A10,F3",7624,8268,5745,2523,3953,1906,0,1906,1254,652,1.923312883,1066,3076,663,272,271,1,89,1,0.044280443,0,empty,CD-0722-1
"A10,F4",11788,12630,8953,3677,5926,2790,0,2801,1778,1023,1.738025415,1513,700,191,72,72,0,28,0,0.236111111,0,empty,CD-0722-1
"A10,F5",9870,10700,7453,3247,5078,2376,0,2380,1517,863,1.757821553,1343,2220,451,170,168,2,60,2,0.029761905,0,empty,CD-0722-1
"A10,F6",8570,9306,6377,2929,4484,2305,0,2306,1470,836,1.758373206,1335,3066,553,193,187,6,91,2,0.032085561,0,empty,CD-0722-1
"A10,F7",11173,12719,8372,4347,5943,2980,0,2982,1934,1048,1.845419847,1713,1235,177,77,76,1,34,1,0.052631579,0,empty,CD-0722-1
"A10,F8",7249,7922,5511,2411,3738,1763,0,1773,1148,625,1.8368,960,272,68,34,34,0,11,0,0.588235294,0,empty,CD-0722-1
"A10,F9",640936,735566,479513,256053,341333,181076,2,181253,141891,39362,3.604771099,105421,189251,35155,11541,11385,156,1798,7,0.041809398,0,hg38,CD-0722-1
"A10,F10",11010,12171,8482,3689,5671,2656,1,2660,1679,981,1.711518858,1487,1927,469,190,189,1,52,1,0.042328042,0,empty,CD-0722-1
"A10,F11",7009,7453,5384,2069,3545,1629,0,1637,1136,501,2.26746507,869,1990,373,146,143,3,47,2,0.146853147,0,empty,CD-0722-1
"A10,F12",8409,9151,6265,2886,4336,2126,0,2129,1347,782,1.722506394,1181,182,22,18,15,3,8,1,0.266666667,0,empty,CD-0722-1
"A10,G1",737268,854571,549181,305390,397139,217964,2,218214,167074,51140,3.266992569,127949,118808,20126,6669,6544,125,1168,5,0.049358191,0,hg38,CD-0722-1
"A10,G2",5792,6283,4158,2125,2940,1482,0,1486,897,589,1.522920204,850,400,105,47,47,0,16,0,0.127659574,0,empty,CD-0722-1
"A10,G3",10728,11613,7943,3670,5523,2712,1,2717,1660,1057,1.570482498,1450,2860,701,261,257,4,89,2,0.073929961,0,empty,CD-0722-1
"A10,G4",18274,20405,13257,7148,9644,5354,0,5365,3284,2081,1.578087458,3108,170,41,28,28,0,11,0,0,0,empty,CD-0722-1
"A10,G5",6911,7908,5192,2716,3766,1912,0,1912,1261,651,1.937019969,1141,1784,440,165,164,1,50,1,0.201219512,0,empty,CD-0722-1
"A10,G6",9464,10348,7144,3204,4877,2387,0,2388,1503,885,1.698305085,1323,172,41,18,18,0,8,0,0.055555556,0,empty,CD-0722-1
"A10,G7",8018,8786,6003,2783,4224,2009,2,2011,1324,687,1.927219796,1181,2915,622,176,175,1,61,1,0.108571429,0,empty,CD-0722-1
"A10,G8",624878,718793,465816,252977,335049,178827,3,179007,142272,36735,3.872927726,105412,162549,27742,9368,9190,178,1387,7,0.071381937,0,hg38,CD-0722-1
"A10,G9",6959,7785,5139,2646,3787,1892,0,1892,1223,669,1.828101644,1098,2757,660,197,196,1,70,1,0.168367347,0,empty,CD-0722-1
"A10,G10",7519,8560,5692,2868,4022,1980,0,1989,1312,677,1.937961595,1107,2742,738,264,263,1,81,1,0.091254753,0,empty,CD-0722-1
"A10,G11",8025,8832,5881,2951,4254,2017,1,2025,1319,706,1.868271955,1173,1233,269,120,120,0,50,0,0.05,0,empty,CD-0722-1
"A10,G12",6650,7359,4946,2413,3522,1769,1,1774,1112,662,1.679758308,994,3674,759,247,246,1,79,1,0.032520325,0,empty,CD-0722-1
"A10,H1",6209,6862,4621,2241,3199,1519,0,1519,944,575,1.64173913,912,1007,109,58,57,1,30,1,0,0,empty,CD-0722-1
"A10,H2",19990,20998,14319,6679,9728,4772,0,4776,3422,1354,2.52732644,2673,5070,834,306,304,2,98,2,0.075657895,0,empty,CD-0722-1
"A10,H3",6187,6864,4678,2186,3267,1558,0,1559,988,571,1.730297723,921,2146,530,198,192,6,57,2,0.041666667,0,empty,CD-0722-1
"A10,H4",9693,10780,7290,3490,5036,2473,0,2475,1597,878,1.818906606,1427,244,39,22,22,0,8,0,0,0,empty,CD-0722-1
"A10,H5",11123,12093,8206,3887,5557,2733,2,2738,1772,966,1.83436853,1537,2404,713,263,260,3,69,2,0.057692308,0,empty,CD-0722-1
"A10,H6",5928,6690,4396,2294,3152,1627,0,1633,1027,606,1.694719472,923,2691,882,274,274,0,70,0,0.02189781,0,empty,CD-0722-1
"A10,H7",7251,7754,5491,2263,3802,1747,3,1754,1147,607,1.889621087,1016,1781,442,165,164,1,60,1,0.024390244,0,empty,CD-0722-1
"A10,H8",13463,15137,10239,4898,7073,3547,4,3551,2472,1079,2.291010195,2028,2799,624,204,203,1,63,1,0.024630542,0,empty,CD-0722-1
"A10,H9",6060,6552,4652,1900,3102,1423,0,1426,946,480,1.970833333,793,1291,304,119,118,1,44,1,0.161016949,0,empty,CD-0722-1
"A10,H10",5698,6270,4260,2010,2928,1393,0,1393,907,486,1.866255144,774,1204,209,94,94,0,37,0,0.031914894,0,empty,CD-0722-1
"A10,H11",685584,776113,519029,257084,360761,185816,2,186015,145982,40033,3.646541603,107517,1887,317,151,151,0,30,0,0.039735099,0,hg38,CD-0722-1
"A10,H12",535946,629214,392794,236420,294167,161451,1,161636,129239,32397,3.989227398,97006,148685,20404,6829,6660,169,1279,9,0.052552553,0,hg38,CD-0722-1
"A11,A1",5655,6089,4247,1842,2990,1474,0,1481,951,530,1.794339623,817,1524,241,92,90,2,31,2,0.111111111,0,empty,CD-0722-1
"A11,A2",480108,531664,372759,158905,247223,118580,0,118688,91851,26837,3.422550956,65605,47253,5326,1751,1696,55,455,5,0.047169811,0,hg38,CD-0722-1
"A11,A3",5207,5817,3854,1963,2691,1364,0,1364,871,493,1.76673428,821,1060,199,89,89,0,26,0,0.011235955,0,empty,CD-0722-1
"A11,A4",836730,968209,630859,337350,437614,234215,2,234488,184259,50229,3.668378825,136922,35528,4338,1524,1482,42,350,3,0.04925776,0,hg38,CD-0722-1
"A11,A5",456505,528218,339209,189009,245814,131948,2,132092,103603,28489,3.636596581,77775,128081,19744,6595,6448,147,1133,4,0.080800248,0,hg38,CD-0722-1
"A11,A6",6392,7229,4741,2488,3486,1820,0,1822,1220,602,2.026578073,1023,2409,568,208,205,3,80,2,0.053658537,0,empty,CD-0722-1
"A11,A7",345264,370708,276538,94170,175501,70751,26,70861,51349,19512,2.631662567,38039,164385,21486,7316,7129,187,1158,8,0.053724225,0,hg38,CD-0722-1
"A11,A8",3319,3685,2505,1180,1759,890,0,890,587,303,1.937293729,500,2051,573,204,203,1,58,1,0.142857143,0,empty,CD-0722-1
"A11,A9",5564,6065,4346,1719,2948,1390,0,1394,911,483,1.886128364,780,2011,436,184,180,4,58,3,0.038888889,0,empty,CD-0722-1
"A11,A10",567574,620731,443654,177077,290849,135478,2,135627,108527,27100,4.004686347,74756,19236,2136,805,778,27,195,2,0.041131105,0,hg38,CD-0722-1
"A11,A11",919564,1039769,709211,330558,480729,242117,5,242443,182884,59559,3.07063584,137527,113273,13454,4404,4293,111,882,5,0.047985092,0,hg38,CD-0722-1
"A11,A12",6586,6987,5097,1890,3393,1606,0,1613,1026,587,1.747870528,841,2976,664,253,250,3,82,1,0.112,0,empty,CD-0722-1
"A11,B1",6083,6433,4542,1891,3089,1520,0,1521,970,551,1.760435572,800,1133,301,127,127,0,42,0,0.125984252,0,empty,CD-0722-1
"A11,B2",7088,7783,4913,2870,3732,2003,0,2005,1279,726,1.761707989,1166,586,116,63,62,1,32,1,0.064516129,0,empty,CD-0722-1
"A11,B3",4822,5369,3478,1891,2596,1338,0,1340,914,426,2.145539906,791,1602,507,166,166,0,47,0,0.138554217,0,empty,CD-0722-1
"A11,B4",5577,6209,4038,2171,2952,1547,0,1548,1008,540,1.866666667,870,1389,310,133,133,0,50,0,0.052631579,0,empty,CD-0722-1
"A11,B5",1212676,620760,336169,284591,406941,236911,26,238846,182337,56509,3.226689554,163011,109919,16603,5517,5424,93,1077,8,0.063421829,0,hg38,CD-0722-1
"A11,B6",6383,7295,4748,2547,3534,1883,0,1890,1215,675,1.8,1088,1631,392,116,116,0,41,0,0.068965517,0,empty,CD-0722-1
"A11,B7",6368,6971,4836,2135,3311,1593,0,1594,1102,492,2.239837398,847,1495,276,105,102,3,22,2,0.117647059,0,empty,CD-0722-1
"A11,B8",4569,5044,3480,1564,2452,1155,0,1155,766,389,1.969151671,675,1375,315,112,111,1,41,1,0.018018018,0,empty,CD-0722-1
"A11,B9",8244,8932,5979,2953,4288,2227,0,2227,1477,750,1.969333333,1255,1057,318,93,92,1,28,1,0.054347826,0,empty,CD-0722-1
"A11,B10",4565,4850,3142,1708,2446,1255,6,1268,799,469,1.703624733,794,437,97,50,50,0,19,0,0.08,0,empty,CD-0722-1
"A11,B11",8976,10069,6637,3432,4825,2659,0,2663,1494,1169,1.278015398,1536,280,22,12,12,0,7,0,0.416666667,0,empty,CD-0722-1
"A11,B12",5297,5776,3903,1873,2754,1391,0,1393,890,503,1.769383698,784,1653,345,151,146,5,52,1,0.061643836,0,empty,CD-0722-1
"A11,C1",10926,11748,8418,3330,5507,2608,1,2615,1644,971,1.693099897,1420,1154,317,126,125,1,42,1,0.08,0,empty,CD-0722-1
"A11,C2",9150,10257,6700,3557,4842,2436,0,2438,1573,865,1.81849711,1411,2042,491,170,167,3,49,1,0,0,empty,CD-0722-1
"A11,C3",574098,698296,412360,285936,324265,191991,1,192198,149504,42694,3.501756687,118287,35218,6137,1985,1961,24,454,2,0.032126466,0,hg38,CD-0722-1
"A11,C4",5604,6246,4231,2015,2941,1386,0,1388,863,525,1.643809524,764,2403,369,149,146,3,57,1,0.034246575,0,empty,CD-0722-1
"A11,C5",8298,9277,6307,2970,4497,2183,0,2183,1420,763,1.861074705,1266,2075,542,207,206,1,73,1,0.009708738,0,empty,CD-0722-1
"A11,C6",7111,7608,5281,2327,3755,1842,0,1844,1210,634,1.90851735,1014,1464,291,103,100,3,51,1,0.09,0,empty,CD-0722-1
"A11,C7",9669,10989,7034,3955,5291,2905,0,2907,1814,1093,1.659652333,1711,476,129,37,36,1,20,1,0.027777778,0,empty,CD-0722-1
"A11,C8",10424,11336,7725,3611,5386,2688,0,2691,1721,970,1.774226804,1463,3194,625,220,214,6,83,2,0.046728972,0,empty,CD-0722-1
"A11,C9",7681,8863,5704,3159,4109,2060,0,2060,1327,733,1.810368349,1175,1322,240,77,77,0,33,0,0.285714286,0,empty,CD-0722-1
"A11,C10",10531,11676,7948,3728,5486,2670,0,2672,1787,885,2.01920904,1502,2205,494,209,203,6,71,2,0.049261084,0,empty,CD-0722-1
"A11,C11",7643,8845,5547,3298,4216,2202,0,2207,1367,840,1.627380952,1328,1842,575,177,177,0,54,0,0.062146893,0,empty,CD-0722-1
"A11,C12",10081,10877,7498,3379,5099,2355,0,2359,1581,778,2.032133676,1335,1913,506,200,200,0,61,0,0.08,0,empty,CD-0722-1
"A11,D1",9489,10796,6817,3979,5044,2698,0,2703,1652,1051,1.571836346,1566,824,171,66,65,1,30,1,0.230769231,0,empty,CD-0722-1
"A11,D2",1634254,1856730,1242670,614060,838525,441229,4,441683,351282,90401,3.885819847,251670,416221,80461,26021,25619,402,3135,6,0.060111636,0,hg38,CD-0722-1
"A11,D3",6969,7686,5125,2561,3730,1873,0,1873,1249,624,2.001602564,1085,1739,337,133,131,2,57,2,0.045801527,0,empty,CD-0722-1
"A11,D4",6090,6949,4539,2410,3414,1759,1,1760,1170,590,1.983050847,1019,1599,423,145,143,2,44,2,0.083916084,0,empty,CD-0722-1
"A11,D5",399865,505054,268247,236807,237543,163625,2,163762,116694,47068,2.479264044,102791,4805,646,292,290,2,127,1,0.034482759,0,hg38,CD-0722-1
"A11,D6",9370,10387,6694,3693,4872,2562,0,2565,1587,978,1.622699387,1474,1552,284,124,123,1,41,1,0.219512195,0,empty,CD-0722-1
"A11,D7",5143,5480,3955,1525,2586,1178,0,1178,829,349,2.375358166,612,1522,295,127,123,4,50,2,0.113821138,0,empty,CD-0722-1
"A11,D8",6509,7191,4850,2341,3466,1749,0,1749,1159,590,1.96440678,968,1329,217,89,89,0,44,0,0.191011236,0,empty,CD-0722-1
"A11,D9",3486,3818,2656,1162,1909,917,0,918,623,295,2.111864407,517,1529,257,116,114,2,54,2,0.026315789,0,empty,CD-0722-1
"A11,D10",5960,6538,4393,2145,3080,1550,0,1552,969,583,1.662092624,867,784,151,55,55,0,18,0,0.054545455,0,empty,CD-0722-1
"A11,D11",7206,7776,5443,2333,3764,1832,0,1835,1184,651,1.818740399,1028,2943,711,263,258,5,91,1,0.019379845,0,empty,CD-0722-1
"A11,D12",662625,795044,482852,312192,366627,211787,1,211994,165903,46091,3.599466273,129247,65280,20141,6407,6343,64,1121,4,0.034053287,0,hg38,CD-0722-1
"A11,E1",10448,11455,7772,3683,5488,2724,0,2726,1727,999,1.728728729,1570,2996,681,245,240,5,95,2,0.125,0,empty,CD-0722-1
"A11,E2",524749,587196,398626,188570,274545,138279,2,138421,105239,33182,3.171568923,79052,35370,5231,1745,1720,25,383,3,0.04244186,0,hg38,CD-0722-1
"A11,E3",5331,6045,4085,1960,2888,1425,0,1425,879,546,1.60989011,793,2336,543,197,196,1,83,1,0.025510204,0,empty,CD-0722-1
"A11,E4",7194,7969,5420,2549,3827,1832,0,1832,1196,636,1.880503145,1024,2580,678,242,239,3,85,1,0.062761506,0,empty,CD-0722-1
"A11,E5",6944,7768,5266,2502,3578,1732,1,1736,1083,653,1.658499234,975,1370,386,94,92,2,42,1,0.108695652,0,empty,CD-0722-1
"A11,E6",11474,12668,8505,4163,5965,2991,2,3000,1894,1106,1.712477396,1720,3390,795,279,277,2,89,1,0.036101083,0,empty,CD-0722-1
"A11,E7",10203,11199,7704,3495,5234,2499,0,2501,1631,870,1.874712644,1392,2734,664,232,232,0,78,0,0.073275862,0,empty,CD-0722-1
"A11,E8",8344,9057,6439,2618,4270,2026,4,2032,1313,719,1.826147427,1117,2760,637,223,221,2,69,2,0.140271493,0,empty,CD-0722-1
"A11,E9",464860,512266,360606,151660,239017,114855,1,114993,94451,20542,4.597945672,63537,90425,15346,4958,4843,115,1013,5,0.017138138,0,hg38,CD-0722-1
"A11,E10",6421,6877,4911,1966,3331,1581,0,1581,1035,546,1.895604396,866,1896,412,196,194,2,66,1,0.06185567,0,empty,CD-0722-1
"A11,E11",7355,8027,5496,2531,3772,1869,0,1871,1208,663,1.822021116,994,2165,501,155,154,1,58,1,0,0,empty,CD-0722-1
"A11,E12",7697,8607,5706,2901,4110,2077,0,2077,1342,735,1.82585034,1216,1831,268,114,108,6,55,2,0.092592593,0,empty,CD-0722-1
"A11,F1",996786,1077091,766825,310266,495390,233092,0,233377,186556,46821,3.984451421,129809,93996,15176,4742,4641,101,905,4,0.035768153,0,hg38,CD-0722-1
"A11,F2",7848,8868,5794,3074,4231,2108,0,2114,1383,731,1.891928865,1265,3018,515,215,213,2,93,1,0.051643192,0,empty,CD-0722-1
"A11,F3",6957,7414,5235,2179,3651,1727,0,1729,1104,625,1.7664,929,2244,446,204,199,5,82,2,0.100502513,0,empty,CD-0722-1
"A11,F4",10659,11509,7966,3543,5578,2687,0,2690,1736,954,1.819706499,1482,540,60,36,35,1,23,1,0.028571429,0,empty,CD-0722-1
"A11,F5",8964,9851,6647,3204,4718,2270,0,2275,1418,857,1.654609102,1335,2598,576,225,221,4,69,1,0.009049774,0,empty,CD-0722-1
"A11,F6",8261,9406,6056,3350,4489,2278,0,2289,1468,821,1.788063337,1369,3074,667,239,234,5,90,3,0.05982906,0,empty,CD-0722-1
"A11,F7",10560,11744,7841,3903,5494,2751,0,2755,1750,1005,1.741293532,1585,1491,410,161,159,2,64,1,0.025157233,0,empty,CD-0722-1
"A11,F8",7327,8042,5536,2506,3855,1879,0,1879,1255,624,2.011217949,1054,237,39,15,15,0,7,0,0.133333333,0,empty,CD-0722-1
"A11,F9",7172,7889,5485,2404,3783,1812,0,1812,1169,643,1.818040435,1003,2873,677,222,220,2,77,2,0.1,0,empty,CD-0722-1
"A11,F10",9816,10688,7407,3281,5009,2301,0,2305,1459,846,1.724586288,1317,1613,415,157,157,0,44,0,0.044585987,0,empty,CD-0722-1
"A11,F11",6929,7538,5252,2286,3590,1654,0,1658,1102,556,1.982014388,944,1597,430,165,165,0,53,0,0.078787879,0,empty,CD-0722-1
"A11,F12",7829,8696,5850,2846,4136,2039,0,2040,1317,723,1.821576763,1192,178,16,14,11,3,10,3,0.090909091,0,empty,CD-0722-1
"A11,G1",9786,10768,7336,3432,5170,2495,0,2497,1640,857,1.913652275,1416,2776,687,224,221,3,94,2,0.14479638,0,empty,CD-0722-1
"A11,G2",5206,5790,3633,2157,2755,1430,3,1433,932,501,1.860279441,852,570,71,38,38,0,21,0,0.026315789,0,empty,CD-0722-1
"A11,G3",9835,10165,7118,3047,4969,2515,1,2525,1535,990,1.550505051,1351,2712,719,242,238,4,94,1,0.06302521,0,empty,CD-0722-1
"A11,G4",17070,19340,12428,6912,9282,5185,0,5196,3222,1974,1.632218845,3063,189,33,21,21,0,15,0,0.095238095,0,empty,CD-0722-1
"A11,G5",6142,6805,4587,2218,3241,1645,0,1651,1066,585,1.822222222,922,1652,473,183,183,0,62,0,0.18579235,0,empty,CD-0722-1
"A11,G6",20902,22362,14523,7839,10422,5915,0,5921,3982,1939,2.053635895,3433,215,60,23,22,1,10,1,0.090909091,0,empty,CD-0722-1
"A11,G7",680972,789609,511647,277962,365489,194821,2,195031,152985,42046,3.63851496,114060,140330,21154,6968,6832,136,1314,5,0.066451991,0,hg38,CD-0722-1
"A11,G8",4922,5287,3673,1614,2503,1183,0,1184,765,419,1.825775656,662,1444,331,145,140,5,47,2,0.007142857,0,empty,CD-0722-1
"A11,G9",594243,708652,439034,269618,328019,183915,2,184082,139470,44612,3.126288891,111373,147313,24115,8035,7871,164,1441,4,0.041926058,0,hg38,CD-0722-1
"A11,G10",499811,570449,375003,195446,267395,140405,0,140578,111491,29087,3.833018187,81751,93043,16759,5458,5337,121,1032,6,0.037474236,0,hg38,CD-0722-1
"A11,G11",7547,8238,5790,2448,3921,1863,0,1873,1191,682,1.746334311,1041,1582,468,163,162,1,59,1,0.018518519,0,empty,CD-0722-1
"A11,G12",6126,7003,4446,2557,3354,1714,2,1718,1057,661,1.599092284,1009,2114,289,106,106,0,51,0,0.018867925,0,empty,CD-0722-1
"A11,H1",5883,6381,4325,2056,3145,1508,0,1508,956,552,1.731884058,865,948,112,52,51,1,26,1,0.019607843,0,empty,CD-0722-1
"A11,H2",9149,10197,6708,3489,4942,2645,0,2647,1779,868,2.049539171,1587,2167,514,193,189,4,63,1,0.079365079,0,empty,CD-0722-1
"A11,H3",6124,6582,4462,2120,3143,1571,0,1571,1028,543,1.893186004,909,1468,303,110,107,3,45,2,0.046728972,0,empty,CD-0722-1
"A11,H4",8812,9473,6644,2829,4479,2097,0,2100,1339,761,1.759526938,1159,126,15,12,11,1,9,1,0.090909091,0,empty,CD-0722-1
"A11,H5",2022939,2437025,1470271,966754,1092896,672397,9,673101,503654,169447,2.972339434,407518,212265,37144,11889,11694,195,1782,8,0.108089619,0,hg38,CD-0722-1
"A11,H6",5859,6545,4297,2248,3083,1553,0,1553,1053,500,2.106,892,2241,565,200,196,4,56,2,0.12244898,0,empty,CD-0722-1
"A11,H7",6671,7193,5034,2159,3462,1622,0,1624,1080,544,1.985294118,905,1861,366,164,164,0,53,0,0.115853659,0,empty,CD-0722-1
"A11,H8",13031,14479,9850,4629,7105,3500,0,3508,2505,1003,2.497507478,2016,2082,573,215,214,1,57,1,0.037383178,0,empty,CD-0722-1
"A11,H9",657131,806513,453311,353202,371381,246286,1,246489,179534,66955,2.681412889,150267,4739,432,155,147,8,70,2,0.095238095,0,hg38,CD-0722-1
"A11,H10",5371,5840,4020,1820,2816,1352,1,1353,898,455,1.973626374,769,1319,268,93,92,1,38,1,0,0,empty,CD-0722-1
"A11,H11",6175,6937,4406,2531,3403,2016,0,2016,1113,903,1.23255814,1176,66,18,10,10,0,2,0,0,0,empty,CD-0722-1
"A11,H12",5440,5975,3950,2025,2856,1431,0,1432,939,493,1.904665314,830,1896,369,169,167,2,60,2,0.071856287,0,empty,CD-0722-1
"A12,A1",6988,7696,5200,2496,3768,1951,0,1954,1240,714,1.736694678,1096,1698,359,116,113,3,47,1,0.07079646,0,empty,CD-0722-1
"A12,A2",10318,11094,7581,3513,5302,2675,1,2682,1732,950,1.823157895,1508,2628,547,228,226,2,85,1,0.101769912,0,empty,CD-0722-1
"A12,A3",6460,7026,4869,2157,3359,1621,0,1621,1035,586,1.766211604,901,1298,309,131,130,1,30,1,0.107692308,0,empty,CD-0722-1
"A12,A4",12078,13414,9083,4331,6296,3135,0,3135,2046,1089,1.878787879,1829,1099,313,95,94,1,32,1,0.053191489,0,empty,CD-0722-1
"A12,A5",9537,10539,7082,3457,5091,2567,0,2573,1602,971,1.64984552,1461,2967,667,247,246,1,94,1,0.06097561,0,empty,CD-0722-1
"A12,A6",18177,20578,13862,6716,9709,4946,0,4956,3788,1168,3.243150685,2782,2927,744,283,270,13,93,2,0.062962963,0,empty,CD-0722-1
"A12,A7",843584,1004638,626827,377811,459669,256167,1,256379,208629,47750,4.369193717,153111,146776,23280,7610,7453,157,1356,9,0.073929961,0,hg38,CD-0722-1
"A12,A8",4232,4763,3193,1570,2296,1112,0,1115,755,360,2.097222222,639,2331,472,185,184,1,73,1,0.048913043,0,empty,CD-0722-1
"A12,A9",6972,7961,5334,2627,3777,1862,0,1867,1196,671,1.782414307,1078,2323,529,175,174,1,57,1,0.103448276,0,empty,CD-0722-1
"A12,A10",7652,8831,5811,3020,4163,2114,0,2121,1341,780,1.719230769,1191,613,191,63,62,1,26,1,0.161290323,0,empty,CD-0722-1
"A12,A11",575509,681749,426473,255276,316151,177371,3,177575,140526,37049,3.792976868,104946,122848,19062,6277,6141,136,1189,4,0.09184172,0,hg38,CD-0722-1
"A12,A12",8344,9251,6297,2954,4329,2128,0,2129,1406,723,1.944674965,1164,3721,772,274,268,6,90,2,0.029850746,0,empty,CD-0722-1
"A12,B1",7446,8374,5501,2873,3952,2055,0,2057,1283,774,1.657622739,1192,1407,327,152,151,1,55,1,0.046357616,0,empty,CD-0722-1
"A12,B2",8607,9466,5794,3672,4665,2565,0,2568,1611,957,1.68338558,1563,629,73,41,40,1,23,1,0.075,0,empty,CD-0722-1
"A12,B3",955501,1178844,693109,485735,541952,321142,3,321427,258029,63398,4.069986435,199112,105246,19991,6504,6410,94,1210,8,0.082839314,0,hg38,CD-0722-1
"A12,B4",6906,7912,5014,2898,3747,2011,0,2011,1319,692,1.906069364,1180,1608,334,125,124,1,53,1,0.056451613,0,empty,CD-0722-1
"A12,B5",8553,5811,3275,2536,3549,2072,0,2085,1445,640,2.2578125,1358,1080,239,73,73,0,32,0,0.068493151,0,empty,CD-0722-1
"A12,B6",8108,9183,5966,3217,4349,2344,0,2347,1477,870,1.697701149,1359,2086,704,240,238,2,64,2,0.050420168,0,empty,CD-0722-1
"A12,B7",8124,9278,6206,3072,4320,2169,0,2171,1426,745,1.91409396,1267,1006,252,70,69,1,30,1,0.043478261,0,empty,CD-0722-1
"A12,B8",5376,6083,4086,1997,2953,1477,0,1479,974,505,1.928712871,846,1459,264,127,119,8,57,3,0.050420168,0,empty,CD-0722-1
"A12,B9",446654,590677,300617,290060,279332,193992,0,194137,135233,58904,2.295820318,128655,8483,2252,767,763,4,219,2,0.062909567,0,hg38,CD-0722-1
"A12,B10",541305,638712,345480,293232,312040,196532,15,197273,159961,37312,4.287119425,128204,54121,9921,3183,3131,52,636,5,0.061002874,0,hg38,CD-0722-1
"A12,B11",594307,652530,459610,192920,300332,142132,1,142295,115119,27176,4.236053871,79377,5007,661,217,216,1,62,1,0.018518519,0,hg38,CD-0722-1
"A12,B12",6579,7326,4837,2489,3504,1733,0,1738,1113,625,1.7808,1024,2667,566,167,161,6,53,2,0.086956522,0,empty,CD-0722-1
"A12,C1",961598,1111414,723013,388401,504881,272777,2,273065,210523,62542,3.366105977,159443,55432,9611,3103,3041,62,614,2,0.085827031,0,hg38,CD-0722-1
"A12,C2",11074,12374,8130,4244,5638,2895,0,2896,1811,1085,1.669124424,1659,2698,543,188,187,1,58,1,0.176470588,0,empty,CD-0722-1
"A12,C3",11799,12770,8781,3989,6125,3029,0,3034,1927,1107,1.740740741,1636,1467,383,108,108,0,32,0,0.212962963,0,empty,CD-0722-1
"A12,C4",7328,7988,5532,2456,3783,1796,0,1799,1203,596,2.018456376,1005,2110,422,184,180,4,76,2,0.027777778,0,empty,CD-0722-1
"A12,C5",12264,13816,9326,4490,6694,3351,0,3354,2291,1063,2.155221072,1880,2247,505,192,190,2,76,2,0.147368421,0,empty,CD-0722-1
"A12,C6",854935,1016466,619496,396970,481646,278047,2,278346,242587,35759,6.783942504,168481,140985,19102,6469,6325,144,1276,4,0.032094862,0,hg38,CD-0722-1
"A12,C7",11896,13802,8642,5160,6573,3614,0,3619,2262,1357,1.666912307,2189,714,154,74,73,1,34,1,0.02739726,0,empty,CD-0722-1
"A12,C8",12669,13682,9563,4119,6613,3274,0,3275,2146,1129,1.900797166,1792,4106,1176,343,334,9,94,2,0.071856287,0,empty,CD-0722-1
"A12,C9",9078,10044,6817,3227,4844,2458,0,2463,1618,845,1.914792899,1386,1571,249,87,86,1,36,1,0.174418605,0,empty,CD-0722-1
"A12,C10",10624,11457,8136,3321,5438,2559,0,2564,1665,899,1.852057842,1405,2127,507,166,160,6,50,1,0.11875,0,empty,CD-0722-1
"A12,C11",9373,10475,6822,3653,4884,2530,0,2532,1611,921,1.749185668,1462,2963,801,307,302,5,89,2,0.109271523,0,empty,CD-0722-1
"A12,C12",12828,13889,9518,4371,6692,3266,0,3268,2122,1146,1.851657941,1848,2118,618,203,201,2,62,2,0.094527363,0,empty,CD-0722-1
"A12,D1",11253,12537,8312,4225,6012,3152,0,3154,1961,1193,1.643755239,1781,1045,236,59,59,0,21,0,0.016949153,0,empty,CD-0722-1
"A12,D2",9935,11301,7643,3658,5301,2498,0,2508,1640,868,1.889400922,1456,3729,1062,350,344,6,102,2,0.058139535,0,empty,CD-0722-1
"A12,D3",8120,8779,6048,2731,4349,2168,1,2174,1422,752,1.890957447,1239,1881,433,162,162,0,49,0,0.166666667,0,empty,CD-0722-1
"A12,D4",7515,8406,5632,2774,4022,2046,0,2048,1384,664,2.084337349,1129,1727,494,178,175,3,42,2,0.074285714,0,empty,CD-0722-1
"A12,D5",7842,8593,5851,2742,4108,2006,2,2010,1334,676,1.973372781,1125,2043,395,180,180,0,73,0,0.061111111,0,empty,CD-0722-1
"A12,D6",686013,797001,511388,285613,368664,196812,3,197059,151250,45809,3.301752931,117622,107765,15875,5522,5430,92,985,4,0.051197053,0,hg38,CD-0722-1
"A12,D7",6516,7252,4962,2290,3390,1628,0,1631,1111,520,2.136538462,906,2583,646,201,199,2,71,2,0.090452261,0,empty,CD-0722-1
"A12,D8",627068,736792,463788,273004,341294,190008,6,190199,148659,41540,3.578695234,113314,82842,12222,3970,3906,64,796,4,0.064516129,0,hg38,CD-0722-1
"A12,D9",4221,4687,3128,1559,2302,1079,0,1081,715,366,1.953551913,668,2101,506,226,225,1,80,1,0.057777778,0,empty,CD-0722-1
"A12,D10",8347,9141,6147,2994,4414,2263,0,2264,1393,871,1.599311137,1275,891,158,55,53,2,18,2,0,0,empty,CD-0722-1
"A12,D11",8747,9568,6644,2924,4568,2205,1,2207,1449,758,1.911609499,1261,3859,1078,396,392,4,120,4,0.056122449,0,empty,CD-0722-1
"A12,D12",803928,936406,597049,339357,432378,237014,3,237237,188189,49048,3.836833306,139908,203328,24936,8025,7787,238,1522,6,0.045331964,0,hg38,CD-0722-1
"A12,E1",13249,14317,9860,4457,6650,3382,0,3387,2110,1277,1.652310102,1870,3918,891,292,291,1,102,1,0.079037801,0,empty,CD-0722-1
"A12,E2",9806,10854,7205,3649,5246,2619,0,2621,1717,904,1.899336283,1543,2932,667,213,211,2,67,1,0.165876777,0,empty,CD-0722-1
"A12,E3",623664,726061,472263,253798,337188,178871,0,179060,140335,38725,3.623886378,104886,130311,14903,4801,4694,107,1009,5,0.04921176,0,hg38,CD-0722-1
"A12,E4",9483,10706,7074,3632,5029,2550,0,2554,1649,905,1.822099448,1498,2738,721,243,243,0,95,0,0.053497942,0,empty,CD-0722-1
"A12,E5",8208,9125,6263,2862,4246,1966,0,1972,1239,733,1.690313779,1079,1500,223,106,104,2,42,1,0.028846154,0,empty,CD-0722-1
"A12,E6",13289,14145,10165,3980,6796,3364,0,3371,2130,1241,1.716357776,1821,4140,1140,423,419,4,103,1,0.102625298,0,empty,CD-0722-1
"A12,E7",1277570,1493491,971217,522274,674824,368706,3,369076,304956,64120,4.756019963,214216,229882,32927,10863,10644,219,1829,8,0.08690342,0,hg38,CD-0722-1
"A12,E8",10023,10942,7700,3242,5186,2413,0,2418,1518,900,1.686666667,1290,3036,610,219,218,1,63,1,0.188073394,0,empty,CD-0722-1
"A12,E9",6141,6654,4444,2210,3248,1655,0,1660,1071,589,1.818336163,966,3115,695,261,251,10,81,2,0.083665339,0,empty,CD-0722-1
"A12,E10",8021,9172,5951,3221,4243,2014,0,2020,1335,685,1.948905109,1165,2239,592,184,177,7,70,2,0.011299435,0,empty,CD-0722-1
"A12,E11",9074,9824,6840,2984,4648,2301,0,2303,1472,831,1.771359807,1271,2693,373,175,174,1,78,1,0.063218391,0,empty,CD-0722-1
"A12,E12",9563,10881,7057,3824,5336,2770,1,2776,1825,951,1.919032597,1675,2076,338,122,121,1,47,1,0.066115702,0,empty,CD-0722-1
"A12,F1",11428,12504,8557,3947,5727,2773,1,2777,1788,989,1.807886754,1554,2917,741,273,264,9,104,2,0.037878788,0,empty,CD-0722-1
"A12,F2",9380,10128,6933,3195,4852,2330,1,2332,1561,771,2.02464332,1330,3799,886,349,344,5,112,2,0.01744186,0,empty,CD-0722-1
"A12,F3",8855,9399,6539,2860,4533,2177,0,2178,1410,768,1.8359375,1230,3972,1006,355,354,1,111,1,0.079096045,0,empty,CD-0722-1
"A12,F4",13580,14559,10316,4243,6886,3295,1,3300,2151,1149,1.872062663,1791,732,204,61,61,0,32,0,0.131147541,0,empty,CD-0722-1
"A12,F5",10671,11546,7909,3637,5481,2607,0,2608,1602,1006,1.592445328,1494,2889,616,209,208,1,74,1,0.014423077,0,empty,CD-0722-1
"A12,F6",10500,11572,7835,3737,5642,2853,0,2858,1927,931,2.069817401,1597,3828,705,247,244,3,79,2,0.069672131,0,empty,CD-0722-1
"A12,F7",12778,14587,9568,5019,6864,3492,0,3501,2292,1209,1.895781638,2034,1972,374,140,140,0,70,0,0.1,0,empty,CD-0722-1
"A12,F8",1190157,1365517,907481,458036,626142,327555,2,327907,262405,65502,4.006060884,189411,11180,1855,669,650,19,153,2,0.067692308,0,hg38,CD-0722-1
"A12,F9",846299,1040907,597541,443366,485335,317396,2,317674,227398,90276,2.518919757,193811,20120,1845,670,647,23,157,5,0.29984544,0,hg38,CD-0722-1
"A12,F10",11826,13148,9029,4119,6190,2974,2,2980,1970,1010,1.95049505,1695,2170,598,184,184,0,57,0,0.157608696,0,empty,CD-0722-1
"A12,F11",8594,9428,6510,2918,4498,2139,0,2141,1367,774,1.766149871,1215,2088,407,152,152,0,63,0,0.006578947,0,empty,CD-0722-1
"A12,F12",9839,10917,7245,3672,5131,2551,0,2551,1652,899,1.83759733,1479,234,43,26,26,0,11,0,0,0,empty,CD-0722-1
"A12,G1",11633,12744,8753,3991,6078,2862,0,2868,1836,1032,1.779069767,1620,3749,755,321,316,5,107,2,0.107594937,0,empty,CD-0722-1
"A12,G2",6376,7050,4434,2616,3482,1855,1,1865,1163,702,1.656695157,1122,349,61,28,28,0,21,0,0,0,empty,CD-0722-1
"A12,G3",12071,13139,9057,4082,6377,3191,0,3195,1969,1226,1.606035889,1756,3113,698,254,248,6,96,2,0.052419355,0,empty,CD-0722-1
"A12,G4",20587,22845,15115,7730,11037,6039,1,6053,3834,2219,1.727805318,3493,229,23,15,15,0,12,0,0,0,empty,CD-0722-1
"A12,G5",7476,8279,5660,2619,3941,1942,0,1946,1311,635,2.064566929,1087,2084,600,249,245,4,81,2,0.06122449,0,empty,CD-0722-1
"A12,G6",10653,11672,7800,3872,5448,2666,0,2672,1792,880,2.036363636,1549,346,74,29,29,0,10,0,0,0,empty,CD-0722-1
"A12,G7",795130,926646,587704,338942,429687,239255,0,239487,190212,49275,3.86021309,141377,234439,39847,13583,13340,243,2012,7,0.064842579,0,hg38,CD-0722-1
"A12,G8",6191,6943,4643,2300,3283,1601,0,1603,1010,593,1.703204047,946,1914,480,183,181,2,74,1,0.016574586,0,empty,CD-0722-1
"A12,G9",7590,8817,5566,3251,4124,2127,0,2130,1370,760,1.802631579,1288,2824,769,225,224,1,80,1,0.075892857,0,empty,CD-0722-1
"A12,G10",9396,10461,7075,3386,4961,2521,0,2523,1652,871,1.896670494,1423,3085,831,292,285,7,100,2,0.056140351,0,empty,CD-0722-1
"A12,G11",9373,10224,7219,3005,4880,2378,0,2383,1620,763,2.123197903,1300,1947,372,156,154,2,61,1,0.058441558,0,empty,CD-0722-1
"A12,G12",7425,8454,5456,2998,4039,2089,0,2090,1249,841,1.485136742,1255,2943,731,250,247,3,77,1,0.060728745,0,empty,CD-0722-1
"A12,H1",7422,7976,5556,2420,3814,1822,1,1824,1203,621,1.937198068,1008,1832,465,138,136,2,41,1,0.022058824,0,empty,CD-0722-1
"A12,H2",9055,9959,6739,3220,4675,2353,0,2354,1453,901,1.612652608,1298,2716,690,251,243,8,81,2,0.148148148,0,empty,CD-0722-1
"A12,H3",7270,7929,5345,2584,3754,1871,0,1873,1208,665,1.816541353,1099,1856,362,135,134,1,55,1,0.156716418,0,empty,CD-0722-1
"A12,H4",10909,12080,8124,3956,5664,2813,1,2817,1811,1006,1.800198807,1634,323,50,31,31,0,19,0,0.258064516,0,empty,CD-0722-1
"A12,H5",11949,13188,9020,4168,6129,3014,0,3022,1950,1072,1.819029851,1689,2152,400,161,160,1,52,1,0.1625,0,empty,CD-0722-1
"A12,H6",6962,7745,5043,2702,3560,1838,0,1838,1236,602,2.053156146,1020,2349,527,181,180,1,47,1,0.127777778,0,empty,CD-0722-1
"A12,H7",8194,9063,6005,3058,4172,2070,1,2080,1344,736,1.826086957,1188,2296,544,179,178,1,65,1,0.095505618,0,empty,CD-0722-1
"A12,H8",8682,9433,6273,3160,4531,2308,0,2312,1504,808,1.861386139,1284,2439,476,170,169,1,59,1,0.035502959,0,empty,CD-0722-1
"A12,H9",7033,7684,5377,2307,3702,1730,0,1733,1158,575,2.013913043,958,1365,384,128,127,1,31,1,0.070866142,0,empty,CD-0722-1
"A12,H10",786944,910126,589876,320250,416090,221008,2,221205,168592,52613,3.204379146,130424,92829,9078,2998,2909,89,730,4,0.039188725,0,hg38,CD-0722-1
"A12,H11",7776,9020,5518,3502,4265,2536,0,2539,1421,1118,1.271019678,1521,105,12,7,7,0,7,0,0,0,empty,CD-0722-1
"A12,H12",602405,702672,444269,258403,328470,178522,6,178752,136341,42411,3.214755606,107948,203531,26800,9000,8801,199,1528,4,0.043858652,0,hg38,CD-0722-1
"B1,A1",625392,718366,470927,247439,337505,178413,3,178617,146361,32256,4.537481399,103650,115845,14014,4620,4514,106,965,4,0.056269384,0,hg38,CD-0722-1
"B1,A2",10750,11752,8071,3681,5606,2790,0,2793,1752,1041,1.682997118,1561,1802,456,146,143,3,62,1,0.118881119,0,empty,CD-0722-1
"B1,A3",6267,6995,4696,2299,3232,1575,0,1575,1029,546,1.884615385,886,1157,279,99,99,0,37,0,0.151515152,0,empty,CD-0722-1
"B1,A4",11228,12577,8492,4085,5852,2879,0,2882,1887,995,1.896482412,1621,867,252,118,110,8,41,2,0.027272727,0,empty,CD-0722-1
"B1,A5",9654,10409,7291,3118,5005,2417,0,2423,1591,832,1.912259615,1345,2515,446,215,215,0,70,0,0.269767442,0,empty,CD-0722-1
"B1,A6",19657,22335,14724,7611,10749,5497,0,5505,4030,1475,2.73220339,3146,2738,704,242,239,3,87,2,0.092050209,0,empty,CD-0722-1
"B1,A7",7365,8380,5494,2886,4032,2146,0,2150,1347,803,1.677459527,1237,1385,248,110,108,2,60,1,0.027777778,0,empty,CD-0722-1
"B1,A8",4294,4957,3145,1812,2383,1192,1,1193,787,406,1.938423645,729,1843,402,165,165,0,67,0,0.060606061,0,empty,CD-0722-1
"B1,A9",801431,947512,588252,359260,435617,248025,2,248232,201675,46557,4.331786842,147668,91067,17045,5636,5549,87,963,7,0.040908272,0,hg38,CD-0722-1
"B1,A10",8699,9459,6702,2757,4541,2194,0,2200,1433,767,1.868318123,1201,483,85,40,40,0,20,0,0,0,empty,CD-0722-1
"B1,A11",6503,7080,4949,2131,3334,1542,0,1542,1056,486,2.172839506,843,1860,453,181,180,1,68,1,0.05,0,empty,CD-0722-1
"B1,A12",8959,9829,6769,3060,4483,2127,0,2133,1411,722,1.954293629,1191,3453,721,260,254,6,87,2,0.078740157,0,empty,CD-0722-1
"B1,B1",1729509,1991296,1305780,685516,892082,482039,4,482590,384473,98117,3.91851565,281192,289156,45133,14510,14174,336,2173,8,0.049668407,0,hg38,CD-0722-1
"B1,B2",8018,8738,5501,3237,4268,2331,0,2333,1467,866,1.693995381,1439,660,195,76,76,0,26,0,0.013157895,0,empty,CD-0722-1
"B1,B3",6257,7003,4594,2409,3368,1673,0,1675,1111,564,1.969858156,989,1449,393,120,118,2,40,1,0.211864407,0,empty,CD-0722-1
"B1,B4",7629,8842,5531,3311,4304,2333,0,2334,1479,855,1.729824561,1416,1693,349,116,115,1,51,1,0.086956522,0,empty,CD-0722-1
"B1,B5",12228,9883,6168,3715,5531,3071,0,3090,2195,895,2.452513966,1966,1070,424,145,143,2,26,1,0.132867133,0,empty,CD-0722-1
"B1,B6",8313,9372,6171,3201,4540,2430,0,2432,1457,975,1.494358974,1387,1608,431,137,137,0,48,0,0.02919708,0,empty,CD-0722-1
"B1,B7",7788,8871,5911,2960,4224,2094,0,2094,1384,710,1.949295775,1244,1330,285,71,69,2,36,1,0.043478261,0,empty,CD-0722-1
"B1,B8",5629,6013,4293,1720,2975,1395,0,1395,959,436,2.199541284,768,1313,298,133,133,0,52,0,0.07518797,0,empty,CD-0722-1
"B1,B9",10483,11889,7718,4171,5756,3007,0,3015,1884,1131,1.665782493,1768,1196,330,83,83,0,40,0,0.192771084,0,empty,CD-0722-1
"B1,B10",5208,5331,3812,1519,2771,1332,0,1335,866,469,1.846481876,740,386,71,40,40,0,17,0,0,0,empty,CD-0722-1
"B1,B11",2488785,2879875,1854293,1025582,1268100,711830,4,712570,579352,133218,4.3489018,417576,29201,4142,1395,1374,21,308,4,0.080786026,0,hg38,CD-0722-1
"B1,B12",6852,7405,5126,2279,3564,1704,1,1707,1091,616,1.771103896,942,1582,472,166,158,8,54,2,0.14556962,0,empty,CD-0722-1
"B1,C1",13105,14582,9865,4717,6860,3366,1,3368,2099,1269,1.654058314,1915,1347,397,106,105,1,40,1,0.228571429,0,empty,CD-0722-1
"B1,C2",10859,11676,8088,3588,5557,2847,0,2849,1794,1055,1.700473934,1589,2090,655,196,191,5,54,2,0.062827225,0,empty,CD-0722-1
"B1,C3",11218,12419,8449,3970,5970,2911,0,2923,1857,1066,1.742026266,1629,800,170,80,79,1,36,1,0.025316456,0,empty,CD-0722-1
"B1,C4",1250120,1436804,918029,518775,656685,367403,5,367784,290818,76966,3.778525583,214033,108817,28127,9130,9018,112,1474,5,0.060656465,0,hg38,CD-0722-1
"B1,C5",10771,12086,8008,4078,5724,2809,0,2820,1901,919,2.068552775,1672,2117,518,201,200,1,66,1,0.25,0,empty,CD-0722-1
"B1,C6",9200,10370,6743,3627,5113,2609,2,2611,1780,831,2.141997593,1516,2266,532,195,193,2,71,2,0.056994819,0,empty,CD-0722-1
"B1,C7",1905750,2250709,1425750,824959,1010752,566828,3,567418,473548,93870,5.044721423,336753,45550,7332,2547,2498,49,552,2,0.06244996,0,hg38,CD-0722-1
"B1,C8",13123,14611,9911,4700,6960,3494,0,3495,2242,1253,1.789305666,1948,3521,1034,308,300,8,97,3,0.083333333,0,empty,CD-0722-1
"B1,C9",696868,838605,510816,327789,388683,223681,1,223878,170034,53844,3.157900602,136200,86808,11765,3817,3738,79,714,5,0.046548957,0,hg38,CD-0722-1
"B1,C10",10213,10915,7776,3139,5260,2556,0,2558,1623,935,1.735828877,1404,2098,533,171,171,0,63,0,0.081871345,0,empty,CD-0722-1
"B1,C11",9092,9755,6722,3033,4709,2279,0,2279,1427,852,1.674882629,1265,2301,506,201,199,2,74,2,0.065326633,0,empty,CD-0722-1
"B1,C12",13013,14284,9672,4612,6571,3201,0,3208,2079,1129,1.841452613,1773,2104,511,177,175,2,58,2,0.045714286,0,empty,CD-0722-1
"B1,D1",11453,13061,8271,4790,6142,3253,3,3259,2079,1180,1.761864407,1926,752,161,45,45,0,20,0,0.244444444,0,empty,CD-0722-1
"B1,D2",9657,10642,7377,3265,4951,2361,1,2362,1523,839,1.815256257,1296,3605,970,327,324,3,105,1,0.033950617,0,empty,CD-0722-1
"B1,D3",8145,9040,6118,2922,4405,2249,0,2256,1465,791,1.852085967,1253,1840,319,127,122,5,52,2,0.147540984,0,empty,CD-0722-1
"B1,D4",412973,508386,291436,216950,245869,159820,3,159934,103650,56284,1.84155355,98523,2234,485,161,157,4,51,2,0.050955414,0,hg38,CD-0722-1
"B1,D5",758397,927004,550712,376292,429060,253079,0,253295,204191,49104,4.158337406,155757,74908,14769,4521,4438,83,961,9,0.051374493,0,hg38,CD-0722-1
"B1,D6",11111,12207,7984,4223,5789,3054,0,3059,1892,1167,1.621251071,1824,1901,596,228,227,1,59,1,0.101321586,0,empty,CD-0722-1
"B1,D7",6378,7050,4704,2346,3347,1619,1,1630,1059,571,1.854640981,939,2614,669,205,204,1,65,1,0.049019608,0,empty,CD-0722-1
"B1,D8",8101,8970,6004,2966,4273,2122,0,2130,1352,778,1.737789203,1287,1564,449,161,161,0,54,0,0.068322981,0,empty,CD-0722-1
"B1,D9",6865,7614,5135,2479,3711,1813,0,1814,1220,594,2.053872054,1030,2199,359,144,144,0,51,0,0.0625,0,empty,CD-0722-1
"B1,D10",9031,10360,6667,3693,4913,2546,1,2556,1655,901,1.836847947,1560,998,228,86,86,0,25,0,0.034883721,0,empty,CD-0722-1
"B1,D11",8886,9953,6682,3271,4769,2284,1,2294,1468,826,1.777239709,1345,3289,769,289,284,5,95,3,0.042253521,0,empty,CD-0722-1
"B1,D12",717436,811423,545903,265520,376728,195014,2,195214,150702,44512,3.385648814,111511,43776,9985,2894,2840,54,627,3,0.025,0,hg38,CD-0722-1
"B1,E1",746418,855272,558589,296683,391443,206834,0,207072,162732,44340,3.670094723,120918,90395,10342,3339,3225,114,784,4,0.045581395,0,hg38,CD-0722-1
"B1,E2",9422,10317,6872,3445,4964,2520,0,2527,1622,905,1.792265193,1404,2525,443,217,214,3,98,1,0.042056075,0,empty,CD-0722-1
"B1,E3",6750,7406,5002,2404,3514,1696,0,1698,1088,610,1.783606557,946,2562,548,211,211,0,81,0,0.109004739,0,empty,CD-0722-1
"B1,E4",9182,10207,6854,3353,4811,2405,0,2407,1579,828,1.907004831,1377,2724,474,192,190,2,93,1,0.068421053,0,empty,CD-0722-1
"B1,E5",727169,882900,530058,352842,414608,245788,1,246026,175934,70092,2.510043942,151471,8378,1919,501,497,4,164,2,0.020120724,0,hg38,CD-0722-1
"B1,E6",13313,15043,9801,5242,7154,3710,0,3722,2300,1422,1.617440225,2185,3069,680,200,197,3,55,1,0.152284264,0,empty,CD-0722-1
"B1,E7",1426949,1639350,1070025,569325,736589,396275,5,396743,311963,84780,3.679676811,230585,302548,52054,16625,16331,294,2290,8,0.058722675,0,hg38,CD-0722-1
"B1,E8",10426,11087,7973,3114,5268,2404,0,2406,1560,846,1.843971631,1276,2464,512,224,220,4,64,2,0.081818182,0,empty,CD-0722-1
"B1,E9",6596,7409,4917,2492,3525,1761,3,1774,1172,602,1.946843854,1053,2247,458,162,155,7,70,2,0.038709677,0,empty,CD-0722-1
"B1,E10",903401,1056401,673175,383226,482029,262013,3,262291,207642,54649,3.799557174,155434,127898,13915,4476,4309,167,955,7,0.057553957,0,hg38,CD-0722-1
"B1,E11",9593,10636,7143,3493,5013,2580,0,2582,1615,967,1.670113754,1428,2239,483,150,147,3,51,2,0.06122449,0,empty,CD-0722-1
"B1,E12",704954,839391,518384,321007,391047,217982,1,218193,172116,46077,3.73539944,133165,131650,21383,7125,6978,147,1227,5,0.06577816,0,hg38,CD-0722-1
"B1,F1",744115,892512,535218,357294,413034,246233,7,246515,188344,58171,3.237764522,149620,35795,14609,4279,4266,13,825,2,0.050632911,0,hg38,CD-0722-1
"B1,F2",10426,11426,7757,3669,5426,2661,0,2668,1716,952,1.802521008,1542,3969,984,385,384,1,106,1,0.143229167,0,empty,CD-0722-1
"B1,F3",8761,9834,6693,3141,4733,2299,4,2312,1544,768,2.010416667,1295,3028,600,226,220,6,89,2,0.068181818,0,empty,CD-0722-1
"B1,F4",12746,13416,9480,3936,6397,2968,0,2978,1892,1086,1.742173112,1628,653,217,79,78,1,19,1,0.012820513,0,empty,CD-0722-1
"B1,F5",10585,11435,8035,3400,5352,2537,0,2543,1590,953,1.66841553,1430,2550,721,220,220,0,64,0,0.081818182,0,empty,CD-0722-1
"B1,F6",10506,11868,7751,4117,5633,2913,0,2917,1855,1062,1.746704331,1683,2666,598,227,224,3,85,1,0.138392857,0,empty,CD-0722-1
"B1,F7",875003,1012419,662349,350070,463422,242866,0,243132,181565,61567,2.949063622,143216,47000,7845,2478,2432,46,529,4,0.029605263,0,hg38,CD-0722-1
"B1,F8",8010,8749,6087,2662,4192,2026,0,2031,1306,725,1.80137931,1150,216,97,16,16,0,13,0,0,0,empty,CD-0722-1
"B1,F9",9008,10031,6811,3220,4710,2229,0,2238,1409,829,1.699638118,1271,3044,700,236,236,0,80,0,0.13559322,0,empty,CD-0722-1
"B1,F10",11906,13305,9032,4273,6126,3028,1,3040,1930,1110,1.738738739,1701,1434,309,118,117,1,32,1,0.111111111,0,empty,CD-0722-1
"B1,F11",9107,9675,6987,2688,4646,2162,5,2169,1448,721,2.008321775,1168,1618,277,111,105,6,42,2,0.133333333,0,empty,CD-0722-1
"B1,F12",10140,11212,7463,3749,5174,2584,0,2587,1700,887,1.916572717,1512,453,79,28,28,0,10,0,0,0,empty,CD-0722-1
"B1,G1",1689545,1978082,1254980,723102,895607,499356,8,499871,414777,85094,4.874338966,295262,267967,60892,20110,19864,246,2670,8,0.061770036,0,hg38,CD-0722-1
"B1,G2",6215,7048,4416,2632,3348,1730,0,1732,1101,631,1.744849445,1045,647,211,70,70,0,23,0,0.085714286,0,empty,CD-0722-1
"B1,G3",11894,12698,8965,3733,6045,3023,0,3030,1858,1172,1.585324232,1604,3304,968,314,299,15,98,3,0.137123746,0,empty,CD-0722-1
"B1,G4",21203,24057,15433,8624,11377,6307,0,6322,3875,2447,1.58357172,3634,153,18,14,14,0,9,0,0,0,empty,CD-0722-1
"B1,G5",7958,8808,5828,2980,4273,2143,0,2151,1459,692,2.108381503,1267,1965,518,203,202,1,66,1,0.03960396,0,empty,CD-0722-1
"B1,G6",899695,1024416,680850,343566,466369,243109,4,243399,190600,52799,3.609916854,140285,9104,1225,359,352,7,93,3,0.09375,0,hg38,CD-0722-1
"B1,G7",9921,11032,7482,3550,5193,2547,0,2549,1724,825,2.08969697,1413,3049,823,312,311,1,91,1,0.067524116,0,empty,CD-0722-1
"B1,G8",5978,6551,4448,2103,3252,1564,0,1569,1029,540,1.905555556,921,1752,433,144,142,2,56,2,0.098591549,0,empty,CD-0722-1
"B1,G9",7513,8361,5718,2643,3984,1932,0,1934,1239,695,1.782733813,1115,2501,615,207,204,3,72,2,0.12254902,0,empty,CD-0722-1
"B1,G10",9268,10160,6854,3306,4847,2405,0,2406,1544,862,1.791183295,1365,2844,712,263,256,7,108,3,0.046875,0,empty,CD-0722-1
"B1,G11",9008,9729,6832,2897,4718,2208,0,2213,1421,792,1.794191919,1202,1802,363,135,134,1,57,1,0.029850746,0,empty,CD-0722-1
"B1,G12",8124,9255,5914,3341,4465,2302,0,2302,1462,840,1.74047619,1409,3330,663,238,223,15,63,2,0.143497758,0,empty,CD-0722-1
"B1,H1",635287,723558,478814,244744,337754,175269,3,175445,133035,42410,3.136878095,102854,63212,10903,3456,3363,93,592,4,0.079393399,0,hg38,CD-0722-1
"B1,H2",8824,9905,6534,3371,4583,2266,1,2275,1408,867,1.623990773,1364,2695,527,220,219,1,67,1,0.086757991,0,empty,CD-0722-1
"B1,H3",7119,7984,5375,2609,3904,1900,0,1905,1292,613,2.10766721,1058,1617,285,103,102,1,47,1,0.019607843,0,empty,CD-0722-1
"B1,H4",2406175,2860757,1775887,1084870,1274636,727337,9,728087,583077,145010,4.020943383,439726,18104,2285,797,778,19,189,3,0.041131105,0,hg38,CD-0722-1
"B1,H5",11754,13330,8805,4525,6176,3117,0,3123,1997,1126,1.773534636,1806,1608,585,188,187,1,56,1,0.090909091,0,empty,CD-0722-1
"B1,H6",7619,8300,5639,2661,3959,2023,3,2028,1340,688,1.947674419,1141,2202,423,176,176,0,49,0,0.0625,0,empty,CD-0722-1
"B1,H7",8483,9394,6270,3124,4516,2199,0,2203,1466,737,1.989145183,1285,2532,600,207,206,1,64,1,0,0,empty,CD-0722-1
"B1,H8",9121,10019,6663,3356,4727,2472,1,2479,1538,941,1.634431456,1409,2502,668,182,176,6,51,2,0.125,0,empty,CD-0722-1
"B1,H9",7227,7980,5500,2480,3666,1733,1,1736,1133,603,1.87893864,966,1088,212,72,72,0,29,0,0.055555556,0,empty,CD-0722-1
"B1,H10",6314,7269,4659,2610,3305,1653,0,1654,1150,504,2.281746032,965,1511,308,88,87,1,30,1,0.126436782,0,empty,CD-0722-1
"B1,H11",8250,9693,5854,3839,4679,2849,0,2853,1524,1329,1.146726862,1742,41,9,5,5,0,5,0,0,0,empty,CD-0722-1
"B1,H12",7249,8126,5307,2819,3809,2003,0,2003,1314,689,1.907111756,1148,1883,413,159,157,2,59,1,0.133757962,0,empty,CD-0722-1
"B2,A1",6330,7100,4709,2391,3476,1752,0,1752,1124,628,1.789808917,1015,984,231,70,70,0,26,0,0.042857143,0,empty,CD-0722-1
"B2,A2",9425,10500,7085,3415,4905,2513,0,2513,1595,918,1.737472767,1364,1469,386,139,138,1,52,1,0.007246377,0,empty,CD-0722-1
"B2,A3",5583,6293,4146,2147,2957,1484,1,1485,961,524,1.833969466,857,1298,258,90,89,1,24,1,0.179775281,0,empty,CD-0722-1
"B2,A4",9895,11070,7358,3712,5149,2504,0,2508,1606,902,1.780487805,1436,961,179,67,64,3,22,2,0.15625,0,empty,CD-0722-1
"B2,A5",8539,9467,6423,3044,4608,2237,0,2239,1477,762,1.93832021,1233,1836,448,130,125,5,50,2,0.08,0,empty,CD-0722-1
"B2,A6",7119,8199,5229,2970,3971,2057,0,2058,1405,653,2.151607963,1220,2273,508,190,190,0,78,0,0.105263158,0,empty,CD-0722-1
"B2,A7",6333,7066,4642,2424,3400,1756,0,1756,1139,617,1.846029173,1014,1418,304,103,101,2,33,2,0.00990099,0,empty,CD-0722-1
"B2,A8",3745,4256,2828,1428,2018,990,0,993,647,346,1.869942197,581,2084,377,117,115,2,44,1,0.07826087,0,empty,CD-0722-1
"B2,A9",6495,7231,4941,2290,3449,1690,0,1690,1097,593,1.849915683,967,1340,331,100,100,0,30,0,0.02,0,empty,CD-0722-1
"B2,A10",7050,7710,5397,2313,3614,1757,0,1757,1102,655,1.682442748,959,511,88,32,32,0,15,0,0.03125,0,empty,CD-0722-1
"B2,A11",5942,6530,4628,1902,3211,1554,0,1557,1010,547,1.846435101,813,1512,257,93,90,3,30,1,0.433333333,0,empty,CD-0722-1
"B2,A12",7674,8161,5807,2354,3947,1871,0,1875,1231,644,1.911490683,976,2824,673,249,245,4,56,1,0.07755102,0,empty,CD-0722-1
"B2,B1",6368,7106,4814,2292,3452,1751,0,1752,1019,733,1.390177353,1016,995,336,129,126,3,36,1,0.063492063,0,empty,CD-0722-1
"B2,B2",738140,856580,521282,335298,399394,229051,4,229296,185378,43918,4.221002778,138061,79557,10416,3493,3429,64,742,4,0.069699621,0,hg38,CD-0722-1
"B2,B3",6166,6880,4553,2327,3296,1664,0,1668,1121,547,2.049360146,973,1029,202,87,87,0,25,0,0,0,empty,CD-0722-1
"B2,B4",6657,7407,4903,2504,3560,1878,0,1882,1231,651,1.89093702,1100,1085,247,87,87,0,46,0,0.034482759,0,empty,CD-0722-1
"B2,B5",6294,3473,1995,1478,2194,1232,0,1237,778,459,1.694989107,816,792,117,59,59,0,18,0,0.016949153,0,empty,CD-0722-1
"B2,B6",583334,690742,433095,257647,318414,176064,1,176226,141548,34678,4.081780956,105067,25992,8560,2844,2831,13,585,3,0.067820558,0,hg38,CD-0722-1
"B2,B7",6523,7106,5011,2095,3443,1665,0,1665,1075,590,1.822033898,947,1232,281,86,84,2,27,1,0,0,empty,CD-0722-1
"B2,B8",4950,5308,3783,1525,2551,1178,0,1179,777,402,1.932835821,639,1122,228,81,81,0,33,0,0.135802469,0,empty,CD-0722-1
"B2,B9",9074,10029,6726,3303,4818,2497,0,2499,1596,903,1.76744186,1441,852,238,92,91,1,35,1,0.054945055,0,empty,CD-0722-1
"B2,B10",4783,5125,3308,1817,2600,1349,0,1354,837,517,1.618955513,809,376,37,22,22,0,10,0,0.136363636,0,empty,CD-0722-1
"B2,B11",9700,10577,7197,3380,5009,2671,0,2673,1550,1123,1.380231523,1461,172,37,15,15,0,9,0,0.133333333,0,empty,CD-0722-1
"B2,B12",5921,6665,4418,2247,3181,1655,0,1663,1100,563,1.953818828,947,1243,216,85,85,0,23,0,0,0,empty,CD-0722-1
"B2,C1",11681,12538,8830,3708,5920,2821,0,2821,1845,976,1.890368852,1541,1001,247,86,83,3,25,1,0.289156627,0,empty,CD-0722-1
"B2,C2",9292,10165,7025,3140,4796,2472,0,2473,1632,841,1.940546968,1328,1935,576,186,186,0,52,0,0.123655914,0,empty,CD-0722-1
"B2,C3",650796,819882,454505,365377,382075,243665,4,243863,191753,52110,3.679773556,154797,9516,4777,1532,1531,1,330,1,0.013716525,0,hg38,CD-0722-1
"B2,C4",6510,6967,4988,1979,3445,1639,3,1646,1073,573,1.872600349,909,1456,209,96,94,2,44,2,0.031914894,0,empty,CD-0722-1
"B2,C5",9458,10933,7068,3865,5038,2527,0,2532,1652,880,1.877272727,1489,1578,305,140,140,0,54,0,0.021428571,0,empty,CD-0722-1
"B2,C6",1361184,1546036,1017739,528297,721349,383116,0,383506,291819,91687,3.182774003,223759,104536,11483,3764,3637,127,785,5,0.065163596,0,hg38,CD-0722-1
"B2,C7",10892,12868,7951,4917,6006,3371,0,3371,2018,1353,1.49150037,2040,381,69,36,34,2,16,1,0,0,empty,CD-0722-1
"B2,C8",11992,13381,8908,4473,6243,3186,0,3191,2128,1063,2.001881468,1803,2442,580,219,217,2,75,1,0.064516129,0,empty,CD-0722-1
"B2,C9",8033,9250,5986,3264,4361,2292,0,2295,1433,862,1.662412993,1403,1814,374,120,120,0,43,0,0.083333333,0,empty,CD-0722-1
"B2,C10",964350,1080620,751491,329129,494412,245158,2,245452,198253,47199,4.200364415,136174,234091,35296,11726,11476,250,1804,6,0.043482049,0,hg38,CD-0722-1
"B2,C11",8285,8875,6136,2739,4332,2138,0,2145,1404,741,1.894736842,1216,1510,391,149,147,2,40,2,0.034013605,0,empty,CD-0722-1
"B2,C12",11694,12792,8840,3952,5924,2833,0,2835,1878,957,1.962382445,1572,1720,545,154,152,2,31,1,0,0,empty,CD-0722-1
"B2,D1",685913,797346,511293,286053,369718,198161,2,198372,156755,41617,3.766609799,117342,53353,8278,2695,2626,69,479,5,0.093678599,0,hg38,CD-0722-1
"B2,D2",8179,8895,6328,2567,4304,2031,0,2033,1284,749,1.714285714,1101,2639,782,286,286,0,87,0,0.076923077,0,empty,CD-0722-1
"B2,D3",7506,8538,5515,3023,4067,2112,0,2115,1445,670,2.156716418,1227,1437,410,118,117,1,34,1,0.085470085,0,empty,CD-0722-1
"B2,D4",5848,6693,4314,2379,3182,1637,4,1641,1119,522,2.143678161,981,1138,288,81,81,0,32,0,0,0,empty,CD-0722-1
"B2,D5",6922,7689,5205,2484,3656,1831,0,1831,1231,600,2.051666667,1029,1466,294,113,112,1,44,1,0.026785714,0,empty,CD-0722-1
"B2,D6",9546,10689,6853,3836,5007,2672,0,2673,1674,999,1.675675676,1572,1642,437,150,149,1,32,1,0.234899329,0,empty,CD-0722-1
"B2,D7",5337,5876,4036,1840,2761,1291,1,1294,835,459,1.819172113,721,1757,465,171,170,1,43,1,0.011764706,0,empty,CD-0722-1
"B2,D8",7010,7637,5216,2421,3647,1740,0,1740,1132,608,1.861842105,965,1145,305,107,105,2,34,1,0.019047619,0,empty,CD-0722-1
"B2,D9",341196,400449,249678,150771,186674,104496,0,104582,84073,20509,4.099322249,62418,111049,17063,5559,5445,114,977,9,0.051423324,0,hg38,CD-0722-1
"B2,D10",7825,8502,5871,2631,4068,2029,0,2033,1359,674,2.016320475,1142,666,141,45,45,0,14,0,0.111111111,0,empty,CD-0722-1
"B2,D11",7653,8290,5748,2542,4043,1982,0,1982,1328,654,2.03058104,1121,2317,456,198,193,5,66,1,0.062176166,0,empty,CD-0722-1
"B2,D12",788659,940711,583060,357651,429520,240940,0,241175,198243,42932,4.617604584,144822,176165,31400,9953,9777,176,1751,12,0.058402373,0,hg38,CD-0722-1
"B2,E1",12172,13455,8994,4461,6444,3232,0,3237,2056,1181,1.740897544,1899,2034,543,193,191,2,67,1,0.020942408,0,empty,CD-0722-1
"B2,E2",8420,9552,6176,3376,4543,2357,13,2370,1559,811,1.922318126,1399,1720,371,115,114,1,34,1,0.201754386,0,empty,CD-0722-1
"B2,E3",5864,6499,4514,1985,3106,1449,0,1455,935,520,1.798076923,807,2243,552,222,219,3,75,2,0.054794521,0,empty,CD-0722-1
"B2,E4",8050,9015,5941,3074,4336,2206,1,2208,1436,772,1.860103627,1280,2304,484,179,176,3,55,2,0.039772727,0,empty,CD-0722-1
"B2,E5",7228,7892,5520,2372,3776,1764,0,1768,1136,632,1.797468354,976,1128,237,91,90,1,33,1,0.022222222,0,empty,CD-0722-1
"B2,E6",11441,12908,8470,4438,6068,3054,0,3057,1899,1158,1.639896373,1809,2747,631,232,228,4,65,2,0.030701754,0,empty,CD-0722-1
"B2,E7",11231,12444,8453,3991,5880,2845,4,2857,1920,937,2.04909285,1652,2041,526,189,187,2,59,2,0.080213904,0,empty,CD-0722-1
"B2,E8",9047,9855,6857,2998,4670,2200,0,2206,1417,789,1.795944233,1210,2171,445,159,158,1,42,1,0.132911392,0,empty,CD-0722-1
"B2,E9",5749,6493,4252,2241,3092,1570,5,1575,1024,551,1.858439201,912,2064,501,181,177,4,61,2,0,0,empty,CD-0722-1
"B2,E10",6712,7221,4989,2232,3533,1649,0,1654,1057,597,1.770519263,945,1971,565,223,219,4,55,1,0.068493151,0,empty,CD-0722-1
"B2,E11",1298026,1586047,902014,684033,729464,486593,2,487011,343213,143798,2.386771721,292811,66916,3265,1249,1141,108,333,5,0.304119194,0,hg38,CD-0722-1
"B2,E12",9632,10563,7066,3497,5089,2590,0,2592,1711,881,1.942111237,1542,1802,285,95,89,6,38,1,0.224719101,0,empty,CD-0722-1
"B2,F1",10064,10887,7570,3317,5176,2493,0,2495,1597,898,1.778396437,1409,1917,299,139,138,1,45,1,0.101449275,0,empty,CD-0722-1
"B2,F2",8614,9554,6499,3055,4529,2229,0,2233,1478,755,1.957615894,1231,2466,516,189,189,0,61,0,0.137566138,0,empty,CD-0722-1
"B2,F3",707175,819169,531069,288100,375872,199958,1,200145,153151,46994,3.258947951,117938,106558,15937,5173,5051,122,1022,4,0.041773906,0,hg38,CD-0722-1
"B2,F4",11559,12448,8564,3884,5850,2785,0,2791,1830,961,1.904266389,1568,366,47,22,22,0,16,0,0.090909091,0,empty,CD-0722-1
"B2,F5",9228,9810,6932,2878,4602,2113,0,2119,1349,770,1.751948052,1166,1937,314,107,103,4,42,2,0.067961165,0,empty,CD-0722-1
"B2,F6",9358,10012,7045,2967,4790,2393,0,2398,1540,858,1.794871795,1318,2726,600,234,234,0,75,0,0.141025641,0,empty,CD-0722-1
"B2,F7",11007,12045,8348,3697,5860,2969,0,2972,1992,980,2.032653061,1680,1060,282,105,104,1,33,1,0,0,empty,CD-0722-1
"B2,F8",6972,7863,5295,2568,3796,1901,6,1913,1167,746,1.564343164,1113,167,11,5,5,0,3,0,0,0,empty,CD-0722-1
"B2,F9",7493,8004,5672,2332,3946,1907,0,1907,1280,627,2.041467305,1073,2554,753,231,228,3,68,2,0.021929825,0,empty,CD-0722-1
"B2,F10",10053,11261,7818,3443,5286,2499,0,2508,1678,830,2.021686747,1381,1410,302,120,118,2,38,2,0.042372881,0,empty,CD-0722-1
"B2,F11",7868,8437,6019,2418,4036,1788,0,1799,1226,573,2.139616056,986,1378,258,112,111,1,28,1,0.225225225,0,empty,CD-0722-1
"B2,F12",9091,9897,6802,3095,4548,2254,0,2261,1517,744,2.038978495,1256,168,98,32,32,0,8,0,0,0,empty,CD-0722-1
"B2,G1",9990,11029,7402,3627,5264,2515,0,2518,1596,922,1.731019523,1444,2248,568,216,213,3,70,2,0.126760563,0,empty,CD-0722-1
"B2,G2",5532,6030,4082,1948,2848,1398,0,1400,942,458,2.056768559,782,283,17,11,11,0,8,0,0,0,empty,CD-0722-1
"B2,G3",10720,11282,7963,3319,5352,2695,0,2700,1681,1019,1.649656526,1440,2172,516,170,170,0,60,0,0.023529412,0,empty,CD-0722-1
"B2,G4",18538,20847,13484,7363,9866,5429,0,5435,3433,2002,1.714785215,3114,154,13,10,10,0,8,0,0,0,empty,CD-0722-1
"B2,G5",6661,7586,5059,2527,3656,1818,0,1820,1175,645,1.821705426,1028,1629,285,116,114,2,46,2,0.026315789,0,empty,CD-0722-1
"B2,G6",9429,10351,7133,3218,4765,2321,0,2321,1536,785,1.956687898,1270,149,30,13,13,0,11,0,0,0,empty,CD-0722-1
"B2,G7",7820,8490,5974,2516,4100,1902,1,1904,1270,634,2.003154574,1047,2891,799,198,197,1,68,1,0.060913706,0,empty,CD-0722-1
"B2,G8",132206,121825,118200,3625,60432,4938,0,4975,3356,1619,2.072884497,1475,2421,492,184,181,3,84,2,0.055248619,0,empty,CD-0722-1
"B2,G9",6699,7579,5028,2551,3635,1804,0,1808,1141,667,1.710644678,1067,2095,399,148,148,0,58,0,0.027027027,0,empty,CD-0722-1
"B2,G10",8153,9008,6058,2950,4315,2146,0,2153,1432,721,1.986130374,1202,2325,679,239,239,0,84,0,0.108786611,0,empty,CD-0722-1
"B2,G11",8274,8983,6214,2769,4398,2099,0,2103,1361,742,1.834231806,1187,1171,197,80,79,1,33,1,0.240506329,0,empty,CD-0722-1
"B2,G12",6664,7781,4865,2916,3578,1831,0,1832,1145,687,1.666666667,1112,1868,529,190,188,2,42,2,0.058510638,0,empty,CD-0722-1
"B2,H1",1113550,1239184,839603,399581,569898,291622,3,291917,237329,54588,4.347640507,168453,92419,11431,3628,3540,88,733,6,0.072881356,0,hg38,CD-0722-1
"B2,H2",7768,8781,5775,3006,4060,2051,0,2051,1318,733,1.798090041,1182,2389,523,176,175,1,59,1,0.068571429,0,empty,CD-0722-1
"B2,H3",6677,7205,4955,2250,3421,1696,0,1699,1141,558,2.044802867,927,1521,253,84,81,3,34,2,0.074074074,0,empty,CD-0722-1
"B2,H4",9496,10471,7061,3410,5014,2500,0,2502,1612,890,1.811235955,1485,121,36,29,29,0,17,0,0,0,empty,CD-0722-1
"B2,H5",10765,11716,8001,3715,5354,2602,0,2606,1666,940,1.772340426,1458,2727,538,163,163,0,46,0,0.030674847,0,empty,CD-0722-1
"B2,H6",6122,6822,4437,2385,3290,1737,0,1737,1173,564,2.079787234,1052,1731,449,125,120,5,43,1,0.083333333,0,empty,CD-0722-1
"B2,H7",7477,7964,5531,2433,3886,1860,1,1865,1246,619,2.012924071,1086,1564,391,152,147,5,37,2,0.034013605,0,empty,CD-0722-1
"B2,H8",7859,8806,5795,3011,4139,2088,0,2090,1337,753,1.775564409,1214,2010,476,136,134,2,31,2,0.171641791,0,empty,CD-0722-1
"B2,H9",6550,7161,4974,2187,3302,1577,0,1580,1059,521,2.032629559,875,902,255,82,81,1,21,1,0.074074074,0,empty,CD-0722-1
"B2,H10",5724,6469,4243,2226,3094,1618,0,1622,1053,569,1.850615114,950,1143,292,104,102,2,23,2,0,0,empty,CD-0722-1
"B2,H11",6993,8023,4861,3162,3742,2259,0,2269,1188,1081,1.098982424,1341,59,3,2,2,0,2,0,0,0,empty,CD-0722-1
"B2,H12",6333,6931,4507,2424,3304,1716,0,1717,1130,587,1.925042589,1009,1432,275,95,93,2,31,1,0.086021505,0,empty,CD-0722-1
"B3,A1",712996,833402,534789,298613,390626,210006,4,210264,163963,46301,3.54124101,124611,107138,14245,4698,4566,132,865,5,0.054752519,0,hg38,CD-0722-1
"B3,A2",12689,13887,9227,4660,6670,3393,0,3403,2148,1255,1.711553785,1973,2172,518,175,173,2,67,2,0.040462428,0,empty,CD-0722-1
"B3,A3",6934,7346,5183,2163,3584,1791,0,1791,1134,657,1.726027397,961,1359,267,84,81,3,29,1,0.086419753,0,empty,CD-0722-1
"B3,A4",12366,13575,9467,4108,6400,3136,0,3139,2113,1026,2.059454191,1680,1215,295,107,107,0,37,0,0.018691589,0,empty,CD-0722-1
"B3,A5",618497,717312,455627,261685,333826,182755,2,182896,148494,34402,4.316435091,108431,137697,19598,6377,6226,151,1180,6,0.042402827,0,hg38,CD-0722-1
"B3,A6",9813,11229,7219,4010,5453,2905,0,2907,1897,1010,1.878217822,1698,3051,656,260,257,3,89,1,0.035019455,0,empty,CD-0722-1
"B3,A7",8299,9237,6231,3006,4486,2318,0,2321,1499,822,1.823600973,1310,1713,342,128,127,1,62,1,0.078740157,0,empty,CD-0722-1
"B3,A8",921037,1128580,664928,463652,527536,315959,0,316276,262672,53604,4.900231326,195985,136408,18796,5885,5741,144,1212,6,0.030830866,0,hg38,CD-0722-1
"B3,A9",8810,9692,6690,3002,4664,2287,0,2290,1546,744,2.077956989,1269,1728,429,161,157,4,56,2,0.140127389,0,empty,CD-0722-1
"B3,A10",10140,11078,7630,3448,5234,2532,0,2538,1630,908,1.795154185,1433,504,48,24,24,0,15,0,0,0,empty,CD-0722-1
"B3,A11",493409,537973,391427,146546,251543,112019,3,112157,84241,27916,3.017660123,60889,27701,5072,1581,1548,33,350,2,0.014857881,0,hg38,CD-0722-1
"B3,A12",10469,11340,7994,3346,5348,2531,0,2535,1683,852,1.975352113,1428,3592,773,290,285,5,81,2,0.045614035,0,empty,CD-0722-1
"B3,B1",8341,9408,6271,3137,4412,2241,0,2242,1459,783,1.863346105,1248,996,281,121,118,3,53,2,0.025423729,0,empty,CD-0722-1
"B3,B2",8792,9318,5978,3340,4650,2522,0,2525,1604,921,1.741585233,1478,840,158,70,70,0,20,0,0.014285714,0,empty,CD-0722-1
"B3,B3",7850,9325,5636,3689,4386,2282,2,2291,1537,754,2.038461538,1411,1700,455,152,151,1,45,1,0.079470199,0,empty,CD-0722-1
"B3,B4",1595744,1892547,1167215,725332,866727,500554,4,501037,425742,75295,5.654319676,303346,251990,32671,10745,10438,307,1699,7,0.097528262,0,hg38,CD-0722-1
"B3,B5",8227,4431,2710,1721,2854,1508,0,1522,989,533,1.855534709,970,1150,346,99,99,0,32,0,0.080808081,0,empty,CD-0722-1
"B3,B6",9516,10726,6948,3778,5251,2807,0,2811,1798,1013,1.774925962,1670,2021,515,181,179,2,52,2,0.011173184,0,empty,CD-0722-1
"B3,B7",8331,9083,6178,2905,4394,2154,0,2160,1440,720,2,1261,1410,322,110,110,0,29,0,0.109090909,0,empty,CD-0722-1
"B3,B8",6652,7283,5007,2276,3489,1659,0,1664,1073,591,1.815566836,908,1492,345,141,136,5,49,2,0.058823529,0,empty,CD-0722-1
"B3,B9",12096,13539,8916,4623,6427,3385,0,3392,2178,1214,1.794069193,2012,1133,244,64,62,2,27,2,0.016129032,0,empty,CD-0722-1
"B3,B10",6567,6857,4535,2322,3546,1785,0,1795,1186,609,1.947454844,1058,512,102,38,38,0,17,0,0,0,empty,CD-0722-1
"B3,B11",12924,14179,9514,4665,6610,3477,0,3481,2034,1447,1.405666897,1951,231,36,19,19,0,11,0,0,0,empty,CD-0722-1
"B3,B12",714344,813915,540438,273477,379434,193569,0,193764,153854,39910,3.855023804,111816,107188,20072,6463,6350,113,1065,3,0.057480315,0,hg38,CD-0722-1
"B3,C1",14640,15560,11154,4406,7379,3489,1,3495,2201,1294,1.700927357,1867,1035,205,91,91,0,26,0,0.098901099,0,empty,CD-0722-1
"B3,C2",581879,663071,436300,226771,310369,163415,3,163626,122593,41033,2.987668462,96768,39602,5369,1654,1612,42,422,5,0.034119107,0,hg38,CD-0722-1
"B3,C3",15086,16598,11313,5285,7968,3901,0,3906,2674,1232,2.170454545,2213,1125,156,46,43,3,31,2,0.209302326,0,empty,CD-0722-1
"B3,C4",8924,9868,6805,3063,4603,2154,0,2157,1378,779,1.768934531,1217,2100,542,174,170,4,59,1,0.070588235,0,empty,CD-0722-1
"B3,C5",12177,13584,9083,4501,6434,3140,0,3150,2012,1138,1.76801406,1792,2319,418,177,173,4,64,2,0.034682081,0,empty,CD-0722-1
"B3,C6",10498,11717,7816,3901,5708,2863,0,2865,1891,974,1.941478439,1679,2224,436,193,192,1,76,1,0.041666667,0,empty,CD-0722-1
"B3,C7",12999,14781,9433,5348,6969,3877,0,3879,2345,1534,1.528683181,2246,585,239,123,123,0,37,0,0.040650407,0,empty,CD-0722-1
"B3,C8",15269,16881,11383,5498,8091,4131,0,4135,2689,1446,1.859612725,2366,3750,792,243,241,2,89,1,0.070539419,0,empty,CD-0722-1
"B3,C9",10530,12210,7897,4313,5685,2848,0,2853,1788,1065,1.678873239,1707,2090,395,148,146,2,59,1,0.020547945,0,empty,CD-0722-1
"B3,C10",11587,12530,8906,3624,5908,2851,0,2858,1865,993,1.878147029,1577,2314,526,207,205,2,72,2,0.058536585,0,empty,CD-0722-1
"B3,C11",10434,11610,7706,3904,5529,2790,0,2790,1852,938,1.974413646,1596,2194,598,211,208,3,68,2,0.072115385,0,empty,CD-0722-1
"B3,C12",14400,15938,10871,5067,7621,3674,0,3680,2379,1301,1.82859339,2165,1844,406,185,181,4,56,1,0.049723757,0,empty,CD-0722-1
"B3,D1",12969,14825,9366,5459,7091,3894,0,3904,2448,1456,1.681318681,2312,964,205,87,86,1,31,1,0.11627907,0,empty,CD-0722-1
"B3,D2",10764,11904,8246,3658,5663,2724,0,2727,1694,1033,1.639883833,1475,3345,955,349,345,4,118,1,0.072463768,0,empty,CD-0722-1
"B3,D3",10175,10909,7504,3405,5368,2693,0,2697,1795,902,1.990022173,1484,1811,387,150,149,1,61,1,0.033557047,0,empty,CD-0722-1
"B3,D4",7314,8480,5523,2957,3908,1982,0,1984,1343,641,2.095163807,1174,1696,294,116,113,3,41,2,0.115044248,0,empty,CD-0722-1
"B3,D5",8911,10089,6697,3392,4941,2496,0,2501,1685,816,2.06495098,1474,1853,341,142,139,3,63,1,0.122302158,0,empty,CD-0722-1
"B3,D6",12737,14231,9167,5064,6615,3545,1,3548,2186,1362,1.604992658,2096,1649,438,138,136,2,44,2,0.029411765,0,empty,CD-0722-1
"B3,D7",7375,7957,5636,2321,3790,1808,0,1811,1220,591,2.0642978,990,2093,546,246,246,0,69,0,0.06504065,0,empty,CD-0722-1
"B3,D8",9587,10730,7082,3648,5180,2653,0,2654,1811,843,2.148279953,1562,1583,345,150,148,2,62,2,0.006756757,0,empty,CD-0722-1
"B3,D9",5196,5646,3902,1744,2818,1393,0,1393,947,446,2.123318386,791,2220,487,175,171,4,75,2,0.029239766,0,empty,CD-0722-1
"B3,D10",8317,9441,6215,3226,4316,2204,0,2207,1383,824,1.678398058,1260,1056,284,94,94,0,29,0,0.095744681,0,empty,CD-0722-1
"B3,D11",9999,10894,7564,3330,5273,2542,0,2544,1678,866,1.937644342,1406,3141,708,285,277,8,112,2,0.108303249,0,empty,CD-0722-1
"B3,D12",12068,13469,9084,4385,6362,3216,0,3223,2159,1064,2.029135338,1818,3650,944,328,326,2,104,2,0.064417178,0,empty,CD-0722-1
"B3,E1",771270,839824,596945,242879,385503,180392,8,180647,140483,40164,3.497734289,100445,53632,12495,3728,3671,57,710,2,0.031599019,0,hg38,CD-0722-1
"B3,E2",10937,12112,7978,4134,5852,2985,0,2988,1939,1049,1.848427073,1734,2238,377,150,148,2,65,1,0.013513514,0,empty,CD-0722-1
"B3,E3",575423,642779,448660,194119,298406,144929,2,145122,109523,35599,3.076575185,81067,76054,15289,4859,4748,111,895,6,0.026116259,0,hg38,CD-0722-1
"B3,E4",10304,11712,7573,4139,5602,2826,0,2828,1878,950,1.976842105,1634,2817,562,227,222,5,83,2,0.234234234,0,empty,CD-0722-1
"B3,E5",8780,9484,6770,2714,4511,2117,0,2118,1337,781,1.71190781,1157,1552,411,156,155,1,52,1,0.109677419,0,empty,CD-0722-1
"B3,E6",15304,17290,11447,5843,8019,4103,3,4122,2534,1588,1.595717884,2426,3593,796,307,306,1,87,1,0.049019608,0,empty,CD-0722-1
"B3,E7",14689,15879,10957,4922,7630,3671,0,3671,2355,1316,1.789513678,2034,3496,809,280,275,5,94,3,0.123636364,0,empty,CD-0722-1
"B3,E8",11409,12495,8723,3772,5802,2626,0,2626,1690,936,1.805555556,1405,3337,738,278,273,5,99,2,0.054945055,0,empty,CD-0722-1
"B3,E9",479772,598115,328336,269779,280137,189099,14,189271,140091,49180,2.84853599,117164,7061,1053,397,390,7,177,3,0.023076923,0,hg38,CD-0722-1
"B3,E10",8415,9384,6321,3063,4423,2130,0,2136,1400,736,1.902173913,1215,1918,602,204,202,2,71,2,0.079207921,0,empty,CD-0722-1
"B3,E11",10267,11352,7689,3663,5479,2713,0,2714,1739,975,1.783589744,1582,2527,716,216,214,2,68,2,0.098130841,0,empty,CD-0722-1
"B3,E12",11488,13007,8467,4540,6249,3120,0,3130,2021,1109,1.822362489,1827,2203,386,131,125,6,48,2,0.08,0,empty,CD-0722-1
"B3,F1",12644,13347,9406,3941,6399,3011,0,3020,1870,1150,1.626086957,1638,2723,677,235,234,1,74,1,0.141025641,0,empty,CD-0722-1
"B3,F2",1053365,1226848,789328,437520,559413,302098,1,302432,243138,59294,4.100549803,179382,327301,47305,15709,15412,297,2315,9,0.052945757,0,hg38,CD-0722-1
"B3,F3",10281,11145,7668,3477,5433,2664,0,2666,1769,897,1.97212932,1493,3433,826,261,260,1,85,1,0.042307692,0,empty,CD-0722-1
"B3,F4",14683,15948,10959,4989,7725,3718,3,3733,2413,1320,1.828030303,2090,824,242,86,86,0,27,0,0.197674419,0,empty,CD-0722-1
"B3,F5",11139,11764,8378,3386,5696,2621,0,2632,1666,966,1.724637681,1464,2399,402,145,144,1,63,1,0.013888889,0,empty,CD-0722-1
"B3,F6",12698,14421,9340,5081,6924,3657,0,3662,2404,1258,1.910969793,2150,3750,939,298,296,2,105,2,0.054054054,0,empty,CD-0722-1
"B3,F7",14347,15888,10647,5241,7609,3826,0,3834,2458,1376,1.786337209,2201,1555,369,150,149,1,56,1,0.006711409,0,empty,CD-0722-1
"B3,F8",9172,10282,6832,3450,4736,2278,0,2285,1486,799,1.859824781,1284,227,37,20,19,1,11,1,0.105263158,0,empty,CD-0722-1
"B3,F9",10342,11580,7757,3823,5419,2601,0,2606,1740,866,2.009237875,1488,3288,755,282,274,8,78,2,0.102189781,0,empty,CD-0722-1
"B3,F10",1167222,1341315,882335,458980,603052,321037,2,321464,262983,58481,4.496896428,184396,125123,26459,8171,8030,141,1423,6,0.064508095,0.007092199,hg38,CD-0722-1
"B3,F11",10558,11676,8054,3622,5429,2567,0,2570,1768,802,2.204488778,1414,1963,360,154,154,0,47,0,0.012987013,0,empty,CD-0722-1
"B3,F12",764653,853179,583615,269564,389740,194100,1,194314,154663,39651,3.900607803,111101,3406,735,163,163,0,44,0,0.012269939,0,hg38,CD-0722-1
"B3,G1",12874,14225,9571,4654,6842,3349,0,3349,2236,1113,2.008984726,1969,3129,808,275,273,2,113,1,0.051282051,0,empty,CD-0722-1
"B3,G2",7211,7732,5213,2519,3584,1810,0,1810,1176,634,1.85488959,1026,603,96,28,27,1,15,1,0,0,empty,CD-0722-1
"B3,G3",1725790,2122336,1265475,856861,958489,570814,5,571338,473072,98266,4.814198197,352451,366146,69364,22433,22061,372,2727,9,0.070622365,0,hg38,CD-0722-1
"B3,G4",931983,1065711,698864,366847,486851,257441,0,257707,208411,49296,4.227746673,150725,3375,596,179,174,5,51,2,0.017241379,0,hg38,CD-0722-1
"B3,G5",8168,9255,5997,3258,4369,2228,0,2231,1498,733,2.043656207,1288,2095,430,194,191,3,63,2,0.083769634,0,empty,CD-0722-1
"B3,G6",11677,12875,8528,4347,6119,3036,0,3042,1998,1044,1.913793103,1724,263,50,28,28,0,13,0,0,0,empty,CD-0722-1
"B3,G7",9968,10752,7580,3172,5107,2381,0,2382,1579,803,1.96637609,1288,3313,826,298,293,5,90,1,0.054607509,0,empty,CD-0722-1
"B3,G8",7008,7416,5126,2290,3647,1773,1,1777,1181,596,1.981543624,974,1877,330,134,129,5,57,2,0.085271318,0,empty,CD-0722-1
"B3,G9",8404,9338,6167,3171,4441,2276,0,2278,1496,782,1.913043478,1318,2149,423,172,163,9,71,2,0.006134969,0,empty,CD-0722-1
"B3,G10",11194,12461,8470,3991,5698,2840,0,2850,1845,1005,1.835820896,1557,2890,853,266,263,3,97,1,0.02661597,0,empty,CD-0722-1
"B3,G11",10594,11944,8078,3866,5660,2720,1,2726,1742,984,1.770325203,1533,1742,444,158,158,0,59,0,0.006329114,0,empty,CD-0722-1
"B3,G12",8681,9441,6382,3059,4532,2322,0,2326,1477,849,1.739693757,1327,2462,726,269,268,1,65,1,0.070895522,0,empty,CD-0722-1
"B3,H1",8805,9431,6501,2930,4489,2144,0,2146,1381,765,1.805228758,1201,1404,344,129,126,3,42,1,0.063492063,0,empty,CD-0722-1
"B3,H2",13534,15451,9933,5518,7405,3834,0,3846,2589,1257,2.059665871,2303,2756,714,236,234,2,65,2,0.051282051,0,empty,CD-0722-1
"B3,H3",8573,9935,6454,3481,4560,2269,0,2271,1489,782,1.904092072,1300,1562,314,105,104,1,39,1,0.163461538,0,empty,CD-0722-1
"B3,H4",12040,12994,8971,4023,6107,2978,0,2991,1941,1050,1.848571429,1672,237,58,24,24,0,16,0,0.125,0,empty,CD-0722-1
"B3,H5",12805,13802,9587,4215,6401,3144,0,3150,2059,1091,1.887259395,1741,2306,473,150,146,4,50,1,0.123287671,0,empty,CD-0722-1
"B3,H6",8021,9006,5904,3102,4217,2152,0,2152,1442,710,2.030985915,1265,2235,424,153,151,2,46,2,0.119205298,0,empty,CD-0722-1
"B3,H7",9884,10768,7254,3514,5070,2409,0,2411,1600,811,1.972872996,1376,2604,790,281,280,1,85,1,0.017857143,0,empty,CD-0722-1
"B3,H8",16551,18856,11849,7007,9028,5196,0,5202,3478,1724,2.017401392,3075,2320,441,191,191,0,57,0,0.109947644,0,empty,CD-0722-1
"B3,H9",1145375,1337537,852551,484986,605295,334500,2,334835,259349,75486,3.43572318,198252,72185,11647,3880,3817,63,755,3,0.089599162,0,hg38,CD-0722-1
"B3,H10",8207,9481,6227,3254,4314,2115,0,2116,1423,693,2.053391053,1226,1292,235,71,71,0,34,0,0.014084507,0,empty,CD-0722-1
"B3,H11",9649,11239,6843,4396,5424,3265,0,3268,1767,1501,1.17721519,1963,69,13,7,7,0,6,0,0,0,empty,CD-0722-1
"B3,H12",8771,9664,6376,3288,4557,2337,0,2339,1578,761,2.073587385,1342,2210,714,208,208,0,57,0,0.028846154,0,empty,CD-0722-1
"B4,A1",8811,9958,6518,3440,4768,2501,1,2512,1604,908,1.766519824,1450,1426,237,96,94,2,41,1,0.095744681,0,empty,CD-0722-1
"B4,A2",14207,15866,10663,5203,7444,3819,1,3823,2426,1397,1.736578382,2164,2651,735,235,228,7,99,2,0.052631579,0,empty,CD-0722-1
"B4,A3",7918,8671,5915,2756,4107,2017,6,2029,1292,737,1.753052917,1203,1463,286,98,96,2,32,1,0.0625,0,empty,CD-0722-1
"B4,A4",13232,14265,10150,4115,6652,3254,0,3258,2093,1165,1.796566524,1738,975,221,109,101,8,39,3,0.128712871,0,empty,CD-0722-1
"B4,A5",926124,1051286,705192,346094,479068,250537,5,250865,206420,44445,4.644391945,143177,300539,35631,11954,11619,335,1940,10,0.047594457,0,hg38,CD-0722-1
"B4,A6",542690,649790,405974,243816,299786,165923,1,166083,127192,38891,3.270473889,99967,145013,21721,7030,6881,149,1265,4,0.033570702,0,hg38,CD-0722-1
"B4,A7",8989,9897,6767,3130,4717,2348,0,2348,1472,876,1.680365297,1316,2043,360,165,161,4,76,2,0.049689441,0,empty,CD-0722-1
"B4,A8",5554,6483,4223,2260,3064,1489,1,1492,1025,467,2.194860814,856,2503,678,233,231,2,81,1,0.121212121,0,empty,CD-0722-1
"B4,A9",9706,10656,7140,3516,4992,2401,0,2401,1551,850,1.824705882,1390,2392,304,142,135,7,63,2,0.162962963,0,empty,CD-0722-1
"B4,A10",11140,12120,8528,3592,5660,2765,0,2766,1758,1008,1.744047619,1483,500,118,55,53,2,23,1,0.075471698,0,empty,CD-0722-1
"B4,A11",8895,10226,6688,3538,4825,2366,0,2370,1576,794,1.98488665,1410,2453,430,185,183,2,74,1,0.120218579,0,empty,CD-0722-1
"B4,A12",889718,1024365,669430,354935,459426,244400,5,244726,198360,46366,4.27813484,142158,288268,48784,15761,15476,285,2317,7,0.027332644,0,hg38,CD-0722-1
"B4,B1",9605,10649,7143,3506,4985,2483,0,2485,1543,942,1.638004246,1442,1443,393,121,118,3,48,2,0.144067797,0,empty,CD-0722-1
"B4,B2",9821,10706,6864,3842,5191,2766,0,2768,1698,1070,1.586915888,1657,661,151,45,45,0,25,0,0.155555556,0,empty,CD-0722-1
"B4,B3",2356738,2856682,1737382,1119300,1271231,745251,5,746048,599003,147045,4.073603319,454601,297030,44430,14876,14604,272,2223,7,0.060805259,0,hg38,CD-0722-1
"B4,B4",10201,11594,7388,4206,5408,2894,0,2895,1884,1011,1.863501484,1715,2145,527,172,169,3,62,1,0.071005917,0,empty,CD-0722-1
"B4,B5",9651,5646,3392,2254,3503,1888,0,1900,1259,641,1.964118565,1216,1119,287,91,91,0,26,0,0,0,empty,CD-0722-1
"B4,B6",10890,12449,7852,4597,5695,3017,0,3023,1891,1132,1.6704947,1775,1919,462,156,155,1,48,1,0,0,empty,CD-0722-1
"B4,B7",9673,10612,7345,3267,4929,2335,0,2340,1547,793,1.950819672,1314,1655,346,122,120,2,50,1,0.033333333,0,empty,CD-0722-1
"B4,B8",7674,8532,5805,2727,4095,1989,0,1991,1324,667,1.985007496,1138,1627,334,153,150,3,58,2,0.02,0,empty,CD-0722-1
"B4,B9",13155,14836,9790,5046,6917,3622,1,3625,2300,1325,1.735849057,2083,1117,302,140,140,0,47,0,0.114285714,0,empty,CD-0722-1
"B4,B10",9732,10499,6492,4007,5188,2916,0,2933,1978,955,2.071204188,1783,610,193,67,67,0,22,0,0.029850746,0,empty,CD-0722-1
"B4,B11",15816,17940,11531,6409,8212,4576,0,4581,2684,1897,1.414865577,2635,228,36,20,19,1,11,1,0,0,empty,CD-0722-1
"B4,B12",8770,9892,6618,3274,4701,2331,0,2331,1534,797,1.924717691,1364,1795,518,218,218,0,78,0,0.050458716,0,empty,CD-0722-1
"B4,C1",16494,17473,12483,4990,8105,3844,0,3854,2437,1417,1.719830628,2086,958,221,81,79,2,43,1,0.025316456,0,empty,CD-0722-1
"B4,C2",13530,15223,9956,5267,6924,3540,0,3547,2299,1248,1.842147436,2060,3066,943,259,251,8,64,2,0.071713147,0,empty,CD-0722-1
"B4,C3",14538,16127,10830,5297,7740,3911,1,3915,2494,1421,1.755102041,2213,1017,258,90,90,0,40,0,0.033333333,0,empty,CD-0722-1
"B4,C4",9541,10353,7257,3096,4912,2321,0,2327,1561,766,2.037859008,1294,2202,459,152,151,1,74,1,0.013245033,0,empty,CD-0722-1
"B4,C5",15713,17748,11836,5912,8455,4273,0,4286,2902,1384,2.096820809,2499,2832,784,280,269,11,93,3,0.104089219,0,empty,CD-0722-1
"B4,C6",11969,13468,8696,4772,6349,3221,0,3226,2121,1105,1.919457014,1903,2710,746,258,255,3,97,2,0.070588235,0,empty,CD-0722-1
"B4,C7",1575441,1904967,1115852,789115,868383,560670,3,561173,434658,126515,3.435624234,340527,4915,308,142,140,2,59,2,0.085714286,0,hg38,CD-0722-1
"B4,C8",16798,18241,12719,5522,8673,4289,0,4300,2873,1427,2.013314646,2389,3783,807,324,319,5,109,2,0.037617555,0,empty,CD-0722-1
"B4,C9",11803,13247,8879,4368,6259,3107,3,3113,1965,1148,1.711672474,1806,2279,519,182,177,5,66,3,0.141242938,0,empty,CD-0722-1
"B4,C10",712405,781125,555967,225158,355157,162395,2,162626,123980,38646,3.208093981,90060,208625,16886,5918,5654,264,1112,11,0.082065794,0,hg38,CD-0722-1
"B4,C11",11324,12561,8531,4030,5835,2880,0,2887,1861,1026,1.813840156,1683,2274,468,176,172,4,64,2,0.040697674,0,empty,CD-0722-1
"B4,C12",16687,18362,12464,5898,8570,4159,0,4168,2719,1449,1.876466529,2414,2366,487,199,194,5,64,2,0.010309278,0,empty,CD-0722-1
"B4,D1",13896,15509,10230,5279,7348,3835,1,3843,2368,1475,1.605423729,2221,1073,229,101,101,0,38,0,0,0,empty,CD-0722-1
"B4,D2",1894066,2263095,1391200,871895,1023151,627593,3,628204,464605,163599,2.839901222,372882,205771,69754,20830,20696,134,2470,4,0.039234635,0,hg38,CD-0722-1
"B4,D3",2128416,2476421,1561174,915247,1120565,647151,9,647892,488851,159041,3.073741991,386354,250975,37919,12086,11823,263,1943,10,0.049818151,0,hg38,CD-0722-1
"B4,D4",8121,9276,6109,3167,4282,2139,0,2144,1444,700,2.062857143,1271,2023,372,125,125,0,48,0,0.024,0,empty,CD-0722-1
"B4,D5",9503,10828,7048,3780,5239,2689,0,2696,1714,982,1.745417515,1559,1809,352,172,166,6,84,2,0.114457831,0,empty,CD-0722-1
"B4,D6",13527,15154,9779,5375,7044,3798,0,3804,2285,1519,1.504279131,2230,2248,501,192,185,7,59,2,0.027027027,0,empty,CD-0722-1
"B4,D7",718537,877192,511582,365610,405399,248588,4,248848,197527,51321,3.848853296,152640,33325,11277,3312,3296,16,739,3,0.024878641,0,hg38,CD-0722-1
"B4,D8",9976,10886,7376,3510,5104,2518,0,2526,1686,840,2.007142857,1458,2246,511,131,131,0,64,0,0.015267176,0,empty,CD-0722-1
"B4,D9",573072,658560,426884,231676,304125,163196,3,163369,127019,36350,3.494332875,95898,100483,15760,4969,4863,106,921,6,0.053464939,0,hg38,CD-0722-1
"B4,D10",9334,10408,6782,3626,4814,2462,0,2462,1611,851,1.89306698,1434,859,211,84,83,1,24,1,0.13253012,0,empty,CD-0722-1
"B4,D11",11225,12350,8550,3800,5844,2918,0,2923,1910,1013,1.885488648,1547,3422,904,363,360,3,135,2,0.027777778,0,empty,CD-0722-1
"B4,D12",890841,1098949,626643,472306,504167,330118,2,330399,239982,90417,2.654169017,201893,20769,3074,1055,1024,31,263,2,0.299804688,0,hg38,CD-0722-1
"B4,E1",17309,19262,12766,6496,8918,4472,1,4480,2869,1611,1.78088144,2548,3134,624,240,235,5,102,3,0.046808511,0,empty,CD-0722-1
"B4,E2",12053,13325,8754,4571,6160,3052,0,3066,1936,1130,1.713274336,1779,2689,631,214,213,1,69,1,0.046948357,0,empty,CD-0722-1
"B4,E3",8336,9328,6286,3042,4373,2134,0,2134,1486,648,2.293209877,1205,2829,702,262,261,1,92,1,0.038314176,0,empty,CD-0722-1
"B4,E4",11506,12497,8684,3813,5964,2914,0,2917,1914,1003,1.908275174,1658,3581,823,301,301,0,119,0,0.086378738,0,empty,CD-0722-1
"B4,E5",11204,12073,8575,3498,5601,2616,0,2622,1714,908,1.887665198,1397,1883,534,181,178,3,67,2,0.016853933,0,empty,CD-0722-1
"B4,E6",1321377,1556786,978639,578147,707925,413444,4,413861,330857,83004,3.986036818,242746,30724,4313,1216,1203,13,388,3,0.068162926,0,hg38,CD-0722-1
"B4,E7",17040,18454,12893,5561,8613,4107,0,4117,2746,1371,2.002917578,2280,3162,752,281,279,2,96,1,0.043010753,0,empty,CD-0722-1
"B4,E8",12438,12991,9514,3477,6074,2749,0,2753,1866,887,2.103720406,1429,3849,772,246,242,4,92,3,0.024793388,0,empty,CD-0722-1
"B4,E9",8976,9824,6675,3149,4565,2240,1,2247,1554,693,2.242424242,1321,3236,602,221,219,2,92,1,0.01369863,0,empty,CD-0722-1
"B4,E10",9211,10311,7128,3183,4816,2317,0,2324,1515,809,1.872682324,1316,2190,564,187,186,1,64,1,0.091397849,0,empty,CD-0722-1
"B4,E11",11047,12416,8269,4147,5918,3063,0,3065,1991,1074,1.853817505,1763,2902,674,263,262,1,83,1,0.118320611,0,empty,CD-0722-1
"B4,E12",13408,15240,9922,5318,7124,3589,1,3599,2359,1240,1.902419355,2166,2428,485,200,194,6,86,2,0.020618557,0,empty,CD-0722-1
"B4,F1",13754,14794,10077,4717,6982,3416,4,3421,2210,1211,1.824938068,1928,2265,592,231,231,0,74,0,0.043290043,0,empty,CD-0722-1
"B4,F2",11585,12575,8665,3910,5983,2920,0,2924,1962,962,2.03950104,1665,3567,754,302,296,6,105,2,0.14527027,0,empty,CD-0722-1
"B4,F3",11542,12404,8759,3645,5893,2829,1,2832,1867,965,1.934715026,1545,3376,682,211,211,0,86,0,0.023696682,0,empty,CD-0722-1
"B4,F4",17562,18412,12638,5774,8581,4083,4,4105,2646,1459,1.813570939,2310,880,252,109,109,0,41,0,0.027522936,0,empty,CD-0722-1
"B4,F5",12812,13894,9856,4038,6427,2940,0,2947,1937,1010,1.917821782,1643,2288,691,245,239,6,86,1,0.184100418,0,empty,CD-0722-1
"B4,F6",1712782,1855547,1332500,523047,826273,395980,4,396500,337627,58873,5.734836003,213217,24792,9032,2606,2597,9,885,4,0.018482865,0,hg38,CD-0722-1
"B4,F7",15783,17613,11772,5841,8379,4236,0,4244,2769,1475,1.877288136,2449,1763,439,147,145,2,52,1,0.027586207,0,empty,CD-0722-1
"B4,F8",9862,10846,7486,3360,5112,2537,0,2541,1747,794,2.200251889,1396,236,51,29,29,0,20,0,0.034482759,0,empty,CD-0722-1
"B4,F9",11468,12638,8750,3888,5859,2719,0,2721,1783,938,1.900852878,1505,3560,1129,417,416,1,98,1,0.139423077,0,empty,CD-0722-1
"B4,F10",954226,1060086,741309,318777,480189,229979,4,230288,180467,49821,3.622307862,127556,119123,23380,7431,7330,101,1281,4,0.037244202,0,hg38,CD-0722-1
"B4,F11",11803,12815,9054,3761,5984,2718,0,2724,1829,895,2.043575419,1483,2251,495,169,169,0,54,0,0.165680473,0,empty,CD-0722-1
"B4,F12",924743,1059757,688153,371604,475375,255440,2,255762,204752,51010,4.013958047,150463,19235,2748,943,914,29,195,3,0.078774617,0,hg38,CD-0722-1
"B4,G1",948771,1155674,675836,479838,532063,336533,4,336868,271467,65401,4.150808092,202388,98287,55567,17458,17426,32,2155,4,0.017215655,0,hg38,CD-0722-1
"B4,G2",7595,8185,5380,2805,3832,1942,0,1944,1218,726,1.67768595,1149,568,98,39,38,1,15,1,0.026315789,0,empty,CD-0722-1
"B4,G3",14988,16739,11156,5583,7876,4015,0,4024,2449,1575,1.554920635,2264,3306,1013,340,338,2,103,1,0.174556213,0,empty,CD-0722-1
"B4,G4",25605,28660,18464,10196,13692,7492,0,7502,4552,2950,1.543050847,4359,258,26,19,19,0,15,0,0,0,empty,CD-0722-1
"B4,G5",9239,10202,6773,3429,4866,2391,0,2394,1579,815,1.937423313,1430,2396,790,267,267,0,87,0,0.131086142,0,empty,CD-0722-1
"B4,G6",12654,13998,9440,4558,6408,3129,0,3134,2121,1013,2.093780849,1789,164,51,25,25,0,8,0,0.04,0,empty,CD-0722-1
"B4,G7",10960,11759,8371,3388,5594,2630,1,2631,1713,918,1.866013072,1384,3582,996,303,301,2,107,2,0.049833887,0,empty,CD-0722-1
"B4,G8",8041,8574,5914,2660,4034,1962,0,1964,1285,679,1.892488954,1091,2200,499,226,226,0,74,0,0.026548673,0,empty,CD-0722-1
"B4,G9",9296,10381,7038,3343,4808,2316,0,2318,1489,829,1.796139928,1323,2840,569,241,240,1,93,1,0.029166667,0,empty,CD-0722-1
"B4,G10",12309,13882,9138,4744,6639,3434,0,3444,2197,1247,1.761828388,2041,3757,1181,408,407,1,133,1,0.105651106,0,empty,CD-0722-1
"B4,G11",11396,12107,8754,3353,5921,2716,0,2720,1796,924,1.943722944,1456,1931,470,180,179,1,72,1,0.055865922,0,empty,CD-0722-1
"B4,G12",8878,9848,6611,3237,4640,2286,0,2289,1456,833,1.74789916,1343,2795,724,214,210,4,76,2,0.161904762,0,empty,CD-0722-1
"B4,H1",10320,11116,7766,3350,5156,2475,1,2476,1595,881,1.810442679,1349,1685,542,122,122,0,42,0,0.114754098,0,empty,CD-0722-1
"B4,H2",1088476,1297086,794040,503046,589372,337593,4,337915,270676,67239,4.025580392,206137,245465,50705,16556,16317,239,2219,5,0.037506895,0,hg38,CD-0722-1
"B4,H3",9470,10413,6917,3496,4857,2429,0,2433,1625,808,2.011138614,1382,2033,439,170,170,0,68,0,0.047058824,0,empty,CD-0722-1
"B4,H4",13746,14724,10450,4274,6879,3307,0,3314,2145,1169,1.834901625,1783,289,12,10,10,0,8,0,0.1,0,empty,CD-0722-1
"B4,H5",14202,15571,10565,5006,7015,3507,0,3512,2159,1353,1.59571323,2002,2158,476,159,152,7,56,2,0.072368421,0,empty,CD-0722-1
"B4,H6",8684,9708,6345,3363,4527,2344,0,2349,1515,834,1.816546763,1324,2855,902,272,271,1,81,1,0.073800738,0,empty,CD-0722-1
"B4,H7",12070,13061,8867,4194,6311,3158,0,3163,2133,1030,2.070873786,1834,2556,503,202,198,4,66,2,0.141414141,0,empty,CD-0722-1
"B4,H8",11176,12313,8306,4007,5813,2959,0,2976,1893,1083,1.747922438,1700,2263,602,222,215,7,68,1,0.055813953,0,empty,CD-0722-1
"B4,H9",9937,10937,7586,3351,5037,2382,0,2386,1665,721,2.309292649,1338,1150,193,78,77,1,32,1,0.103896104,0,empty,CD-0722-1
"B4,H10",7560,8539,5636,2903,4125,2057,0,2062,1318,744,1.771505376,1215,1716,349,128,128,0,42,0,0.203125,0,empty,CD-0722-1
"B4,H11",10711,12429,7427,5002,5950,3564,0,3566,1923,1643,1.170419963,2162,122,13,10,10,0,9,0,0.1,0,empty,CD-0722-1
"B4,H12",9643,10597,7072,3525,5001,2569,0,2574,1745,829,2.104945718,1490,2218,609,165,163,2,58,1,0.079754601,0,empty,CD-0722-1
"B5,A1",6714,7415,4919,2496,3477,1813,0,1815,1164,651,1.788018433,1001,1894,474,151,149,2,41,1,0.033557047,0,empty,CD-0722-1
"B5,A2",622664,712796,473184,239612,327352,171282,4,171465,137674,33791,4.074280134,98526,136203,20799,7470,7330,140,1304,5,0.075306958,0,hg38,CD-0722-1
"B5,A3",5878,6465,4310,2155,3050,1542,0,1542,1004,538,1.866171004,903,1174,353,124,122,2,35,1,0.098360656,0,empty,CD-0722-1
"B5,A4",11123,12470,8217,4253,5791,2940,0,2947,1834,1113,1.647798742,1684,966,108,48,38,10,22,3,0,0,empty,CD-0722-1
"B5,A5",8931,9683,6794,2889,4561,2195,0,2198,1395,803,1.737235367,1198,3050,852,270,267,3,77,1,0.059925094,0,empty,CD-0722-1
"B5,A6",8973,10294,6656,3638,4962,2541,0,2542,1744,798,2.185463659,1466,2975,663,246,235,11,80,2,0.042553191,0,empty,CD-0722-1
"B5,A7",6709,7292,5039,2253,3407,1774,0,1774,1178,596,1.976510067,933,1746,343,149,147,2,66,2,0.156462585,0,empty,CD-0722-1
"B5,A8",4152,4971,3088,1883,2274,1177,0,1180,748,432,1.731481481,720,2049,371,123,123,0,60,0,0.105691057,0,empty,CD-0722-1
"B5,A9",6709,7614,5090,2524,3506,1729,0,1737,1119,618,1.810679612,979,2216,530,194,193,1,61,1,0.093264249,0,empty,CD-0722-1
"B5,A10",7175,8080,5398,2682,3849,1918,0,1923,1187,736,1.612771739,1168,480,58,28,24,4,14,1,0.083333333,0,empty,CD-0722-1
"B5,A11",6462,6895,4933,1962,3367,1610,0,1612,1095,517,2.117988395,861,1612,239,94,90,4,51,2,0.1,0,empty,CD-0722-1
"B5,A12",8030,8664,6185,2479,4088,1952,0,1958,1273,685,1.858394161,1092,4726,837,314,304,10,86,2,0.052631579,0,empty,CD-0722-1
"B5,B1",7093,7874,5242,2632,3636,1849,0,1851,1157,694,1.667146974,1079,1137,344,129,128,1,38,1,0.015625,0,empty,CD-0722-1
"B5,B2",852735,965978,549735,416243,453289,274959,3,275182,210023,65159,3.22323854,171343,22633,5762,1919,1898,21,383,2,0.069020021,0,hg38,CD-0722-1
"B5,B3",5679,6158,4317,1841,2928,1458,0,1461,950,511,1.859099804,797,1178,192,70,70,0,26,0,0.171428571,0,empty,CD-0722-1
"B5,B4",6361,6846,4745,2101,3347,1669,0,1669,1058,611,1.731587561,875,1296,291,127,127,0,54,0,0.078740157,0,empty,CD-0722-1
"B5,B5",6701,3544,2141,1403,2363,1266,1,1279,829,450,1.842222222,861,969,212,76,76,0,25,0,0.184210526,0,empty,CD-0722-1
"B5,B6",7133,7886,5192,2694,3805,1969,0,1979,1248,731,1.707250342,1106,1730,315,112,111,1,46,1,0.09009009,0,empty,CD-0722-1
"B5,B7",7377,8146,5736,2410,3846,1858,0,1859,1188,671,1.770491803,1023,1290,294,90,87,3,31,1,0.057471264,0,empty,CD-0722-1
"B5,B8",568974,651065,428913,222152,300244,158178,1,158348,122090,36258,3.367256881,90920,82412,11323,3840,3756,84,768,4,0.070553781,0,hg38,CD-0722-1
"B5,B9",8938,9814,6579,3235,4675,2389,0,2389,1471,918,1.602396514,1363,1604,273,77,75,2,33,1,0.013333333,0,empty,CD-0722-1
"B5,B10",4983,5029,3634,1395,2497,1145,1,1151,776,375,2.069333333,600,613,84,41,41,0,17,0,0.317073171,0,empty,CD-0722-1
"B5,B11",10230,11319,7515,3804,5326,2821,0,2825,1646,1179,1.396098388,1622,266,115,26,25,1,10,1,0,0,empty,CD-0722-1
"B5,B12",6072,6696,4549,2147,3184,1566,0,1568,1023,545,1.87706422,870,1802,399,113,112,1,32,1,0.053571429,0,empty,CD-0722-1
"B5,C1",12440,13297,9400,3897,6405,3119,0,3121,2077,1044,1.989463602,1700,1047,241,87,87,0,39,0,0.057471264,0,empty,CD-0722-1
"B5,C2",10364,11324,7680,3644,5352,2706,0,2708,1721,987,1.74366768,1508,2133,493,188,187,1,58,1,0.139037433,0,empty,CD-0722-1
"B5,C3",12046,13250,9025,4225,6395,3152,0,3161,2130,1031,2.065955383,1823,1109,325,104,104,0,34,0,0.182692308,0,empty,CD-0722-1
"B5,C4",7016,7629,5288,2341,3462,1617,0,1619,1055,564,1.870567376,910,2235,428,147,144,3,55,2,0,0,empty,CD-0722-1
"B5,C5",10736,11912,8026,3886,5671,2804,0,2808,1918,890,2.15505618,1593,1998,406,183,179,4,64,2,0.055865922,0,empty,CD-0722-1
"B5,C6",1510548,1786002,1105180,680822,830357,472643,1,473171,368765,104406,3.532028811,285984,225501,41538,13617,13406,211,2019,7,0.047963598,0,hg38,CD-0722-1
"B5,C7",13210,15315,9476,5839,7231,4156,0,4163,2540,1623,1.565003081,2444,553,118,46,46,0,18,0,0.043478261,0,empty,CD-0722-1
"B5,C8",12459,13608,9298,4310,6427,3222,0,3229,2132,1097,1.943482224,1808,3655,945,346,344,2,98,1,0.081395349,0,empty,CD-0722-1
"B5,C9",8155,9103,6181,2922,4230,2141,0,2145,1395,750,1.86,1205,1986,334,131,126,5,45,1,0.03968254,0,empty,CD-0722-1
"B5,C10",9854,10867,7533,3334,4958,2332,1,2338,1493,845,1.766863905,1297,2356,489,182,178,4,59,1,0.078651685,0,empty,CD-0722-1
"B5,C11",8549,9251,6341,2910,4384,2149,0,2150,1392,758,1.836411609,1189,2412,607,196,195,1,67,1,0.143589744,0,empty,CD-0722-1
"B5,C12",11879,12891,8914,3977,6126,2935,0,2936,1975,961,2.055150884,1641,2103,515,194,191,3,62,1,0.172774869,0,empty,CD-0722-1
"B5,D1",10625,12026,7865,4161,5637,2940,2,2950,1858,1092,1.701465201,1729,792,109,51,47,4,24,1,0.063829787,0,empty,CD-0722-1
"B5,D2",9198,9873,7097,2776,4678,2102,0,2110,1331,779,1.70860077,1129,2762,756,267,265,2,90,1,0.083018868,0,empty,CD-0722-1
"B5,D3",1036674,1156302,792682,363620,538528,269003,4,269277,213417,55860,3.82056928,152893,50762,7262,2325,2265,60,551,3,0.025165563,0,hg38,CD-0722-1
"B5,D4",5955,6738,4526,2212,3232,1639,0,1640,1073,567,1.892416226,906,1409,328,105,105,0,39,0,0.085714286,0,empty,CD-0722-1
"B5,D5",577901,712934,400309,312625,332191,221042,2,221226,160520,60706,2.644219682,135223,3396,671,168,163,5,73,2,0.012269939,0,hg38,CD-0722-1
"B5,D6",9986,11153,7277,3876,5303,2811,0,2814,1632,1182,1.38071066,1668,1669,453,159,159,0,62,0,0.100628931,0,empty,CD-0722-1
"B5,D7",5773,6257,4305,1952,3041,1430,0,1432,926,506,1.830039526,807,2525,626,199,193,6,53,2,0.10880829,0,empty,CD-0722-1
"B5,D8",7617,8562,5544,3018,4172,2166,0,2170,1426,744,1.916666667,1270,1587,294,119,119,0,50,0,0.016806723,0,empty,CD-0722-1
"B5,D9",3961,4420,2943,1477,2176,1064,0,1066,701,365,1.920547945,646,2133,562,181,176,5,51,2,0.005681818,0,empty,CD-0722-1
"B5,D10",7142,7642,5248,2394,3542,1715,0,1717,1113,604,1.842715232,940,1124,270,85,83,2,24,1,0.048192771,0,empty,CD-0722-1
"B5,D11",8344,8803,6260,2543,4294,2066,0,2071,1340,731,1.833105335,1129,3180,850,322,319,3,97,2,0.037617555,0,empty,CD-0722-1
"B5,D12",10562,11698,8072,3626,5603,2790,0,2790,1775,1015,1.748768473,1598,3820,839,344,333,11,99,2,0.093093093,0,empty,CD-0722-1
"B5,E1",12147,13209,9011,4198,6232,3116,0,3118,1886,1232,1.530844156,1739,3474,516,248,240,8,99,2,0.145833333,0,empty,CD-0722-1
"B5,E2",9201,9955,6834,3121,4742,2383,1,2387,1540,847,1.818181818,1337,2074,311,137,135,2,57,2,0.192592593,0,empty,CD-0722-1
"B5,E3",6252,7018,4720,2298,3334,1621,0,1625,1039,586,1.773037543,919,2430,511,220,219,1,64,1,0.095890411,0,empty,CD-0722-1
"B5,E4",8607,9296,6457,2839,4460,2161,0,2167,1352,815,1.658895706,1209,2305,495,213,212,1,76,1,0.099056604,0,empty,CD-0722-1
"B5,E5",7899,8546,6033,2513,4005,1831,1,1832,1207,625,1.9312,1002,1655,398,135,129,6,50,2,0.03875969,0,empty,CD-0722-1
"B5,E6",12534,14125,9318,4807,6577,3294,0,3297,2112,1185,1.782278481,1903,3353,718,236,228,8,67,2,0.065789474,0,empty,CD-0722-1
"B5,E7",11547,12736,8644,4092,5964,2921,1,2924,1892,1032,1.833333333,1617,3149,731,258,256,2,84,2,0.03515625,0,empty,CD-0722-1
"B5,E8",9781,10874,7464,3410,5071,2397,1,2398,1575,823,1.913730255,1304,3182,818,269,267,2,71,2,0.08988764,0,empty,CD-0722-1
"B5,E9",542262,618148,412255,205893,287161,148491,2,148620,119760,28860,4.14968815,85198,68185,12678,4195,4135,60,827,4,0.028053204,0,hg38,CD-0722-1
"B5,E10",7413,8021,5637,2384,3897,1850,0,1852,1270,582,2.182130584,1030,2065,482,145,142,3,53,2,0.056338028,0,empty,CD-0722-1
"B5,E11",8174,8926,6234,2692,4281,2113,0,2119,1332,787,1.692503177,1142,2713,608,215,211,4,66,1,0.033175355,0,empty,CD-0722-1
"B5,E12",2110631,2556753,1521568,1035185,1166632,698822,3,699478,569128,130350,4.366152666,433177,166567,24889,8167,7993,174,1450,6,0.083322908,0,hg38,CD-0722-1
"B5,F1",640684,699547,496371,203176,324043,154460,2,154662,117951,36711,3.212960693,85999,28504,5651,1837,1811,26,421,4,0.041965765,0,hg38,CD-0722-1
"B5,F2",600903,688910,447132,241778,320127,168757,0,168949,130170,38779,3.356713685,99962,224265,28043,9598,9361,237,1595,7,0.067941459,0,hg38,CD-0722-1
"B5,F3",8210,9177,6063,3114,4311,2044,2,2050,1337,713,1.875175316,1193,2924,717,270,265,5,89,2,0.098113208,0,empty,CD-0722-1
"B5,F4",965328,1126214,713121,413093,515870,284713,10,285060,228856,56204,4.071881005,169168,57836,8540,2824,2759,65,624,5,0.059079377,0,hg38,CD-0722-1
"B5,F5",9652,10412,7401,3011,4907,2247,7,2263,1456,807,1.804213135,1226,2169,538,176,174,2,67,2,0.045977011,0,empty,CD-0722-1
"B5,F6",9296,10071,6916,3155,4713,2379,3,2383,1586,797,1.989962359,1352,3295,578,229,221,8,77,2,0.040723982,0,empty,CD-0722-1
"B5,F7",770045,931748,553683,378065,433899,262759,1,262975,196503,66472,2.956177037,160668,9223,1805,566,564,2,178,2,0.078014184,0,hg38,CD-0722-1
"B5,F8",8606,9759,6460,3299,4534,2264,0,2270,1471,799,1.841051314,1321,236,48,22,22,0,13,0,0,0,empty,CD-0722-1
"B5,F9",8358,9151,6244,2907,4389,2078,0,2081,1388,693,2.002886003,1204,3262,745,227,223,4,85,2,0.00896861,0,empty,CD-0722-1
"B5,F10",11016,11990,8516,3474,5686,2707,1,2721,1765,956,1.84623431,1496,1668,515,169,169,0,49,0,0.106508876,0,empty,CD-0722-1
"B5,F11",8173,8773,6152,2621,4145,1960,0,1960,1266,694,1.824207493,1067,2236,367,133,130,3,44,2,0.161538462,0,empty,CD-0722-1
"B5,F12",9443,10505,6807,3698,4954,2503,0,2513,1567,946,1.656448203,1492,311,85,22,22,0,12,0,0,0,empty,CD-0722-1
"B5,G1",10585,11427,7896,3531,5424,2593,0,2598,1733,865,2.003468208,1469,3185,761,304,297,7,122,2,0.037037037,0,empty,CD-0722-1
"B5,G2",5890,6346,4125,2221,3082,1587,0,1588,984,604,1.629139073,934,312,45,23,22,1,12,1,0.045454545,0,empty,CD-0722-1
"B5,G3",11039,11778,8122,3656,5703,2831,0,2831,1720,1111,1.548154815,1521,2168,374,152,152,0,71,0,0.190789474,0,empty,CD-0722-1
"B5,G4",19727,22318,14298,8020,10481,5800,0,5806,3469,2337,1.484381686,3403,251,33,22,22,0,16,0,0.090909091,0,empty,CD-0722-1
"B5,G5",7632,8252,5556,2696,4072,2087,0,2089,1395,694,2.010086455,1160,1975,407,167,166,1,61,1,0.162650602,0,empty,CD-0722-1
"B5,G6",10107,11150,7613,3537,5081,2463,0,2472,1625,847,1.918536009,1365,177,18,8,8,0,6,0,0,0,empty,CD-0722-1
"B5,G7",8726,9641,6689,2952,4551,2133,0,2134,1396,738,1.891598916,1203,2949,696,226,224,2,86,1,0.035714286,0,empty,CD-0722-1
"B5,G8",5912,6522,4460,2062,3051,1508,0,1510,978,532,1.838345865,882,2895,586,239,238,1,61,1,0.058823529,0,empty,CD-0722-1
"B5,G9",1387131,1673560,1005173,668387,764228,458362,3,458833,332921,125912,2.644076816,281607,334103,69997,22122,21785,337,2838,7,0.055588708,0,hg38,CD-0722-1
"B5,G10",1223853,1448259,900590,547669,666762,379866,0,380300,288720,91580,3.152653418,228231,212480,53938,17316,17145,171,2444,3,0.040419948,0,hg38,CD-0722-1
"B5,G11",8641,9028,6424,2604,4365,2100,0,2100,1380,720,1.916666667,1126,1524,352,169,169,0,52,0,0.035502959,0,empty,CD-0722-1
"B5,G12",7150,7638,5323,2315,3649,1799,0,1799,1178,621,1.896940419,983,2501,511,186,182,4,53,2,0.131868132,0,empty,CD-0722-1
"B5,H1",6996,7486,5204,2282,3530,1624,0,1626,1073,553,1.940325497,920,1351,270,120,116,4,38,1,0.094827586,0,empty,CD-0722-1
"B5,H2",8477,9590,6208,3382,4540,2293,0,2302,1477,825,1.79030303,1388,2532,556,210,209,1,52,1,0.105263158,0,empty,CD-0722-1
"B5,H3",6722,7423,5011,2412,3602,1741,0,1743,1106,637,1.736263736,1012,1441,356,131,131,0,51,0,0,0,empty,CD-0722-1
"B5,H4",10026,10911,7493,3418,5035,2398,0,2402,1601,801,1.998751561,1349,312,78,48,47,1,18,1,0.340425532,0,empty,CD-0722-1
"B5,H5",11273,12372,8362,4010,5680,2805,1,2810,1819,991,1.835519677,1570,2196,493,147,146,1,49,1,0.047945205,0,empty,CD-0722-1
"B5,H6",5978,6329,4300,2029,3036,1477,0,1479,952,527,1.806451613,835,2475,369,125,124,1,51,1,0.016129032,0,empty,CD-0722-1
"B5,H7",7743,8275,5733,2542,4009,1918,1,1922,1250,672,1.860119048,1065,2538,533,214,211,3,65,2,0.061611374,0,empty,CD-0722-1
"B5,H8",13340,15152,9834,5318,7254,3783,0,3786,2719,1067,2.548266167,2219,2152,496,153,152,1,49,1,0.184210526,0,empty,CD-0722-1
"B5,H9",6665,7027,5142,1885,3313,1525,0,1528,1029,499,2.062124248,801,1547,361,129,124,5,40,2,0.072580645,0,empty,CD-0722-1
"B5,H10",5931,6742,4433,2309,3069,1510,0,1513,954,559,1.706618962,880,1206,200,73,71,2,31,2,0.169014085,0,empty,CD-0722-1
"B5,H11",7199,8387,5065,3322,3945,2319,0,2321,1316,1005,1.309452736,1391,102,49,15,15,0,5,0,0,0,empty,CD-0722-1
"B5,H12",659931,772667,478702,293965,360044,210926,3,211125,145847,65278,2.234244309,126974,56665,11837,3599,3543,56,745,2,0.047135196,0,hg38,CD-0722-1
"B6,A1",4618,5364,3391,1973,2572,1389,0,1392,861,531,1.621468927,812,942,359,66,66,0,24,0,0.121212121,0,empty,CD-0722-1
"B6,A2",6804,7544,5101,2443,3468,1758,0,1762,1102,660,1.66969697,975,950,208,72,71,1,25,1,0.056338028,0,empty,CD-0722-1
"B6,A3",4169,4689,3173,1516,2139,1013,2,1020,648,372,1.741935484,559,852,100,44,44,0,17,0,0.113636364,0,empty,CD-0722-1
"B6,A4",7571,8192,5589,2603,3893,1991,0,1997,1285,712,1.804775281,1097,350,76,27,27,0,18,0,0.111111111,0,empty,CD-0722-1
"B6,A5",6249,7091,4636,2455,3354,1680,0,1682,1069,613,1.743882545,977,944,159,54,52,2,19,1,0.192307692,0,empty,CD-0722-1
"B6,A6",5190,6007,3907,2100,2884,1461,0,1466,984,482,2.041493776,846,1528,437,138,137,1,37,1,0,0,empty,CD-0722-1
"B6,A7",4445,5066,3391,1675,2345,1200,0,1202,803,399,2.012531328,677,783,187,62,61,1,24,1,0.016393443,0,empty,CD-0722-1
"B6,A8",2857,3214,2116,1098,1542,786,0,786,526,260,2.023076923,442,1068,303,119,116,3,35,1,0.146551724,0,empty,CD-0722-1
"B6,A9",4669,5194,3539,1655,2574,1302,0,1302,833,469,1.776119403,753,1111,263,96,96,0,37,0,0,0,empty,CD-0722-1
"B6,A10",5296,5647,4055,1592,2704,1326,0,1327,842,485,1.736082474,676,281,77,21,21,0,9,0,0,0,empty,CD-0722-1
"B6,A11",4220,4463,3137,1326,2215,1086,0,1089,763,326,2.340490798,623,814,158,67,67,0,21,0,0,0,empty,CD-0722-1
"B6,A12",5431,5799,4086,1713,2768,1316,0,1317,869,448,1.939732143,707,1782,342,131,131,0,40,0,0.06870229,0,empty,CD-0722-1
"B6,B1",4897,5347,3715,1632,2491,1252,1,1258,820,438,1.872146119,678,479,94,40,40,0,16,0,0.175,0,empty,CD-0722-1
"B6,B2",5358,5839,3735,2104,2825,1485,0,1490,969,521,1.859884837,866,424,131,34,34,0,8,0,0,0,empty,CD-0722-1
"B6,B3",4006,4472,2956,1516,2141,1097,0,1102,709,393,1.804071247,634,813,176,60,58,2,22,2,0,0,empty,CD-0722-1
"B6,B4",4781,5561,3480,2081,2617,1394,0,1397,888,509,1.74459725,838,833,249,109,109,0,34,0,0.055045872,0,empty,CD-0722-1
"B6,B5",4813,2726,1504,1222,1742,949,0,955,610,345,1.768115942,656,405,151,65,65,0,13,0,0.369230769,0,empty,CD-0722-1
"B6,B6",5417,5929,3958,1971,2885,1495,0,1497,906,591,1.532994924,873,774,200,72,71,1,30,1,0.014084507,0,empty,CD-0722-1
"B6,B7",5123,5449,3934,1515,2638,1283,0,1286,801,485,1.651546392,700,578,165,59,59,0,13,0,0.271186441,0,empty,CD-0722-1
"B6,B8",3610,4119,2767,1352,1915,944,0,944,620,324,1.913580247,553,552,66,26,25,1,16,1,0.08,0,empty,CD-0722-1
"B6,B9",6796,7808,5074,2734,3658,1929,0,1929,1204,725,1.660689655,1112,401,128,38,37,1,19,1,0.027027027,0,empty,CD-0722-1
"B6,B10",3711,4141,2656,1485,2101,1056,3,1062,674,388,1.737113402,658,278,68,23,23,0,6,0,0,0,empty,CD-0722-1
"B6,B11",7830,8895,5661,3234,4150,2299,0,2301,1227,1074,1.142458101,1369,131,27,12,12,0,3,0,0.333333333,0,empty,CD-0722-1
"B6,B12",4408,4759,3370,1389,2221,1069,0,1069,683,386,1.769430052,580,716,247,76,76,0,21,0,0,0,empty,CD-0722-1
"B6,C1",8839,9162,6579,2583,4303,2047,0,2052,1240,812,1.527093596,1096,445,116,48,48,0,12,0,0,0,empty,CD-0722-1
"B6,C2",7279,7905,5432,2473,3679,1861,0,1861,1205,656,1.836890244,1033,1449,398,100,99,1,28,1,0.04040404,0,empty,CD-0722-1
"B6,C3",577097,696555,419903,276652,323167,188255,2,188420,147041,41379,3.553517485,115443,21131,3610,1080,1072,8,244,4,0.03358209,0,hg38,CD-0722-1
"B6,C4",4986,5476,3774,1702,2542,1183,0,1183,756,427,1.770491803,657,1058,265,97,95,2,25,2,0.105263158,0,empty,CD-0722-1
"B6,C5",7953,8840,6030,2810,4194,2049,2,2057,1413,644,2.194099379,1160,1222,165,69,68,1,21,1,0.132352941,0,empty,CD-0722-1
"B6,C6",6134,6512,4446,2066,3219,1652,0,1655,1089,566,1.924028269,915,902,227,74,72,2,29,1,0.055555556,0,empty,CD-0722-1
"B6,C7",3166309,3750629,2378731,1371898,1634427,936167,5,937141,768951,168190,4.571918663,556395,73180,11450,3844,3763,81,802,5,0.069891044,0,hg38,CD-0722-1
"B6,C8",8394,9635,6228,3407,4510,2312,0,2316,1469,847,1.734356553,1325,1327,352,126,124,2,41,1,0.064516129,0,empty,CD-0722-1
"B6,C9",5882,6491,4374,2117,3075,1526,1,1529,967,562,1.720640569,888,825,156,57,57,0,18,0,0.01754386,0,empty,CD-0722-1
"B6,C10",6817,7519,5187,2332,3532,1691,1,1699,1061,638,1.663009404,929,1366,284,110,109,1,26,1,0.220183486,0,empty,CD-0722-1
"B6,C11",6372,7028,4696,2332,3271,1625,0,1629,983,646,1.521671827,941,1080,298,87,86,1,29,1,0.406976744,0,empty,CD-0722-1
"B6,C12",884294,1000603,671619,328984,457308,238607,5,238886,193021,45865,4.20845961,138321,31849,5160,1683,1656,27,354,2,0.028985507,0,hg38,CD-0722-1
"B6,D1",7403,8218,5440,2778,3921,2000,1,2003,1210,793,1.525851198,1160,337,121,52,52,0,12,0,0,0,empty,CD-0722-1
"B6,D2",6275,6982,4704,2278,3361,1655,0,1657,1100,557,1.97486535,977,1515,377,111,111,0,31,0,0.261261261,0,empty,CD-0722-1
"B6,D3",391161,441652,296391,145261,207523,106108,1,106217,84180,22037,3.819939193,61202,19070,3500,1172,1152,20,260,2,0.029513889,0,hg38,CD-0722-1
"B6,D4",4087,4560,3058,1502,2178,1078,0,1080,706,374,1.887700535,632,747,153,52,51,1,15,1,0.31372549,0,empty,CD-0722-1
"B6,D5",5084,5583,3790,1793,2623,1283,0,1285,795,490,1.62244898,729,844,115,55,54,1,34,1,0.018518519,0,empty,CD-0722-1
"B6,D6",7459,8281,5486,2795,3930,2076,0,2082,1221,861,1.418118467,1163,886,162,71,71,0,22,0,0.126760563,0,empty,CD-0722-1
"B6,D7",4000,4433,3020,1413,2210,1042,5,1047,682,365,1.868493151,613,1232,401,120,119,1,37,1,0.075630252,0,empty,CD-0722-1
"B6,D8",7332,8243,5474,2769,4034,2168,0,2175,1545,630,2.452380952,1269,1044,347,108,108,0,31,0,0.009259259,0,empty,CD-0722-1
"B6,D9",2823,3067,2151,916,1519,736,0,742,495,247,2.004048583,432,1203,210,73,70,3,22,2,0.085714286,0,empty,CD-0722-1
"B6,D10",6065,7183,4415,2768,3403,1821,0,1821,1225,596,2.055369128,1139,614,144,56,56,0,11,0,0.053571429,0,empty,CD-0722-1
"B6,D11",541554,636101,403592,232509,294066,162286,1,162386,130852,31534,4.149552864,95662,91400,18049,5569,5463,106,1057,4,0.029104887,0,hg38,CD-0722-1
"B6,D12",7218,8086,5413,2673,3776,1856,0,1858,1200,658,1.823708207,1040,1855,599,194,192,2,48,2,0.067708333,0,empty,CD-0722-1
"B6,E1",8684,9396,6487,2909,4460,2218,0,2223,1363,860,1.584883721,1228,1228,243,111,111,0,44,0,0.009009009,0,empty,CD-0722-1
"B6,E2",481262,556456,359691,196765,259408,138788,1,138944,105883,33061,3.202655697,81630,63812,8024,2652,2592,60,579,5,0.051697531,0,hg38,CD-0722-1
"B6,E3",4602,5090,3516,1574,2400,1148,2,1159,725,434,1.670506912,650,1447,436,159,158,1,41,1,0,0,empty,CD-0722-1
"B6,E4",5847,6487,4405,2082,3064,1508,0,1512,1018,494,2.060728745,833,1338,341,127,127,0,45,0,0.188976378,0,empty,CD-0722-1
"B6,E5",5639,6234,4224,2010,2926,1378,0,1380,875,505,1.732673267,788,517,145,69,64,5,22,1,0.21875,0,empty,CD-0722-1
"B6,E6",8901,9869,6789,3080,4655,2351,0,2353,1489,864,1.72337963,1341,1591,263,101,95,6,27,1,0.284210526,0,empty,CD-0722-1
"B6,E7",8176,8927,6166,2761,4258,1971,0,1977,1280,697,1.836441894,1095,2220,577,217,217,0,60,0,0.138248848,0,empty,CD-0722-1
"B6,E8",7036,7577,5374,2203,3516,1602,0,1603,1067,536,1.990671642,883,1910,518,195,192,3,35,2,0.119791667,0,empty,CD-0722-1
"B6,E9",3945,4353,3002,1351,2110,999,0,1002,650,352,1.846590909,555,1237,371,105,103,2,36,2,0.077669903,0,empty,CD-0722-1
"B6,E10",5180,5495,3989,1506,2612,1191,1,1194,787,407,1.933660934,639,883,182,78,78,0,26,0,0,0,empty,CD-0722-1
"B6,E11",6013,6445,4361,2084,3177,1599,0,1603,1033,570,1.812280702,902,1220,207,65,63,2,30,2,0.063492063,0,empty,CD-0722-1
"B6,E12",480072,586941,344501,242440,275626,162546,1,162682,134087,28595,4.689176429,100980,44884,8191,2662,2609,53,552,6,0.073208126,0,hg38,CD-0722-1
"B6,F1",7511,8345,5669,2676,3888,1891,0,1898,1241,657,1.888888889,1059,1509,418,100,99,1,31,1,0.01010101,0,empty,CD-0722-1
"B6,F2",6532,7285,4730,2555,3501,1758,0,1759,1142,617,1.85089141,1056,1421,333,96,96,0,32,0,0,0,empty,CD-0722-1
"B6,F3",5736,6361,4380,1981,2978,1406,0,1406,919,487,1.887063655,784,1786,379,155,153,2,48,1,0.196078431,0,empty,CD-0722-1
"B6,F4",725907,833002,543208,289794,384383,206714,8,206931,164011,42920,3.821318733,120626,31205,4577,1375,1337,38,287,4,0.098728497,0,hg38,CD-0722-1
"B6,F5",552546,633953,410890,223063,290416,156526,0,156691,122507,34184,3.583752633,91297,65118,11852,3916,3853,63,720,4,0.048274072,0,hg38,CD-0722-1
"B6,F6",6812,7566,5003,2563,3560,1844,3,1850,1179,671,1.757078987,1069,1547,237,87,87,0,32,0,0.137931034,0,empty,CD-0722-1
"B6,F7",8227,9322,6200,3122,4359,2178,1,2186,1426,760,1.876315789,1277,754,162,31,31,0,11,0,0,0,empty,CD-0722-1
"B6,F8",5259,5747,3941,1806,2748,1376,0,1379,892,487,1.831622177,775,127,54,27,27,0,8,0,0.666666667,0,empty,CD-0722-1
"B6,F9",6018,6579,4473,2106,3044,1451,0,1452,926,526,1.760456274,795,1475,378,132,132,0,42,0,0.053030303,0,empty,CD-0722-1
"B6,F10",8051,9053,6229,2824,4157,1980,0,1980,1279,701,1.824536377,1133,1220,400,120,120,0,27,0,0.15,0,empty,CD-0722-1
"B6,F11",5739,6305,4339,1966,3011,1384,0,1387,899,488,1.842213115,815,1183,152,52,51,1,18,1,0,0,empty,CD-0722-1
"B6,F12",6633,7361,4929,2432,3498,1750,0,1754,1060,694,1.527377522,1035,200,77,21,21,0,7,0,0.285714286,0,empty,CD-0722-1
"B6,G1",7280,7989,5491,2498,3806,1831,0,1837,1163,674,1.725519288,1042,1748,406,122,121,1,40,1,0,0,empty,CD-0722-1
"B6,G2",4239,4618,3059,1559,2131,1087,0,1088,642,446,1.439461883,633,281,51,24,24,0,7,0,0,0,empty,CD-0722-1
"B6,G3",8667,9542,6432,3110,4444,2251,0,2254,1369,885,1.546892655,1230,1560,353,134,133,1,48,1,0.015037594,0,empty,CD-0722-1
"B6,G4",13288,15171,9549,5622,7106,3956,0,3958,2367,1591,1.487743558,2307,99,41,18,18,0,6,0,0,0,empty,CD-0722-1
"B6,G5",5610,5946,4257,1689,2799,1336,0,1341,926,415,2.231325301,708,1222,319,102,102,0,31,0,0,0,empty,CD-0722-1
"B6,G6",7221,7656,5519,2137,3647,1727,0,1728,1139,589,1.933786078,911,91,18,9,9,0,3,0,0,0,empty,CD-0722-1
"B6,G7",5910,6624,4457,2167,3038,1422,4,1429,948,481,1.970893971,812,1879,429,114,114,0,38,0,0.00877193,0,empty,CD-0722-1
"B6,G8",4201,4729,3150,1579,2291,1109,0,1112,711,401,1.773067332,662,1007,266,87,87,0,27,0,0.172413793,0,empty,CD-0722-1
"B6,G9",5138,5651,3757,1894,2744,1365,0,1369,863,506,1.705533597,790,1103,172,76,75,1,31,1,0.013333333,0,empty,CD-0722-1
"B6,G10",5917,6699,4431,2268,3114,1570,0,1572,999,573,1.743455497,915,1189,307,97,93,4,37,2,0.064516129,0,empty,CD-0722-1
"B6,G11",6123,6613,4671,1942,3160,1468,0,1470,914,556,1.643884892,787,737,203,55,55,0,21,0,0,0,empty,CD-0722-1
"B6,G12",551441,642953,412435,230518,302787,163688,0,163810,125430,38380,3.26810839,97312,110415,18293,5992,5882,110,1042,6,0.042842571,0,hg38,CD-0722-1
"B6,H1",5108,5569,3741,1828,2577,1246,0,1246,795,451,1.762749446,692,825,156,48,47,1,14,1,0,0,empty,CD-0722-1
"B6,H2",6513,7204,4919,2285,3405,1627,0,1628,1065,563,1.891651865,903,1166,311,108,105,3,29,2,0.085714286,0,empty,CD-0722-1
"B6,H3",4779,5282,3597,1685,2384,1182,0,1185,765,420,1.821428571,637,843,129,38,38,0,17,0,0,0,empty,CD-0722-1
"B6,H4",7218,7989,5352,2637,3709,1844,1,1847,1138,709,1.605077574,1055,145,64,19,19,0,5,0,0.157894737,0,empty,CD-0722-1
"B6,H5",7459,8148,5499,2649,3834,1846,0,1851,1134,717,1.581589958,1055,1153,290,78,73,5,26,2,0,0,empty,CD-0722-1
"B6,H6",4545,5156,3339,1817,2423,1243,0,1244,791,453,1.746136865,743,1045,117,44,44,0,18,0,0.022727273,0,empty,CD-0722-1
"B6,H7",5975,6377,4474,1903,2920,1327,0,1327,854,473,1.805496829,719,1001,256,76,76,0,22,0,0.157894737,0,empty,CD-0722-1
"B6,H8",6091,6997,4548,2449,3150,1644,0,1644,1007,637,1.580847724,929,1119,311,84,84,0,33,0,0,0,empty,CD-0722-1
"B6,H9",5501,6038,4160,1878,2820,1368,0,1369,937,432,2.168981481,762,933,219,84,84,0,20,0,0.333333333,0,empty,CD-0722-1
"B6,H10",3982,4377,2933,1444,2121,1072,0,1074,718,356,2.016853933,630,631,293,75,75,0,26,0,0.013333333,0,empty,CD-0722-1
"B6,H11",5611,6277,4077,2200,3027,1761,0,1766,961,805,1.19378882,1042,16,2,1,0,1,0,1,0,0,empty,CD-0722-1
"B6,H12",4492,4957,3282,1675,2303,1139,0,1142,762,380,2.005263158,641,967,217,85,85,0,24,0,0,0,empty,CD-0722-1
"B7,A1",8713,9390,6393,2997,4461,2253,0,2257,1385,872,1.588302752,1246,1310,221,79,78,1,36,1,0.217948718,0,empty,CD-0722-1
"B7,A2",14054,15894,10517,5377,7305,3757,0,3766,2390,1376,1.736918605,2158,2275,482,171,170,1,74,1,0.023529412,0,empty,CD-0722-1
"B7,A3",768532,926265,552972,373293,418057,246076,2,246293,211075,35218,5.993384065,150437,93477,16821,5403,5316,87,986,4,0.085402558,0,hg38,CD-0722-1
"B7,A4",14042,15712,10580,5132,7129,3539,0,3543,2259,1284,1.759345794,2044,1016,254,81,81,0,33,0,0.320987654,0,empty,CD-0722-1
"B7,A5",12455,13840,9288,4552,6376,3102,0,3106,1982,1124,1.763345196,1792,2823,666,218,216,2,59,2,0.087962963,0,empty,CD-0722-1
"B7,A6",9920,11428,7439,3989,5348,2700,1,2703,1794,909,1.97359736,1585,2432,373,173,172,1,87,1,0.110465116,0,empty,CD-0722-1
"B7,A7",635767,704902,495075,209827,319235,153308,1,153514,116401,37113,3.136394255,85542,28290,4956,1555,1515,40,371,4,0.040924092,0,hg38,CD-0722-1
"B7,A8",1146967,1392564,835708,556856,621578,363156,3,363556,303486,60070,5.05220576,222382,319159,57571,18798,18476,322,2685,9,0.056451613,0,hg38,CD-0722-1
"B7,A9",350559,429096,241727,187369,198748,127031,1,127167,99142,28025,3.537627119,79697,11793,5063,1596,1592,4,411,1,0.04459799,0,hg38,CD-0722-1
"B7,A10",10718,11743,8303,3440,5424,2606,0,2610,1600,1010,1.584158416,1420,644,145,42,41,1,15,1,0,0,empty,CD-0722-1
"B7,A11",8414,9306,6518,2788,4308,1954,0,1956,1253,703,1.782361309,1121,1622,370,152,149,3,57,2,0.134228188,0,empty,CD-0722-1
"B7,A12",11142,12490,8540,3950,5618,2720,6,2726,1819,907,2.005512679,1511,3183,691,247,239,8,84,2,0.071129707,0,empty,CD-0722-1
"B7,B1",9731,10572,7283,3289,4883,2414,0,2414,1543,871,1.77152698,1366,1174,258,105,105,0,34,0,0.00952381,0,empty,CD-0722-1
"B7,B2",640914,771657,426692,344965,352044,234036,0,234216,165943,68273,2.430580171,145731,947,121,43,42,1,22,1,0.047619048,0,empty,CD-0722-1
"B7,B3",521369,651903,350967,300936,298980,203557,0,203696,148898,54798,2.717215957,127396,4836,579,179,173,6,92,2,0.069364162,0,hg38,CD-0722-1
"B7,B4",1532364,1813419,1130862,682557,807571,454590,3,455072,359457,95615,3.759420593,273640,251878,33862,11618,11346,272,1928,6,0.078089194,0,hg38,CD-0722-1
"B7,B5",9198,5108,2803,2305,3174,1757,1,1779,1135,644,1.76242236,1241,904,180,69,67,2,35,1,0.208955224,0,empty,CD-0722-1
"B7,B6",10131,11452,7330,4122,5287,2762,1,2765,1773,992,1.787298387,1623,1358,329,147,147,0,40,0,0.217687075,0,empty,CD-0722-1
"B7,B7",9345,10503,7069,3434,4746,2274,0,2276,1483,793,1.870113493,1292,1192,288,107,107,0,33,0,0.056074766,0,empty,CD-0722-1
"B7,B8",7341,8326,5483,2843,3800,1848,0,1849,1224,625,1.9584,1100,1359,334,131,126,5,47,2,0.095238095,0,empty,CD-0722-1
"B7,B9",13078,14399,9561,4838,6669,3414,0,3418,2176,1242,1.752012882,2007,1173,262,97,94,3,32,2,0.021276596,0,empty,CD-0722-1
"B7,B10",6835,7197,4836,2361,3526,1682,1,1696,1111,585,1.899145299,1010,522,64,19,19,0,14,0,0.105263158,0,empty,CD-0722-1
"B7,B11",15952,18146,11612,6534,8218,4436,0,4442,2696,1746,1.544100802,2555,289,54,37,37,0,16,0,0.054054054,0,empty,CD-0722-1
"B7,B12",8504,9434,6274,3160,4454,2245,0,2248,1470,778,1.889460154,1336,1929,371,113,110,3,42,1,0.018181818,0,empty,CD-0722-1
"B7,C1",16042,17303,12138,5165,7946,3879,1,3882,2462,1420,1.733802817,2144,1190,244,97,96,1,41,1,0.0625,0,empty,CD-0722-1
"B7,C2",13305,14788,9650,5138,6671,3399,1,3412,2189,1223,1.789860998,1991,2457,764,262,254,8,73,2,0.078740157,0,empty,CD-0722-1
"B7,C3",13807,15325,10308,5017,7245,3570,0,3574,2387,1187,2.01095198,2038,1189,245,86,86,0,28,0,0.069767442,0,empty,CD-0722-1
"B7,C4",9374,10233,7126,3107,4705,2182,0,2189,1450,739,1.962110961,1213,1943,217,107,105,2,53,2,0.104761905,0,empty,CD-0722-1
"B7,C5",13648,15146,10189,4957,7017,3453,0,3455,2271,1184,1.918074324,1974,2122,393,162,157,5,76,2,0.031847134,0,empty,CD-0722-1
"B7,C6",11197,12367,8223,4144,5880,2913,0,2921,1895,1026,1.846978558,1670,2214,596,239,237,2,80,1,0.080168776,0,empty,CD-0722-1
"B7,C7",761761,962975,503637,459338,433572,302079,1,302351,232628,69723,3.336459992,190672,758,168,66,66,0,35,0,0,0,empty,CD-0722-1
"B7,C8",16728,18570,12478,6092,8490,4251,0,4260,2776,1484,1.870619946,2434,3048,777,307,303,4,110,2,0.062706271,0,empty,CD-0722-1
"B7,C9",11348,13077,8407,4670,6066,3032,0,3035,1922,1113,1.726864331,1836,1830,415,157,157,0,40,0,0.082802548,0,empty,CD-0722-1
"B7,C10",819095,936182,616504,319678,415302,219590,2,219811,172133,47678,3.61032342,127087,157775,27531,9554,9355,199,1559,5,0.055264564,0,hg38,CD-0722-1
"B7,C11",847979,1010800,621138,389662,454849,254460,3,254737,212069,42668,4.970211868,154834,169171,26908,9181,9025,156,1537,6,0.071357341,0,hg38,CD-0722-1
"B7,C12",16066,17708,12005,5703,8141,3889,0,3900,2586,1314,1.96803653,2211,1558,262,128,128,0,49,0,0,0,empty,CD-0722-1
"B7,D1",14227,16086,10454,5632,7418,3920,0,3929,2425,1504,1.612367021,2253,917,165,52,51,1,24,1,0,0,empty,CD-0722-1
"B7,D2",11235,12100,8775,3325,5565,2477,0,2485,1584,901,1.758046615,1295,3081,741,293,291,2,105,1,0.058419244,0,empty,CD-0722-1
"B7,D3",10489,11728,7699,4029,5576,2850,0,2858,1886,972,1.940329218,1629,1880,524,201,201,0,68,0,0.009950249,0,empty,CD-0722-1
"B7,D4",11184,12466,8436,4030,5985,3109,0,3115,2169,946,2.292811839,1798,1235,310,123,123,0,47,0,0.016260163,0,empty,CD-0722-1
"B7,D5",9861,11478,7304,4174,5191,2601,0,2604,1731,873,1.982817869,1541,2258,668,238,236,2,75,1,0.055084746,0,empty,CD-0722-1
"B7,D6",13610,14824,9789,5035,6777,3573,1,3581,2153,1428,1.507703081,2033,1776,496,195,194,1,54,1,0.067010309,0,empty,CD-0722-1
"B7,D7",745624,848571,565322,283249,377938,195622,8,195853,150252,45601,3.294927743,113155,136551,13978,4675,4532,143,965,5,0.05847308,0,hg38,CD-0722-1
"B7,D8",10834,11761,8084,3677,5540,2750,0,2752,1828,924,1.978354978,1537,1557,329,132,131,1,52,1,0.007633588,0,empty,CD-0722-1
"B7,D9",5650,6308,4251,2057,2976,1438,0,1441,968,473,2.046511628,836,2509,335,136,135,1,66,1,0.066666667,0,empty,CD-0722-1
"B7,D10",8908,9826,6536,3290,4607,2380,0,2380,1505,875,1.72,1355,640,98,36,36,0,10,0,0.194444444,0,empty,CD-0722-1
"B7,D11",10769,12184,8170,4014,5590,2689,1,2690,1745,945,1.846560847,1534,3575,1122,369,368,1,114,1,0.081521739,0,empty,CD-0722-1
"B7,D12",13468,15035,9969,5066,6887,3347,0,3348,2186,1162,1.881239243,1949,3931,868,351,350,1,123,1,0.068571429,0,empty,CD-0722-1
"B7,E1",17136,19079,12707,6372,8665,4447,0,4451,2756,1695,1.625958702,2531,3138,707,266,263,3,89,3,0.152091255,0,empty,CD-0722-1
"B7,E2",684283,790566,512434,278132,358814,190162,2,190370,141499,48871,2.895357165,112731,80789,10585,3506,3413,93,676,6,0.04893056,0,hg38,CD-0722-1
"B7,E3",596173,686776,451409,235367,309478,161757,2,161924,128513,33411,3.846427823,93647,171264,27278,8983,8799,184,1518,6,0.033412888,0,hg38,CD-0722-1
"B7,E4",1913245,2292885,1405151,887734,1007296,582019,5,582647,460151,122496,3.756457354,353154,183278,36400,11721,11571,150,1979,9,0.045112782,0,hg38,CD-0722-1
"B7,E5",9881,10938,7609,3329,4997,2287,0,2289,1439,850,1.692941176,1308,1620,359,119,117,2,50,1,0.085470085,0,empty,CD-0722-1
"B7,E6",16724,18547,12507,6040,8524,4364,0,4380,2841,1539,1.846003899,2501,3395,814,280,277,3,74,2,0.090252708,0,empty,CD-0722-1
"B7,E7",16033,17779,12112,5667,8265,3968,1,3979,2697,1282,2.10374415,2262,3429,1104,343,340,3,101,1,0.047058824,0,empty,CD-0722-1
"B7,E8",12351,13283,9433,3850,6046,2770,0,2774,1833,941,1.947927736,1458,3328,748,242,235,7,73,2,0.080851064,0,empty,CD-0722-1
"B7,E9",8457,9185,6367,2818,4280,2174,0,2174,1439,735,1.957823129,1209,2717,645,226,225,1,80,1,0.208888889,0,empty,CD-0722-1
"B7,E10",788674,897592,598178,299414,404882,210600,1,210841,154870,55971,2.766968609,122805,104904,16659,5793,5680,113,1101,3,0.041373239,0,hg38,CD-0722-1
"B7,E11",11178,12248,8364,3884,5755,2879,0,2881,1826,1055,1.730805687,1631,2321,489,201,200,1,64,1,0.04,0,empty,CD-0722-1
"B7,E12",12132,13670,8950,4720,6606,3385,0,3388,2246,1142,1.966725044,2029,2466,386,172,169,3,71,2,0.059171598,0,empty,CD-0722-1
"B7,F1",13834,14904,10109,4795,6903,3320,0,3327,2153,1174,1.833901193,1908,1873,575,159,157,2,57,1,0.031847134,0,empty,CD-0722-1
"B7,F2",11782,12733,8699,4034,5940,2838,0,2845,1898,947,2.004223865,1596,3534,851,365,360,5,120,2,0.063888889,0,empty,CD-0722-1
"B7,F3",11043,12158,8144,4014,5593,2655,0,2657,1762,895,1.968715084,1520,3088,905,331,326,5,99,1,0.150306748,0,empty,CD-0722-1
"B7,F4",16305,17698,12136,5562,8101,3881,0,3886,2557,1329,1.92400301,2182,690,77,42,42,0,32,0,0.047619048,0,empty,CD-0722-1
"B7,F5",922728,1094392,666451,427941,483040,283648,1,283972,224567,59405,3.780271021,170932,19876,7267,2338,2335,3,516,2,0.034261242,0,hg38,CD-0722-1
"B7,F6",13674,15556,10143,5413,7021,3663,0,3663,2392,1271,1.881982691,2100,3360,839,352,347,5,107,2,0.141210375,0,empty,CD-0722-1
"B7,F7",15199,16873,11312,5561,7843,3878,0,3881,2539,1342,1.89195231,2220,1579,409,153,151,2,45,1,0.145695364,0,empty,CD-0722-1
"B7,F8",9797,10840,7358,3482,4998,2449,0,2450,1550,900,1.722222222,1397,392,96,24,24,0,11,0,0.041666667,0,empty,CD-0722-1
"B7,F9",11042,12211,8405,3806,5624,2703,0,2706,1787,919,1.944504897,1555,2561,689,250,248,2,81,1,0.056451613,0,empty,CD-0722-1
"B7,F10",14087,15012,10833,4179,6933,3201,0,3208,2058,1150,1.789565217,1695,1645,469,103,103,0,40,0,0.077669903,0,empty,CD-0722-1
"B7,F11",12211,13244,9496,3748,5969,2658,0,2662,1763,899,1.961067853,1421,2131,382,127,126,1,50,1,0.023809524,0,empty,CD-0722-1
"B7,F12",12357,13468,9099,4369,6203,2983,0,2989,1930,1059,1.822474032,1717,211,36,21,21,0,11,0,0,0,empty,CD-0722-1
"B7,G1",14020,15430,10645,4785,7137,3445,0,3453,2318,1135,2.042290749,1948,3486,825,342,340,2,124,2,0.064705882,0,empty,CD-0722-1
"B7,G2",7889,8856,5532,3324,4125,2171,0,2172,1403,769,1.824447334,1332,438,66,32,32,0,19,0,0,0,empty,CD-0722-1
"B7,G3",841799,1020977,582083,438894,463323,302316,0,302554,220395,82159,2.682542387,185480,13048,1035,388,380,8,137,3,0.068421053,0,hg38,CD-0722-1
"B7,G4",946623,1043567,738412,305155,461858,217890,3,218157,162547,55610,2.922981478,120627,2200,298,115,114,1,34,1,0.026315789,0,hg38,CD-0722-1
"B7,G5",9350,10168,7052,3116,4768,2318,0,2324,1595,729,2.187928669,1293,2367,663,245,243,2,67,1,0.152263374,0,empty,CD-0722-1
"B7,G6",12389,13844,9504,4340,6266,2985,0,2990,1910,1080,1.768518519,1609,263,63,35,35,0,12,0,0.028571429,0,empty,CD-0722-1
"B7,G7",1844480,2177862,1361281,816581,958655,546309,9,546971,436227,110744,3.939057646,324906,195084,39783,13004,12870,134,2076,4,0.053146853,0,hg38,CD-0722-1
"B7,G8",7571,8128,5523,2605,3790,1858,0,1858,1198,660,1.815151515,1079,1960,454,175,168,7,53,2,0.023809524,0,empty,CD-0722-1
"B7,G9",9485,10527,7201,3326,4792,2326,0,2333,1470,863,1.703360371,1309,2154,451,173,170,3,74,2,0.029411765,0,empty,CD-0722-1
"B7,G10",11504,12677,8561,4116,5981,3050,0,3064,1913,1151,1.662033015,1753,2648,694,254,253,1,88,1,0.015810277,0,empty,CD-0722-1
"B7,G11",11491,12801,8573,4228,5859,2718,0,2727,1800,927,1.941747573,1612,1437,416,174,173,1,72,1,0.01734104,0,empty,CD-0722-1
"B7,G12",9571,10677,6931,3746,4899,2528,1,2533,1615,918,1.759259259,1470,2392,637,200,198,2,65,2,0.055555556,0,empty,CD-0722-1
"B7,H1",9827,10979,7400,3579,4987,2379,0,2381,1564,817,1.914320685,1347,1146,292,111,111,0,34,0,0.108108108,0,empty,CD-0722-1
"B7,H2",10698,11736,7911,3825,5411,2692,3,2696,1699,997,1.704112337,1521,2817,604,252,251,1,67,1,0.107569721,0,empty,CD-0722-1
"B7,H3",9345,10292,7022,3270,4710,2309,0,2309,1525,784,1.945153061,1296,1632,336,129,129,0,48,0,0.062015504,0,empty,CD-0722-1
"B7,H4",70718,83980,49672,34308,37122,21564,1,21579,15387,6192,2.48498062,13313,4010,307,120,113,7,38,2,0.03539823,0,empty,CD-0722-1
"B7,H5",14186,15124,10644,4480,6743,3235,0,3244,2068,1176,1.758503401,1720,1970,452,169,167,2,63,2,0.101796407,0,empty,CD-0722-1
"B7,H6",8481,9118,6271,2847,4290,2134,0,2134,1372,762,1.800524934,1218,1754,377,138,133,5,49,2,0,0,empty,CD-0722-1
"B7,H7",10393,11569,7817,3752,5326,2626,0,2629,1715,914,1.876367615,1506,2270,525,148,148,0,61,0,0.168918919,0,empty,CD-0722-1
"B7,H8",11614,12549,8779,3770,5684,2799,0,2803,1808,995,1.817085427,1525,2360,536,180,175,5,56,2,0.034285714,0,empty,CD-0722-1
"B7,H9",9134,9871,7067,2804,4554,2091,0,2094,1405,689,2.039187228,1171,1164,290,113,113,0,42,0,0.053097345,0,empty,CD-0722-1
"B7,H10",473486,525948,363917,162031,230054,114757,5,114890,81527,33363,2.443635165,64440,47466,7496,2355,2322,33,528,2,0.053832903,0,hg38,CD-0722-1
"B7,H11",10104,11934,7069,4865,5647,3480,1,3483,1887,1596,1.182330827,2157,56,9,7,7,0,6,0,0,0,empty,CD-0722-1
"B7,H12",9365,10426,6971,3455,4821,2442,3,2449,1632,817,1.99755202,1365,1683,353,143,142,1,63,1,0.105633803,0,empty,CD-0722-1
"B8,A1",8016,8816,5862,2954,4238,2211,1,2216,1400,816,1.715686275,1261,2195,281,123,122,1,48,1,0.016393443,0,empty,CD-0722-1
"B8,A2",12751,14282,9598,4684,6775,3443,0,3448,2246,1202,1.868552413,1929,2888,752,260,256,4,86,1,0.109375,0,empty,CD-0722-1
"B8,A3",7487,8410,5718,2692,3849,1879,0,1882,1230,652,1.886503067,1066,1645,319,114,113,1,34,1,0.044247788,0,empty,CD-0722-1
"B8,A4",13226,14624,9920,4704,6904,3390,0,3392,2163,1229,1.759967453,1920,1450,260,111,110,1,44,1,0.018181818,0,empty,CD-0722-1
"B8,A5",11236,12268,8314,3954,5888,2920,1,2930,1852,1078,1.717996289,1639,2854,785,280,279,1,73,1,0.050179211,0,empty,CD-0722-1
"B8,A6",8847,10428,6618,3810,5069,2651,0,2656,1759,897,1.960981048,1588,3221,817,307,302,5,108,2,0.066225166,0,empty,CD-0722-1
"B8,A7",712744,843483,523442,320041,390413,220691,4,220935,177888,43047,4.132413409,132269,106359,19371,6444,6353,91,1106,4,0.048008815,0,hg38,CD-0722-1
"B8,A8",4894,5553,3763,1790,2600,1287,1,1292,873,419,2.08353222,722,2692,635,206,205,1,66,1,0.024390244,0,empty,CD-0722-1
"B8,A9",8508,9604,6478,3126,4610,2304,0,2306,1560,746,2.091152815,1290,1936,337,165,164,1,67,1,0.018292683,0,empty,CD-0722-1
"B8,A10",9026,9745,6884,2861,4674,2198,0,2201,1372,829,1.655006031,1200,479,60,41,41,0,23,0,0,0,empty,CD-0722-1
"B8,A11",7860,8758,6046,2712,4201,2031,0,2031,1333,698,1.90974212,1134,2001,495,170,170,0,71,0,0.041176471,0,empty,CD-0722-1
"B8,A12",718725,812711,547449,265262,373002,188549,3,188782,143990,44792,3.214636542,108926,261976,32870,10708,10401,307,1644,8,0.062013268,0,hg38,CD-0722-1
"B8,B1",8684,9715,6363,3352,4629,2426,0,2429,1496,933,1.603429796,1422,1561,274,127,125,2,52,1,0.112,0,empty,CD-0722-1
"B8,B2",9519,10472,6520,3952,5042,2726,0,2727,1748,979,1.785495403,1635,1107,203,84,83,1,25,1,0.024096386,0,empty,CD-0722-1
"B8,B3",7060,7963,5168,2795,3788,1907,0,1909,1257,652,1.92791411,1083,2068,481,127,127,0,48,0,0.133858268,0,empty,CD-0722-1
"B8,B4",8570,9836,6366,3470,4683,2438,0,2443,1532,911,1.681668496,1430,1747,465,179,174,5,76,2,0.057471264,0,empty,CD-0722-1
"B8,B5",8453,4603,2837,1766,3021,1620,0,1629,1036,593,1.747048904,1061,1090,234,91,88,3,24,1,0.102272727,0,empty,CD-0722-1
"B8,B6",9535,10732,7046,3686,5083,2654,0,2656,1687,969,1.740970072,1522,1587,463,137,136,1,49,1,0.022058824,0,empty,CD-0722-1
"B8,B7",771352,948373,548504,399869,447354,282379,0,282599,198399,84200,2.35628266,172965,17557,2533,742,738,4,219,2,0.077235772,0,hg38,CD-0722-1
"B8,B8",6586,7334,4964,2370,3578,1742,0,1746,1123,623,1.802568218,978,1555,331,147,144,3,50,2,0.041666667,0,empty,CD-0722-1
"B8,B9",12087,13183,9020,4163,6329,3212,0,3219,2012,1207,1.666942833,1765,1281,388,130,129,1,53,1,0.108527132,0,empty,CD-0722-1
"B8,B10",6482,7026,4747,2279,3505,1713,0,1720,1091,629,1.734499205,993,433,63,29,29,0,18,0,0.137931034,0,empty,CD-0722-1
"B8,B11",12990,14597,9436,5161,6917,3785,0,3789,2138,1651,1.294972744,2242,178,31,21,20,1,13,1,0,0,empty,CD-0722-1
"B8,B12",7625,8586,5632,2954,4207,2117,0,2117,1334,783,1.703703704,1268,1522,384,140,137,3,48,1,0.102189781,0,empty,CD-0722-1
"B8,C1",15505,16941,11886,5055,8011,3884,0,3892,2536,1356,1.87020649,2090,1646,297,114,113,1,44,1,0.008849558,0,empty,CD-0722-1
"B8,C2",12500,14024,9312,4712,6551,3280,0,3289,2097,1192,1.759228188,1908,3102,687,207,206,1,58,1,0.101941748,0,empty,CD-0722-1
"B8,C3",828723,1010058,587338,422720,467778,299634,1,299928,235083,64845,3.6253065,182931,8048,646,221,218,3,79,2,0.266055046,0,hg38,CD-0722-1
"B8,C4",1539079,1802710,1145883,656827,822932,456903,5,457327,370126,87201,4.244515545,269143,271091,42403,14158,13893,265,2163,10,0.079536457,0,hg38,CD-0722-1
"B8,C5",12502,13879,9312,4567,6564,3258,0,3260,2200,1060,2.075471698,1820,2342,561,208,208,0,69,0,0.120192308,0,empty,CD-0722-1
"B8,C6",979878,1159916,719770,440146,543765,304931,2,305213,241568,63645,3.795553461,184719,246794,38485,12809,12531,278,1976,8,0.064320485,0,hg38,CD-0722-1
"B8,C7",14012,16267,10187,6080,7696,4297,0,4298,2512,1786,1.406494961,2521,575,82,47,47,0,27,0,0.085106383,0,empty,CD-0722-1
"B8,C8",1362981,1567193,1017331,549862,723164,404559,3,404930,297478,107452,2.768473365,236322,83550,17365,5395,5323,72,945,3,0.037948525,0,hg38,CD-0722-1
"B8,C9",9885,11426,7413,4013,5385,2735,0,2736,1684,1052,1.600760456,1591,1841,398,153,151,2,46,2,0.059602649,0,empty,CD-0722-1
"B8,C10",12197,13416,9170,4246,6290,3034,2,3042,1979,1063,1.861712135,1744,2157,587,245,244,1,77,1,0.131147541,0,empty,CD-0722-1
"B8,C11",10637,11847,7870,3977,5633,2844,1,2848,1796,1052,1.707224335,1666,2449,739,233,231,2,84,2,0.03030303,0,empty,CD-0722-1
"B8,C12",14889,16350,11019,5331,7844,3835,0,3843,2585,1258,2.054848967,2263,2817,831,281,277,4,70,2,0.036101083,0,empty,CD-0722-1
"B8,D1",14439,16432,10485,5947,7925,4152,0,4161,2641,1520,1.7375,2526,4641,343,116,108,8,50,4,0.101851852,0,empty,CD-0722-1
"B8,D2",10725,11683,8228,3455,5588,2629,0,2630,1653,977,1.691914023,1475,4388,1280,348,344,4,115,1,0.069767442,0,empty,CD-0722-1
"B8,D3",10026,11379,7327,4052,5407,2761,0,2766,1801,965,1.866321244,1606,2081,399,170,167,3,66,2,0.05988024,0,empty,CD-0722-1
"B8,D4",707052,828194,531595,296599,384438,206991,2,207192,162606,44586,3.647019244,122912,74994,10480,3479,3397,82,662,5,0.062408007,0,hg38,CD-0722-1
"B8,D5",8809,9729,6568,3161,4754,2412,0,2413,1558,855,1.822222222,1388,2209,468,155,153,2,66,1,0.052287582,0,empty,CD-0722-1
"B8,D6",12751,14079,9186,4893,6545,3519,1,3529,2154,1375,1.566545455,2001,1976,551,193,192,1,67,1,0.109375,0,empty,CD-0722-1
"B8,D7",7518,8304,5687,2617,3837,1818,0,1822,1168,654,1.785932722,1001,2222,424,146,144,2,64,1,0.006944444,0,empty,CD-0722-1
"B8,D8",1497134,1718750,1128633,590117,784471,420413,5,420880,326052,94828,3.438351542,246828,142295,22556,7209,7062,147,1267,9,0.037524781,0,hg38,CD-0722-1
"B8,D9",5005,5511,3884,1627,2720,1350,0,1350,875,475,1.842105263,745,2531,646,203,196,7,62,2,0.020408163,0,empty,CD-0722-1
"B8,D10",8735,9621,6456,3165,4455,2256,3,2262,1397,865,1.615028902,1266,889,256,85,85,0,26,0,0.023529412,0,empty,CD-0722-1
"B8,D11",10423,11678,7753,3925,5590,2767,0,2770,1839,931,1.975295381,1614,3709,828,315,313,2,121,2,0.051118211,0,empty,CD-0722-1
"B8,D12",750363,843041,571409,271632,389253,198879,5,199117,156878,42239,3.71405573,114036,136124,19170,6201,6029,172,1150,3,0.032011942,0,hg38,CD-0722-1
"B8,E1",15725,17145,11738,5407,8095,3999,0,4003,2538,1465,1.732423208,2247,4448,995,367,365,2,132,1,0.019178082,0,empty,CD-0722-1
"B8,E2",11204,12587,8246,4341,5928,2991,0,2998,1938,1060,1.828301887,1721,2959,463,154,154,0,47,0,0.064935065,0,empty,CD-0722-1
"B8,E3",7638,8579,5889,2690,4149,1921,0,1923,1226,697,1.758967001,1129,3017,686,283,280,3,92,1,0.125,0,empty,CD-0722-1
"B8,E4",10449,11637,7913,3724,5598,2695,1,2698,1714,984,1.741869919,1591,3561,627,219,219,0,94,0,0.086757991,0,empty,CD-0722-1
"B8,E5",9431,10436,7262,3174,4897,2292,1,2307,1446,861,1.679442509,1295,1845,503,178,173,5,56,2,0.046242775,0,empty,CD-0722-1
"B8,E6",15465,16951,11510,5441,8010,4010,0,4015,2611,1404,1.85968661,2270,3989,974,327,323,4,93,2,0.021671827,0,empty,CD-0722-1
"B8,E7",14671,16024,11078,4946,7616,3684,0,3687,2462,1225,2.009795918,2031,3158,662,236,231,5,78,2,0.177489177,0,empty,CD-0722-1
"B8,E8",943941,1073384,721764,351620,490662,252419,3,252702,196373,56329,3.48617941,143771,319651,52556,16884,16592,292,2338,9,0.051470588,0,hg38,CD-0722-1
"B8,E9",7409,8318,5620,2698,3969,1950,0,1952,1294,658,1.96656535,1101,2929,624,244,242,2,87,1,0.020661157,0,empty,CD-0722-1
"B8,E10",9231,10191,6903,3288,4819,2325,0,2328,1486,842,1.764845606,1330,2602,750,261,258,3,74,1,0.104651163,0,empty,CD-0722-1
"B8,E11",12059,13038,8741,4297,6290,3315,0,3316,2092,1224,1.709150327,1850,2474,495,182,180,2,58,2,0.138888889,0,empty,CD-0722-1
"B8,E12",10969,12018,8007,4011,5818,2947,0,2954,1850,1104,1.675724638,1732,2037,447,164,161,3,64,2,0.055900621,0,empty,CD-0722-1
"B8,F1",12966,14052,9604,4448,6703,3275,0,3275,2061,1214,1.697693575,1860,2649,660,233,232,1,75,1,0.077586207,0,empty,CD-0722-1
"B8,F2",11845,13430,8752,4678,6333,3205,0,3207,2092,1115,1.876233184,1874,3780,691,260,258,2,113,2,0.073643411,0,empty,CD-0722-1
"B8,F3",9898,11264,7507,3757,5499,2735,0,2741,1758,983,1.788402848,1600,3668,906,279,274,5,91,2,0.03649635,0,empty,CD-0722-1
"B8,F4",14919,16364,11264,5100,7742,3698,2,3702,2366,1336,1.770958084,2089,796,121,52,50,2,28,2,0.02,0,empty,CD-0722-1
"B8,F5",11950,13005,9032,3973,6057,2864,0,2868,1862,1006,1.850894632,1585,2724,571,201,200,1,66,1,0.065,0,empty,CD-0722-1
"B8,F6",12708,14512,9229,5283,6892,3608,0,3615,2416,1199,2.01501251,2139,3205,633,277,271,6,85,2,0.092250923,0,empty,CD-0722-1
"B8,F7",14405,16359,10816,5543,7803,4019,0,4019,2653,1366,1.942166911,2269,1754,588,145,144,1,58,1,0.111111111,0,empty,CD-0722-1
"B8,F8",9168,10147,7003,3144,4767,2317,0,2321,1497,824,1.816747573,1295,301,81,30,29,1,11,1,0,0,empty,CD-0722-1
"B8,F9",866620,1004652,644990,359662,461859,252313,1,252601,189497,63104,3.002931668,148796,183249,25071,8249,8036,213,1454,6,0.034594326,0,hg38,CD-0722-1
"B8,F10",13599,14808,10492,4316,6892,3234,0,3242,2150,1092,1.968864469,1760,1844,344,106,105,1,43,1,0.038095238,0,empty,CD-0722-1
"B8,F11",10981,11828,8468,3360,5591,2535,0,2538,1657,881,1.880817253,1389,2231,486,196,196,0,52,0,0.142857143,0,empty,CD-0722-1
"B8,F12",721966,887355,509124,378231,407664,250119,0,250321,195846,54475,3.59515374,157120,2251,845,256,255,1,77,1,0.003921569,0,hg38,CD-0722-1
"B8,G1",13035,14190,9789,4401,6806,3265,6,3271,2210,1061,2.082940622,1817,4079,888,318,312,6,118,2,0.115384615,0,empty,CD-0722-1
"B8,G2",7696,8548,5433,3115,4006,2126,7,2138,1349,789,1.709759189,1275,421,56,25,25,0,16,0,0,0,empty,CD-0722-1
"B8,G3",13767,14940,10338,4602,7038,3547,0,3548,2174,1374,1.58224163,1910,3850,1157,324,322,2,110,2,0.059006211,0,empty,CD-0722-1
"B8,G4",24119,26927,17414,9513,13080,7248,0,7262,4462,2800,1.593571429,4222,302,30,20,20,0,17,0,0,0,empty,CD-0722-1
"B8,G5",8683,9591,6470,3121,4655,2339,0,2345,1526,819,1.863247863,1362,2110,532,187,186,1,63,1,0.123655914,0,empty,CD-0722-1
"B8,G6",12332,13354,9301,4053,6273,2984,0,2984,1951,1033,1.888673766,1673,285,63,30,30,0,12,0,0.533333333,0,empty,CD-0722-1
"B8,G7",10088,10871,7674,3197,5280,2452,0,2453,1582,871,1.8163031,1339,2945,662,261,258,3,85,2,0.139534884,0,empty,CD-0722-1
"B8,G8",7375,8037,5522,2515,3778,1829,0,1830,1204,626,1.923322684,1038,2118,630,204,203,1,59,1,0.108374384,0,empty,CD-0722-1
"B8,G9",647125,779518,459634,319884,365338,230790,1,231000,156798,74202,2.113123635,140643,15643,1768,531,503,28,125,3,0.248508946,0,hg38,CD-0722-1
"B8,G10",10470,11396,7808,3588,5542,2809,0,2811,1788,1023,1.747800587,1590,3116,719,256,254,2,91,1,0.035433071,0,empty,CD-0722-1
"B8,G11",2371116,2713327,1791971,921356,1217171,655169,7,655859,517576,138283,3.742875118,379281,194396,40644,12877,12679,198,1968,7,0.042905592,0,hg38,CD-0722-1
"B8,G12",8572,9578,6226,3352,4512,2310,0,2312,1483,829,1.788902292,1333,2978,721,272,269,3,72,2,0.07063197,0,empty,CD-0722-1
"B8,H1",8697,9228,6463,2765,4467,2104,0,2110,1421,689,2.062409289,1180,1324,303,91,91,0,36,0,0.076923077,0,empty,CD-0722-1
"B8,H2",10172,11550,7422,4128,5400,2674,0,2674,1634,1040,1.571153846,1566,3554,920,296,293,3,80,1,0.040955631,0,empty,CD-0722-1
"B8,H3",8687,9893,6478,3415,4577,2345,0,2351,1520,831,1.82912154,1339,2556,423,152,144,8,60,1,0.006944444,0,empty,CD-0722-1
"B8,H4",12849,14169,9516,4653,6553,3163,0,3169,2034,1135,1.792070485,1774,319,77,32,31,1,16,1,0,0,empty,CD-0722-1
"B8,H5",13644,15141,10226,4915,7073,3539,0,3550,2245,1305,1.720306513,1987,2628,665,237,233,4,69,1,0.004291845,0,empty,CD-0722-1
"B8,H6",8914,9835,6712,3123,4557,2294,0,2297,1557,740,2.104054054,1267,2154,363,144,144,0,48,0,0.034722222,0,empty,CD-0722-1
"B8,H7",9910,10670,7333,3337,5126,2478,3,2487,1634,853,1.915592028,1411,2058,328,134,133,1,60,1,0.015037594,0,empty,CD-0722-1
"B8,H8",9750,10596,7175,3421,5134,2586,0,2592,1600,992,1.612903226,1482,2954,552,222,217,5,69,2,0.032258065,0,empty,CD-0722-1
"B8,H9",8314,9170,6344,2826,4256,1974,1,1979,1376,603,2.281923715,1129,1346,386,124,119,5,34,1,0.176470588,0,empty,CD-0722-1
"B8,H10",7643,8331,5722,2609,3793,1872,0,1873,1265,608,2.080592105,990,1356,348,121,120,1,36,1,0.133333333,0,empty,CD-0722-1
"B8,H11",9331,10767,6537,4230,5093,3070,0,3072,1755,1317,1.332574032,1808,72,15,8,8,0,6,0,0,0,empty,CD-0722-1
"B8,H12",8273,9371,6030,3341,4395,2299,0,2300,1543,757,2.038309115,1300,1871,324,140,137,3,56,1,0.01459854,0,empty,CD-0722-1
"B9,A1",7324,8101,5502,2599,3856,1974,1,1979,1236,743,1.663526245,1119,1181,201,103,99,4,29,2,0.121212121,0,empty,CD-0722-1
"B9,A2",11136,12789,8180,4609,6060,3106,0,3110,1956,1154,1.694974003,1837,1621,401,117,111,6,39,1,0.072072072,0,empty,CD-0722-1
"B9,A3",6815,7761,5002,2759,3688,1879,0,1880,1194,686,1.740524781,1105,1289,300,92,92,0,25,0,0.086956522,0,empty,CD-0722-1
"B9,A4",11926,13094,9011,4083,6118,2958,0,2973,1893,1080,1.752777778,1596,782,257,74,74,0,22,0,0.013513514,0,empty,CD-0722-1
"B9,A5",9736,10547,7223,3324,5226,2526,0,2528,1592,936,1.700854701,1413,1835,329,118,116,2,39,1,0.086206897,0,empty,CD-0722-1
"B9,A6",9241,10553,6880,3673,5088,2685,0,2690,1838,852,2.157276995,1516,2215,531,209,206,3,59,2,0.048543689,0,empty,CD-0722-1
"B9,A7",7591,8676,5701,2975,4024,2068,0,2072,1298,774,1.677002584,1170,1165,211,91,91,0,37,0,0.032967033,0,empty,CD-0722-1
"B9,A8",4543,5107,3517,1590,2546,1314,0,1316,870,446,1.950672646,743,1578,402,153,152,1,63,1,0.052631579,0,empty,CD-0722-1
"B9,A9",7852,8615,6030,2585,4132,1944,1,1945,1329,616,2.157467532,1050,1349,188,75,72,3,33,3,0.041666667,0,empty,CD-0722-1
"B9,A10",8603,9448,6581,2867,4479,2175,0,2178,1328,850,1.562352941,1174,429,113,36,36,0,11,0,0,0,empty,CD-0722-1
"B9,A11",6842,7469,5286,2183,3587,1622,0,1625,1065,560,1.901785714,867,1349,220,94,94,0,33,0,0,0,empty,CD-0722-1
"B9,A12",9494,10221,7040,3181,4758,2280,0,2282,1512,770,1.963636364,1263,2676,473,184,181,3,54,2,0.093922652,0,empty,CD-0722-1
"B9,B1",7916,8949,5939,3010,4146,2068,0,2074,1265,809,1.563658838,1174,680,127,41,39,2,22,1,0.179487179,0,empty,CD-0722-1
"B9,B2",8859,9540,6072,3468,4632,2479,0,2482,1512,970,1.558762887,1459,326,32,20,18,2,12,2,0.055555556,0,empty,CD-0722-1
"B9,B3",6488,7274,4896,2378,3428,1740,0,1741,1148,593,1.935919056,975,1176,240,89,88,1,24,1,0,0,empty,CD-0722-1
"B9,B4",8046,9331,5918,3413,4527,2448,3,2454,1530,924,1.655844156,1419,1177,322,93,91,2,37,2,0.021978022,0,empty,CD-0722-1
"B9,B5",7828,4165,2391,1774,2677,1463,0,1479,959,520,1.844230769,978,909,196,64,63,1,17,1,0.015873016,0,empty,CD-0722-1
"B9,B6",8969,10049,6471,3578,4765,2536,0,2542,1555,987,1.575481256,1530,1602,405,125,123,2,27,1,0.089430894,0,empty,CD-0722-1
"B9,B7",8450,9367,6507,2860,4434,2150,0,2150,1359,791,1.718078382,1188,782,251,89,88,1,23,1,0.068181818,0,empty,CD-0722-1
"B9,B8",5838,6529,4432,2097,3138,1524,0,1524,1059,465,2.277419355,844,841,161,81,81,0,34,0,0.098765432,0,empty,CD-0722-1
"B9,B9",11104,12591,8116,4475,5985,3207,0,3210,1957,1253,1.561851556,1831,828,341,72,72,0,25,0,0.027777778,0,empty,CD-0722-1
"B9,B10",5863,6519,4173,2346,3178,1591,0,1597,1041,556,1.872302158,932,408,98,45,45,0,12,0,0.022222222,0,empty,CD-0722-1
"B9,B11",1711427,1971183,1287577,683606,878140,473900,7,474413,368424,105989,3.476058836,276461,7411,1046,309,305,4,93,3,0.019672131,0,hg38,CD-0722-1
"B9,B12",7295,7981,5593,2388,3858,1880,0,1886,1298,588,2.207482993,1056,1529,543,123,122,1,29,1,0.057377049,0,empty,CD-0722-1
"B9,C1",13781,14894,10537,4357,7006,3347,0,3356,2143,1213,1.766694147,1793,818,314,84,83,1,19,1,0.012048193,0,empty,CD-0722-1
"B9,C2",11199,12707,8292,4415,5957,3016,0,3020,1944,1076,1.80669145,1738,1850,613,170,167,3,47,2,0.089820359,0,empty,CD-0722-1
"B9,C3",12321,13933,9047,4886,6652,3436,0,3440,2236,1204,1.857142857,2001,848,169,54,53,1,23,1,0.056603774,0,empty,CD-0722-1
"B9,C4",8015,8912,6033,2879,4221,2065,0,2065,1325,740,1.790540541,1188,1589,357,149,146,3,54,1,0.006849315,0,empty,CD-0722-1
"B9,C5",11321,12535,8437,4098,5900,2944,0,2948,2042,906,2.253863135,1612,1493,395,148,146,2,57,2,0.02739726,0,empty,CD-0722-1
"B9,C6",10880,12407,8071,4336,6030,3146,1,3153,1999,1154,1.732235702,1910,1406,264,102,99,3,35,1,0.060606061,0,empty,CD-0722-1
"B9,C7",12540,14403,9193,5210,6832,3772,0,3775,2272,1503,1.51164338,2229,398,20,13,13,0,9,0,0,0,empty,CD-0722-1
"B9,C8",13925,15548,10231,5317,7374,3757,4,3766,2456,1310,1.87480916,2222,2721,717,206,204,2,60,2,0.019607843,0,empty,CD-0722-1
"B9,C9",9691,11015,7294,3721,5082,2585,0,2590,1682,908,1.852422907,1503,1547,373,115,115,0,38,0,0.069565217,0,empty,CD-0722-1
"B9,C10",11111,12092,8414,3678,5717,2764,0,2764,1810,954,1.897274633,1544,1891,523,229,228,1,51,1,0.043859649,0,empty,CD-0722-1
"B9,C11",9519,10745,6921,3824,5133,2588,0,2590,1671,919,1.81828074,1548,1504,400,144,143,1,42,1,0.062937063,0,empty,CD-0722-1
"B9,C12",13742,14911,10372,4539,7022,3399,0,3408,2256,1152,1.958333333,1925,1541,365,138,137,1,47,1,0.124087591,0,empty,CD-0722-1
"B9,D1",12216,13821,8955,4866,6577,3514,0,3516,2115,1401,1.509635974,2087,1005,263,101,101,0,26,0,0.04950495,0,empty,CD-0722-1
"B9,D2",727953,842329,543512,298817,386858,214940,5,215149,163159,51990,3.138276592,125436,31082,8218,2396,2373,23,572,3,0.048040455,0,hg38,CD-0722-1
"B9,D3",8793,9833,6461,3372,4791,2419,2,2423,1589,834,1.905275779,1385,1705,314,112,111,1,36,1,0.036036036,0,empty,CD-0722-1
"B9,D4",6857,7728,5045,2683,3592,1767,0,1767,1181,586,2.015358362,1033,1215,335,95,92,3,33,2,0.076086957,0,empty,CD-0722-1
"B9,D5",8142,9094,6105,2989,4345,2076,0,2080,1350,730,1.849315068,1202,1807,515,157,156,1,44,1,0.121794872,0,empty,CD-0722-1
"B9,D6",11715,13440,8359,5081,6293,3438,0,3440,2101,1339,1.569081404,2090,1256,271,86,86,0,32,0,0.046511628,0,empty,CD-0722-1
"B9,D7",6739,7394,5125,2269,3462,1683,0,1684,1098,586,1.873720137,950,1641,479,151,149,2,47,1,0.067114094,0,empty,CD-0722-1
"B9,D8",8246,8812,6178,2634,4200,2000,0,2000,1270,730,1.739726027,1086,1249,318,70,69,1,31,1,0.072463768,0,empty,CD-0722-1
"B9,D9",6314,7056,4746,2310,3432,1723,0,1723,1191,532,2.238721805,981,1481,256,90,88,2,37,2,0.056818182,0,empty,CD-0722-1
"B9,D10",10608,12166,7788,4378,5789,3124,0,3127,1972,1155,1.707359307,1838,678,227,68,68,0,19,0,0.014705882,0,empty,CD-0722-1
"B9,D11",9289,10872,6908,3964,5179,2542,0,2548,1579,969,1.629514964,1583,2551,679,211,209,2,62,2,0.057416268,0,empty,CD-0722-1
"B9,D12",11339,12497,8477,4020,5849,2835,0,2841,1852,989,1.872598584,1616,2628,548,186,186,0,68,0,0.069892473,0,empty,CD-0722-1
"B9,E1",782880,886074,585839,300235,405142,212827,2,213064,179723,33341,5.390450196,122053,99720,17704,5647,5529,118,1107,3,0.054801953,0,hg38,CD-0722-1
"B9,E2",704748,793574,539191,254383,367567,184810,0,185035,141655,43380,3.265444905,105225,34148,6238,2072,2035,37,444,3,0.039312039,0,hg38,CD-0722-1
"B9,E3",6976,7876,5293,2583,3717,1774,0,1776,1149,627,1.832535885,1006,1846,475,144,143,1,46,1,0.034965035,0,empty,CD-0722-1
"B9,E4",9677,10748,7261,3487,5035,2430,1,2431,1649,782,2.108695652,1376,2176,551,168,162,6,67,2,0.080246914,0,empty,CD-0722-1
"B9,E5",8095,8747,6197,2550,4244,1959,0,1964,1317,647,2.035548686,1108,1216,341,134,134,0,38,0,0.291044776,0,empty,CD-0722-1
"B9,E6",806694,918803,604912,313891,415515,217492,4,217749,180717,37032,4.880022683,125495,254981,42961,14350,14068,282,2053,7,0.06098948,0,hg38,CD-0722-1
"B9,E7",13208,14141,10028,4113,6833,3281,0,3285,2131,1154,1.846620451,1781,2068,512,189,189,0,66,0,0.068783069,0,empty,CD-0722-1
"B9,E8",10960,11933,8404,3529,5639,2637,0,2639,1729,910,1.9,1452,2235,345,118,116,2,33,1,0.267241379,0,empty,CD-0722-1
"B9,E9",7177,7696,5314,2382,3752,1842,0,1851,1225,626,1.95686901,1064,2370,607,211,209,2,58,2,0.200956938,0,empty,CD-0722-1
"B9,E10",8352,9267,6283,2984,4335,2060,0,2062,1350,712,1.896067416,1174,1493,345,123,115,8,43,2,0.008695652,0,empty,CD-0722-1
"B9,E11",9323,10321,6967,3354,4957,2459,0,2459,1587,872,1.819954128,1378,1932,501,151,151,0,42,0,0.099337748,0,empty,CD-0722-1
"B9,E12",10490,11459,7637,3822,5484,2693,0,2695,1746,949,1.839831401,1612,1524,315,89,84,5,31,1,0.047619048,0,empty,CD-0722-1
"B9,F1",11960,13139,8985,4154,6301,3061,0,3062,1958,1104,1.773550725,1741,1721,398,142,141,1,44,1,0.056737589,0,empty,CD-0722-1
"B9,F2",9573,10695,7060,3635,5167,2581,0,2582,1668,914,1.824945295,1496,2651,605,211,208,3,75,2,0.105769231,0,empty,CD-0722-1
"B9,F3",9469,10613,6975,3638,5034,2478,0,2483,1648,835,1.973652695,1489,2150,333,131,122,9,60,3,0.098360656,0,empty,CD-0722-1
"B9,F4",14360,15100,10922,4178,7154,3254,1,3258,2146,1112,1.929856115,1796,596,68,35,34,1,16,1,0.029411765,0,empty,CD-0722-1
"B9,F5",985960,1197902,703796,494106,550496,348073,1,348361,241270,107091,2.252943758,212868,5404,537,165,161,4,71,3,0.043478261,0,hg38,CD-0722-1
"B9,F6",2245072,2613651,1676826,936825,1178590,660066,4,660719,546651,114068,4.79232563,391006,403778,66647,22574,22188,386,2849,11,0.080133405,0,hg38,CD-0722-1
"B9,F7",13351,14968,9885,5083,7252,3668,2,3676,2396,1280,1.871875,2153,1163,307,76,76,0,29,0,0.157894737,0,empty,CD-0722-1
"B9,F8",9937,11209,7508,3701,5413,2788,0,2792,1912,880,2.172727273,1612,297,80,19,16,3,7,1,0.4375,0,empty,CD-0722-1
"B9,F9",9581,10566,7346,3220,4937,2317,0,2317,1474,843,1.7485172,1286,2292,654,210,207,3,55,1,0.028985507,0,empty,CD-0722-1
"B9,F10",12127,13052,9259,3793,6214,2915,0,2921,1854,1067,1.737582006,1607,1369,316,103,103,0,34,0,0.067961165,0,empty,CD-0722-1
"B9,F11",820164,956902,592290,364612,435209,259505,0,259773,199543,60230,3.313016769,150630,4227,925,367,366,1,167,1,0.12568306,0,hg38,CD-0722-1
"B9,F12",9941,10949,7440,3509,5147,2451,1,2460,1615,845,1.911242604,1388,62,7,7,7,0,7,0,0,0,empty,CD-0722-1
"B9,G1",12063,12944,9189,3755,6219,2877,0,2878,1836,1042,1.761996161,1611,2507,607,189,188,1,63,1,0.111702128,0,empty,CD-0722-1
"B9,G2",6700,6997,4801,2196,3369,1661,0,1662,1028,634,1.621451104,911,340,149,42,42,0,11,0,0.30952381,0,empty,CD-0722-1
"B9,G3",14201,15825,10328,5497,7451,3910,0,3917,2475,1442,1.716366158,2270,2171,724,257,251,6,68,2,0.015936255,0,empty,CD-0722-1
"B9,G4",22185,25326,16111,9215,11968,6656,0,6661,4035,2626,1.536557502,3937,121,13,10,10,0,10,0,0.1,0,empty,CD-0722-1
"B9,G5",8146,9125,6037,3088,4284,2135,0,2137,1383,754,1.834217507,1206,1274,282,117,115,2,40,2,0.017391304,0,empty,CD-0722-1
"B9,G6",11099,11991,8435,3556,5685,2760,0,2763,1809,954,1.896226415,1481,161,8,7,7,0,6,0,0,0,empty,CD-0722-1
"B9,G7",9633,10476,7324,3152,5108,2427,1,2437,1568,869,1.804372842,1379,2064,644,251,248,3,65,1,0.137096774,0,empty,CD-0722-1
"B9,G8",6524,7212,4862,2350,3407,1678,0,1681,1151,530,2.171698113,941,1201,238,78,77,1,29,1,0.051948052,0,empty,CD-0722-1
"B9,G9",8147,8848,6144,2704,4273,2014,0,2014,1308,706,1.852691218,1129,1926,584,207,205,2,67,1,0,0,empty,CD-0722-1
"B9,G10",9691,10815,7294,3521,5208,2625,0,2628,1772,856,2.070093458,1497,2082,558,211,209,2,60,1,0.210526316,0,empty,CD-0722-1
"B9,G11",9827,10591,7372,3219,5156,2428,0,2436,1609,827,1.945586457,1361,1577,379,136,135,1,41,1,0,0,empty,CD-0722-1
"B9,G12",7872,8812,5814,2998,4162,2111,0,2113,1318,795,1.657861635,1240,1765,435,133,133,0,42,0,0.082706767,0,empty,CD-0722-1
"B9,H1",2247440,2584795,1639701,945094,1179977,694230,11,694861,468481,226380,2.069445181,406233,6108,2364,586,585,1,232,1,0.034188034,0,hg38,CD-0722-1
"B9,H2",9363,10251,6937,3314,4760,2326,1,2328,1513,815,1.856441718,1350,2131,441,152,147,5,44,1,0.034013605,0,empty,CD-0722-1
"B9,H3",7878,8425,5916,2509,4047,1980,0,1984,1273,711,1.790436006,1129,1320,312,91,90,1,30,1,0.077777778,0,empty,CD-0722-1
"B9,H4",2130794,2530146,1571445,958701,1131689,661626,4,662266,496700,165566,3.00001208,397051,3897,765,272,272,0,71,0,0.025735294,0,hg38,CD-0722-1
"B9,H5",12268,13301,9229,4072,6230,3052,0,3053,1980,1073,1.845293569,1704,1670,448,131,130,1,39,1,0.076923077,0,empty,CD-0722-1
"B9,H6",6732,7632,5011,2621,3622,1841,0,1842,1227,615,1.995121951,1059,1681,324,137,134,3,39,1,0.037313433,0,empty,CD-0722-1
"B9,H7",9390,10149,6950,3199,4811,2301,0,2304,1538,766,2.007832898,1297,1606,335,121,121,0,55,0,0.008264463,0,empty,CD-0722-1
"B9,H8",9332,10440,6764,3676,4879,2531,0,2531,1622,909,1.784378438,1450,1247,304,121,119,2,48,2,0.109243697,0,empty,CD-0722-1
"B9,H9",7435,7787,5762,2025,3731,1683,0,1686,1134,552,2.054347826,868,612,143,62,62,0,18,0,0.241935484,0,empty,CD-0722-1
"B9,H10",6867,7562,5011,2551,3592,1824,0,1824,1231,593,2.075885329,1094,1319,281,100,100,0,24,0,0.18,0,empty,CD-0722-1
"B9,H11",8574,9910,6043,3867,4751,2806,0,2809,1515,1294,1.170788253,1670,15,5,3,3,0,1,0,0,0,empty,CD-0722-1
"B9,H12",7790,8647,5718,2929,3995,2063,0,2064,1335,729,1.83127572,1178,1437,274,99,96,3,36,2,0.104166667,0,empty,CD-0722-1
"B10,A1",7064,8029,5229,2800,3928,2038,0,2038,1325,713,1.858345021,1157,1764,307,113,110,3,42,2,0.227272727,0,empty,CD-0722-1
"B10,A2",10831,11877,8075,3802,5728,2882,0,2886,1838,1048,1.753816794,1600,2552,762,261,259,2,76,1,0.135135135,0,empty,CD-0722-1
"B10,A3",6729,7261,4960,2301,3471,1719,0,1722,1140,582,1.958762887,986,1225,271,97,97,0,36,0,0.030927835,0,empty,CD-0722-1
"B10,A4",12258,13255,9399,3856,6223,3026,0,3029,1941,1088,1.784007353,1636,1147,281,101,101,0,34,0,0.118811881,0,empty,CD-0722-1
"B10,A5",9880,10855,7375,3480,5289,2577,0,2581,1649,932,1.769313305,1445,2814,693,257,249,8,78,2,0.088353414,0,empty,CD-0722-1
"B10,A6",8351,9448,6140,3308,4547,2346,0,2350,1547,803,1.926525529,1368,2736,668,248,244,4,92,3,0.176229508,0,empty,CD-0722-1
"B10,A7",7458,8600,5509,3091,3932,2005,0,2008,1327,681,1.948604993,1161,2125,339,165,161,4,59,2,0.105590062,0,empty,CD-0722-1
"B10,A8",4261,4842,3142,1700,2373,1182,0,1183,778,405,1.920987654,719,2430,607,206,203,3,64,1,0.0591133,0,empty,CD-0722-1
"B10,A9",7672,8576,5830,2746,4065,1995,0,1995,1275,720,1.770833333,1127,2303,399,165,162,3,61,3,0.055555556,0,empty,CD-0722-1
"B10,A10",8767,9854,6681,3173,4539,2218,0,2218,1391,827,1.681983071,1222,563,45,27,27,0,18,0,0.074074074,0,empty,CD-0722-1
"B10,A11",7092,7727,5462,2265,3725,1735,0,1737,1176,561,2.096256684,955,2198,493,185,184,1,60,1,0.032608696,0,empty,CD-0722-1
"B10,A12",9176,10103,7038,3065,4746,2291,0,2293,1526,767,1.989569752,1290,5931,1018,384,381,3,104,1,0.041994751,0,empty,CD-0722-1
"B10,B1",7826,8763,5880,2883,4236,2156,0,2164,1376,788,1.746192893,1223,1353,249,102,102,0,37,0,0.254901961,0,empty,CD-0722-1
"B10,B2",8598,9323,5920,3403,4570,2409,1,2418,1557,861,1.808362369,1432,748,142,54,54,0,20,0,0,0,empty,CD-0722-1
"B10,B3",6546,7340,4784,2556,3436,1696,0,1704,1098,606,1.811881188,1008,1553,408,152,152,0,45,0,0.026315789,0,empty,CD-0722-1
"B10,B4",7633,8751,5623,3128,4219,2250,0,2251,1418,833,1.702280912,1340,1757,246,122,118,4,51,2,0.186440678,0,empty,CD-0722-1
"B10,B5",7423,3935,2348,1587,2640,1429,0,1432,903,529,1.706994329,936,1105,223,79,79,0,24,0,0.113924051,0,empty,CD-0722-1
"B10,B6",8663,9457,6284,3173,4640,2468,0,2469,1618,851,1.901292597,1400,1893,412,194,194,0,55,0,0.139175258,0,empty,CD-0722-1
"B10,B7",1086494,1262248,821265,440983,574843,307329,2,307689,242651,65038,3.73091116,179399,96377,19149,6183,6108,75,1102,5,0.078421742,0,hg38,CD-0722-1
"B10,B8",5853,6499,4384,2115,3159,1534,0,1535,995,540,1.842592593,885,1512,277,97,96,1,41,1,0.020833333,0,empty,CD-0722-1
"B10,B9",11156,12340,8212,4128,5843,3033,0,3040,1881,1159,1.62295082,1736,1195,227,81,81,0,40,0,0.098765432,0,empty,CD-0722-1
"B10,B10",5726,5929,4148,1781,2936,1391,2,1398,926,472,1.961864407,790,601,106,52,50,2,21,1,0.12,0,empty,CD-0722-1
"B10,B11",16129,18030,11879,6151,8540,4553,0,4559,2839,1720,1.650581395,2660,339,76,32,31,1,21,1,0.032258065,0,empty,CD-0722-1
"B10,B12",677901,798770,501494,297276,373970,205689,2,205907,161402,44505,3.626603752,123845,155517,19129,6242,6079,163,1157,5,0.056259253,0,hg38,CD-0722-1
"B10,C1",13933,14988,10571,4417,7052,3401,0,3403,2139,1264,1.692246835,1779,1348,364,98,98,0,39,0,0.020408163,0,empty,CD-0722-1
"B10,C2",1674724,1952276,1253888,698388,881559,484513,3,485017,372028,112989,3.292603705,286841,284055,46108,15150,14854,296,2173,6,0.057425609,0,hg38,CD-0722-1
"B10,C3",16043,17612,12141,5471,8553,4284,1,4291,2870,1421,2.019704433,2344,1213,200,88,88,0,33,0,0.102272727,0,empty,CD-0722-1
"B10,C4",7580,8200,5683,2517,3976,1869,0,1873,1171,702,1.668091168,1054,2232,476,176,176,0,72,0,0.039772727,0,empty,CD-0722-1
"B10,C5",887740,1047855,661831,386024,481959,265313,1,265562,209578,55984,3.743533867,159499,96664,11334,3788,3657,131,792,5,0.050041017,0,hg38,CD-0722-1
"B10,C6",9268,10256,6703,3553,5086,2610,0,2615,1719,896,1.918526786,1533,2411,540,235,234,1,90,1,0.02991453,0,empty,CD-0722-1
"B10,C7",957630,1175782,694184,481598,536740,316649,3,316959,253288,63671,3.978074791,194761,24526,5176,1691,1667,24,398,3,0.104379124,0,hg38,CD-0722-1
"B10,C8",13585,14735,10199,4536,7072,3516,0,3518,2243,1275,1.759215686,1984,3684,813,321,316,5,109,2,0.025316456,0,empty,CD-0722-1
"B10,C9",9674,10970,7155,3815,5133,2549,0,2553,1664,889,1.871766029,1483,1919,418,127,126,1,40,1,0.103174603,0,empty,CD-0722-1
"B10,C10",10804,12037,8193,3844,5516,2658,0,2666,1757,909,1.932893289,1502,2548,539,187,186,1,77,1,0.02688172,0,empty,CD-0722-1
"B10,C11",784414,862815,599854,262961,400437,196901,3,197085,161360,35725,4.516724983,109650,45366,7376,2049,2005,44,464,5,0.045885287,0,hg38,CD-0722-1
"B10,C12",12697,13599,9560,4039,6494,3076,2,3084,2060,1024,2.01171875,1700,3415,628,228,221,7,70,1,0.054298643,0,empty,CD-0722-1
"B10,D1",11702,13789,8523,5266,6457,3417,0,3422,2069,1353,1.529194383,2062,1084,224,81,79,2,24,2,0,0,empty,CD-0722-1
"B10,D2",2699907,3063051,2066413,996638,1354533,723685,5,724520,607548,116972,5.193960948,409537,357317,73128,23878,23600,278,3099,12,0.061822034,0,hg38,CD-0722-1
"B10,D3",9126,10187,6694,3493,5053,2642,0,2643,1758,885,1.986440678,1546,2489,443,183,179,4,76,2,0.089385475,0,empty,CD-0722-1
"B10,D4",6717,7590,5026,2564,3574,1792,0,1794,1152,642,1.794392523,1027,1778,505,181,180,1,60,1,0.077777778,0,empty,CD-0722-1
"B10,D5",8175,8971,6040,2931,4356,2177,0,2184,1474,710,2.076056338,1255,2290,471,203,202,1,83,1,0.079207921,0,empty,CD-0722-1
"B10,D6",11469,12612,8271,4341,6132,3278,0,3278,1995,1283,1.554949337,1880,2865,903,248,246,2,67,1,0.077235772,0,empty,CD-0722-1
"B10,D7",2687979,3126535,2023117,1103418,1381411,770891,6,771778,608922,162856,3.739020976,452039,624733,110129,36914,36322,592,3884,14,0.066984197,0,hg38,CD-0722-1
"B10,D8",8469,9380,6267,3113,4369,2126,0,2132,1412,720,1.961111111,1204,1633,356,123,122,1,65,1,0.032786885,0,empty,CD-0722-1
"B10,D9",4432,4772,3318,1454,2298,1092,0,1096,734,362,2.027624309,618,1943,372,145,145,0,66,0,0.048275862,0,empty,CD-0722-1
"B10,D10",8021,8963,5890,3073,4211,2125,0,2130,1413,717,1.970711297,1280,933,162,51,47,4,18,1,0.276595745,0,empty,CD-0722-1
"B10,D11",595702,718160,422947,295213,332997,211913,2,212076,147690,64386,2.293821638,128012,11044,1439,551,540,11,177,2,0.181481481,0,hg38,CD-0722-1
"B10,D12",11230,12581,8476,4105,5895,2975,0,2975,1969,1006,1.957256461,1683,5172,941,342,336,6,127,4,0.044642857,0,empty,CD-0722-1
"B10,E1",13746,15328,10096,5232,7222,3674,0,3679,2351,1328,1.770331325,2126,3731,636,254,253,1,119,1,0.039525692,0,empty,CD-0722-1
"B10,E2",10266,11457,7547,3910,5499,2854,0,2856,1793,1063,1.686735654,1637,2478,772,238,236,2,68,2,0.008474576,0,empty,CD-0722-1
"B10,E3",7215,8026,5498,2528,3833,1877,0,1880,1209,671,1.801788376,1035,2882,647,230,228,2,81,2,0.065789474,0,empty,CD-0722-1
"B10,E4",848859,981195,640090,341105,448529,233900,5,234120,176750,57370,3.080878508,137452,113032,19095,6135,6006,129,1167,7,0.045621046,0,hg38,CD-0722-1
"B10,E5",8102,9259,6217,3042,4363,2054,0,2059,1276,783,1.62962963,1184,1911,582,212,211,1,55,1,0.047393365,0,empty,CD-0722-1
"B10,E6",14550,15928,10903,5025,7405,3611,3,3620,2269,1351,1.679496669,2005,3852,913,320,318,2,90,1,0.08490566,0,empty,CD-0722-1
"B10,E7",13965,15540,10588,4952,7315,3471,0,3472,2337,1135,2.059030837,2007,3923,972,334,331,3,85,1,0.102719033,0,empty,CD-0722-1
"B10,E8",10753,11582,8224,3358,5466,2503,1,2508,1592,916,1.737991266,1360,3826,808,273,270,3,87,1,0.02962963,0,empty,CD-0722-1
"B10,E9",6890,7758,5123,2635,3732,1861,0,1861,1221,640,1.9078125,1093,3068,720,244,239,5,85,2,0.012552301,0,empty,CD-0722-1
"B10,E10",8022,8610,6120,2490,4034,1886,0,1886,1241,645,1.924031008,985,2057,412,136,135,1,54,1,0.022222222,0,empty,CD-0722-1
"B10,E11",9751,10634,7267,3367,4996,2464,0,2469,1601,868,1.844470046,1410,3052,606,218,207,11,72,2,0.033816425,0,empty,CD-0722-1
"B10,E12",9986,10982,7408,3574,5343,2606,0,2608,1713,895,1.91396648,1512,2629,482,166,165,1,61,1,0.103030303,0,empty,CD-0722-1
"B10,F1",11849,12907,8982,3925,6143,2992,0,2995,1938,1057,1.833491012,1662,2491,629,271,270,1,80,1,0.022222222,0,empty,CD-0722-1
"B10,F2",1750971,2055011,1296434,758577,932467,519747,10,520290,414898,105392,3.936712464,312093,291281,48776,16214,15913,301,2412,6,0.052095771,0,hg38,CD-0722-1
"B10,F3",9451,10127,7047,3080,4951,2333,0,2342,1575,767,2.05345502,1299,3246,586,204,200,4,91,2,0.05,0,empty,CD-0722-1
"B10,F4",13828,14736,10382,4354,7002,3319,0,3323,2188,1135,1.927753304,1781,792,97,62,62,0,38,0,0.016129032,0,empty,CD-0722-1
"B10,F5",10482,11155,7917,3238,5323,2466,0,2471,1607,864,1.859953704,1367,2708,553,198,195,3,70,2,0.025641026,0,empty,CD-0722-1
"B10,F6",10896,12611,7984,4627,6006,3191,0,3197,2062,1135,1.816740088,1922,3540,795,328,326,2,115,2,0.088957055,0,empty,CD-0722-1
"B10,F7",13155,14844,9737,5107,6905,3457,1,3466,2255,1211,1.86209744,1978,1500,405,155,154,1,54,1,0.12987013,0,empty,CD-0722-1
"B10,F8",8230,9074,6062,3012,4283,2155,0,2157,1451,706,2.055240793,1225,298,54,19,18,1,10,1,0,0,empty,CD-0722-1
"B10,F9",9467,10472,7269,3203,4942,2321,0,2325,1504,821,1.831912302,1323,3589,832,290,286,4,96,2,0.055944056,0,empty,CD-0722-1
"B10,F10",12134,13555,9262,4293,6267,2997,0,3003,1906,1097,1.737465816,1685,2407,622,217,216,1,68,1,0.069444444,0,empty,CD-0722-1
"B10,F11",9276,10107,7097,3010,4798,2213,0,2216,1425,791,1.801517067,1224,1683,373,172,168,4,52,1,0.047619048,0,empty,CD-0722-1
"B10,F12",800704,959029,579302,379727,437119,255737,4,255976,192331,63645,3.021934166,157107,2073,835,279,279,0,67,0,0.129032258,0,hg38,CD-0722-1
"B10,G1",11757,12886,8859,4027,6116,3009,0,3019,2009,1010,1.989108911,1670,3423,627,234,228,6,114,3,0.052631579,0,empty,CD-0722-1
"B10,G2",6691,7311,4741,2570,3416,1767,0,1770,1126,644,1.748447205,1017,571,124,64,63,1,25,1,0,0,empty,CD-0722-1
"B10,G3",12216,13141,9077,4064,6397,3319,0,3326,2127,1199,1.773978315,1789,3384,868,312,311,1,100,1,0.147909968,0,empty,CD-0722-1
"B10,G4",21628,24521,15617,8904,11706,6517,0,6528,3919,2609,1.502108087,3819,223,27,20,18,2,15,2,0,0,empty,CD-0722-1
"B10,G5",8032,8925,5919,3006,4351,2173,0,2179,1411,768,1.837239583,1276,2180,378,166,165,1,66,1,0.042424242,0,empty,CD-0722-1
"B10,G6",11212,12416,8584,3832,5744,2800,0,2806,1858,948,1.959915612,1580,254,24,14,14,0,12,0,0.071428571,0,empty,CD-0722-1
"B10,G7",9369,9991,7122,2869,4744,2164,1,2171,1450,721,2.0110957,1169,3104,710,265,258,7,100,2,0.104651163,0,empty,CD-0722-1
"B10,G8",6433,7096,4806,2290,3497,1729,0,1731,1139,592,1.923986486,995,2242,465,185,183,2,70,2,0.092896175,0,empty,CD-0722-1
"B10,G9",717107,841066,534887,306179,387401,209471,2,209685,161781,47904,3.377191884,124527,94574,12838,4303,4164,139,882,4,0.03506244,0,hg38,CD-0722-1
"B10,G10",9840,11007,7473,3534,5281,2693,0,2696,1725,971,1.776519053,1552,3324,706,268,263,5,98,1,0.045627376,0,empty,CD-0722-1
"B10,G11",9685,10543,7356,3187,5064,2369,0,2377,1532,845,1.813017751,1356,2001,466,199,199,0,58,0,0.060301508,0,empty,CD-0722-1
"B10,G12",7357,8339,5436,2903,4058,2082,0,2082,1327,755,1.757615894,1266,3199,629,195,192,3,62,2,0.057291667,0,empty,CD-0722-1
"B10,H1",7911,8625,5946,2679,4065,1915,0,1916,1258,658,1.911854103,1063,1343,412,159,159,0,44,0,0.100628931,0,empty,CD-0722-1
"B10,H2",9744,11062,7157,3905,5244,2645,0,2647,1660,987,1.681864235,1567,2341,570,196,193,3,75,2,0.160621762,0,empty,CD-0722-1
"B10,H3",7856,8885,5917,2968,4080,2043,1,2044,1299,745,1.743624161,1185,1813,379,140,139,1,49,1,0.057553957,0,empty,CD-0722-1
"B10,H4",11253,12590,8434,4156,5862,2908,0,2913,1940,973,1.993833505,1654,371,99,56,56,0,27,0,0,0,empty,CD-0722-1
"B10,H5",757665,963460,509924,453536,448473,310124,2,310362,211206,99156,2.130037517,197427,3635,1023,402,396,6,130,3,0.128787879,0,hg38,CD-0722-1
"B10,H6",7611,8295,5693,2602,3941,2004,0,2008,1345,663,2.028657617,1169,2383,488,181,178,3,53,2,0.213483146,0,empty,CD-0722-1
"B10,H7",8871,9786,6654,3132,4625,2178,0,2180,1498,682,2.196480938,1208,2279,578,205,202,3,70,3,0.089108911,0,empty,CD-0722-1
"B10,H8",9494,10359,7047,3312,4823,2421,0,2426,1566,860,1.820930233,1351,2877,639,231,230,1,80,1,0.160869565,0,empty,CD-0722-1
"B10,H9",8191,9223,6132,3091,4302,2109,0,2113,1419,694,2.044668588,1202,1340,389,162,161,1,50,1,0.01863354,0,empty,CD-0722-1
"B10,H10",6752,7487,5100,2387,3496,1715,0,1719,1109,610,1.818032787,1010,1558,392,127,125,2,42,1,0.08,0,empty,CD-0722-1
"B10,H11",8492,9880,6070,3810,4658,2744,0,2749,1500,1249,1.200960769,1607,75,2,2,2,0,2,0,0,0,empty,CD-0722-1
"B10,H12",7841,8667,5800,2867,4071,2050,0,2051,1390,661,2.102874433,1200,2903,669,213,212,1,66,1,0.004716981,0,empty,CD-0722-1
"B11,A1",6417,7408,4763,2645,3461,1787,0,1789,1144,645,1.773643411,1017,924,199,81,78,3,25,1,0.128205128,0,empty,CD-0722-1
"B11,A2",10590,11606,7784,3822,5525,2865,0,2870,1847,1023,1.805474096,1615,2047,381,131,131,0,40,0,0.122137405,0,empty,CD-0722-1
"B11,A3",5767,6170,4199,1971,2930,1396,0,1396,907,489,1.854805726,826,601,77,49,48,1,27,1,0.041666667,0,empty,CD-0722-1
"B11,A4",999294,1152374,755528,396846,514937,273819,3,274138,223462,50676,4.409621912,157780,51668,7391,2525,2460,65,529,3,0.064227642,0,hg38,CD-0722-1
"B11,A5",9371,10297,6954,3343,4952,2463,0,2466,1576,890,1.770786517,1442,1890,427,126,123,3,39,2,0.12195122,0,empty,CD-0722-1
"B11,A6",7704,8821,5723,3098,4295,2290,0,2293,1466,827,1.77267231,1358,1956,499,187,187,0,56,0,0.096256684,0,empty,CD-0722-1
"B11,A7",6508,7442,4857,2585,3508,1839,0,1841,1200,641,1.872074883,1070,1002,222,80,78,2,35,2,0.076923077,0,empty,CD-0722-1
"B11,A8",3961,4368,3017,1351,2072,1051,0,1051,692,359,1.927576602,573,1914,492,151,149,2,49,1,0.100671141,0,empty,CD-0722-1
"B11,A9",7122,7906,5401,2505,3725,1813,0,1816,1199,617,1.943273906,1016,1384,433,129,129,0,37,0,0,0,empty,CD-0722-1
"B11,A10",384024,441777,291503,150274,205583,107787,2,107925,84944,22981,3.696270832,62893,20312,2422,790,763,27,188,4,0.056356488,0,hg38,CD-0722-1
"B11,A11",6193,6607,4680,1927,3263,1526,3,1531,1025,506,2.0256917,869,1365,450,118,118,0,39,0,0.042372881,0,empty,CD-0722-1
"B11,A12",8524,9317,6413,2904,4346,2122,0,2126,1421,705,2.015602837,1196,3215,959,296,291,5,68,2,0.147766323,0,empty,CD-0722-1
"B11,B1",7075,7748,5172,2576,3690,1905,0,1908,1209,699,1.729613734,1089,1092,223,100,100,0,23,0,0.11,0,empty,CD-0722-1
"B11,B2",7224,8023,4905,3118,3762,2011,0,2016,1229,787,1.561626429,1250,527,142,57,57,0,14,0,0,0,empty,CD-0722-1
"B11,B3",5471,6079,4052,2027,2983,1519,1,1520,927,593,1.563237774,831,762,149,53,53,0,31,0,0.132075472,0,empty,CD-0722-1
"B11,B4",7224,8201,5280,2921,3990,2157,0,2164,1394,770,1.81038961,1295,815,175,88,87,1,33,1,0.011494253,0,empty,CD-0722-1
"B11,B5",6679,3722,2118,1604,2415,1359,0,1373,894,479,1.866388309,917,788,143,53,53,0,19,0,0,0,empty,CD-0722-1
"B11,B6",7795,8765,5742,3023,4181,2179,0,2180,1324,856,1.546728972,1261,1448,321,120,120,0,32,0,0.033333333,0,empty,CD-0722-1
"B11,B7",7211,7913,5406,2507,3653,1733,0,1740,1169,571,2.047285464,984,1009,284,123,123,0,33,0,0.048780488,0,empty,CD-0722-1
"B11,B8",5593,6394,4175,2219,2930,1468,0,1473,970,503,1.928429423,854,770,186,52,51,1,25,1,0.039215686,0,empty,CD-0722-1
"B11,B9",9931,11028,7336,3692,5098,2642,0,2642,1640,1002,1.636726547,1476,696,143,43,42,1,19,1,0.023809524,0,empty,CD-0722-1
"B11,B10",5192,5704,3770,1934,2831,1432,0,1436,918,518,1.772200772,818,382,41,22,21,1,10,1,0.428571429,0,empty,CD-0722-1
"B11,B11",10865,12083,7849,4234,5751,3194,0,3200,1818,1382,1.315484805,1814,133,11,4,4,0,2,0,0,0,empty,CD-0722-1
"B11,B12",590730,690790,443322,247468,322100,170183,3,170361,128349,42012,3.055055698,101762,83142,9805,3207,3108,99,667,5,0.026061776,0,hg38,CD-0722-1
"B11,C1",664504,735245,513411,221834,335858,161328,2,161514,120579,40935,2.945621107,90381,49329,7207,2485,2437,48,471,3,0.086992204,0,hg38,CD-0722-1
"B11,C2",10054,11147,7317,3830,5228,2696,1,2703,1745,958,1.821503132,1561,1658,321,126,125,1,42,1,0.008,0,empty,CD-0722-1
"B11,C3",10617,11907,7988,3919,5613,2791,1,2793,1775,1018,1.743614931,1639,607,121,36,34,2,12,1,0.323529412,0,empty,CD-0722-1
"B11,C4",1111642,1224806,869691,355115,561895,263653,2,263965,205428,58537,3.509370142,145968,111661,14279,4703,4562,141,914,5,0.052608505,0,hg38,CD-0722-1
"B11,C5",9957,11506,7484,4022,5308,2622,0,2631,1700,931,1.825993555,1575,1305,303,99,98,1,43,1,0.081632653,0,empty,CD-0722-1
"B11,C6",8519,9582,6280,3302,4649,2376,5,2386,1648,738,2.233062331,1432,1062,318,98,98,0,38,0,0.040816327,0,empty,CD-0722-1
"B11,C7",11215,13091,8150,4941,6208,3471,0,3471,2075,1396,1.486389685,2082,290,34,12,12,0,7,0,0.166666667,0,empty,CD-0722-1
"B11,C8",12522,13761,9313,4448,6519,3217,1,3222,2048,1174,1.744463373,1730,2144,616,227,224,3,63,2,0.084821429,0,empty,CD-0722-1
"B11,C9",8640,9769,6316,3453,4653,2379,0,2381,1538,843,1.824436536,1427,928,236,63,63,0,23,0,0.063492063,0,empty,CD-0722-1
"B11,C10",9816,10673,7408,3265,5090,2520,0,2527,1595,932,1.711373391,1397,1689,343,116,114,2,46,2,0.078947368,0,empty,CD-0722-1
"B11,C11",8141,9129,5985,3144,4377,2194,1,2198,1378,820,1.680487805,1293,1643,355,151,151,0,47,0,0.039735099,0,empty,CD-0722-1
"B11,C12",11767,12767,8889,3878,6159,2994,0,2997,1997,1000,1.997,1702,1694,435,148,146,2,36,1,0.123287671,0,empty,CD-0722-1
"B11,D1",10647,12139,7660,4479,5755,3046,0,3052,1787,1265,1.412648221,1804,658,83,16,16,0,12,0,0.0625,0,empty,CD-0722-1
"B11,D2",8431,9007,6371,2636,4318,1991,0,1994,1337,657,2.03500761,1050,2039,668,218,212,6,59,1,0.117924528,0,empty,CD-0722-1
"B11,D3",8472,9474,6221,3253,4440,2320,0,2321,1509,812,1.858374384,1321,1275,246,74,68,6,31,1,0.088235294,0,empty,CD-0722-1
"B11,D4",5882,6670,4432,2238,3187,1573,0,1575,1032,543,1.900552486,902,1154,249,81,81,0,29,0,0.024691358,0,empty,CD-0722-1
"B11,D5",6962,7640,5303,2337,3698,1775,0,1776,1212,564,2.14893617,987,1171,202,80,78,2,37,2,0.038461538,0,empty,CD-0722-1
"B11,D6",10414,11615,7645,3970,5441,2928,0,2930,1810,1120,1.616071429,1705,1363,364,122,122,0,34,0,0.016393443,0,empty,CD-0722-1
"B11,D7",5901,6266,4423,1843,3036,1411,0,1419,943,476,1.981092437,819,1281,366,102,100,2,29,1,0.19,0,empty,CD-0722-1
"B11,D8",7444,8145,5599,2546,3770,1814,0,1817,1136,681,1.668135095,990,1308,374,116,116,0,40,0,0.017241379,0,empty,CD-0722-1
"B11,D9",387902,444494,290542,153952,207162,108903,0,108983,82561,26422,3.124706684,63897,120516,13987,4726,4609,117,940,6,0.04144066,0,hg38,CD-0722-1
"B11,D10",6834,7728,5067,2661,3511,1810,0,1813,1130,683,1.654465593,1027,667,125,48,47,1,11,1,0.063829787,0,empty,CD-0722-1
"B11,D11",716072,835099,532715,302384,381715,209319,0,209573,167419,42154,3.971604118,123698,103313,17980,5936,5831,105,1130,6,0.06242497,0,hg38,CD-0722-1
"B11,D12",9917,11041,7358,3683,5226,2634,0,2639,1638,1001,1.636363636,1507,2978,939,321,320,1,92,1,0.06875,0,empty,CD-0722-1
"B11,E1",12720,14142,9550,4592,6650,3379,0,3379,2101,1278,1.643974961,1923,2239,433,167,165,2,54,2,0.036363636,0,empty,CD-0722-1
"B11,E2",9035,9964,6629,3335,4754,2418,0,2422,1517,905,1.676243094,1405,1382,287,100,99,1,30,1,0.111111111,0,empty,CD-0722-1
"B11,E3",6050,6796,4647,2149,3208,1525,0,1526,962,564,1.705673759,853,2107,541,197,194,3,54,2,0.164948454,0,empty,CD-0722-1
"B11,E4",8778,9632,6517,3115,4530,2252,1,2256,1481,775,1.910967742,1246,1995,534,203,200,3,67,1,0.075,0,empty,CD-0722-1
"B11,E5",569109,631890,439336,192554,293503,142797,0,142979,110120,32859,3.35128884,79921,46206,8460,2858,2798,60,532,7,0.041100786,0,hg38,CD-0722-1
"B11,E6",594983,643286,467888,175398,293010,134086,4,134253,103970,30283,3.433279398,72370,73240,12174,4020,3927,93,744,4,0.03030303,0,hg38,CD-0722-1
"B11,E7",12280,13476,9322,4154,6408,3012,0,3018,1905,1113,1.711590296,1684,2596,655,198,194,4,52,2,0.092783505,0,empty,CD-0722-1
"B11,E8",9383,10059,7149,2910,4735,2155,0,2162,1432,730,1.961643836,1190,2031,395,134,133,1,28,1,0.127819549,0,empty,CD-0722-1
"B11,E9",6518,7130,4947,2183,3386,1691,0,1693,1136,557,2.039497307,944,2080,402,138,138,0,48,0,0.108695652,0,empty,CD-0722-1
"B11,E10",7092,7604,5489,2115,3552,1587,0,1589,1089,500,2.178,868,1644,395,137,134,3,43,1,0.298507463,0,empty,CD-0722-1
"B11,E11",8333,9457,6203,3254,4428,2206,0,2206,1470,736,1.997282609,1259,2112,433,122,119,3,32,1,0.008403361,0,empty,CD-0722-1
"B11,E12",10096,11433,7391,4042,5421,2777,0,2779,1816,963,1.885773624,1671,1331,309,122,122,0,33,0,0.163934426,0,empty,CD-0722-1
"B11,F1",10581,11515,7793,3722,5379,2627,0,2631,1608,1023,1.571847507,1520,1951,431,148,144,4,45,2,0.152777778,0,empty,CD-0722-1
"B11,F2",8699,9346,6494,2852,4500,2170,0,2172,1443,729,1.979423868,1202,2194,552,187,183,4,70,2,0.076502732,0,empty,CD-0722-1
"B11,F3",8405,9031,6234,2797,4233,2018,0,2021,1363,658,2.071428571,1110,2062,413,151,147,4,55,1,0.095238095,0,empty,CD-0722-1
"B11,F4",12133,12999,9178,3821,6135,2885,1,2888,1891,997,1.89669007,1608,535,111,49,45,4,17,1,0.088888889,0,empty,CD-0722-1
"B11,F5",9201,9600,6968,2632,4630,2098,0,2099,1356,743,1.825033647,1130,1362,261,115,114,1,45,1,0.105263158,0,empty,CD-0722-1
"B11,F6",10331,11560,7678,3882,5370,2794,1,2796,1824,972,1.87654321,1581,2503,618,208,206,2,61,1,0.131067961,0,empty,CD-0722-1
"B11,F7",11635,13316,8801,4515,6192,3153,0,3153,2099,1054,1.991461101,1847,879,114,62,59,3,25,1,0.016949153,0,empty,CD-0722-1
"B11,F8",7601,8454,5787,2667,3970,1889,0,1895,1185,710,1.669014085,1087,385,136,53,53,0,7,0,0.037735849,0,empty,CD-0722-1
"B11,F9",8972,9654,6931,2723,4533,2067,0,2069,1374,695,1.976978417,1075,2538,546,180,176,4,51,3,0.051136364,0,empty,CD-0722-1
"B11,F10",10396,11282,7925,3357,5252,2470,0,2474,1643,831,1.977135981,1334,1267,306,110,109,1,36,1,0,0,empty,CD-0722-1
"B11,F11",8972,9829,6904,2925,4524,2083,0,2085,1419,666,2.130630631,1114,1298,208,73,69,4,18,1,0,0,empty,CD-0722-1
"B11,F12",9047,10056,6762,3294,4700,2268,0,2271,1499,772,1.941709845,1282,312,106,22,22,0,7,0,0.045454545,0,empty,CD-0722-1
"B11,G1",11007,12238,8311,3927,5798,2813,0,2819,1816,1003,1.810568295,1595,2353,586,215,211,4,60,2,0.037914692,0,empty,CD-0722-1
"B11,G2",5946,6668,4256,2412,3088,1632,0,1632,1061,571,1.858143608,972,509,141,57,56,1,13,1,0.089285714,0,empty,CD-0722-1
"B11,G3",11894,12693,8558,4135,6061,3040,6,3051,1830,1221,1.498771499,1741,1969,478,129,126,3,54,2,0.079365079,0,empty,CD-0722-1
"B11,G4",19780,22220,14246,7974,10638,6001,0,6007,3636,2371,1.533530156,3513,60,9,6,6,0,5,0,0,0,empty,CD-0722-1
"B11,G5",6711,7488,5073,2415,3519,1705,0,1705,1085,620,1.75,971,1329,279,92,92,0,31,0,0.043478261,0,empty,CD-0722-1
"B11,G6",9398,10227,7058,3169,4750,2273,0,2282,1535,747,2.054886212,1294,203,61,31,31,0,9,0,0.258064516,0,empty,CD-0722-1
"B11,G7",8206,8878,6298,2580,4158,1846,0,1857,1165,692,1.683526012,963,2366,600,232,228,4,72,2,0.01754386,0,empty,CD-0722-1
"B11,G8",5752,6166,4326,1840,2907,1379,0,1381,886,495,1.78989899,792,1405,345,142,141,1,43,1,0.092198582,0,empty,CD-0722-1
"B11,G9",7090,7872,5261,2611,3738,1927,0,1930,1272,658,1.933130699,1133,1862,417,106,105,1,37,1,0.095238095,0,empty,CD-0722-1
"B11,G10",8777,10006,6538,3468,4790,2461,0,2461,1539,922,1.669197397,1434,2140,471,188,187,1,73,1,0.010695187,0,empty,CD-0722-1
"B11,G11",2381557,2855966,1738007,1117959,1290762,797315,6,798169,566474,231695,2.444912493,479796,80480,10959,3525,3423,102,687,3,0.105463044,0,hg38,CD-0722-1
"B11,G12",6758,7539,5026,2513,3677,1875,0,1875,1194,681,1.753303965,1075,1547,345,117,116,1,35,1,0.086206897,0,empty,CD-0722-1
"B11,H1",7580,8520,5677,2843,3996,1935,0,1937,1271,666,1.908408408,1129,864,225,69,69,0,25,0,0.115942029,0,empty,CD-0722-1
"B11,H2",9076,10278,6882,3396,4850,2435,0,2436,1603,833,1.924369748,1422,2073,538,185,184,1,54,1,0,0,empty,CD-0722-1
"B11,H3",7131,7918,5228,2690,3759,1885,0,1885,1214,671,1.80923994,1103,1473,353,139,139,0,34,0,0.050359712,0,empty,CD-0722-1
"B11,H4",10351,11762,7668,4094,5522,2770,0,2774,1824,950,1.92,1677,82,10,6,6,0,4,0,0,0,empty,CD-0722-1
"B11,H5",10452,11741,7726,4015,5550,2800,0,2808,1809,999,1.810810811,1663,1877,415,160,160,0,42,0,0.0625,0,empty,CD-0722-1
"B11,H6",6975,7785,5132,2653,3744,1962,0,1962,1304,658,1.981762918,1141,1556,444,127,126,1,35,1,0.079365079,0,empty,CD-0722-1
"B11,H7",7894,8517,5837,2680,4103,1974,1,1983,1280,703,1.820768137,1161,1333,220,100,99,1,39,1,0.04040404,0,empty,CD-0722-1
"B11,H8",8610,9837,6434,3403,4566,2338,1,2342,1481,861,1.720092915,1351,1448,333,108,108,0,29,0,0.333333333,0,empty,CD-0722-1
"B11,H9",7304,7891,5679,2212,3703,1773,0,1777,1200,577,2.079722704,937,1316,326,112,103,9,25,2,0.126213592,0,empty,CD-0722-1
"B11,H10",6018,6706,4505,2201,3186,1582,0,1590,1020,570,1.789473684,919,1042,265,90,88,2,30,1,0.125,0,empty,CD-0722-1
"B11,H11",12139,14950,8038,6912,7086,4854,0,4861,2171,2690,0.807063197,3045,49,9,5,5,0,3,0,0,0,empty,CD-0722-1
"B11,H12",7143,8067,5345,2722,3764,1909,2,1916,1280,636,2.012578616,1092,1338,276,100,97,3,34,2,0.030927835,0,empty,CD-0722-1
"B12,A1",7186,8254,5389,2865,3995,2096,0,2102,1308,794,1.647355164,1209,992,162,74,73,1,31,1,0.082191781,0,empty,CD-0722-1
"B12,A2",10749,11813,7962,3851,5644,2892,0,2893,1784,1109,1.608656447,1663,1517,367,119,119,0,49,0,0.042016807,0,empty,CD-0722-1
"B12,A3",6591,7351,4957,2394,3531,1743,0,1747,1116,631,1.768621236,1011,1007,199,65,65,0,20,0,0.030769231,0,empty,CD-0722-1
"B12,A4",11349,12565,8510,4055,5914,2953,0,2956,1880,1076,1.747211896,1676,761,141,53,53,0,23,0,0.150943396,0,empty,CD-0722-1
"B12,A5",10157,11063,7562,3501,5268,2543,1,2546,1617,929,1.74058127,1431,2369,639,209,208,1,61,1,0.076923077,0,empty,CD-0722-1
"B12,A6",8059,9382,6043,3339,4575,2372,0,2375,1534,841,1.824019025,1406,2556,652,237,237,0,66,0,0.05907173,0,empty,CD-0722-1
"B12,A7",7319,8132,5440,2692,3880,2022,0,2022,1277,745,1.71409396,1157,2555,631,229,226,3,61,2,0.10619469,0,empty,CD-0722-1
"B12,A8",4222,4646,3174,1472,2228,1068,0,1070,701,369,1.899728997,599,1839,383,130,130,0,41,0,0.069230769,0,empty,CD-0722-1
"B12,A9",7770,8533,6011,2522,3970,1891,0,1899,1198,701,1.708987161,1019,1516,294,124,121,3,39,1,0.099173554,0,empty,CD-0722-1
"B12,A10",952998,1078106,731567,346539,499986,248776,4,249078,178672,70406,2.537738261,142740,30213,3697,1246,1226,20,281,2,0.030995106,0,hg38,CD-0722-1
"B12,A11",6964,7658,5346,2312,3611,1687,0,1689,1107,582,1.902061856,959,1603,382,166,161,5,38,2,0.192546584,0,empty,CD-0722-1
"B12,A12",9271,9953,7000,2953,4594,2132,0,2136,1341,795,1.686792453,1132,3054,678,244,239,5,64,2,0.012552301,0,empty,CD-0722-1
"B12,B1",7834,8455,5929,2526,4127,2084,0,2088,1277,811,1.57459926,1138,1058,182,82,81,1,32,1,0.012345679,0,empty,CD-0722-1
"B12,B2",2205810,2555289,1569767,985522,1177917,675866,10,676544,542382,134162,4.042739375,410336,88851,10907,3640,3533,107,746,4,0.041607699,0,hg38,CD-0722-1
"B12,B3",6400,7360,4661,2699,3387,1714,0,1717,1097,620,1.769354839,1014,975,335,82,82,0,24,0,0.012195122,0,empty,CD-0722-1
"B12,B4",7801,8905,5754,3151,4270,2289,0,2293,1336,957,1.396029258,1363,1268,255,86,86,0,33,0,0.011627907,0,empty,CD-0722-1
"B12,B5",7708,4307,2563,1744,2817,1534,0,1542,1025,517,1.982591876,1006,982,181,63,60,3,16,2,0,0,empty,CD-0722-1
"B12,B6",8948,10128,6576,3552,4811,2550,0,2553,1522,1031,1.476236663,1513,1631,476,128,128,0,38,0,0.0546875,0,empty,CD-0722-1
"B12,B7",8018,8812,6070,2742,4158,2019,0,2023,1349,674,2.00148368,1143,995,228,78,77,1,25,1,0.051948052,0,empty,CD-0722-1
"B12,B8",5859,6169,4477,1692,2990,1439,0,1451,952,499,1.907815631,751,1090,203,72,72,0,25,0,0.013888889,0,empty,CD-0722-1
"B12,B9",11244,12431,8377,4054,5851,3034,0,3036,1887,1149,1.64229765,1744,841,286,89,87,2,32,1,0.137931034,0,empty,CD-0722-1
"B12,B10",5728,6040,4166,1874,2929,1403,0,1406,909,497,1.828973843,793,656,161,58,57,1,15,1,0.01754386,0,empty,CD-0722-1
"B12,B11",14841,17542,10248,7294,8240,4999,0,5004,2522,2482,1.016116035,3080,91,14,11,11,0,9,0,0,0,empty,CD-0722-1
"B12,B12",7112,7717,5250,2467,3771,1889,1,1891,1214,677,1.793205318,1073,1693,284,112,111,1,30,1,0.036036036,0,empty,CD-0722-1
"B12,C1",13789,14750,10477,4273,6965,3239,0,3246,1990,1256,1.584394904,1787,874,216,73,73,0,24,0,0.232876712,0,empty,CD-0722-1
"B12,C2",11558,13136,8484,4652,6014,3137,0,3145,2053,1092,1.88003663,1838,2058,639,200,197,3,51,2,0.005076142,0,empty,CD-0722-1
"B12,C3",11586,13091,8712,4379,6204,3093,0,3101,1957,1144,1.710664336,1765,1010,213,73,73,0,28,0,0.150684932,0,empty,CD-0722-1
"B12,C4",7567,8165,5712,2453,3948,1796,0,1798,1203,595,2.021848739,1015,1752,376,119,112,7,37,2,0.267857143,0,empty,CD-0722-1
"B12,C5",10970,12130,8374,3756,5849,2878,0,2880,1873,1007,1.859980139,1632,1897,411,155,154,1,50,1,0.090909091,0,empty,CD-0722-1
"B12,C6",9108,10036,6817,3219,4923,2361,0,2365,1491,874,1.705949657,1363,2034,362,126,123,3,41,2,0.06504065,0,empty,CD-0722-1
"B12,C7",13113,15514,9393,6121,7160,4055,0,4060,2516,1544,1.629533679,2447,347,71,33,33,0,15,0,0.484848485,0,empty,CD-0722-1
"B12,C8",14025,15780,10333,5447,7378,3738,0,3742,2336,1406,1.661450925,2210,2801,764,297,289,8,73,2,0.051903114,0,empty,CD-0722-1
"B12,C9",9840,11125,7351,3774,5188,2641,0,2643,1668,975,1.710769231,1530,1238,237,87,87,0,29,0,0,0,empty,CD-0722-1
"B12,C10",843627,985186,631268,353918,452584,248517,2,248742,185063,63679,2.906185713,146496,80624,12355,4142,4077,65,813,7,0.052734854,0,hg38,CD-0722-1
"B12,C11",9592,10553,7077,3476,5074,2505,1,2509,1622,887,1.828635851,1442,1930,654,200,200,0,49,0,0.125,0,empty,CD-0722-1
"B12,C12",13531,14591,10174,4417,6929,3347,0,3352,2186,1166,1.874785592,1894,2025,543,171,171,0,47,0,0.105263158,0,empty,CD-0722-1
"B12,D1",13069,14884,9302,5582,7104,3945,0,3949,2190,1759,1.245025583,2380,838,166,80,75,5,21,2,0.013333333,0,empty,CD-0722-1
"B12,D2",9582,10275,7269,3006,5034,2343,0,2345,1553,792,1.960858586,1288,2895,691,241,241,0,62,0,0.024896266,0,empty,CD-0722-1
"B12,D3",9070,10034,6612,3422,4837,2435,0,2435,1585,850,1.864705882,1401,1607,331,125,125,0,32,0,0.048,0,empty,CD-0722-1
"B12,D4",6548,7289,4954,2335,3452,1725,0,1729,1123,606,1.853135314,975,1169,213,65,63,2,24,1,0.031746032,0,empty,CD-0722-1
"B12,D5",7758,8562,5925,2637,4011,1982,0,1982,1272,710,1.791549296,1113,1866,512,150,148,2,39,1,0.074324324,0,empty,CD-0722-1
"B12,D6",11774,13394,8402,4992,6441,3540,0,3546,2088,1458,1.432098765,2139,1785,463,141,140,1,39,1,0.057142857,0,empty,CD-0722-1
"B12,D7",6918,7467,5189,2278,3564,1673,0,1675,1079,596,1.810402685,933,1817,363,106,104,2,41,2,0.038461538,0,empty,CD-0722-1
"B12,D8",7802,8947,5697,3250,4265,2193,0,2193,1322,871,1.517795637,1299,1553,566,187,187,0,38,0,0,0,empty,CD-0722-1
"B12,D9",767251,872161,594029,278132,404292,201916,2,202155,164465,37690,4.363624304,115118,194001,25561,8211,8051,160,1491,5,0.050552726,0,hg38,CD-0722-1
"B12,D10",7601,8747,5670,3077,4085,2081,9,2093,1299,794,1.636020151,1247,823,282,78,76,2,14,1,0.184210526,0,empty,CD-0722-1
"B12,D11",9120,9829,7049,2780,4739,2207,0,2209,1367,842,1.623515439,1190,3001,870,315,312,3,82,1,0.141025641,0,empty,CD-0722-1
"B12,D12",10988,12086,8294,3792,5698,2782,0,2788,1830,958,1.910229645,1580,3231,890,322,321,1,97,1,0.021806854,0,empty,CD-0722-1
"B12,E1",14199,15367,10500,4867,7249,3653,0,3658,2253,1405,1.603558719,2036,2397,653,200,199,1,69,1,0.110552764,0,empty,CD-0722-1
"B12,E2",10182,11353,7602,3751,5321,2693,0,2693,1675,1018,1.645383104,1530,1798,319,117,115,2,30,1,0.130434783,0,empty,CD-0722-1
"B12,E3",6796,7526,5086,2440,3688,1805,0,1808,1153,655,1.760305344,1022,2417,702,205,200,5,72,1,0.14,0,empty,CD-0722-1
"B12,E4",820991,963960,612949,351011,443275,241047,5,241286,184743,56543,3.267300992,144203,166107,24577,8328,8164,164,1436,5,0.060877021,0,hg38,CD-0722-1
"B12,E5",1516521,1771916,1159505,612411,801853,434176,1,434638,359054,75584,4.750396909,251274,104052,22203,6850,6762,88,1169,4,0.090062112,0,hg38,CD-0722-1
"B12,E6",14088,15780,10547,5233,7393,3758,0,3762,2271,1491,1.523138833,2160,2475,604,209,205,4,64,2,0.004878049,0,empty,CD-0722-1
"B12,E7",13100,14078,9930,4148,6680,3120,0,3122,2031,1091,1.861594867,1699,2705,700,216,213,3,68,1,0.051643192,0,empty,CD-0722-1
"B12,E8",10884,11952,8320,3632,5506,2599,6,2607,1665,942,1.767515924,1436,2120,524,151,149,2,53,1,0.053691275,0,empty,CD-0722-1
"B12,E9",6985,7676,5330,2346,3560,1648,0,1649,1076,573,1.877835951,916,2321,478,168,164,4,56,2,0.146341463,0,empty,CD-0722-1
"B12,E10",8072,9007,5923,3084,4215,2064,1,2065,1330,735,1.80952381,1217,1925,655,195,194,1,57,1,0.046391753,0,empty,CD-0722-1
"B12,E11",9386,10208,7161,3047,4902,2399,0,2403,1532,871,1.758897819,1283,2300,495,152,151,1,39,1,0.158940397,0,empty,CD-0722-1
"B12,E12",11863,13499,8786,4713,6384,3188,0,3192,2110,1082,1.950092421,1889,1809,501,143,143,0,35,0,0.146853147,0,empty,CD-0722-1
"B12,F1",11990,13031,9046,3985,6103,2931,0,2931,1872,1059,1.767705382,1662,1776,364,131,125,6,55,2,0.024,0,empty,CD-0722-1
"B12,F2",9493,10424,6991,3433,4941,2455,0,2459,1549,910,1.702197802,1390,2395,628,237,231,6,70,2,0.147186147,0,empty,CD-0722-1
"B12,F3",9027,10073,6683,3390,4773,2284,5,2289,1465,824,1.777912621,1342,2468,730,283,276,7,67,2,0.144927536,0,empty,CD-0722-1
"B12,F4",13300,14357,9962,4395,6831,3251,0,3254,2077,1177,1.764655905,1824,687,129,53,53,0,23,0,0.245283019,0,empty,CD-0722-1
"B12,F5",10910,11387,8242,3145,5494,2559,0,2560,1639,921,1.779587405,1378,2161,540,172,171,1,57,1,0.052631579,0,empty,CD-0722-1
"B12,F6",10867,12107,7955,4152,5702,2924,0,2933,1837,1096,1.676094891,1723,2795,582,197,192,5,77,2,0.046875,0,empty,CD-0722-1
"B12,F7",14885,15803,11004,4799,7491,3680,0,3685,2368,1317,1.798025816,2058,1038,292,99,99,0,36,0,0.04040404,0,empty,CD-0722-1
"B12,F8",8489,9478,6415,3063,4438,2142,0,2144,1418,726,1.953168044,1234,176,41,16,16,0,4,0,0,0,empty,CD-0722-1
"B12,F9",9672,10602,7441,3161,4920,2296,0,2296,1452,844,1.720379147,1250,2441,563,205,203,2,53,2,0.15270936,0,empty,CD-0722-1
"B12,F10",11793,12989,9084,3905,6089,2877,1,2884,1828,1056,1.731060606,1599,1971,430,125,123,2,34,2,0.016260163,0,empty,CD-0722-1
"B12,F11",9754,10565,7425,3140,5007,2290,0,2290,1497,793,1.88776797,1293,1396,443,165,163,2,34,1,0.110429448,0,empty,CD-0722-1
"B12,F12",10310,11387,7703,3684,5350,2597,0,2598,1553,1045,1.486124402,1495,146,36,29,29,0,16,0,0,0,empty,CD-0722-1
"B12,G1",1138797,1333437,854428,479009,609798,335837,4,336211,260572,75639,3.444942424,196869,49187,20651,6525,6493,32,1228,4,0.023563838,0,hg38,CD-0722-1
"B12,G2",682944,809488,472469,337019,379842,226863,0,227065,183014,44051,4.154593539,140075,15895,2927,916,909,7,215,2,0.056105611,0,hg38,CD-0722-1
"B12,G3",12173,13293,9036,4257,6313,3237,0,3240,1878,1362,1.378854626,1757,2582,712,216,211,5,71,2,0.042654028,0,empty,CD-0722-1
"B12,G4",21889,24511,16045,8466,11613,6426,0,6433,3902,2531,1.541683129,3700,133,19,10,10,0,7,0,0,0,empty,CD-0722-1
"B12,G5",7659,8221,5683,2538,3927,1861,1,1872,1203,669,1.798206278,1024,1463,333,127,124,3,34,2,0.008064516,0,empty,CD-0722-1
"B12,G6",1069059,1260906,792373,468533,577259,324535,2,324914,268806,56108,4.790867612,193706,8152,1462,497,485,12,128,3,0.144329897,0,hg38,CD-0722-1
"B12,G7",9364,10357,7170,3187,4882,2254,0,2257,1476,781,1.889884763,1285,2817,649,225,222,3,60,3,0.085585586,0,empty,CD-0722-1
"B12,G8",6330,6923,4707,2216,3381,1624,0,1632,1048,584,1.794520548,959,1398,250,108,106,2,39,2,0.235849057,0,empty,CD-0722-1
"B12,G9",7956,8854,5955,2899,4079,1989,0,1989,1300,689,1.886792453,1111,2277,531,172,172,0,54,0,0.069767442,0,empty,CD-0722-1
"B12,G10",9915,11305,7452,3853,5296,2696,0,2700,1694,1006,1.68389662,1532,2121,415,162,159,3,57,2,0.13836478,0,empty,CD-0722-1
"B12,G11",9698,10594,7404,3190,4960,2312,0,2312,1510,802,1.882793017,1257,1687,448,140,138,2,42,1,0.072463768,0,empty,CD-0722-1
"B12,G12",7876,8757,5742,3015,4085,2118,0,2119,1343,776,1.730670103,1213,2843,762,202,197,5,48,2,0.126903553,0,empty,CD-0722-1
"B12,H1",7708,8231,5788,2443,3967,1881,1,1885,1217,668,1.821856287,1031,1365,299,106,104,2,26,1,0.009615385,0,empty,CD-0722-1
"B12,H2",9214,10198,6910,3288,4659,2232,0,2234,1489,745,1.998657718,1250,1985,485,132,132,0,44,0,0.068181818,0,empty,CD-0722-1
"B12,H3",7713,8590,5675,2915,3948,1979,0,1980,1307,673,1.94205052,1144,1577,349,119,119,0,35,0,0.159663866,0,empty,CD-0722-1
"B12,H4",11106,12492,8319,4173,5907,2950,1,2962,1879,1083,1.734995383,1713,169,36,5,5,0,5,0,0,0,empty,CD-0722-1
"B12,H5",12557,13994,9299,4695,6489,3261,1,3274,2054,1220,1.683606557,1887,1914,452,166,166,0,36,0,0.030120482,0,empty,CD-0722-1
"B12,H6",7239,7865,5392,2473,3697,1829,0,1833,1169,664,1.760542169,1011,1808,435,135,135,0,40,0,0.059259259,0,empty,CD-0722-1
"B12,H7",8839,9729,6558,3171,4592,2195,0,2201,1386,815,1.700613497,1273,1805,605,191,190,1,52,1,0.094736842,0,empty,CD-0722-1
"B12,H8",9753,10938,7043,3895,5060,2593,0,2597,1627,970,1.677319588,1521,1982,379,147,145,2,47,2,0.2,0,empty,CD-0722-1
"B12,H9",7826,8684,6051,2633,3934,1777,0,1779,1163,616,1.887987013,959,878,200,81,81,0,24,0,0.049382716,0,empty,CD-0722-1
"B12,H10",6744,7504,5034,2470,3485,1686,0,1686,1091,595,1.833613445,943,1181,167,69,67,2,25,2,0.044776119,0,empty,CD-0722-1
"B12,H11",9117,10482,6427,4055,4985,2938,1,2939,1597,1342,1.190014903,1799,139,78,16,16,0,4,0,0,0,empty,CD-0722-1
"B12,H12",7505,8482,5523,2959,3987,2076,0,2079,1312,767,1.710560626,1214,1303,312,98,98,0,35,0,0.091836735,0,empty,CD-0722-1
"C1,A1",977744,1151685,737118,414567,534664,295004,3,295284,239057,56227,4.251640671,174968,141324,21161,7038,6886,152,1260,7,0.046325879,0,hg38,CD-0722-1
"C1,A2",9310,10343,7026,3317,4940,2569,0,2572,1627,945,1.721693122,1409,1786,374,182,181,1,86,1,0.033149171,0,empty,CD-0722-1
"C1,A3",5840,6263,4414,1849,3008,1461,0,1462,957,505,1.895049505,786,984,312,78,77,1,30,1,0.025974026,0,empty,CD-0722-1
"C1,A4",10611,11465,7812,3653,5490,2692,0,2698,1723,975,1.767179487,1525,955,219,86,84,2,43,1,0.05952381,0,empty,CD-0722-1
"C1,A5",8839,9480,6563,2917,4745,2325,0,2327,1525,802,1.901496259,1324,2036,413,173,171,2,81,2,0.128654971,0,empty,CD-0722-1
"C1,A6",1286179,1539577,966746,572831,710439,396927,2,397329,322330,74999,4.297790637,236855,221167,49383,15938,15740,198,2331,7,0.034307497,0,hg38,CD-0722-1
"C1,A7",6396,7161,4764,2397,3465,1739,0,1740,1055,685,1.540145985,1024,1357,295,144,142,2,78,2,0.042253521,0,empty,CD-0722-1
"C1,A8",373909,436393,283467,152926,205532,107644,0,107790,80741,27049,2.984990203,63615,112265,11053,3812,3673,139,850,7,0.036754696,0,hg38,CD-0722-1
"C1,A9",8503,9630,6307,3323,4631,2326,3,2329,1539,790,1.948101266,1353,1653,355,141,140,1,68,1,0.021428571,0,empty,CD-0722-1
"C1,A10",7064,7538,5396,2142,3648,1772,0,1773,1126,647,1.740340031,963,517,79,50,50,0,31,0,0.06,0,empty,CD-0722-1
"C1,A11",5964,6500,4568,1932,3212,1468,0,1475,1004,471,2.13163482,854,1857,411,155,154,1,70,1,0.103896104,0,empty,CD-0722-1
"C1,A12",7580,8331,5688,2643,3887,1900,4,1907,1205,702,1.716524217,1054,3107,891,345,338,7,82,2,0.094674556,0,empty,CD-0722-1
"C1,B1",6598,7342,4822,2520,3440,1725,0,1728,1043,685,1.522627737,986,1323,440,154,153,1,49,1,0.045751634,0,empty,CD-0722-1
"C1,B2",7854,8510,5432,3078,4127,2240,0,2244,1391,853,1.630715123,1330,551,83,55,55,0,26,0,0.072727273,0,empty,CD-0722-1
"C1,B3",6630,7419,4828,2591,3650,1917,0,1919,1280,639,2.00312989,1099,1127,143,72,71,1,35,1,0,0,empty,CD-0722-1
"C1,B4",6670,7238,4950,2288,3547,1834,0,1838,1172,666,1.75975976,1015,1402,218,134,134,0,69,0,0.007462687,0,empty,CD-0722-1
"C1,B5",6456,3371,1866,1505,2272,1279,0,1286,826,460,1.795652174,894,793,107,59,59,0,36,0,0.033898305,0,empty,CD-0722-1
"C1,B6",7326,7995,5416,2579,3858,1942,0,1948,1178,770,1.52987013,1117,1619,397,120,117,3,41,1,0.05982906,0,empty,CD-0722-1
"C1,B7",7650,8340,5699,2641,3985,1941,0,1942,1289,653,1.973966309,1120,916,225,95,95,0,39,0,0.126315789,0,empty,CD-0722-1
"C1,B8",5767,6489,4207,2282,3141,1584,0,1584,1067,517,2.063829787,903,1363,193,105,101,4,48,2,0.118811881,0,empty,CD-0722-1
"C1,B9",613771,718464,454543,263921,331288,182698,3,182875,138197,44678,3.09317785,109313,32302,5740,1865,1820,45,452,5,0.064835165,0,hg38,CD-0722-1
"C1,B10",5228,5272,3621,1651,2751,1358,0,1362,908,454,2,777,612,111,58,57,1,23,1,0,0,empty,CD-0722-1
"C1,B11",10148,11388,7441,3947,5375,2891,0,2893,1622,1271,1.276160504,1679,323,64,30,30,0,14,0,0.1,0,empty,CD-0722-1
"C1,B12",6086,6622,4616,2006,3283,1577,0,1579,1076,503,2.13916501,895,1500,275,122,120,2,58,1,0.066666667,0,empty,CD-0722-1
"C1,C1",12604,13325,9522,3803,6582,3134,0,3136,2064,1072,1.925373134,1706,1301,225,98,97,1,36,1,0.051546392,0,empty,CD-0722-1
"C1,C2",10377,11389,7565,3824,5620,2930,0,2933,1926,1007,1.912611718,1668,1620,476,182,180,2,61,1,0.072222222,0,empty,CD-0722-1
"C1,C3",10554,11786,7945,3841,5629,2785,0,2793,1801,992,1.815524194,1561,1005,198,90,90,0,31,0,0.111111111,0,empty,CD-0722-1
"C1,C4",6237,6731,4836,1895,3337,1579,0,1580,995,585,1.700854701,879,2325,722,243,239,4,69,3,0.10460251,0,empty,CD-0722-1
"C1,C5",11628,13414,8479,4935,6515,3493,8,3505,2450,1055,2.322274882,2153,1732,400,201,198,3,90,2,0.075757576,0,empty,CD-0722-1
"C1,C6",9154,10248,6767,3481,5090,2638,0,2638,1773,865,2.049710983,1562,2496,735,239,235,4,78,2,0.021276596,0,empty,CD-0722-1
"C1,C7",10995,12342,7890,4452,5946,3235,0,3240,1952,1288,1.51552795,1898,629,147,63,60,3,27,1,0.066666667,0,empty,CD-0722-1
"C1,C8",11694,12907,8782,4125,6158,3106,1,3110,2044,1066,1.917448405,1752,2838,745,273,270,3,100,2,0.137037037,0,empty,CD-0722-1
"C1,C9",8532,9836,6315,3521,4602,2331,0,2331,1536,795,1.932075472,1363,1696,271,125,124,1,36,1,0.137096774,0,empty,CD-0722-1
"C1,C10",9761,10489,7369,3120,4907,2303,0,2308,1485,823,1.804374241,1261,2595,567,228,225,3,75,3,0.04,0,empty,CD-0722-1
"C1,C11",8678,9597,6402,3195,4786,2338,0,2338,1545,793,1.948297604,1352,1802,290,126,124,2,68,1,0.169354839,0,empty,CD-0722-1
"C1,C12",12006,12766,9156,3610,5996,2754,0,2756,1771,985,1.797969543,1487,1736,445,158,158,0,49,0,0.037974684,0,empty,CD-0722-1
"C1,D1",9970,10921,7312,3609,5424,2850,0,2855,1738,1117,1.555953447,1592,811,174,52,49,3,33,1,0.204081633,0,empty,CD-0722-1
"C1,D2",8964,9606,6880,2726,4667,2204,0,2206,1458,748,1.949197861,1223,3093,609,266,262,4,102,3,0.122137405,0,empty,CD-0722-1
"C1,D3",8039,8919,5856,3063,4268,2179,1,2181,1422,759,1.873517787,1227,1569,292,141,139,2,73,1,0.021582734,0,empty,CD-0722-1
"C1,D4",6195,6952,4528,2424,3459,1744,0,1744,1177,567,2.075837743,999,1291,335,162,162,0,51,0,0.117283951,0,empty,CD-0722-1
"C1,D5",3129023,3610297,2331598,1278699,1614548,915696,8,916696,764912,151784,5.039477152,541069,462000,62568,20286,19867,419,2940,14,0.028841798,0,hg38,CD-0722-1
"C1,D6",1068693,1315137,724745,590392,610839,414294,2,414624,326238,88386,3.69105967,257237,8507,831,265,254,11,103,2,0.173228346,0,hg38,CD-0722-1
"C1,D7",5859,6642,4357,2285,3140,1576,0,1578,1022,556,1.838129496,926,1786,542,189,187,2,54,1,0.122994652,0,empty,CD-0722-1
"C1,D8",7206,8230,5454,2776,3941,1978,0,1986,1311,675,1.942222222,1179,1366,369,124,117,7,59,2,0.025641026,0,empty,CD-0722-1
"C1,D9",399332,454465,301742,152723,212745,108824,0,108941,84409,24532,3.440771238,63296,141212,16821,5547,5378,169,1075,5,0.055224991,0,hg38,CD-0722-1
"C1,D10",715859,839054,534678,304376,387934,209174,1,209416,164672,44744,3.680314679,124673,86663,10508,3757,3635,122,753,4,0.049243466,0,hg38,CD-0722-1
"C1,D11",1934920,2240757,1449414,791343,1010399,555579,6,556182,449495,106687,4.213212481,326100,307809,52721,16885,16591,294,2448,9,0.061961304,0,hg38,CD-0722-1
"C1,D12",10333,11618,7576,4042,5581,2812,0,2814,1824,990,1.842424242,1661,3668,765,325,320,5,129,3,0.028125,0,empty,CD-0722-1
"C1,E1",11865,12842,8816,4026,6152,3046,0,3049,1919,1130,1.698230088,1701,3208,645,250,238,12,114,2,0.021008403,0,empty,CD-0722-1
"C1,E2",2446260,2973964,1750882,1223082,1356611,828546,5,829345,671518,157827,4.254772631,513602,460747,65365,21406,20967,439,2901,10,0.075118043,0,hg38,CD-0722-1
"C1,E3",5928,6410,4491,1919,3034,1434,0,1436,872,564,1.546099291,804,2687,637,236,232,4,92,3,0.125,0,empty,CD-0722-1
"C1,E4",8780,9664,6371,3293,4719,2366,0,2369,1587,782,2.029411765,1380,2585,427,202,200,2,99,2,0.095,0,empty,CD-0722-1
"C1,E5",7420,8021,5633,2388,3931,1774,0,1774,1167,607,1.922570016,1005,1549,323,113,112,1,49,1,0.089285714,0,empty,CD-0722-1
"C1,E6",12671,13946,9513,4433,6513,3225,1,3235,2033,1202,1.691347754,1813,3071,620,252,252,0,84,0,0.047619048,0,empty,CD-0722-1
"C1,E7",665481,801800,487261,314539,366083,209993,2,210189,162888,47301,3.443648126,127704,34478,10494,3294,3264,30,760,3,0.073223039,0,hg38,CD-0722-1
"C1,E8",9429,10339,7411,2928,4773,2179,0,2179,1413,766,1.84464752,1148,2795,609,204,201,3,64,1,0.044776119,0,empty,CD-0722-1
"C1,E9",5878,6631,4236,2395,3220,1678,0,1682,1116,566,1.971731449,988,2719,616,257,253,4,96,2,0.007905138,0,empty,CD-0722-1
"C1,E10",7179,7769,5455,2314,3738,1693,0,1698,1089,609,1.78817734,925,1764,463,174,171,3,65,2,0.058479532,0,empty,CD-0722-1
"C1,E11",8024,9161,5903,3258,4319,2179,0,2184,1408,776,1.81443299,1300,1975,363,158,155,3,73,1,0.025806452,0,empty,CD-0722-1
"C1,E12",9384,10265,6950,3315,5001,2502,0,2503,1674,829,2.019300362,1441,2070,401,141,140,1,65,1,0.107142857,0,empty,CD-0722-1
"C1,F1",10469,11315,7797,3518,5373,2620,0,2625,1678,947,1.771911299,1473,1874,326,156,156,0,74,0,0.057692308,0,empty,CD-0722-1
"C1,F2",9127,9803,6763,3040,4730,2230,0,2234,1525,709,2.150916784,1242,4245,875,332,328,4,126,2,0.076219512,0,empty,CD-0722-1
"C1,F3",739585,845563,564083,281480,391526,200783,1,200981,149255,51726,2.885492789,116812,72959,9460,3007,2949,58,699,4,0.061376738,0,hg38,CD-0722-1
"C1,F4",12620,13692,9440,4252,6777,3300,0,3309,2151,1158,1.857512953,1865,616,96,69,69,0,41,0,0.028985507,0,empty,CD-0722-1
"C1,F5",812096,932615,603046,329569,423811,228487,0,228734,181644,47090,3.857379486,133713,144948,29919,10013,9890,123,1537,6,0.060060667,0,hg38,CD-0722-1
"C1,F6",9599,10344,6992,3352,5030,2561,0,2567,1655,912,1.814692982,1462,2997,646,218,215,3,98,2,0.060465116,0,empty,CD-0722-1
"C1,F7",11413,12810,8552,4258,6139,3095,1,3104,2061,1043,1.976030681,1778,1504,251,131,126,5,63,1,0.063492063,0,empty,CD-0722-1
"C1,F8",7574,8292,5747,2545,3913,1947,0,1949,1271,678,1.874631268,1066,270,84,35,33,2,18,2,0.181818182,0,empty,CD-0722-1
"C1,F9",8297,9037,6248,2789,4242,2089,1,2095,1384,711,1.946554149,1161,2474,636,233,227,6,78,2,0.092511013,0,empty,CD-0722-1
"C1,F10",10874,12112,8329,3783,5735,2694,0,2697,1833,864,2.121527778,1503,1938,420,139,136,3,48,1,0.117647059,0,empty,CD-0722-1
"C1,F11",7743,8490,5932,2558,4096,1895,0,1901,1279,622,2.056270096,1043,1825,297,102,100,2,37,2,0.06,0,empty,CD-0722-1
"C1,F12",8897,9785,6649,3136,4560,2249,0,2254,1485,769,1.931079324,1265,215,46,32,32,0,17,0,0.15625,0,empty,CD-0722-1
"C1,G1",9999,11223,7494,3729,5432,2629,0,2637,1767,870,2.031034483,1525,3521,830,348,344,4,151,2,0.043604651,0,empty,CD-0722-1
"C1,G2",6002,6590,4141,2449,3153,1637,0,1641,1050,591,1.776649746,974,582,214,83,83,0,25,0,0.156626506,0,empty,CD-0722-1
"C1,G3",1359926,1615333,1018882,596451,735362,417917,3,418379,350454,67925,5.159425837,246768,282534,46852,15502,15238,264,2364,7,0.070941068,0,hg38,CD-0722-1
"C1,G4",995582,1157249,748484,408765,526047,280853,1,281146,233508,47638,4.901717117,164739,1750,471,144,144,0,44,0,0.131944444,0,hg38,CD-0722-1
"C1,G5",610493,713408,458203,255205,330988,174367,3,174573,130705,43868,2.979506702,103814,177878,26733,9210,9023,187,1489,7,0.062285271,0,hg38,CD-0722-1
"C1,G6",150645,137236,132164,5072,66362,6072,0,6111,3757,2354,1.596006797,2177,223,26,24,24,0,13,0,0.166666667,0,empty,CD-0722-1
"C1,G7",8655,9434,6424,3010,4813,2358,0,2362,1654,708,2.336158192,1280,2549,454,179,177,2,83,1,0.079096045,0,empty,CD-0722-1
"C1,G8",5365,5718,4042,1676,2710,1251,0,1255,799,456,1.752192982,668,1672,374,129,127,2,63,2,0.062992126,0,empty,CD-0722-1
"C1,G9",7068,7963,5217,2746,3753,1836,0,1842,1162,680,1.708823529,1062,2543,506,163,162,1,74,1,0.086419753,0,empty,CD-0722-1
"C1,G10",579339,648559,447980,200579,302883,146590,1,146757,120240,26517,4.534449598,81819,179616,31767,10487,10347,140,1642,6,0.040011598,0,hg38,CD-0722-1
"C1,G11",7959,8683,6070,2613,4183,1946,1,1952,1290,662,1.948640483,1068,1540,428,154,154,0,65,0,0.032467532,0,empty,CD-0722-1
"C1,G12",7820,8785,5698,3087,4145,2131,0,2138,1348,790,1.706329114,1271,3091,656,248,245,3,84,2,0.102040816,0,empty,CD-0722-1
"C1,H1",6784,7383,4946,2437,3623,1789,0,1791,1173,618,1.898058252,1045,1224,146,73,73,0,38,0,0.054794521,0,empty,CD-0722-1
"C1,H2",9938,10940,7401,3539,5251,2615,0,2622,1794,828,2.166666667,1537,2095,414,166,165,1,71,1,0.012121212,0,empty,CD-0722-1
"C1,H3",6613,7357,4900,2457,3459,1746,0,1748,1127,621,1.814814815,1010,1416,318,144,142,2,68,2,0.147887324,0,empty,CD-0722-1
"C1,H4",10016,10795,7585,3210,5161,2512,0,2515,1662,853,1.948417351,1386,216,29,24,23,1,15,1,0.173913043,0,empty,CD-0722-1
"C1,H5",10743,12227,7973,4254,5552,2808,0,2812,1811,1001,1.809190809,1622,1552,303,121,120,1,52,1,0.058333333,0,empty,CD-0722-1
"C1,H6",6122,7013,4506,2507,3283,1715,0,1715,1101,614,1.793159609,1003,1473,309,113,112,1,56,1,0.142857143,0,empty,CD-0722-1
"C1,H7",7528,8219,5664,2555,3911,1893,0,1897,1222,675,1.81037037,1024,2221,565,222,220,2,92,2,0.072727273,0,empty,CD-0722-1
"C1,H8",884711,1066247,645514,420733,498896,309564,1,309835,219640,90195,2.435168247,185742,10747,1598,540,533,7,150,3,0.253283302,0,hg38,CD-0722-1
"C1,H9",8143,8964,6241,2723,4331,2081,0,2081,1418,663,2.138763198,1160,885,202,62,62,0,28,0,0.016129032,0,empty,CD-0722-1
"C1,H10",6447,7107,4739,2368,3406,1706,0,1707,1163,544,2.137867647,969,1050,188,80,79,1,35,1,0.050632911,0,empty,CD-0722-1
"C1,H11",7885,9511,5478,4033,4499,2742,0,2747,1468,1279,1.147771697,1714,79,6,4,4,0,4,0,0,0,empty,CD-0722-1
"C1,H12",524571,580607,399006,181601,272376,134975,2,135139,106412,28727,3.704250357,76975,48413,8342,2551,2506,45,547,3,0.040702314,0,hg38,CD-0722-1
"C2,A1",5653,6108,4065,2043,2912,1510,0,1510,960,550,1.745454545,867,1234,232,78,78,0,27,0,0.269230769,0,empty,CD-0722-1
"C2,A2",8506,9750,6299,3451,4632,2441,0,2443,1525,918,1.661220044,1438,1691,388,164,163,1,53,1,0.006134969,0,empty,CD-0722-1
"C2,A3",5225,5652,3854,1798,2665,1330,0,1330,855,475,1.8,741,1224,274,94,93,1,26,1,0.064516129,0,empty,CD-0722-1
"C2,A4",8639,9394,6511,2883,4425,2148,3,2153,1369,784,1.746173469,1166,904,214,98,98,0,26,0,0.030612245,0,empty,CD-0722-1
"C2,A5",7368,7792,5502,2290,3803,1810,0,1817,1122,695,1.614388489,983,1738,339,101,100,1,40,1,0.18,0,empty,CD-0722-1
"C2,A6",11175,12486,8471,4015,6143,3130,1,3134,2197,937,2.344717182,1798,2423,743,247,246,1,74,1,0.012195122,0,empty,CD-0722-1
"C2,A7",5518,6077,4124,1953,2949,1533,0,1534,945,589,1.604414261,872,1156,219,77,70,7,33,2,0.014285714,0,empty,CD-0722-1
"C2,A8",3217,3527,2402,1125,1720,872,0,872,596,276,2.15942029,491,1833,420,170,170,0,54,0,0.064705882,0,empty,CD-0722-1
"C2,A9",5822,6490,4368,2122,3033,1494,0,1495,953,542,1.758302583,847,1534,338,104,104,0,37,0,0.163461538,0,empty,CD-0722-1
"C2,A10",6707,7278,5038,2240,3529,1724,0,1724,1081,643,1.68118196,967,379,99,36,36,0,15,0,0.111111111,0,empty,CD-0722-1
"C2,A11",5424,5806,4110,1696,2700,1245,0,1245,845,400,2.1125,637,1463,403,119,112,7,34,3,0.026785714,0,empty,CD-0722-1
"C2,A12",486754,532588,377690,154898,245496,116866,1,116990,90199,26791,3.366764958,64543,90998,14674,4864,4760,104,910,5,0.032142857,0,hg38,CD-0722-1
"C2,B1",6249,6871,4714,2157,3162,1602,0,1605,1009,596,1.69295302,908,1308,524,170,170,0,45,0,0.005882353,0,empty,CD-0722-1
"C2,B2",475863,538779,328264,210515,254026,143453,1,143592,119203,24389,4.887572266,87423,77263,7328,2538,2468,70,581,5,0.059967585,0,hg38,CD-0722-1
"C2,B3",6427,7008,4745,2263,3381,1685,0,1687,1143,544,2.101102941,962,1057,222,87,87,0,31,0,0.057471264,0,empty,CD-0722-1
"C2,B4",6100,6893,4427,2466,3334,1779,0,1780,1135,645,1.759689922,1060,1034,171,81,81,0,40,0,0.037037037,0,empty,CD-0722-1
"C2,B5",5665,3130,1819,1311,2021,1073,0,1088,682,406,1.679802956,729,617,121,48,47,1,17,1,0.042553191,0,empty,CD-0722-1
"C2,B6",6377,7237,4663,2574,3531,1843,0,1847,1145,702,1.631054131,1109,1435,446,108,108,0,31,0,0.305555556,0,empty,CD-0722-1
"C2,B7",5947,6740,4511,2229,3203,1588,5,1595,1083,512,2.115234375,949,867,205,85,85,0,28,0,0.129411765,0,empty,CD-0722-1
"C2,B8",4506,4831,3480,1351,2369,1102,0,1103,731,372,1.965053763,613,1211,210,92,92,0,43,0,0.141304348,0,empty,CD-0722-1
"C2,B9",8234,9329,5918,3411,4492,2378,0,2385,1488,897,1.658862876,1424,739,187,43,42,1,21,1,0.238095238,0,empty,CD-0722-1
"C2,B10",4818,5105,3367,1738,2513,1252,0,1271,826,445,1.856179775,758,370,43,30,30,0,12,0,0,0,empty,CD-0722-1
"C2,B11",11893,13620,8572,5048,6322,3507,0,3507,2147,1360,1.578676471,2043,123,11,4,4,0,3,0,0.25,0,empty,CD-0722-1
"C2,B12",5506,6042,4135,1907,2868,1393,5,1404,933,471,1.98089172,782,1353,198,86,86,0,30,0,0.302325581,0,empty,CD-0722-1
"C2,C1",10449,11282,8069,3213,5321,2527,0,2531,1582,949,1.667017914,1362,571,106,51,51,0,25,0,0.039215686,0,empty,CD-0722-1
"C2,C2",8530,9510,6141,3369,4380,2237,2,2241,1483,758,1.95646438,1284,1698,471,187,185,2,48,2,0.102702703,0,empty,CD-0722-1
"C2,C3",10645,11536,7966,3570,5582,2727,4,2738,1745,993,1.757301108,1530,876,179,73,73,0,27,0,0.260273973,0,empty,CD-0722-1
"C2,C4",751403,879702,561798,317904,405672,223431,1,223668,180565,43103,4.189151567,131212,155139,27552,8771,8618,153,1449,6,0.038524019,0,hg38,CD-0722-1
"C2,C5",8528,9394,6401,2993,4565,2279,1,2281,1498,783,1.913154534,1292,1773,467,181,174,7,62,2,0.143678161,0,empty,CD-0722-1
"C2,C6",7240,7811,5310,2501,3839,1950,0,1950,1280,670,1.910447761,1117,1720,600,222,221,1,75,1,0.049773756,0,empty,CD-0722-1
"C2,C7",9680,11395,7011,4384,5328,2974,0,2977,1755,1222,1.436170213,1802,280,55,19,19,0,14,0,0.157894737,0,empty,CD-0722-1
"C2,C8",258972,316613,173935,142678,148798,99527,0,99616,67003,32613,2.054487474,62066,3751,1030,268,267,1,103,1,0.048689139,0,hg38,CD-0722-1
"C2,C9",7300,8159,5376,2783,3876,1921,0,1925,1228,697,1.761836442,1130,1345,324,103,103,0,32,0,0,0,empty,CD-0722-1
"C2,C10",636156,743017,467732,275285,344124,191280,5,191475,163965,27510,5.960196292,113413,121729,21170,6798,6702,96,1204,5,0.044613548,0,hg38,CD-0722-1
"C2,C11",7037,7955,5154,2801,3775,1903,0,1903,1246,657,1.896499239,1119,1785,488,183,182,1,47,1,0.071428571,0,empty,CD-0722-1
"C2,C12",10126,11129,7664,3465,5250,2558,0,2563,1686,877,1.922462942,1488,1635,505,178,176,2,42,2,0.068181818,0,empty,CD-0722-1
"C2,D1",985465,1147127,750833,396294,528149,282322,4,282671,231610,51061,4.5359472,165124,33886,4033,1364,1345,19,355,3,0.036431227,0,hg38,CD-0722-1
"C2,D2",7477,8027,5721,2306,3771,1685,1,1692,1090,602,1.810631229,915,2599,632,244,241,3,76,2,0.058091286,0,empty,CD-0722-1
"C2,D3",6852,7937,4967,2970,3751,2024,0,2025,1328,697,1.905308465,1183,1207,379,121,121,0,40,0,0.082644628,0,empty,CD-0722-1
"C2,D4",5030,5601,3700,1901,2687,1310,0,1310,821,489,1.678936605,782,1212,291,113,113,0,46,0,0.097345133,0,empty,CD-0722-1
"C2,D5",6077,6657,4606,2051,3199,1515,0,1515,959,556,1.724820144,855,1634,345,140,134,6,52,2,0.029850746,0,empty,CD-0722-1
"C2,D6",9193,10157,6664,3493,4753,2567,0,2567,1513,1054,1.435483871,1496,1518,390,142,142,0,36,0,0,0,empty,CD-0722-1
"C2,D7",5127,5608,3802,1806,2709,1267,0,1268,856,412,2.077669903,723,1452,334,118,117,1,51,1,0.094017094,0,empty,CD-0722-1
"C2,D8",5957,6564,4445,2119,3117,1517,0,1517,1053,464,2.269396552,846,1513,547,181,181,0,52,0,0.165745856,0,empty,CD-0722-1
"C2,D9",3841,4257,2818,1439,2053,978,0,980,653,327,1.996941896,587,1431,254,106,102,4,41,1,0.019607843,0,empty,CD-0722-1
"C2,D10",5969,6564,4387,2177,3156,1614,0,1614,1023,591,1.730964467,911,734,126,50,50,0,20,0,0,0,empty,CD-0722-1
"C2,D11",6930,7638,5142,2496,3673,1799,0,1799,1161,638,1.819749216,1042,2698,718,233,225,8,82,2,0.137777778,0,empty,CD-0722-1
"C2,D12",9062,10193,6791,3402,4813,2417,0,2423,1582,841,1.881093936,1365,4387,1218,434,427,7,119,2,0.152224824,0,empty,CD-0722-1
"C2,E1",10685,11387,7932,3455,5471,2765,0,2777,1764,1013,1.74136229,1479,2588,481,212,211,1,66,1,0.028436019,0,empty,CD-0722-1
"C2,E2",7389,8157,5558,2599,3924,1971,0,1973,1274,699,1.82260372,1116,1719,275,101,100,1,40,1,0.01,0,empty,CD-0722-1
"C2,E3",5056,5519,3864,1655,2632,1201,0,1203,796,407,1.955773956,661,2278,475,207,206,1,66,1,0.111650485,0,empty,CD-0722-1
"C2,E4",7003,7657,5296,2361,3543,1637,0,1637,1055,582,1.812714777,898,2273,446,171,167,4,75,2,0.095808383,0,empty,CD-0722-1
"C2,E5",6116,6662,4651,2011,3223,1547,0,1555,983,572,1.718531469,848,1536,372,147,147,0,42,0,0.183673469,0,empty,CD-0722-1
"C2,E6",10542,12009,7866,4143,5688,2957,1,2963,1904,1059,1.797922568,1737,2580,700,287,282,5,80,2,0.15248227,0,empty,CD-0722-1
"C2,E7",441585,493451,338110,155341,232169,116516,0,116641,90495,26146,3.461141284,66628,38945,8810,2697,2665,32,497,4,0.013508443,0,hg38,CD-0722-1
"C2,E8",8050,8878,6176,2702,4156,1935,1,1939,1276,663,1.924585219,1067,2999,628,225,224,1,63,1,0.049107143,0,empty,CD-0722-1
"C2,E9",5514,6179,4073,2106,2886,1446,0,1446,993,453,2.19205298,822,2331,606,242,242,0,68,0,0.066115702,0,empty,CD-0722-1
"C2,E10",638386,753205,473461,279744,348501,192915,0,193114,148955,44159,3.373151566,115790,106485,17047,5315,5230,85,1080,7,0.060038241,0,hg38,CD-0722-1
"C2,E11",6954,7676,5279,2397,3630,1786,2,1792,1149,643,1.786936236,998,1920,447,139,138,1,54,1,0.043478261,0,empty,CD-0722-1
"C2,E12",740042,885055,544179,340876,410248,232841,3,233097,178954,54143,3.305210276,141148,35434,4658,1604,1561,43,420,4,0.024983985,0,hg38,CD-0722-1
"C2,F1",8884,9513,6597,2916,4478,2129,0,2133,1306,827,1.579201935,1181,1666,419,154,151,3,50,2,0.033112583,0,empty,CD-0722-1
"C2,F2",682307,791289,508667,282622,365568,194276,4,194496,148651,45845,3.24246919,116148,137796,13711,4481,4346,135,967,6,0.042337782,0,hg38,CD-0722-1
"C2,F3",1099979,1231433,843935,387498,566644,282473,3,282783,219050,63733,3.436994963,161494,194646,26180,8398,8206,192,1489,5,0.056665854,0,hg38,CD-0722-1
"C2,F4",10012,10493,7587,2906,5042,2294,1,2306,1479,827,1.788391778,1260,527,104,39,39,0,16,0,0.358974359,0,empty,CD-0722-1
"C2,F5",8090,8821,6025,2796,4202,1985,0,1986,1220,766,1.592689295,1154,1630,416,157,157,0,56,0,0.006369427,0,empty,CD-0722-1
"C2,F6",8643,9603,6324,3279,4535,2362,0,2364,1469,895,1.641340782,1359,2929,759,240,233,7,71,2,0.111587983,0,empty,CD-0722-1
"C2,F7",9636,10859,7382,3477,5052,2535,4,2541,1643,898,1.829621381,1379,1370,511,145,144,1,46,1,0.090277778,0,empty,CD-0722-1
"C2,F8",1022740,1219303,762032,457271,555222,313919,0,314233,259576,54657,4.749181258,186278,19796,3555,1150,1133,17,250,2,0.075904678,0,hg38,CD-0722-1
"C2,F9",7368,8020,5720,2300,3620,1633,0,1635,1033,602,1.715946844,863,2536,760,239,238,1,62,1,0.06302521,0,empty,CD-0722-1
"C2,F10",9082,9798,6914,2884,4598,2155,0,2155,1396,759,1.839262187,1165,1596,529,155,154,1,43,1,0.11038961,0,empty,CD-0722-1
"C2,F11",7476,8302,5676,2626,3814,1804,0,1811,1190,621,1.91626409,979,1752,291,108,106,2,29,1,0.20754717,0,empty,CD-0722-1
"C2,F12",7941,8854,5966,2888,4087,1980,0,1980,1304,676,1.928994083,1139,50,10,7,7,0,7,0,0.142857143,0,empty,CD-0722-1
"C2,G1",8631,9437,6377,3060,4621,2297,0,2297,1487,810,1.835802469,1318,2454,707,205,199,6,83,2,0.140703518,0,empty,CD-0722-1
"C2,G2",586944,682940,418046,264894,319075,180105,1,180257,141542,38715,3.655998967,109675,29480,4677,1468,1426,42,302,2,0.056802244,0,hg38,CD-0722-1
"C2,G3",9641,10478,7028,3450,4971,2568,0,2570,1533,1037,1.478302797,1432,2880,649,246,243,3,85,2,0.04526749,0,empty,CD-0722-1
"C2,G4",16933,18845,12231,6614,9102,5010,0,5017,3118,1899,1.641916798,2906,147,18,8,8,0,5,0,0,0,empty,CD-0722-1
"C2,G5",5963,6629,4436,2193,3140,1559,0,1564,1028,536,1.917910448,847,1516,298,96,94,2,39,1,0.021276596,0,empty,CD-0722-1
"C2,G6",8453,9350,6399,2951,4293,2058,0,2059,1357,702,1.933048433,1160,144,44,18,18,0,10,0,0,0,empty,CD-0722-1
"C2,G7",7008,7670,5232,2438,3623,1689,0,1691,1079,612,1.763071895,943,2264,538,186,183,3,60,2,0.06010929,0,empty,CD-0722-1
"C2,G8",4976,5512,3748,1764,2558,1250,0,1252,783,469,1.669509595,735,1313,347,122,121,1,50,1,0.074380165,0,empty,CD-0722-1
"C2,G9",5734,6523,4262,2261,3170,1640,1,1643,1061,582,1.823024055,980,1909,506,141,138,3,54,1,0.195652174,0,empty,CD-0722-1
"C2,G10",523413,606671,386315,220356,282079,154569,3,154715,123680,31035,3.985178025,91371,149426,23417,7802,7634,168,1378,5,0.048074404,0,hg38,CD-0722-1
"C2,G11",7290,7946,5404,2542,3820,1849,0,1854,1171,683,1.714494876,1064,1074,257,93,92,1,38,1,0.065217391,0,empty,CD-0722-1
"C2,G12",5819,6571,4356,2215,3133,1568,0,1572,1001,571,1.753064799,888,1689,359,121,113,8,51,2,0.097345133,0,empty,CD-0722-1
"C2,H1",6297,6626,4662,1964,3164,1452,1,1459,952,507,1.877712032,792,1114,219,74,69,5,23,2,0.086956522,0,empty,CD-0722-1
"C2,H2",6708,7527,4922,2605,3562,1801,0,1801,1137,664,1.712349398,1056,2848,733,237,233,4,57,2,0.068669528,0,empty,CD-0722-1
"C2,H3",5791,6312,4314,1998,2989,1425,0,1433,912,521,1.750479846,813,1262,251,89,89,0,35,0,0.02247191,0,empty,CD-0722-1
"C2,H4",677341,788764,498700,290064,362757,200831,3,201034,161894,39140,4.13628002,119539,5994,709,216,212,4,68,1,0.023584906,0,hg38,CD-0722-1
"C2,H5",9037,10046,6664,3382,4616,2301,0,2307,1395,912,1.529605263,1330,1826,449,127,122,5,42,2,0.098360656,0,empty,CD-0722-1
"C2,H6",5862,6675,4448,2227,3146,1686,0,1686,1121,565,1.984070796,960,1611,389,125,124,1,41,1,0.040322581,0,empty,CD-0722-1
"C2,H7",6418,6959,4826,2133,3352,1583,0,1583,1072,511,2.097847358,842,2047,504,183,182,1,58,1,0.071428571,0,empty,CD-0722-1
"C2,H8",557140,701133,385291,315842,323845,217838,2,218042,150123,67919,2.210324062,134705,11404,1418,451,428,23,100,3,0.338785047,0,hg38,CD-0722-1
"C2,H9",5552,5928,4262,1666,2871,1264,1,1268,839,429,1.955710956,698,1460,307,106,104,2,33,2,0.173076923,0,empty,CD-0722-1
"C2,H10",5126,5364,3758,1606,2618,1264,0,1266,849,417,2.035971223,687,1296,312,94,93,1,30,1,0.010752688,0,empty,CD-0722-1
"C2,H11",6858,7897,4739,3158,3817,2301,0,2306,1271,1035,1.228019324,1372,60,10,6,6,0,6,0,0.166666667,0,empty,CD-0722-1
"C2,H12",686041,792100,514197,277903,369652,200435,3,200688,158505,42183,3.757556362,118107,13399,2613,783,774,9,212,3,0.027131783,0,hg38,CD-0722-1
"C3,A1",623759,715568,472227,243341,335854,176161,1,176308,130764,45544,2.871157562,102434,127902,14107,4530,4386,144,883,5,0.062243502,0,hg38,CD-0722-1
"C3,A2",8796,9969,6540,3429,4693,2471,0,2471,1613,858,1.87995338,1434,1836,436,167,166,1,75,1,0.030120482,0,empty,CD-0722-1
"C3,A3",5884,6399,4409,1990,3034,1483,1,1486,1004,482,2.082987552,829,1363,263,112,110,2,30,2,0.018181818,0,empty,CD-0722-1
"C3,A4",10460,11929,7732,4197,5426,2747,0,2749,1749,1000,1.749,1576,936,110,28,28,0,20,0,0.035714286,0,empty,CD-0722-1
"C3,A5",691380,803921,509397,294524,370419,205034,1,205238,166982,38256,4.3648578,120851,135110,20549,6692,6587,105,1270,5,0.05267952,0,hg38,CD-0722-1
"C3,A6",353739,415589,266824,148765,196176,106721,2,106847,82045,24802,3.307999355,62790,59605,10517,3567,3487,80,717,4,0.034700315,0,hg38,CD-0722-1
"C3,A7",641314,771193,471184,300009,357915,205029,4,205235,164656,40579,4.057665295,124142,172418,25977,8688,8513,175,1540,8,0.056619288,0,hg38,CD-0722-1
"C3,A8",3927,4397,2929,1468,2034,1054,1,1057,720,337,2.136498516,594,2697,350,150,146,4,60,1,0.047945205,0,empty,CD-0722-1
"C3,A9",6771,7576,5095,2481,3547,1779,0,1783,1117,666,1.677177177,995,1960,387,154,153,1,60,1,0.137254902,0,empty,CD-0722-1
"C3,A10",6619,7282,5081,2201,3448,1638,0,1640,1044,596,1.751677852,925,547,138,42,41,1,18,1,0,0,empty,CD-0722-1
"C3,A11",2054594,2340861,1589588,751273,1048323,552495,5,553161,451217,101944,4.426126108,313793,271688,36717,12132,11847,285,1896,9,0.059339917,0,hg38,CD-0722-1
"C3,A12",7467,7991,5799,2192,3740,1711,1,1716,1111,605,1.836363636,947,3148,832,288,287,1,87,1,0.031358885,0,empty,CD-0722-1
"C3,B1",6506,7035,4783,2252,3400,1697,0,1699,1044,655,1.59389313,959,1186,232,83,81,2,37,1,0.049382716,0,empty,CD-0722-1
"C3,B2",7533,8241,5243,2998,3919,2047,8,2055,1256,799,1.571964956,1234,644,141,50,50,0,17,0,0.02,0,empty,CD-0722-1
"C3,B3",7163,8297,5235,3062,3946,2049,0,2053,1399,654,2.139143731,1226,1395,333,113,113,0,42,0,0.327433628,0,empty,CD-0722-1
"C3,B4",6062,6944,4351,2593,3349,1810,0,1810,1157,653,1.771822358,1098,1576,265,97,97,0,54,0,0.103092784,0,empty,CD-0722-1
"C3,B5",6776,3790,2172,1618,2389,1327,1,1343,877,466,1.881974249,900,996,194,72,72,0,29,0,0.055555556,0,empty,CD-0722-1
"C3,B6",7063,7794,5252,2542,3721,1931,0,1935,1227,708,1.733050847,1091,1522,438,149,148,1,39,1,0.006756757,0,empty,CD-0722-1
"C3,B7",916805,1087929,679057,408872,499158,283677,3,283956,215012,68944,3.118647018,168481,87798,19061,6037,5934,103,1065,4,0.037074486,0,hg38,CD-0722-1
"C3,B8",5151,5856,3962,1894,2726,1320,0,1325,879,446,1.970852018,736,1302,200,60,57,3,30,1,0.035087719,0,empty,CD-0722-1
"C3,B9",8802,9775,6531,3244,4614,2361,0,2363,1557,806,1.931761787,1309,1093,274,76,74,2,28,2,0,0,empty,CD-0722-1
"C3,B10",4761,5287,3383,1904,2539,1257,3,1268,790,478,1.652719665,752,398,59,30,30,0,14,0,0.233333333,0,empty,CD-0722-1
"C3,B11",9744,10930,6979,3951,5075,2793,0,2798,1576,1222,1.289689034,1641,295,120,43,43,0,25,0,0.046511628,0,empty,CD-0722-1
"C3,B12",5890,6189,4512,1677,2996,1381,4,1391,863,528,1.634469697,739,1220,279,82,78,4,41,1,0.153846154,0,empty,CD-0722-1
"C3,C1",12459,13446,9429,4017,6207,2967,0,2967,1841,1126,1.634991119,1628,831,160,69,66,3,31,1,0.060606061,0,empty,CD-0722-1
"C3,C2",9656,10798,7110,3688,5089,2614,0,2624,1618,1006,1.608349901,1515,1846,368,154,153,1,41,1,0.058823529,0,empty,CD-0722-1
"C3,C3",10351,11473,7668,3805,5372,2664,0,2665,1715,950,1.805263158,1533,807,134,60,60,0,27,0,0.016666667,0,empty,CD-0722-1
"C3,C4",6155,6618,4628,1990,3187,1479,0,1481,945,536,1.763059701,806,1800,309,126,122,4,60,3,0.057377049,0,empty,CD-0722-1
"C3,C5",808047,965899,590827,375072,446035,256647,0,256911,206629,50282,4.109402967,155178,83541,14115,4650,4563,87,870,4,0.079333772,0,hg38,CD-0722-1
"C3,C6",7469,8191,5482,2709,4116,2057,3,2063,1384,679,2.038291605,1174,1795,341,148,147,1,72,1,0.088435374,0,empty,CD-0722-1
"C3,C7",10324,11992,7483,4509,5525,2984,1,2996,1836,1160,1.582758621,1749,652,179,50,50,0,25,0,0.06,0,empty,CD-0722-1
"C3,C8",11202,12464,8357,4107,5961,3012,0,3013,1958,1055,1.855924171,1728,3204,826,286,276,10,101,2,0.083333333,0,empty,CD-0722-1
"C3,C9",7961,8894,5954,2940,4170,2104,0,2109,1360,749,1.815754339,1213,1690,330,143,143,0,52,0,0.104895105,0,empty,CD-0722-1
"C3,C10",564350,618436,438665,179771,286037,134084,2,134244,103597,30647,3.380330864,74611,45250,9025,2792,2742,50,543,5,0.019328957,0,hg38,CD-0722-1
"C3,C11",8210,8952,6118,2834,4249,2059,0,2063,1344,719,1.869262865,1156,2078,447,163,158,5,62,2,0.025316456,0,empty,CD-0722-1
"C3,C12",11667,12594,8792,3802,5921,2865,0,2869,1832,1037,1.766634523,1642,1788,471,150,147,3,58,2,0.102040816,0,empty,CD-0722-1
"C3,D1",9453,10721,6895,3826,5167,2692,2,2694,1661,1033,1.607938045,1638,808,58,39,37,2,24,2,0.108108108,0,empty,CD-0722-1
"C3,D2",752084,851040,575043,275997,390905,201379,0,201610,157672,43938,3.588511084,114011,224464,42216,13770,13561,209,1998,6,0.04557186,0,hg38,CD-0722-1
"C3,D3",1354352,1582252,1002393,579859,730146,410045,4,410449,347977,62472,5.570127417,244071,137449,16796,5479,5328,151,1112,7,0.050863363,0,hg38,CD-0722-1
"C3,D4",5564,6226,4131,2095,3004,1514,2,1518,1010,508,1.988188976,853,1224,277,116,114,2,50,2,0.254385965,0,empty,CD-0722-1
"C3,D5",6748,7631,5025,2606,3620,1803,0,1806,1154,652,1.76993865,1055,1882,331,168,165,3,69,1,0.090909091,0,empty,CD-0722-1
"C3,D6",9875,10996,7154,3842,5086,2645,0,2651,1659,992,1.672379032,1520,1581,289,90,90,0,41,0,0.055555556,0,empty,CD-0722-1
"C3,D7",5606,6134,4187,1947,2894,1366,0,1370,885,485,1.824742268,764,1956,487,160,158,2,54,2,0.126582278,0,empty,CD-0722-1
"C3,D8",689411,816469,509092,307377,377663,208941,2,209166,169747,39419,4.306222887,125505,95876,18520,6271,6191,80,1113,7,0.033758682,0,hg38,CD-0722-1
"C3,D9",3686,4061,2795,1266,2073,1028,0,1029,704,325,2.166153846,620,1847,338,155,154,1,66,1,0.032467532,0,empty,CD-0722-1
"C3,D10",6779,7543,4941,2602,3580,1887,0,1890,1177,713,1.650771388,1153,917,190,82,82,0,15,0,0.012195122,0,empty,CD-0722-1
"C3,D11",7338,8132,5511,2621,4034,1978,0,1980,1276,704,1.8125,1158,3608,934,331,327,4,119,2,0.04587156,0,empty,CD-0722-1
"C3,D12",9688,10784,7197,3587,5122,2516,1,2517,1638,879,1.863481229,1492,3912,840,279,275,4,100,3,0.090909091,0,empty,CD-0722-1
"C3,E1",12062,13145,8978,4167,6111,3093,0,3096,1988,1108,1.794223827,1729,3167,669,227,223,4,101,2,0.112107623,0,empty,CD-0722-1
"C3,E2",8773,9768,6488,3280,4589,2288,0,2294,1462,832,1.757211538,1329,2208,609,236,235,1,66,1,0.076595745,0,empty,CD-0722-1
"C3,E3",5954,6741,4518,2223,3206,1523,0,1523,955,568,1.681338028,912,2633,830,302,294,8,84,2,0.095238095,0,empty,CD-0722-1
"C3,E4",7968,8763,5967,2796,4213,2051,0,2053,1321,732,1.804644809,1192,2493,494,188,187,1,84,1,0.122994652,0,empty,CD-0722-1
"C3,E5",7259,7859,5611,2248,3735,1698,0,1698,1072,626,1.712460064,915,1544,309,152,150,2,62,1,0.073333333,0,empty,CD-0722-1
"C3,E6",11876,12972,8852,4120,6084,3030,2,3035,1989,1046,1.901529637,1690,2984,583,227,225,2,64,1,0.173333333,0,empty,CD-0722-1
"C3,E7",11017,12262,8365,3897,5877,2836,1,2855,1813,1042,1.739923225,1613,2895,499,199,196,3,87,2,0.051020408,0,empty,CD-0722-1
"C3,E8",9543,10342,7326,3016,4799,2292,0,2294,1455,839,1.73420739,1249,2949,671,218,210,8,59,2,0.042857143,0,empty,CD-0722-1
"C3,E9",5597,6391,4165,2226,2944,1484,1,1485,966,519,1.861271676,843,2553,469,178,177,1,79,1,0.039548023,0,empty,CD-0722-1
"C3,E10",7163,7764,5415,2349,3666,1755,0,1757,1185,572,2.071678322,969,2280,581,211,210,1,73,1,0.042857143,0,empty,CD-0722-1
"C3,E11",8262,9054,6217,2837,4233,2081,0,2083,1337,746,1.792225201,1142,2442,471,197,195,2,95,1,0.092307692,0,empty,CD-0722-1
"C3,E12",8305,9423,5983,3440,4374,2243,1,2252,1478,774,1.909560724,1324,2194,439,166,158,8,88,2,0.082278481,0,empty,CD-0722-1
"C3,F1",10370,11354,7595,3759,5326,2665,0,2676,1720,956,1.79916318,1514,1869,267,113,113,0,54,0,0.150442478,0,empty,CD-0722-1
"C3,F2",8121,8611,6094,2517,4208,1977,0,1977,1318,659,2,1107,2990,599,218,212,6,106,2,0.033018868,0,empty,CD-0722-1
"C3,F3",1455800,1732108,1061829,670279,788217,456117,2,456540,364753,91787,3.97390698,276362,301048,56527,18442,18163,279,2526,7,0.061443594,0,hg38,CD-0722-1
"C3,F4",12896,13197,9297,3900,6301,2950,1,2958,1890,1068,1.769662921,1647,793,173,62,57,5,22,1,0,0,empty,CD-0722-1
"C3,F5",581441,637280,443268,194012,293840,142139,0,142313,109164,33149,3.293131015,79942,58112,10099,3396,3360,36,698,6,0.043154762,0,hg38,CD-0722-1
"C3,F6",8758,9626,6379,3247,4588,2352,0,2352,1522,830,1.83373494,1337,3737,919,289,285,4,109,1,0.038596491,0,empty,CD-0722-1
"C3,F7",976045,1164052,715533,448519,534204,306649,0,306920,240770,66150,3.639758125,184465,63493,11053,3557,3480,77,665,3,0.043390805,0,hg38,CD-0722-1
"C3,F8",612962,736579,444106,292473,343726,211090,2,211300,141109,70191,2.010357453,127855,2576,135,52,50,2,29,2,0.24,0,empty,CD-0722-1
"C3,F9",7958,8649,6005,2644,4123,1943,1,1952,1262,690,1.828985507,1107,3155,720,245,242,3,68,2,0.136363636,0,empty,CD-0722-1
"C3,F10",10914,12029,8271,3758,5546,2587,5,2594,1673,921,1.8165038,1462,2207,615,220,220,0,57,0,0.095454545,0,empty,CD-0722-1
"C3,F11",645762,726390,489265,237125,333325,169941,2,170139,133533,36606,3.647844616,97464,312014,32552,11175,10789,386,1812,9,0.087959959,0,hg38,CD-0722-1
"C3,F12",8775,10124,6433,3691,4639,2294,0,2294,1498,796,1.881909548,1366,128,8,7,7,0,6,0,0,0,empty,CD-0722-1
"C3,G1",9816,10981,7387,3594,5323,2554,0,2557,1675,882,1.899092971,1492,2901,692,263,255,8,114,2,0.047058824,0,empty,CD-0722-1
"C3,G2",5750,6509,4041,2468,2988,1583,0,1585,1022,563,1.815275311,924,682,177,69,69,0,27,0,0.115942029,0,empty,CD-0722-1
"C3,G3",11726,12914,8700,4214,6149,3113,1,3116,1961,1155,1.697835498,1735,2395,589,184,183,1,86,1,0.032786885,0,empty,CD-0722-1
"C3,G4",18546,20942,13467,7475,9783,5377,0,5380,3283,2097,1.565569862,3033,258,42,26,25,1,18,1,0.04,0,empty,CD-0722-1
"C3,G5",6718,7441,4982,2459,3527,1680,0,1682,1074,608,1.766447368,942,1614,295,120,116,4,48,2,0.043103448,0,empty,CD-0722-1
"C3,G6",9491,10224,7296,2928,4822,2294,0,2296,1497,799,1.87359199,1219,176,56,24,24,0,11,0,0,0,empty,CD-0722-1
"C3,G7",7807,8496,5978,2518,4089,1937,0,1937,1255,682,1.840175953,1063,2547,497,179,177,2,77,1,0.073446328,0,empty,CD-0722-1
"C3,G8",5620,6212,4118,2094,2876,1390,0,1393,861,532,1.618421053,838,1544,397,184,183,1,61,1,0.224043716,0,empty,CD-0722-1
"C3,G9",6558,7142,4966,2176,3375,1571,0,1572,1006,566,1.777385159,891,2712,683,251,250,1,68,1,0.124,0,empty,CD-0722-1
"C3,G10",661771,772122,491945,280177,358833,198469,2,198663,162920,35743,4.558095291,116716,42138,5476,1756,1726,30,541,2,0.074159907,0,hg38,CD-0722-1
"C3,G11",8133,8945,6129,2816,4241,2044,0,2050,1320,730,1.808219178,1201,1859,253,83,79,4,50,3,0.012658228,0,empty,CD-0722-1
"C3,G12",6705,7508,4983,2525,3561,1777,2,1780,1184,596,1.986577181,1023,2182,371,152,151,1,56,1,0.013245033,0,empty,CD-0722-1
"C3,H1",6351,6932,4679,2253,3306,1562,0,1567,1063,504,2.109126984,902,1534,478,160,159,1,40,1,0.006289308,0,empty,CD-0722-1
"C3,H2",7620,8274,5752,2522,3953,1905,0,1917,1256,661,1.900151286,1067,2577,641,232,224,8,69,2,0.049107143,0,empty,CD-0722-1
"C3,H3",6267,6703,4589,2114,3167,1543,0,1551,994,557,1.784560144,829,1884,425,148,145,3,61,2,0.117241379,0,empty,CD-0722-1
"C3,H4",9829,10697,7295,3402,5029,2442,0,2451,1583,868,1.823732719,1375,253,45,25,25,0,18,0,0,0,empty,CD-0722-1
"C3,H5",10707,12257,7823,4434,5638,2961,0,2966,1868,1098,1.701275046,1756,2371,742,226,226,0,61,0,0.066371681,0,empty,CD-0722-1
"C3,H6",5667,6473,4164,2309,2984,1577,0,1577,1061,516,2.05620155,917,1585,389,166,166,0,69,0,0,0,empty,CD-0722-1
"C3,H7",7558,7806,5652,2154,3686,1711,0,1718,1129,589,1.916808149,919,2049,376,169,163,6,78,2,0.098159509,0,empty,CD-0722-1
"C3,H8",7767,8482,5601,2881,4028,2050,0,2053,1317,736,1.789402174,1212,2316,333,124,120,4,48,2,0.125,0,empty,CD-0722-1
"C3,H9",6230,6828,4615,2213,3152,1463,0,1463,945,518,1.824324324,821,821,133,55,55,0,27,0,0.036363636,0,empty,CD-0722-1
"C3,H10",5461,5966,3992,1974,2942,1453,0,1454,963,491,1.961303462,866,1159,255,105,105,0,43,0,0.20952381,0,empty,CD-0722-1
"C3,H11",6858,7662,4718,2944,3696,2185,0,2187,1191,996,1.195783133,1319,84,18,12,12,0,7,0,0.166666667,0,empty,CD-0722-1
"C3,H12",5697,6221,4247,1974,2966,1525,0,1533,1014,519,1.953757225,844,1695,266,116,114,2,47,2,0.175438596,0,empty,CD-0722-1
"C4,A1",8074,9132,5957,3175,4380,2272,0,2274,1474,800,1.8425,1328,1729,370,146,145,1,60,1,0.082758621,0,empty,CD-0722-1
"C4,A2",685905,742378,547396,194982,339563,144837,4,145032,107621,37411,2.876720751,77602,182022,29157,9859,9662,197,1558,4,0.049265162,0,hg38,CD-0722-1
"C4,A3",611285,760529,421708,338821,355950,236539,0,236737,170674,66063,2.583503625,147634,6778,730,242,234,8,63,2,0.294871795,0,hg38,CD-0722-1
"C4,A4",12346,13475,9345,4130,6382,3101,0,3103,2048,1055,1.941232227,1693,1059,225,76,75,1,45,1,0.013333333,0,empty,CD-0722-1
"C4,A5",11283,12766,8521,4245,6011,2974,0,2974,1913,1061,1.803016023,1705,2937,611,226,225,1,86,1,0.071111111,0,empty,CD-0722-1
"C4,A6",9437,10914,7025,3889,5375,2882,0,2883,1856,1027,1.807205453,1738,3723,657,240,238,2,118,1,0.079831933,0,empty,CD-0722-1
"C4,A7",8318,9385,6232,3153,4444,2280,0,2280,1430,850,1.682352941,1309,1519,198,110,108,2,63,1,0.037037037,0,empty,CD-0722-1
"C4,A8",681913,772253,523701,248552,363390,184384,3,184556,149596,34960,4.279061785,105348,148081,21696,7373,7206,167,1250,5,0.036219817,0,hg38,CD-0722-1
"C4,A9",8577,9673,6506,3167,4636,2286,0,2286,1455,831,1.750902527,1322,2194,529,234,232,2,80,1,0.185344828,0,empty,CD-0722-1
"C4,A10",331375,429256,219569,209687,207051,147795,0,147893,113104,34789,3.251142603,94020,663,104,39,38,1,26,1,0,0,empty,CD-0722-1
"C4,A11",859806,1021670,636415,385255,468630,266759,3,267024,207457,59567,3.482750516,159048,40528,9273,2911,2870,41,666,5,0.055749129,0,hg38,CD-0722-1
"C4,A12",10983,12007,8305,3702,5649,2704,0,2711,1748,963,1.815160955,1497,4242,1178,421,419,2,101,2,0.183770883,0,empty,CD-0722-1
"C4,B1",8729,9569,6579,2990,4494,2246,0,2250,1406,844,1.665876777,1234,1415,262,116,115,1,46,1,0.086956522,0,empty,CD-0722-1
"C4,B2",9528,10509,6561,3948,5044,2749,0,2749,1752,997,1.757271815,1676,786,104,60,58,2,29,1,0.034482759,0,empty,CD-0722-1
"C4,B3",7494,8806,5437,3369,4157,2196,3,2203,1440,763,1.887287025,1366,1811,511,172,171,1,53,1,0.046783626,0,empty,CD-0722-1
"C4,B4",9555,10989,6867,4122,5329,2987,0,2993,1851,1142,1.62084063,1754,2223,553,201,199,2,91,2,0.040201005,0,empty,CD-0722-1
"C4,B5",10028,6322,3887,2435,3841,2033,1,2049,1335,714,1.869747899,1293,1078,142,58,55,3,18,1,0.4,0,empty,CD-0722-1
"C4,B6",10025,11113,7301,3812,5288,2795,0,2801,1817,984,1.846544715,1610,2213,639,211,206,5,64,2,0.160194175,0,empty,CD-0722-1
"C4,B7",9164,10192,6877,3315,4756,2268,0,2273,1506,767,1.963494133,1283,1322,309,125,124,1,43,1,0.032258065,0,empty,CD-0722-1
"C4,B8",6891,7401,5170,2231,3540,1667,0,1672,1133,539,2.102040816,915,1786,376,149,146,3,64,2,0.075342466,0,empty,CD-0722-1
"C4,B9",12609,14178,9285,4893,6772,3621,0,3623,2273,1350,1.683703704,2083,1299,308,118,117,1,55,1,0.025641026,0,empty,CD-0722-1
"C4,B10",615040,645640,441927,203713,311257,146740,20,147523,107538,39985,2.689458547,85536,50941,6836,2321,2270,51,474,3,0.036563877,0,hg38,CD-0722-1
"C4,B11",19171,21841,14059,7782,10055,5406,1,5410,3310,2100,1.576190476,3172,353,48,26,24,2,17,2,0.125,0,empty,CD-0722-1
"C4,B12",8064,9252,5966,3286,4367,2269,0,2269,1443,826,1.746973366,1338,1756,257,123,122,1,56,1,0.057377049,0,empty,CD-0722-1
"C4,C1",871565,978719,666750,311969,444406,223677,1,223942,177369,46573,3.808408305,126449,51170,7231,2397,2355,42,563,7,0.047983015,0,hg38,CD-0722-1
"C4,C2",12569,13764,9304,4460,6520,3306,0,3307,2150,1157,1.858254105,1900,2972,765,252,247,5,76,2,0.198380567,0,empty,CD-0722-1
"C4,C3",840356,958845,637177,321668,444370,232258,3,232539,179760,52779,3.405900074,135025,15195,1977,679,673,6,174,3,0.034175334,0,hg38,CD-0722-1
"C4,C4",9166,9735,6961,2774,4650,2176,0,2183,1409,774,1.820413437,1221,2751,499,208,205,3,87,2,0.112195122,0,empty,CD-0722-1
"C4,C5",13343,14914,9973,4941,7030,3506,0,3511,2306,1205,1.913692946,1994,2574,603,236,232,4,93,2,0.038793103,0,empty,CD-0722-1
"C4,C6",11264,12509,8268,4241,6175,3226,4,3233,2064,1169,1.765611634,1915,2430,520,202,198,4,86,2,0.101010101,0,empty,CD-0722-1
"C4,C7",14328,16807,10121,6686,8006,4594,0,4600,2656,1944,1.366255144,2835,749,140,71,69,2,33,1,0,0,empty,CD-0722-1
"C4,C8",22788,25152,16064,9088,11749,6487,0,6492,4073,2419,1.683753617,3779,4009,1054,360,359,1,113,1,0.108635097,0,empty,CD-0722-1
"C4,C9",11257,12488,8597,3891,5920,2861,0,2867,1857,1010,1.838613861,1616,2125,470,152,144,8,60,3,0.201388889,0,empty,CD-0722-1
"C4,C10",1828517,2098220,1379981,718239,939144,510041,5,510558,403845,106713,3.784403025,295080,138806,14626,4780,4633,147,1126,6,0.026764515,0,hg38,CD-0722-1
"C4,C11",10460,11737,7787,3950,5560,2787,0,2789,1833,956,1.917364017,1655,2384,457,167,166,1,87,1,0.06626506,0,empty,CD-0722-1
"C4,C12",15518,17185,11627,5558,8012,3804,0,3816,2444,1372,1.781341108,2141,2044,446,209,209,0,66,0,0.052631579,0,empty,CD-0722-1
"C4,D1",13057,15008,9426,5582,7149,3907,0,3912,2369,1543,1.535320804,2334,1331,294,107,106,1,44,1,0.141509434,0,empty,CD-0722-1
"C4,D2",11256,12144,8453,3691,5777,2706,1,2713,1690,1023,1.65200391,1472,3342,834,291,288,3,117,1,0.0625,0,empty,CD-0722-1
"C4,D3",10902,11987,8082,3905,5648,2845,0,2852,1865,987,1.889564336,1632,1985,457,202,199,3,80,2,0.08040201,0,empty,CD-0722-1
"C4,D4",7714,8836,5660,3176,4123,2089,0,2089,1209,880,1.373863636,1240,2282,516,210,203,7,69,1,0.167487685,0,empty,CD-0722-1
"C4,D5",8953,9853,6683,3170,4678,2315,0,2317,1532,785,1.951592357,1316,1868,367,169,163,6,86,1,0.018404908,0,empty,CD-0722-1
"C4,D6",13254,14489,9618,4871,6943,3727,0,3728,2286,1442,1.585298197,2137,2257,646,211,210,1,56,1,0.171428571,0,empty,CD-0722-1
"C4,D7",7445,7828,5627,2201,3731,1701,0,1703,1125,578,1.946366782,919,2472,709,223,223,0,77,0,0.067264574,0,empty,CD-0722-1
"C4,D8",1135422,1373279,826466,546813,623154,362142,4,362508,264441,98067,2.696534002,224041,48610,6196,1901,1857,44,497,6,0.018847604,0,hg38,CD-0722-1
"C4,D9",1047321,1212423,779338,433085,557467,306060,3,306376,239755,66621,3.598790171,180755,308054,64711,21123,20881,242,2805,6,0.054451415,0,hg38,CD-0722-1
"C4,D10",9344,10399,6849,3550,4742,2420,0,2427,1542,885,1.742372881,1426,999,231,93,91,2,32,1,0.120879121,0,empty,CD-0722-1
"C4,D11",10553,11895,8092,3803,5687,2760,0,2765,1802,963,1.871235722,1580,3978,974,352,343,9,135,2,0.204081633,0,empty,CD-0722-1
"C4,D12",1186489,1383528,875170,508358,627672,349563,6,349935,291211,58724,4.95897759,207402,144414,30333,9922,9771,151,1613,7,0.051683553,0,hg38,CD-0722-1
"C4,E1",959998,1133652,701580,432072,517620,297800,5,298138,232383,65755,3.534073454,177549,81339,18463,5822,5771,51,1127,4,0.079362329,0,hg38,CD-0722-1
"C4,E2",969633,1146739,720426,426313,526287,292927,1,293250,231666,61584,3.761788776,175430,110401,20994,6944,6850,94,1252,7,0.077518248,0,hg38,CD-0722-1
"C4,E3",7926,9093,5977,3116,4148,2096,0,2107,1399,708,1.975988701,1195,3254,703,263,259,4,114,2,0.065637066,0,empty,CD-0722-1
"C4,E4",10806,12062,8139,3923,5717,2793,0,2801,1807,994,1.817907445,1632,3339,803,357,357,0,146,0,0.067226891,0,empty,CD-0722-1
"C4,E5",9000,9876,6860,3016,4689,2155,0,2163,1362,801,1.700374532,1246,1769,302,119,114,5,57,3,0.122807018,0,empty,CD-0722-1
"C4,E6",15883,17825,11826,5999,8431,4345,0,4357,2700,1657,1.629450815,2484,4358,1182,370,368,2,92,2,0.105978261,0,empty,CD-0722-1
"C4,E7",15195,16480,11640,4840,7902,3821,0,3825,2516,1309,1.922077922,2108,3500,745,303,302,1,115,1,0.043046358,0,empty,CD-0722-1
"C4,E8",12026,13150,9049,4101,6152,2924,0,2930,1932,998,1.935871743,1652,3398,756,305,299,6,87,2,0.066889632,0,empty,CD-0722-1
"C4,E9",581290,636837,448920,187917,293313,140286,1,140483,109045,31438,3.468573064,77754,102430,15122,4734,4623,111,922,8,0.022063595,0,hg38,CD-0722-1
"C4,E10",1583954,1818374,1186376,631998,829823,446068,3,446544,372105,74439,4.998790956,260535,325972,40129,13443,13108,335,2130,7,0.067516021,0,hg38,CD-0722-1
"C4,E11",10840,11911,8197,3714,5663,2767,0,2769,1802,967,1.863495346,1567,2527,577,231,228,3,81,1,0.078947368,0,empty,CD-0722-1
"C4,E12",13461,15046,10080,4966,7225,3651,0,3662,2448,1214,2.016474465,2119,2427,444,180,180,0,85,0,0.033333333,0,empty,CD-0722-1
"C4,F1",13540,14593,10054,4539,6736,3298,0,3307,2114,1193,1.772003353,1848,2491,612,235,231,4,85,2,0.095238095,0,empty,CD-0722-1
"C4,F2",940642,1122245,685775,436470,515997,294313,4,294577,238930,55647,4.293672615,180011,220513,43971,14773,14567,206,2169,9,0.052447312,0,hg38,CD-0722-1
"C4,F3",10307,11181,7812,3369,5297,2519,0,2519,1687,832,2.027644231,1403,3875,777,313,308,5,121,2,0.038961039,0,empty,CD-0722-1
"C4,F4",14740,15638,11067,4571,7377,3434,3,3439,2168,1271,1.705743509,1906,798,145,68,67,1,33,1,0.029850746,0,empty,CD-0722-1
"C4,F5",11901,12961,9051,3910,6107,2875,1,2881,1891,990,1.91010101,1637,2428,596,241,240,1,90,1,0.0125,0,empty,CD-0722-1
"C4,F6",12828,14330,9435,4895,6802,3473,0,3475,2211,1264,1.749208861,2058,3486,827,324,319,5,126,2,0.065830721,0,empty,CD-0722-1
"C4,F7",1154588,1412466,816114,596352,647198,423896,2,424296,305594,118702,2.574463783,257460,2451,537,168,167,1,70,1,0.047904192,0,hg38,CD-0722-1
"C4,F8",10076,11106,7744,3362,5265,2472,0,2472,1593,879,1.812286689,1419,346,77,21,21,0,12,0,0,0,empty,CD-0722-1
"C4,F9",10805,12165,8183,3982,5630,2698,0,2710,1767,943,1.873806999,1584,3566,1108,342,339,3,109,2,0.1179941,0,empty,CD-0722-1
"C4,F10",13225,14452,10064,4388,6689,3203,0,3208,2084,1124,1.854092527,1781,2146,503,167,163,4,74,2,0.128834356,0,empty,CD-0722-1
"C4,F11",11148,12427,8508,3919,5814,2790,0,2794,1865,929,2.007534984,1595,1864,415,148,148,0,53,0,0.101351351,0,empty,CD-0722-1
"C4,F12",11467,12504,8528,3976,5824,2844,0,2844,1902,942,2.01910828,1608,255,55,34,33,1,17,1,0.03030303,0,empty,CD-0722-1
"C4,G1",13060,14598,9725,4873,6826,3310,3,3326,2227,1099,2.026387625,1918,3942,741,311,307,4,139,2,0.078175896,0,empty,CD-0722-1
"C4,G2",775772,895456,557346,338110,418828,232004,1,232257,195177,37080,5.263673139,138704,51582,8104,2602,2540,62,584,3,0.038188976,0,hg38,CD-0722-1
"C4,G3",1004777,1213680,731806,481874,553378,320405,1,320719,260501,60218,4.325965658,195827,129909,26307,8606,8465,141,1535,7,0.061429415,0,hg38,CD-0722-1
"C4,G4",813095,996415,556294,440121,462474,308837,0,309155,232291,76864,3.022103976,190009,341,30,22,22,0,17,0,0.045454545,0,empty,CD-0722-1
"C4,G5",8490,9435,6406,3029,4526,2271,0,2274,1509,765,1.97254902,1271,2699,849,287,283,4,99,1,0.024734982,0,empty,CD-0722-1
"C4,G6",12184,13549,9265,4284,6453,3318,0,3321,2203,1118,1.970483005,1875,304,52,30,27,3,17,2,0.259259259,0,empty,CD-0722-1
"C4,G7",10367,11014,7789,3225,5265,2473,0,2474,1592,882,1.804988662,1345,3526,939,305,300,5,96,2,0.06,0,empty,CD-0722-1
"C4,G8",1541340,1849249,1148238,701011,838580,477247,3,477736,390045,87691,4.447947908,289179,271851,39478,13127,12821,306,2081,8,0.0421184,0,hg38,CD-0722-1
"C4,G9",1808234,2069446,1384650,684796,931805,490904,4,491410,388125,103285,3.757806071,284474,256243,40149,12949,12695,254,2102,9,0.03702245,0,hg38,CD-0722-1
"C4,G10",11371,12470,8499,3971,6027,3013,0,3016,1998,1018,1.962671906,1743,3526,618,267,261,6,111,2,0.08045977,0,empty,CD-0722-1
"C4,G11",11124,12283,8374,3909,5869,2864,0,2864,1874,990,1.892929293,1640,1841,368,154,152,2,83,1,0.085526316,0,empty,CD-0722-1
"C4,G12",8803,9962,6372,3590,4727,2453,4,2465,1556,909,1.711771177,1473,2573,770,259,257,2,88,2,0.046692607,0,empty,CD-0722-1
"C4,H1",718216,801054,553469,247585,370449,179021,1,179220,135639,43581,3.112342535,102662,77693,8332,2748,2659,89,573,2,0.100789771,0,hg38,CD-0722-1
"C4,H2",10070,11464,7366,4098,5428,2797,0,2803,1781,1022,1.742661448,1692,2665,772,218,213,5,69,1,0.079812207,0,empty,CD-0722-1
"C4,H3",8970,10114,6641,3473,4759,2485,3,2490,1619,871,1.858783008,1477,1829,297,133,130,3,57,2,0.061538462,0,empty,CD-0722-1
"C4,H4",909339,1030985,696367,334618,467652,236025,3,236359,183595,52764,3.479550451,136643,8339,1379,464,459,5,125,3,0.02832244,0,hg38,CD-0722-1
"C4,H5",842385,926906,634328,292578,425466,217570,0,217805,170076,47729,3.563368183,123284,111606,22316,7142,7023,119,1208,4,0.021500783,0,hg38,CD-0722-1
"C4,H6",8634,9724,6420,3304,4608,2413,0,2418,1569,849,1.848056537,1381,2664,561,195,191,4,68,2,0.209424084,0,empty,CD-0722-1
"C4,H7",10136,10775,7625,3150,5167,2454,0,2454,1636,818,2,1309,2814,608,209,209,0,74,0,0.148325359,0,empty,CD-0722-1
"C4,H8",19433,21880,14617,7263,10287,5197,0,5199,3511,1688,2.079976303,2974,2171,395,167,166,1,61,1,0.084337349,0,empty,CD-0722-1
"C4,H9",8692,9497,6598,2899,4395,2065,0,2067,1372,695,1.974100719,1193,1441,339,96,96,0,38,0,0.041666667,0,empty,CD-0722-1
"C4,H10",7961,8832,5899,2933,4122,2023,0,2024,1382,642,2.152647975,1157,1484,279,96,96,0,46,0,0.0625,0,empty,CD-0722-1
"C4,H11",10376,11857,7213,4644,5755,3525,0,3525,1867,1658,1.126055489,2117,117,12,5,5,0,5,0,0,0,empty,CD-0722-1
"C4,H12",830128,957495,617636,339859,440947,234893,6,235218,177039,58179,3.043005208,139817,133331,15133,5179,5015,164,991,7,0.070388833,0,hg38,CD-0722-1
"C5,A1",6790,7889,4996,2893,3714,1960,1,1963,1258,705,1.784397163,1186,1168,327,111,110,1,38,1,0.054545455,0,empty,CD-0722-1
"C5,A2",9585,10764,7083,3681,5145,2683,0,2687,1679,1008,1.665674603,1588,1634,394,128,127,1,53,1,0.125984252,0,empty,CD-0722-1
"C5,A3",5837,6416,4277,2139,3065,1522,0,1523,942,581,1.621342513,870,1135,232,92,92,0,24,0,0.097826087,0,empty,CD-0722-1
"C5,A4",778614,871780,610450,261330,395603,186998,1,187226,140903,46323,3.041750318,104048,62437,8651,2977,2902,75,593,5,0.037904893,0,hg38,CD-0722-1
"C5,A5",9031,9935,6688,3247,4783,2316,0,2317,1453,864,1.681712963,1318,1938,402,127,127,0,45,0,0.102362205,0,empty,CD-0722-1
"C5,A6",277122,307909,219407,88502,144790,67001,0,67090,48601,18489,2.628644059,36992,35658,8941,2884,2842,42,588,5,0.030612245,0,hg38,CD-0722-1
"C5,A7",6478,7340,4768,2572,3450,1757,0,1759,1116,643,1.735614308,1052,1135,206,82,78,4,30,2,0.256410256,0,empty,CD-0722-1
"C5,A8",4109,4552,3152,1400,2121,1056,0,1056,679,377,1.801061008,571,1939,547,194,193,1,57,1,0.056994819,0,empty,CD-0722-1
"C5,A9",6565,7283,4943,2340,3506,1728,0,1732,1108,624,1.775641026,1009,1783,497,186,182,4,49,2,0.054945055,0,empty,CD-0722-1
"C5,A10",7250,8165,5527,2638,3899,1939,0,1942,1241,701,1.770328103,1067,337,21,14,14,0,10,0,0.071428571,0,empty,CD-0722-1
"C5,A11",6332,6697,4860,1837,3141,1457,0,1457,995,462,2.153679654,746,1733,289,122,122,0,45,0,0.040983607,0,empty,CD-0722-1
"C5,A12",7726,8545,5793,2752,4059,1971,0,1976,1326,650,2.04,1102,2700,519,212,211,1,77,1,0.047393365,0,empty,CD-0722-1
"C5,B1",7176,7925,5308,2617,3790,1960,0,1960,1294,666,1.942942943,1101,1162,235,99,98,1,33,1,0.040816327,0,empty,CD-0722-1
"C5,B2",8057,8626,5558,3068,4112,2203,0,2208,1410,798,1.766917293,1268,549,85,41,41,0,16,0,0.219512195,0,empty,CD-0722-1
"C5,B3",7870,8682,5770,2912,4228,2168,0,2170,1487,683,2.17715959,1238,1153,291,119,117,2,35,1,0.170940171,0,empty,CD-0722-1
"C5,B4",533015,639630,383383,256247,298785,185327,4,185497,141280,44217,3.195151186,110471,10558,879,285,268,17,99,3,0.205223881,0,hg38,CD-0722-1
"C5,B5",11648,9203,5769,3434,5054,2758,0,2769,1972,797,2.474278545,1684,890,191,63,63,0,21,0,0.031746032,0,empty,CD-0722-1
"C5,B6",3405170,4216852,2311531,1905321,1929360,1341450,7,1342659,924091,418568,2.207744022,830316,89055,12295,4108,4013,95,845,4,0.043608273,0,hg38,CD-0722-1
"C5,B7",7324,8178,5528,2650,3793,1815,0,1819,1174,645,1.820155039,1051,997,230,81,78,3,27,2,0,0,empty,CD-0722-1
"C5,B8",5212,5771,3976,1795,2706,1296,0,1298,878,420,2.09047619,736,1142,202,76,75,1,33,1,0.066666667,0,empty,CD-0722-1
"C5,B9",9648,10583,7164,3419,4969,2560,0,2560,1594,966,1.65010352,1420,1042,392,134,132,2,37,1,0.007575758,0,empty,CD-0722-1
"C5,B10",5043,5282,3639,1643,2693,1320,1,1325,836,489,1.709611452,769,426,131,50,50,0,20,0,0.04,0,empty,CD-0722-1
"C5,B11",10238,11386,7576,3810,5367,2897,4,2909,1666,1243,1.340305712,1631,232,34,22,22,0,11,0,0.045454545,0,empty,CD-0722-1
"C5,B12",6270,6873,4636,2237,3343,1651,0,1651,1111,540,2.057407407,972,1745,336,131,131,0,34,0,0.183206107,0,empty,CD-0722-1
"C5,C1",12628,13517,9683,3834,6367,3014,0,3016,1974,1042,1.894433781,1627,716,178,72,70,2,31,2,0.028571429,0,empty,CD-0722-1
"C5,C2",10320,11081,7667,3414,5197,2657,0,2662,1757,905,1.941436464,1428,2180,608,226,223,3,55,2,0.044843049,0,empty,CD-0722-1
"C5,C3",10982,12423,8185,4238,5864,2877,4,2882,1814,1068,1.698501873,1661,1006,191,53,53,0,23,0,0.018867925,0,empty,CD-0722-1
"C5,C4",398198,487784,272066,215718,232394,151596,0,151753,110133,41620,2.646155694,94815,41810,6973,2223,2163,60,520,2,0.044382802,0,hg38,CD-0722-1
"C5,C5",10710,11929,7851,4078,5633,2807,0,2808,1894,914,2.072210066,1646,2083,437,153,153,0,58,0,0.071895425,0,empty,CD-0722-1
"C5,C6",8517,9350,6421,2929,4545,2233,0,2234,1476,758,1.947229551,1268,1656,457,156,156,0,47,0,0.064102564,0,empty,CD-0722-1
"C5,C7",10960,12644,7977,4667,6036,3313,0,3321,1930,1391,1.387491014,2002,434,65,30,27,3,15,1,0,0,empty,CD-0722-1
"C5,C8",779046,879122,586879,292243,401593,209116,2,209339,162302,47037,3.450517678,119829,38640,4707,1554,1517,37,438,3,0.100856955,0,hg38,CD-0722-1
"C5,C9",637615,750938,474939,275999,348066,191117,1,191319,149610,41709,3.586995612,114560,88388,7264,2551,2431,120,556,8,0.053064582,0,hg38,CD-0722-1
"C5,C10",9866,10830,7514,3316,5100,2453,0,2453,1594,859,1.8556461,1365,1848,324,112,112,0,42,0,0.026785714,0,empty,CD-0722-1
"C5,C11",8754,10041,6478,3563,4754,2348,0,2351,1522,829,1.835946924,1403,1860,454,167,167,0,50,0,0.02994012,0,empty,CD-0722-1
"C5,C12",11927,13048,8808,4240,6148,2976,0,2978,1893,1085,1.744700461,1707,1829,368,135,135,0,39,0,0.044444444,0,empty,CD-0722-1
"C5,D1",10733,11751,7883,3868,5645,2950,0,2955,1873,1082,1.731053604,1662,773,165,74,73,1,28,1,0.082191781,0,empty,CD-0722-1
"C5,D2",9434,10376,7055,3321,4942,2341,0,2345,1479,866,1.707852194,1345,3006,872,327,327,0,91,0,0.085626911,0,empty,CD-0722-1
"C5,D3",692732,827467,505880,321587,380124,218179,1,218408,165353,53055,3.116633682,132693,63238,13178,4277,4218,59,786,3,0.079184448,0,hg38,CD-0722-1
"C5,D4",6366,7344,4728,2616,3445,1777,0,1779,1190,589,2.020373514,1046,1339,348,143,143,0,43,0,0.167832168,0,empty,CD-0722-1
"C5,D5",6808,7397,5015,2382,3570,1794,0,1794,1141,653,1.747320061,1000,1573,468,148,148,0,63,0,0.047297297,0,empty,CD-0722-1
"C5,D6",10381,11742,7318,4424,5570,3005,1,3011,1753,1258,1.393481717,1782,1848,488,154,154,0,38,0,0.175324675,0,empty,CD-0722-1
"C5,D7",5968,6587,4553,2034,3128,1502,0,1504,998,506,1.972332016,838,2219,423,151,151,0,43,0,0.099337748,0,empty,CD-0722-1
"C5,D8",7623,8641,5739,2902,4066,2009,0,2010,1289,721,1.78779473,1138,1521,316,122,122,0,48,0,0.139344262,0,empty,CD-0722-1
"C5,D9",4094,4536,3023,1513,2130,1052,0,1052,689,363,1.898071625,598,1724,306,87,87,0,39,0,0.08045977,0,empty,CD-0722-1
"C5,D10",6890,7590,5075,2515,3550,1793,0,1796,1152,644,1.788819876,997,711,136,41,40,1,19,1,0.025,0,empty,CD-0722-1
"C5,D11",8397,9374,6266,3108,4426,2177,0,2184,1425,759,1.877470356,1257,2574,518,202,199,3,79,2,0.035175879,0,empty,CD-0722-1
"C5,D12",10092,11026,7561,3465,5165,2521,0,2522,1652,870,1.898850575,1382,3665,973,347,341,6,94,2,0.058651026,0,empty,CD-0722-1
"C5,E1",12332,12987,9274,3713,6175,3019,0,3021,1909,1112,1.716726619,1602,2870,517,202,200,2,60,2,0.12,0,empty,CD-0722-1
"C5,E2",8959,10194,6593,3601,4831,2449,1,2455,1555,900,1.727777778,1456,2176,714,208,206,2,50,1,0.106796117,0,empty,CD-0722-1
"C5,E3",6146,6828,4660,2168,3226,1489,0,1491,943,548,1.72080292,844,2257,530,170,169,1,57,1,0.00591716,0,empty,CD-0722-1
"C5,E4",8343,9310,6160,3150,4415,2165,0,2165,1376,789,1.743979721,1215,2194,578,222,222,0,74,0,0.04954955,0,empty,CD-0722-1
"C5,E5",7659,8214,5828,2386,3905,1784,0,1786,1149,637,1.803767661,978,1224,313,100,99,1,38,1,0.01010101,0,empty,CD-0722-1
"C5,E6",12895,14292,9661,4631,6647,3357,1,3363,2095,1268,1.652208202,1864,3274,843,273,266,7,66,3,0.071428571,0,empty,CD-0722-1
"C5,E7",11952,13154,9202,3952,6055,2871,0,2871,1918,953,2.012591815,1554,2712,630,220,215,5,78,2,0.106976744,0,empty,CD-0722-1
"C5,E8",9698,10541,7447,3094,4876,2200,0,2204,1398,806,1.734491315,1201,3503,669,222,215,7,65,2,0.03255814,0,empty,CD-0722-1
"C5,E9",5983,6824,4451,2373,3247,1578,0,1579,1009,570,1.770175439,946,2318,673,232,227,5,77,1,0.061674009,0,empty,CD-0722-1
"C5,E10",7387,8052,5600,2452,3799,1739,0,1742,1124,618,1.818770227,965,2192,448,123,117,6,38,2,0.051282051,0,empty,CD-0722-1
"C5,E11",8529,9339,6389,2950,4509,2254,0,2254,1473,781,1.886043534,1245,2029,426,141,139,2,43,2,0.035971223,0,empty,CD-0722-1
"C5,E12",9183,10322,6988,3334,4878,2476,0,2478,1616,862,1.874709977,1411,1922,389,139,138,1,43,1,0.079710145,0,empty,CD-0722-1
"C5,F1",10508,11134,7785,3349,5298,2513,0,2515,1592,923,1.724810401,1375,1864,381,133,130,3,51,1,0.030769231,0,empty,CD-0722-1
"C5,F2",8373,9423,6183,3240,4460,2183,0,2194,1402,792,1.77020202,1293,2591,710,261,260,1,66,1,0.111538462,0,empty,CD-0722-1
"C5,F3",1406344,1625142,1055024,570118,735363,394162,2,394590,311352,83238,3.740503136,232961,273546,35808,11656,11343,313,1877,7,0.07176232,0,hg38,CD-0722-1
"C5,F4",954912,1098532,713210,385322,504062,272451,16,272758,214976,57782,3.720466581,160006,58549,6776,2225,2184,41,496,3,0.065018315,0,hg38,CD-0722-1
"C5,F5",9718,10633,7306,3327,4865,2243,1,2245,1452,793,1.831021438,1271,1971,490,180,178,2,48,2,0.146067416,0,empty,CD-0722-1
"C5,F6",10049,11085,7281,3804,5202,2680,0,2685,1698,987,1.720364742,1563,2707,840,246,242,4,68,4,0.140495868,0,empty,CD-0722-1
"C5,F7",11709,13111,8789,4322,6184,3195,2,3199,2050,1149,1.784160139,1856,1002,211,78,77,1,34,1,0,0,empty,CD-0722-1
"C5,F8",327613,359502,261356,98146,166555,76106,1,76219,60880,15339,3.96896799,40855,1236,190,69,68,1,26,1,0.044117647,0,empty,CD-0722-1
"C5,F9",8212,8721,6288,2433,4057,1893,0,1895,1270,625,2.032,987,3077,755,251,242,9,66,2,0.049586777,0,empty,CD-0722-1
"C5,F10",11076,12228,8417,3811,5670,2705,0,2711,1785,926,1.927645788,1495,2196,422,128,128,0,36,0,0.109375,0,empty,CD-0722-1
"C5,F11",8415,9094,6398,2696,4323,2077,0,2079,1411,668,2.112275449,1151,1738,324,115,110,5,35,2,0.2,0,empty,CD-0722-1
"C5,F12",9229,10392,6866,3526,4784,2396,0,2396,1562,834,1.872901679,1380,128,15,4,4,0,4,0,0,0,empty,CD-0722-1
"C5,G1",10569,11754,8160,3594,5506,2597,0,2602,1680,922,1.822125813,1435,3190,848,301,299,2,100,2,0.093645485,0,empty,CD-0722-1
"C5,G2",5907,6426,4270,2156,3089,1604,0,1611,1057,554,1.907942238,946,325,76,29,28,1,9,1,0.071428571,0,empty,CD-0722-1
"C5,G3",11182,12223,8322,3901,5889,2957,1,2962,1785,1177,1.516567545,1620,2643,686,225,224,1,61,1,0.044642857,0,empty,CD-0722-1
"C5,G4",19604,22220,14211,8009,10480,5691,1,5703,3482,2221,1.567762269,3380,95,10,6,6,0,5,0,0,0,empty,CD-0722-1
"C5,G5",7569,8841,5594,3247,4081,2155,0,2157,1422,735,1.934693878,1266,1507,274,95,95,0,38,0,0,0,empty,CD-0722-1
"C5,G6",10570,11726,8031,3695,5395,2617,0,2617,1721,896,1.920758929,1443,177,7,5,5,0,4,0,0,0,empty,CD-0722-1
"C5,G7",8302,8911,6401,2510,4172,1910,0,1912,1226,686,1.787172012,1034,2545,822,295,293,2,81,1,0.027303754,0,empty,CD-0722-1
"C5,G8",5928,6656,4372,2284,3090,1501,1,1506,966,540,1.788888889,906,1653,407,134,133,1,42,1,0.015037594,0,empty,CD-0722-1
"C5,G9",6906,7622,5224,2398,3597,1718,0,1722,1105,617,1.790923825,1004,2295,497,190,188,2,64,2,0.053191489,0,empty,CD-0722-1
"C5,G10",8468,9436,6332,3104,4486,2285,0,2289,1463,826,1.771186441,1306,2702,731,283,282,1,93,1,0.042553191,0,empty,CD-0722-1
"C5,G11",8472,9192,6524,2668,4420,2064,0,2073,1379,694,1.9870317,1128,1211,307,145,144,1,45,1,0,0,empty,CD-0722-1
"C5,G12",7080,8164,5173,2991,3735,1864,0,1871,1224,647,1.891808346,1119,2568,702,236,236,0,70,0,0.029661017,0,empty,CD-0722-1
"C5,H1",6927,7428,5087,2341,3515,1664,0,1667,1042,625,1.6672,935,1178,314,96,96,0,29,0,0,0,empty,CD-0722-1
"C5,H2",11272,12337,8558,3779,5903,2864,1,2865,1935,930,2.080645161,1585,2644,759,235,234,1,60,1,0.085470085,0,empty,CD-0722-1
"C5,H3",6942,7630,5154,2476,3603,1746,0,1748,1146,602,1.903654485,998,1783,355,116,116,0,41,0,0.017241379,0,empty,CD-0722-1
"C5,H4",10410,11471,7669,3802,5253,2562,0,2569,1684,885,1.902824859,1500,167,84,37,37,0,11,0,0.405405405,0,empty,CD-0722-1
"C5,H5",11176,12586,8382,4204,5814,2954,0,2955,1898,1057,1.795648061,1717,1590,438,141,133,8,39,2,0.090225564,0,empty,CD-0722-1
"C5,H6",6426,7350,4678,2672,3449,1796,0,1798,1182,616,1.918831169,1070,1780,471,171,165,6,50,2,0.133333333,0,empty,CD-0722-1
"C5,H7",8157,8674,6035,2639,4122,1929,0,1934,1259,675,1.865185185,1080,2409,557,214,208,6,47,1,0.163461538,0,empty,CD-0722-1
"C5,H8",9115,10015,6742,3273,4795,2465,0,2465,1584,881,1.797956867,1385,2308,553,193,190,3,53,1,0.105263158,0,empty,CD-0722-1
"C5,H9",851589,920714,674110,246604,416227,186495,4,186748,145783,40965,3.558720859,100379,15102,2125,607,600,7,162,2,0.048333333,0,hg38,CD-0722-1
"C5,H10",5900,6740,4437,2303,3204,1575,0,1575,1004,571,1.758318739,959,1203,230,86,85,1,24,1,0.141176471,0,empty,CD-0722-1
"C5,H11",7504,8938,5194,3744,4201,2590,0,2592,1435,1157,1.240276577,1616,37,10,5,5,0,3,0,0,0,empty,CD-0722-1
"C5,H12",6376,7445,4728,2717,3549,1850,0,1850,1213,637,1.904238619,1115,1475,294,95,94,1,30,1,0.20212766,0,empty,CD-0722-1
"C6,A1",4314,4728,3233,1495,2367,1199,0,1199,749,450,1.664444444,682,1083,161,66,65,1,27,1,0.092307692,0,empty,CD-0722-1
"C6,A2",6990,7548,5268,2280,3629,1817,0,1817,1119,698,1.603151862,1020,1078,238,107,107,0,39,0,0.028037383,0,empty,CD-0722-1
"C6,A3",4063,4462,3046,1416,2081,1024,0,1025,641,384,1.669270833,564,1025,223,68,66,2,24,1,0.287878788,0,empty,CD-0722-1
"C6,A4",7495,8243,5533,2710,3870,1949,0,1952,1262,690,1.828985507,1084,647,55,38,38,0,23,0,0,0,empty,CD-0722-1
"C6,A5",6288,7064,4695,2369,3309,1618,0,1620,1062,558,1.903225806,919,1911,462,157,155,2,48,2,0.038709677,0,empty,CD-0722-1
"C6,A6",8624,9649,6560,3089,4691,2378,0,2381,1723,658,2.618541033,1358,1592,518,184,180,4,68,2,0.094444444,0,empty,CD-0722-1
"C6,A7",4718,5084,3426,1658,2392,1253,0,1253,802,451,1.77827051,704,971,202,73,70,3,32,1,0,0,empty,CD-0722-1
"C6,A8",2819,3325,2161,1164,1619,845,0,845,569,276,2.061594203,502,1308,277,115,112,3,50,2,0.026785714,0,empty,CD-0722-1
"C6,A9",5005,5546,3774,1772,2539,1224,0,1225,795,430,1.848837209,694,1424,304,96,95,1,36,1,0,0,empty,CD-0722-1
"C6,A10",5376,5711,4138,1573,2793,1412,0,1412,900,512,1.7578125,762,391,158,35,35,0,10,0,0.028571429,0,empty,CD-0722-1
"C6,A11",4566,4973,3381,1592,2390,1147,0,1149,747,402,1.858208955,662,1014,173,61,57,4,38,2,0.140350877,0,empty,CD-0722-1
"C6,A12",5759,6405,4234,2171,3014,1515,0,1522,1008,514,1.961089494,898,2133,546,206,201,5,59,1,0.099502488,0,empty,CD-0722-1
"C6,B1",487875,554435,365701,188734,256549,134935,0,135072,110236,24836,4.438556933,77535,74849,11147,3734,3658,76,732,2,0.053854565,0,hg38,CD-0722-1
"C6,B2",5351,5895,3689,2206,2799,1492,0,1492,912,580,1.572413793,913,407,70,23,23,0,14,0,0.130434783,0,empty,CD-0722-1
"C6,B3",3866,4271,2825,1446,2077,1061,1,1065,735,330,2.227272727,625,983,157,56,53,3,19,2,0.018867925,0,empty,CD-0722-1
"C6,B4",4698,5406,3420,1986,2572,1322,0,1324,879,445,1.975280899,786,980,156,68,67,1,30,1,0.149253731,0,empty,CD-0722-1
"C6,B5",5124,2892,1834,1058,1838,972,0,976,679,297,2.286195286,607,482,169,46,45,1,14,1,0.266666667,0,empty,CD-0722-1
"C6,B6",5595,6330,4105,2225,2998,1569,0,1580,1015,565,1.796460177,917,1458,391,105,105,0,33,0,0.076190476,0,empty,CD-0722-1
"C6,B7",5040,5831,3814,2017,2792,1436,0,1439,914,525,1.740952381,879,707,150,51,51,0,23,0,0.078431373,0,empty,CD-0722-1
"C6,B8",3681,3991,2797,1194,1912,908,0,909,607,302,2.009933775,495,766,110,65,63,2,29,2,0.031746032,0,empty,CD-0722-1
"C6,B9",6776,7621,5095,2526,3643,1938,0,1942,1181,761,1.551905388,1088,609,168,60,60,0,21,0,0.183333333,0,empty,CD-0722-1
"C6,B10",3638,3944,2649,1295,1956,979,0,982,619,363,1.70523416,579,595,150,52,52,0,14,0,0.096153846,0,empty,CD-0722-1
"C6,B11",7703,9110,5443,3667,4144,2331,3,2336,1244,1092,1.139194139,1474,272,61,23,23,0,8,0,0.043478261,0,empty,CD-0722-1
"C6,B12",4387,4929,3213,1716,2381,1205,0,1206,785,421,1.864608076,717,1301,154,62,61,1,21,1,0.344262295,0,empty,CD-0722-1
"C6,C1",8810,9516,6694,2822,4408,2110,0,2110,1317,793,1.660781841,1163,600,156,66,66,0,19,0,0,0,empty,CD-0722-1
"C6,C2",7030,7679,5261,2418,3667,1862,0,1866,1168,698,1.673352436,1055,1719,417,126,126,0,37,0,0.214285714,0,empty,CD-0722-1
"C6,C3",7562,8207,5777,2430,3905,1818,2,1834,1194,640,1.865625,972,863,173,61,60,1,27,1,0.033333333,0,empty,CD-0722-1
"C6,C4",5051,5820,3828,1992,2643,1250,0,1251,832,419,1.985680191,700,1603,200,88,83,5,44,2,0.036144578,0,empty,CD-0722-1
"C6,C5",636339,736645,478910,257735,338952,181581,2,181785,142511,39274,3.62863472,106723,70533,8118,2699,2636,63,598,5,0.04969651,0,hg38,CD-0722-1
"C6,C6",6304,6993,4587,2406,3367,1701,0,1705,1113,592,1.880067568,947,1358,373,131,131,0,45,0,0.022900763,0,empty,CD-0722-1
"C6,C7",7697,9049,5513,3536,4297,2399,0,2399,1404,995,1.411055276,1471,393,42,22,22,0,12,0,0,0,empty,CD-0722-1
"C6,C8",8679,9936,6353,3583,4710,2455,0,2459,1557,902,1.72616408,1463,2933,479,194,185,9,77,2,0.054054054,0,empty,CD-0722-1
"C6,C9",6021,6868,4459,2409,3216,1615,0,1621,1034,587,1.761499148,970,1603,366,122,116,6,33,2,0.034482759,0,empty,CD-0722-1
"C6,C10",6913,7669,5110,2559,3566,1749,0,1752,1161,591,1.964467005,1003,1599,349,121,121,0,46,0,0.041322314,0,empty,CD-0722-1
"C6,C11",426274,532031,298528,233503,249763,154946,0,155074,119074,36000,3.307611111,98892,20623,8770,2717,2711,6,519,2,0.036886758,0,hg38,CD-0722-1
"C6,C12",8566,9275,6498,2777,4385,2125,0,2127,1395,732,1.905737705,1202,1324,211,69,68,1,29,1,0.073529412,0,empty,CD-0722-1
"C6,D1",7258,8368,5215,3153,3910,2063,0,2063,1256,807,1.55638166,1254,910,237,82,82,0,25,0,0,0,empty,CD-0722-1
"C6,D2",6434,7101,5003,2098,3351,1535,1,1539,980,559,1.75313059,850,2183,533,168,167,1,59,1,0.02994012,0,empty,CD-0722-1
"C6,D3",581696,686854,428302,258552,317030,176292,1,176460,140476,35984,3.903846154,105936,79232,12855,4109,4034,75,807,4,0.050818047,0,hg38,CD-0722-1
"C6,D4",4330,4891,3309,1582,2264,1139,0,1141,725,416,1.742788462,630,1275,246,102,102,0,28,0,0,0,empty,CD-0722-1
"C6,D5",4865,5464,3738,1726,2608,1305,0,1306,859,447,1.921700224,763,1648,347,133,132,1,42,1,0.03030303,0,empty,CD-0722-1
"C6,D6",7243,8219,5144,3075,3830,2113,1,2114,1292,822,1.571776156,1262,1440,309,145,144,1,43,1,0.013888889,0,empty,CD-0722-1
"C6,D7",4081,4311,3173,1138,2094,966,0,969,636,333,1.90990991,507,1171,308,89,76,13,35,1,0.026315789,0,empty,CD-0722-1
"C6,D8",5193,5553,3955,1598,2692,1295,1,1302,839,463,1.812095032,704,1057,203,87,87,0,41,0,0.011494253,0,empty,CD-0722-1
"C6,D9",2848,3174,2200,974,1517,701,1,702,466,236,1.974576271,402,1872,569,174,174,0,55,0,0.172413793,0,empty,CD-0722-1
"C6,D10",4812,5559,3536,2023,2586,1338,0,1341,815,526,1.549429658,795,681,153,55,53,2,17,2,0,0,empty,CD-0722-1
"C6,D11",5632,6133,4216,1917,2972,1411,0,1419,958,461,2.078091106,800,2413,702,217,213,4,87,2,0.061032864,0,empty,CD-0722-1
"C6,D12",586564,687108,437836,249272,317285,173579,2,173738,142941,30797,4.641393642,102882,194623,31462,10240,10008,232,1652,4,0.057154277,0,hg38,CD-0722-1
"C6,E1",8961,9768,6656,3112,4619,2326,0,2331,1406,925,1.52,1306,2144,489,186,186,0,78,0,0.043010753,0,empty,CD-0722-1
"C6,E2",794677,841007,622094,218913,389943,172046,4,172287,139283,33004,4.220185432,93123,61528,8926,2888,2808,80,619,3,0.031339031,0,hg38,CD-0722-1
"C6,E3",4354,4763,3220,1543,2270,1115,0,1115,736,379,1.941952507,615,2072,446,178,173,5,61,2,0.075144509,0,empty,CD-0722-1
"C6,E4",450077,525906,336916,188990,244860,131635,2,131758,99168,32590,3.042896594,78149,79406,12063,4064,3974,90,796,6,0.037242073,0,hg38,CD-0722-1
"C6,E5",5144,5509,3949,1560,2625,1182,1,1183,794,389,2.041131105,616,1146,247,90,90,0,32,0,0.144444444,0,empty,CD-0722-1
"C6,E6",390037,466483,273224,193259,215474,138561,1,138665,100841,37824,2.666058587,82240,7139,860,304,295,9,94,2,0.091525424,0,hg38,CD-0722-1
"C6,E7",425468,478425,323407,155018,220555,112096,3,112245,89315,22930,3.895115569,63279,140351,18223,6091,5963,128,1152,4,0.073956062,0,hg38,CD-0722-1
"C6,E8",6839,7331,5308,2023,3492,1565,2,1568,1052,516,2.03875969,882,1962,486,163,161,2,46,1,0.031055901,0,empty,CD-0722-1
"C6,E9",4410,4916,3194,1722,2406,1236,1,1241,796,445,1.788764045,728,1983,509,192,190,2,70,1,0.031578947,0,empty,CD-0722-1
"C6,E10",5034,5411,3900,1511,2597,1200,0,1200,782,418,1.870813397,631,1391,433,152,151,1,45,1,0.105960265,0,empty,CD-0722-1
"C6,E11",6094,6727,4536,2191,3250,1632,0,1632,1010,622,1.623794212,925,1977,350,130,128,2,35,2,0.1328125,0,empty,CD-0722-1
"C6,E12",6147,6985,4516,2469,3395,1752,0,1752,1132,620,1.825806452,1049,1416,279,115,115,0,40,0,0.113043478,0,empty,CD-0722-1
"C6,F1",7231,7739,5349,2390,3709,1783,0,1783,1168,615,1.899186992,963,1963,354,131,131,0,45,0,0.114503817,0,empty,CD-0722-1
"C6,F2",6196,6826,4645,2181,3283,1598,1,1605,1049,556,1.886690647,917,2759,583,227,224,3,69,2,0.147321429,0,empty,CD-0722-1
"C6,F3",5952,6611,4482,2129,3171,1497,0,1503,982,521,1.884836852,871,2561,529,177,174,3,65,2,0.028735632,0,empty,CD-0722-1
"C6,F4",9221,9880,6697,3183,4704,2285,2,2297,1486,811,1.832305795,1282,520,75,40,39,1,20,1,0.128205128,0,empty,CD-0722-1
"C6,F5",6783,7338,5103,2235,3474,1623,0,1623,1029,594,1.732323232,901,1340,281,127,124,3,40,2,0.169354839,0,empty,CD-0722-1
"C6,F6",6784,7581,5006,2575,3602,1836,1,1839,1193,646,1.846749226,1060,2264,602,254,253,1,77,1,0.106719368,0,empty,CD-0722-1
"C6,F7",640398,742446,479103,263343,340827,183759,3,183968,156632,27336,5.729880012,107510,20994,1344,491,481,10,191,3,0.029106029,0,hg38,CD-0722-1
"C6,F8",5469,5935,4024,1911,2820,1361,0,1364,877,487,1.800821355,782,81,8,8,8,0,3,0,0,0,empty,CD-0722-1
"C6,F9",5877,6484,4433,2051,3024,1435,0,1443,933,510,1.829411765,816,2665,576,216,215,1,61,1,0.158139535,0,empty,CD-0722-1
"C6,F10",7975,8621,6178,2443,3957,1779,0,1783,1100,683,1.610541728,971,1281,382,124,120,4,35,1,0.008333333,0,empty,CD-0722-1
"C6,F11",6010,6435,4674,1761,3071,1427,2,1430,944,486,1.942386831,744,1290,239,77,76,1,19,1,0.078947368,0,empty,CD-0722-1
"C6,F12",6713,7359,4973,2386,3484,1720,0,1721,1132,589,1.921901528,1017,110,24,16,16,0,9,0,0.125,0,empty,CD-0722-1
"C6,G1",7276,7925,5526,2399,3814,1776,0,1777,1182,595,1.986554622,980,2109,455,174,174,0,61,0,0.034482759,0,empty,CD-0722-1
"C6,G2",4133,4577,2828,1749,2180,1140,0,1144,753,391,1.925831202,691,327,60,19,19,0,12,0,0.157894737,0,empty,CD-0722-1
"C6,G3",7453,8062,5491,2571,3935,1991,0,1995,1226,769,1.594278283,1136,2051,467,188,187,1,70,1,0.037433155,0,empty,CD-0722-1
"C6,G4",13625,15362,9800,5562,7433,4236,0,4246,2633,1613,1.632362058,2543,113,9,6,5,1,5,1,0.2,0,empty,CD-0722-1
"C6,G5",4788,5318,3534,1784,2549,1275,0,1276,858,418,2.052631579,710,1110,282,79,77,2,31,2,0.038961039,0,empty,CD-0722-1
"C6,G6",6913,7414,5203,2211,3545,1703,1,1706,1139,567,2.008818342,937,145,60,24,24,0,7,0,0.25,0,empty,CD-0722-1
"C6,G7",5674,6081,4375,1706,2940,1355,0,1358,897,461,1.945770065,722,1983,453,159,157,2,64,1,0.031847134,0,empty,CD-0722-1
"C6,G8",350020,429663,239480,190183,203743,135105,0,135240,85985,49255,1.745711095,84318,1611,481,142,142,0,54,0,0.246478873,0,hg38,CD-0722-1
"C6,G9",4801,5354,3561,1793,2552,1231,0,1235,783,452,1.732300885,743,1824,362,133,131,2,44,2,0.145038168,0,empty,CD-0722-1
"C6,G10",6300,6739,4713,2026,3217,1605,0,1605,1008,597,1.688442211,894,1629,287,119,118,1,62,1,0.152542373,0,empty,CD-0722-1
"C6,G11",6169,6957,4684,2273,3341,1638,0,1638,1054,584,1.804794521,942,1171,291,96,92,4,40,1,0.02173913,0,empty,CD-0722-1
"C6,G12",4761,5426,3527,1899,2581,1321,0,1326,830,496,1.673387097,787,1667,339,130,129,1,37,1,0.062015504,0,empty,CD-0722-1
"C6,H1",5064,5339,3708,1631,2510,1221,0,1221,804,417,1.928057554,664,722,255,84,83,1,23,1,0.120481928,0,empty,CD-0722-1
"C6,H2",553565,641435,416562,224873,299096,158934,3,159130,123742,35388,3.496722053,93930,95628,12090,3908,3776,132,806,4,0.049523305,0,hg38,CD-0722-1
"C6,H3",494531,576219,365224,210995,268574,148068,2,148219,120972,27247,4.439828238,88829,49520,9266,2884,2838,46,596,3,0.025017618,0,hg38,CD-0722-1
"C6,H4",6995,7752,5283,2469,3673,1782,0,1783,1200,583,2.058319039,1010,127,23,7,7,0,7,0,0,0,empty,CD-0722-1
"C6,H5",564990,657311,422548,234763,303461,160652,3,160799,119839,40960,2.925756836,96020,100352,14601,4741,4623,118,885,4,0.031797534,0,hg38,CD-0722-1
"C6,H6",4625,5334,3459,1875,2469,1313,0,1314,837,477,1.754716981,775,1290,329,119,118,1,35,1,0.237288136,0,empty,CD-0722-1
"C6,H7",436782,507097,323593,183504,238465,129416,7,129552,98315,31237,3.147389314,76684,124631,18394,5719,5579,140,1008,6,0.044810898,0,hg38,CD-0722-1
"C6,H8",6058,6639,4430,2209,3099,1525,0,1526,989,537,1.841713222,844,1118,290,114,113,1,34,1,0.061946903,0,empty,CD-0722-1
"C6,H9",5142,5427,3915,1512,2606,1221,0,1221,854,367,2.326975477,657,810,224,65,62,3,15,1,0.258064516,0,empty,CD-0722-1
"C6,H10",4039,4360,3009,1351,2074,1025,0,1025,654,371,1.762803235,578,1194,282,91,90,1,25,1,0.022222222,0,empty,CD-0722-1
"C6,H11",5186,5981,3531,2450,2876,1770,0,1770,984,786,1.251908397,1082,30,5,2,2,0,2,0,0,0,empty,CD-0722-1
"C6,H12",391475,457419,286289,171130,216563,119153,3,119273,91897,27376,3.356845412,71907,152845,16809,5456,5298,158,1021,5,0.09588524,0,hg38,CD-0722-1
"C7,A1",7249,7940,5382,2558,3861,1940,0,1943,1266,677,1.870014771,1092,1140,213,90,89,1,31,1,0.168539326,0,empty,CD-0722-1
"C7,A2",10367,11311,7792,3519,5430,2669,0,2676,1680,996,1.686746988,1508,1964,510,181,180,1,65,1,0.044444444,0,empty,CD-0722-1
"C7,A3",7085,7987,5346,2641,3745,1834,0,1837,1137,700,1.624285714,1053,3259,746,233,233,0,65,0,0.094420601,0,empty,CD-0722-1
"C7,A4",12416,13447,9407,4040,6306,3026,0,3032,1930,1102,1.751361162,1681,1047,169,60,60,0,35,0,0.05,0,empty,CD-0722-1
"C7,A5",9669,10675,7356,3319,5107,2474,0,2479,1559,920,1.694565217,1380,2519,626,226,221,5,85,2,0.013574661,0,empty,CD-0722-1
"C7,A6",7894,8762,5973,2789,4191,2137,1,2141,1447,694,2.085014409,1201,2855,716,244,241,3,82,2,0.128630705,0,empty,CD-0722-1
"C7,A7",7051,7783,5219,2564,3733,1910,0,1911,1208,703,1.718349929,1087,1588,338,151,151,0,48,0,0.026490066,0,empty,CD-0722-1
"C7,A8",4454,4965,3295,1670,2456,1231,0,1233,837,396,2.113636364,691,2483,448,174,172,2,57,1,0.127906977,0,empty,CD-0722-1
"C7,A9",7391,8056,5532,2524,3802,1897,0,1899,1258,641,1.962558502,1075,1874,355,151,150,1,56,1,0.08,0,empty,CD-0722-1
"C7,A10",7862,8625,6010,2615,4189,2065,0,2065,1319,746,1.768096515,1154,380,75,44,44,0,17,0,0.318181818,0,empty,CD-0722-1
"C7,A11",6529,7148,4941,2207,3451,1639,0,1639,1069,570,1.875438596,914,1955,298,104,104,0,52,0,0.057692308,0,empty,CD-0722-1
"C7,A12",8338,8992,6290,2702,4249,2030,0,2030,1327,703,1.887624467,1140,3365,714,237,234,3,74,2,0.076923077,0,empty,CD-0722-1
"C7,B1",7665,8582,5727,2855,4119,2070,0,2076,1293,783,1.651340996,1204,1436,335,115,115,0,42,0,0.017391304,0,empty,CD-0722-1
"C7,B2",776391,886824,535169,351655,416304,237947,5,238181,199651,38530,5.181702569,144823,44290,6348,2062,2037,25,446,4,0.076583211,0,hg38,CD-0722-1
"C7,B3",6402,7108,4723,2385,3414,1770,0,1778,1132,646,1.752321981,1038,1744,361,117,116,1,40,1,0.129310345,0,empty,CD-0722-1
"C7,B4",7209,8057,5211,2846,3870,2057,0,2060,1231,829,1.484921592,1189,1922,325,141,140,1,57,1,0.071428571,0,empty,CD-0722-1
"C7,B5",7839,4252,2552,1700,2825,1526,1,1537,971,566,1.715547703,979,952,167,63,63,0,24,0,0.142857143,0,empty,CD-0722-1
"C7,B6",8185,9136,5943,3193,4249,2228,0,2230,1463,767,1.907431551,1310,1433,268,119,118,1,40,1,0.050847458,0,empty,CD-0722-1
"C7,B7",955708,1111469,713572,397897,514427,283749,1,284023,237000,47023,5.040086766,165049,76640,16463,4717,4663,54,879,4,0.045249839,0,hg38,CD-0722-1
"C7,B8",5317,5922,4078,1844,2863,1363,0,1363,873,490,1.781632653,747,1387,295,126,126,0,49,0,0.087301587,0,empty,CD-0722-1
"C7,B9",14826,16244,10982,5262,7615,3857,2,3865,2416,1449,1.667356798,2182,3614,1009,339,336,3,97,2,0.020833333,0,empty,CD-0722-1
"C7,B10",5403,5662,3872,1790,2774,1359,0,1369,854,515,1.658252427,751,494,57,28,28,0,12,0,0,0,empty,CD-0722-1
"C7,B11",10924,12283,7961,4322,5815,3076,0,3079,1810,1269,1.426319937,1812,201,65,35,35,0,18,0,0,0,empty,CD-0722-1
"C7,B12",6619,7176,4829,2347,3504,1693,0,1693,1134,559,2.02862254,981,1826,528,195,192,3,61,1,0.010416667,0,empty,CD-0722-1
"C7,C1",14190,15434,10774,4660,7046,3400,1,3404,2133,1271,1.678206137,1832,1295,306,101,97,4,28,2,0,0,empty,CD-0722-1
"C7,C2",11279,12556,8224,4332,6077,3105,0,3107,1950,1157,1.685393258,1855,3014,801,265,263,2,66,2,0.144486692,0,empty,CD-0722-1
"C7,C3",1026723,1187331,777452,409879,542560,286401,5,286723,225902,60821,3.714210552,167944,51528,6180,2119,2056,63,450,5,0.063715953,0,hg38,CD-0722-1
"C7,C4",7360,7995,5656,2339,3743,1719,1,1722,1153,569,2.026362039,922,2374,649,173,171,2,55,1,0.140350877,0,empty,CD-0722-1
"C7,C5",11579,12598,8678,3920,6059,3007,0,3015,2068,947,2.18373812,1702,2298,486,186,186,0,60,0,0.193548387,0,empty,CD-0722-1
"C7,C6",9084,9856,6730,3126,4916,2540,0,2543,1688,855,1.974269006,1414,2125,486,204,201,3,82,2,0.074626866,0,empty,CD-0722-1
"C7,C7",12249,14174,8692,5482,6747,3729,1,3734,2236,1498,1.492656876,2302,635,175,65,65,0,33,0,0.169230769,0,empty,CD-0722-1
"C7,C8",12784,14153,9350,4803,6659,3315,1,3317,2114,1203,1.757273483,1913,3555,799,258,254,4,73,2,0.153543307,0,empty,CD-0722-1
"C7,C9",9339,10480,6926,3554,4877,2400,0,2405,1564,841,1.859690844,1373,1576,345,138,136,2,40,1,0.029411765,0,empty,CD-0722-1
"C7,C10",10863,11799,8121,3678,5501,2635,3,2641,1692,949,1.782929399,1449,2221,502,170,168,2,63,1,0.047619048,0,empty,CD-0722-1
"C7,C11",9678,10553,7340,3213,5093,2481,0,2485,1624,861,1.886178862,1406,2288,561,199,196,3,67,2,0.091836735,0,empty,CD-0722-1
"C7,C12",328801,370940,236193,134747,176155,99350,2,99445,77829,21616,3.600527387,58177,5753,2188,662,659,3,173,2,0.048558422,0,hg38,CD-0722-1
"C7,D1",11754,13174,8515,4659,6208,3286,0,3287,2018,1269,1.590228526,1893,1240,260,91,89,2,35,2,0,0,empty,CD-0722-1
"C7,D2",10109,11189,7764,3425,5354,2628,0,2628,1690,938,1.801705757,1461,3810,1096,390,384,6,115,2,0.1171875,0,empty,CD-0722-1
"C7,D3",751444,890825,553181,337644,415052,233091,1,233336,187444,45892,4.084459165,140478,31352,4510,1595,1574,21,423,2,0.063532402,0,hg38,CD-0722-1
"C7,D4",6454,7445,4870,2575,3575,1817,0,1821,1131,690,1.639130435,1079,1513,266,101,100,1,44,1,0.01,0,empty,CD-0722-1
"C7,D5",7895,8322,5900,2422,4006,1982,1,1991,1242,749,1.658210948,1105,1913,400,159,159,0,57,0,0.056603774,0,empty,CD-0722-1
"C7,D6",11425,12915,8341,4574,6100,3216,0,3222,1966,1256,1.565286624,1910,2372,586,210,205,5,64,2,0.058536585,0,empty,CD-0722-1
"C7,D7",6688,7256,5043,2213,3503,1644,0,1644,1056,588,1.795918367,913,2119,620,209,203,6,62,2,0.004926108,0,empty,CD-0722-1
"C7,D8",2052557,2356848,1574010,782838,1060643,555467,5,556053,453071,102982,4.39951642,321060,273987,49157,15967,15675,292,2344,8,0.044210526,0,hg38,CD-0722-1
"C7,D9",4198,4636,3134,1502,2208,1041,0,1041,662,379,1.746701847,609,2245,484,173,172,1,56,1,0.145348837,0,empty,CD-0722-1
"C7,D10",7589,8540,5586,2954,4029,2053,0,2055,1172,883,1.327293318,1199,1075,235,78,78,0,22,0,0.153846154,0,empty,CD-0722-1
"C7,D11",490826,526696,387602,139094,246904,110579,2,110713,84073,26640,3.155893393,59634,41707,6967,2249,2202,47,533,4,0.018165304,0,hg38,CD-0722-1
"C7,D12",11461,12567,8588,3979,5869,2907,0,2909,1928,981,1.965341488,1644,4541,1419,482,481,1,126,1,0.172557173,0,empty,CD-0722-1
"C7,E1",13157,14421,9694,4727,7026,3545,0,3550,2202,1348,1.633531157,2055,3441,772,276,273,3,96,1,0.146520147,0,empty,CD-0722-1
"C7,E2",10209,11360,7491,3869,5378,2668,2,2677,1732,945,1.832804233,1598,2187,569,204,203,1,59,1,0.014778325,0,empty,CD-0722-1
"C7,E3",7020,7996,5278,2718,3755,1785,0,1791,1162,629,1.847376789,1051,3048,769,278,277,1,81,1,0.083032491,0,empty,CD-0722-1
"C7,E4",1171517,1290261,917675,372586,585657,282490,5,282912,224378,58534,3.83329347,155107,234345,25111,8138,7899,239,1582,7,0.026332447,0,hg38,CD-0722-1
"C7,E5",8406,9132,6390,2742,4377,2060,0,2062,1337,725,1.844137931,1150,1375,304,127,118,9,48,2,0.110169492,0,empty,CD-0722-1
"C7,E6",677926,740807,526483,214324,340213,160008,7,160180,124121,36059,3.442164231,87749,146006,21862,7225,7032,193,1222,11,0.041240046,0,hg38,CD-0722-1
"C7,E7",12164,13309,9178,4131,6406,3019,0,3021,2037,984,2.070121951,1695,3683,905,346,342,4,111,3,0.078947368,0,empty,CD-0722-1
"C7,E8",10672,11662,8069,3593,5470,2506,3,2515,1632,883,1.848244621,1440,3391,738,243,242,1,66,1,0.066115702,0,empty,CD-0722-1
"C7,E9",6342,7320,4706,2614,3402,1706,0,1713,1125,588,1.913265306,1002,3403,817,284,281,3,96,2,0.039145907,0,empty,CD-0722-1
"C7,E10",8151,9097,6254,2843,4263,1935,0,1935,1258,677,1.858197932,1079,2008,394,156,155,1,62,1,0.096774194,0,empty,CD-0722-1
"C7,E11",711120,829990,525835,304155,391165,213752,0,213992,173086,40906,4.23131081,127534,290201,52042,17207,16914,293,2268,9,0.057940168,0,hg38,CD-0722-1
"C7,E12",9601,10608,7214,3394,4931,2431,0,2432,1580,852,1.854460094,1399,2231,447,166,165,1,56,1,0.006060606,0,empty,CD-0722-1
"C7,F1",746277,844309,562542,281767,387121,198143,3,198327,151483,46844,3.233775937,114990,191089,23929,7864,7648,216,1331,7,0.056354603,0,hg38,CD-0722-1
"C7,F2",10533,11394,7901,3493,5342,2558,0,2563,1712,851,2.011750881,1397,3681,697,258,255,3,102,2,0.066666667,0,empty,CD-0722-1
"C7,F3",8805,9449,6560,2889,4632,2234,0,2234,1444,790,1.827848101,1274,4037,968,306,304,2,102,1,0.049342105,0,empty,CD-0722-1
"C7,F4",13898,14633,10430,4203,7089,3240,4,3247,2103,1144,1.838286713,1790,836,163,48,47,1,27,1,0.021276596,0,empty,CD-0722-1
"C7,F5",11134,12181,8409,3772,5717,2634,0,2642,1714,928,1.846982759,1521,2054,503,186,183,3,66,1,0.092896175,0,empty,CD-0722-1
"C7,F6",10213,11362,7594,3768,5468,2839,0,2842,1937,905,2.140331492,1654,3326,691,235,234,1,82,1,0.047008547,0,empty,CD-0722-1
"C7,F7",13174,14891,9776,5115,6915,3447,0,3454,2239,1215,1.842798354,1998,1810,433,160,157,3,50,2,0.012738854,0,empty,CD-0722-1
"C7,F8",8085,9221,6087,3134,4341,2134,0,2134,1332,802,1.66084788,1244,223,81,30,30,0,12,0,0.5,0,empty,CD-0722-1
"C7,F9",9588,10386,7489,2897,4914,2219,0,2221,1468,753,1.949535193,1181,3361,736,253,247,6,75,2,0.024291498,0,empty,CD-0722-1
"C7,F10",932130,1060351,708277,352074,486365,250528,3,250835,194108,56727,3.421792092,144302,85385,14846,4546,4460,86,914,5,0.061210762,0,hg38,CD-0722-1
"C7,F11",8895,9915,6764,3151,4548,2148,0,2150,1440,710,2.028169014,1243,2019,476,154,153,1,48,1,0.026143791,0,empty,CD-0722-1
"C7,F12",10136,10823,7630,3193,5082,2434,0,2439,1600,839,1.907032181,1348,217,24,17,17,0,13,0,0,0,empty,CD-0722-1
"C7,G1",11452,12242,8653,3589,5946,2790,0,2797,1854,943,1.966065748,1585,3346,712,279,279,0,106,0,0.0609319,0,empty,CD-0722-1
"C7,G2",6720,7532,4800,2732,3574,1873,0,1877,1194,683,1.748169839,1125,563,152,59,58,1,26,1,0.017241379,0,empty,CD-0722-1
"C7,G3",12360,13498,9210,4288,6332,3191,0,3195,1933,1262,1.531695721,1714,2748,687,286,283,3,80,2,0.219081272,0,empty,CD-0722-1
"C7,G4",21578,24243,15770,8473,11454,6222,0,6237,3836,2401,1.597667638,3602,152,25,14,14,0,9,0,0.071428571,0,empty,CD-0722-1
"C7,G5",7680,8413,5727,2686,4053,1993,0,1994,1262,732,1.724043716,1167,1502,298,95,93,2,40,1,0.021505376,0,empty,CD-0722-1
"C7,G6",11190,11883,8466,3417,5564,2688,2,2699,1757,942,1.865180467,1457,206,42,17,17,0,6,0,0.058823529,0,empty,CD-0722-1
"C7,G7",9116,9868,6924,2944,4605,2159,0,2163,1423,740,1.922972973,1149,3944,1122,371,362,9,102,3,0.121546961,0,empty,CD-0722-1
"C7,G8",6450,7033,4819,2214,3270,1560,1,1564,956,608,1.572368421,859,1678,371,136,131,5,46,2,0.076335878,0,empty,CD-0722-1
"C7,G9",8246,9099,6073,3026,4224,2055,0,2060,1304,756,1.724867725,1203,2967,778,265,264,1,89,1,0.064393939,0,empty,CD-0722-1
"C7,G10",9101,10190,6760,3430,4846,2453,0,2457,1560,897,1.739130435,1422,2854,689,248,247,1,93,1,0.089068826,0,empty,CD-0722-1
"C7,G11",9681,11026,7296,3730,5074,2429,0,2430,1575,855,1.842105263,1368,2037,398,122,118,4,54,1,0.033898305,0,empty,CD-0722-1
"C7,G12",613961,692435,462863,229572,329855,167769,0,167941,137413,30528,4.501212002,97287,75945,20956,6585,6507,78,1019,3,0.024127862,0,hg38,CD-0722-1
"C7,H1",7387,8059,5575,2484,3854,1831,0,1833,1151,682,1.687683284,1027,1378,341,111,111,0,30,0,0.036036036,0,empty,CD-0722-1
"C7,H2",13356,15169,9896,5273,7046,3643,0,3647,2484,1163,2.135855546,2101,2628,543,204,203,1,78,1,0.123152709,0,empty,CD-0722-1
"C7,H3",7537,8147,5512,2635,3885,1901,0,1907,1209,698,1.732091691,1092,1635,383,133,132,1,46,1,0.136363636,0,empty,CD-0722-1
"C7,H4",11495,12599,8445,4154,5826,2844,0,2845,1818,1027,1.770204479,1662,199,30,16,16,0,12,0,0,0,empty,CD-0722-1
"C7,H5",12124,13558,9090,4468,6164,3106,0,3113,1928,1185,1.627004219,1797,2249,544,196,190,6,57,2,0.052631579,0,empty,CD-0722-1
"C7,H6",7706,8389,5479,2910,3975,2032,0,2034,1380,654,2.110091743,1198,4195,818,254,249,5,71,2,0.036144578,0,empty,CD-0722-1
"C7,H7",8604,9449,6383,3066,4454,2130,0,2131,1414,717,1.972105997,1252,1923,364,127,127,0,52,0,0,0,empty,CD-0722-1
"C7,H8",8663,9564,6487,3077,4605,2363,0,2363,1475,888,1.661036036,1308,2356,712,218,216,2,52,1,0.097222222,0,empty,CD-0722-1
"C7,H9",937776,1114659,687140,427519,509182,290549,4,290817,229222,61595,3.721438428,175063,86611,22132,6898,6846,52,1235,3,0.064271107,0,hg38,CD-0722-1
"C7,H10",6565,7136,4942,2194,3404,1628,0,1629,1057,572,1.847902098,928,1786,332,95,93,2,45,2,0.043010753,0,empty,CD-0722-1
"C7,H11",758249,922722,523937,398785,430833,282137,1,282368,192108,90260,2.128384667,173472,885,32,9,5,4,5,2,0,0,empty,CD-0722-1
"C7,H12",6783,7379,4924,2455,3533,1771,0,1773,1214,559,2.171735242,997,1995,472,126,124,2,42,1,0.169354839,0,empty,CD-0722-1
"C8,A1",8400,9679,6062,3617,4642,2501,0,2501,1618,883,1.832389581,1519,1792,386,130,130,0,42,0,0.046153846,0,empty,CD-0722-1
"C8,A2",12604,13797,9475,4322,6620,3281,0,3291,2132,1159,1.839516825,1797,2125,511,206,205,1,72,1,0.16097561,0,empty,CD-0722-1
"C8,A3",7310,7817,5365,2452,3802,1827,1,1838,1196,642,1.862928349,1042,1543,299,109,108,1,31,1,0.055555556,0,empty,CD-0722-1
"C8,A4",12569,13999,9489,4510,6573,3307,0,3310,2087,1223,1.706459526,1866,957,245,91,91,0,37,0,0.021978022,0,empty,CD-0722-1
"C8,A5",877882,1006542,656376,350166,462410,245887,4,246151,190634,55517,3.433795054,143765,166718,24654,8004,7837,167,1282,5,0.078346306,0,hg38,CD-0722-1
"C8,A6",487566,628749,337910,290839,296390,194692,1,194846,153342,41504,3.694631843,124345,8791,2817,803,799,4,248,2,0.082603254,0,hg38,CD-0722-1
"C8,A7",8208,8906,6010,2896,4311,2170,0,2170,1320,850,1.552941176,1222,1197,226,92,90,2,49,1,0.044444444,0,empty,CD-0722-1
"C8,A8",4998,5650,3776,1874,2802,1414,0,1416,944,472,2,812,2333,540,176,176,0,73,0,0.119318182,0,empty,CD-0722-1
"C8,A9",10796,12520,8372,4148,6004,3201,0,3214,2088,1126,1.854351687,1845,2948,629,213,212,1,86,1,0.169811321,0,empty,CD-0722-1
"C8,A10",9601,10504,7327,3177,5075,2543,0,2549,1566,983,1.593082401,1427,347,23,18,17,1,13,1,0,0,empty,CD-0722-1
"C8,A11",8158,8842,6183,2659,4184,2019,0,2021,1336,685,1.950364964,1096,2758,385,154,150,4,57,1,0.066666667,0,empty,CD-0722-1
"C8,A12",677617,822602,474970,347632,379613,246987,0,247171,181710,65461,2.77585127,149388,16718,2607,802,791,11,209,3,0.058154235,0,hg38,CD-0722-1
"C8,B1",9534,10466,7053,3413,5019,2595,0,2599,1602,997,1.606820461,1450,1647,427,151,151,0,53,0,0.112582781,0,empty,CD-0722-1
"C8,B2",9357,10108,6531,3577,4888,2608,0,2612,1662,950,1.749473684,1496,615,183,72,72,0,24,0,0.236111111,0,empty,CD-0722-1
"C8,B3",7241,7855,5341,2514,3751,1893,3,1903,1258,645,1.950387597,1038,1817,341,113,110,3,43,1,0.090909091,0,empty,CD-0722-1
"C8,B4",8960,10264,6542,3722,4907,2628,0,2631,1703,928,1.83512931,1548,1828,442,171,169,2,59,1,0.029585799,0,empty,CD-0722-1
"C8,B5",8330,4507,2692,1815,2903,1550,0,1568,1001,567,1.765432099,1028,847,161,58,58,0,21,0,0.017241379,0,empty,CD-0722-1
"C8,B6",9869,11463,7238,4225,5444,2911,1,2917,1822,1095,1.663926941,1745,2240,589,175,167,8,49,2,0.113772455,0,empty,CD-0722-1
"C8,B7",8847,10293,6804,3489,4778,2358,0,2358,1534,824,1.861650485,1315,1562,176,75,73,2,33,1,0.04109589,0,empty,CD-0722-1
"C8,B8",6924,8081,5181,2900,3838,1900,1,1902,1219,683,1.78477306,1128,1210,232,79,73,6,39,1,0.04109589,0,empty,CD-0722-1
"C8,B9",1613255,1846744,1212069,634675,829630,442345,5,442855,348664,94191,3.701670011,257911,95233,12152,3775,3714,61,800,7,0.034194938,0,hg38,CD-0722-1
"C8,B10",6816,7072,4838,2234,3621,1850,0,1866,1176,690,1.704347826,1073,506,110,40,40,0,14,0,0.35,0,empty,CD-0722-1
"C8,B11",13397,15124,9586,5538,7159,3928,0,3930,2189,1741,1.257323377,2298,456,41,14,11,3,6,1,0,0,empty,CD-0722-1
"C8,B12",7943,9064,5928,3136,4260,2120,0,2126,1378,748,1.842245989,1273,5606,656,253,251,2,84,1,0.055776892,0,empty,CD-0722-1
"C8,C1",14803,16044,11216,4828,7622,3671,3,3680,2294,1386,1.655122655,2060,1886,445,167,165,2,52,2,0.054545455,0,empty,CD-0722-1
"C8,C2",12184,13633,8902,4731,6419,3273,0,3275,2080,1195,1.740585774,1943,2436,634,176,173,3,52,2,0.057803468,0,empty,CD-0722-1
"C8,C3",1029296,1231121,766754,464367,564806,314920,2,315189,240689,74500,3.230724832,191072,26170,5974,2074,2055,19,410,3,0.127007299,0,hg38,CD-0722-1
"C8,C4",8821,9822,6550,3272,4685,2207,0,2209,1434,775,1.850322581,1291,2280,471,176,175,1,64,1,0.137142857,0,empty,CD-0722-1
"C8,C5",12883,14117,9632,4485,6696,3304,0,3313,2282,1031,2.213385063,1841,2202,649,211,210,1,70,1,0.004761905,0,empty,CD-0722-1
"C8,C6",1879246,2213843,1354641,859202,1028780,621252,4,621864,522022,99842,5.228481,370064,142847,55174,16149,16063,86,2179,7,0.011703916,0,hg38,CD-0722-1
"C8,C7",14782,17023,10514,6509,8087,4571,0,4575,2702,1873,1.442605446,2767,543,127,44,44,0,21,0,0.159090909,0,empty,CD-0722-1
"C8,C8",17136,19398,12890,6508,9285,4886,0,4893,3134,1759,1.781694144,2814,3756,1013,369,362,7,97,2,0.044198895,0,empty,CD-0722-1
"C8,C9",10593,12221,7939,4282,5706,2924,0,2924,1881,1043,1.803451582,1705,1656,284,77,76,1,34,1,0.105263158,0,empty,CD-0722-1
"C8,C10",12209,13516,9150,4366,6371,3154,0,3155,2048,1107,1.850045167,1810,2502,542,192,190,2,64,2,0.068421053,0,empty,CD-0722-1
"C8,C11",10279,11867,7580,4287,5628,2854,0,2856,1831,1025,1.786341463,1702,2717,446,149,144,5,57,1,0.097222222,0,empty,CD-0722-1
"C8,C12",14841,16080,11122,4958,7732,3692,1,3705,2414,1291,1.869868319,2087,6749,1172,414,407,7,95,3,0.036855037,0,empty,CD-0722-1
"C8,D1",13396,15220,9636,5584,7235,3925,0,3925,2423,1502,1.613182423,2368,976,90,39,39,0,22,0,0.051282051,0,empty,CD-0722-1
"C8,D2",10435,11355,8162,3193,5386,2503,0,2505,1609,896,1.795758929,1327,3558,796,333,332,1,109,1,0.138554217,0,empty,CD-0722-1
"C8,D3",10374,11674,7620,4054,5644,2975,0,2986,1957,1029,1.901846453,1735,2241,481,187,184,3,63,2,0.097826087,0,empty,CD-0722-1
"C8,D4",9180,10160,6974,3186,4785,2356,0,2356,1600,756,2.116402116,1308,2153,595,159,156,3,42,3,0.179487179,0,empty,CD-0722-1
"C8,D5",9105,10223,6834,3389,4910,2443,1,2446,1605,841,1.908442331,1393,2118,418,175,173,2,70,1,0.034682081,0,empty,CD-0722-1
"C8,D6",12685,14028,9052,4976,6623,3618,1,3629,2231,1398,1.595851216,2148,2008,456,162,156,6,49,3,0.044871795,0,empty,CD-0722-1
"C8,D7",7601,8265,5855,2410,3994,1908,0,1911,1227,684,1.793859649,1079,2989,795,282,279,3,80,1,0.0609319,0,empty,CD-0722-1
"C8,D8",9775,11079,7180,3899,5250,2610,0,2620,1710,910,1.879120879,1597,1649,278,109,109,0,48,0,0.082568807,0,empty,CD-0722-1
"C8,D9",476960,543578,357859,185719,254086,133135,5,133282,107579,25703,4.185464732,77495,145585,19288,6146,6001,145,1218,5,0.02866189,0,hg38,CD-0722-1
"C8,D10",8212,9437,6143,3294,4236,2147,0,2151,1353,798,1.695488722,1256,1115,234,72,67,5,22,2,0.104477612,0,empty,CD-0722-1
"C8,D11",10572,11555,8036,3519,5580,2687,0,2690,1742,948,1.837552743,1484,3759,682,234,230,4,91,1,0.091304348,0,empty,CD-0722-1
"C8,D12",2816849,3286712,2102975,1183737,1456533,814078,15,814949,635764,179185,3.548087172,483940,601832,81761,25913,25264,649,3395,14,0.055098163,0,hg38,CD-0722-1
"C8,E1",15513,17186,11355,5831,8169,4175,0,4179,2563,1616,1.586014851,2392,3824,686,278,277,1,107,1,0.054151625,0,empty,CD-0722-1
"C8,E2",11137,12366,8259,4107,5908,2974,0,2976,1926,1050,1.834285714,1760,2526,435,154,153,1,65,1,0.013071895,0,empty,CD-0722-1
"C8,E3",7748,8514,5925,2589,4075,1957,0,1957,1256,701,1.791726106,1094,3178,881,333,331,2,99,2,0.012084592,0,empty,CD-0722-1
"C8,E4",10505,11603,7841,3762,5639,2798,0,2807,1836,971,1.890834192,1654,3267,563,203,201,2,80,2,0.044776119,0,empty,CD-0722-1
"C8,E5",9189,10230,7028,3202,4972,2340,0,2350,1480,870,1.701149425,1368,1805,412,145,144,1,56,1,0.034722222,0,empty,CD-0722-1
"C8,E6",16319,18227,12290,5937,8518,4231,1,4248,2687,1561,1.721332479,2385,9183,1688,545,535,10,142,3,0.013084112,0,empty,CD-0722-1
"C8,E7",15529,17126,11745,5381,8200,3995,0,3996,2606,1390,1.874820144,2249,3298,646,255,255,0,82,0,0.101960784,0,empty,CD-0722-1
"C8,E8",11404,12358,8900,3458,5778,2612,0,2618,1633,985,1.65786802,1377,3272,595,212,210,2,48,1,0.157142857,0,empty,CD-0722-1
"C8,E9",7905,8917,5970,2947,4334,2224,0,2228,1446,782,1.849104859,1282,3351,734,273,268,5,90,2,0.164179104,0,empty,CD-0722-1
"C8,E10",9020,9682,6702,2980,4650,2254,0,2255,1480,775,1.909677419,1269,2690,570,189,187,2,73,2,0.021390374,0,empty,CD-0722-1
"C8,E11",10677,11567,8020,3547,5435,2646,0,2650,1701,949,1.792413066,1430,2927,559,211,209,2,60,1,0.04784689,0,empty,CD-0722-1
"C8,E12",12709,14107,9587,4520,6785,3471,0,3476,2340,1136,2.059859155,1982,3544,666,250,249,1,80,1,0.064257028,0,empty,CD-0722-1
"C8,F1",12766,14291,9431,4860,6753,3352,0,3354,2085,1269,1.643026005,1990,2344,395,131,127,4,53,2,0.188976378,0,empty,CD-0722-1
"C8,F2",11669,12690,8753,3937,6152,2892,0,2899,1905,994,1.916498994,1627,3864,941,349,349,0,106,0,0.074498567,0,empty,CD-0722-1
"C8,F3",10402,11389,7725,3664,5502,2579,0,2580,1694,886,1.911963883,1474,3523,815,285,283,2,113,1,0.038869258,0,empty,CD-0722-1
"C8,F4",14726,16079,10979,5100,7743,3700,1,3710,2417,1293,1.86929621,2103,910,102,37,37,0,18,0,0,0,empty,CD-0722-1
"C8,F5",11659,12652,8637,4015,6004,2815,0,2818,1819,999,1.820820821,1626,2590,833,286,285,1,86,1,0.066666667,0,empty,CD-0722-1
"C8,F6",12663,14175,9358,4817,6709,3442,0,3449,2191,1258,1.741653418,1978,3233,574,225,217,8,86,2,0.133640553,0,empty,CD-0722-1
"C8,F7",1005856,1173568,750739,422829,537937,294917,1,295241,235541,59700,3.945410385,173747,48123,8075,2624,2585,39,575,4,0.041005803,0,hg38,CD-0722-1
"C8,F8",9204,10406,6920,3486,4857,2395,0,2397,1585,812,1.951970443,1375,249,46,9,9,0,5,0,0,0,empty,CD-0722-1
"C8,F9",10409,11501,8031,3470,5558,2655,0,2655,1762,893,1.9731243,1463,3243,866,265,260,5,80,1,0.096153846,0,empty,CD-0722-1
"C8,F10",13157,14423,10093,4330,6670,3001,0,3002,1976,1026,1.925925926,1678,2116,622,184,183,1,57,1,0.114754098,0,empty,CD-0722-1
"C8,F11",10627,11513,8123,3390,5423,2501,0,2502,1689,813,2.077490775,1364,2499,379,136,129,7,34,2,0.317829457,0,empty,CD-0722-1
"C8,F12",11250,12512,8414,4098,5964,3003,0,3007,1916,1091,1.756186984,1727,379,43,24,24,0,10,0,0.166666667,0,empty,CD-0722-1
"C8,G1",12408,14134,9276,4858,6606,3161,1,3167,2045,1122,1.822638146,1845,3565,734,285,280,5,107,2,0.039285714,0,empty,CD-0722-1
"C8,G2",7838,8639,5568,3071,4069,2185,0,2190,1407,783,1.796934866,1275,472,138,52,49,3,23,1,0.06122449,0,empty,CD-0722-1
"C8,G3",13162,14393,9803,4590,6903,3466,0,3472,2148,1324,1.622356495,1869,3175,847,280,277,3,76,2,0.285198556,0,empty,CD-0722-1
"C8,G4",24088,27208,17410,9798,12841,6981,1,6992,4259,2733,1.558360776,4071,221,38,23,22,1,14,1,0.090909091,0,empty,CD-0722-1
"C8,G5",8421,9263,6225,3038,4384,2124,0,2129,1362,767,1.775749674,1210,1748,327,138,136,2,59,1,0.25,0,empty,CD-0722-1
"C8,G6",11683,12983,8991,3992,6045,2907,4,2912,1903,1009,1.886025768,1605,252,51,22,21,1,6,1,0.095238095,0,empty,CD-0722-1
"C8,G7",808857,914445,619670,294775,424240,214628,1,214879,162725,52154,3.120086666,122094,268670,35454,11737,11423,314,1813,9,0.063731069,0,hg38,CD-0722-1
"C8,G8",7061,7509,5203,2306,3648,1783,0,1784,1155,629,1.836248013,995,1728,351,138,136,2,53,2,0.102941176,0,empty,CD-0722-1
"C8,G9",8972,9887,6696,3191,4728,2305,0,2305,1481,824,1.797330097,1307,2524,683,215,214,1,79,1,0.037383178,0,empty,CD-0722-1
"C8,G10",11070,12410,8214,4196,5866,3020,0,3027,1912,1115,1.714798206,1722,2633,702,222,217,5,85,2,0.082949309,0,empty,CD-0722-1
"C8,G11",10787,11848,8228,3620,5656,2684,0,2686,1782,904,1.971238938,1515,2029,406,129,124,5,55,2,0.016129032,0,empty,CD-0722-1
"C8,G12",8540,9470,6332,3138,4453,2237,0,2237,1389,848,1.637971698,1234,5926,902,316,306,10,91,3,0.088235294,0,empty,CD-0722-1
"C8,H1",9289,10193,6902,3291,4868,2379,1,2382,1597,785,2.034394904,1357,1513,295,107,104,3,50,1,0.125,0,empty,CD-0722-1
"C8,H2",13208,14827,9837,4990,7016,3648,0,3648,2468,1180,2.091525424,2142,2765,700,221,218,3,67,2,0.178899083,0,empty,CD-0722-1
"C8,H3",8726,9693,6416,3277,4636,2342,0,2344,1541,803,1.919053549,1338,1848,260,110,110,0,51,0,0.054545455,0,empty,CD-0722-1
"C8,H4",12726,13742,9449,4293,6604,3278,0,3281,2091,1190,1.757142857,1854,331,63,24,23,1,15,1,0.173913043,0,empty,CD-0722-1
"C8,H5",1818700,2048629,1385348,663281,910369,476850,8,477359,381435,95924,3.976429256,271212,241874,32957,10565,10345,220,1783,8,0.072015466,0,hg38,CD-0722-1
"C8,H6",8963,10553,6562,3991,4847,2542,0,2548,1659,889,1.866141732,1561,2472,573,222,220,2,53,2,0.159090909,0,empty,CD-0722-1
"C8,H7",9913,11107,7287,3820,5319,2650,2,2657,1715,942,1.82059448,1533,1779,424,171,169,2,50,1,0.082840237,0,empty,CD-0722-1
"C8,H8",10784,11786,8005,3781,5612,2804,0,2818,1829,989,1.84934277,1599,2177,402,135,130,5,51,2,0.023076923,0,empty,CD-0722-1
"C8,H9",944899,1162383,659762,502621,531801,349631,2,349954,251647,98307,2.559807542,213957,4468,440,140,133,7,51,2,0.127819549,0,hg38,CD-0722-1
"C8,H10",7570,8406,5704,2702,3985,1992,0,1998,1306,692,1.887283237,1150,1504,288,92,92,0,25,0,0.043478261,0,empty,CD-0722-1
"C8,H11",9713,11376,6756,4620,5470,3316,1,3326,1780,1546,1.151358344,2050,77,20,12,12,0,6,0,0,0,empty,CD-0722-1
"C8,H12",8957,9778,6519,3259,4687,2417,0,2420,1612,808,1.995049505,1373,4346,548,187,178,9,47,1,0.06741573,0,empty,CD-0722-1
"C9,A1",667917,769586,503915,265671,358176,187000,1,187209,144449,42760,3.37813377,109633,126833,12346,4349,4205,144,881,8,0.063020214,0,hg38,CD-0722-1
"C9,A2",10891,12060,8019,4041,5699,2976,0,2980,1815,1165,1.557939914,1702,1458,297,118,116,2,44,1,0.017241379,0,empty,CD-0722-1
"C9,A3",6490,7284,4775,2509,3368,1735,0,1742,1124,618,1.818770227,1005,1106,303,79,78,1,17,1,0.128205128,0,empty,CD-0722-1
"C9,A4",11454,12803,8626,4177,5878,2945,0,2948,1903,1045,1.821052632,1668,798,133,53,53,0,21,0,0.037735849,0,empty,CD-0722-1
"C9,A5",9476,10309,6998,3311,5014,2446,0,2450,1557,893,1.74356103,1409,2395,604,198,197,1,53,1,0.126903553,0,empty,CD-0722-1
"C9,A6",7845,8595,5951,2644,4090,2079,0,2082,1302,780,1.669230769,1154,2575,724,281,276,5,70,2,0.061594203,0,empty,CD-0722-1
"C9,A7",655672,785041,471191,313850,375520,235614,1,235806,153239,82567,1.85593518,141231,3404,731,232,224,8,68,2,0.352678571,0,hg38,CD-0722-1
"C9,A8",4201,4746,3269,1477,2271,1131,0,1131,708,423,1.673758865,637,1723,400,152,152,0,38,0,0.171052632,0,empty,CD-0722-1
"C9,A9",590561,721667,417908,303759,335793,214481,1,214687,140604,74083,1.8979253,130920,7406,780,200,194,6,74,3,0.103092784,0,hg38,CD-0722-1
"C9,A10",8620,9082,6585,2497,4223,1987,1,1996,1268,728,1.741758242,1043,470,56,28,28,0,13,0,0.25,0,empty,CD-0722-1
"C9,A11",6831,7656,5216,2440,3562,1646,0,1646,1065,581,1.833046472,948,1804,460,169,161,8,46,2,0.031055901,0,empty,CD-0722-1
"C9,A12",690091,765142,530806,234336,349120,170395,1,170644,125911,44733,2.814722911,96179,232862,26325,8783,8515,268,1456,9,0.039929536,0,hg38,CD-0722-1
"C9,B1",7614,8381,5624,2757,4004,2072,0,2075,1258,817,1.539779682,1188,1222,340,120,120,0,35,0,0.016666667,0,empty,CD-0722-1
"C9,B2",7848,8454,5442,3012,4055,2209,0,2209,1392,817,1.70379437,1296,684,200,64,64,0,25,0,0.046875,0,empty,CD-0722-1
"C9,B3",6668,7180,5030,2150,3427,1685,0,1685,1118,567,1.971781305,890,940,241,107,106,1,37,1,0.08490566,0,empty,CD-0722-1
"C9,B4",666090,748086,508973,239113,346332,173759,1,174035,137544,36491,3.769258173,97735,61816,8719,3034,2973,61,617,4,0.039354188,0,hg38,CD-0722-1
"C9,B5",9040,5060,2790,2270,3053,1715,0,1734,1214,520,2.334615385,1198,1206,200,69,69,0,19,0,0.173913043,0,empty,CD-0722-1
"C9,B6",8429,9627,6105,3522,4539,2492,1,2494,1477,1017,1.452310718,1477,1686,337,118,114,4,34,2,0.175438596,0,empty,CD-0722-1
"C9,B7",7546,8251,5574,2677,3991,1951,0,1953,1272,681,1.86784141,1137,1602,301,116,116,0,32,0,0.189655172,0,empty,CD-0722-1
"C9,B8",5634,6126,4302,1824,2934,1341,0,1343,862,481,1.792099792,735,1078,282,97,96,1,32,1,0.114583333,0,empty,CD-0722-1
"C9,B9",10924,12186,8058,4128,5781,2943,0,2946,1802,1144,1.575174825,1694,696,85,42,39,3,22,1,0,0,empty,CD-0722-1
"C9,B10",798111,829946,552288,277658,393973,192775,29,194049,152237,41812,3.640988233,114990,4108,1786,455,454,1,162,1,0.019823789,0,hg38,CD-0722-1
"C9,B11",15436,17110,11292,5818,8194,4343,0,4349,2564,1785,1.436414566,2556,112,25,16,15,1,12,1,0.266666667,0,empty,CD-0722-1
"C9,B12",6780,7417,5129,2288,3477,1658,0,1661,1106,555,1.992792793,879,1988,533,178,178,0,43,0,0,0,empty,CD-0722-1
"C9,C1",13371,14500,10102,4398,6849,3258,3,3262,2085,1177,1.771452846,1779,1184,380,114,113,1,34,1,0.14159292,0,empty,CD-0722-1
"C9,C2",10967,11926,8228,3698,5550,2779,0,2783,1761,1022,1.723091977,1526,2069,658,189,189,0,44,0,0.08994709,0,empty,CD-0722-1
"C9,C3",11685,12917,8706,4211,6119,3051,0,3052,1874,1178,1.590831919,1711,895,197,61,55,6,22,2,0.018181818,0,empty,CD-0722-1
"C9,C4",776085,884977,581735,303242,408749,218421,3,218711,171711,47000,3.653425532,127259,70328,9462,3065,3013,52,663,3,0.023564554,0,hg38,CD-0722-1
"C9,C5",10486,11477,7717,3760,5398,2646,0,2648,1725,923,1.868905742,1518,1978,489,173,172,1,66,1,0.005813953,0,empty,CD-0722-1
"C9,C6",8619,9789,6424,3365,4679,2377,2,2383,1527,856,1.783878505,1402,1677,388,131,130,1,54,1,0.007692308,0,empty,CD-0722-1
"C9,C7",11780,13490,8574,4916,6483,3598,0,3604,2128,1476,1.441734417,2160,673,120,53,53,0,27,0,0.132075472,0,empty,CD-0722-1
"C9,C8",14040,15628,10468,5160,7335,3773,1,3782,2520,1262,1.996830428,2156,3205,613,219,216,3,69,2,0.069444444,0,empty,CD-0722-1
"C9,C9",9388,10366,7172,3194,4746,2307,0,2318,1511,807,1.872366791,1263,1358,229,91,87,4,29,2,0.103448276,0,empty,CD-0722-1
"C9,C10",10504,11199,7921,3278,5203,2504,0,2505,1594,911,1.749725576,1378,2249,342,117,115,2,46,2,0.060869565,0,empty,CD-0722-1
"C9,C11",8913,10025,6598,3427,4692,2412,0,2414,1527,887,1.721533258,1409,1901,539,165,165,0,49,0,0.048484848,0,empty,CD-0722-1
"C9,C12",12689,13934,9524,4410,6471,3108,0,3112,2007,1105,1.816289593,1770,2359,518,173,171,2,53,1,0.105263158,0,empty,CD-0722-1
"C9,D1",11593,13206,8236,4970,6101,3265,0,3271,1940,1331,1.457550714,1972,591,107,33,32,1,18,1,0.28125,0,empty,CD-0722-1
"C9,D2",9434,10210,7235,2975,4783,2192,0,2197,1427,770,1.853246753,1218,2800,622,203,198,5,75,2,0.126262626,0,empty,CD-0722-1
"C9,D3",8714,9679,6422,3257,4512,2296,0,2297,1529,768,1.990885417,1351,1451,238,80,78,2,33,1,0.064102564,0,empty,CD-0722-1
"C9,D4",6386,7319,4773,2546,3438,1702,0,1702,1075,627,1.714513557,1001,1258,332,123,123,0,41,0,0.203252033,0,empty,CD-0722-1
"C9,D5",576004,692661,403602,289059,325709,209507,1,209694,145563,64131,2.269775927,127604,6587,758,266,249,17,92,2,0.148594378,0,hg38,CD-0722-1
"C9,D6",13291,15060,9297,5763,7110,4166,0,4169,2333,1836,1.270697168,2463,1566,347,116,115,1,40,1,0.086956522,0,empty,CD-0722-1
"C9,D7",6350,6931,4872,2059,3254,1514,1,1516,1017,499,2.038076152,798,1514,274,111,109,2,43,1,0.247706422,0,empty,CD-0722-1
"C9,D8",619137,693404,468184,225220,323194,165020,5,165225,125626,39599,3.17245385,94660,18477,3991,1265,1248,17,302,3,0.029647436,0,hg38,CD-0722-1
"C9,D9",6016,6482,4606,1876,3149,1446,1,1451,963,488,1.973360656,830,1838,457,156,156,0,59,0,0.025641026,0,empty,CD-0722-1
"C9,D10",7467,8331,5483,2848,3838,1985,0,1987,1241,746,1.663538874,1122,628,102,50,49,1,16,1,0.102040816,0,empty,CD-0722-1
"C9,D11",612864,687770,468516,219254,316769,158308,4,158526,121025,37501,3.227247273,90039,177537,25482,8169,7992,177,1374,10,0.048298298,0,hg38,CD-0722-1
"C9,D12",10404,11613,7867,3746,5380,2611,0,2611,1646,965,1.705699482,1479,3767,737,251,251,0,84,0,0.067729084,0,empty,CD-0722-1
"C9,E1",14229,15636,10625,5011,7222,3567,0,3571,2221,1350,1.645185185,2028,3083,645,212,212,0,71,0,0.075471698,0,empty,CD-0722-1
"C9,E2",10052,11097,7322,3775,5288,2709,0,2719,1705,1014,1.681459566,1609,2304,433,154,147,7,51,3,0.013605442,0,empty,CD-0722-1
"C9,E3",6409,6833,4919,1914,3317,1522,1,1529,976,553,1.764918626,816,2028,529,181,178,3,60,1,0.078651685,0,empty,CD-0722-1
"C9,E4",8790,9740,6428,3312,4557,2288,0,2291,1484,807,1.838909542,1299,2466,489,188,187,1,71,1,0.026737968,0,empty,CD-0722-1
"C9,E5",8038,9306,6082,3224,4345,2122,0,2125,1321,804,1.643034826,1269,1116,353,104,104,0,29,0,0.153846154,0,empty,CD-0722-1
"C9,E6",13890,15434,10345,5089,7109,3615,1,3621,2269,1352,1.678254438,2041,3315,725,255,254,1,78,1,0.043307087,0,empty,CD-0722-1
"C9,E7",13014,14105,9786,4319,6623,3149,1,3157,2056,1101,1.867393279,1771,2943,668,212,211,1,63,1,0.09478673,0,empty,CD-0722-1
"C9,E8",10332,10944,7950,2994,5117,2332,1,2337,1471,866,1.698614319,1231,2423,646,228,226,2,67,1,0.057522124,0,empty,CD-0722-1
"C9,E9",6594,7436,5007,2429,3435,1683,1,1686,1102,584,1.886986301,964,2187,454,173,172,1,62,1,0.069767442,0,empty,CD-0722-1
"C9,E10",743290,861093,551119,309974,399589,217359,0,217606,169879,47727,3.559389863,128894,122725,20315,6665,6576,89,1202,8,0.041058394,0,hg38,CD-0722-1
"C9,E11",9227,9992,6931,3061,4742,2333,40,2380,1484,896,1.65625,1327,2270,519,157,156,1,49,1,0.032051282,0,empty,CD-0722-1
"C9,E12",624674,708989,469771,239218,334883,174312,2,174542,134460,40082,3.354623023,101676,84584,9714,3179,3071,108,617,4,0.030283295,0,hg38,CD-0722-1
"C9,F1",11599,12477,8632,3845,5845,2822,0,2828,1789,1039,1.721847931,1535,2040,540,187,187,0,54,0,0.197860963,0,empty,CD-0722-1
"C9,F2",9398,10237,6895,3342,4786,2284,0,2287,1439,848,1.696933962,1294,3133,683,245,244,1,79,1,0.045081967,0,empty,CD-0722-1
"C9,F3",8865,9667,6635,3032,4493,2217,1,2222,1431,791,1.809102402,1234,2370,379,136,134,2,57,1,0.156716418,0,empty,CD-0722-1
"C9,F4",13112,14115,9941,4174,6619,3131,2,3135,2044,1091,1.873510541,1707,559,143,65,65,0,31,0,0.169230769,0,empty,CD-0722-1
"C9,F5",10068,10800,7613,3187,5079,2366,0,2371,1547,824,1.877427184,1331,1734,413,142,142,0,54,0,0.063380282,0,empty,CD-0722-1
"C9,F6",11087,12412,8188,4224,5746,2950,0,2957,1868,1089,1.71533517,1707,3079,747,250,250,0,78,0,0.068,0,empty,CD-0722-1
"C9,F7",832217,1002537,596944,405593,465998,281236,2,281489,228902,52587,4.352824843,171327,23007,4723,1424,1409,15,354,3,0.03761533,0,hg38,CD-0722-1
"C9,F8",8098,8919,6163,2756,4151,2009,1,2014,1303,711,1.832630098,1111,194,69,18,18,0,5,0,0.166666667,0,empty,CD-0722-1
"C9,F9",9039,10103,6786,3317,4703,2242,0,2243,1479,764,1.935863874,1288,2804,596,170,168,2,58,2,0.107142857,0,empty,CD-0722-1
"C9,F10",11425,12401,8543,3858,5776,2625,0,2630,1698,932,1.821888412,1471,1633,379,109,109,0,38,0,0.082568807,0,empty,CD-0722-1
"C9,F11",8968,9719,6845,2874,4586,2122,0,2130,1409,721,1.954230236,1126,1742,418,133,133,0,29,0,0.345864662,0,empty,CD-0722-1
"C9,F12",9786,10729,7352,3377,5039,2453,0,2456,1608,848,1.896226415,1390,132,49,20,20,0,9,0,0,0,empty,CD-0722-1
"C9,G1",10913,12044,8141,3903,5724,2751,0,2757,1724,1033,1.66892546,1580,2460,512,209,208,1,84,1,0.081730769,0,empty,CD-0722-1
"C9,G2",6260,6920,4414,2506,3259,1705,0,1709,1094,615,1.778861789,1011,618,163,38,38,0,10,0,0.052631579,0,empty,CD-0722-1
"C9,G3",12012,12746,8911,3835,6085,3101,0,3101,1893,1208,1.56705298,1688,2805,570,220,215,5,75,2,0.046511628,0,empty,CD-0722-1
"C9,G4",20414,22916,14751,8165,10798,5935,0,5941,3580,2361,1.51630665,3478,140,15,11,11,0,11,0,0.090909091,0,empty,CD-0722-1
"C9,G5",7441,8070,5480,2590,3826,1863,0,1868,1198,670,1.788059701,1042,1972,507,187,184,3,52,2,0.152173913,0,empty,CD-0722-1
"C9,G6",10543,11522,7919,3603,5360,2635,0,2638,1701,937,1.815368196,1522,183,31,16,16,0,5,0,0.0625,0,empty,CD-0722-1
"C9,G7",8955,9748,6833,2915,4547,2077,0,2079,1345,734,1.832425068,1181,2600,537,200,198,2,63,1,0.02020202,0,empty,CD-0722-1
"C9,G8",6193,6937,4555,2382,3279,1603,0,1606,1041,565,1.842477876,960,1714,407,135,134,1,44,1,0.059701493,0,empty,CD-0722-1
"C9,G9",869791,1028909,647202,381707,468741,256663,3,256968,204655,52313,3.912125093,153668,121508,23595,7375,7269,106,1303,5,0.082267162,0,hg38,CD-0722-1
"C9,G10",9190,9942,6913,3029,4829,2359,0,2359,1461,898,1.626948775,1318,2744,763,237,231,6,79,1,0.164502165,0,empty,CD-0722-1
"C9,G11",9590,10722,7272,3450,4946,2356,0,2359,1518,841,1.804994055,1355,1876,631,170,168,2,49,1,0.178571429,0,empty,CD-0722-1
"C9,G12",7949,9082,5885,3197,4255,2203,0,2205,1444,761,1.897503285,1312,2849,710,211,211,0,60,0,0.014218009,0,empty,CD-0722-1
"C9,H1",8025,8933,6034,2899,4202,2049,0,2051,1318,733,1.798090041,1185,921,154,54,54,0,27,0,0.055555556,0,empty,CD-0722-1
"C9,H2",9480,10848,7006,3842,5032,2588,0,2588,1692,896,1.888392857,1533,2554,588,249,248,1,72,1,0.133064516,0,empty,CD-0722-1
"C9,H3",7356,7959,5408,2551,3803,1894,0,1894,1195,699,1.709585122,1077,1618,324,108,107,1,43,1,0.037383178,0,empty,CD-0722-1
"C9,H4",835888,922712,643370,279342,421724,203155,1,203417,155084,48333,3.208656611,114105,9465,883,273,265,8,73,2,0.011320755,0,hg38,CD-0722-1
"C9,H5",11539,12592,8597,3995,5922,2996,2,3009,1903,1106,1.720614828,1678,1783,526,163,163,0,42,0,0.214723926,0,empty,CD-0722-1
"C9,H6",7639,8612,5592,3020,4019,2083,1,2085,1397,688,2.030523256,1208,1919,487,202,199,3,56,1,0.060301508,0,empty,CD-0722-1
"C9,H7",8945,9702,6737,2965,4534,2165,0,2172,1378,794,1.735516373,1219,2292,673,177,176,1,51,1,0.153409091,0,empty,CD-0722-1
"C9,H8",9083,10278,6571,3707,4729,2428,0,2430,1529,901,1.69700333,1432,2111,416,156,153,3,43,2,0.071895425,0,empty,CD-0722-1
"C9,H9",8042,8484,6102,2382,4028,1860,0,1864,1241,623,1.991974318,1045,1521,471,120,120,0,37,0,0.1,0,empty,CD-0722-1
"C9,H10",6568,7241,4950,2291,3320,1608,0,1613,1009,604,1.670529801,882,1119,217,85,85,0,31,0,0.023529412,0,empty,CD-0722-1
"C9,H11",8823,10009,6067,3942,4743,2898,1,2903,1582,1321,1.197577593,1721,31,9,7,7,0,6,0,0,0,empty,CD-0722-1
"C9,H12",711192,819551,524612,294939,382669,206924,7,207168,157291,49877,3.153577801,124100,102509,8614,2788,2663,125,611,7,0.06045813,0,hg38,CD-0722-1
"C10,A1",7947,9028,5975,3053,4271,2158,0,2165,1396,769,1.815344603,1234,1204,269,79,79,0,32,0,0.139240506,0,empty,CD-0722-1
"C10,A2",12675,13941,9505,4436,6816,3450,0,3451,2309,1142,2.021891419,1965,1960,370,146,144,2,64,1,0.090277778,0,empty,CD-0722-1
"C10,A3",6908,7767,5081,2686,3737,1886,0,1888,1256,632,1.987341772,1102,1513,430,129,125,4,42,1,0.024,0,empty,CD-0722-1
"C10,A4",12021,13140,8925,4215,6265,3060,0,3070,2020,1050,1.923809524,1715,693,163,66,65,1,26,1,0.015384615,0,empty,CD-0722-1
"C10,A5",10955,11969,8258,3711,5778,2799,0,2799,1819,980,1.856122449,1567,2372,564,220,217,3,61,2,0.073732719,0,empty,CD-0722-1
"C10,A6",657670,789664,488545,301119,364390,205323,2,205509,162583,42926,3.787518054,123774,100527,21152,6972,6883,89,1166,5,0.050268778,0,hg38,CD-0722-1
"C10,A7",739973,848751,565584,283167,390552,201939,0,202160,156835,45325,3.46023166,116364,65655,10359,3511,3439,72,672,4,0.058738005,0,hg38,CD-0722-1
"C10,A8",5126,5753,3787,1966,2746,1388,1,1391,948,443,2.139954853,815,2120,547,168,163,5,65,3,0.055214724,0,empty,CD-0722-1
"C10,A9",8639,9494,6668,2826,4551,2197,0,2204,1483,721,2.056865465,1263,1791,506,166,166,0,61,0,0.036144578,0,empty,CD-0722-1
"C10,A10",9988,10972,7689,3283,5203,2502,0,2506,1623,883,1.838052095,1335,371,62,32,32,0,16,0,0.03125,0,empty,CD-0722-1
"C10,A11",7815,8535,6084,2451,4071,1891,0,1895,1299,596,2.179530201,996,1894,447,153,152,1,55,1,0.131578947,0,empty,CD-0722-1
"C10,A12",1112154,1344597,814820,529777,615161,383283,1,383650,263606,120044,2.195911499,228922,30190,2381,716,683,33,183,5,0.338213763,0,hg38,CD-0722-1
"C10,B1",8401,9338,6198,3140,4426,2292,0,2298,1441,857,1.681446908,1291,1211,350,125,125,0,43,0,0.04,0,empty,CD-0722-1
"C10,B2",8700,9443,6045,3398,4549,2384,0,2384,1481,903,1.640088594,1387,603,77,34,33,1,18,1,0.060606061,0,empty,CD-0722-1
"C10,B3",7255,8157,5361,2796,3877,1947,0,1950,1254,696,1.801724138,1145,1643,330,156,152,4,50,2,0.118421053,0,empty,CD-0722-1
"C10,B4",9504,10871,7050,3821,5115,2733,0,2733,1756,977,1.797338792,1608,1359,162,73,73,0,45,0,0.02739726,0,empty,CD-0722-1
"C10,B5",638448,316117,188527,127590,206378,109305,15,110228,81186,29042,2.795468632,72803,57333,5711,1842,1772,70,375,4,0.065462754,0,hg38,CD-0722-1
"C10,B6",9365,10499,6805,3694,5093,2722,0,2732,1728,1004,1.721115538,1599,1647,407,145,145,0,38,0,0,0,empty,CD-0722-1
"C10,B7",8419,9356,6423,2933,4390,2135,0,2138,1370,768,1.783854167,1187,1398,342,156,155,1,37,1,0,0,empty,CD-0722-1
"C10,B8",7013,8023,5306,2717,3785,1882,0,1882,1277,605,2.110743802,1061,1176,231,94,94,0,42,0,0.053191489,0,empty,CD-0722-1
"C10,B9",1385157,1609817,1009323,600494,733691,433847,4,434281,296197,138084,2.14504939,254406,43517,4826,1706,1655,51,398,4,0.065256798,0,hg38,CD-0722-1
"C10,B10",6248,6686,4499,2187,3354,1690,0,1699,1114,585,1.904273504,962,504,42,27,26,1,12,1,0,0,empty,CD-0722-1
"C10,B11",13157,14774,9568,5206,6939,3783,0,3785,2052,1733,1.18407386,2206,260,39,25,24,1,15,1,0.291666667,0,empty,CD-0722-1
"C10,B12",7626,8541,5586,2955,4156,2112,0,2119,1392,727,1.914718019,1258,1563,260,102,102,0,41,0,0.068627451,0,empty,CD-0722-1
"C10,C1",14757,15934,11219,4715,7369,3557,0,3560,2257,1303,1.732156562,1899,814,223,101,101,0,35,0,0.02970297,0,empty,CD-0722-1
"C10,C2",11652,13168,8446,4722,6049,3144,0,3146,1964,1182,1.661590525,1859,1814,471,183,181,2,51,1,0.049723757,0,empty,CD-0722-1
"C10,C3",13120,14726,9791,4935,7029,3529,0,3533,2329,1204,1.934385382,2053,1020,245,92,92,0,35,0,0.184782609,0,empty,CD-0722-1
"C10,C4",8468,9113,6433,2680,4388,2018,1,2020,1296,724,1.790055249,1095,1604,266,102,101,1,42,1,0,0,empty,CD-0722-1
"C10,C5",13101,15018,9619,5399,7134,3648,0,3649,2474,1175,2.105531915,2192,1630,265,120,116,4,61,3,0.051724138,0,empty,CD-0722-1
"C10,C6",10229,11513,7472,4041,5607,2840,0,2844,1907,937,2.035218783,1679,1755,338,136,134,2,64,2,0.052238806,0,empty,CD-0722-1
"C10,C7",13541,15621,9897,5724,7327,4017,0,4025,2468,1557,1.58509955,2424,550,133,53,53,0,23,0,0.018867925,0,empty,CD-0722-1
"C10,C8",776466,913538,569489,344049,419096,238213,4,238469,193364,45105,4.286974836,141942,41793,7811,2508,2465,43,646,4,0.051926978,0,hg38,CD-0722-1
"C10,C9",10796,12003,8002,4001,5608,2769,0,2771,1809,962,1.88045738,1618,1803,381,133,130,3,48,2,0.084615385,0,empty,CD-0722-1
"C10,C10",11335,12635,8533,4102,5998,2972,0,2975,1917,1058,1.811909263,1675,2574,567,197,196,1,66,1,0.005102041,0,empty,CD-0722-1
"C10,C11",10233,11333,7599,3734,5420,2695,8,2708,1771,937,1.890074707,1572,2368,552,185,181,4,75,2,0.182320442,0,empty,CD-0722-1
"C10,C12",14855,16119,11094,5025,7713,3766,0,3773,2503,1270,1.970866142,2132,1975,528,174,174,0,60,0,0.068965517,0,empty,CD-0722-1
"C10,D1",13204,14803,9598,5205,6941,3708,0,3709,2340,1369,1.709276844,2126,840,206,70,70,0,26,0,0,0,empty,CD-0722-1
"C10,D2",9736,10761,7336,3425,5129,2525,0,2529,1646,883,1.86409966,1419,2595,561,178,176,2,77,1,0.107954545,0,empty,CD-0722-1
"C10,D3",708622,822724,528765,293959,379888,203526,3,203736,153694,50042,3.071300108,120979,99104,10824,3815,3685,130,792,7,0.046404342,0,hg38,CD-0722-1
"C10,D4",7632,8607,5611,2996,4216,2115,0,2116,1409,707,1.992927864,1259,1374,389,108,107,1,43,1,0.037383178,0,empty,CD-0722-1
"C10,D5",8862,9896,6656,3240,4737,2306,0,2308,1553,755,2.056953642,1303,2229,429,130,130,0,58,0,0.107692308,0,empty,CD-0722-1
"C10,D6",11993,13203,8688,4515,6272,3282,1,3289,2006,1283,1.563522993,1905,1484,402,151,146,5,54,2,0.082191781,0,empty,CD-0722-1
"C10,D7",7242,7817,5444,2373,3797,1821,0,1824,1158,666,1.738738739,1022,1919,532,181,180,1,57,1,0.094444444,0,empty,CD-0722-1
"C10,D8",8769,9873,6526,3347,4761,2377,0,2381,1440,941,1.530286929,1380,1151,331,107,100,7,45,2,0.12,0,empty,CD-0722-1
"C10,D9",5299,5953,4041,1912,2909,1400,0,1400,937,463,2.023758099,841,1886,444,201,201,0,68,0,0.014925373,0,empty,CD-0722-1
"C10,D10",7796,8530,5815,2715,4002,2026,0,2026,1322,704,1.877840909,1134,661,178,24,24,0,12,0,0.041666667,0,empty,CD-0722-1
"C10,D11",10661,11560,8057,3503,5457,2648,2,2653,1804,849,2.124852768,1460,2954,946,314,312,2,100,2,0.032051282,0,empty,CD-0722-1
"C10,D12",12070,13696,9094,4602,6271,3061,0,3067,1985,1082,1.834565619,1766,3760,993,370,367,3,113,1,0.040871935,0,empty,CD-0722-1
"C10,E1",817030,910312,619590,290722,414292,206422,1,206645,154612,52033,2.971421982,118363,163528,19325,6433,6246,187,1194,7,0.071886007,0,hg38,CD-0722-1
"C10,E2",10996,12358,8176,4182,5782,2903,0,2915,1924,991,1.941473259,1680,2033,556,195,189,6,57,1,0.052910053,0,empty,CD-0722-1
"C10,E3",688231,830158,508404,321754,382982,218816,0,219057,177774,41283,4.306227745,131825,112001,21945,7164,7050,114,1362,6,0.051489362,0,hg38,CD-0722-1
"C10,E4",10901,12278,8016,4262,5971,2965,0,2968,1897,1071,1.77124183,1751,2931,700,276,270,6,81,2,0.062962963,0,empty,CD-0722-1
"C10,E5",8428,9288,6424,2864,4391,2063,0,2070,1330,740,1.797297297,1153,1182,198,95,93,2,47,1,0,0,empty,CD-0722-1
"C10,E6",15172,17234,11253,5981,7840,3943,0,3950,2557,1393,1.835606604,2262,3771,610,228,225,3,79,1,0.088888889,0,empty,CD-0722-1
"C10,E7",15392,16834,11504,5330,8099,3975,0,3984,2653,1331,1.993238167,2205,2832,689,234,230,4,101,2,0.008695652,0,empty,CD-0722-1
"C10,E8",11072,11829,8394,3435,5641,2641,0,2641,1775,866,2.04965358,1397,3193,553,243,237,6,74,1,0.080168776,0,empty,CD-0722-1
"C10,E9",451235,574811,304920,269891,269714,185694,1,185832,117899,67933,1.73551882,117783,3562,1013,357,352,5,114,2,0.09375,0,hg38,CD-0722-1
"C10,E10",686326,786487,511287,275200,365119,195582,0,195785,153249,42536,3.602807034,114565,95257,16097,5521,5408,113,1023,5,0.026997041,0,hg38,CD-0722-1
"C10,E11",10288,11120,7720,3400,5248,2520,0,2520,1611,909,1.772277228,1410,2141,340,135,135,0,64,0,0.022222222,0,empty,CD-0722-1
"C10,E12",11600,13467,8482,4985,6439,3379,0,3385,2190,1195,1.832635983,2121,1628,352,152,149,3,64,2,0.013422819,0,empty,CD-0722-1
"C10,F1",12687,13877,9396,4481,6494,3186,0,3192,2015,1177,1.711979609,1805,1939,384,151,150,1,61,1,0.006666667,0,empty,CD-0722-1
"C10,F2",10801,11876,8054,3822,5639,2772,3,2785,1817,968,1.877066116,1630,3568,1050,416,407,9,134,2,0.061425061,0,empty,CD-0722-1
"C10,F3",10143,11017,7596,3421,5279,2555,0,2555,1651,904,1.826327434,1445,3228,703,277,270,7,91,2,0.040740741,0,empty,CD-0722-1
"C10,F4",14253,15094,10450,4644,7272,3464,4,3471,2229,1242,1.79468599,1916,898,197,77,76,1,29,1,0.171052632,0,empty,CD-0722-1
"C10,F5",891542,1012025,670456,341569,456281,239527,3,239795,188738,51057,3.696613589,138664,149912,23986,7932,7801,131,1380,6,0.072426612,0,hg38,CD-0722-1
"C10,F6",13221,14892,9673,5219,7092,3653,1,3657,2468,1189,2.07569386,2162,3003,631,209,206,3,88,2,0.04368932,0,empty,CD-0722-1
"C10,F7",13928,15562,10382,5180,7505,3758,1,3768,2457,1311,1.874141876,2174,1504,346,155,154,1,60,1,0.149350649,0,empty,CD-0722-1
"C10,F8",852843,967549,656327,311222,444184,223565,0,223784,168384,55400,3.039422383,128110,22229,2199,729,708,21,153,3,0.063559322,0,hg38,CD-0722-1
"C10,F9",10088,11434,7683,3751,5456,2661,0,2666,1699,967,1.756980352,1556,2395,541,173,172,1,67,1,0.063953488,0,empty,CD-0722-1
"C10,F10",12248,13411,9326,4085,6248,2910,0,2912,1945,967,2.011375388,1631,1819,290,121,120,1,42,1,0.258333333,0,empty,CD-0722-1
"C10,F11",10540,11827,8051,3776,5527,2608,0,2613,1757,856,2.052570093,1491,1763,356,105,104,1,46,1,0.076923077,0,empty,CD-0722-1
"C10,F12",875355,1071577,626637,444940,485850,292590,3,292868,229510,63358,3.622431264,182474,1436,518,216,214,2,54,1,0.009345794,0,hg38,CD-0722-1
"C10,G1",12653,13736,9340,4396,6580,3165,0,3170,2091,1079,1.937905468,1839,2919,737,254,250,4,99,1,0.012,0,empty,CD-0722-1
"C10,G2",7085,7860,5029,2831,3741,1988,0,1988,1238,750,1.650666667,1178,510,112,52,52,0,25,0,0,0,empty,CD-0722-1
"C10,G3",1563198,1874560,1109063,765497,860918,549473,2,549917,368496,181421,2.03116508,333614,50735,2566,930,861,69,280,3,0.272938444,0,hg38,CD-0722-1
"C10,G4",23788,26992,17104,9888,12787,7034,0,7043,4263,2780,1.533453237,4154,223,50,24,24,0,12,0,0,0,empty,CD-0722-1
"C10,G5",7946,9295,5911,3384,4481,2288,0,2290,1478,812,1.820197044,1392,1806,400,137,133,4,50,3,0.105263158,0,empty,CD-0722-1
"C10,G6",11273,12183,8410,3773,5761,2767,0,2772,1833,939,1.952076677,1585,283,55,27,26,1,10,1,0,0,empty,CD-0722-1
"C10,G7",9958,10841,7494,3347,5253,2436,2,2441,1653,788,2.097715736,1427,2396,516,222,216,6,76,2,0.064814815,0,empty,CD-0722-1
"C10,G8",6767,7371,5023,2348,3584,1776,0,1777,1163,614,1.894136808,1011,1958,363,121,121,0,51,0,0.008264463,0,empty,CD-0722-1
"C10,G9",8430,9365,6131,3234,4547,2285,0,2293,1469,824,1.78276699,1366,2268,502,209,205,4,87,2,0.092682927,0,empty,CD-0722-1
"C10,G10",10745,12175,8101,4074,5743,2895,0,2905,1913,992,1.928427419,1680,2502,540,206,203,3,86,2,0.024630542,0,empty,CD-0722-1
"C10,G11",886504,1037297,660446,376851,471737,258815,3,259145,210404,48741,4.316776431,152319,101077,20100,6551,6449,102,1179,6,0.059389053,0,hg38,CD-0722-1
"C10,G12",8018,9032,5815,3217,4271,2187,0,2194,1377,817,1.685434517,1284,2314,616,234,233,1,69,1,0.0472103,0,empty,CD-0722-1
"C10,H1",9303,10000,6914,3086,4718,2274,1,2280,1472,808,1.821782178,1273,1007,261,95,95,0,35,0,0.031578947,0,empty,CD-0722-1
"C10,H2",920787,1073771,690204,383567,492911,264554,2,264866,201666,63200,3.190917722,158077,150638,30958,10185,10027,158,1545,4,0.042086367,0,hg38,CD-0722-1
"C10,H3",462969,479255,373316,105939,225498,82551,1,82674,65122,17552,3.710232452,42106,272683,45597,14818,14527,291,2177,5,0.063123838,0,hg38,CD-0722-1
"C10,H4",12159,13411,8968,4443,6283,3132,0,3137,2031,1106,1.836347197,1772,341,75,26,26,0,18,0,0.269230769,0,empty,CD-0722-1
"C10,H5",12814,14401,9523,4878,6619,3305,2,3319,2140,1179,1.81509754,1870,1674,438,136,134,2,54,1,0.007462687,0,empty,CD-0722-1
"C10,H6",7923,8520,5931,2589,4096,2069,0,2071,1359,712,1.908707865,1165,2150,360,137,135,2,51,1,0.111111111,0,empty,CD-0722-1
"C10,H7",9888,10698,7434,3264,5081,2461,3,2466,1666,800,2.0825,1348,2242,495,185,184,1,71,1,0.027173913,0,empty,CD-0722-1
"C10,H8",2656646,3176313,1942182,1234131,1397541,821134,4,821944,669614,152330,4.395811725,497163,452571,73723,24580,24173,407,3146,10,0.074545981,0,hg38,CD-0722-1
"C10,H9",13465,14753,10372,4381,6913,3201,1,3204,2246,958,2.344467641,1792,1420,315,111,109,2,37,1,0.073394495,0,empty,CD-0722-1
"C10,H10",7534,8187,5585,2602,3902,1935,1,1943,1281,662,1.935045317,1097,1478,347,129,128,1,35,1,0.0078125,0,empty,CD-0722-1
"C10,H11",9555,11207,6649,4558,5216,3140,0,3143,1678,1465,1.145392491,1850,90,13,8,8,0,6,0,0,0,empty,CD-0722-1
"C10,H12",8947,10198,6622,3576,4793,2514,0,2518,1674,844,1.983412322,1448,1858,492,149,149,0,57,0,0.093959732,0,empty,CD-0722-1
"C11,A1",6356,7196,4625,2571,3431,1815,1,1816,1162,654,1.77675841,1044,1080,163,66,66,0,22,0,0.015151515,0,empty,CD-0722-1
"C11,A2",10361,11490,7701,3789,5495,2826,0,2832,1810,1022,1.771037182,1621,1739,300,123,121,2,39,2,0.033057851,0,empty,CD-0722-1
"C11,A3",5773,6187,4326,1861,2962,1431,2,1437,954,483,1.97515528,767,909,237,79,77,2,25,2,0,0,empty,CD-0722-1
"C11,A4",10480,11566,7535,4031,5350,2748,0,2750,1707,1043,1.63662512,1580,624,92,52,52,0,22,0,0.076923077,0,empty,CD-0722-1
"C11,A5",8768,9729,6473,3256,4748,2360,0,2368,1498,870,1.72183908,1384,2042,650,186,183,3,52,1,0.054644809,0,empty,CD-0722-1
"C11,A6",822536,946960,632662,314298,439890,227722,0,227926,188636,39290,4.801119878,131489,59502,9393,3236,3174,62,643,3,0.040642722,0,hg38,CD-0722-1
"C11,A7",6254,7028,4530,2498,3388,1771,0,1771,1138,633,1.79778831,1050,1188,282,91,89,2,34,1,0.134831461,0,empty,CD-0722-1
"C11,A8",3862,4289,2926,1363,2036,1018,0,1022,676,346,1.953757225,570,1320,244,91,88,3,35,3,0,0,empty,CD-0722-1
"C11,A9",6715,7541,5014,2527,3594,1756,2,1761,1115,646,1.726006192,1004,1298,260,118,118,0,44,0,0.016949153,0,empty,CD-0722-1
"C11,A10",8176,8948,6314,2634,4291,2053,0,2054,1288,766,1.681462141,1111,242,18,11,10,1,7,1,0,0,empty,CD-0722-1
"C11,A11",6060,6855,4600,2255,3311,1604,0,1608,1040,568,1.830985915,930,1379,350,116,116,0,37,0,0.051724138,0,empty,CD-0722-1
"C11,A12",8451,8983,6395,2588,4291,1999,0,1999,1293,706,1.831444759,1092,2556,433,172,166,6,53,2,0.018072289,0,empty,CD-0722-1
"C11,B1",6709,7177,5000,2177,3473,1721,0,1724,1099,625,1.7584,968,1057,300,103,103,0,33,0,0.009708738,0,empty,CD-0722-1
"C11,B2",1233938,1325168,920072,405096,613134,299392,4,299721,244940,54781,4.471258283,169825,18257,2656,858,840,18,184,3,0.020238095,0,hg38,CD-0722-1
"C11,B3",6255,6764,4678,2086,3223,1602,0,1605,1075,530,2.028301887,891,948,178,75,75,0,25,0,0.133333333,0,empty,CD-0722-1
"C11,B4",604476,676767,467169,209598,312254,151229,4,151408,113768,37640,3.022529224,85640,74199,8787,3022,2922,100,584,3,0.046885695,0,hg38,CD-0722-1
"C11,B5",6591,3534,2017,1517,2331,1310,0,1319,856,463,1.848812095,869,712,152,61,61,0,22,0,0.31147541,0,empty,CD-0722-1
"C11,B6",7817,8835,5556,3279,4231,2243,0,2248,1335,913,1.462212486,1352,1060,314,126,125,1,34,1,0.112,0,empty,CD-0722-1
"C11,B7",6977,7626,5433,2193,3725,1813,0,1816,1133,683,1.65885798,992,911,170,50,49,1,19,1,0.265306122,0,empty,CD-0722-1
"C11,B8",5733,6327,4423,1904,2982,1409,0,1412,938,474,1.978902954,775,892,137,65,65,0,23,0,0.107692308,0,empty,CD-0722-1
"C11,B9",9953,10881,7432,3449,5196,2651,1,2654,1657,997,1.661985958,1473,829,208,86,85,1,24,1,0.105882353,0,empty,CD-0722-1
"C11,B10",5280,5295,3662,1633,2679,1290,0,1303,841,462,1.82034632,728,448,116,36,35,1,14,1,0.028571429,0,empty,CD-0722-1
"C11,B11",15562,18297,10811,7486,8827,5417,0,5429,2893,2536,1.140772871,3347,182,24,17,16,1,12,1,0,0,empty,CD-0722-1
"C11,B12",6327,7048,4760,2288,3309,1597,0,1597,1005,592,1.697635135,875,1347,291,124,123,1,39,1,0.089430894,0,empty,CD-0722-1
"C11,C1",12586,13761,9517,4244,6445,3108,1,3114,1926,1188,1.621212121,1737,680,176,69,69,0,27,0,0,0,empty,CD-0722-1
"C11,C2",9551,10514,7139,3375,4988,2538,1,2541,1613,928,1.738146552,1447,1894,554,174,173,1,51,1,0.086705202,0,empty,CD-0722-1
"C11,C3",10221,11108,7682,3426,5463,2637,0,2641,1676,965,1.736787565,1483,521,102,47,47,0,16,0,0.29787234,0,empty,CD-0722-1
"C11,C4",6952,7427,5277,2150,3512,1590,0,1590,1018,572,1.77972028,867,1666,448,153,149,4,49,1,0.060402685,0,empty,CD-0722-1
"C11,C5",9883,11044,7346,3698,5102,2549,1,2553,1723,830,2.075903614,1474,1408,189,87,86,1,39,1,0.023255814,0,empty,CD-0722-1
"C11,C6",8273,9189,5939,3250,4500,2292,3,2297,1474,823,1.791008505,1370,1367,394,142,142,0,47,0,0.161971831,0,empty,CD-0722-1
"C11,C7",850619,1006920,635231,371689,461208,254553,1,254796,196822,57974,3.395004657,152734,35549,3874,1223,1191,32,291,2,0.037783375,0,hg38,CD-0722-1
"C11,C8",12705,13759,9429,4330,6601,3308,0,3318,2158,1160,1.860344828,1875,2906,690,219,218,1,65,1,0.128440367,0,empty,CD-0722-1
"C11,C9",8499,9737,6282,3455,4557,2321,0,2321,1504,817,1.840881273,1367,1174,233,80,79,1,26,1,0.113924051,0,empty,CD-0722-1
"C11,C10",9304,10596,6983,3613,4938,2403,0,2404,1531,873,1.753722795,1417,1312,311,96,95,1,38,1,0.042105263,0,empty,CD-0722-1
"C11,C11",8568,9392,6375,3017,4414,2224,0,2228,1430,798,1.79197995,1262,1703,413,170,169,1,53,1,0.029585799,0,empty,CD-0722-1
"C11,C12",11904,12937,8866,4071,6100,2951,0,2957,1936,1021,1.896180215,1695,1417,451,100,100,0,37,0,0.09,0,empty,CD-0722-1
"C11,D1",1564242,1887215,1136007,751208,858041,503656,9,504200,414688,89512,4.632764322,307928,132720,20762,7034,6920,114,1194,6,0.068208092,0,hg38,CD-0722-1
"C11,D2",8262,9055,6316,2739,4200,1960,0,1961,1318,643,2.049766719,1013,2122,581,233,231,2,77,2,0.008658009,0,empty,CD-0722-1
"C11,D3",7904,8698,5892,2806,4172,2101,0,2104,1380,724,1.906077348,1192,1063,199,89,89,0,35,0,0.123595506,0,empty,CD-0722-1
"C11,D4",5833,6729,4368,2361,3281,1669,0,1669,1092,577,1.89254766,986,1238,416,147,144,3,35,2,0.076388889,0,empty,CD-0722-1
"C11,D5",7180,7998,5302,2696,3794,1938,0,1944,1248,696,1.793103448,1152,1028,170,73,73,0,40,0,0.191780822,0,empty,CD-0722-1
"C11,D6",10438,11538,7623,3915,5388,2826,0,2828,1703,1125,1.513777778,1625,1041,231,83,83,0,45,0,0.024096386,0,empty,CD-0722-1
"C11,D7",5564,6194,4096,2098,2935,1408,0,1411,922,489,1.885480573,801,1651,309,99,96,3,36,1,0.083333333,0,empty,CD-0722-1
"C11,D8",7845,8659,5904,2755,4180,2031,0,2037,1337,700,1.91,1168,1210,222,99,98,1,43,1,0.030612245,0,empty,CD-0722-1
"C11,D9",4408,4795,3307,1488,2348,1178,0,1178,757,421,1.798099762,649,1565,408,157,156,1,55,1,0.076923077,0,empty,CD-0722-1
"C11,D10",6889,7725,5192,2533,3585,1789,0,1793,1167,626,1.864217252,1031,722,167,62,62,0,27,0,0.032258065,0,empty,CD-0722-1
"C11,D11",8062,9014,6197,2817,4215,1963,0,1963,1290,673,1.91679049,1054,2395,402,147,146,1,72,1,0.226027397,0,empty,CD-0722-1
"C11,D12",9534,10691,7105,3586,5033,2486,0,2486,1537,949,1.619599579,1413,2409,590,202,200,2,72,1,0.11,0,empty,CD-0722-1
"C11,E1",12488,14162,9333,4829,6643,3369,0,3373,2140,1233,1.735604217,1949,2295,485,179,177,2,60,2,0.050847458,0,empty,CD-0722-1
"C11,E2",8663,9741,6346,3395,4634,2367,0,2373,1437,936,1.53525641,1422,1774,250,121,116,5,35,2,0.146551724,0,empty,CD-0722-1
"C11,E3",575893,673181,434573,238608,312125,165833,6,166062,131068,34994,3.745442076,97778,171848,23433,7912,7709,203,1363,8,0.053444026,0,hg38,CD-0722-1
"C11,E4",10723,12034,8122,3912,5634,2709,0,2721,1922,799,2.405506884,1530,2037,462,187,185,2,70,1,0.113513514,0,empty,CD-0722-1
"C11,E5",7155,7514,5428,2086,3603,1645,0,1647,1042,605,1.72231405,864,1041,186,80,78,2,24,2,0.102564103,0,empty,CD-0722-1
"C11,E6",12419,14136,9243,4893,6495,3311,0,3317,2071,1246,1.66211878,1903,2743,762,247,242,5,67,2,0.132231405,0,empty,CD-0722-1
"C11,E7",1627598,1859334,1246900,612434,835312,435538,4,436062,337424,98638,3.420831728,250718,144440,25857,8186,8057,129,1475,4,0.043688718,0,hg38,CD-0722-1
"C11,E8",9262,10275,7135,3140,4812,2270,0,2275,1469,806,1.822580645,1291,1887,367,135,129,6,53,1,0.07751938,0,empty,CD-0722-1
"C11,E9",6730,7968,4917,3051,3745,1929,0,1931,1262,669,1.886397608,1212,2562,661,176,174,2,64,1,0.005747126,0,empty,CD-0722-1
"C11,E10",7197,7962,5428,2534,3676,1734,0,1735,1117,618,1.807443366,991,1613,496,180,177,3,49,2,0.203389831,0,empty,CD-0722-1
"C11,E11",8555,9294,6517,2777,4420,2127,0,2130,1354,776,1.744845361,1186,1858,429,157,156,1,61,1,0.08974359,0,empty,CD-0722-1
"C11,E12",9484,10709,7102,3607,4982,2528,0,2530,1584,946,1.674418605,1444,1321,231,88,88,0,35,0,0.079545455,0,empty,CD-0722-1
"C11,F1",1421815,1583973,1074598,509375,717654,372537,0,372944,302857,70087,4.321157989,212534,98685,21003,6709,6624,85,1139,4,0.042119565,0,hg38,CD-0722-1
"C11,F2",8564,9344,6388,2956,4529,2220,0,2221,1448,773,1.873221216,1272,2217,466,152,151,1,69,1,0.046357616,0,empty,CD-0722-1
"C11,F3",8057,8813,6022,2791,4174,2060,0,2063,1354,709,1.909732017,1159,2274,471,177,175,2,63,1,0.074285714,0,empty,CD-0722-1
"C11,F4",11539,12614,8668,3946,6014,2876,1,2879,1858,1021,1.819784525,1586,502,144,64,64,0,24,0,0.25,0,empty,CD-0722-1
"C11,F5",9189,9847,6988,2859,4567,2093,0,2095,1351,744,1.815860215,1155,1495,320,128,126,2,50,1,0.015873016,0,empty,CD-0722-1
"C11,F6",10127,11340,7512,3828,5277,2710,0,2714,1703,1011,1.684470821,1558,2226,375,146,139,7,55,1,0.086330935,0,empty,CD-0722-1
"C11,F7",11061,12236,8373,3863,5824,2907,2,2924,1847,1077,1.714948932,1663,873,231,100,100,0,39,0,0.05,0,empty,CD-0722-1
"C11,F8",7353,8130,5667,2463,3758,1799,6,1809,1168,641,1.822152886,983,157,77,21,21,0,7,0,0.333333333,0,empty,CD-0722-1
"C11,F9",8391,9184,6509,2675,4340,2039,0,2043,1354,689,1.965166909,1085,1973,370,153,152,1,58,1,0.072368421,0,empty,CD-0722-1
"C11,F10",10122,10829,7775,3054,5027,2343,0,2347,1534,813,1.886838868,1264,1233,254,104,103,1,40,1,0.067961165,0,empty,CD-0722-1
"C11,F11",8903,9448,6764,2684,4363,2074,2,2076,1472,604,2.437086093,1080,1264,208,85,82,3,27,2,0.146341463,0,empty,CD-0722-1
"C11,F12",8874,9918,6571,3347,4601,2245,0,2256,1464,792,1.848484848,1310,209,57,23,23,0,8,0,0.043478261,0,empty,CD-0722-1
"C11,G1",5096826,6049618,3755045,2294573,2616043,1600304,15,1601992,1227384,374608,3.276448981,960598,549170,102637,33837,33299,538,3685,15,0.05477642,0,hg38,CD-0722-1
"C11,G2",5799,6348,4174,2174,2938,1490,0,1492,977,515,1.897087379,884,358,80,37,37,0,24,0,0.027027027,0,empty,CD-0722-1
"C11,G3",10872,11429,7923,3506,5477,2803,0,2810,1702,1108,1.536101083,1486,2040,491,217,213,4,67,1,0.126760563,0,empty,CD-0722-1
"C11,G4",19279,21883,13939,7944,10274,5660,0,5671,3503,2168,1.615774908,3363,91,15,8,8,0,7,0,0,0,empty,CD-0722-1
"C11,G5",7340,8014,5400,2614,3655,1762,0,1767,1118,649,1.722650231,1026,1151,302,90,90,0,42,0,0,0,empty,CD-0722-1
"C11,G6",9503,10184,7174,3010,4812,2309,0,2311,1559,752,2.073138298,1270,176,26,6,6,0,5,0,0,0,empty,CD-0722-1
"C11,G7",8034,8800,6188,2612,4147,1958,0,1961,1299,662,1.96223565,1051,1868,454,172,172,0,53,0,0.203488372,0,empty,CD-0722-1
"C11,G8",5330,5889,3966,1923,2837,1360,0,1363,928,435,2.133333333,799,1677,372,133,128,5,41,2,0.0234375,0,empty,CD-0722-1
"C11,G9",6600,7187,4990,2197,3543,1705,0,1711,1122,589,1.904923599,973,1813,389,147,144,3,42,2,0.166666667,0,empty,CD-0722-1
"C11,G10",8706,9829,6515,3314,4568,2306,0,2311,1401,910,1.53956044,1287,2190,408,160,155,5,64,2,0.006451613,0,empty,CD-0722-1
"C11,G11",8498,9091,6389,2702,4443,2099,0,2104,1346,758,1.775725594,1146,1510,402,78,75,3,38,2,0.013333333,0,empty,CD-0722-1
"C11,G12",6835,7633,5106,2527,3692,1855,0,1859,1178,681,1.729809104,1083,1487,298,111,109,2,31,1,0.073394495,0,empty,CD-0722-1
"C11,H1",7566,8016,5674,2342,3889,1856,2,1861,1150,711,1.617440225,1058,933,141,49,48,1,18,1,0.020833333,0,empty,CD-0722-1
"C11,H2",7914,8799,5991,2808,4143,2024,0,2024,1244,780,1.594871795,1154,1570,325,112,111,1,43,1,0.153153153,0,empty,CD-0722-1
"C11,H3",6929,7672,5260,2412,3717,1837,0,1839,1167,672,1.736607143,1075,1146,240,77,74,3,33,1,0.040540541,0,empty,CD-0722-1
"C11,H4",606724,753775,408129,345646,348954,238434,2,238657,171321,67336,2.544270524,149097,469,14,9,8,1,7,1,0,0,empty,CD-0722-1
"C11,H5",10268,11483,7609,3874,5310,2699,0,2705,1658,1047,1.583572111,1579,1316,332,121,120,1,43,1,0.033333333,0,empty,CD-0722-1
"C11,H6",6243,6942,4685,2257,3308,1667,0,1671,1117,554,2.016245487,959,1269,445,159,156,3,38,2,0.038461538,0,empty,CD-0722-1
"C11,H7",7816,8494,5874,2620,4110,1952,0,1957,1314,643,2.043545879,1122,1675,340,101,99,2,35,2,0.242424242,0,empty,CD-0722-1
"C11,H8",8267,9487,6131,3356,4398,2276,0,2276,1471,805,1.827329193,1349,2004,433,144,144,0,45,0,0.020833333,0,empty,CD-0722-1
"C11,H9",6671,7313,5082,2231,3491,1627,0,1630,1049,581,1.805507745,918,1048,179,71,67,4,23,1,0.089552239,0,empty,CD-0722-1
"C11,H10",5965,6463,4460,2003,3007,1459,0,1460,959,501,1.914171657,803,794,193,75,75,0,32,0,0.093333333,0,empty,CD-0722-1
"C11,H11",8268,9616,5957,3659,4625,2770,0,2770,1557,1213,1.283594394,1685,49,4,3,3,0,3,0,0.333333333,0,empty,CD-0722-1
"C11,H12",7035,7676,5148,2528,3665,1909,0,1913,1248,665,1.876691729,1104,1707,299,88,88,0,37,0,0.056818182,0,empty,CD-0722-1
"C12,A1",7902,8866,5915,2951,4166,2138,0,2139,1408,731,1.926128591,1191,1090,137,31,30,1,15,1,0.066666667,0,empty,CD-0722-1
"C12,A2",12236,13620,9047,4573,6415,3271,0,3272,2033,1239,1.640839387,1861,1446,393,136,135,1,42,1,0.185185185,0,empty,CD-0722-1
"C12,A3",7154,7732,5277,2455,3709,1860,0,1860,1193,667,1.788605697,1041,859,171,55,54,1,26,1,0.037037037,0,empty,CD-0722-1
"C12,A4",12313,13764,9299,4465,6446,3169,0,3171,2018,1153,1.750216826,1831,749,161,47,47,0,25,0,0.085106383,0,empty,CD-0722-1
"C12,A5",10881,11815,8334,3481,5693,2772,0,2775,1739,1036,1.678571429,1530,1548,353,160,158,2,40,2,0.018987342,0,empty,CD-0722-1
"C12,A6",9261,10654,6977,3677,5091,2625,0,2631,1686,945,1.784126984,1564,2187,509,199,194,5,67,2,0.108247423,0,empty,CD-0722-1
"C12,A7",7601,8832,5473,3359,4162,2179,0,2188,1410,778,1.812339332,1347,972,204,83,82,1,28,1,0.036585366,0,empty,CD-0722-1
"C12,A8",5026,5686,3742,1944,2672,1342,0,1343,928,415,2.236144578,775,1597,437,158,157,1,36,1,0.050955414,0,empty,CD-0722-1
"C12,A9",8077,9302,6100,3202,4258,2106,0,2109,1352,757,1.785997358,1211,1808,426,151,149,2,66,1,0.020134228,0,empty,CD-0722-1
"C12,A10",9705,10390,7337,3053,5121,2474,0,2479,1520,959,1.584984359,1381,215,45,16,13,3,8,1,0.076923077,0,empty,CD-0722-1
"C12,A11",7833,8775,5905,2870,4163,1979,1,1980,1312,668,1.964071856,1133,1610,337,117,116,1,37,1,0.043103448,0,empty,CD-0722-1
"C12,A12",10028,11434,7510,3924,5229,2574,0,2575,1650,925,1.783783784,1487,2949,713,236,235,1,71,1,0.085106383,0,empty,CD-0722-1
"C12,B1",8381,9219,6264,2955,4409,2193,0,2199,1410,789,1.787072243,1249,920,277,98,98,0,32,0,0,0,empty,CD-0722-1
"C12,B2",8727,9642,6117,3525,4464,2359,0,2364,1477,887,1.665163472,1403,527,91,39,37,2,14,1,0.027027027,0,empty,CD-0722-1
"C12,B3",7147,7976,5251,2725,3883,1986,0,1987,1308,679,1.926362297,1162,771,143,60,60,0,19,0,0.133333333,0,empty,CD-0722-1
"C12,B4",8645,9789,6343,3446,4773,2540,0,2545,1590,955,1.664921466,1481,1310,310,76,76,0,29,0,0.263157895,0,empty,CD-0722-1
"C12,B5",8087,4551,2647,1904,2954,1584,0,1598,978,620,1.577419355,1069,634,182,74,74,0,19,0,0.054054054,0,empty,CD-0722-1
"C12,B6",660360,754185,502811,251374,348020,178182,4,178342,134735,43607,3.089756232,103583,105281,11698,4104,3980,124,835,5,0.089698492,0,hg38,CD-0722-1
"C12,B7",8611,9471,6516,2955,4403,2107,0,2112,1401,711,1.970464135,1157,923,188,80,76,4,22,2,0.026315789,0,empty,CD-0722-1
"C12,B8",6243,6764,4756,2008,3298,1582,0,1584,1066,518,2.057915058,867,1086,277,113,110,3,30,1,0.163636364,0,empty,CD-0722-1
"C12,B9",1337205,1528764,1010049,518715,690291,366661,2,367066,289283,77783,3.719103146,212912,71138,12162,3858,3755,103,752,4,0.050865513,0,hg38,CD-0722-1
"C12,B10",5970,6256,4362,1894,3074,1501,0,1505,952,553,1.721518987,824,186,35,15,15,0,10,0,0,0,empty,CD-0722-1
"C12,B11",13344,14977,9647,5330,7159,3981,1,3987,2240,1747,1.282198054,2394,122,8,7,7,0,6,0,0,0,empty,CD-0722-1
"C12,B12",7983,8846,5953,2893,4116,2034,0,2038,1337,701,1.907275321,1140,1168,247,98,97,1,34,1,0.010309278,0,empty,CD-0722-1
"C12,C1",14466,15459,11034,4425,7299,3463,2,3470,2275,1195,1.90376569,1901,868,199,86,85,1,19,1,0.364705882,0,empty,CD-0722-1
"C12,C2",11778,12884,8809,4075,6054,3061,1,3072,1935,1137,1.701846966,1721,1609,374,156,155,1,42,1,0.04516129,0,empty,CD-0722-1
"C12,C3",12661,13911,9637,4274,6529,3206,0,3211,2041,1170,1.744444444,1776,893,259,90,85,5,24,1,0,0,empty,CD-0722-1
"C12,C4",8745,9490,6650,2840,4642,2226,0,2232,1398,834,1.676258993,1272,1546,396,122,121,1,46,1,0.148760331,0,empty,CD-0722-1
"C12,C5",12661,14268,9528,4740,6660,3332,0,3335,2185,1150,1.9,1941,1311,255,104,104,0,44,0,0.086538462,0,empty,CD-0722-1
"C12,C6",9836,10822,7212,3610,5301,2656,0,2659,1727,932,1.853004292,1553,1193,277,99,99,0,45,0,0.121212121,0,empty,CD-0722-1
"C12,C7",13171,15160,9364,5796,7091,3952,0,3956,2350,1606,1.463262765,2415,345,59,25,25,0,12,0,0.24,0,empty,CD-0722-1
"C12,C8",15166,16810,11234,5576,7743,3885,0,3889,2591,1298,1.99614792,2237,2777,738,213,212,1,73,1,0.080188679,0,empty,CD-0722-1
"C12,C9",10854,12541,8128,4413,5639,2801,0,2801,1836,965,1.902590674,1612,997,177,71,69,2,26,2,0.014492754,0,empty,CD-0722-1
"C12,C10",11682,13205,8763,4442,6164,3055,0,3057,1957,1100,1.779090909,1733,1720,493,159,158,1,56,1,0.139240506,0,empty,CD-0722-1
"C12,C11",850446,1004050,627840,376210,462084,254722,2,255036,204309,50727,4.027618428,153753,102639,19411,6196,6094,102,1162,6,0.064653758,0,hg38,CD-0722-1
"C12,C12",14612,15902,10796,5106,7463,3587,1,3595,2350,1245,1.887550201,2039,1744,385,148,146,2,39,2,0.171232877,0,empty,CD-0722-1
"C12,D1",12381,14128,9115,5013,6637,3545,5,3550,2151,1399,1.537526805,2093,869,95,29,28,1,14,1,0,0,empty,CD-0722-1
"C12,D2",10316,11245,7948,3297,5325,2456,0,2466,1613,853,1.890973036,1355,2243,600,216,215,1,59,1,0.106976744,0,empty,CD-0722-1
"C12,D3",857390,1009415,633039,376376,464661,259787,0,260033,198590,61443,3.232101297,154719,82755,13583,4512,4413,99,892,5,0.060503059,0,hg38,CD-0722-1
"C12,D4",8864,10319,6661,3658,4843,2472,0,2474,1668,806,2.069478908,1461,1184,242,100,100,0,32,0,0.01,0,empty,CD-0722-1
"C12,D5",8681,9714,6567,3147,4495,2232,0,2234,1549,685,2.261313869,1246,2014,492,148,146,2,54,1,0.04109589,0,empty,CD-0722-1
"C12,D6",12079,13669,8764,4905,6380,3404,1,3410,2016,1394,1.446197991,1978,1376,235,111,111,0,34,0,0.009009009,0,empty,CD-0722-1
"C12,D7",6944,7579,5156,2423,3590,1726,0,1728,1115,613,1.818923328,986,1360,394,169,167,2,44,1,0.017964072,0,empty,CD-0722-1
"C12,D8",8868,10019,6616,3403,4681,2321,0,2325,1449,876,1.654109589,1361,1072,287,63,63,0,24,0,0.285714286,0,empty,CD-0722-1
"C12,D9",4992,5421,3735,1686,2670,1266,0,1268,846,422,2.004739336,730,1233,238,73,67,6,34,1,0.089552239,0,empty,CD-0722-1
"C12,D10",7944,8886,5920,2966,4156,2143,0,2144,1349,795,1.696855346,1219,726,188,65,65,0,18,0,0.184615385,0,empty,CD-0722-1
"C12,D11",9937,10975,7505,3470,5291,2577,0,2585,1667,918,1.815904139,1467,2206,524,192,190,2,71,1,0.094736842,0,empty,CD-0722-1
"C12,D12",12309,13547,9187,4360,6348,3174,0,3177,2126,1051,2.022835395,1789,3026,693,235,229,6,84,2,0.087336245,0,empty,CD-0722-1
"C12,E1",1017691,1210571,732597,477974,550678,337793,4,338137,239466,98671,2.426913683,201365,38334,4099,1300,1229,71,269,4,0.476810415,0,hg38,CD-0722-1
"C12,E2",83513,96205,61906,34299,43731,23353,2,23391,17637,5754,3.065172054,13701,4315,1021,347,343,4,92,1,0.005830904,0,empty,CD-0722-1
"C12,E3",7557,8394,5811,2583,3944,1907,0,1909,1263,646,1.955108359,1042,2156,610,204,201,3,55,2,0.114427861,0,empty,CD-0722-1
"C12,E4",10103,11589,7447,4142,5365,2675,0,2685,1738,947,1.835269271,1585,2228,528,199,199,0,63,0,0.070351759,0,empty,CD-0722-1
"C12,E5",8934,9620,6905,2715,4444,2033,0,2033,1304,729,1.788751715,1093,1980,509,204,200,4,60,1,0.025,0,empty,CD-0722-1
"C12,E6",252185,346541,152181,194360,167143,129397,1,129482,80303,49179,1.632871754,87093,4435,1279,289,286,3,100,1,0.132867133,0,hg38,CD-0722-1
"C12,E7",14843,15979,11099,4880,7622,3611,0,3618,2420,1198,2.020033389,2047,2360,736,257,256,1,79,1,0.0625,0,empty,CD-0722-1
"C12,E8",11007,12021,8527,3494,5628,2627,0,2629,1702,927,1.836030205,1433,2129,427,164,163,1,41,1,0.104294479,0,empty,CD-0722-1
"C12,E9",7974,8841,6040,2801,4075,2014,0,2018,1376,642,2.143302181,1126,1650,404,158,157,1,61,1,0.044585987,0,empty,CD-0722-1
"C12,E10",8340,8901,6188,2713,4419,2115,0,2118,1374,744,1.846774194,1198,1646,409,159,158,1,48,1,0.120253165,0,empty,CD-0722-1
"C12,E11",10022,11174,7401,3773,5355,2737,0,2739,1696,1043,1.626078619,1543,2064,397,143,142,1,48,1,0.070422535,0,empty,CD-0722-1
"C12,E12",10869,12312,7946,4366,5893,3042,0,3046,1915,1131,1.693191866,1792,1546,422,127,127,0,48,0,0.141732283,0,empty,CD-0722-1
"C12,F1",12644,13545,9435,4110,6380,3044,0,3049,1930,1119,1.724754245,1679,1808,455,174,173,1,46,1,0.242774566,0,empty,CD-0722-1
"C12,F2",10488,11715,7738,3977,5485,2648,0,2652,1732,920,1.882608696,1528,2535,570,208,200,8,53,1,0.17,0,empty,CD-0722-1
"C12,F3",9867,11066,7315,3751,5220,2625,0,2631,1705,926,1.8412527,1510,2043,436,183,182,1,59,1,0.230769231,0,empty,CD-0722-1
"C12,F4",14565,15528,10738,4790,7444,3602,2,3613,2340,1273,1.838177533,2062,865,240,66,66,0,27,0,0.015151515,0,empty,CD-0722-1
"C12,F5",11107,11748,8324,3424,5576,2588,0,2590,1656,934,1.773019272,1423,1667,510,192,191,1,49,1,0.083769634,0,empty,CD-0722-1
"C12,F6",12419,13755,9320,4435,6531,3338,0,3345,2134,1211,1.762180017,1903,2152,468,158,157,1,59,1,0.012738854,0,empty,CD-0722-1
"C12,F7",14156,15835,10675,5160,7243,3548,0,3555,2371,1184,2.002533784,2037,968,192,85,83,2,36,2,0.012048193,0,empty,CD-0722-1
"C12,F8",9203,10357,6888,3469,4799,2401,0,2404,1536,868,1.769585253,1406,151,8,4,4,0,4,0,0,0,empty,CD-0722-1
"C12,F9",10167,11104,7725,3379,5234,2475,0,2479,1585,894,1.772930649,1377,2458,734,263,259,4,59,2,0.104247104,0,empty,CD-0722-1
"C12,F10",12927,14281,9893,4388,6625,3221,0,3221,2132,1089,1.957759412,1791,1542,306,107,107,0,31,0,0.056074766,0,empty,CD-0722-1
"C12,F11",10218,11134,7758,3376,5185,2377,0,2380,1563,817,1.913096695,1303,1263,234,83,83,0,26,0,0.192771084,0,empty,CD-0722-1
"C12,F12",11421,12613,8471,4142,5869,2889,0,2897,1880,1017,1.848574238,1668,59,12,9,8,1,7,1,0.25,0,empty,CD-0722-1
"C12,G1",12407,13471,9424,4047,6346,3016,0,3019,2051,968,2.118801653,1624,2208,504,167,165,2,70,2,0.072727273,0,empty,CD-0722-1
"C12,G2",7024,7340,5092,2248,3435,1725,0,1732,1133,599,1.89148581,940,269,115,45,45,0,17,0,0.044444444,0,empty,CD-0722-1
"C12,G3",13336,14482,9846,4636,6881,3485,0,3492,2157,1335,1.615730337,1923,2574,658,248,246,2,73,2,0.06504065,0,empty,CD-0722-1
"C12,G4",23641,26776,17122,9654,12627,6974,0,6982,4244,2738,1.550036523,4100,63,12,7,7,0,7,0,0,0,empty,CD-0722-1
"C12,G5",8428,9261,6206,3055,4365,2128,1,2131,1374,757,1.815059445,1217,1395,276,120,112,8,40,2,0.098214286,0,empty,CD-0722-1
"C12,G6",11014,12195,8288,3907,5733,2781,0,2795,1799,996,1.8062249,1555,139,65,11,10,1,6,1,0.3,0,empty,CD-0722-1
"C12,G7",886891,1019881,664824,355057,470078,251941,0,252178,202737,49441,4.100584535,146725,194777,27431,9202,8990,212,1564,7,0.065517241,0,hg38,CD-0722-1
"C12,G8",7219,7704,5391,2313,3733,1770,0,1770,1138,632,1.800632911,1016,1170,225,92,92,0,39,0,0.184782609,0,empty,CD-0722-1
"C12,G9",8496,9308,6299,3009,4495,2230,1,2232,1466,766,1.91383812,1307,1752,431,138,138,0,47,0,0.166666667,0,empty,CD-0722-1
"C12,G10",671557,725358,532792,192566,336089,147019,0,147165,115178,31987,3.600775315,79292,36793,10435,3413,3388,25,647,3,0.012101535,0,hg38,CD-0722-1
"C12,G11",11281,12355,8563,3792,5829,2797,0,2801,1811,990,1.829292929,1562,1293,347,108,105,3,42,1,0.019047619,0,empty,CD-0722-1
"C12,G12",8230,9021,6110,2911,4266,2131,0,2132,1338,794,1.685138539,1209,1852,405,164,158,6,44,2,0.006329114,0,empty,CD-0722-1
"C12,H1",9353,10101,6968,3133,4816,2351,0,2352,1598,754,2.119363395,1279,1041,155,50,49,1,21,1,0.081632653,0,empty,CD-0722-1
"C12,H2",9494,10629,7007,3622,5109,2601,0,2606,1731,875,1.978285714,1502,2115,579,163,159,4,42,2,0.125786164,0,empty,CD-0722-1
"C12,H3",8561,9471,6300,3171,4410,2231,3,2236,1450,786,1.844783715,1304,972,245,91,91,0,33,0,0.076923077,0,empty,CD-0722-1
"C12,H4",12227,13124,9087,4037,6278,3060,0,3064,2070,994,2.08249497,1706,200,21,9,8,1,6,1,0.125,0,empty,CD-0722-1
"C12,H5",12441,13633,9240,4393,6340,3144,0,3144,2000,1144,1.748251748,1791,2061,706,227,226,1,43,1,0.079646018,0,empty,CD-0722-1
"C12,H6",7773,8689,5680,3009,4054,2079,0,2080,1320,760,1.736842105,1242,1679,462,114,109,5,27,1,0.055045872,0,empty,CD-0722-1
"C12,H7",1666216,1960327,1226571,733756,893911,504787,29,505381,402204,103177,3.898194365,303646,242741,42779,14028,13856,172,2194,3,0.054922055,0,hg38,CD-0722-1
"C12,H8",10483,11503,7877,3626,5358,2691,0,2693,1749,944,1.852754237,1514,1757,348,132,132,0,36,0,0.060606061,0,empty,CD-0722-1
"C12,H9",8522,9278,6417,2861,4249,2042,0,2052,1345,707,1.902404526,1125,866,233,91,88,3,31,2,0.022727273,0,empty,CD-0722-1
"C12,H10",7203,7908,5428,2480,3573,1701,0,1702,1100,602,1.827242525,931,1168,334,120,118,2,26,2,0,0,empty,CD-0722-1
"C12,H11",9599,11090,6823,4267,5325,3188,0,3199,1740,1459,1.19259767,1901,55,31,8,8,0,1,0,0,0,empty,CD-0722-1
"C12,H12",9008,9689,6619,3070,4597,2334,0,2336,1548,788,1.964467005,1329,1307,175,88,87,1,30,1,0.022988506,0,empty,CD-0722-1
"D1,A1",7900,8720,5894,2826,4187,2165,0,2170,1402,768,1.825520833,1203,1738,389,135,131,4,50,2,0.06870229,0,empty,CD-0722-1
"D1,A2",11771,13098,8793,4305,6349,3238,0,3244,2043,1201,1.701082431,1867,2437,569,216,212,4,95,2,0.033018868,0,empty,CD-0722-1
"D1,A3",558732,635390,418784,216606,295644,154775,1,154931,118936,35995,3.3042367,90192,61342,9649,2986,2904,82,586,3,0.036501377,0,hg38,CD-0722-1
"D1,A4",871178,1022235,652043,370192,464867,258048,8,258281,189913,68368,2.777805406,152383,41207,5601,1891,1853,38,399,3,0.071775499,0,hg38,CD-0722-1
"D1,A5",10836,11618,8126,3492,5748,2853,0,2856,1846,1010,1.827722772,1560,2728,606,235,233,2,89,1,0.0472103,0,empty,CD-0722-1
"D1,A6",9129,10542,6719,3823,5056,2655,0,2657,1710,947,1.805702218,1573,4439,1223,433,431,2,131,2,0.13225058,0,empty,CD-0722-1
"D1,A7",8041,9035,6026,3009,4333,2245,0,2248,1497,751,1.99334221,1278,1680,254,109,105,4,54,3,0.028571429,0,empty,CD-0722-1
"D1,A8",4818,5352,3606,1746,2582,1331,0,1331,954,377,2.530503979,741,2431,437,158,153,5,64,2,0.091503268,0,empty,CD-0722-1
"D1,A9",8311,9386,6271,3115,4428,2212,0,2212,1438,774,1.857881137,1285,2316,418,181,176,5,78,2,0.056818182,0,empty,CD-0722-1
"D1,A10",9687,10600,7477,3123,5033,2477,0,2477,1542,935,1.649197861,1347,528,153,72,72,0,34,0,0,0,empty,CD-0722-1
"D1,A11",7638,8337,5715,2622,4052,1950,0,1953,1314,639,2.056338028,1107,1810,317,137,136,1,61,1,0.029411765,0,empty,CD-0722-1
"D1,A12",10164,11018,7747,3271,5118,2478,3,2486,1623,863,1.880648899,1373,3928,1125,368,366,2,120,2,0.057377049,0,empty,CD-0722-1
"D1,B1",8333,9225,6096,3129,4376,2306,0,2308,1433,875,1.637714286,1325,1549,304,96,92,4,40,2,0.02173913,0,empty,CD-0722-1
"D1,B2",8695,9404,6008,3396,4599,2456,0,2456,1551,905,1.713812155,1441,613,160,61,61,0,27,0,0,0,empty,CD-0722-1
"D1,B3",6805,7510,4937,2573,3599,1870,0,1874,1199,675,1.776296296,1056,1533,258,105,105,0,44,0,0.114285714,0,empty,CD-0722-1
"D1,B4",8740,10042,6297,3745,4891,2647,1,2652,1711,941,1.818278427,1593,1873,295,142,137,5,73,1,0.065693431,0,empty,CD-0722-1
"D1,B5",7673,4097,2389,1708,2649,1417,0,1434,851,583,1.459691252,971,954,204,80,80,0,32,0,0.1125,0,empty,CD-0722-1
"D1,B6",504008,619303,354575,264728,285741,176004,2,176175,140351,35824,3.917792541,109962,15471,5335,1697,1687,10,394,2,0.039715471,0,hg38,CD-0722-1
"D1,B7",8716,9867,6642,3225,4402,2072,0,2074,1334,740,1.802702703,1159,1550,259,114,112,2,32,1,0.098214286,0,empty,CD-0722-1
"D1,B8",6381,7065,4791,2274,3347,1617,3,1625,1092,533,2.048780488,910,1428,278,116,111,5,50,1,0.054054054,0,empty,CD-0722-1
"D1,B9",11721,12996,8873,4123,6174,3168,0,3170,2018,1152,1.751736111,1732,1209,221,103,102,1,48,1,0.068627451,0,empty,CD-0722-1
"D1,B10",5942,6184,4318,1866,3122,1473,0,1481,977,504,1.938492063,828,781,146,35,35,0,19,0,0.171428571,0,empty,CD-0722-1
"D1,B11",12916,14519,9418,5101,6886,3789,4,3794,2141,1653,1.295220811,2261,303,37,26,26,0,20,0,0.038461538,0,empty,CD-0722-1
"D1,B12",7606,8315,5719,2596,4069,1981,3,1988,1314,674,1.949554896,1139,1836,335,125,124,1,43,1,0.024193548,0,empty,CD-0722-1
"D1,C1",14357,15369,10998,4371,7218,3379,0,3387,2199,1188,1.851010101,1805,1256,271,115,115,0,36,0,0.052173913,0,empty,CD-0722-1
"D1,C2",11544,12676,8490,4186,5946,2969,0,2977,1850,1127,1.641526176,1720,2685,754,280,280,0,68,0,0.057142857,0,empty,CD-0722-1
"D1,C3",12559,13613,9466,4147,6676,3334,0,3336,2227,1109,2.008115419,1878,1097,250,94,94,0,36,0,0.053191489,0,empty,CD-0722-1
"D1,C4",7981,8524,6054,2470,4141,1922,0,1925,1239,686,1.806122449,1071,2089,428,133,133,0,64,0,0.105263158,0,empty,CD-0722-1
"D1,C5",11765,12849,8712,4137,6137,3017,0,3023,2027,996,2.035140562,1715,2495,537,208,205,3,97,1,0.073170732,0,empty,CD-0722-1
"D1,C6",10410,11817,7702,4115,5665,2872,0,2880,1886,994,1.897384306,1698,2512,623,230,229,1,86,1,0.148471616,0,empty,CD-0722-1
"D1,C7",13088,14869,9529,5340,7102,3903,0,3911,2403,1508,1.593501326,2288,539,166,71,70,1,32,1,0.042857143,0,empty,CD-0722-1
"D1,C8",14907,16307,11131,5176,7595,3710,0,3713,2393,1320,1.812878788,2065,3426,706,286,280,6,95,3,0.085714286,0,empty,CD-0722-1
"D1,C9",10005,11383,7548,3835,5263,2593,0,2600,1637,963,1.699896158,1464,1761,380,116,113,3,42,1,0.008849558,0,empty,CD-0722-1
"D1,C10",11312,12367,8614,3753,5888,2748,0,2754,1817,937,1.939167556,1523,2355,674,227,223,4,74,1,0.035874439,0,empty,CD-0722-1
"D1,C11",9945,10832,7418,3414,5173,2501,3,2506,1627,879,1.850967008,1396,2702,651,243,238,5,85,2,0.058823529,0,empty,CD-0722-1
"D1,C12",904549,1053422,663074,390348,484857,286000,7,286339,208959,77380,2.700426467,168470,36461,12922,3866,3845,21,695,2,0.023146944,0,hg38,CD-0722-1
"D1,D1",12648,14295,9217,5078,6686,3583,0,3584,2250,1334,1.686656672,2099,1178,215,82,81,1,31,1,0,0,empty,CD-0722-1
"D1,D2",9848,10821,7451,3370,5183,2436,0,2445,1588,857,1.852975496,1372,4175,1070,312,311,1,115,1,0.025723473,0,empty,CD-0722-1
"D1,D3",9457,10835,6974,3861,5169,2591,0,2595,1747,848,2.060141509,1563,1979,304,148,146,2,65,1,0.130136986,0,empty,CD-0722-1
"D1,D4",7124,7995,5372,2623,3694,1873,0,1876,1158,718,1.61281337,1002,1852,508,164,162,2,48,2,0.092592593,0,empty,CD-0722-1
"D1,D5",8898,10166,6724,3442,4778,2325,0,2330,1514,816,1.855392157,1330,2818,729,271,267,4,90,2,0.093632959,0,empty,CD-0722-1
"D1,D6",11827,13055,8509,4546,6183,3298,0,3304,2010,1294,1.553323029,1910,2335,575,179,177,2,74,2,0.02259887,0,empty,CD-0722-1
"D1,D7",6984,7683,5358,2325,3599,1710,0,1711,1112,599,1.856427379,945,2730,555,202,199,3,67,2,0.08040201,0,empty,CD-0722-1
"D1,D8",8702,9843,6518,3325,4609,2262,0,2265,1512,753,2.007968127,1303,1856,481,189,186,3,64,1,0.075268817,0,empty,CD-0722-1
"D1,D9",2856278,3367076,2105679,1261397,1496781,869472,11,870380,707230,163150,4.334845234,519328,619903,110053,34777,34249,528,3982,11,0.045957546,0,hg38,CD-0722-1
"D1,D10",7912,8764,5787,2977,4077,2132,0,2132,1323,809,1.635352287,1203,1044,177,61,61,0,20,0,0.016393443,0,empty,CD-0722-1
"D1,D11",10306,11161,7761,3400,5507,2693,3,2699,1703,996,1.709839357,1504,4063,1159,410,400,10,127,2,0.0425,0,empty,CD-0722-1
"D1,D12",2255354,2525546,1733902,791644,1121236,573539,6,574264,445954,128310,3.475598161,325856,354393,59015,18792,18375,417,2616,12,0.045333333,0,hg38,CD-0722-1
"D1,E1",15625,16988,11585,5403,7977,3972,0,3983,2555,1428,1.789215686,2288,3395,722,286,285,1,119,1,0.101754386,0,empty,CD-0722-1
"D1,E2",10743,11769,7864,3905,5521,2782,0,2789,1781,1008,1.766865079,1573,2363,372,134,127,7,62,2,0.070866142,0,empty,CD-0722-1
"D1,E3",1802370,2146263,1342665,803598,970220,548016,4,548544,442023,106521,4.149632467,327728,489850,81135,26449,25933,516,3308,8,0.055450584,0,hg38,CD-0722-1
"D1,E4",9892,11082,7304,3778,5277,2604,0,2616,1701,915,1.859016393,1541,3030,623,269,266,3,108,2,0.022556391,0,empty,CD-0722-1
"D1,E5",8428,9226,6446,2780,4352,2018,0,2020,1299,721,1.801664355,1106,1503,286,117,117,0,48,0,0.025641026,0,empty,CD-0722-1
"D1,E6",14907,16771,10980,5791,7772,4006,0,4013,2491,1522,1.636662286,2332,4440,824,256,252,4,91,2,0.194444444,0,empty,CD-0722-1
"D1,E7",16552,18315,12536,5779,8578,4059,0,4064,2673,1391,1.921639109,2328,5780,1105,387,377,10,150,3,0.013262599,0,empty,CD-0722-1
"D1,E8",11172,11783,8694,3089,5530,2462,0,2465,1589,876,1.813926941,1329,2822,751,304,302,2,88,1,0.105960265,0,empty,CD-0722-1
"D1,E9",7716,8710,5791,2919,4143,2133,0,2135,1455,680,2.139705882,1216,3227,769,252,248,4,92,2,0.092741935,0,empty,CD-0722-1
"D1,E10",811634,961637,602080,359557,440433,245830,0,246101,190124,55977,3.396466406,147590,66434,9858,3124,3051,73,798,5,0.046869879,0,hg38,CD-0722-1
"D1,E11",9699,10764,7305,3459,5103,2505,0,2506,1644,862,1.907192575,1385,2500,533,190,190,0,68,0,0.031578947,0,empty,CD-0722-1
"D1,E12",15878,18085,11767,6318,8460,4360,0,4367,3092,1275,2.425098039,2532,2398,435,197,196,1,70,1,0.137755102,0,empty,CD-0722-1
"D1,F1",874291,1011120,645382,365738,457741,249865,4,250127,205692,44435,4.629053674,146828,191982,34998,11220,11018,202,1739,7,0.052913414,0,hg38,CD-0722-1
"D1,F2",13240,14314,9980,4334,6775,3347,0,3355,2214,1141,1.940403155,1874,5693,802,339,334,5,121,2,0.071856287,0,empty,CD-0722-1
"D1,F3",10442,11430,7946,3484,5425,2620,1,2622,1705,917,1.859323882,1477,3797,824,331,328,3,104,2,0.048780488,0,empty,CD-0722-1
"D1,F4",14180,15267,10522,4745,7239,3492,2,3500,2266,1234,1.8363047,1978,913,184,80,80,0,37,0,0.0625,0,empty,CD-0722-1
"D1,F5",10785,11591,8418,3173,5549,2548,0,2554,1665,889,1.872890889,1383,3093,797,260,258,2,81,1,0.131782946,0,empty,CD-0722-1
"D1,F6",13106,14706,9648,5058,6959,3635,0,3642,2458,1184,2.076013514,2120,4113,902,280,275,5,119,2,0.029090909,0,empty,CD-0722-1
"D1,F7",13747,15192,10310,4882,7302,3682,0,3683,2476,1207,2.051367026,2081,1534,319,127,125,2,67,2,0.12,0,empty,CD-0722-1
"D1,F8",8999,9750,6853,2897,4564,2164,0,2169,1419,750,1.892,1164,221,64,29,28,1,14,1,0.035714286,0,empty,CD-0722-1
"D1,F9",9802,10689,7494,3195,5079,2403,0,2408,1562,846,1.846335697,1338,2846,714,265,260,5,78,2,0.165384615,0,empty,CD-0722-1
"D1,F10",11978,13388,9126,4262,6200,2984,0,2989,1937,1052,1.841254753,1689,2129,574,184,182,2,54,1,0.098901099,0,empty,CD-0722-1
"D1,F11",10225,10855,7766,3089,5172,2419,0,2419,1613,806,2.001240695,1325,1961,386,145,144,1,40,1,0.138888889,0,empty,CD-0722-1
"D1,F12",10490,11557,7892,3665,5340,2585,3,2589,1722,867,1.98615917,1444,248,14,7,6,1,5,1,0,0,empty,CD-0722-1
"D1,G1",11864,12741,8973,3768,6216,2939,0,2946,1938,1008,1.922619048,1611,3694,823,323,321,2,134,1,0.133956386,0,empty,CD-0722-1
"D1,G2",6961,7563,5004,2559,3609,1809,0,1813,1127,686,1.642857143,1058,496,97,50,50,0,31,0,0.24,0,empty,CD-0722-1
"D1,G3",838415,990512,623759,366753,450727,245471,0,245762,186702,59060,3.161225872,148668,234724,31645,10769,10547,222,1692,10,0.087228596,0,hg38,CD-0722-1
"D1,G4",3417113,3930512,2582364,1348148,1699793,943547,9,944610,786721,157889,4.982747373,546205,6302,727,254,245,9,70,2,0.065306122,0,hg38,CD-0722-1
"D1,G5",8225,9140,6168,2972,4487,2224,0,2226,1474,752,1.960106383,1317,1928,555,168,168,0,66,0,0.029761905,0,empty,CD-0722-1
"D1,G6",10750,11871,8064,3807,5531,2688,0,2691,1804,887,2.033821871,1516,205,18,15,14,1,8,1,0,0,empty,CD-0722-1
"D1,G7",9905,10626,7557,3069,5102,2393,0,2396,1574,822,1.914841849,1328,3463,820,291,289,2,94,2,0.048442907,0,empty,CD-0722-1
"D1,G8",6634,7251,4948,2303,3496,1716,0,1721,1110,611,1.816693944,968,1740,340,148,148,0,61,0,0.040540541,0,empty,CD-0722-1
"D1,G9",8273,9179,6124,3055,4243,2096,0,2096,1359,737,1.843962008,1171,2637,521,190,185,5,69,2,0.12972973,0,empty,CD-0722-1
"D1,G10",10422,11598,7777,3821,5503,2842,0,2842,1804,1038,1.737957611,1621,3353,871,325,315,10,119,2,0.063492063,0,empty,CD-0722-1
"D1,G11",10272,11286,7953,3333,5336,2495,0,2499,1662,837,1.985663082,1380,1964,344,142,140,2,56,1,0.171428571,0,empty,CD-0722-1
"D1,G12",755220,884819,563280,321539,412120,222960,2,223158,169111,54047,3.12896183,133722,161854,19892,6519,6325,194,1167,6,0.052806324,0,hg38,CD-0722-1
"D1,H1",8904,9549,6634,2915,4549,2128,0,2132,1389,743,1.869448183,1179,1675,469,138,137,1,42,1,0.04379562,0,empty,CD-0722-1
"D1,H2",9544,10801,7100,3701,4994,2540,0,2540,1659,881,1.883087401,1487,2970,763,254,247,7,66,3,0.085020243,0,empty,CD-0722-1
"D1,H3",8354,9461,6235,3226,4366,2191,0,2192,1393,799,1.743429287,1286,2540,565,209,206,3,68,2,0.116504854,0,empty,CD-0722-1
"D1,H4",12630,13845,9172,4673,6500,3266,0,3273,2139,1134,1.886243386,1910,223,18,11,11,0,8,0,0,0,empty,CD-0722-1
"D1,H5",12616,14058,9539,4519,6343,3201,0,3207,2043,1164,1.755154639,1797,2541,561,218,215,3,70,1,0.069767442,0,empty,CD-0722-1
"D1,H6",7965,8843,5862,2981,4199,2186,0,2190,1461,729,2.004115226,1236,2290,502,199,195,4,65,1,0.087179487,0,empty,CD-0722-1
"D1,H7",9343,10432,6972,3460,4947,2462,5,2470,1650,820,2.012195122,1419,3226,790,237,232,5,77,2,0.034482759,0,empty,CD-0722-1
"D1,H8",1460489,1765884,1065432,700452,796485,464348,1,464812,363413,101399,3.58398998,285415,163131,26931,8765,8617,148,1590,8,0.052222351,0,hg38,CD-0722-1
"D1,H9",7824,8408,5944,2464,4056,1890,0,1892,1234,658,1.875379939,1052,1497,343,135,134,1,45,1,0.067164179,0,empty,CD-0722-1
"D1,H10",763878,901453,561966,339487,411325,237687,0,237922,180483,57439,3.142168213,141785,40585,7606,2409,2373,36,487,4,0.05899705,0,hg38,CD-0722-1
"D1,H11",9487,11011,6515,4496,5314,3205,0,3208,1821,1387,1.312905552,1960,80,5,5,5,0,4,0,0,0,empty,CD-0722-1
"D1,H12",690564,799869,509937,289932,368772,198642,4,198870,158723,40147,3.953545719,119272,152206,20377,6789,6635,154,1151,7,0.04189902,0,hg38,CD-0722-1
"D2,A1",690979,814493,511007,303486,378194,209785,1,210019,173846,36173,4.805960247,125482,119589,16356,5452,5303,149,1023,5,0.06543466,0,hg38,CD-0722-1
"D2,A2",9781,10884,7179,3705,5186,2649,0,2655,1703,952,1.788865546,1503,1788,387,141,139,2,55,1,0.071942446,0,empty,CD-0722-1
"D2,A3",5934,6665,4355,2310,3110,1548,0,1554,1008,546,1.846153846,890,1040,351,105,104,1,33,1,0.009615385,0,empty,CD-0722-1
"D2,A4",10533,11717,7776,3941,5376,2628,0,2631,1696,935,1.813903743,1502,715,175,79,78,1,30,1,0.115384615,0,empty,CD-0722-1
"D2,A5",624755,728208,464330,263878,334552,181748,0,181941,146032,35909,4.06672422,107689,145756,20347,6795,6621,174,1208,5,0.074157982,0,hg38,CD-0722-1
"D2,A6",7457,8379,5593,2786,4065,2044,0,2044,1364,680,2.005882353,1187,2207,562,171,168,3,68,2,0.029761905,0,empty,CD-0722-1
"D2,A7",6421,7506,4849,2657,3628,1883,0,1883,1175,708,1.65960452,1113,1386,213,105,105,0,48,0,0.114285714,0,empty,CD-0722-1
"D2,A8",3756,4341,2777,1564,2070,1051,0,1051,694,357,1.943977591,621,1668,240,104,103,1,66,1,0.019417476,0,empty,CD-0722-1
"D2,A9",573478,644527,443944,200583,298465,147444,1,147619,118502,29117,4.069856098,83317,20630,4216,1195,1181,14,283,2,0.035563082,0,hg38,CD-0722-1
"D2,A10",7625,8343,5764,2579,3980,1999,0,2006,1266,740,1.710810811,1094,328,64,45,45,0,19,0,0.222222222,0,empty,CD-0722-1
"D2,A11",6218,6754,4668,2086,3288,1554,0,1563,1020,543,1.878453039,888,1845,459,163,163,0,59,0,0.067484663,0,empty,CD-0722-1
"D2,A12",8471,9319,6498,2821,4348,2049,0,2051,1304,747,1.745649264,1166,3135,749,286,283,3,80,2,0.141342756,0,empty,CD-0722-1
"D2,B1",6827,7438,5227,2211,3509,1704,0,1706,1060,646,1.640866873,930,1228,247,85,81,4,39,2,0.296296296,0,empty,CD-0722-1
"D2,B2",7310,7828,4990,2838,3712,1958,0,1960,1239,721,1.718446602,1125,343,63,29,29,0,16,0,0.068965517,0,empty,CD-0722-1
"D2,B3",5748,6729,4081,2648,3135,1664,0,1664,1075,589,1.825127334,1014,1130,193,85,85,0,33,0,0.094117647,0,empty,CD-0722-1
"D2,B4",7003,8328,5146,3182,4025,2211,0,2217,1369,848,1.614386792,1338,2013,278,108,108,0,45,0,0.12962963,0,empty,CD-0722-1
"D2,B5",21007,20904,12474,8430,10671,6035,0,6054,4640,1414,3.281471004,3795,662,65,36,36,0,19,0,0.166666667,0,empty,CD-0722-1
"D2,B6",8111,9029,5922,3107,4311,2318,0,2320,1422,898,1.583518931,1351,1969,493,186,180,6,48,2,0.177777778,0,empty,CD-0722-1
"D2,B7",7098,7837,5300,2537,3618,1763,0,1764,1148,616,1.863636364,965,872,201,82,82,0,22,0,0,0,empty,CD-0722-1
"D2,B8",5222,5800,3920,1880,2787,1331,0,1331,861,470,1.831914894,784,1089,219,82,82,0,40,0,0.036585366,0,empty,CD-0722-1
"D2,B9",9649,10701,7200,3501,5147,2656,0,2662,1655,1007,1.643495531,1519,1120,208,77,74,3,32,2,0.027027027,0,empty,CD-0722-1
"D2,B10",1066527,1173847,726839,447008,557282,311608,26,312991,247596,65395,3.786161021,189943,84823,10106,3358,3293,65,717,6,0.059823869,0,hg38,CD-0722-1
"D2,B11",11066,12501,8042,4459,5769,3169,0,3172,1836,1336,1.374251497,1810,247,24,16,13,3,8,1,0,0,empty,CD-0722-1
"D2,B12",712039,828074,531316,296758,382231,207576,3,207781,161825,45956,3.521302985,123053,62267,7917,2518,2443,75,535,4,0.026606631,0,hg38,CD-0722-1
"D2,C1",2335567,2711530,1770274,941256,1192867,666838,2,667545,552905,114640,4.822967551,387042,105599,17059,5496,5413,83,1066,6,0.082948457,0,hg38,CD-0722-1
"D2,C2",756274,904568,549501,355067,412784,238552,0,238771,197896,40875,4.841492355,144990,112767,24182,7619,7525,94,1338,4,0.038272425,0,hg38,CD-0722-1
"D2,C3",10875,11899,8260,3639,5797,2870,0,2874,1843,1031,1.787584869,1605,966,149,58,55,3,24,2,0.036363636,0,empty,CD-0722-1
"D2,C4",6920,7570,5281,2289,3601,1647,0,1648,1107,541,2.046210721,917,2137,392,135,129,6,47,2,0.100775194,0,empty,CD-0722-1
"D2,C5",10297,11516,7632,3884,5674,2929,0,2933,1984,949,2.090621707,1750,1873,341,119,116,3,52,2,0.094827586,0,empty,CD-0722-1
"D2,C6",8227,8967,6100,2867,4376,2185,0,2187,1413,774,1.825581395,1251,1815,345,119,119,0,48,0,0.050420168,0,empty,CD-0722-1
"D2,C7",11138,12620,8154,4466,5927,3224,0,3229,1944,1285,1.512840467,1841,375,62,37,37,0,19,0,0.027027027,0,empty,CD-0722-1
"D2,C8",12281,13673,9103,4570,6468,3237,0,3242,2122,1120,1.894642857,1883,3564,942,294,293,1,90,1,0.092150171,0,empty,CD-0722-1
"D2,C9",1537167,1878033,1118715,759318,847664,499792,3,500311,401495,98816,4.06305659,308298,141207,23467,7827,7703,124,1421,5,0.067506166,0,hg38,CD-0722-1
"D2,C10",10132,11101,7685,3416,5171,2446,0,2451,1599,852,1.876760563,1367,2347,627,180,178,2,56,1,0.185393258,0,empty,CD-0722-1
"D2,C11",1353158,1590763,1005314,585449,720495,405189,4,405647,338567,67080,5.047212284,242108,191389,32277,10517,10352,165,1673,7,0.070034776,0,hg38,CD-0722-1
"D2,C12",11737,13110,8777,4333,6116,2964,2,2976,1873,1103,1.698096102,1728,1588,495,158,158,0,48,0,0.088607595,0,empty,CD-0722-1
"D2,D1",1310059,1449061,1011920,437141,666868,329745,2,330158,265498,64660,4.106062481,185138,3044,249,97,93,4,43,2,0.010752688,0,empty,CD-0722-1
"D2,D2",9104,9916,6883,3033,4566,2085,1,2089,1357,732,1.853825137,1137,3414,896,317,315,2,118,2,0.073015873,0,empty,CD-0722-1
"D2,D3",663194,810675,470628,340047,375081,236013,2,236226,161062,75164,2.142807727,146126,34186,14424,4480,4461,19,793,3,0.017709034,0,hg38,CD-0722-1
"D2,D4",1192666,1415552,900947,514605,635261,353632,1,353976,285317,68659,4.155565913,208827,32259,3921,1169,1150,19,381,3,0.029565217,0,hg38,CD-0722-1
"D2,D5",7529,8204,5661,2543,3973,1922,0,1922,1296,626,2.07028754,1114,2089,543,158,154,4,61,2,0.116883117,0,empty,CD-0722-1
"D2,D6",10465,11806,7529,4277,5492,2970,1,2973,1796,1177,1.525913339,1759,1956,466,138,135,3,39,1,0.185185185,0,empty,CD-0722-1
"D2,D7",5949,6341,4538,1803,3046,1398,0,1400,939,461,2.036876356,772,1588,372,134,133,1,51,1,0.07518797,0,empty,CD-0722-1
"D2,D8",7265,7986,5399,2587,3837,1895,0,1897,1275,622,2.049839228,1061,1541,388,154,151,3,54,1,0.033112583,0,empty,CD-0722-1
"D2,D9",4066,4329,3073,1256,2113,969,0,972,656,316,2.075949367,530,1812,379,150,148,2,61,1,0.081081081,0,empty,CD-0722-1
"D2,D10",6923,7795,5061,2734,3618,1865,0,1870,1120,750,1.493333333,1105,575,76,31,31,0,11,0,0,0,empty,CD-0722-1
"D2,D11",8277,9055,6325,2730,4416,2072,0,2075,1309,766,1.708877285,1160,2856,696,256,249,7,105,2,0.108433735,0,empty,CD-0722-1
"D2,D12",9794,10848,7376,3472,5207,2535,0,2544,1622,922,1.759219089,1430,2975,715,288,282,6,88,2,0.063829787,0,empty,CD-0722-1
"D2,E1",12307,13277,9059,4218,6244,3124,0,3126,1957,1169,1.674080411,1722,3076,802,316,306,10,96,4,0.107843137,0,empty,CD-0722-1
"D2,E2",8705,9683,6376,3307,4675,2341,0,2351,1538,813,1.891758918,1377,1778,365,109,105,4,49,2,0.047619048,0,empty,CD-0722-1
"D2,E3",6197,6734,4762,1972,3256,1546,1,1549,988,561,1.76114082,845,3135,719,277,272,5,87,2,0.036764706,0,empty,CD-0722-1
"D2,E4",928783,1040595,721485,319110,479120,226562,2,226839,176973,49866,3.548971243,129628,313100,44814,14955,14552,403,2122,7,0.065832875,0,hg38,CD-0722-1
"D2,E5",558039,606552,437924,168628,281909,127741,0,127940,96648,31292,3.088584942,70261,32272,6952,2132,2098,34,427,2,0.046234509,0,hg38,CD-0722-1
"D2,E6",12813,14229,9496,4733,6671,3341,0,3348,2080,1268,1.640378549,1906,2779,751,254,251,3,82,2,0.035856574,0,empty,CD-0722-1
"D2,E7",11966,12992,9041,3951,6218,2902,0,2907,1927,980,1.966326531,1631,3435,702,253,250,3,101,1,0.144,0,empty,CD-0722-1
"D2,E8",9743,10482,7543,2939,4855,2249,0,2257,1460,797,1.831869511,1207,2519,730,228,220,8,70,2,0.113636364,0,empty,CD-0722-1
"D2,E9",6135,6804,4560,2244,3206,1566,0,1566,1052,514,2.046692607,920,2516,585,173,170,3,71,1,0.064705882,0,empty,CD-0722-1
"D2,E10",6775,7222,5175,2047,3524,1622,0,1626,1092,534,2.04494382,910,1625,293,118,118,0,48,0,0.152542373,0,empty,CD-0722-1
"D2,E11",8753,9583,6555,3028,4529,2281,0,2281,1476,805,1.833540373,1266,1534,375,152,152,0,50,0,0.065789474,0,empty,CD-0722-1
"D2,E12",9021,10000,6698,3302,4763,2360,0,2360,1514,846,1.789598109,1367,1670,286,102,100,2,52,2,0.04,0,empty,CD-0722-1
"D2,F1",10806,11766,7935,3831,5509,2712,1,2716,1699,1017,1.670599803,1536,1613,311,112,107,5,44,1,0.009345794,0,empty,CD-0722-1
"D2,F2",8768,9657,6558,3099,4675,2264,0,2274,1489,785,1.896815287,1311,2630,754,291,284,7,92,1,0.042253521,0,empty,CD-0722-1
"D2,F3",9530,11236,7006,4230,5203,2825,0,2834,1776,1058,1.678638941,1720,2829,702,253,251,2,94,1,0.107569721,0,empty,CD-0722-1
"D2,F4",1671475,1870943,1274385,596558,846662,432504,26,432970,338560,94410,3.586060799,246478,29197,4873,1523,1492,31,352,3,0.021447721,0,hg38,CD-0722-1
"D2,F5",9811,10530,7324,3206,4984,2352,0,2353,1508,845,1.784615385,1342,1909,440,161,158,3,60,2,0.050632911,0,empty,CD-0722-1
"D2,F6",10034,11636,7356,4280,5397,2785,0,2787,1735,1052,1.649239544,1612,3399,904,287,285,2,85,2,0.126315789,0,empty,CD-0722-1
"D2,F7",11387,12479,8444,4035,6027,2982,0,2982,1982,1000,1.982,1717,1366,263,114,112,2,43,1,0.0625,0,empty,CD-0722-1
"D2,F8",7592,8369,5613,2756,3939,1968,0,1968,1261,707,1.783592645,1167,288,57,28,28,0,12,0,0.035714286,0,empty,CD-0722-1
"D2,F9",8224,9081,6158,2923,4194,1937,0,1939,1294,645,2.00620155,1072,2326,578,211,209,2,63,1,0.110047847,0,empty,CD-0722-1
"D2,F10",937246,1081607,709775,371832,487731,261624,4,261944,204949,56995,3.595911922,152038,168459,17821,5909,5737,172,1149,8,0.06013596,0,hg38,CD-0722-1
"D2,F11",10914,11835,8084,3751,5529,2682,0,2684,1893,791,2.393173198,1493,1689,329,100,99,1,39,1,0,0,empty,CD-0722-1
"D2,F12",9674,10855,7132,3723,5031,2535,0,2537,1611,926,1.739740821,1493,257,25,18,18,0,10,0,0,0,empty,CD-0722-1
"D2,G1",10001,11210,7556,3654,5271,2587,0,2590,1693,897,1.887402453,1469,2625,609,262,260,2,109,1,0.034615385,0,empty,CD-0722-1
"D2,G2",5386,5761,3894,1867,2808,1406,0,1406,909,497,1.828973843,800,484,115,48,47,1,27,1,0.021276596,0,empty,CD-0722-1
"D2,G3",11118,12022,8179,3843,5730,2888,0,2894,1831,1063,1.722483537,1573,2585,598,242,239,3,86,2,0.033472803,0,empty,CD-0722-1
"D2,G4",18967,21222,13702,7520,9970,5472,0,5477,3360,2117,1.58715163,3130,170,34,26,25,1,19,1,0.16,0,empty,CD-0722-1
"D2,G5",7049,8155,5143,3012,3748,1882,0,1885,1187,698,1.700573066,1146,1671,312,129,128,1,55,1,0.0859375,0,empty,CD-0722-1
"D2,G6",9571,10559,7141,3418,4768,2318,0,2321,1515,806,1.879652605,1309,149,9,7,7,0,6,0,0,0,empty,CD-0722-1
"D2,G7",2505055,2986764,1870248,1116516,1337312,784461,9,785210,638795,146415,4.362906806,466159,49602,13222,3934,3903,31,924,5,0.056366897,0,hg38,CD-0722-1
"D2,G8",5964,6529,4460,2069,3042,1460,3,1465,921,544,1.693014706,836,1528,397,150,148,2,52,1,0.02027027,0,empty,CD-0722-1
"D2,G9",6949,7545,5186,2359,3569,1744,0,1748,1112,636,1.748427673,979,2494,556,209,207,2,74,1,0.053140097,0,empty,CD-0722-1
"D2,G10",663522,774849,493138,281711,355071,195212,1,195428,155208,40220,3.858975634,114266,133942,26742,8620,8517,103,1423,4,0.052835505,0,hg38,CD-0722-1
"D2,G11",8682,9799,6688,3111,4638,2185,0,2189,1433,756,1.895502646,1252,1435,357,139,137,2,52,2,0.051094891,0,empty,CD-0722-1
"D2,G12",7147,8043,5190,2853,3841,1933,0,1934,1173,761,1.541392904,1162,1639,303,145,145,0,61,0,0.027586207,0,empty,CD-0722-1
"D2,H1",7397,7986,5620,2366,3810,1839,1,1842,1197,645,1.855813953,1043,1367,342,100,100,0,32,0,0.15,0,empty,CD-0722-1
"D2,H2",8079,8863,6059,2804,4209,2025,0,2026,1329,697,1.906743185,1123,2467,445,156,149,7,53,2,0.100671141,0,empty,CD-0722-1
"D2,H3",7117,7831,5239,2592,3687,1863,3,1868,1257,611,2.057283142,1080,1520,334,111,109,2,49,2,0.009174312,0,empty,CD-0722-1
"D2,H4",10103,11370,7517,3853,5232,2631,0,2632,1726,906,1.905077263,1550,337,80,23,23,0,10,0,0,0,empty,CD-0722-1
"D2,H5",10798,12051,7987,4064,5470,2672,0,2672,1740,932,1.86695279,1501,1848,561,157,156,1,42,1,0.006410256,0,empty,CD-0722-1
"D2,H6",6470,7368,4749,2619,3381,1690,6,1698,1149,549,2.092896175,1002,1636,310,132,132,0,48,0,0,0,empty,CD-0722-1
"D2,H7",7962,8513,5798,2715,4046,1932,0,1933,1328,605,2.195041322,1068,1749,371,167,166,1,48,1,0.090361446,0,empty,CD-0722-1
"D2,H8",8398,9537,6229,3308,4368,2220,3,2224,1415,809,1.74907293,1273,2443,713,203,199,4,57,1,0.045226131,0,empty,CD-0722-1
"D2,H9",6833,7479,5258,2221,3447,1617,0,1620,1074,546,1.967032967,904,1123,209,53,53,0,29,0,0.037735849,0,empty,CD-0722-1
"D2,H10",5769,6639,4284,2355,3064,1506,0,1508,954,554,1.722021661,881,1312,199,106,105,1,45,1,0.19047619,0,empty,CD-0722-1
"D2,H11",7980,9435,5639,3796,4420,2634,0,2635,1455,1180,1.233050847,1601,40,9,6,6,0,6,0,0,0,empty,CD-0722-1
"D2,H12",6700,7442,5022,2420,3438,1737,0,1739,1132,607,1.86490939,963,1341,243,95,95,0,32,0,0.115789474,0,empty,CD-0722-1
"D3,A1",934420,1063086,719905,343181,495764,257393,5,257707,211814,45893,4.615387968,145698,90543,11191,3924,3792,132,766,4,0.04193038,0,hg38,CD-0722-1
"D3,A2",12290,13935,9188,4747,6651,3398,0,3401,2150,1251,1.7186251,2009,2403,581,193,193,0,72,0,0.077720207,0,empty,CD-0722-1
"D3,A3",7051,7857,5397,2460,3692,1844,0,1849,1181,668,1.767964072,990,1255,330,103,102,1,38,1,0.205882353,0,empty,CD-0722-1
"D3,A4",12379,13826,9288,4538,6364,3110,0,3116,1978,1138,1.738137083,1697,929,221,96,95,1,31,1,0.168421053,0,empty,CD-0722-1
"D3,A5",10985,11923,8446,3477,5727,2723,0,2726,1754,972,1.804526749,1473,2835,678,212,209,3,69,2,0.086124402,0,empty,CD-0722-1
"D3,A6",9301,10731,6853,3878,5067,2694,0,2707,1759,948,1.855485232,1596,3746,863,288,288,0,83,0,0.128472222,0,empty,CD-0722-1
"D3,A7",852902,1010353,632416,377937,464216,252757,2,253031,207419,45612,4.547465579,151913,4285,1109,339,337,2,167,2,0.071216617,0,hg38,CD-0722-1
"D3,A8",4877,5372,3642,1730,2581,1252,0,1256,836,420,1.99047619,721,2246,510,177,169,8,59,2,0.017751479,0,empty,CD-0722-1
"D3,A9",8852,9984,6663,3321,4652,2372,0,2375,1565,810,1.932098765,1352,2218,490,174,172,2,58,1,0.023255814,0,empty,CD-0722-1
"D3,A10",9696,10692,7606,3086,5054,2424,0,2424,1554,870,1.786206897,1287,396,36,29,29,0,17,0,0.103448276,0,empty,CD-0722-1
"D3,A11",622803,731638,460644,270994,336866,187291,2,187467,159609,27858,5.729377558,110810,198739,28578,9387,9202,185,1542,11,0.045098892,0,hg38,CD-0722-1
"D3,A12",10246,11083,7824,3259,5159,2463,0,2466,1599,867,1.844290657,1346,3374,791,246,240,6,79,2,0.125,0,empty,CD-0722-1
"D3,B1",8642,9360,6480,2880,4424,2219,6,2230,1409,821,1.716199756,1252,1406,374,171,165,6,51,2,0.018181818,0,empty,CD-0722-1
"D3,B2",817261,930670,580367,350303,434229,238088,1,238332,179019,59313,3.018208487,144433,32724,4301,1388,1332,56,304,4,0.03003003,0,hg38,CD-0722-1
"D3,B3",7069,8012,5088,2924,3721,1893,0,1903,1227,676,1.815088757,1121,1652,356,133,133,0,44,0,0.082706767,0,empty,CD-0722-1
"D3,B4",8764,9592,6436,3156,4637,2404,0,2409,1547,862,1.794663573,1374,1768,270,106,104,2,46,1,0.153846154,0,empty,CD-0722-1
"D3,B5",826144,389226,224774,164452,254320,138109,13,139480,106593,32887,3.241189528,93799,62546,8085,2681,2633,48,572,3,0.015951386,0,hg38,CD-0722-1
"D3,B6",9601,10614,7014,3600,5147,2776,0,2782,1783,999,1.784784785,1557,1931,436,139,136,3,42,1,0.014705882,0,empty,CD-0722-1
"D3,B7",8551,9366,6481,2885,4431,2158,2,2163,1419,744,1.907258065,1205,1747,510,137,137,0,40,0,0.03649635,0,empty,CD-0722-1
"D3,B8",6288,6804,4766,2038,3236,1513,0,1513,990,523,1.89292543,840,1874,440,147,145,2,49,2,0.082758621,0,empty,CD-0722-1
"D3,B9",635662,710796,481548,229248,327790,166685,1,166859,124442,42417,2.933776552,95549,25064,4139,1385,1370,15,333,5,0.012408759,0,hg38,CD-0722-1
"D3,B10",6528,6915,4660,2255,3441,1703,0,1712,1131,581,1.946643718,1005,691,96,53,53,0,20,0,0,0,empty,CD-0722-1
"D3,B11",15081,17019,11156,5863,8120,4302,0,4308,2552,1756,1.453302961,2498,310,46,29,29,0,10,0,0.034482759,0,empty,CD-0722-1
"D3,B12",7577,8636,5677,2959,4071,2079,0,2080,1407,673,2.09063893,1190,1929,489,174,173,1,54,1,0.115606936,0,empty,CD-0722-1
"D3,C1",18727,20747,14312,6435,9808,5070,0,5073,3120,1953,1.597542243,2815,1510,415,144,144,0,38,0,0.013888889,0,empty,CD-0722-1
"D3,C2",12410,13569,9311,4258,6262,3132,0,3134,1967,1167,1.685518423,1733,2264,534,171,169,2,50,2,0.100591716,0,empty,CD-0722-1
"D3,C3",12840,14163,9443,4720,6818,3439,0,3445,2255,1190,1.894957983,1961,1410,307,113,111,2,36,2,0.207207207,0,empty,CD-0722-1
"D3,C4",8564,9362,6525,2837,4498,2139,0,2147,1402,745,1.881879195,1204,2418,462,188,184,4,63,2,0.005434783,0,empty,CD-0722-1
"D3,C5",12233,13614,9070,4544,6550,3292,0,3300,2270,1030,2.203883495,1921,2621,490,206,205,1,71,1,0.117073171,0,empty,CD-0722-1
"D3,C6",10977,12087,8098,3989,5756,2903,0,2905,1931,974,1.982546201,1623,2209,604,198,196,2,75,1,0.153061224,0,empty,CD-0722-1
"D3,C7",13798,15972,9766,6206,7489,4222,0,4226,2495,1731,1.441363374,2566,630,119,47,46,1,27,1,0.065217391,0,empty,CD-0722-1
"D3,C8",842089,959971,642455,317516,438208,226823,1,227045,165714,61331,2.701961488,131621,35161,5786,1643,1591,52,511,5,0.077938404,0,hg38,CD-0722-1
"D3,C9",10540,11722,7989,3733,5476,2705,0,2707,1813,894,2.027964206,1518,1840,415,169,169,0,42,0,0.201183432,0,empty,CD-0722-1
"D3,C10",11509,12433,8763,3670,5921,2849,0,2855,1855,1000,1.855,1579,2554,475,175,172,3,70,1,0.046511628,0,empty,CD-0722-1
"D3,C11",1586954,1816953,1178668,638285,825552,453938,5,454432,381418,73014,5.223902265,267966,260147,41559,13484,13224,260,2028,8,0.068360557,0,hg38,CD-0722-1
"D3,C12",1156714,1429575,783207,646368,658561,441960,3,442394,296832,145562,2.039213531,276835,23829,4365,1321,1306,15,307,2,0.08575804,0,hg38,CD-0722-1
"D3,D1",791899,932259,586792,345467,431085,239056,2,239278,180094,59184,3.042950798,144053,48391,4877,1602,1559,43,348,3,0.05837075,0,hg38,CD-0722-1
"D3,D2",567683,620690,448654,172036,292862,133890,4,134064,99257,34807,2.851639038,72380,15683,2499,822,809,13,282,2,0.045735476,0,hg38,CD-0722-1
"D3,D3",9980,11271,7355,3916,5349,2717,0,2723,1825,898,2.032293987,1580,2810,604,191,190,1,52,1,0.1,0,empty,CD-0722-1
"D3,D4",780522,935314,576644,358670,431686,243741,2,243976,189946,54030,3.515565427,148048,141202,24728,7714,7581,133,1300,7,0.062260915,0,hg38,CD-0722-1
"D3,D5",8487,9296,6431,2865,4472,2280,3,2283,1526,757,2.015852048,1267,2184,591,231,227,4,71,2,0.013215859,0,empty,CD-0722-1
"D3,D6",12119,13839,8663,5176,6446,3533,0,3537,2072,1465,1.414334471,2119,1820,334,140,138,2,54,2,0.108695652,0,empty,CD-0722-1
"D3,D7",7032,7828,5284,2544,3708,1831,1,1834,1204,630,1.911111111,1029,2049,390,146,145,1,53,1,0.124137931,0,empty,CD-0722-1
"D3,D8",562622,679144,395360,283784,316353,202041,1,202211,144578,57633,2.508597505,123522,5553,620,256,248,8,85,3,0.137096774,0,hg38,CD-0722-1
"D3,D9",5756,6113,4379,1734,3080,1406,0,1410,936,474,1.974683544,797,2172,388,147,146,1,57,1,0.109589041,0,empty,CD-0722-1
"D3,D10",9688,10649,7233,3416,4971,2475,0,2482,1561,921,1.694896851,1445,1347,342,89,88,1,30,1,0.034090909,0,empty,CD-0722-1
"D3,D11",9696,10579,7343,3236,5084,2449,0,2452,1692,760,2.226315789,1332,3983,1168,353,350,3,117,1,0.042857143,0,empty,CD-0722-1
"D3,D12",11952,13252,9085,4167,6250,3096,0,3102,2029,1073,1.890959925,1757,4122,929,321,316,5,107,1,0.060126582,0,empty,CD-0722-1
"D3,E1",15427,17165,11312,5853,8172,4224,0,4231,2674,1557,1.717405267,2497,3309,784,279,274,5,107,2,0.025547445,0,empty,CD-0722-1
"D3,E2",10974,12344,8011,4333,5665,2894,0,2905,1945,960,2.026041667,1696,2934,775,237,234,3,73,1,0.098290598,0,empty,CD-0722-1
"D3,E3",7354,8113,5586,2527,3768,1864,0,1870,1214,656,1.850609756,1037,2891,788,218,213,5,71,2,0.262910798,0,empty,CD-0722-1
"D3,E4",10177,11256,7601,3655,5439,2609,0,2616,1680,936,1.794871795,1495,3053,718,263,262,1,86,1,0.072519084,0,empty,CD-0722-1
"D3,E5",858204,995096,643157,351939,454370,248358,1,248630,199570,49060,4.06787607,145352,137432,17311,5621,5482,139,1057,5,0.055454214,0,hg38,CD-0722-1
"D3,E6",14693,16420,11000,5420,7708,3897,0,3901,2526,1375,1.837090909,2265,3864,773,234,230,4,97,3,0.039130435,0,empty,CD-0722-1
"D3,E7",14358,15810,10638,5172,7471,3721,0,3737,2468,1269,1.944838455,2137,3159,641,224,223,1,72,1,0.134529148,0,empty,CD-0722-1
"D3,E8",10907,12142,8344,3798,5511,2654,0,2654,1758,896,1.962053571,1429,3334,543,210,206,4,63,2,0.029126214,0,empty,CD-0722-1
"D3,E9",7757,8694,5925,2769,4060,2025,0,2033,1354,679,1.994108984,1141,3214,724,239,236,3,81,2,0.025423729,0,empty,CD-0722-1
"D3,E10",8241,9094,6185,2909,4305,2063,0,2071,1380,691,1.997105644,1183,2815,592,220,219,1,65,1,0.03652968,0,empty,CD-0722-1
"D3,E11",836565,937112,642769,294343,430094,212811,3,213070,163962,49108,3.338804268,120744,212352,23579,8069,7826,243,1313,8,0.071939688,0,hg38,CD-0722-1
"D3,E12",871463,1048306,637521,410785,481080,274976,0,275229,220883,54346,4.064383763,168590,167077,23132,7941,7740,201,1352,8,0.130232558,0,hg38,CD-0722-1
"D3,F1",908128,1034262,689062,345200,468982,239134,3,239397,191817,47580,4.031462799,138141,239700,39109,12893,12652,241,1926,8,0.068684793,0,hg38,CD-0722-1
"D3,F2",10504,11742,7790,3952,5543,2717,0,2721,1748,973,1.796505653,1626,3608,746,312,308,4,114,2,0.100649351,0,empty,CD-0722-1
"D3,F3",10013,10963,7531,3432,5146,2503,0,2504,1680,824,2.038834951,1374,4895,1179,458,456,2,113,1,0.155701754,0,empty,CD-0722-1
"D3,F4",1765829,2000178,1273436,726742,916286,533532,24,534102,469159,64943,7.224165807,314138,35317,12557,3777,3759,18,722,3,0.007714818,0,hg38,CD-0722-1
"D3,F5",11576,12796,8726,4070,5932,2921,1,2932,1935,997,1.940822467,1644,2827,715,237,234,3,76,2,0.025641026,0,empty,CD-0722-1
"D3,F6",12616,14113,9246,4867,6763,3541,0,3547,2279,1268,1.797318612,2079,3235,568,203,196,7,80,2,0.040816327,0,empty,CD-0722-1
"D3,F7",13460,15184,10067,5117,7168,3648,0,3652,2305,1347,1.711210097,2146,1528,421,175,174,1,64,1,0.045977011,0,empty,CD-0722-1
"D3,F8",9074,10038,6892,3146,4784,2405,0,2410,1606,804,1.997512438,1346,274,46,16,16,0,11,0,0,0,empty,CD-0722-1
"D3,F9",10059,10904,7701,3203,5249,2494,0,2494,1652,842,1.961995249,1400,3761,1042,335,333,2,79,1,0.15015015,0,empty,CD-0722-1
"D3,F10",12610,13416,9881,3535,6298,2882,0,2888,1897,991,1.914228052,1472,2236,548,159,158,1,45,1,0.012658228,0,empty,CD-0722-1
"D3,F11",10575,11531,8190,3341,5399,2478,0,2485,1631,854,1.909836066,1349,2135,344,135,128,7,47,2,0.1328125,0,empty,CD-0722-1
"D3,F12",893617,1051219,648437,402782,475845,287108,3,287401,189713,97688,1.942029727,172527,2113,99,46,43,3,21,2,0.255813953,0,empty,CD-0722-1
"D3,G1",12026,13142,9091,4051,6163,2964,0,2965,1940,1025,1.892682927,1681,3921,991,348,347,1,121,1,0.080691643,0,empty,CD-0722-1
"D3,G2",6991,7615,4977,2638,3566,1801,0,1803,1165,638,1.826018809,1066,648,230,93,93,0,25,0,0.225806452,0,empty,CD-0722-1
"D3,G3",12989,14298,9739,4559,6808,3492,0,3498,2189,1309,1.672268908,1913,3221,738,302,301,1,107,1,0.053156146,0,empty,CD-0722-1
"D3,G4",23654,26619,17186,9433,12448,6784,0,6789,4177,2612,1.599157734,3900,273,25,17,17,0,12,0,0.058823529,0,empty,CD-0722-1
"D3,G5",8031,9000,6053,2947,4262,2129,0,2133,1370,763,1.795543906,1172,1830,505,171,169,2,60,2,0.088757396,0,empty,CD-0722-1
"D3,G6",11430,12430,8718,3712,5848,2840,0,2840,1876,964,1.946058091,1575,195,35,18,16,2,12,1,0.0625,0,empty,CD-0722-1
"D3,G7",9774,10671,7255,3416,5112,2455,0,2455,1649,806,2.045905707,1420,3253,737,316,314,2,95,2,0.127388535,0,empty,CD-0722-1
"D3,G8",7193,7815,5374,2441,3765,1795,0,1797,1220,577,2.114384749,1016,2054,542,145,143,2,52,1,0.111888112,0,empty,CD-0722-1
"D3,G9",8368,9711,6142,3569,4395,2156,0,2159,1402,757,1.852047556,1307,3058,894,344,341,3,101,2,0.187683284,0,empty,CD-0722-1
"D3,G10",10843,12385,8118,4267,5854,3047,0,3053,1956,1097,1.783044667,1750,3641,1072,396,390,6,124,2,0.120512821,0,empty,CD-0722-1
"D3,G11",1367434,1578891,1052632,526259,708048,371452,3,371890,297910,73980,4.026899162,213819,106064,16577,5443,5337,106,1033,6,0.046468053,0,hg38,CD-0722-1
"D3,G12",8409,9633,6256,3377,4473,2284,0,2289,1441,848,1.699292453,1341,2278,310,110,103,7,47,2,0.019417476,0,empty,CD-0722-1
"D3,H1",1127809,1223502,873692,349810,557607,263218,6,263481,213601,49880,4.282297514,146792,67895,11861,3639,3557,82,699,6,0.028956986,0,hg38,CD-0722-1
"D3,H2",9417,10516,6961,3555,4850,2416,0,2419,1522,897,1.696767001,1425,3281,928,281,275,6,67,1,0.047272727,0,empty,CD-0722-1
"D3,H3",8344,9380,6257,3123,4369,2160,0,2162,1381,781,1.768245839,1234,1810,557,153,151,2,49,1,0.079470199,0,empty,CD-0722-1
"D3,H4",749994,815697,588223,227474,373302,169774,1,169977,128798,41179,3.127759295,93381,2834,613,189,177,12,48,1,0.129943503,0,hg38,CD-0722-1
"D3,H5",12606,13937,9465,4472,6571,3244,0,3256,2123,1133,1.873786408,1876,2792,756,216,216,0,60,0,0.092592593,0,empty,CD-0722-1
"D3,H6",7616,8380,5661,2719,3929,1981,0,1983,1265,718,1.76183844,1163,2350,533,175,170,5,60,2,0.129411765,0,empty,CD-0722-1
"D3,H7",9417,10480,6927,3553,5030,2454,2,2460,1634,826,1.978208232,1420,2872,804,275,271,4,77,3,0.014760148,0,empty,CD-0722-1
"D3,H8",10103,11291,7472,3819,5361,2723,0,2733,1747,986,1.771805274,1563,2543,574,183,183,0,60,0,0.06557377,0,empty,CD-0722-1
"D3,H9",8543,9546,6419,3127,4356,2132,2,2137,1378,759,1.815546772,1226,1373,423,149,148,1,37,1,0.040540541,0,empty,CD-0722-1
"D3,H10",7348,8063,5602,2461,3663,1770,0,1772,1135,637,1.781789639,958,1661,292,110,101,9,35,2,0.079207921,0,empty,CD-0722-1
"D3,H11",9740,11238,6927,4311,5364,3251,0,3252,1763,1489,1.184016118,1928,95,1,1,1,0,1,0,0,0,empty,CD-0722-1
"D3,H12",8554,9199,6378,2821,4389,2150,0,2155,1426,729,1.956104252,1220,2010,380,159,158,1,50,1,0.025316456,0,empty,CD-0722-1
"D4,A1",8154,8990,5933,3057,4476,2367,0,2376,1564,812,1.926108374,1381,1556,394,123,120,3,33,2,0.016666667,0,empty,CD-0722-1
"D4,A2",13370,14594,9810,4784,7113,3650,3,3656,2300,1356,1.696165192,2120,2306,521,159,156,3,58,2,0.012820513,0,empty,CD-0722-1
"D4,A3",750864,868766,563709,305057,399321,210045,3,210252,159850,50402,3.171501131,124264,109486,13817,4527,4405,122,840,6,0.065153235,0,hg38,CD-0722-1
"D4,A4",1026956,1192812,770360,422452,542562,295350,2,295674,231003,64671,3.571971981,172330,53316,7604,2574,2518,56,597,2,0.02700556,0,hg38,CD-0722-1
"D4,A5",11881,13114,8834,4280,6232,3137,0,3139,2058,1081,1.903792784,1796,3042,605,219,215,4,74,2,0.009302326,0,empty,CD-0722-1
"D4,A6",9843,11535,7321,4214,5591,2976,0,2990,1886,1104,1.708333333,1762,3195,905,316,313,3,84,1,0.156549521,0,empty,CD-0722-1
"D4,A7",8575,9726,6497,3229,4585,2333,0,2335,1448,887,1.632468997,1360,1391,346,113,109,4,43,1,0.073394495,0,empty,CD-0722-1
"D4,A8",5130,5721,3850,1871,2779,1392,0,1392,893,499,1.789579158,797,2013,421,159,158,1,58,1,0.025316456,0,empty,CD-0722-1
"D4,A9",8927,10139,6718,3421,4773,2436,0,2438,1630,808,2.017326733,1356,1989,438,133,129,4,51,2,0.046511628,0,empty,CD-0722-1
"D4,A10",10675,11961,8245,3716,5763,2812,1,2815,1737,1078,1.611317254,1590,425,51,26,26,0,13,0,0.153846154,0,empty,CD-0722-1
"D4,A11",8224,9297,6246,3051,4573,2228,1,2232,1527,705,2.165957447,1300,2246,448,129,127,2,51,1,0.149606299,0,empty,CD-0722-1
"D4,A12",11122,12417,8455,3962,5748,2825,0,2827,1873,954,1.963312369,1605,3492,726,231,229,2,74,1,0.087336245,0,empty,CD-0722-1
"D4,B1",9222,10311,6821,3490,4892,2566,0,2571,1665,906,1.837748344,1508,1314,326,116,116,0,39,0,0.060344828,0,empty,CD-0722-1
"D4,B2",9975,10886,7080,3806,5267,2810,0,2813,1750,1063,1.646284102,1658,638,79,31,31,0,16,0,0.032258065,0,empty,CD-0722-1
"D4,B3",750101,955382,521791,433591,447617,288618,2,288840,221127,67713,3.265650614,184315,23688,10727,3154,3150,4,680,2,0.022857143,0,hg38,CD-0722-1
"D4,B4",902333,1052595,677549,375046,483514,260793,3,261116,207431,53685,3.863853963,153115,30511,3360,1063,1043,20,337,3,0.02780441,0,hg38,CD-0722-1
"D4,B5",8235,4490,2531,1959,2930,1566,0,1581,961,620,1.55,1101,1008,258,66,65,1,25,1,0.046153846,0,empty,CD-0722-1
"D4,B6",10259,11642,7559,4083,5550,2988,0,2996,1899,1097,1.731084777,1710,1762,283,107,105,2,41,1,0.076190476,0,empty,CD-0722-1
"D4,B7",8839,9644,6755,2889,4718,2334,0,2336,1561,775,2.014193548,1305,1431,363,141,137,4,29,3,0.233576642,0,empty,CD-0722-1
"D4,B8",7131,7979,5353,2626,3726,1764,0,1767,1155,612,1.887254902,978,1412,355,136,135,1,53,1,0.162962963,0,empty,CD-0722-1
"D4,B9",12788,14195,9462,4733,6743,3500,0,3509,2266,1243,1.82300885,1977,1069,203,62,61,1,32,1,0.032786885,0,empty,CD-0722-1
"D4,B10",7143,7502,5183,2319,3773,1892,0,1902,1292,610,2.118032787,1079,538,106,31,31,0,11,0,0.032258065,0,empty,CD-0722-1
"D4,B11",14216,16051,10408,5643,7693,4196,0,4199,2376,1823,1.303346133,2468,159,9,5,5,0,5,0,0,0,empty,CD-0722-1
"D4,B12",8534,9633,6330,3303,4526,2235,0,2240,1457,783,1.860791826,1316,2006,658,173,171,2,42,1,0.029239766,0,empty,CD-0722-1
"D4,C1",15678,16927,11955,4972,7842,3706,0,3709,2392,1317,1.816249051,2036,1451,367,128,127,1,35,1,0.007874016,0,empty,CD-0722-1
"D4,C2",12753,14061,9518,4543,6658,3368,0,3370,2186,1184,1.846283784,1951,3160,921,289,284,5,67,2,0.070422535,0,empty,CD-0722-1
"D4,C3",13716,15420,10220,5200,7423,3744,0,3751,2444,1307,1.86993114,2137,1016,222,85,85,0,22,0,0.011764706,0,empty,CD-0722-1
"D4,C4",9440,10470,7210,3260,4956,2302,0,2304,1506,798,1.887218045,1344,2238,487,160,158,2,51,1,0.158227848,0,empty,CD-0722-1
"D4,C5",1054178,1256538,778096,478442,570826,322120,3,322432,258351,64081,4.031631841,194703,209159,28884,9286,9099,187,1549,10,0.050664908,0,hg38,CD-0722-1
"D4,C6",12537,13517,9483,4034,6700,3399,0,3400,2310,1090,2.119266055,1853,2284,644,200,199,1,56,1,0.090452261,0,empty,CD-0722-1
"D4,C7",14593,16765,10531,6234,8030,4482,0,4488,2701,1787,1.51147174,2726,479,112,49,49,0,17,0,0,0,empty,CD-0722-1
"D4,C8",16557,18231,12319,5912,8531,4257,0,4265,2810,1455,1.931271478,2373,3445,845,305,299,6,100,3,0.08361204,0,empty,CD-0722-1
"D4,C9",12672,14413,9495,4918,6605,3250,0,3255,2120,1135,1.86784141,1893,3020,406,159,157,2,52,2,0.063694268,0,empty,CD-0722-1
"D4,C10",11954,13003,9081,3922,6274,3045,0,3051,2002,1049,1.908484271,1682,2381,517,189,189,0,57,0,0.015873016,0,empty,CD-0722-1
"D4,C11",11202,12201,8278,3923,5857,2919,0,2925,1927,998,1.930861723,1687,2333,527,180,180,0,58,0,0.1,0,empty,CD-0722-1
"D4,C12",15891,17626,11939,5687,8425,4088,0,4093,2653,1440,1.842361111,2369,2473,480,168,168,0,47,0,0.017857143,0,empty,CD-0722-1
"D4,D1",834979,946954,632341,314613,433808,220886,3,221179,162585,58594,2.774772161,128646,57276,4222,1465,1418,47,334,3,0.033850494,0,hg38,CD-0722-1
"D4,D2",10840,12193,8357,3836,5789,2736,0,2742,1735,1007,1.722939424,1534,3664,1073,350,347,3,99,1,0.09221902,0,empty,CD-0722-1
"D4,D3",764225,865549,585191,280358,402319,200886,3,201132,149344,51788,2.883756855,116169,67927,8162,2805,2685,120,588,5,0.048789572,0,hg38,CD-0722-1
"D4,D4",961290,1140695,710735,429960,523487,295866,4,296167,242000,54167,4.467664814,177510,122371,16989,5361,5219,142,1085,5,0.058248707,0,hg38,CD-0722-1
"D4,D5",9366,10346,6970,3376,4972,2403,0,2405,1569,836,1.876794258,1373,2140,518,202,202,0,66,0,0.064356436,0,empty,CD-0722-1
"D4,D6",12873,14235,9275,4960,6648,3563,0,3568,2149,1419,1.514446794,2019,2101,448,152,151,1,52,1,0.112582781,0,empty,CD-0722-1
"D4,D7",7459,8206,5682,2524,3858,1842,0,1848,1207,641,1.88299532,1036,1922,462,174,169,5,60,2,0,0,empty,CD-0722-1
"D4,D8",703009,778736,544025,234711,360123,172286,1,172492,130663,41829,3.123741902,97150,39724,6827,2174,2132,42,460,4,0.042682927,0,hg38,CD-0722-1
"D4,D9",5642,6252,4204,2048,2999,1437,0,1438,953,485,1.964948454,823,2678,598,226,225,1,77,1,0.08,0,empty,CD-0722-1
"D4,D10",1027952,1176826,776885,399941,538822,287269,2,287553,247371,40182,6.156263999,164909,5240,692,235,235,0,90,0,0.076595745,0,hg38,CD-0722-1
"D4,D11",10576,11861,8077,3784,5756,2863,0,2863,1876,987,1.90070922,1619,3334,931,286,284,2,87,2,0.007042254,0,empty,CD-0722-1
"D4,D12",12682,13975,9551,4424,6731,3349,0,3358,2133,1225,1.74122449,1943,4484,1404,437,434,3,105,1,0.087557604,0,empty,CD-0722-1
"D4,E1",16684,18387,12374,6013,8663,4339,0,4340,2787,1553,1.794591114,2449,3349,854,269,268,1,79,1,0.201492537,0,empty,CD-0722-1
"D4,E2",640235,704181,495181,209000,328745,156172,1,156363,113885,42478,2.681034889,87587,106184,17099,5556,5453,103,1057,5,0.027141023,0,hg38,CD-0722-1
"D4,E3",7855,8343,6018,2325,4092,1913,0,1915,1259,656,1.919207317,1058,2664,404,148,147,1,57,1,0.142857143,0,empty,CD-0722-1
"D4,E4",11056,12400,8219,4181,5885,2936,0,2942,1921,1021,1.881488737,1690,3054,691,267,264,3,97,2,0.011363636,0,empty,CD-0722-1
"D4,E5",8906,9728,6799,2929,4686,2186,0,2190,1426,764,1.866492147,1219,2058,672,234,233,1,59,1,0.17167382,0,empty,CD-0722-1
"D4,E6",16334,18355,12204,6151,8560,4302,0,4310,2769,1541,1.79688514,2486,4581,1049,379,374,5,74,1,0.13368984,0,empty,CD-0722-1
"D4,E7",15699,17346,11974,5372,8295,3997,0,4001,2600,1401,1.855817273,2287,3342,742,247,242,5,80,2,0.26446281,0,empty,CD-0722-1
"D4,E8",914635,1022642,709223,313419,467789,232588,3,232885,186077,46808,3.975324731,128480,87535,18148,5431,5361,70,962,5,0.033575825,0,hg38,CD-0722-1
"D4,E9",8622,9824,6385,3439,4691,2355,1,2358,1550,808,1.918316832,1411,2845,600,216,214,2,77,1,0.051401869,0,empty,CD-0722-1
"D4,E10",9002,10295,6785,3510,4869,2396,0,2400,1573,827,1.902055623,1401,2146,469,218,216,2,69,1,0.106481481,0,empty,CD-0722-1
"D4,E11",11115,12067,8382,3685,5708,2843,0,2845,1829,1016,1.80019685,1561,2675,454,137,135,2,54,1,0.044444444,0,empty,CD-0722-1
"D4,E12",1327960,1582549,945270,637279,740931,451060,2,451513,324042,127471,2.542084082,276979,68980,11302,3450,3351,99,693,7,0.043569084,0,hg38,CD-0722-1
"D4,F1",14149,15440,10462,4978,7207,3468,0,3471,2169,1302,1.665898618,1974,2378,465,139,138,1,51,1,0.050724638,0,empty,CD-0722-1
"D4,F2",11515,12766,8653,4113,6035,2870,2,2883,1858,1025,1.812682927,1630,3845,960,330,327,3,98,2,0.058103976,0,empty,CD-0722-1
"D4,F3",10861,11900,8249,3651,5590,2660,0,2662,1795,867,2.070357555,1443,3131,677,232,231,1,78,1,0.064935065,0,empty,CD-0722-1
"D4,F4",15476,16514,11469,5045,7730,3713,2,3720,2415,1305,1.850574713,2060,700,123,52,52,0,21,0,0.115384615,0,empty,CD-0722-1
"D4,F5",11736,12754,8830,3924,5963,2767,0,2773,1816,957,1.897596656,1578,2554,498,153,150,3,53,3,0.046666667,0,empty,CD-0722-1
"D4,F6",13373,15435,9821,5614,7310,3870,0,3872,2498,1374,1.818049491,2300,2991,464,197,194,3,71,1,0.020618557,0,empty,CD-0722-1
"D4,F7",14332,15941,10852,5089,7555,3774,0,3782,2499,1283,1.947778644,2150,1358,355,99,98,1,39,1,0.06122449,0,empty,CD-0722-1
"D4,F8",9550,10668,7267,3401,4966,2460,0,2463,1614,849,1.901060071,1380,282,45,26,26,0,11,0,0.115384615,0,empty,CD-0722-1
"D4,F9",10826,11783,8159,3624,5664,2747,0,2747,1888,859,2.19790454,1550,2881,636,220,220,0,70,0,0.136363636,0,empty,CD-0722-1
"D4,F10",12950,14213,9921,4292,6659,3141,0,3147,2056,1091,1.884509624,1766,1850,444,158,155,3,44,2,0.058064516,0,empty,CD-0722-1
"D4,F11",748975,836862,572570,264292,383979,192304,1,192540,141566,50974,2.777219759,109080,65272,10352,3449,3368,81,659,2,0.037410926,0,hg38,CD-0722-1
"D4,F12",11737,12856,8883,3973,5981,2880,0,2886,1894,992,1.909274194,1633,136,28,10,10,0,6,0,0,0,empty,CD-0722-1
"D4,G1",12725,13766,9621,4145,6581,3130,0,3140,2083,1057,1.970671712,1738,3286,653,211,202,9,86,2,0.103960396,0,empty,CD-0722-1
"D4,G2",7335,8083,5241,2842,3775,1878,0,1879,1225,654,1.873088685,1100,728,214,75,75,0,21,0,0.253333333,0,empty,CD-0722-1
"D4,G3",1029318,1232257,760973,471284,558348,312780,1,313109,245812,67297,3.652644249,190007,124080,18849,5908,5799,109,1169,4,0.040696672,0,hg38,CD-0722-1
"D4,G4",24925,28463,18142,10321,13675,7670,0,7682,4733,2949,1.604950831,4480,167,18,15,15,0,13,0,0,0,empty,CD-0722-1
"D4,G5",8527,9593,6302,3291,4469,2259,0,2262,1451,811,1.789149199,1323,2060,381,146,146,0,44,0,0.157534247,0,empty,CD-0722-1
"D4,G6",11902,12934,8995,3939,6136,3009,1,3013,1982,1031,1.922405432,1704,125,22,13,13,0,10,0,0,0,empty,CD-0722-1
"D4,G7",10486,11119,8123,2996,5424,2478,1,2483,1572,911,1.72557629,1321,3601,1071,347,346,1,93,1,0.063583815,0,empty,CD-0722-1
"D4,G8",7704,8562,5531,3031,4061,2049,0,2049,1289,760,1.696052632,1214,1656,350,111,108,3,43,2,0.083333333,0,empty,CD-0722-1
"D4,G9",8751,9993,6507,3486,4735,2302,0,2308,1525,783,1.947637292,1397,2543,514,192,187,5,57,1,0.058823529,0,empty,CD-0722-1
"D4,G10",887631,1032150,668032,364118,473575,255044,2,255347,199720,55627,3.590342819,150050,175072,31316,10311,10161,150,1666,5,0.049699833,0,hg38,CD-0722-1
"D4,G11",10852,12276,8399,3877,5921,2866,1,2878,1864,1014,1.8382643,1632,1809,371,147,146,1,53,1,0.130136986,0,empty,CD-0722-1
"D4,G12",8722,10117,6403,3714,4757,2493,0,2505,1545,960,1.609375,1511,2721,698,187,183,4,68,2,0.071038251,0,empty,CD-0722-1
"D4,H1",9721,10756,7341,3415,5004,2356,0,2361,1510,851,1.774383079,1310,1195,382,96,95,1,37,1,0,0,empty,CD-0722-1
"D4,H2",10527,11520,7794,3726,5378,2707,0,2710,1757,953,1.843651626,1477,2294,608,206,203,3,60,1,0.073891626,0,empty,CD-0722-1
"D4,H3",8905,9952,6543,3409,4720,2377,0,2380,1573,807,1.949194548,1400,1415,184,92,90,2,38,1,0.077777778,0,empty,CD-0722-1
"D4,H4",12878,14110,9635,4475,6610,3200,0,3200,2051,1149,1.785030461,1825,160,18,11,10,1,6,1,0,0,empty,CD-0722-1
"D4,H5",13059,14663,9739,4924,6779,3450,1,3457,2189,1268,1.726340694,1992,1873,379,136,136,0,51,0,0.080882353,0,empty,CD-0722-1
"D4,H6",8502,9684,6248,3436,4545,2365,0,2372,1537,835,1.840718563,1380,1746,506,187,187,0,47,0,0.139037433,0,empty,CD-0722-1
"D4,H7",10553,11318,7831,3487,5406,2536,0,2544,1663,881,1.887627696,1436,1867,426,172,170,2,58,1,0.176470588,0,empty,CD-0722-1
"D4,H8",11389,12539,8368,4171,5957,3082,1,3083,1943,1140,1.704385965,1784,2429,571,192,191,1,63,1,0.015706806,0,empty,CD-0722-1
"D4,H9",8927,9774,6734,3040,4518,2094,0,2096,1414,682,2.073313783,1153,1577,323,95,93,2,28,1,0.032258065,0,empty,CD-0722-1
"D4,H10",8235,9038,6161,2877,4194,2043,0,2047,1344,703,1.911806543,1173,1362,338,116,116,0,37,0,0.086206897,0,empty,CD-0722-1
"D4,H11",10556,12347,7479,4868,5882,3550,1,3553,1898,1655,1.146827795,2155,103,2,2,2,0,2,0,0,0,empty,CD-0722-1
"D4,H12",9280,10649,6740,3909,5052,2682,0,2685,1824,861,2.118466899,1615,1851,433,156,155,1,44,1,0.038709677,0,empty,CD-0722-1
"D5,A1",6413,7205,4725,2480,3439,1796,0,1796,1171,625,1.8736,1023,1200,160,73,71,2,27,2,0,0,empty,CD-0722-1
"D5,A2",9977,10944,7434,3510,5235,2658,0,2661,1659,1002,1.655688623,1523,1618,416,122,121,1,55,1,0.115702479,0,empty,CD-0722-1
"D5,A3",5790,6248,4341,1907,3011,1466,0,1468,974,494,1.971659919,800,924,230,87,87,0,31,0,0.034482759,0,empty,CD-0722-1
"D5,A4",10926,11656,8152,3504,5534,2617,1,2622,1698,924,1.837662338,1417,796,165,70,70,0,37,0,0,0,empty,CD-0722-1
"D5,A5",9227,9842,6938,2904,4698,2237,0,2239,1385,854,1.621779859,1233,2002,362,179,178,1,72,1,0.08988764,0,empty,CD-0722-1
"D5,A6",3664717,4510510,2683771,1826739,2024028,1246117,8,1247246,988456,258790,3.819529348,759369,373442,87254,27613,27299,314,3422,7,0.051174036,0,hg38,CD-0722-1
"D5,A7",6747,7629,5093,2536,3635,1854,0,1857,1161,696,1.668103448,1081,1302,257,128,128,0,56,0,0.0703125,0,empty,CD-0722-1
"D5,A8",382603,454340,283170,171170,214514,118447,0,118565,98414,20151,4.883827105,70915,115999,15045,4812,4693,119,941,5,0.03856808,0,hg38,CD-0722-1
"D5,A9",6974,7802,5275,2527,3715,1844,0,1851,1182,669,1.766816143,1071,1698,442,155,152,3,60,2,0.046052632,0,empty,CD-0722-1
"D5,A10",8128,8497,6214,2283,4138,1953,0,1953,1292,661,1.954614221,1019,550,110,51,51,0,22,0,0.039215686,0,empty,CD-0722-1
"D5,A11",6238,6861,4693,2168,3257,1531,2,1536,984,552,1.782608696,878,1569,167,81,81,0,42,0,0.135802469,0,empty,CD-0722-1
"D5,A12",8392,9066,6477,2589,4280,2030,0,2035,1298,737,1.76119403,1099,2797,625,270,267,3,84,1,0.06741573,0,empty,CD-0722-1
"D5,B1",7442,8325,5523,2802,3911,1988,1,1992,1264,728,1.736263736,1098,1060,276,116,115,1,40,1,0.034782609,0,empty,CD-0722-1
"D5,B2",7563,8154,5266,2888,3936,2092,0,2095,1288,807,1.596034696,1217,328,25,16,16,0,12,0,0.125,0,empty,CD-0722-1
"D5,B3",6137,6872,4464,2408,3284,1683,0,1689,1145,544,2.104779412,970,1178,194,100,99,1,41,1,0.151515152,0,empty,CD-0722-1
"D5,B4",499407,580542,375363,205179,274327,144035,1,144222,110938,33284,3.333072948,86049,60785,6516,2284,2226,58,539,4,0.042677448,0,hg38,CD-0722-1
"D5,B5",9010,6025,3738,2287,3569,1883,0,1899,1309,590,2.218644068,1199,733,190,68,67,1,25,1,0.164179104,0,empty,CD-0722-1
"D5,B6",9557,10779,7064,3715,5018,2639,0,2642,1622,1020,1.590196078,1504,1226,268,119,119,0,39,0,0.058823529,0,empty,CD-0722-1
"D5,B7",7676,8323,6018,2305,3911,1800,0,1800,1176,624,1.884615385,963,1241,336,132,132,0,30,0,0.090909091,0,empty,CD-0722-1
"D5,B8",7005,7634,5237,2397,3757,1868,0,1868,1271,597,2.128978224,1017,1372,323,111,110,1,46,1,0.072727273,0,empty,CD-0722-1
"D5,B9",505601,615837,348480,267357,285553,188620,2,188750,142726,46024,3.101121154,114657,1881,300,128,126,2,62,2,0.063492063,0,hg38,CD-0722-1
"D5,B10",527093,550451,367020,183431,270322,135662,22,136529,99958,36571,2.733258593,80609,26122,3596,1138,1092,46,241,2,0.04029304,0,hg38,CD-0722-1
"D5,B11",11190,12540,8120,4420,5867,3192,0,3194,1824,1370,1.331386861,1903,424,114,37,37,0,13,0,0.459459459,0,empty,CD-0722-1
"D5,B12",6374,7066,4647,2419,3508,1792,0,1795,1147,648,1.770061728,1069,1515,519,208,208,0,56,0,0.129807692,0,empty,CD-0722-1
"D5,C1",12794,13911,9739,4172,6484,3079,0,3083,1951,1132,1.723498233,1684,1147,256,98,96,2,34,1,0.260416667,0,empty,CD-0722-1
"D5,C2",10725,11881,7898,3983,5615,2899,0,2899,1875,1024,1.831054688,1675,1855,535,162,160,2,48,1,0.1125,0,empty,CD-0722-1
"D5,C3",12504,14001,9437,4564,6690,3319,0,3330,2187,1143,1.913385827,1920,727,207,78,78,0,34,0,0.051282051,0,empty,CD-0722-1
"D5,C4",632170,728006,469399,258607,337443,182133,2,182351,147378,34973,4.214050839,106750,118788,25464,8297,8226,71,1428,8,0.056163384,0,hg38,CD-0722-1
"D5,C5",10292,11337,7752,3585,5420,2700,0,2703,1745,958,1.821503132,1526,2138,362,167,165,2,75,2,0.060606061,0,empty,CD-0722-1
"D5,C6",8664,9410,6520,2890,4549,2210,0,2214,1521,693,2.194805195,1245,1773,378,178,175,3,70,3,0.017142857,0,empty,CD-0722-1
"D5,C7",938059,1139271,687149,452122,522584,303491,0,303804,237435,66369,3.577498531,186009,25257,5360,1661,1643,18,359,2,0.077297626,0,hg38,CD-0722-1
"D5,C8",824128,947194,612110,335084,435914,235625,0,235912,189709,46203,4.105988789,137835,142033,25307,8332,8190,142,1432,5,0.05995116,0,hg38,CD-0722-1
"D5,C9",8850,10321,6647,3674,4831,2430,0,2433,1596,837,1.906810036,1427,1955,528,186,180,6,59,2,0.144444444,0,empty,CD-0722-1
"D5,C10",9958,11147,7537,3610,5322,2576,0,2583,1692,891,1.898989899,1468,2134,505,179,173,6,63,2,0.005780347,0,empty,CD-0722-1
"D5,C11",656119,799459,458269,341190,381934,247431,1,247630,174640,72990,2.392656528,153064,4576,835,272,271,1,95,1,0.070110701,0,hg38,CD-0722-1
"D5,C12",12541,13793,9307,4486,6500,3050,0,3055,2003,1052,1.903992395,1717,1420,294,126,124,2,45,1,0.10483871,0,empty,CD-0722-1
"D5,D1",756412,883555,563516,320039,412707,223008,1,223217,172930,50287,3.438860938,132841,33647,4175,1353,1298,55,312,4,0.080123267,0,hg38,CD-0722-1
"D5,D2",707453,781778,550015,231763,361913,172957,9,173189,139780,33409,4.183902541,94763,279738,42836,14054,13765,289,2144,9,0.051071558,0,hg38,CD-0722-1
"D5,D3",8121,8880,5993,2887,4209,2128,0,2128,1386,742,1.867924528,1190,2365,444,162,154,8,61,2,0.084415584,0,empty,CD-0722-1
"D5,D4",6569,7470,4954,2516,3581,1794,0,1803,1148,655,1.752671756,1013,1325,419,128,128,0,38,0,0.0625,0,empty,CD-0722-1
"D5,D5",7225,8053,5436,2617,3746,1891,0,1893,1285,608,2.113486842,1083,1877,497,170,170,0,73,0,0.064705882,0,empty,CD-0722-1
"D5,D6",10709,11748,7914,3834,5593,2954,0,2957,1783,1174,1.518739353,1678,1915,475,178,177,1,52,1,0.09039548,0,empty,CD-0722-1
"D5,D7",5802,6294,4366,1928,3070,1402,0,1408,890,518,1.718146718,807,1802,415,150,149,1,61,1,0.120805369,0,empty,CD-0722-1
"D5,D8",7658,8299,5748,2551,4074,1944,0,1954,1251,703,1.779516358,1092,1767,218,80,78,2,40,2,0.205128205,0,empty,CD-0722-1
"D5,D9",4041,4337,3087,1250,2144,1009,0,1009,647,362,1.787292818,578,1740,319,140,139,1,69,1,0.086330935,0,empty,CD-0722-1
"D5,D10",7274,8080,5301,2779,3783,1905,0,1905,1205,700,1.721428571,1089,745,138,48,46,2,15,2,0.065217391,0,empty,CD-0722-1
"D5,D11",8410,9176,6224,2952,4497,2191,0,2195,1391,804,1.730099502,1259,2836,729,286,281,5,101,1,0.028469751,0,empty,CD-0722-1
"D5,D12",10462,11754,7687,4067,5555,2756,1,2758,1748,1010,1.730693069,1596,3156,619,228,227,1,99,1,0.13215859,0,empty,CD-0722-1
"D5,E1",12983,14268,9572,4696,6768,3481,0,3481,2227,1254,1.775917065,1912,2925,659,238,236,2,85,2,0.029661017,0,empty,CD-0722-1
"D5,E2",635419,731748,477035,254713,342588,179816,0,180033,138569,41464,3.341911055,105733,128512,17630,5747,5619,128,1106,6,0.04911906,0,hg38,CD-0722-1
"D5,E3",6289,6819,4879,1940,3299,1538,0,1541,979,562,1.741992883,834,2306,527,224,219,5,88,2,0.114155251,0,empty,CD-0722-1
"D5,E4",663273,759063,502811,256252,353576,182772,6,182963,135231,47732,2.833130814,106430,90941,12247,4040,3974,66,826,4,0.047559134,0,hg38,CD-0722-1
"D5,E5",7829,8608,6056,2552,4045,1894,0,1900,1246,654,1.905198777,1030,1329,347,135,135,0,52,0,0.022222222,0,empty,CD-0722-1
"D5,E6",12815,14195,9564,4631,6782,3412,0,3417,2132,1285,1.659143969,1931,3693,710,261,258,3,87,1,0.15503876,0,empty,CD-0722-1
"D5,E7",15524,17028,11685,5343,8124,4078,0,4091,2879,1212,2.375412541,2282,2802,760,297,295,2,103,1,0.016949153,0,empty,CD-0722-1
"D5,E8",9878,10603,7695,2908,4975,2234,0,2235,1468,767,1.913950456,1144,2576,524,181,178,3,74,3,0.039325843,0,empty,CD-0722-1
"D5,E9",6225,6960,4525,2435,3307,1652,0,1660,1077,583,1.847341338,998,2088,459,205,203,2,71,2,0.019704433,0,empty,CD-0722-1
"D5,E10",7313,7792,5528,2264,3740,1714,1,1716,1128,588,1.918367347,942,1748,442,180,179,1,69,1,0.078212291,0,empty,CD-0722-1
"D5,E11",8663,9646,6463,3183,4598,2267,0,2269,1442,827,1.743651753,1277,1924,448,168,168,0,67,0,0.053571429,0,empty,CD-0722-1
"D5,E12",9201,10246,6780,3466,4805,2370,0,2370,1534,836,1.83492823,1362,2019,431,162,155,7,57,2,0.025806452,0,empty,CD-0722-1
"D5,F1",11844,13045,8799,4246,6044,2967,1,2972,1830,1142,1.602451839,1716,2125,629,202,197,5,65,2,0.081218274,0,empty,CD-0722-1
"D5,F2",726919,860825,529766,331059,401157,228095,2,228300,180497,47803,3.775850888,137995,100099,19874,6141,6045,96,1186,4,0.061869313,0,hg38,CD-0722-1
"D5,F3",8382,9348,6246,3102,4464,2191,0,2193,1422,771,1.844357977,1275,2844,769,284,284,0,103,0,0.095070423,0,empty,CD-0722-1
"D5,F4",13172,14384,9774,4610,6723,3210,2,3217,2109,1108,1.903429603,1792,696,101,51,51,0,35,0,0.058823529,0,empty,CD-0722-1
"D5,F5",9769,10374,7319,3055,4996,2304,0,2308,1510,798,1.892230576,1300,2037,464,192,190,2,79,1,0.057894737,0,empty,CD-0722-1
"D5,F6",10610,11628,7871,3757,5610,2864,0,2877,1908,969,1.969040248,1600,2989,715,283,282,1,92,1,0.063829787,0,empty,CD-0722-1
"D5,F7",11862,13326,8853,4473,6222,3077,0,3079,2049,1030,1.989320388,1721,1147,241,95,93,2,40,1,0.193548387,0,empty,CD-0722-1
"D5,F8",8224,9296,6168,3128,4380,2245,0,2249,1466,783,1.872286079,1307,258,55,36,35,1,15,1,0.057142857,0,empty,CD-0722-1
"D5,F9",8856,9721,6737,2984,4599,2198,0,2202,1515,687,2.205240175,1218,2814,872,285,283,2,72,1,0.091872792,0,empty,CD-0722-1
"D5,F10",11133,12327,8598,3729,5793,2747,0,2758,1824,934,1.952890792,1524,1640,448,124,123,1,48,1,0.130081301,0,empty,CD-0722-1
"D5,F11",920076,1068873,680741,388132,495256,290430,3,290678,214374,76304,2.809472636,166827,62174,19063,5952,5903,49,1053,4,0.04370659,0,hg38,CD-0722-1
"D5,F12",9389,10205,7035,3170,4846,2356,0,2359,1502,857,1.752625438,1339,158,49,23,23,0,9,0,0.47826087,0,empty,CD-0722-1
"D5,G1",10453,11439,7894,3545,5569,2670,0,2671,1698,973,1.745118191,1530,2736,430,176,173,3,83,2,0.057803468,0,empty,CD-0722-1
"D5,G2",5981,6405,4314,2091,3047,1495,0,1497,926,571,1.621716287,841,478,158,44,43,1,17,1,0,0,empty,CD-0722-1
"D5,G3",804077,946570,598750,347820,437720,237675,2,237889,178612,59277,3.013175431,142614,142491,19042,6150,6012,138,1154,5,0.052062542,0,hg38,CD-0722-1
"D5,G4",20019,22626,14697,7929,10769,5905,0,5914,3546,2368,1.497466216,3454,179,32,22,21,1,15,1,0,0,empty,CD-0722-1
"D5,G5",7536,8262,5566,2696,3905,1908,0,1909,1219,690,1.766666667,1090,1469,280,110,109,1,46,1,0.055045872,0,empty,CD-0722-1
"D5,G6",911121,1039998,696418,343580,477153,244713,2,245002,191323,53679,3.564205742,140600,12045,1768,594,581,13,125,2,0.046471601,0,hg38,CD-0722-1
"D5,G7",8491,9205,6557,2648,4374,1958,0,1963,1313,650,2.02,1053,2975,838,238,233,5,85,2,0.060085837,0,empty,CD-0722-1
"D5,G8",6044,6446,4440,2006,3078,1479,0,1482,964,518,1.861003861,814,1850,334,132,129,3,58,2,0.03875969,0,empty,CD-0722-1
"D5,G9",7253,8053,5414,2639,3771,1851,0,1856,1202,654,1.837920489,1040,2325,558,234,233,1,81,1,0.012875536,0,empty,CD-0722-1
"D5,G10",9042,9909,6708,3201,4754,2397,1,2398,1523,875,1.740571429,1359,2848,557,227,227,0,102,0,0.022026432,0,empty,CD-0722-1
"D5,G11",9051,9959,6924,3035,4650,2233,0,2236,1429,807,1.770755886,1253,1487,359,129,128,1,53,1,0,0,empty,CD-0722-1
"D5,G12",7290,8228,5223,3005,3912,2044,0,2046,1304,742,1.757412399,1186,2150,553,173,171,2,74,2,0.035087719,0,empty,CD-0722-1
"D5,H1",8160,8911,5963,2948,4363,2091,0,2092,1379,713,1.934081346,1218,1120,192,75,74,1,42,1,0.121621622,0,empty,CD-0722-1
"D5,H2",893964,1064731,661244,403487,492750,273557,2,273826,215279,58547,3.677028712,166438,111309,15518,4844,4694,150,928,7,0.056028973,0,hg38,CD-0722-1
"D5,H3",1676835,1995194,1234001,761193,909288,516186,7,516687,404052,112635,3.587268611,313379,209803,33381,10947,10741,206,1745,7,0.08220836,0,hg38,CD-0722-1
"D5,H4",11047,12241,8189,4052,5747,2915,0,2916,1909,1007,1.895729891,1694,256,31,19,19,0,13,0,0,0,empty,CD-0722-1
"D5,H5",11436,13038,8420,4618,5994,3028,0,3032,1987,1045,1.901435407,1820,1969,478,178,177,1,53,1,0.062146893,0,empty,CD-0722-1
"D5,H6",6970,7860,5110,2750,3638,1908,0,1916,1280,636,2.012578616,1108,2043,407,150,150,0,66,0,0.02,0,empty,CD-0722-1
"D5,H7",1236780,1383810,940631,443179,642151,328622,9,329067,267318,61749,4.329106544,188189,107912,15141,4759,4644,115,953,5,0.03079242,0,hg38,CD-0722-1
"D5,H8",8773,9747,6470,3277,4638,2407,0,2416,1562,854,1.829039813,1407,1910,414,160,160,0,55,0,0.14375,0,empty,CD-0722-1
"D5,H9",7660,8483,5809,2674,3979,1870,0,1871,1278,593,2.155143339,1051,1035,188,79,76,3,35,2,0.092105263,0,empty,CD-0722-1
"D5,H10",6165,6576,4734,1842,3181,1495,0,1501,994,507,1.960552268,836,1080,245,91,89,2,28,2,0.325842697,0,empty,CD-0722-1
"D5,H11",8073,9016,5553,3463,4370,2630,0,2631,1498,1133,1.322153575,1548,100,27,9,9,0,6,0,0,0,empty,CD-0722-1
"D5,H12",6692,7571,4927,2644,3540,1841,1,1846,1202,644,1.866459627,1066,1425,166,92,89,3,45,2,0,0,empty,CD-0722-1
"D6,A1",5056,5286,3782,1504,2565,1261,0,1261,777,484,1.605371901,676,1017,244,78,78,0,31,0,0.025641026,0,empty,CD-0722-1
"D6,A2",448104,511662,335114,176548,234908,124030,3,124192,96400,27792,3.468624064,71673,115624,14622,5202,5096,106,933,4,0.065934066,0,hg38,CD-0722-1
"D6,A3",582129,744925,382364,362561,351063,250240,1,250412,167034,83378,2.003334213,158759,1887,553,135,135,0,62,0,0.192592593,0,hg38,CD-0722-1
"D6,A4",9418,10519,6871,3648,5079,2654,0,2657,1732,925,1.872432432,1569,834,213,93,91,2,45,1,0.021978022,0,empty,CD-0722-1
"D6,A5",484038,533910,369878,164032,250815,127895,0,128030,96020,32010,2.999687598,71453,23133,5735,1751,1734,17,402,2,0.022491349,0,hg38,CD-0722-1
"D6,A6",289206,339213,218597,120616,159783,87343,1,87431,67746,19685,3.441503683,51461,78751,12039,4010,3921,89,769,4,0.030604438,0,hg38,CD-0722-1
"D6,A7",5003,5588,3739,1849,2737,1390,0,1393,895,498,1.797188755,817,1142,215,94,93,1,40,1,0.021505376,0,empty,CD-0722-1
"D6,A8",2982,3308,2174,1134,1590,810,0,814,540,274,1.97080292,481,1449,275,110,110,0,51,0,0.045454545,0,empty,CD-0722-1
"D6,A9",5193,5994,3977,2017,2901,1474,0,1477,940,537,1.750465549,850,1355,238,97,96,1,46,1,0.104166667,0,empty,CD-0722-1
"D6,A10",6021,6524,4643,1881,3116,1494,0,1502,967,535,1.807476636,835,357,90,24,23,1,9,1,0,0,empty,CD-0722-1
"D6,A11",5194,5892,3891,2001,2848,1421,0,1421,1005,416,2.415865385,802,1597,391,123,122,1,48,1,0.024590164,0,empty,CD-0722-1
"D6,A12",6408,6773,4824,1949,3214,1482,0,1483,1004,479,2.096033403,820,3007,728,223,221,2,69,1,0.045248869,0,empty,CD-0722-1
"D6,B1",5491,6111,4149,1962,2898,1394,0,1395,873,522,1.672413793,776,944,259,102,102,0,40,0,0.088235294,0,empty,CD-0722-1
"D6,B2",6132,6680,4185,2495,3327,1821,0,1822,1156,666,1.735735736,1088,457,99,37,36,1,19,1,0,0,empty,CD-0722-1
"D6,B3",5581,6241,4193,2048,3049,1503,0,1504,1038,466,2.227467811,865,1086,203,77,76,1,34,1,0.171052632,0,empty,CD-0722-1
"D6,B4",5285,5939,3879,2060,2877,1549,1,1554,1019,535,1.904672897,907,1641,395,154,153,1,59,1,0.032679739,0,empty,CD-0722-1
"D6,B5",7050,5031,2986,2045,2958,1663,0,1674,1194,480,2.4875,1054,679,129,45,45,0,24,0,0.022222222,0,empty,CD-0722-1
"D6,B6",5820,6585,4302,2283,3154,1653,0,1654,1005,649,1.54853621,962,1197,247,93,93,0,32,0,0.010752688,0,empty,CD-0722-1
"D6,B7",5307,5799,4043,1756,2922,1410,0,1412,910,502,1.812749004,777,1140,215,88,84,4,28,1,0.035714286,0,empty,CD-0722-1
"D6,B8",392626,431207,307870,123337,201396,94109,2,94230,73678,20552,3.584955236,51378,58348,8559,2850,2789,61,559,4,0.043384726,0,hg38,CD-0722-1
"D6,B9",7704,8630,5674,2956,4032,2100,0,2100,1336,764,1.748691099,1192,1051,220,77,73,4,35,2,0,0,empty,CD-0722-1
"D6,B10",676666,732583,462219,270364,355279,198018,31,199180,159718,39462,4.04738736,117949,92904,15341,5236,5158,78,903,3,0.063978286,0,hg38,CD-0722-1
"D6,B11",8359,9675,6078,3597,4569,2493,2,2498,1451,1047,1.385864374,1520,169,50,26,26,0,9,0,0.038461538,0,empty,CD-0722-1
"D6,B12",5053,5319,3643,1676,2650,1348,3,1353,850,503,1.689860835,787,1184,208,91,87,4,29,1,0.103448276,0,empty,CD-0722-1
"D6,C1",9536,10353,7316,3037,4890,2305,1,2309,1524,785,1.941401274,1255,1028,220,95,93,2,35,1,0.150537634,0,empty,CD-0722-1
"D6,C2",7680,8428,5652,2776,3927,1988,0,1993,1323,670,1.974626866,1107,1164,357,148,142,6,39,1,0.316901408,0,empty,CD-0722-1
"D6,C3",1467786,1771049,1073295,697754,798656,463536,7,464068,391672,72396,5.410133157,281997,120674,15883,5288,5200,88,979,4,0.078461538,0,hg38,CD-0722-1
"D6,C4",5355,5906,4119,1787,2851,1319,0,1321,859,462,1.859307359,749,1680,311,120,117,3,42,2,0.256410256,0,empty,CD-0722-1
"D6,C5",634594,755721,466420,289301,349221,198079,0,198262,157317,40945,3.842154109,119367,62162,10360,3524,3458,66,702,4,0.054077501,0,hg38,CD-0722-1
"D6,C6",6199,6818,4490,2328,3453,1765,0,1765,1166,599,1.946577629,1008,1478,366,129,128,1,56,1,0.046875,0,empty,CD-0722-1
"D6,C7",8914,10327,6477,3850,4888,2728,6,2735,1669,1066,1.565666041,1660,611,100,35,35,0,18,0,0.114285714,0,empty,CD-0722-1
"D6,C8",499707,560168,384358,175810,260125,129997,1,130177,98480,31697,3.106918636,73771,106441,12446,3943,3821,122,869,6,0.042920701,0,hg38,CD-0722-1
"D6,C9",6610,7360,4957,2403,3500,1751,0,1753,1122,631,1.778129952,1002,1479,327,127,127,0,47,0,0.204724409,0,empty,CD-0722-1
"D6,C10",7279,7752,5424,2328,3764,1830,0,1832,1164,668,1.74251497,1021,1577,232,85,83,2,40,1,0,0,empty,CD-0722-1
"D6,C11",556240,645397,414103,231294,297996,162164,2,162340,134666,27674,4.866155959,96213,89788,9668,3301,3190,111,685,5,0.080250784,0,hg38,CD-0722-1
"D6,C12",9502,10406,7105,3301,4800,2358,0,2363,1607,756,2.125661376,1271,1604,396,155,154,1,47,1,0.019480519,0,empty,CD-0722-1
"D6,D1",8391,9441,6054,3387,4499,2394,1,2402,1430,972,1.471193416,1427,565,104,52,50,2,21,2,0.06,0,empty,CD-0722-1
"D6,D2",6669,7211,5055,2156,3450,1606,0,1612,1029,583,1.765008576,873,2275,640,210,208,2,77,2,0.043269231,0,empty,CD-0722-1
"D6,D3",6278,6772,4660,2112,3214,1598,0,1600,1048,552,1.898550725,852,1397,232,85,84,1,43,1,0.178571429,0,empty,CD-0722-1
"D6,D4",5160,5759,3811,1948,2793,1406,0,1407,967,440,2.197727273,846,1254,449,124,124,0,41,0,0.032258065,0,empty,CD-0722-1
"D6,D5",5722,6281,4219,2062,2980,1479,0,1482,1018,464,2.193965517,830,1438,151,88,84,4,40,2,0.011904762,0,empty,CD-0722-1
"D6,D6",8324,9190,5978,3212,4355,2370,0,2373,1469,904,1.625,1369,1232,294,104,103,1,33,1,0.019417476,0,empty,CD-0722-1
"D6,D7",4394,4648,3294,1354,2257,1052,0,1054,707,347,2.037463977,584,1587,377,137,135,2,47,1,0.103703704,0,empty,CD-0722-1
"D6,D8",5525,6345,4187,2158,2993,1457,0,1457,881,576,1.529513889,816,1146,264,115,112,3,47,2,0.017857143,0,empty,CD-0722-1
"D6,D9",3310,3515,2504,1011,1753,868,0,868,567,301,1.88372093,457,1182,263,72,72,0,37,0,0.138888889,0,empty,CD-0722-1
"D6,D10",5096,5471,3762,1709,2590,1277,0,1283,817,466,1.753218884,719,627,131,55,55,0,20,0,0,0,empty,CD-0722-1
"D6,D11",6244,7113,4633,2480,3341,1663,0,1665,1107,558,1.983870968,950,2801,947,311,309,2,92,2,0.055016181,0,empty,CD-0722-1
"D6,D12",527452,592425,407557,184868,274028,134210,1,134367,102940,31427,3.275527413,75894,186561,26311,8635,8440,195,1394,6,0.052843602,0,hg38,CD-0722-1
"D6,E1",9711,10694,7240,3454,5076,2540,0,2546,1647,899,1.832035595,1463,2221,469,161,160,1,70,1,0.025,0,empty,CD-0722-1
"D6,E2",504763,612316,366742,245574,285408,165453,1,165610,134740,30870,4.364755426,101725,50943,9157,3042,2989,53,631,4,0.057544329,0,hg38,CD-0722-1
"D6,E3",4596,5155,3460,1695,2599,1298,0,1300,848,452,1.876106195,752,1760,384,154,151,3,65,2,0.092715232,0,empty,CD-0722-1
"D6,E4",1866958,1816369,1528564,287805,865134,375681,5,376162,261911,114251,2.292417572,136689,4391,1213,378,372,6,135,2,0.099462366,0,hg38,CD-0722-1
"D6,E5",5504,6139,4159,1980,2974,1433,0,1434,956,478,2,816,1396,306,107,101,6,45,1,0.158415842,0,empty,CD-0722-1
"D6,E6",600337,686004,452358,233646,312499,165881,1,166053,128394,37659,3.409384211,96047,55247,5560,1771,1688,83,448,4,0.028436019,0,hg38,CD-0722-1
"D6,E7",9767,10664,7402,3262,5161,2510,0,2510,1656,854,1.93911007,1392,2251,521,236,233,3,70,2,0.137339056,0,empty,CD-0722-1
"D6,E8",7401,8056,5682,2374,3761,1719,0,1721,1112,609,1.825944171,913,2280,625,230,227,3,61,2,0.022026432,0,empty,CD-0722-1
"D6,E9",4900,5584,3661,1923,2635,1372,0,1374,882,492,1.792682927,795,1958,445,178,175,3,64,2,0.085714286,0,empty,CD-0722-1
"D6,E10",5356,5873,4061,1812,2769,1286,0,1288,844,444,1.900900901,742,1473,372,147,145,2,50,2,0.089655172,0,empty,CD-0722-1
"D6,E11",6547,7360,4903,2457,3486,1770,0,1772,1085,687,1.579330422,995,1683,350,133,133,0,44,0,0.082706767,0,empty,CD-0722-1
"D6,E12",7150,7841,5259,2582,3719,1866,0,1870,1235,635,1.94488189,1070,1299,249,106,105,1,46,1,0.00952381,0,empty,CD-0722-1
"D6,F1",8197,9076,6054,3022,4328,2104,1,2107,1312,795,1.650314465,1195,1953,431,151,150,1,56,1,0.053333333,0,empty,CD-0722-1
"D6,F2",7708,8727,5712,3015,4208,2144,0,2144,1483,661,2.243570348,1266,2185,513,208,207,1,80,1,0.004830918,0,empty,CD-0722-1
"D6,F3",949277,1069839,738473,331366,491007,245397,4,245668,197659,48009,4.117123873,137615,73092,11779,3729,3672,57,837,3,0.022058824,0,hg38,CD-0722-1
"D6,F4",9767,10515,7356,3159,4983,2376,0,2380,1581,799,1.978723404,1297,680,252,68,67,1,34,1,0.149253731,0,empty,CD-0722-1
"D6,F5",7266,7773,5449,2324,3715,1749,0,1754,1119,635,1.762204724,986,1537,390,145,136,9,48,2,0.139705882,0,empty,CD-0722-1
"D6,F6",7602,8515,5666,2849,4158,2207,3,2221,1509,712,2.119382022,1307,2245,443,189,189,0,76,0,0.031746032,0,empty,CD-0722-1
"D6,F7",9264,10224,6912,3312,4924,2484,0,2484,1577,907,1.738699008,1435,907,201,77,77,0,38,0,0.168831169,0,empty,CD-0722-1
"D6,F8",6408,6913,4815,2098,3238,1563,0,1565,1031,534,1.93071161,853,229,13,9,9,0,8,0,0.111111111,0,empty,CD-0722-1
"D6,F9",6366,7023,4835,2188,3382,1610,0,1616,1021,595,1.715966387,901,2257,576,191,191,0,59,0,0.083769634,0,empty,CD-0722-1
"D6,F10",1413156,1636259,1063324,572935,744073,409134,3,409514,322424,87090,3.702193134,237847,94015,16989,5419,5353,66,1090,3,0.041658883,0,hg38,CD-0722-1
"D6,F11",6483,6914,4841,2073,3316,1543,2,1545,1019,526,1.937262357,859,1181,203,64,64,0,29,0,0,0,empty,CD-0722-1
"D6,F12",1950646,2318486,1431478,887008,1031050,597871,5,598517,486088,112429,4.323510838,360057,10945,1638,547,542,5,148,3,0.046125461,0,hg38,CD-0722-1
"D6,G1",626190,752737,443051,309686,347515,221953,3,222182,153677,68505,2.24329611,133398,7874,860,311,296,15,130,2,0.192567568,0,hg38,CD-0722-1
"D6,G2",4504,4759,3220,1539,2334,1194,0,1195,752,443,1.69751693,684,315,78,19,19,0,11,0,0.263157895,0,empty,CD-0722-1
"D6,G3",633486,768075,461367,306708,353258,208387,1,208574,166464,42110,3.953075279,127621,122647,21046,7126,7007,119,1291,4,0.043385186,0,hg38,CD-0722-1
"D6,G4",14964,16997,10790,6207,8311,4731,0,4735,2860,1875,1.525333333,2828,151,26,15,14,1,10,1,0,0,empty,CD-0722-1
"D6,G5",5251,5753,3951,1802,2777,1360,0,1363,917,446,2.056053812,746,1725,319,123,121,2,46,2,0.099173554,0,empty,CD-0722-1
"D6,G6",7474,8066,5615,2451,3781,1836,2,1838,1238,600,2.063333333,1022,152,44,16,16,0,10,0,0,0,empty,CD-0722-1
"D6,G7",6569,7103,5134,1969,3433,1558,0,1560,1024,536,1.910447761,837,3476,1012,331,330,1,90,1,0.054545455,0,empty,CD-0722-1
"D6,G8",4533,5100,3268,1832,2485,1245,0,1247,812,435,1.866666667,714,1632,335,121,121,0,41,0,0.024793388,0,empty,CD-0722-1
"D6,G9",358679,404012,273249,130763,189522,95740,0,95818,72496,23322,3.108481262,54859,71236,14975,4908,4850,58,865,5,0.022680412,0,hg38,CD-0722-1
"D6,G10",6518,7597,4809,2788,3594,1897,0,1902,1193,709,1.682651622,1114,2029,370,141,140,1,67,1,0.092857143,0,empty,CD-0722-1
"D6,G11",6923,7636,5231,2405,3611,1674,0,1674,1098,576,1.90625,941,1458,231,95,94,1,39,1,0.010638298,0,empty,CD-0722-1
"D6,G12",5395,6212,3955,2257,2904,1494,0,1497,934,563,1.658969805,871,1720,440,137,137,0,46,0,0,0,empty,CD-0722-1
"D6,H1",5718,6318,4159,2159,3109,1541,1,1544,965,579,1.666666667,885,770,188,96,95,1,33,1,0.136842105,0,empty,CD-0722-1
"D6,H2",6356,7215,4534,2681,3377,1773,0,1775,1123,652,1.722392638,1056,1983,454,155,150,5,62,2,0.02,0,empty,CD-0722-1
"D6,H3",5263,5788,3888,1900,2670,1315,0,1319,846,473,1.78858351,721,1430,369,168,166,2,52,1,0.006024096,0,empty,CD-0722-1
"D6,H4",7508,8086,5587,2499,3844,1860,0,1862,1261,601,2.098169717,991,125,44,17,17,0,10,0,0.058823529,0,empty,CD-0722-1
"D6,H5",815285,952475,611960,340515,428639,229836,5,230129,178063,52066,3.419947759,136269,85424,10698,3585,3465,120,744,5,0.071861472,0,hg38,CD-0722-1
"D6,H6",5396,6246,4041,2205,2869,1522,0,1522,954,568,1.679577465,900,1540,367,133,133,0,46,0,0.045112782,0,empty,CD-0722-1
"D6,H7",6326,6919,4656,2263,3284,1601,0,1603,1004,599,1.676126878,928,1656,353,152,151,1,50,1,0.119205298,0,empty,CD-0722-1
"D6,H8",6448,7443,4724,2719,3546,1826,0,1826,1171,655,1.78778626,1091,1784,404,143,142,1,44,1,0.105633803,0,empty,CD-0722-1
"D6,H9",4978,5235,3804,1431,2529,1147,3,1155,752,403,1.866004963,617,941,284,96,95,1,29,1,0.105263158,0,empty,CD-0722-1
"D6,H10",4395,4785,3244,1541,2273,1130,1,1133,742,391,1.89769821,630,988,180,75,75,0,26,0,0.04,0,empty,CD-0722-1
"D6,H11",6253,7109,4223,2886,3414,2065,0,2069,1140,929,1.227125942,1247,95,15,9,9,0,6,0,0,0,empty,CD-0722-1
"D6,H12",5183,5564,3842,1722,2723,1373,0,1373,901,472,1.908898305,721,1599,430,158,157,1,56,1,0.076433121,0,empty,CD-0722-1
"D7,A1",9103,10273,6670,3603,4865,2482,0,2484,1608,876,1.835616438,1462,1310,253,78,78,0,28,0,0,0,empty,CD-0722-1
"D7,A2",1631794,1886814,1227146,659668,845630,461821,3,462315,362163,100152,3.616133477,268970,104134,17946,6084,5993,91,1176,6,0.02870015,0,hg38,CD-0722-1
"D7,A3",8307,9263,6166,3097,4334,2151,0,2153,1399,754,1.855437666,1250,969,251,88,88,0,31,0,0,0,empty,CD-0722-1
"D7,A4",13467,14586,10135,4451,6915,3297,0,3302,2093,1209,1.731182796,1827,978,297,80,75,5,31,2,0,0,empty,CD-0722-1
"D7,A5",13219,14760,9936,4824,6984,3457,0,3459,2225,1234,1.803079417,2016,1951,384,128,125,3,41,2,0.2,0,empty,CD-0722-1
"D7,A6",10847,12307,8145,4162,5893,3093,0,3096,2071,1025,2.020487805,1733,2505,650,243,242,1,79,1,0.128099174,0,empty,CD-0722-1
"D7,A7",9562,10769,7084,3685,5052,2567,0,2575,1647,928,1.774784483,1509,1239,178,70,67,3,35,1,0.164179104,0,empty,CD-0722-1
"D7,A8",5666,6346,4262,2084,2994,1495,0,1497,1008,489,2.061349693,821,1762,366,135,132,3,49,1,0.28030303,0,empty,CD-0722-1
"D7,A9",10311,11618,7704,3914,5374,2644,0,2650,1716,934,1.837259101,1529,1575,289,136,136,0,49,0,0.110294118,0,empty,CD-0722-1
"D7,A10",12382,13638,9663,3975,6362,3052,0,3058,1975,1083,1.823638042,1657,357,40,21,21,0,10,0,0,0,empty,CD-0722-1
"D7,A11",9456,10357,7218,3139,4981,2351,0,2358,1556,802,1.940149626,1306,1248,288,118,118,0,49,0,0.016949153,0,empty,CD-0722-1
"D7,A12",12533,13730,9496,4234,6361,2985,0,2987,1982,1005,1.972139303,1682,3044,645,211,203,8,60,5,0.044334975,0,empty,CD-0722-1
"D7,B1",9878,11313,7266,4047,5279,2733,0,2736,1702,1034,1.646034816,1645,1152,206,81,79,2,31,2,0.063291139,0,empty,CD-0722-1
"D7,B2",9911,10620,6837,3783,5086,2727,0,2729,1713,1016,1.686023622,1604,517,121,39,39,0,15,0,0.076923077,0,empty,CD-0722-1
"D7,B3",8538,9432,6362,3070,4549,2293,0,2296,1457,839,1.73659118,1303,1260,319,91,84,7,31,2,0.226190476,0,empty,CD-0722-1
"D7,B4",11475,13008,8393,4615,6105,3338,0,3339,2132,1207,1.766362883,1918,1115,156,66,65,1,33,1,0.076923077,0,empty,CD-0722-1
"D7,B5",9445,5048,3073,1975,3269,1739,0,1753,1164,589,1.9762309,1121,838,124,65,64,1,27,1,0.15625,0,empty,CD-0722-1
"D7,B6",11548,12913,8275,4638,6074,3253,0,3256,2002,1254,1.596491228,1933,1542,378,114,113,1,39,1,0.159292035,0,empty,CD-0722-1
"D7,B7",9814,10735,7626,3109,5163,2468,0,2471,1631,840,1.941666667,1355,1114,267,111,110,1,22,1,0.118181818,0,empty,CD-0722-1
"D7,B8",7984,8795,6079,2716,4136,1971,0,1971,1305,666,1.959459459,1098,1291,231,92,91,1,38,1,0.175824176,0,empty,CD-0722-1
"D7,B9",14003,16051,10483,5568,7610,3995,0,3997,2523,1474,1.711668928,2356,959,361,106,106,0,33,0,0.047169811,0,empty,CD-0722-1
"D7,B10",7370,7968,5338,2630,3976,1974,0,1979,1265,714,1.771708683,1166,432,137,27,27,0,12,0,0.037037037,0,empty,CD-0722-1
"D7,B11",19736,22486,14362,8124,10415,5607,1,5612,3410,2202,1.548592189,3335,111,15,7,7,0,6,0,0.285714286,0,empty,CD-0722-1
"D7,B12",9575,10747,7152,3595,4997,2498,0,2500,1673,827,2.022974607,1426,1695,397,134,134,0,45,0,0.074626866,0,empty,CD-0722-1
"D7,C1",1046244,1210772,783219,427553,542131,296048,3,296364,238381,57983,4.111222255,172840,26062,5590,1771,1761,10,424,4,0.02725724,0,hg38,CD-0722-1
"D7,C2",14205,15858,10511,5347,7245,3633,0,3641,2337,1304,1.792177914,2090,2240,608,188,186,2,56,1,0.123655914,0,empty,CD-0722-1
"D7,C3",14549,16479,10791,5688,7884,4037,0,4042,2602,1440,1.806944444,2430,1027,200,85,84,1,29,1,0.035714286,0,empty,CD-0722-1
"D7,C4",1005870,1155491,757856,397635,524091,277635,8,277937,223862,54075,4.139842811,162012,222810,30730,10445,10202,243,1612,7,0.068025877,0,hg38,CD-0722-1
"D7,C5",14725,16617,10933,5684,7702,3877,0,3886,2627,1259,2.086576648,2222,1762,328,138,138,0,47,0,0.036231884,0,empty,CD-0722-1
"D7,C6",12054,13506,8884,4622,6489,3290,0,3290,2121,1169,1.814371257,1900,1775,464,152,150,2,60,1,0.08,0,empty,CD-0722-1
"D7,C7",15963,18431,11581,6850,8647,4844,0,4844,2929,1915,1.529503916,2894,419,54,21,21,0,13,0,0.047619048,0,empty,CD-0722-1
"D7,C8",17874,20170,13285,6885,9410,4671,0,4676,3008,1668,1.803357314,2729,3712,682,275,274,1,75,1,0.156934307,0,empty,CD-0722-1
"D7,C9",12350,13702,9317,4385,6410,3152,1,3157,2008,1149,1.747606614,1757,1480,361,139,136,3,39,2,0.080882353,0,empty,CD-0722-1
"D7,C10",13610,14627,10392,4235,6788,3177,1,3181,2065,1116,1.850358423,1688,2240,488,162,157,5,51,2,0.01910828,0,empty,CD-0722-1
"D7,C11",12210,13515,8972,4543,6281,3088,0,3090,2008,1082,1.855822551,1846,1975,549,193,192,1,64,1,0.072916667,0,empty,CD-0722-1
"D7,C12",16192,17609,11976,5633,8501,4141,1,4147,2742,1405,1.951601423,2364,1815,411,143,137,6,44,3,0.124087591,0,empty,CD-0722-1
"D7,D1",1014085,1253487,727722,525765,571259,341941,2,342253,262694,79559,3.301876595,214740,12699,2906,957,953,4,218,2,0.028331584,0,hg38,CD-0722-1
"D7,D2",11788,12767,9080,3687,6002,2855,0,2857,1864,993,1.87713998,1540,2656,683,239,239,0,86,0,0.025104603,0,empty,CD-0722-1
"D7,D3",12339,14075,9095,4980,6668,3501,0,3503,2355,1148,2.051393728,2030,1740,432,149,149,0,57,0,0.006711409,0,empty,CD-0722-1
"D7,D4",8963,10046,6836,3210,4765,2351,0,2356,1512,844,1.791469194,1340,1405,448,136,136,0,42,0,0.102941176,0,empty,CD-0722-1
"D7,D5",10430,11641,8000,3641,5510,2701,0,2703,1872,831,2.252707581,1510,2013,441,192,185,7,56,2,0.07027027,0,empty,CD-0722-1
"D7,D6",14686,16477,10598,5879,7739,4210,0,4214,2624,1590,1.650314465,2475,2114,499,163,162,1,52,1,0.061728395,0,empty,CD-0722-1
"D7,D7",8624,9473,6559,2914,4444,2086,0,2086,1359,727,1.869325997,1181,2063,455,140,138,2,46,2,0.108695652,0,empty,CD-0722-1
"D7,D8",10105,11314,7397,3917,5362,2745,0,2747,1755,992,1.769153226,1598,1149,194,97,89,8,40,1,0.101123596,0,empty,CD-0722-1
"D7,D9",7212,8093,5433,2660,3911,1920,0,1925,1310,615,2.130081301,1122,2116,540,181,179,2,58,2,0.067039106,0,empty,CD-0722-1
"D7,D10",9186,10217,6823,3394,4583,2241,0,2248,1363,885,1.540112994,1272,583,87,40,40,0,12,0,0.025,0,empty,CD-0722-1
"D7,D11",12122,13448,9250,4198,6387,3078,1,3084,2147,937,2.29135539,1731,3011,869,276,271,5,78,2,0.199261993,0,empty,CD-0722-1
"D7,D12",13880,15225,10531,4694,7217,3521,1,3524,2306,1218,1.893267652,2007,3552,909,299,297,2,89,2,0.050505051,0,empty,CD-0722-1
"D7,E1",18292,20506,13636,6870,9583,4912,1,4927,3154,1773,1.778905809,2807,2364,521,174,173,1,71,1,0.034682081,0,empty,CD-0722-1
"D7,E2",12969,14166,9466,4700,6644,3364,0,3365,2126,1239,1.715899919,1920,2135,336,135,135,0,53,0,0.22962963,0,empty,CD-0722-1
"D7,E3",8694,9709,6551,3158,4638,2272,0,2276,1458,818,1.782396088,1290,2568,604,208,208,0,65,0,0.0625,0,empty,CD-0722-1
"D7,E4",12055,13206,9012,4194,6448,3138,0,3140,2032,1108,1.833935018,1825,2471,631,246,243,3,75,2,0.152263374,0,empty,CD-0722-1
"D7,E5",835093,930068,649250,280818,424856,206245,1,206532,158430,48102,3.293626045,115631,101150,10198,3462,3359,103,802,4,0.03929741,0,hg38,CD-0722-1
"D7,E6",1317690,1511673,1010846,500827,667663,349400,4,349810,286337,63473,4.511162226,199841,208023,37168,11971,11735,236,1815,8,0.064337452,0,hg38,CD-0722-1
"D7,E7",18022,19345,13754,5591,9029,4144,0,4151,2714,1437,1.888656924,2255,2516,400,154,152,2,61,1,0.059210526,0,empty,CD-0722-1
"D7,E8",13406,14536,10206,4330,6736,3144,0,3153,2001,1152,1.736979167,1755,2925,509,200,189,11,58,3,0.031746032,0,empty,CD-0722-1
"D7,E9",9648,10915,7270,3645,5109,2468,0,2476,1650,826,1.997578692,1417,2423,734,281,279,2,73,1,0.003584229,0,empty,CD-0722-1
"D7,E10",9980,10983,7520,3463,5250,2551,0,2557,1727,830,2.080722892,1458,1850,494,171,167,4,47,2,0.023952096,0,empty,CD-0722-1
"D7,E11",1026601,1194408,774277,420131,544918,293296,3,293650,236210,57440,4.112291086,171814,139076,18723,6158,6043,115,1198,7,0.098130068,0,hg38,CD-0722-1
"D7,E12",818851,915244,623193,292051,421944,212423,2,212604,163386,49218,3.319639156,121853,34247,6212,2046,2010,36,407,4,0.019900498,0,hg38,CD-0722-1
"D7,F1",14940,16720,11007,5713,7717,3768,0,3772,2413,1359,1.775570272,2230,1981,495,154,148,6,44,2,0.148648649,0,empty,CD-0722-1
"D7,F2",12608,13811,9376,4435,6624,3217,0,3220,2115,1105,1.914027149,1843,3035,514,191,190,1,84,1,0.021052632,0,empty,CD-0722-1
"D7,F3",11972,13117,8923,4194,6150,3000,0,3006,1948,1058,1.84120983,1727,2295,507,205,204,1,73,1,0.176470588,0,empty,CD-0722-1
"D7,F4",16335,17615,12308,5307,8234,3877,1,3881,2544,1337,1.90276739,2155,502,81,32,30,2,19,1,0,0,empty,CD-0722-1
"D7,F5",13088,14247,9835,4412,6661,3145,0,3153,1987,1166,1.704116638,1787,2143,536,178,172,6,42,2,0.023255814,0,empty,CD-0722-1
"D7,F6",15361,17215,11637,5578,8063,4040,0,4040,2638,1402,1.881597718,2306,3293,786,284,275,9,91,2,0.072727273,0,empty,CD-0722-1
"D7,F7",16207,18013,12205,5808,8397,4184,0,4190,2723,1467,1.856169052,2367,1225,292,85,85,0,34,0,0.070588235,0,empty,CD-0722-1
"D7,F8",1075495,1270390,805205,465185,575895,320657,4,320994,263566,57428,4.589503378,189634,7999,1358,476,460,16,130,2,0.017391304,0,hg38,CD-0722-1
"D7,F9",12082,13465,9211,4254,6178,2997,0,3001,2068,933,2.216505895,1662,2394,568,222,219,3,60,2,0.077625571,0,empty,CD-0722-1
"D7,F10",14271,15558,11033,4525,7329,3401,1,3404,2243,1161,1.931955211,1883,1668,421,150,148,2,44,2,0.040540541,0,empty,CD-0722-1
"D7,F11",856326,945939,666501,279438,429546,203897,0,204111,153906,50205,3.06555124,114239,88605,8608,3030,2942,88,626,4,0.143099932,0,hg38,CD-0722-1
"D7,F12",12705,14329,9429,4900,6640,3367,0,3374,2162,1212,1.783828383,1961,128,12,6,6,0,3,0,0.166666667,0,empty,CD-0722-1
"D7,G1",14153,15673,10627,5046,7508,3689,0,3695,2414,1281,1.884465262,2136,2579,713,289,284,5,91,1,0.088028169,0,empty,CD-0722-1
"D7,G2",9012,10282,6328,3954,4948,2731,0,2743,1870,873,2.142038946,1647,346,32,20,20,0,12,0,0.35,0,empty,CD-0722-1
"D7,G3",15773,17570,11676,5894,8131,4139,0,4153,2553,1600,1.595625,2250,2410,608,210,209,1,70,1,0.090909091,0,empty,CD-0722-1
"D7,G4",3070962,3571859,2262149,1309710,1565829,914685,5,915623,702221,213402,3.290601775,539126,4262,387,135,130,5,44,3,0.092307692,0,hg38,CD-0722-1
"D7,G5",9994,10961,7541,3420,5188,2498,1,2502,1586,916,1.731441048,1427,2364,681,220,218,2,58,2,0.165137615,0,empty,CD-0722-1
"D7,G6",12875,14187,9768,4419,6548,3147,0,3154,2082,1072,1.942164179,1761,290,15,9,9,0,8,0,0,0,empty,CD-0722-1
"D7,G7",11859,13034,9179,3855,6174,2826,0,2831,1841,990,1.85959596,1533,2150,413,130,121,9,58,2,0.033057851,0,empty,CD-0722-1
"D7,G8",8364,9112,6253,2859,4303,2113,2,2119,1369,750,1.825333333,1186,1600,309,122,118,4,43,2,0.06779661,0,empty,CD-0722-1
"D7,G9",9666,10760,7115,3645,5086,2511,0,2511,1656,855,1.936842105,1486,2450,610,176,172,4,57,2,0.186046512,0,empty,CD-0722-1
"D7,G10",12418,13541,9550,3991,6345,3075,0,3077,1984,1093,1.815187557,1638,2540,643,205,204,1,77,1,0.093137255,0,empty,CD-0722-1
"D7,G11",12924,14253,9730,4523,6651,3199,0,3203,2115,1088,1.943933824,1829,1485,360,145,145,0,46,0,0.103448276,0,empty,CD-0722-1
"D7,G12",9636,10767,7236,3531,5142,2614,0,2621,1669,952,1.753151261,1520,2166,457,162,160,2,62,1,0.04375,0,empty,CD-0722-1
"D7,H1",10933,11814,8222,3592,5457,2615,0,2619,1698,921,1.843648208,1448,1312,437,107,106,1,25,1,0,0,empty,CD-0722-1
"D7,H2",11245,12572,8312,4260,5835,2942,0,2944,1933,1011,1.911968348,1717,2463,503,179,179,0,56,0,0.039106145,0,empty,CD-0722-1
"D7,H3",10199,11418,7554,3864,5368,2729,0,2737,1807,930,1.943010753,1586,1439,324,99,99,0,46,0,0.03030303,0,empty,CD-0722-1
"D7,H4",1283841,1498620,964715,533905,665901,355520,3,355910,281475,74435,3.781487204,211203,7371,1258,392,386,6,92,2,0.062176166,0,hg38,CD-0722-1
"D7,H5",14516,16023,10925,5098,7283,3623,0,3625,2370,1255,1.888446215,2013,1819,484,203,202,1,46,1,0.034653465,0,empty,CD-0722-1
"D7,H6",9930,11249,7403,3846,5307,2717,0,2717,1838,879,2.091012514,1575,1585,329,119,117,2,34,2,0.094017094,0,empty,CD-0722-1
"D7,H7",11365,12643,8445,4198,5885,2871,0,2879,1806,1073,1.683131407,1648,1753,303,122,119,3,46,1,0.025210084,0,empty,CD-0722-1
"D7,H8",12359,13828,9187,4641,6466,3289,0,3295,2083,1212,1.718646865,1906,2162,380,163,159,4,39,2,0.106918239,0,empty,CD-0722-1
"D7,H9",9936,10843,7491,3352,5072,2428,0,2435,1639,796,2.059045226,1395,1160,305,104,104,0,30,0,0.019230769,0,empty,CD-0722-1
"D7,H10",821904,964177,608215,355962,439132,242346,1,242602,193644,48958,3.955308632,145223,128809,18195,6096,5976,120,1106,7,0.109939759,0,hg38,CD-0722-1
"D7,H11",12184,14194,8471,5723,6750,4162,0,4165,2257,1908,1.182914046,2518,113,41,8,8,0,1,0,0,0,empty,CD-0722-1
"D7,H12",913195,1074359,671320,403039,489211,271945,7,272280,216354,55926,3.868576333,163558,158265,17242,5934,5739,195,1104,5,0.077713887,0,hg38,CD-0722-1
"D8,A1",8293,9086,6081,3005,4387,2222,0,2222,1430,792,1.805555556,1266,1647,401,160,160,0,38,0,0.0125,0,empty,CD-0722-1
"D8,A2",12558,13824,9353,4471,6509,3330,0,3331,2131,1200,1.775833333,1903,2296,554,187,185,2,52,1,0.005405405,0,empty,CD-0722-1
"D8,A3",550281,600261,428278,171983,280335,129803,8,129961,102292,27669,3.696989411,72449,40141,8772,2756,2727,29,551,3,0.027869454,0,hg38,CD-0722-1
"D8,A4",12794,14044,9582,4462,6596,3291,0,3298,2085,1213,1.718878813,1815,638,82,34,33,1,19,1,0.060606061,0,empty,CD-0722-1
"D8,A5",758487,864915,572022,292893,399135,208536,4,208778,167379,41399,4.043068673,120337,169138,26832,8643,8493,150,1423,5,0.072765807,0,hg38,CD-0722-1
"D8,A6",9268,10629,6961,3668,5030,2589,0,2593,1659,934,1.776231263,1489,2458,532,191,190,1,70,1,0.042105263,0,empty,CD-0722-1
"D8,A7",8102,8863,6057,2806,4228,2157,0,2158,1358,800,1.6975,1199,1396,341,113,111,2,38,1,0.162162162,0,empty,CD-0722-1
"D8,A8",4920,5668,3765,1903,2670,1382,0,1382,959,423,2.26713948,784,2012,424,159,158,1,46,1,0.107594937,0,empty,CD-0722-1
"D8,A9",8361,8892,6355,2537,4287,2070,0,2072,1365,707,1.930693069,1117,1865,407,154,152,2,42,2,0.065789474,0,empty,CD-0722-1
"D8,A10",9285,10160,7195,2965,4872,2338,0,2341,1458,883,1.651189128,1257,370,56,23,23,0,11,0,0,0,empty,CD-0722-1
"D8,A11",7698,8250,5875,2375,3988,1860,1,1866,1249,617,2.024311183,1015,1735,271,111,109,2,42,1,0.073394495,0,empty,CD-0722-1
"D8,A12",920770,1082744,679363,403381,495152,288678,2,288924,201958,86966,2.322263873,171270,69929,30277,9074,9053,21,1394,3,0.038329835,0,hg38,CD-0722-1
"D8,B1",8903,9844,6729,3115,4629,2313,0,2317,1476,841,1.755053508,1304,1337,307,117,117,0,25,0,0.256410256,0,empty,CD-0722-1
"D8,B2",9800,10824,6800,4024,5267,2796,0,2801,1753,1048,1.672709924,1689,702,306,101,101,0,20,0,0.227722772,0,empty,CD-0722-1
"D8,B3",6796,7509,5024,2485,3606,1832,0,1832,1194,638,1.871473354,1033,1527,203,71,70,1,27,1,0.014285714,0,empty,CD-0722-1
"D8,B4",8866,9975,6461,3514,4790,2534,0,2538,1601,937,1.70864461,1474,1697,357,122,115,7,37,2,0.008695652,0,empty,CD-0722-1
"D8,B5",8409,4784,2749,2035,2991,1636,1,1650,1056,594,1.777777778,1075,1203,312,104,104,0,20,0,0.317307692,0,empty,CD-0722-1
"D8,B6",9629,10780,7023,3757,5123,2715,0,2719,1688,1031,1.637245393,1583,1871,464,144,144,0,46,0,0.097222222,0,empty,CD-0722-1
"D8,B7",9041,10395,6898,3497,4891,2407,0,2411,1520,891,1.705948373,1398,1172,307,107,106,1,30,1,0.056603774,0,empty,CD-0722-1
"D8,B8",6599,7094,5080,2014,3446,1592,0,1600,1031,569,1.811950791,892,1481,432,139,137,2,34,2,0.072992701,0,empty,CD-0722-1
"D8,B9",12615,14015,9235,4780,6615,3473,1,3476,2085,1391,1.498921639,1999,1011,204,77,74,3,25,1,0.189189189,0,empty,CD-0722-1
"D8,B10",6497,7150,4532,2618,3542,1809,0,1828,1116,712,1.56741573,1123,528,39,17,13,4,8,2,0.076923077,0,empty,CD-0722-1
"D8,B11",13163,14721,9586,5135,6932,3803,0,3808,2127,1681,1.265318263,2189,222,51,16,16,0,10,0,0.1875,0,empty,CD-0722-1
"D8,B12",7854,8942,5794,3148,4163,2142,0,2143,1419,724,1.959944751,1263,1487,341,133,132,1,39,1,0.136363636,0,empty,CD-0722-1
"D8,C1",811570,886013,632037,253976,408287,201114,1,201343,149158,52185,2.858254288,109806,19500,3232,987,961,26,245,4,0.047866805,0,hg38,CD-0722-1
"D8,C2",12359,14050,9088,4962,6509,3280,0,3289,2088,1201,1.738551207,1954,2220,467,160,159,1,40,1,0.044025157,0,empty,CD-0722-1
"D8,C3",13575,15572,10037,5535,7276,3715,0,3720,2353,1367,1.721287491,2198,922,128,30,29,1,19,1,0.344827586,0,empty,CD-0722-1
"D8,C4",8492,9048,6528,2520,4426,2050,0,2052,1391,661,2.104387292,1151,1849,408,125,123,2,38,1,0.048780488,0,empty,CD-0722-1
"D8,C5",13810,15598,10459,5139,7418,3672,3,3680,2459,1221,2.013923014,2123,2081,385,131,131,0,46,0,0.167938931,0,empty,CD-0722-1
"D8,C6",10329,11277,7691,3586,5529,2757,2,2773,1828,945,1.934391534,1570,2152,551,161,156,5,53,1,0.038461538,0,empty,CD-0722-1
"D8,C7",19068,23933,12692,11241,11278,7383,1,7395,3905,3490,1.118911175,4846,408,90,37,37,0,12,0,0,0,empty,CD-0722-1
"D8,C8",15389,16629,11484,5145,8060,4015,0,4023,2599,1424,1.825140449,2290,3629,958,367,363,4,108,1,0.011019284,0,empty,CD-0722-1
"D8,C9",10246,11379,7693,3686,5402,2624,0,2625,1642,983,1.670396745,1534,2024,456,159,158,1,41,1,0.050632911,0,empty,CD-0722-1
"D8,C10",12299,13381,9353,4028,6209,2965,0,2973,1890,1083,1.745152355,1641,2353,578,195,191,4,58,1,0.167539267,0,empty,CD-0722-1
"D8,C11",10675,11649,8075,3574,5528,2701,0,2703,1682,1021,1.647404505,1493,2114,574,168,166,2,39,2,0.024096386,0,empty,CD-0722-1
"D8,C12",14925,16300,11006,5294,7640,3643,2,3649,2403,1246,1.928571429,2100,2007,533,168,167,1,53,1,0.071856287,0,empty,CD-0722-1
"D8,D1",828219,972911,602632,370279,450012,252871,4,253177,211975,41202,5.144774526,152508,39287,5934,1933,1897,36,432,4,0.022140221,0,hg38,CD-0722-1
"D8,D2",10567,11405,8010,3395,5450,2442,0,2447,1663,784,2.121173469,1334,3793,1096,333,331,2,88,1,0.069486405,0,empty,CD-0722-1
"D8,D3",10239,11250,7642,3608,5345,2686,0,2686,1793,893,2.007838746,1507,1742,380,118,117,1,40,1,0.085470085,0,empty,CD-0722-1
"D8,D4",7348,8322,5525,2797,3930,1933,0,1935,1222,713,1.713884993,1108,1416,343,144,138,6,38,1,0,0,empty,CD-0722-1
"D8,D5",8497,9511,6339,3172,4546,2260,0,2263,1493,770,1.938961039,1272,1782,390,99,97,2,39,1,0.134020619,0,empty,CD-0722-1
"D8,D6",818030,958932,604572,354360,440649,240973,5,241261,185192,56069,3.302930318,145365,124377,15133,4846,4708,138,967,6,0.056499575,0,hg38,CD-0722-1
"D8,D7",7349,7734,5632,2102,3739,1708,0,1711,1106,605,1.828099174,924,2358,691,208,208,0,49,0,0.072115385,0,empty,CD-0722-1
"D8,D8",8865,9818,6637,3181,4647,2210,0,2214,1404,810,1.733333333,1251,1848,428,137,135,2,36,2,0.02962963,0,empty,CD-0722-1
"D8,D9",5101,5627,3856,1771,2799,1339,1,1340,937,403,2.325062035,754,1989,517,129,127,2,48,1,0.078740157,0,empty,CD-0722-1
"D8,D10",9259,10829,6883,3946,5040,2635,0,2638,1648,990,1.664646465,1617,967,210,54,50,4,13,1,0.16,0,empty,CD-0722-1
"D8,D11",9843,10797,7400,3397,5200,2512,0,2515,1633,882,1.851473923,1366,3435,984,276,273,3,84,2,0.058608059,0,empty,CD-0722-1
"D8,D12",12936,14129,9929,4200,6561,3184,0,3186,2023,1163,1.739466896,1750,4159,1070,340,333,7,89,3,0.087087087,0,empty,CD-0722-1
"D8,E1",15494,16888,11482,5406,8097,4064,0,4069,2500,1569,1.593371574,2286,2752,673,241,241,0,67,0,0.037344398,0,empty,CD-0722-1
"D8,E2",11154,12502,8272,4230,5879,2975,0,2978,1887,1091,1.729605866,1719,2680,613,251,249,2,83,1,0.168674699,0,empty,CD-0722-1
"D8,E3",7727,8777,5848,2929,4173,2006,0,2011,1288,723,1.781466113,1181,3003,850,283,282,1,75,1,0.163120567,0,empty,CD-0722-1
"D8,E4",10664,11996,7905,4091,5672,2791,0,2791,1720,1071,1.605975724,1650,2878,541,177,175,2,69,2,0.142857143,0,empty,CD-0722-1
"D8,E5",9513,10185,7369,2816,4834,2219,0,2225,1430,795,1.798742138,1189,1294,256,102,102,0,35,0,0.068627451,0,empty,CD-0722-1
"D8,E6",124461,144780,92587,52193,66973,36714,2,36758,32182,4576,7.03277972,21556,23557,7918,1923,1913,10,408,4,0.028750653,0,empty,CD-0722-1
"D8,E7",15055,16753,11281,5472,7937,3936,0,3944,2533,1411,1.795180723,2251,3492,831,297,295,2,80,2,0.047457627,0,empty,CD-0722-1
"D8,E8",12125,13389,9177,4212,6252,3034,0,3036,1946,1090,1.785321101,1686,3424,981,257,257,0,62,0,0.097276265,0,empty,CD-0722-1
"D8,E9",7669,8403,5765,2638,3925,1951,0,1953,1328,625,2.1248,1072,2775,708,240,234,6,71,1,0.025641026,0,empty,CD-0722-1
"D8,E10",8543,9757,6478,3279,4634,2231,0,2233,1500,733,2.04638472,1343,2478,555,216,214,2,55,1,0.102803738,0,empty,CD-0722-1
"D8,E11",10680,12132,7986,4146,5651,2897,0,2902,1864,1038,1.795761079,1686,2089,528,152,151,1,55,1,0.092715232,0,empty,CD-0722-1
"D8,E12",11006,12278,8266,4012,5867,2866,0,2867,1906,961,1.983350676,1667,1912,459,146,145,1,39,1,0.075862069,0,empty,CD-0722-1
"D8,F1",13074,14420,9583,4837,6784,3351,0,3351,2125,1226,1.733278956,2002,2982,755,249,246,3,74,2,0.004065041,0,empty,CD-0722-1
"D8,F2",10600,11519,7883,3636,5480,2638,2,2644,1747,897,1.947603122,1477,2838,743,278,270,8,88,2,0.133333333,0,empty,CD-0722-1
"D8,F3",10086,10973,7653,3320,5262,2506,0,2509,1649,860,1.91744186,1432,2826,642,200,200,0,66,0,0.025,0,empty,CD-0722-1
"D8,F4",14848,16111,11063,5048,7761,3666,1,3673,2342,1331,1.759579264,2043,573,121,38,38,0,16,0,0.052631579,0,empty,CD-0722-1
"D8,F5",12572,14255,9283,4972,6625,3333,0,3337,2201,1136,1.9375,1967,2501,497,183,183,0,46,0,0.071038251,0,empty,CD-0722-1
"D8,F6",12119,13833,8891,4942,6522,3344,0,3355,2166,1189,1.821698907,1940,3474,737,227,225,2,67,2,0.053333333,0,empty,CD-0722-1
"D8,F7",14352,15570,10808,4762,7437,3728,0,3728,2436,1292,1.885448916,2092,1348,367,122,122,0,42,0,0.057377049,0,empty,CD-0722-1
"D8,F8",9570,10530,7190,3340,4979,2413,2,2423,1573,850,1.850588235,1419,323,52,15,15,0,7,0,0.333333333,0,empty,CD-0722-1
"D8,F9",10653,11637,8145,3492,5468,2596,0,2597,1694,903,1.875968992,1427,3021,852,289,288,1,60,1,0.0625,0,empty,CD-0722-1
"D8,F10",937121,1060327,715911,344416,481264,243007,5,243240,185179,58061,3.189387024,138915,157469,25095,8077,7929,148,1324,4,0.04918653,0,hg38,CD-0722-1
"D8,F11",10890,11632,8327,3305,5416,2439,2,2442,1567,875,1.790857143,1327,2094,518,188,186,2,50,2,0.086021505,0,empty,CD-0722-1
"D8,F12",11384,12302,8464,3838,5724,2779,0,2784,1839,945,1.946031746,1545,113,7,5,5,0,4,0,0,0,empty,CD-0722-1
"D8,G1",12573,14034,9530,4504,6648,3202,0,3204,2110,1094,1.928702011,1806,3318,707,267,260,7,77,2,0.146153846,0,empty,CD-0722-1
"D8,G2",7480,8084,5433,2651,3870,1970,0,1973,1218,755,1.613245033,1125,337,63,25,25,0,8,0,0,0,empty,CD-0722-1
"D8,G3",14206,15300,10464,4836,7169,3664,0,3665,2252,1413,1.593772116,2023,2526,644,237,235,2,70,2,0.046808511,0,empty,CD-0722-1
"D8,G4",2538225,2964753,1895165,1069588,1311639,735723,6,736486,594925,141561,4.202605237,434357,4866,763,221,216,5,71,2,0.092592593,0,hg38,CD-0722-1
"D8,G5",8126,9107,6046,3061,4308,2139,0,2141,1388,753,1.843293493,1215,1836,368,148,148,0,48,0,0.209459459,0,empty,CD-0722-1
"D8,G6",833203,1014053,589314,424739,468334,287426,1,287659,236316,51343,4.602691701,179042,1700,850,216,216,0,49,0,0.032407407,0,hg38,CD-0722-1
"D8,G7",10613,11746,7998,3748,5455,2620,0,2623,1755,868,2.021889401,1459,3414,1030,345,345,0,83,0,0.005797101,0,empty,CD-0722-1
"D8,G8",7483,8622,5512,3110,3971,1991,0,2000,1243,757,1.642007926,1198,1900,422,135,134,1,43,1,0,0,empty,CD-0722-1
"D8,G9",8847,9802,6605,3197,4495,2172,0,2176,1375,801,1.716604245,1206,2721,626,228,225,3,68,2,0.053333333,0,empty,CD-0722-1
"D8,G10",18197,19654,14231,5423,9164,4221,0,4227,2779,1448,1.919198895,2298,3317,849,295,293,2,81,1,0.017064846,0,empty,CD-0722-1
"D8,G11",10776,11544,8181,3363,5670,2712,0,2719,1788,931,1.920515575,1483,1427,365,134,130,4,34,1,0.192307692,0,empty,CD-0722-1
"D8,G12",8585,9864,6378,3486,4617,2369,0,2371,1493,878,1.700455581,1388,2736,704,255,253,2,64,1,0.043478261,0,empty,CD-0722-1
"D8,H1",8937,9823,6499,3324,4629,2240,0,2240,1425,815,1.748466258,1299,1370,208,51,49,2,22,1,0.040816327,0,empty,CD-0722-1
"D8,H2",10242,11614,7656,3958,5368,2705,0,2715,1741,974,1.787474333,1610,2705,722,252,251,1,54,1,0.235059761,0,empty,CD-0722-1
"D8,H3",8501,9205,6287,2918,4274,2143,0,2150,1412,738,1.913279133,1184,1595,333,112,111,1,28,1,0.054054054,0,empty,CD-0722-1
"D8,H4",12460,13881,9223,4658,6429,3087,5,3099,2001,1098,1.822404372,1824,375,51,17,17,0,10,0,0,0,empty,CD-0722-1
"D8,H5",13802,15299,10243,5056,6853,3415,1,3418,2197,1221,1.799344799,1982,2082,550,156,154,2,47,1,0,0,empty,CD-0722-1
"D8,H6",7956,8856,5861,2995,4237,2205,0,2206,1439,767,1.876140808,1285,2065,564,163,162,1,52,1,0.080246914,0,empty,CD-0722-1
"D8,H7",9413,10403,7051,3352,5004,2372,2,2374,1502,872,1.722477064,1337,2208,480,176,175,1,58,1,0.045714286,0,empty,CD-0722-1
"D8,H8",10519,11731,7868,3863,5503,2796,0,2796,1745,1051,1.660323501,1589,2486,521,166,163,3,49,3,0.061349693,0,empty,CD-0722-1
"D8,H9",8423,9185,6387,2798,4193,1914,1,1918,1292,626,2.063897764,1068,1034,275,96,96,0,23,0,0.15625,0,empty,CD-0722-1
"D8,H10",9111,10145,6736,3409,4654,2317,3,2323,1614,709,2.276445698,1346,1672,310,95,94,1,31,1,0.063829787,0,empty,CD-0722-1
"D8,H11",9948,11511,6970,4541,5518,3317,1,3325,1815,1510,1.201986755,2044,53,2,2,2,0,2,0,0,0,empty,CD-0722-1
"D8,H12",8391,9097,6099,2998,4295,2250,0,2257,1502,755,1.989403974,1273,1260,143,53,52,1,24,1,0.134615385,0,empty,CD-0722-1
"D9,A1",8415,9360,6153,3207,4408,2284,0,2288,1467,821,1.786845311,1294,1426,378,120,120,0,44,0,0.008333333,0,empty,CD-0722-1
"D9,A2",13843,15569,10267,5302,7348,3834,0,3837,2441,1396,1.748567335,2257,2034,455,192,192,0,59,0,0.010416667,0,empty,CD-0722-1
"D9,A3",7206,7658,5373,2285,3623,1732,0,1732,1165,567,2.054673721,916,1008,206,58,57,1,25,1,0,0,empty,CD-0722-1
"D9,A4",12483,13429,9289,4140,6373,3157,0,3157,2039,1118,1.823792487,1698,844,154,72,71,1,33,1,0.042253521,0,empty,CD-0722-1
"D9,A5",11397,12672,8436,4236,5989,2964,0,2970,1907,1063,1.793979304,1686,2474,665,244,244,0,82,0,0.163934426,0,empty,CD-0722-1
"D9,A6",10152,11789,7406,4383,5674,2990,0,2995,1951,1044,1.868773946,1790,2935,688,245,244,1,94,1,0.094262295,0,empty,CD-0722-1
"D9,A7",8218,9309,6092,3217,4493,2306,0,2306,1557,749,2.078771696,1341,1712,483,160,158,2,57,1,0.012658228,0,empty,CD-0722-1
"D9,A8",5222,6092,3937,2155,2971,1550,0,1554,1041,513,2.029239766,926,1723,382,136,136,0,60,0,0.022058824,0,empty,CD-0722-1
"D9,A9",1459701,1738244,1083986,654258,791733,448901,4,449297,351709,97588,3.604018937,269385,27086,4991,1468,1446,22,423,5,0.036652835,0,hg38,CD-0722-1
"D9,A10",10142,11228,7708,3520,5364,2672,0,2674,1711,963,1.776739356,1493,523,132,39,39,0,15,0,0.076923077,0,empty,CD-0722-1
"D9,A11",8010,9034,6087,2947,4349,2082,0,2087,1369,718,1.906685237,1208,1742,334,128,128,0,47,0,0.1015625,0,empty,CD-0722-1
"D9,A12",11249,12098,8394,3704,5635,2742,0,2750,1815,935,1.941176471,1526,3300,758,293,290,3,85,2,0.113793103,0,empty,CD-0722-1
"D9,B1",8834,9989,6486,3503,4714,2432,0,2440,1570,870,1.804597701,1408,1014,273,95,92,3,47,1,0.086956522,0,empty,CD-0722-1
"D9,B2",9076,9912,6308,3604,4743,2531,0,2537,1573,964,1.631742739,1515,560,66,38,38,0,23,0,0.052631579,0,empty,CD-0722-1
"D9,B3",7439,8442,5451,2991,4176,2169,0,2180,1426,754,1.891246684,1289,1382,357,143,141,2,48,1,0.014184397,0,empty,CD-0722-1
"D9,B4",9735,11129,7090,4039,5326,2839,0,2849,1810,1039,1.742059673,1684,1668,366,116,114,2,58,2,0.035087719,0,empty,CD-0722-1
"D9,B5",12936,10799,5802,4997,6018,3624,0,3637,2601,1036,2.510617761,2394,804,73,32,30,2,15,1,0,0,empty,CD-0722-1
"D9,B6",9696,10981,7041,3940,5327,2890,0,2893,1792,1101,1.627611262,1712,1651,513,152,149,3,38,1,0.013422819,0,empty,CD-0722-1
"D9,B7",8566,9502,6494,3008,4517,2193,0,2193,1450,743,1.951547779,1222,1174,319,121,121,0,32,0,0.066115702,0,empty,CD-0722-1
"D9,B8",6737,7533,5129,2404,3613,1742,0,1743,1162,581,2,995,1432,336,125,122,3,46,2,0,0,empty,CD-0722-1
"D9,B9",12668,14383,9321,5062,6758,3535,1,3546,2254,1292,1.744582043,2101,1105,362,94,91,3,34,2,0.10989011,0,empty,CD-0722-1
"D9,B10",6929,7128,4852,2276,3621,1812,0,1817,1160,657,1.765601218,1053,486,80,39,39,0,17,0,0.179487179,0,empty,CD-0722-1
"D9,B11",13905,16020,9960,6060,7439,4123,0,4130,2263,1867,1.212104981,2454,302,35,25,24,1,13,1,0.083333333,0,empty,CD-0722-1
"D9,B12",8212,9027,6228,2799,4399,2173,0,2177,1447,730,1.982191781,1195,1798,280,107,107,0,39,0,0.056074766,0,empty,CD-0722-1
"D9,C1",14137,15504,10954,4550,7368,3505,0,3506,2216,1290,1.717829457,1917,1177,276,92,89,3,37,1,0.011235955,0,empty,CD-0722-1
"D9,C2",11688,13209,8675,4534,6157,3084,0,3098,1994,1104,1.80615942,1801,2119,528,160,157,3,52,2,0.025477707,0,empty,CD-0722-1
"D9,C3",13676,15297,10094,5203,7541,3789,0,3793,2497,1296,1.926697531,2216,889,273,89,89,0,34,0,0.269662921,0,empty,CD-0722-1
"D9,C4",8538,9140,6473,2667,4426,1999,0,2001,1306,695,1.879136691,1128,2218,523,190,189,1,61,1,0.100529101,0,empty,CD-0722-1
"D9,C5",2274335,2704349,1674110,1030239,1203249,709969,0,710708,548659,162049,3.385759863,424091,179276,32714,10974,10729,245,1837,8,0.060769876,0,hg38,CD-0722-1
"D9,C6",11058,12348,8172,4176,6043,3076,0,3078,2055,1023,2.008797654,1811,1874,544,175,173,2,70,1,0.150289017,0,empty,CD-0722-1
"D9,C7",14045,16212,10250,5962,7666,4257,0,4260,2550,1710,1.49122807,2543,684,140,62,57,5,26,2,0.052631579,0,empty,CD-0722-1
"D9,C8",907119,1066087,672621,393466,485187,271376,0,271608,212970,58638,3.631945155,160868,122647,22470,7600,7450,150,1349,6,0.081073826,0,hg38,CD-0722-1
"D9,C9",757974,970771,530565,440206,447435,284620,1,284853,218114,66739,3.268164042,182897,11484,3169,967,960,7,261,2,0.061458333,0,hg38,CD-0722-1
"D9,C10",1452452,1612984,1130899,482085,724307,358764,0,359199,285115,74084,3.848536796,200977,93416,16514,5675,5595,80,1029,5,0.028596962,0,hg38,CD-0722-1
"D9,C11",10261,11517,7612,3905,5584,2862,0,2869,1816,1053,1.724596391,1698,2019,579,200,198,2,62,2,0.121212121,0,empty,CD-0722-1
"D9,C12",4710594,5247534,3615372,1632162,2202271,1200927,24,1202484,933023,269461,3.462553023,671637,465332,75840,25159,24730,429,3180,12,0.063687829,0,hg38,CD-0722-1
"D9,D1",13416,15063,9955,5108,7179,3823,0,3827,2235,1592,1.403894472,2191,850,151,78,78,0,33,0,0.166666667,0,empty,CD-0722-1
"D9,D2",9914,10753,7624,3129,5243,2439,1,2447,1595,852,1.872065728,1348,3066,762,312,309,3,107,1,0.025889968,0,empty,CD-0722-1
"D9,D3",10835,12039,7963,4076,5737,2967,0,2972,1976,996,1.983935743,1702,2158,567,169,167,2,69,2,0.065868263,0,empty,CD-0722-1
"D9,D4",8070,9280,6054,3226,4412,2261,0,2261,1503,758,1.982849604,1359,1682,398,148,145,3,58,1,0.2,0,empty,CD-0722-1
"D9,D5",770881,887150,581607,305543,409635,213804,3,214094,163058,51036,3.19496042,125548,112733,14538,4869,4775,94,924,4,0.047958115,0,hg38,CD-0722-1
"D9,D6",12732,14325,9207,5118,6800,3666,0,3669,2205,1464,1.506147541,2150,1812,461,163,163,0,49,0,0.128834356,0,empty,CD-0722-1
"D9,D7",7116,7820,5346,2474,3727,1752,0,1754,1151,603,1.908789386,956,1913,529,132,127,5,53,1,0.007874016,0,empty,CD-0722-1
"D9,D8",9333,10368,6879,3489,4909,2480,0,2481,1610,871,1.848450057,1412,1532,395,174,164,10,53,2,0.024390244,0,empty,CD-0722-1
"D9,D9",5416,5732,4143,1589,2761,1221,0,1221,840,381,2.204724409,648,1769,299,131,131,0,62,0,0.053435115,0,empty,CD-0722-1
"D9,D10",8525,9256,6260,2996,4416,2219,0,2221,1413,808,1.748762376,1254,730,69,29,29,0,14,0,0.068965517,0,empty,CD-0722-1
"D9,D11",10253,11298,7680,3618,5518,2670,0,2672,1776,896,1.982142857,1550,2987,637,267,261,6,96,2,0.107279693,0,empty,CD-0722-1
"D9,D12",12003,12791,9194,3597,6024,2813,0,2815,1795,1020,1.759803922,1465,3763,959,362,361,1,125,1,0.091412742,0,empty,CD-0722-1
"D9,E1",16154,17784,11999,5785,8591,4349,0,4357,2779,1578,1.761089987,2469,2677,585,223,222,1,103,1,0.040540541,0,empty,CD-0722-1
"D9,E2",11364,12359,8377,3982,5907,2956,0,2956,1858,1098,1.692167577,1673,2069,434,171,168,3,57,2,0.113095238,0,empty,CD-0722-1
"D9,E3",7536,8319,5802,2517,3952,1845,0,1849,1180,669,1.763826607,1010,2573,730,252,252,0,92,0,0.047619048,0,empty,CD-0722-1
"D9,E4",10893,12216,8000,4216,5909,2955,0,2959,2007,952,2.108193277,1754,3042,697,276,275,1,108,1,0.032727273,0,empty,CD-0722-1
"D9,E5",771694,857126,590133,266993,393040,196252,1,196495,155582,40913,3.802752181,110124,92845,18319,5824,5711,113,949,4,0.049028191,0,hg38,CD-0722-1
"D9,E6",15666,17160,11714,5446,8044,4045,0,4051,2667,1384,1.927023121,2309,3784,1147,284,284,0,78,0,0.098591549,0,empty,CD-0722-1
"D9,E7",15814,17587,11941,5646,8267,4000,0,4002,2595,1407,1.84434968,2258,3029,462,193,188,5,93,2,0.095744681,0,empty,CD-0722-1
"D9,E8",11580,12508,8887,3621,5829,2727,0,2732,1818,914,1.989059081,1456,2985,612,253,252,1,72,1,0.035714286,0,empty,CD-0722-1
"D9,E9",701524,897108,463518,433590,414333,288735,3,288969,218447,70522,3.097572389,184115,3248,770,315,310,5,143,2,0.041935484,0,hg38,CD-0722-1
"D9,E10",8396,9413,6329,3084,4515,2210,0,2210,1464,746,1.962466488,1285,2180,550,207,204,3,76,3,0.024509804,0,empty,CD-0722-1
"D9,E11",10533,11357,7917,3440,5310,2587,0,2590,1686,904,1.865044248,1412,2573,625,235,232,3,66,2,0.038793103,0,empty,CD-0722-1
"D9,E12",11750,12891,8697,4194,6219,3054,0,3056,2004,1052,1.904942966,1797,2017,468,167,165,2,64,1,0.012121212,0,empty,CD-0722-1
"D9,F1",13260,14659,9651,5008,6813,3371,0,3378,2121,1257,1.687350835,1955,2296,479,149,147,2,58,2,0.013605442,0,empty,CD-0722-1
"D9,F2",11267,11943,8192,3751,5863,2801,0,2805,1828,977,1.871033777,1569,4243,758,279,269,10,97,3,0.118959108,0,empty,CD-0722-1
"D9,F3",10643,11912,8006,3906,5630,2749,0,2751,1830,921,1.986970684,1563,2745,582,268,266,2,106,1,0.037593985,0,empty,CD-0722-1
"D9,F4",14738,16120,10969,5151,7821,3906,1,3919,2586,1333,1.939984996,2209,803,228,93,93,0,36,0,0.075268817,0,empty,CD-0722-1
"D9,F5",11888,12977,8828,4149,6077,2908,0,2914,1845,1069,1.725912067,1678,2759,763,269,268,1,83,1,0.014925373,0,empty,CD-0722-1
"D9,F6",1121949,1355020,817851,537169,608742,353929,2,354300,285333,68967,4.137239549,215313,200098,34979,11951,11783,168,1901,3,0.051939234,0,hg38,CD-0722-1
"D9,F7",14411,16623,10697,5926,7937,4084,0,4087,2682,1405,1.908896797,2482,1675,373,153,149,4,56,1,0.046979866,0,empty,CD-0722-1
"D9,F8",9257,10303,6893,3410,4896,2468,0,2468,1511,957,1.578892372,1408,296,69,32,32,0,11,0,0.03125,0,empty,CD-0722-1
"D9,F9",10388,11106,8026,3080,5258,2436,0,2437,1636,801,2.042446941,1309,2808,660,273,269,4,86,2,0.048327138,0,empty,CD-0722-1
"D9,F10",946965,1066131,722584,343547,481746,244862,2,245144,190318,54826,3.471309233,139470,87359,15278,4943,4865,78,916,5,0.061048304,0,hg38,CD-0722-1
"D9,F11",884153,1001873,670534,331339,454169,233737,0,233986,177303,56683,3.127974878,135055,138971,13967,4993,4827,166,985,6,0.091361094,0,hg38,CD-0722-1
"D9,F12",11486,12817,8454,4363,5864,2950,0,2954,1927,1027,1.876338851,1738,183,61,8,8,0,8,0,0,0,empty,CD-0722-1
"D9,G1",827991,945717,632294,313423,434710,222457,2,222723,173588,49135,3.532878803,129159,207454,28897,9673,9420,253,1575,10,0.057643312,0,hg38,CD-0722-1
"D9,G2",7140,7679,5126,2553,3712,1928,0,1928,1185,743,1.594885599,1111,398,66,34,34,0,19,0,0.088235294,0,empty,CD-0722-1
"D9,G3",1988883,2394789,1435764,959025,1077053,644834,8,645478,571408,74070,7.714432294,396983,117198,17606,5669,5588,81,1247,4,0.07480315,0,hg38,CD-0722-1
"D9,G4",941075,1033024,730848,302176,472228,228120,3,228383,151191,77192,1.95863561,125009,975,253,101,101,0,34,0,0.02970297,0,hg38,CD-0722-1
"D9,G5",8085,8926,5967,2959,4392,2256,0,2259,1455,804,1.809701493,1343,1737,374,167,167,0,61,0,0.047904192,0,empty,CD-0722-1
"D9,G6",11343,12455,8653,3802,5788,2773,0,2777,1804,973,1.854059609,1525,234,73,24,24,0,15,0,0,0,empty,CD-0722-1
"D9,G7",10261,11034,7863,3171,5381,2467,0,2475,1637,838,1.953460621,1381,2045,392,164,163,1,84,1,0.042944785,0,empty,CD-0722-1
"D9,G8",7020,7788,5224,2564,3646,1740,1,1750,1176,574,2.048780488,1008,1450,308,136,131,5,62,2,0.045801527,0,empty,CD-0722-1
"D9,G9",8709,9553,6577,2976,4579,2228,0,2232,1452,780,1.861538462,1243,2244,436,171,166,5,69,2,0.006024096,0,empty,CD-0722-1
"D9,G10",11205,12459,8383,4076,6007,3117,0,3118,1965,1153,1.704249783,1794,2801,638,238,238,0,85,0,0.092436975,0,empty,CD-0722-1
"D9,G11",514623,562276,393840,168436,259024,124559,1,124726,91748,32978,2.782097156,69866,33686,5222,1554,1514,40,366,4,0.033685601,0,hg38,CD-0722-1
"D9,G12",8431,9338,6172,3166,4589,2340,0,2348,1518,830,1.828915663,1361,2244,585,221,220,1,57,1,0.086363636,0,empty,CD-0722-1
"D9,H1",629570,692968,479224,213744,322971,159424,8,159631,123493,36138,3.417261608,90079,36644,7056,2181,2148,33,435,2,0.016759777,0,hg38,CD-0722-1
"D9,H2",10062,11193,7386,3807,5223,2591,0,2595,1646,949,1.734457323,1507,3009,878,272,268,4,84,1,0.104477612,0,empty,CD-0722-1
"D9,H3",9069,10126,6765,3361,4779,2401,0,2410,1595,815,1.957055215,1385,1790,439,148,146,2,52,1,0.082191781,0,empty,CD-0722-1
"D9,H4",12616,13830,9489,4341,6340,3134,0,3138,2060,1078,1.910946197,1718,317,22,14,13,1,9,1,0.076923077,0,empty,CD-0722-1
"D9,H5",12695,14206,9261,4945,6601,3404,0,3407,2208,1199,1.841534612,1963,1805,410,128,125,3,42,2,0.16,0,empty,CD-0722-1
"D9,H6",8338,9512,6144,3368,4590,2455,0,2455,1622,833,1.947178872,1437,1785,422,155,154,1,52,1,0.025974026,0,empty,CD-0722-1
"D9,H7",10283,11266,7545,3721,5344,2569,1,2580,1663,917,1.813522356,1478,2573,417,176,169,7,62,2,0.065088757,0,empty,CD-0722-1
"D9,H8",17693,20820,12710,8110,9847,5743,0,5745,4001,1744,2.294151376,3438,2116,412,153,149,4,51,1,0.087248322,0,empty,CD-0722-1
"D9,H9",8512,9176,6509,2667,4297,1976,1,1978,1328,650,2.043076923,1099,783,129,58,58,0,27,0,0.086206897,0,empty,CD-0722-1
"D9,H10",8151,9307,6141,3166,4357,2166,0,2169,1488,681,2.185022026,1268,1406,390,125,125,0,45,0,0.056,0,empty,CD-0722-1
"D9,H11",10530,12003,7376,4627,5767,3453,0,3455,1897,1558,1.21758665,2015,47,3,1,1,0,1,0,0,0,empty,CD-0722-1
"D9,H12",8952,9978,6552,3426,4755,2424,0,2428,1597,831,1.921780987,1412,1829,290,108,107,1,40,1,0.009345794,0,empty,CD-0722-1
"D10,A1",7994,9120,5961,3159,4339,2331,0,2331,1561,770,2.027272727,1377,1099,253,80,78,2,25,1,0.294871795,0,empty,CD-0722-1
"D10,A2",12695,14496,9537,4959,6872,3476,0,3480,2182,1298,1.681047766,2020,1319,220,95,94,1,39,1,0.031914894,0,empty,CD-0722-1
"D10,A3",7238,8116,5423,2693,3877,2004,0,2007,1353,654,2.068807339,1143,1187,225,59,57,2,21,1,0.192982456,0,empty,CD-0722-1
"D10,A4",12187,13579,9092,4487,6317,3099,0,3107,1924,1183,1.626373626,1760,705,141,45,45,0,27,0,0.044444444,0,empty,CD-0722-1
"D10,A5",10901,11588,8255,3333,5599,2673,0,2676,1733,943,1.837751856,1450,1703,365,114,113,1,36,1,0.159292035,0,empty,CD-0722-1
"D10,A6",9410,10836,6908,3928,5195,2707,0,2714,1729,985,1.755329949,1621,1789,383,150,148,2,63,2,0.114864865,0,empty,CD-0722-1
"D10,A7",7835,8671,5709,2962,4185,2243,1,2248,1423,825,1.724848485,1326,1334,304,106,106,0,37,0,0.018867925,0,empty,CD-0722-1
"D10,A8",359976,456750,249891,206859,215467,144035,0,144154,109020,35134,3.102977173,89463,4393,519,167,162,5,61,2,0.067901235,0,hg38,CD-0722-1
"D10,A9",8370,9249,6393,2856,4412,2094,0,2100,1359,741,1.834008097,1179,1549,522,172,170,2,39,1,0.252941176,0,empty,CD-0722-1
"D10,A10",10398,11521,7910,3611,5383,2631,0,2638,1642,996,1.648594378,1470,159,33,14,14,0,5,0,0,0,empty,CD-0722-1
"D10,A11",7620,8299,5800,2499,3967,1851,0,1851,1219,632,1.928797468,996,1553,159,83,81,2,33,1,0.086419753,0,empty,CD-0722-1
"D10,A12",10725,11927,8070,3857,5483,2666,0,2666,1717,949,1.809272919,1501,2963,681,252,251,1,74,1,0.015936255,0,empty,CD-0722-1
"D10,B1",8690,9848,6535,3313,4506,2301,0,2305,1468,837,1.753882915,1315,1004,262,87,87,0,23,0,0,0,empty,CD-0722-1
"D10,B2",8764,9753,6138,3615,4647,2420,2,2422,1441,981,1.468909276,1453,413,71,30,28,2,16,1,0.035714286,0,empty,CD-0722-1
"D10,B3",7379,8361,5362,2999,3971,2068,0,2072,1287,785,1.639490446,1245,1009,197,87,86,1,27,1,0.093023256,0,empty,CD-0722-1
"D10,B4",9371,10634,6857,3777,5164,2749,0,2751,1678,1073,1.563839702,1640,1290,307,128,127,1,36,1,0.078740157,0,empty,CD-0722-1
"D10,B5",751640,383543,214656,168887,251365,141206,11,142307,109874,32433,3.387722382,95937,87253,11324,3594,3536,58,761,5,0.042986425,0,hg38,CD-0722-1
"D10,B6",9750,11439,7077,4362,5314,2891,0,2897,1767,1130,1.563716814,1715,1303,214,104,103,1,31,1,0.067961165,0,empty,CD-0722-1
"D10,B7",8662,9518,6695,2823,4499,2170,0,2175,1456,719,2.025034771,1151,899,273,102,100,2,31,1,0.14,0,empty,CD-0722-1
"D10,B8",6481,7177,4955,2222,3373,1626,0,1626,1070,556,1.924460432,902,1117,357,121,120,1,31,1,0.225,0,empty,CD-0722-1
"D10,B9",12358,13864,9125,4739,6506,3421,0,3423,2146,1277,1.680501175,1976,567,75,28,28,0,19,0,0.035714286,0,empty,CD-0722-1
"D10,B10",6583,6941,4667,2274,3450,1749,0,1761,1113,648,1.717592593,1043,494,133,22,22,0,9,0,0.045454545,0,empty,CD-0722-1
"D10,B11",13854,15750,10281,5469,7330,4052,1,4058,2219,1839,1.20663404,2389,136,12,8,8,0,6,0,0,0,empty,CD-0722-1
"D10,B12",7807,8572,5745,2827,4176,2094,3,2097,1341,756,1.773809524,1245,1078,211,70,70,0,23,0,0,0,empty,CD-0722-1
"D10,C1",14755,15874,11239,4635,7465,3593,0,3600,2253,1347,1.672605791,1933,544,136,48,48,0,18,0,0,0,empty,CD-0722-1
"D10,C2",12265,13848,9037,4811,6460,3329,0,3330,2135,1195,1.786610879,1929,1562,341,110,109,1,33,1,0.018348624,0,empty,CD-0722-1
"D10,C3",12836,14105,9524,4581,6783,3339,0,3352,2170,1182,1.835871404,1897,787,124,43,43,0,16,0,0.139534884,0,empty,CD-0722-1
"D10,C4",8641,9437,6603,2834,4516,2149,0,2151,1391,760,1.830263158,1196,1793,432,130,128,2,32,2,0.1796875,0,empty,CD-0722-1
"D10,C5",12324,13850,9162,4688,6391,3190,0,3194,2124,1070,1.985046729,1786,1807,381,114,113,1,40,1,0.194690265,0,empty,CD-0722-1
"D10,C6",10633,11390,7961,3429,5539,2737,1,2740,1772,968,1.830578512,1469,1841,527,185,185,0,45,0,0.118918919,0,empty,CD-0722-1
"D10,C7",13670,15875,9805,6070,7504,4235,0,4244,2601,1643,1.583079732,2528,265,59,24,22,2,11,2,0.045454545,0,empty,CD-0722-1
"D10,C8",15696,17499,11753,5746,8137,4108,0,4111,2678,1433,1.868806699,2372,2189,511,176,176,0,56,0,0.113636364,0,empty,CD-0722-1
"D10,C9",11209,12728,8510,4218,5853,2902,0,2904,1883,1021,1.844270323,1673,1378,417,132,131,1,41,1,0.091603053,0,empty,CD-0722-1
"D10,C10",11762,12938,8908,4030,6077,2893,1,2897,1864,1033,1.804453049,1588,1783,496,164,161,3,40,2,0.037267081,0,empty,CD-0722-1
"D10,C11",9963,10968,7326,3642,5220,2550,0,2554,1598,956,1.671548117,1494,1166,385,116,115,1,44,1,0,0,empty,CD-0722-1
"D10,C12",15034,15978,11223,4755,7518,3544,0,3550,2313,1237,1.869846403,1972,1600,591,154,154,0,37,0,0.12987013,0,empty,CD-0722-1
"D10,D1",20781,24586,14640,9946,11521,6969,0,6983,3336,3647,0.914724431,4133,805,134,42,40,2,16,2,0.05,0,empty,CD-0722-1
"D10,D2",10243,11291,7828,3463,5351,2476,0,2483,1610,873,1.844215349,1354,2078,484,178,177,1,68,1,0.005649718,0,empty,CD-0722-1
"D10,D3",10282,11565,7699,3866,5660,2881,0,2883,1968,915,2.150819672,1662,1578,322,117,112,5,36,1,0.044642857,0,empty,CD-0722-1
"D10,D4",8931,9988,6652,3336,4835,2521,0,2526,1679,847,1.982290437,1484,995,263,47,47,0,18,0,0.127659574,0,empty,CD-0722-1
"D10,D5",8838,9798,6653,3145,4674,2313,0,2324,1536,788,1.949238579,1339,1624,376,135,132,3,41,1,0,0,empty,CD-0722-1
"D10,D6",12546,13750,9104,4646,6400,3383,0,3394,1994,1400,1.424285714,1918,1411,348,99,98,1,33,1,0.071428571,0,empty,CD-0722-1
"D10,D7",7215,8079,5368,2711,3776,1825,0,1825,1100,725,1.517241379,1091,1926,489,138,137,1,43,1,0.058394161,0,empty,CD-0722-1
"D10,D8",9021,10195,6801,3394,4960,2506,1,2514,1631,883,1.847112118,1463,855,161,61,60,1,21,1,0,0,empty,CD-0722-1
"D10,D9",5103,5776,3829,1947,2841,1384,0,1384,920,464,1.982758621,824,1641,425,147,144,3,36,1,0.152777778,0,empty,CD-0722-1
"D10,D10",7842,8934,5846,3088,4031,2052,0,2053,1266,787,1.608640407,1154,582,175,68,67,1,16,1,0.089552239,0,empty,CD-0722-1
"D10,D11",10276,11079,7722,3357,5307,2534,0,2543,1675,868,1.929723502,1389,2683,665,227,226,1,70,1,0.053097345,0,empty,CD-0722-1
"D10,D12",12125,13129,9113,4016,6234,2996,0,3005,1976,1029,1.920310982,1659,2868,863,276,270,6,73,2,0.07037037,0,empty,CD-0722-1
"D10,E1",15497,17268,11607,5661,8059,4003,0,4006,2498,1508,1.656498674,2241,1953,321,130,126,4,58,2,0.023809524,0,empty,CD-0722-1
"D10,E2",10979,12325,7988,4337,5823,2994,0,3000,1912,1088,1.757352941,1761,2020,445,130,126,4,40,2,0,0,empty,CD-0722-1
"D10,E3",7558,8501,5770,2731,3974,1882,0,1885,1199,686,1.747813411,1072,1937,659,210,209,1,48,1,0.057416268,0,empty,CD-0722-1
"D10,E4",10566,11721,7873,3848,5670,2842,0,2851,1870,981,1.906218145,1656,2056,418,165,163,2,53,1,0.055214724,0,empty,CD-0722-1
"D10,E5",8851,9571,6750,2821,4552,2102,0,2104,1360,744,1.827956989,1160,1211,304,96,95,1,33,1,0.021052632,0,empty,CD-0722-1
"D10,E6",15451,17034,11553,5481,8039,4009,0,4010,2539,1471,1.72603671,2225,2865,805,297,294,3,61,1,0.153061224,0,empty,CD-0722-1
"D10,E7",15172,16909,11495,5414,7898,3876,5,3889,2608,1281,2.035909446,2236,2560,587,190,185,5,60,3,0.054054054,0,empty,CD-0722-1
"D10,E8",11109,12443,8566,3877,5874,2830,0,2830,1842,988,1.86437247,1629,2417,588,199,199,0,48,0,0,0,empty,CD-0722-1
"D10,E9",682853,812794,499940,312854,376185,213041,0,213262,184157,29105,6.327332074,128317,196441,35226,11263,11054,209,1726,5,0.071376877,0,hg38,CD-0722-1
"D10,E10",812720,958821,604724,354097,443180,240463,2,240745,196552,44193,4.447582196,144680,151036,26730,8639,8494,145,1463,6,0.06510478,0,hg38,CD-0722-1
"D10,E11",10330,11207,7729,3478,5410,2694,0,2696,1763,933,1.88960343,1535,1676,303,119,119,0,37,0,0,0,empty,CD-0722-1
"D10,E12",11432,12941,8399,4542,6112,3113,0,3115,2030,1085,1.870967742,1857,1550,393,147,147,0,35,0,0.034013605,0,empty,CD-0722-1
"D10,F1",12757,13885,9510,4375,6573,3268,0,3272,2017,1255,1.607171315,1820,1972,325,118,117,1,43,1,0.008547009,0,empty,CD-0722-1
"D10,F2",10726,12285,7871,4414,5680,2871,0,2874,1832,1042,1.75815739,1708,2034,457,143,142,1,58,1,0.197183099,0,empty,CD-0722-1
"D10,F3",9982,10805,7361,3444,5168,2534,0,2537,1642,895,1.834636872,1453,2383,533,186,184,2,68,2,0.054347826,0,empty,CD-0722-1
"D10,F4",1585276,2059365,1073519,985846,930153,620579,22,621196,501503,119693,4.189910855,403668,1491,324,108,106,2,61,2,0.037735849,0,hg38,CD-0722-1
"D10,F5",11165,12147,8453,3694,5723,2676,0,2678,1718,960,1.789583333,1508,1371,235,105,103,2,37,1,0.233009709,0,empty,CD-0722-1
"D10,F6",12801,14234,9470,4764,6614,3405,0,3407,2215,1192,1.858221477,1917,2368,376,127,124,3,52,1,0.080645161,0,empty,CD-0722-1
"D10,F7",13749,15635,10064,5571,7269,3739,0,3743,2398,1345,1.782899628,2229,822,252,73,71,2,22,1,0.042253521,0,empty,CD-0722-1
"D10,F8",8986,9938,6851,3087,4787,2339,0,2339,1543,796,1.938442211,1305,147,62,16,16,0,4,0,0,0,empty,CD-0722-1
"D10,F9",10378,11109,7891,3218,5325,2483,0,2483,1667,816,2.042892157,1370,2597,583,202,198,4,51,1,0.060606061,0,empty,CD-0722-1
"D10,F10",12284,13365,9446,3919,6278,2899,0,2904,1934,970,1.993814433,1574,1268,343,113,113,0,25,0,0.353982301,0,empty,CD-0722-1
"D10,F11",10870,11701,8347,3354,5543,2554,0,2557,1696,861,1.969802555,1416,1219,302,102,102,0,25,0,0.117647059,0,empty,CD-0722-1
"D10,F12",11007,12201,8233,3968,5708,2783,0,2786,1808,978,1.848670757,1592,105,18,12,12,0,8,0,0.083333333,0,empty,CD-0722-1
"D10,G1",12378,13433,9296,4137,6371,3040,1,3047,2037,1010,2.016831683,1709,2313,350,128,126,2,61,1,0.03968254,0,empty,CD-0722-1
"D10,G2",7087,7556,4987,2569,3626,1880,0,1882,1201,681,1.763582966,1077,395,72,34,32,2,9,1,0.46875,0,empty,CD-0722-1
"D10,G3",13530,14662,10059,4603,6842,3503,0,3506,2175,1331,1.634109692,1891,1618,423,140,138,2,48,1,0.014492754,0,empty,CD-0722-1
"D10,G4",23778,26903,17316,9587,12731,7036,1,7042,4227,2815,1.501598579,4091,89,16,10,10,0,9,0,0.2,0,empty,CD-0722-1
"D10,G5",8144,9134,5992,3142,4318,2172,0,2174,1399,775,1.80516129,1233,1526,335,70,61,9,30,2,0.016393443,0,empty,CD-0722-1
"D10,G6",11285,12407,8546,3861,5886,2790,0,2790,1791,999,1.792792793,1584,118,14,9,8,1,4,1,0,0,empty,CD-0722-1
"D10,G7",887550,1104781,630268,474513,517087,328505,2,328797,258795,70002,3.696965801,204361,36152,17504,5272,5260,12,1044,3,0.013878327,0,hg38,CD-0722-1
"D10,G8",7005,7664,5193,2471,3605,1679,0,1679,1134,545,2.080733945,983,1409,275,120,119,1,35,1,0,0,empty,CD-0722-1
"D10,G9",8516,9706,6374,3332,4539,2247,0,2252,1447,805,1.797515528,1325,2140,526,177,175,2,63,1,0.005714286,0,empty,CD-0722-1
"D10,G10",1403383,1561554,1088192,473362,714450,349735,5,350129,278573,71556,3.893076751,197032,60682,13593,4158,4120,38,853,3,0.02184466,0,hg38,CD-0722-1
"D10,G11",1744196,2023616,1309585,714031,912570,497832,11,498403,391969,106434,3.682742357,290950,130876,21877,6976,6836,140,1284,4,0.063194851,0,hg38,CD-0722-1
"D10,G12",8446,9339,6212,3127,4546,2313,0,2313,1522,791,1.92414665,1337,2425,545,198,197,1,43,1,0.010152284,0,empty,CD-0722-1
"D10,H1",9112,10020,6800,3220,4830,2368,0,2370,1564,806,1.94044665,1378,1383,254,106,103,3,27,2,0.048543689,0,empty,CD-0722-1
"D10,H2",10256,11432,7689,3743,5277,2650,0,2652,1716,936,1.833333333,1508,1765,435,140,139,1,47,1,0.115107914,0,empty,CD-0722-1
"D10,H3",8785,9648,6593,3055,4502,2227,0,2228,1372,856,1.602803738,1251,1153,181,66,66,0,27,0,0.075757576,0,empty,CD-0722-1
"D10,H4",12353,13772,9139,4633,6351,3122,0,3123,2084,1039,2.005774783,1814,247,46,12,12,0,4,0,0,0,empty,CD-0722-1
"D10,H5",1943307,2599217,1243741,1355476,1180944,867461,1,868049,604922,263127,2.298973499,570747,3539,1064,324,323,1,128,1,0.099071207,0,hg38,CD-0722-1
"D10,H6",8092,9018,5941,3077,4235,2190,0,2192,1418,774,1.832041344,1266,1345,353,113,113,0,30,0,0.221238938,0,empty,CD-0722-1
"D10,H7",9743,10445,7321,3124,5004,2386,1,2396,1632,764,2.136125654,1314,1892,556,162,156,6,42,2,0.083333333,0,empty,CD-0722-1
"D10,H8",19275,22067,14243,7824,10603,5649,1,5661,4279,1382,3.096237337,3348,2197,395,126,123,3,36,2,0.081300813,0,empty,CD-0722-1
"D10,H9",8359,9023,6393,2630,4182,1896,0,1898,1281,617,2.076175041,1043,1093,279,87,86,1,27,1,0,0,empty,CD-0722-1
"D10,H10",7570,8092,5684,2408,3803,1850,0,1854,1253,601,2.084858569,1040,1321,274,85,85,0,24,0,0.011764706,0,empty,CD-0722-1
"D10,H11",10019,11515,7068,4447,5584,3385,0,3388,1894,1494,1.267737617,2048,32,4,2,2,0,2,0,0,0,empty,CD-0722-1
"D10,H12",8810,9782,6535,3247,4673,2411,2,2416,1575,841,1.872770511,1407,1418,316,126,125,1,36,1,0.008,0,empty,CD-0722-1
"D11,A1",6067,6823,4581,2242,3307,1706,0,1708,1115,593,1.880269815,975,879,142,64,63,1,35,1,0.031746032,0,empty,CD-0722-1
"D11,A2",11568,12892,8530,4362,6016,3028,0,3035,1940,1095,1.771689498,1720,2022,352,169,163,6,60,2,0.036809816,0,empty,CD-0722-1
"D11,A3",5523,5956,4121,1835,2896,1451,3,1456,978,478,2.046025105,827,913,215,79,78,1,31,1,0.038461538,0,empty,CD-0722-1
"D11,A4",9430,10512,7144,3368,4900,2429,0,2429,1561,868,1.798387097,1371,322,38,23,23,0,15,0,0.043478261,0,empty,CD-0722-1
"D11,A5",8633,9648,6438,3210,4556,2279,0,2288,1512,776,1.948453608,1312,1678,366,154,152,2,56,2,0.013157895,0,empty,CD-0722-1
"D11,A6",1192884,1388340,907035,481305,645984,351051,2,351426,276033,75393,3.661255024,202838,168533,25957,8618,8420,198,1460,6,0.053206651,0,hg38,CD-0722-1
"D11,A7",358300,412607,264638,147969,198837,115972,3,116070,70565,45505,1.550708713,67828,10210,722,258,244,14,85,2,0.221311475,0,hg38,CD-0722-1
"D11,A8",340811,401465,255944,145521,190257,101948,1,102041,82233,19808,4.151504443,60794,91706,15745,4866,4767,99,933,5,0.060415356,0,hg38,CD-0722-1
"D11,A9",6781,7609,5123,2486,3554,1739,0,1741,1123,618,1.817152104,983,1014,267,102,102,0,35,0,0.009803922,0,empty,CD-0722-1
"D11,A10",397752,456609,304112,152497,214233,108895,0,108998,82217,26781,3.069974982,63293,8253,1258,356,353,3,78,1,0.042492918,0,hg38,CD-0722-1
"D11,A11",5842,6305,4522,1783,3018,1415,0,1421,914,507,1.802761341,729,1388,368,139,136,3,41,1,0.073529412,0,empty,CD-0722-1
"D11,A12",618411,689934,471781,218153,316237,157880,1,158072,123949,34123,3.632418017,89914,245647,22980,8012,7735,277,1384,10,0.063348416,0,hg38,CD-0722-1
"D11,B1",6489,7191,4794,2397,3464,1804,0,1805,1127,678,1.662241888,1027,868,195,74,73,1,33,1,0.01369863,0,empty,CD-0722-1
"D11,B2",6764,7600,4649,2951,3671,2013,0,2017,1201,816,1.471813725,1247,402,20,10,9,1,6,1,0.111111111,0,empty,CD-0722-1
"D11,B3",447200,530696,330017,200679,250523,137744,0,137884,111042,26842,4.136875047,83431,57875,9876,3328,3277,51,672,4,0.03753433,0,hg38,CD-0722-1
"D11,B4",459398,571377,323230,248147,266963,175538,1,175668,139594,36074,3.869656817,106321,13639,6929,2175,2173,2,504,1,0.014726185,0,hg38,CD-0722-1
"D11,B5",6624,3555,2089,1466,2284,1186,0,1194,751,443,1.695259594,794,339,40,28,28,0,12,0,0.142857143,0,empty,CD-0722-1
"D11,B6",7588,8483,5559,2924,4113,2206,0,2211,1410,801,1.760299625,1305,848,149,78,77,1,19,1,0.207792208,0,empty,CD-0722-1
"D11,B7",6858,7530,5165,2365,3562,1721,0,1723,1158,565,2.049557522,938,541,128,69,69,0,18,0,0,0,empty,CD-0722-1
"D11,B8",5694,6094,4318,1776,2971,1423,0,1428,985,443,2.223476298,770,792,126,51,50,1,27,1,0.02,0,empty,CD-0722-1
"D11,B9",9770,10865,7167,3698,5131,2713,0,2714,1647,1067,1.543580131,1517,639,188,74,74,0,30,0,0.094594595,0,empty,CD-0722-1
"D11,B10",4874,5132,3295,1837,2607,1339,0,1345,866,479,1.807933194,814,414,63,24,24,0,13,0,0.125,0,empty,CD-0722-1
"D11,B11",10735,12026,7847,4179,5837,3219,0,3224,1770,1454,1.217331499,1940,146,48,11,11,0,3,0,0,0,empty,CD-0722-1
"D11,B12",6037,6688,4428,2260,3217,1611,0,1611,1030,581,1.772805508,917,1219,134,47,47,0,18,0,0.021276596,0,empty,CD-0722-1
"D11,C1",11257,12069,8691,3378,5631,2631,1,2635,1604,1031,1.555771096,1399,500,136,46,46,0,21,0,0,0,empty,CD-0722-1
"D11,C2",9312,10483,6788,3695,4881,2544,0,2546,1560,986,1.582150101,1471,1786,422,124,122,2,35,1,0.18852459,0,empty,CD-0722-1
"D11,C3",9351,10353,7042,3311,5038,2479,0,2484,1592,892,1.784753363,1389,619,137,47,47,0,17,0,0.021276596,0,empty,CD-0722-1
"D11,C4",6642,7112,5069,2043,3443,1587,0,1589,1034,555,1.863063063,879,1239,300,131,129,2,47,1,0.093023256,0,empty,CD-0722-1
"D11,C5",9178,10238,6716,3522,4977,2465,0,2468,1593,875,1.820571429,1435,1317,347,146,146,0,58,0,0.01369863,0,empty,CD-0722-1
"D11,C6",7944,8995,5920,3075,4401,2246,1,2248,1475,773,1.908150065,1293,1128,277,104,104,0,52,0,0.115384615,0,empty,CD-0722-1
"D11,C7",10371,12107,7395,4712,5662,3110,0,3111,1857,1254,1.480861244,1857,258,31,18,18,0,12,0,0,0,empty,CD-0722-1
"D11,C8",11869,13429,8814,4615,6326,3218,0,3229,2055,1174,1.750425894,1898,2559,544,183,183,0,71,0,0.032786885,0,empty,CD-0722-1
"D11,C9",8190,9056,6218,2838,4237,2015,4,2022,1332,690,1.930434783,1108,783,57,29,29,0,18,0,0,0,empty,CD-0722-1
"D11,C10",9017,9862,6824,3038,4625,2226,0,2228,1441,787,1.831003812,1245,1170,275,98,95,3,38,3,0.031578947,0,empty,CD-0722-1
"D11,C11",7700,8662,5663,2999,4154,2142,0,2145,1386,759,1.826086957,1238,1362,403,137,135,2,49,1,0.022222222,0,empty,CD-0722-1
"D11,C12",11546,12446,8671,3775,5865,2834,0,2843,1900,943,2.014846235,1594,1352,310,110,107,3,41,2,0.018691589,0,empty,CD-0722-1
"D11,D1",1240808,1439548,932679,506869,666636,360285,3,360721,294394,66327,4.438524281,211267,36165,5038,1758,1727,31,408,3,0.070642733,0,hg38,CD-0722-1
"D11,D2",7781,8504,5944,2560,4043,1834,0,1837,1180,657,1.796042618,1024,1686,519,174,172,2,55,2,0.069767442,0,empty,CD-0722-1
"D11,D3",7269,8385,5306,3079,4087,2098,0,2103,1401,702,1.995726496,1247,690,193,70,68,2,36,1,0.029411765,0,empty,CD-0722-1
"D11,D4",5588,6190,4173,2017,3032,1576,0,1577,1000,577,1.733102253,921,1086,316,104,104,0,28,0,0.163461538,0,empty,CD-0722-1
"D11,D5",6641,7246,4938,2308,3423,1672,0,1672,1075,597,1.800670017,939,1441,352,154,151,3,51,1,0.066225166,0,empty,CD-0722-1
"D11,D6",9825,11042,7101,3941,5129,2741,0,2741,1668,1073,1.554520037,1592,1331,288,85,84,1,29,1,0.011904762,0,empty,CD-0722-1
"D11,D7",5435,5821,4042,1779,2843,1361,0,1361,876,485,1.806185567,759,1431,424,151,149,2,45,1,0.006711409,0,empty,CD-0722-1
"D11,D8",6872,7679,5230,2449,3715,1854,0,1854,1215,639,1.901408451,1089,902,194,54,53,1,19,1,0.113207547,0,empty,CD-0722-1
"D11,D9",4016,4338,2940,1398,2096,1025,0,1026,666,360,1.85,595,1329,237,94,88,6,35,1,0.022727273,0,empty,CD-0722-1
"D11,D10",6167,6808,4552,2256,3220,1647,2,1651,1025,626,1.637380192,965,511,107,26,26,0,8,0,0.307692308,0,empty,CD-0722-1
"D11,D11",7716,8539,5794,2745,4136,1962,4,1971,1219,752,1.621010638,1169,1706,339,144,139,5,57,2,0.129496403,0,empty,CD-0722-1
"D11,D12",9215,10352,6976,3376,4751,2316,4,2325,1509,816,1.849264706,1298,2438,521,189,187,2,61,1,0.053475936,0,empty,CD-0722-1
"D11,E1",11622,12862,8651,4211,6134,3109,0,3113,1947,1166,1.669811321,1783,1975,401,149,145,4,55,2,0.089655172,0,empty,CD-0722-1
"D11,E2",8204,9410,5945,3465,4431,2324,1,2330,1471,859,1.712456345,1393,1123,198,67,67,0,25,0,0.044776119,0,empty,CD-0722-1
"D11,E3",5725,6383,4272,2111,3091,1503,0,1506,929,577,1.610051993,846,1578,332,167,163,4,54,2,0.09202454,0,empty,CD-0722-1
"D11,E4",7528,8322,5701,2621,4004,1951,0,1953,1229,724,1.697513812,1103,1629,292,119,117,2,56,1,0.068376068,0,empty,CD-0722-1
"D11,E5",6893,7429,5263,2166,3564,1636,0,1639,1067,572,1.865384615,913,853,201,70,70,0,25,0,0.114285714,0,empty,CD-0722-1
"D11,E6",12263,13816,9102,4714,6463,3313,0,3318,2081,1237,1.682295877,1916,2132,554,167,165,2,49,2,0.066666667,0,empty,CD-0722-1
"D11,E7",684823,797785,510297,287488,365356,199292,1,199489,157036,42453,3.699055426,117414,127234,21404,7162,7014,148,1313,5,0.0427716,0,hg38,CD-0722-1
"D11,E8",8945,9812,6896,2916,4574,2149,0,2153,1418,735,1.929251701,1146,1513,257,93,92,1,44,1,0.054347826,0,empty,CD-0722-1
"D11,E9",6105,6751,4453,2298,3243,1663,0,1665,1069,596,1.793624161,990,1611,491,180,176,4,59,2,0.0625,0,empty,CD-0722-1
"D11,E10",6538,7413,4882,2531,3527,1729,0,1729,1093,636,1.718553459,1018,1081,233,66,66,0,36,0,0.121212121,0,empty,CD-0722-1
"D11,E11",8097,8771,5958,2813,4182,2128,1,2129,1336,793,1.684741488,1214,1419,231,89,86,3,39,2,0.360465116,0,empty,CD-0722-1
"D11,E12",8735,9857,6359,3498,4729,2418,0,2419,1504,915,1.643715847,1399,1186,201,96,94,2,38,2,0.063829787,0,empty,CD-0722-1
"D11,F1",10045,11077,7454,3623,5217,2559,0,2563,1609,954,1.686582809,1434,1611,287,106,102,4,36,2,0.147058824,0,empty,CD-0722-1
"D11,F2",7984,8798,5871,2927,4275,2111,0,2114,1378,736,1.872282609,1244,1786,560,167,167,0,66,0,0.089820359,0,empty,CD-0722-1
"D11,F3",7624,8258,5734,2524,3986,1880,0,1881,1212,669,1.811659193,1030,2137,454,170,168,2,72,1,0.035714286,0,empty,CD-0722-1
"D11,F4",1220864,1388224,935206,453018,636146,331244,28,331649,274621,57028,4.815546749,188768,49023,6479,2153,2097,56,481,3,0.048164044,0,hg38,CD-0722-1
"D11,F5",8592,9195,6601,2594,4276,1916,0,1917,1213,704,1.723011364,1005,1489,446,152,151,1,37,1,0.079470199,0,empty,CD-0722-1
"D11,F6",9190,10686,6777,3909,5146,2709,0,2712,1706,1006,1.69582505,1640,2369,701,236,235,1,75,1,0.05106383,0,empty,CD-0722-1
"D11,F7",10304,11451,7704,3747,5541,2775,0,2780,1799,981,1.833843017,1617,966,146,51,51,0,28,0,0.019607843,0,empty,CD-0722-1
"D11,F8",6926,7493,5224,2269,3558,1680,0,1686,1128,558,2.021505376,937,259,111,27,27,0,12,0,0,0,empty,CD-0722-1
"D11,F9",985497,1149903,743461,406442,526717,287002,6,287326,234684,52642,4.458113294,166938,171263,24686,8105,7946,159,1452,4,0.049962245,0,hg38,CD-0722-1
"D11,F10",10104,10877,7743,3134,4990,2280,0,2294,1520,774,1.963824289,1239,1158,264,115,111,4,30,2,0.081081081,0,empty,CD-0722-1
"D11,F11",34676,39701,26640,13061,18536,9290,0,9299,7117,2182,3.261686526,5220,2274,444,172,169,3,46,2,0.023668639,0,empty,CD-0722-1
"D11,F12",8804,9573,6439,3134,4491,2220,0,2222,1454,768,1.893229167,1270,121,42,28,27,1,16,1,0,0,empty,CD-0722-1
"D11,G1",9886,11090,7454,3636,5290,2625,0,2629,1687,942,1.790870488,1513,2061,592,180,180,0,74,0,0.094444444,0,empty,CD-0722-1
"D11,G2",5493,6112,3893,2219,2942,1562,0,1569,996,573,1.738219895,893,165,32,22,21,1,13,1,0.047619048,0,empty,CD-0722-1
"D11,G3",10218,11094,7528,3566,5294,2689,1,2694,1608,1086,1.480662983,1538,1811,440,160,159,1,62,1,0.100628931,0,empty,CD-0722-1
"D11,G4",18252,20755,13295,7460,9908,5548,0,5549,3422,2127,1.60883874,3238,119,26,19,19,0,10,0,0,0,empty,CD-0722-1
"D11,G5",6345,7261,4573,2688,3479,1819,0,1821,1201,620,1.937096774,1084,1015,196,88,87,1,38,1,0.034482759,0,empty,CD-0722-1
"D11,G6",1500676,1674753,1146870,527883,759159,384747,5,385192,323686,61506,5.26267356,220030,5911,715,243,241,2,69,2,0.082987552,0,hg38,CD-0722-1
"D11,G7",7580,8231,5871,2360,3878,1790,0,1790,1192,598,1.993311037,936,1499,233,117,116,1,38,1,0.112068966,0,empty,CD-0722-1
"D11,G8",609274,700616,455259,245357,324152,176186,4,176354,136380,39974,3.411717616,103433,154967,15114,5080,4909,171,1048,7,0.035037686,0,hg38,CD-0722-1
"D11,G9",6546,7097,4881,2216,3343,1623,0,1623,1032,591,1.746192893,893,1863,484,193,191,2,65,2,0.031413613,0,empty,CD-0722-1
"D11,G10",8413,9367,6214,3153,4497,2251,0,2260,1428,832,1.716346154,1310,1748,391,142,141,1,54,1,0.09929078,0,empty,CD-0722-1
"D11,G11",7985,8763,6048,2715,4225,2007,1,2012,1301,711,1.829817159,1149,1048,155,66,66,0,28,0,0.03030303,0,empty,CD-0722-1
"D11,G12",6594,7274,4904,2370,3569,1786,0,1788,1216,572,2.125874126,1048,1516,441,155,154,1,37,1,0.12987013,0,empty,CD-0722-1
"D11,H1",7012,7791,5198,2593,3691,1784,0,1784,1155,629,1.836248013,1043,775,233,76,73,3,19,1,0.301369863,0,empty,CD-0722-1
"D11,H2",7908,8683,5804,2879,4081,2032,0,2037,1348,689,1.956458636,1113,1544,411,150,150,0,50,0,0.086666667,0,empty,CD-0722-1
"D11,H3",6555,7140,4830,2310,3446,1702,0,1706,1073,633,1.695102686,998,1065,193,67,67,0,24,0,0.402985075,0,empty,CD-0722-1
"D11,H4",9630,10541,7073,3468,4983,2419,0,2423,1543,880,1.753409091,1461,184,30,19,19,0,9,0,0,0,empty,CD-0722-1
"D11,H5",9771,10917,7222,3695,5106,2578,0,2580,1622,958,1.693110647,1512,1532,507,149,146,3,37,2,0.006849315,0,empty,CD-0722-1
"D11,H6",6170,6790,4550,2240,3291,1677,0,1682,1097,585,1.875213675,980,1294,363,142,141,1,46,1,0.063829787,0,empty,CD-0722-1
"D11,H7",7585,8340,5554,2786,3992,1982,1,1985,1317,668,1.971556886,1156,1157,114,52,51,1,31,1,0.117647059,0,empty,CD-0722-1
"D11,H8",8282,9246,6049,3197,4275,2155,0,2162,1366,796,1.716080402,1275,1108,251,111,108,3,43,1,0.009259259,0,empty,CD-0722-1
"D11,H9",6328,6788,4828,1960,3270,1502,0,1503,1013,490,2.067346939,810,888,248,51,51,0,21,0,0.058823529,0,empty,CD-0722-1
"D11,H10",5731,6377,4287,2090,2989,1446,0,1450,924,526,1.756653992,844,836,159,61,61,0,22,0,0.081967213,0,empty,CD-0722-1
"D11,H11",7772,9011,5418,3593,4382,2731,0,2740,1546,1194,1.29480737,1662,114,5,3,3,0,3,0,0,0,empty,CD-0722-1
"D11,H12",6701,7348,4791,2557,3507,1782,0,1785,1174,611,1.921440262,1013,798,138,63,57,6,33,1,0.263157895,0,empty,CD-0722-1
"D12,A1",7299,8294,5280,3014,3933,2005,0,2007,1283,724,1.772099448,1172,1035,222,64,64,0,29,0,0.328125,0,empty,CD-0722-1
"D12,A2",11017,11978,8292,3686,5749,2838,0,2841,1802,1039,1.734359962,1569,1614,439,153,153,0,43,0,0.176470588,0,empty,CD-0722-1
"D12,A3",6679,7200,5067,2133,3440,1684,0,1685,1137,548,2.074817518,933,872,190,74,74,0,24,0,0.040540541,0,empty,CD-0722-1
"D12,A4",11897,13328,8866,4462,6239,3100,0,3111,2091,1020,2.05,1775,981,247,73,72,1,25,1,0.138888889,0,empty,CD-0722-1
"D12,A5",594027,659515,454510,205005,306527,151113,0,151252,117627,33625,3.498200743,85723,48302,7920,2615,2561,54,546,4,0.024599766,0,hg38,CD-0722-1
"D12,A6",8136,9446,6079,3367,4597,2431,0,2436,1586,850,1.865882353,1425,2070,448,168,167,1,60,1,0.071856287,0,empty,CD-0722-1
"D12,A7",7601,8415,5658,2757,4043,2017,0,2021,1265,756,1.673280423,1170,1118,241,94,91,3,37,1,0.120879121,0,empty,CD-0722-1
"D12,A8",4535,5002,3331,1671,2452,1232,0,1233,793,440,1.802272727,726,1778,247,99,94,5,42,2,0.021276596,0,empty,CD-0722-1
"D12,A9",7876,8793,5991,2802,4067,2028,0,2030,1342,688,1.950581395,1120,1888,411,134,134,0,40,0,0,0,empty,CD-0722-1
"D12,A10",9079,10058,6983,3075,4763,2361,0,2362,1503,859,1.749708964,1316,269,42,20,20,0,10,0,0.35,0,empty,CD-0722-1
"D12,A11",683386,810883,507681,303202,372022,208796,1,209032,164319,44713,3.674971485,123958,38245,8224,2617,2601,16,639,3,0.055363322,0,hg38,CD-0722-1
"D12,A12",9528,10282,7351,2931,4786,2238,1,2241,1470,771,1.906614786,1207,3584,903,311,310,1,71,1,0.141935484,0,empty,CD-0722-1
"D12,B1",7816,8486,5969,2517,4022,1923,0,1928,1206,722,1.670360111,1083,1148,198,81,81,0,26,0,0.024691358,0,empty,CD-0722-1
"D12,B2",691236,771601,500821,270780,358767,193151,3,193341,149797,43544,3.440129524,113312,17540,2640,922,899,23,210,3,0.035595106,0,hg38,CD-0722-1
"D12,B3",6597,7240,4887,2353,3594,1809,0,1811,1116,695,1.605755396,1094,1366,219,71,71,0,33,0,0.014084507,0,empty,CD-0722-1
"D12,B4",8119,9162,5920,3242,4408,2353,0,2353,1415,938,1.508528785,1345,1126,336,96,95,1,40,1,0.073684211,0,empty,CD-0722-1
"D12,B5",8463,5079,2848,2231,3242,1838,1,1856,1213,643,1.886469673,1254,931,213,77,70,7,24,1,0.171428571,0,empty,CD-0722-1
"D12,B6",8823,9931,6347,3584,4705,2473,0,2480,1552,928,1.672413793,1453,1386,416,153,153,0,41,0,0.045751634,0,empty,CD-0722-1
"D12,B7",8072,9072,6111,2961,4275,2077,0,2078,1366,712,1.918539326,1158,842,154,60,60,0,25,0,0.05,0,empty,CD-0722-1
"D12,B8",6085,6785,4652,2133,3261,1531,0,1536,986,550,1.792727273,884,991,253,101,100,1,28,1,0.03,0,empty,CD-0722-1
"D12,B9",11035,11912,8327,3585,5618,2832,0,2838,1786,1052,1.697718631,1551,849,193,70,70,0,28,0,0.014285714,0,empty,CD-0722-1
"D12,B10",5841,6160,4105,2055,3232,1632,0,1635,1079,556,1.940647482,942,576,19,11,9,2,6,1,0.222222222,0,empty,CD-0722-1
"D12,B11",11903,13291,8662,4629,6274,3432,0,3436,1951,1485,1.313804714,1973,259,178,35,34,1,11,1,0,0,empty,CD-0722-1
"D12,B12",7340,7889,5501,2388,3806,1826,0,1826,1159,667,1.737631184,1048,1295,326,132,131,1,33,1,0.06870229,0,empty,CD-0722-1
"D12,C1",817876,913296,628897,284399,414183,202636,1,202879,150546,52333,2.876693482,115347,32263,4029,1285,1264,21,324,3,0.064082278,0,hg38,CD-0722-1
"D12,C2",11284,12401,8390,4011,5903,2939,0,2945,1837,1108,1.657942238,1686,1853,502,171,165,6,46,1,0.042424242,0,empty,CD-0722-1
"D12,C3",12019,12916,9162,3754,6316,3092,0,3098,1966,1132,1.736749117,1613,919,147,50,49,1,20,1,0,0,empty,CD-0722-1
"D12,C4",7867,8574,6084,2490,4043,1876,0,1878,1213,665,1.82406015,1014,1474,332,122,119,3,44,1,0.033613445,0,empty,CD-0722-1
"D12,C5",10966,12158,8262,3896,5782,2826,0,2831,1832,999,1.833833834,1635,2110,427,152,151,1,54,1,0.072847682,0,empty,CD-0722-1
"D12,C6",9555,10503,7028,3475,5074,2523,0,2528,1665,863,1.929316338,1445,1741,543,208,207,1,56,1,0.019323671,0,empty,CD-0722-1
"D12,C7",898027,1044705,678115,366590,474419,249701,0,249988,192319,57669,3.334876623,147682,23703,2235,866,838,28,209,3,0.058472554,0,hg38,CD-0722-1
"D12,C8",14169,15896,10621,5275,7445,3752,0,3753,2456,1297,1.893600617,2160,2794,558,203,200,3,55,1,0.075,0,empty,CD-0722-1
"D12,C9",9360,10559,7044,3515,5116,2599,0,2602,1692,910,1.859340659,1496,1789,325,125,119,6,33,2,0.025210084,0,empty,CD-0722-1
"D12,C10",11263,12314,8556,3758,5691,2743,0,2745,1792,953,1.880377754,1518,1740,256,84,84,0,32,0,0.035714286,0,empty,CD-0722-1
"D12,C11",9540,10568,7008,3560,5176,2627,0,2631,1682,949,1.772391992,1533,1918,468,149,145,4,47,2,0.068965517,0,empty,CD-0722-1
"D12,C12",13411,14954,10088,4866,6932,3266,1,3276,2130,1146,1.858638743,1856,2246,586,202,202,0,45,0,0.034653465,0,empty,CD-0722-1
"D12,D1",11749,13416,8680,4736,6389,3413,0,3420,2109,1311,1.608695652,1992,498,70,33,33,0,17,0,0.03030303,0,empty,CD-0722-1
"D12,D2",9813,10602,7559,3043,5025,2312,0,2312,1450,862,1.682134571,1218,2941,909,295,293,2,80,1,0.017064846,0,empty,CD-0722-1
"D12,D3",8969,9734,6629,3105,4829,2377,0,2379,1561,818,1.908312958,1365,1634,251,106,106,0,38,0,0.009433962,0,empty,CD-0722-1
"D12,D4",7030,7727,5344,2383,3742,1825,0,1825,1215,610,1.991803279,1031,1226,285,69,69,0,26,0,0.043478261,0,empty,CD-0722-1
"D12,D5",734990,854250,550750,303500,393887,211905,3,212126,168337,43789,3.84427596,124730,80377,15053,5003,4947,56,1009,4,0.052759248,0,hg38,CD-0722-1
"D12,D6",12198,13531,8965,4566,6499,3452,0,3456,2111,1345,1.569516729,2022,1462,358,128,126,2,36,1,0.119047619,0,empty,CD-0722-1
"D12,D7",6793,7446,5110,2336,3460,1630,0,1630,1070,560,1.910714286,903,2200,538,169,166,3,45,1,0.042168675,0,empty,CD-0722-1
"D12,D8",8363,9162,6254,2908,4436,2211,0,2217,1443,774,1.864341085,1269,1245,449,142,138,4,35,3,0.057971014,0,empty,CD-0722-1
"D12,D9",4481,5048,3389,1659,2485,1215,0,1217,868,349,2.487106017,718,1368,346,97,97,0,39,0,0.103092784,0,empty,CD-0722-1
"D12,D10",7938,9143,5997,3146,4166,2097,0,2102,1324,778,1.701799486,1189,783,269,64,61,3,16,1,0.049180328,0,empty,CD-0722-1
"D12,D11",9119,9666,6942,2724,4664,2236,0,2236,1434,802,1.788029925,1201,2691,623,188,186,2,67,2,0.129032258,0,empty,CD-0722-1
"D12,D12",11462,12720,8454,4266,5981,2981,0,2983,1908,1075,1.774883721,1750,3232,734,292,289,3,84,1,0.017301038,0,empty,CD-0722-1
"D12,E1",14589,15690,10890,4800,7417,3762,0,3769,2224,1545,1.439482201,2088,2819,890,272,262,10,86,1,0.114503817,0,empty,CD-0722-1
"D12,E2",564566,618454,432040,186414,289097,140548,2,140753,106484,34269,3.107298141,79013,43079,8357,2624,2584,40,518,3,0.028250774,0,hg38,CD-0722-1
"D12,E3",7145,7778,5492,2286,3678,1787,0,1792,1189,603,1.971807629,999,2625,515,193,189,4,62,2,0.068783069,0,empty,CD-0722-1
"D12,E4",9677,10978,7248,3730,5201,2608,0,2611,1674,937,1.786552828,1541,2401,463,168,160,8,55,2,0.075,0,empty,CD-0722-1
"D12,E5",8735,9464,6740,2724,4427,2048,0,2055,1347,708,1.902542373,1085,2058,451,176,175,1,55,1,0.097142857,0,empty,CD-0722-1
"D12,E6",15140,16684,11302,5382,7745,3880,1,3885,2438,1447,1.684865238,2219,2969,903,267,267,0,67,0,0.108614232,0,empty,CD-0722-1
"D12,E7",14076,15315,10662,4653,7190,3477,0,3487,2308,1179,1.957591179,1895,2497,590,217,217,0,62,0,0.069124424,0,empty,CD-0722-1
"D12,E8",10833,11839,8347,3492,5595,2588,1,2591,1658,933,1.777063237,1469,2131,524,194,190,4,48,2,0.168421053,0,empty,CD-0722-1
"D12,E9",6884,7593,5184,2409,3566,1730,0,1731,1099,632,1.738924051,972,2290,666,223,222,1,66,1,0.081081081,0,empty,CD-0722-1
"D12,E10",8426,9144,6379,2765,4360,2108,1,2109,1375,734,1.873297003,1204,1963,473,172,170,2,47,1,0.070588235,0,empty,CD-0722-1
"D12,E11",9787,11194,7170,4024,5314,2791,0,2793,1833,960,1.909375,1621,2284,534,160,155,5,45,1,0.167741935,0,empty,CD-0722-1
"D12,E12",10419,11792,7679,4113,5506,2760,0,2766,1773,993,1.785498489,1601,1853,415,160,159,1,51,1,0.06918239,0,empty,CD-0722-1
"D12,F1",11949,12919,8933,3986,6110,2899,1,2909,1881,1028,1.829766537,1559,2082,451,153,151,2,56,2,0.026490066,0,empty,CD-0722-1
"D12,F2",9627,10748,7178,3570,5090,2420,0,2426,1535,891,1.722783389,1391,2239,646,223,218,5,66,3,0.128440367,0,empty,CD-0722-1
"D12,F3",9341,10142,6875,3267,4923,2393,0,2393,1581,812,1.947044335,1372,2736,617,187,186,1,62,1,0.032258065,0,empty,CD-0722-1
"D12,F4",14116,15325,10759,4566,7287,3429,1,3438,2177,1261,1.726407613,1927,667,202,54,54,0,21,0,0,0,empty,CD-0722-1
"D12,F5",11392,11813,8576,3237,5501,2463,0,2464,1590,874,1.819221968,1327,2181,503,173,172,1,57,1,0.075581395,0,empty,CD-0722-1
"D12,F6",1231431,1376703,947171,429532,627014,310305,5,310742,240003,70739,3.392796053,176918,121407,16592,5158,5044,114,1067,4,0.035884219,0,hg38,CD-0722-1
"D12,F7",13098,14909,9811,5098,6981,3506,0,3510,2268,1242,1.826086957,2012,913,159,71,71,0,36,0,0.098591549,0,empty,CD-0722-1
"D12,F8",8746,9652,6558,3094,4587,2195,0,2204,1409,795,1.772327044,1259,159,7,5,5,0,4,0,0,0,empty,CD-0722-1
"D12,F9",9700,10724,7467,3257,4993,2341,0,2342,1586,756,2.097883598,1278,2555,737,271,267,4,79,2,0.093632959,0,empty,CD-0722-1
"D12,F10",994616,1169761,729204,440557,531167,304163,3,304457,238147,66310,3.591419092,179938,32941,12692,3777,3772,5,785,3,0.033138918,0,hg38,CD-0722-1
"D12,F11",9711,10702,7365,3337,5003,2370,0,2370,1563,807,1.936802974,1336,2017,410,150,148,2,39,2,0.060810811,0,empty,CD-0722-1
"D12,F12",10231,11202,7498,3704,5186,2546,0,2553,1658,895,1.852513966,1430,180,47,33,33,0,11,0,0,0,empty,CD-0722-1
"D12,G1",12123,13021,9120,3901,6257,2954,1,2956,1928,1028,1.875486381,1664,2522,628,234,230,4,79,2,0.065217391,0,empty,CD-0722-1
"D12,G2",1498227,1746956,1061504,685452,804714,467169,4,467618,379450,88168,4.303715634,284273,20374,3429,1084,1071,13,254,3,0.089635854,0,hg38,CD-0722-1
"D12,G3",12431,13411,9075,4336,6445,3242,0,3242,2006,1236,1.622977346,1814,2621,701,202,193,9,65,3,0.025906736,0,empty,CD-0722-1
"D12,G4",22429,25487,16376,9111,11877,6535,0,6537,3992,2545,1.568565815,3741,143,10,5,5,0,5,0,0,0,empty,CD-0722-1
"D12,G5",7682,8484,5635,2849,4117,2053,1,2054,1349,705,1.913475177,1222,1876,536,164,162,2,38,2,0.080246914,0,empty,CD-0722-1
"D12,G6",11012,12024,8337,3687,5595,2649,0,2655,1711,944,1.8125,1442,72,7,5,5,0,3,0,0,0,empty,CD-0722-1
"D12,G7",9367,10270,7079,3191,4965,2295,0,2298,1473,825,1.785454545,1318,2914,769,242,238,4,78,1,0.084033613,0,empty,CD-0722-1
"D12,G8",6305,6946,4716,2230,3276,1611,0,1612,1016,596,1.704697987,927,1576,467,153,153,0,47,0,0.006535948,0,empty,CD-0722-1
"D12,G9",7764,8599,5785,2814,3984,1925,0,1929,1253,676,1.853550296,1074,1961,465,173,171,2,59,1,0.152046784,0,empty,CD-0722-1
"D12,G10",9904,10951,7351,3600,5032,2585,0,2594,1710,884,1.93438914,1425,2421,501,169,169,0,60,0,0.023668639,0,empty,CD-0722-1
"D12,G11",9576,10430,7305,3125,4963,2334,1,2339,1534,805,1.905590062,1318,1449,279,110,106,4,37,2,0.113207547,0,empty,CD-0722-1
"D12,G12",7688,8772,5492,3280,4075,2138,0,2138,1373,765,1.794771242,1236,2074,417,158,156,2,42,2,0.012820513,0,empty,CD-0722-1
"D12,H1",7879,8733,5937,2796,4141,2031,0,2032,1313,719,1.826147427,1110,1244,369,134,132,2,43,1,0.022727273,0,empty,CD-0722-1
"D12,H2",952197,1151050,689455,461595,530365,312086,2,312384,247482,64902,3.813164463,192265,89613,18549,5667,5586,81,1039,4,0.037773004,0,hg38,CD-0722-1
"D12,H3",7862,8934,5849,3085,4110,2076,0,2076,1312,764,1.717277487,1241,1480,352,123,122,1,48,1,0.057377049,0,empty,CD-0722-1
"D12,H4",11465,12823,8586,4237,5995,3007,0,3013,1870,1143,1.636045494,1742,127,23,12,11,1,4,1,0,0,empty,CD-0722-1
"D12,H5",12075,13605,8843,4762,6212,3129,0,3136,1961,1175,1.66893617,1868,1565,345,132,129,3,36,2,0.015503876,0,empty,CD-0722-1
"D12,H6",753328,874869,566846,308023,401109,214511,1,214692,163440,51252,3.188948724,126872,135236,17695,5626,5449,177,1118,5,0.050284456,0,hg38,CD-0722-1
"D12,H7",9034,9667,6880,2787,4520,2149,4,2154,1374,780,1.761538462,1126,1856,455,156,156,0,48,0,0.083333333,0,empty,CD-0722-1
"D12,H8",9361,10770,6852,3918,4931,2561,0,2564,1636,928,1.762931034,1483,2108,451,157,155,2,54,1,0.025806452,0,empty,CD-0722-1
"D12,H9",1314174,1586633,958351,628282,723815,439529,3,439940,365052,74888,4.874639462,264662,84788,19652,5969,5906,63,1137,5,0.055367423,0,hg38,CD-0722-1
"D12,H10",6715,7478,5003,2475,3473,1719,0,1719,1169,550,2.125454545,944,993,156,63,61,2,18,2,0,0,empty,CD-0722-1
"D12,H11",10178,12064,7131,4933,5831,3685,0,3689,2020,1669,1.210305572,2219,45,6,4,4,0,4,0,0,0,empty,CD-0722-1
"D12,H12",7557,8449,5476,2973,4040,2142,0,2144,1418,726,1.953168044,1253,1253,239,92,91,1,27,1,0.032967033,0,empty,CD-0722-1
"E1,A1",7601,8459,5599,2860,4087,2116,0,2122,1411,711,1.984528833,1218,1503,315,129,127,2,58,2,0.11023622,0,empty,CD-0722-1
"E1,A2",11729,12764,8790,3974,6088,3087,0,3093,1938,1155,1.677922078,1662,1987,504,188,187,1,82,1,0.144385027,0,empty,CD-0722-1
"E1,A3",6999,8079,5105,2974,3693,1853,1,1854,1231,623,1.975922953,1099,1526,241,87,87,0,34,0,0.057471264,0,empty,CD-0722-1
"E1,A4",2321628,2648604,1743479,905125,1183067,648800,4,649427,523302,126125,4.149074331,375394,177386,26864,8767,8613,154,1458,6,0.051085568,0,hg38,CD-0722-1
"E1,A5",593903,677594,445916,231678,316839,167662,4,167841,122796,45045,2.726073926,97816,85234,13647,4464,4376,88,836,4,0.064442413,0,hg38,CD-0722-1
"E1,A6",8571,9703,6385,3318,4740,2440,1,2442,1592,850,1.872941176,1379,3650,802,324,321,3,112,1,0.171339564,0,empty,CD-0722-1
"E1,A7",941902,1179893,635611,544282,564301,380832,4,381171,348782,32389,10.76853253,241543,91080,25900,8314,8232,82,1403,6,0.008624879,0,hg38,CD-0722-1
"E1,A8",490176,623744,350037,273707,293320,181626,3,181793,143124,38669,3.701259407,114998,154154,25185,8377,8210,167,1467,5,0.063459196,0,hg38,CD-0722-1
"E1,A9",7861,8805,5832,2973,4291,2145,0,2149,1387,762,1.820209974,1257,2111,413,179,175,4,61,2,0.194285714,0,empty,CD-0722-1
"E1,A10",9201,9770,7040,2730,4678,2277,0,2280,1512,768,1.96875,1208,461,105,53,53,0,19,0,0.018867925,0,empty,CD-0722-1
"E1,A11",712384,884886,510569,374317,410671,254140,3,254376,197355,57021,3.461093281,157603,15914,5603,1682,1679,3,416,3,0.054794521,0,hg38,CD-0722-1
"E1,A12",457267,540339,328551,211788,252205,149385,2,149528,114875,34653,3.315008802,89666,26317,11610,3425,3411,14,757,5,0.021987687,0,hg38,CD-0722-1
"E1,B1",8140,9029,6023,3006,4294,2150,0,2153,1322,831,1.590854392,1266,1342,266,94,94,0,48,0,0.085106383,0,empty,CD-0722-1
"E1,B2",8579,9338,5932,3406,4569,2429,0,2432,1535,897,1.711259755,1475,976,234,109,109,0,30,0,0.339449541,0,empty,CD-0722-1
"E1,B3",308863,416843,190795,226048,199660,151076,2,151181,92518,58663,1.577109933,100108,2008,551,160,159,1,79,1,0.031446541,0,hg38,CD-0722-1
"E1,B4",8933,9861,6642,3219,4679,2420,0,2424,1535,889,1.726659168,1390,1369,218,108,107,1,64,1,0.037383178,0,empty,CD-0722-1
"E1,B5",9536,6191,3768,2423,3706,1996,0,2006,1343,663,2.025641026,1305,1181,239,87,87,0,32,0,0.149425287,0,empty,CD-0722-1
"E1,B6",9436,10496,7054,3442,4999,2639,4,2643,1627,1016,1.601377953,1465,1204,360,151,148,3,49,2,0.067567568,0,empty,CD-0722-1
"E1,B7",8307,9173,6293,2880,4336,2151,0,2153,1406,747,1.882195448,1202,1000,260,121,118,3,43,2,0,0,empty,CD-0722-1
"E1,B8",6539,7071,5069,2002,3325,1517,0,1521,1041,480,2.16875,805,1189,199,89,85,4,42,2,0.047058824,0,empty,CD-0722-1
"E1,B9",11448,12721,8409,4312,6021,3134,0,3135,1896,1239,1.530266344,1782,1121,299,134,133,1,46,1,0.07518797,0,empty,CD-0722-1
"E1,B10",715207,752951,506569,246382,361391,178546,20,179459,136002,43457,3.129576363,104781,16576,1924,698,684,14,171,3,0.045321637,0,hg38,CD-0722-1
"E1,B11",14985,17172,10721,6451,8124,4626,0,4633,2676,1957,1.36739908,2782,340,75,21,21,0,11,0,0,0,empty,CD-0722-1
"E1,B12",528925,591421,404599,186822,281230,139162,2,139338,114088,25250,4.518336634,79355,36348,6844,2026,1987,39,492,4,0.029189733,0,hg38,CD-0722-1
"E1,C1",13743,14579,10516,4063,7053,3367,0,3374,2110,1264,1.669303797,1833,1087,307,109,108,1,43,1,0,0,empty,CD-0722-1
"E1,C2",851416,987704,637061,350643,450044,244179,5,244456,188030,56426,3.332329068,144257,122262,13730,4598,4461,137,971,6,0.082044385,0,hg38,CD-0722-1
"E1,C3",925678,1106167,689306,416861,509228,280489,4,280779,222188,58591,3.792186513,170107,66244,9205,2861,2753,108,576,6,0.062840538,0,hg38,CD-0722-1
"E1,C4",8138,8728,6270,2458,4176,1892,0,1894,1250,644,1.940993789,1021,2103,345,108,107,1,49,1,0.009345794,0,empty,CD-0722-1
"E1,C5",13448,14978,10185,4793,7077,3532,0,3540,2409,1131,2.129973475,1962,2088,380,171,167,4,79,1,0.023952096,0,empty,CD-0722-1
"E1,C6",9658,10642,7168,3474,5274,2688,0,2695,1761,934,1.885438972,1552,2027,554,221,219,2,91,2,0.00456621,0,empty,CD-0722-1
"E1,C7",12470,14857,9076,5781,6912,3787,0,3800,2278,1522,1.496714849,2279,625,30,20,20,0,16,0,0.15,0,empty,CD-0722-1
"E1,C8",806937,916376,612954,303422,421154,213332,2,213579,161741,51838,3.120124233,123367,125889,15923,5022,4900,122,967,4,0.067142857,0,hg38,CD-0722-1
"E1,C9",10109,11564,7650,3914,5297,2624,0,2625,1702,923,1.843986999,1485,1624,397,159,153,6,53,2,0.22875817,0,empty,CD-0722-1
"E1,C10",11254,12133,8575,3558,5823,2793,1,2797,1882,915,2.056830601,1509,2420,524,185,183,2,64,2,0.092896175,0,empty,CD-0722-1
"E1,C11",779014,932789,569044,363745,430248,245188,2,245411,192870,52541,3.670847529,149860,87543,10861,3584,3478,106,815,6,0.037090282,0,hg38,CD-0722-1
"E1,C12",14080,15753,10548,5205,7429,3636,1,3649,2410,1239,1.94511703,2059,2348,533,186,183,3,63,2,0.120218579,0,empty,CD-0722-1
"E1,D1",12171,13842,8768,5074,6648,3566,0,3575,2225,1350,1.648148148,2163,973,155,65,65,0,32,0,0.015384615,0,empty,CD-0722-1
"E1,D2",9873,10868,7670,3198,5070,2342,0,2347,1518,829,1.831121834,1246,3103,863,341,339,2,121,1,0.064896755,0,empty,CD-0722-1
"E1,D3",9531,10820,7038,3782,5234,2728,0,2729,1802,927,1.94390507,1581,1722,364,128,125,3,59,2,0.056,0,empty,CD-0722-1
"E1,D4",632626,739180,465634,273546,348139,203382,0,203579,140634,62945,2.234236238,120543,19127,2933,933,921,12,309,2,0.066232356,0,hg38,CD-0722-1
"E1,D5",1648612,1942929,1228772,714157,887691,498461,2,498879,382106,116773,3.272211898,296277,166615,26572,8647,8498,149,1490,4,0.067074606,0,hg38,CD-0722-1
"E1,D6",713275,850989,514548,336441,395178,228660,0,228881,182836,46045,3.970811163,139938,124374,23694,7925,7806,119,1330,4,0.057263643,0,hg38,CD-0722-1
"E1,D7",1433610,1752683,990372,762311,818835,547649,5,548062,379132,168930,2.244314213,336085,23552,1932,674,659,15,227,2,0.282245827,0,hg38,CD-0722-1
"E1,D8",8203,9269,6074,3195,4439,2206,0,2215,1387,828,1.675120773,1289,1372,315,104,103,1,42,1,0,0,empty,CD-0722-1
"E1,D9",5231,6248,3797,2451,2982,1508,0,1513,1026,487,2.106776181,973,2669,722,225,225,0,71,0,0.08,0,empty,CD-0722-1
"E1,D10",8395,9681,6139,3542,4511,2329,0,2334,1469,865,1.698265896,1414,925,230,77,77,0,27,0,0.12987013,0,empty,CD-0722-1
"E1,D11",9498,10333,7065,3268,4991,2433,3,2440,1553,887,1.750845547,1351,3584,932,312,310,2,133,1,0.074193548,0,empty,CD-0722-1
"E1,D12",11361,12534,8418,4116,6035,2943,0,2947,1901,1046,1.817399618,1639,3784,827,278,275,3,101,1,0.076363636,0,empty,CD-0722-1
"E1,E1",1979970,2292857,1467242,825615,1032441,580149,7,580811,490611,90200,5.439146341,343002,95076,21118,6843,6726,117,1287,8,0.050698781,0,hg38,CD-0722-1
"E1,E2",10310,11414,7480,3934,5481,2764,0,2769,1700,1069,1.590271282,1591,2018,427,141,136,5,57,2,0.147058824,0,empty,CD-0722-1
"E1,E3",6910,7800,5264,2536,3728,1787,1,1791,1182,609,1.9408867,1031,2659,692,249,247,2,93,1,0.085020243,0,empty,CD-0722-1
"E1,E4",9833,11111,7459,3652,5375,2643,0,2647,1696,951,1.78338591,1549,2774,599,247,242,5,92,2,0.111570248,0,empty,CD-0722-1
"E1,E5",8456,9323,6520,2803,4411,2087,0,2087,1318,769,1.713914174,1147,1283,189,108,108,0,48,0,0.027777778,0,empty,CD-0722-1
"E1,E6",14369,16087,10607,5480,7573,3816,2,3824,2431,1393,1.745154343,2210,3586,909,318,312,6,99,2,0.163461538,0,empty,CD-0722-1
"E1,E7",21555,23766,16604,7162,11132,5160,0,5164,3476,1688,2.059241706,2865,12371,2005,671,655,16,180,3,0.05648855,0,empty,CD-0722-1
"E1,E8",1418814,1628345,1065267,563078,745874,412059,4,412464,315296,97168,3.244854273,236318,171280,20832,6784,6619,165,1198,10,0.076295513,0,hg38,CD-0722-1
"E1,E9",7554,8543,5608,2935,4069,2054,1,2063,1372,691,1.98552822,1160,3676,798,274,269,5,104,2,0.100371747,0,empty,CD-0722-1
"E1,E10",663007,828668,444908,383760,384433,264683,1,264912,197165,67747,2.910313372,164322,13726,1341,515,499,16,175,2,0.210420842,0,hg38,CD-0722-1
"E1,E11",9788,10771,7221,3550,5170,2642,0,2648,1700,948,1.793248945,1482,2446,525,151,148,3,59,2,0.060810811,0,empty,CD-0722-1
"E1,E12",11041,11972,8139,3833,5742,2834,0,2838,1801,1037,1.736740598,1638,2252,256,130,128,2,61,2,0.109375,0,empty,CD-0722-1
"E1,F1",12178,13069,9067,4002,6233,3041,0,3050,1950,1100,1.772727273,1716,2315,733,279,277,2,78,2,0.119133574,0,empty,CD-0722-1
"E1,F2",18855,21217,14199,7018,9879,4783,1,4793,3230,1563,2.066538708,2795,9190,1206,482,469,13,157,3,0.066098081,0,empty,CD-0722-1
"E1,F3",18579,20803,13230,7573,9798,5220,0,5222,3486,1736,2.008064516,3065,3702,750,292,286,6,110,2,0.122377622,0,empty,CD-0722-1
"E1,F4",14090,15348,10649,4699,7310,3454,1,3462,2246,1216,1.847039474,1940,861,84,41,40,1,27,1,0.1,0,empty,CD-0722-1
"E1,F5",10937,11785,8245,3540,5495,2548,0,2559,1763,796,2.214824121,1398,2377,801,260,258,2,83,1,0.108527132,0,empty,CD-0722-1
"E1,F6",2545783,2953255,1902031,1051224,1331116,746737,12,747462,550885,196577,2.802387868,442668,357309,52676,17822,17502,320,2714,4,0.043023654,0,hg38,CD-0722-1
"E1,F7",13203,14527,9760,4767,7054,3547,1,3550,2273,1277,1.779953015,1991,1455,329,138,136,2,58,2,0.044117647,0,empty,CD-0722-1
"E1,F8",8592,9617,6418,3199,4604,2314,0,2316,1485,831,1.78700361,1333,275,56,23,23,0,15,0,0,0,empty,CD-0722-1
"E1,F9",9987,11157,7494,3663,5217,2481,0,2488,1649,839,1.965435042,1451,2990,604,226,223,3,83,2,0.062780269,0,empty,CD-0722-1
"E1,F10",11986,13086,9065,4021,6159,2888,1,2904,1852,1052,1.760456274,1642,1399,454,148,146,2,46,1,0.020547945,0,empty,CD-0722-1
"E1,F11",9761,10462,7483,2979,4991,2267,0,2270,1566,704,2.224431818,1206,2312,359,149,149,0,51,0,0.053691275,0,empty,CD-0722-1
"E1,F12",10318,11602,7629,3973,5494,2767,0,2778,1764,1014,1.73964497,1614,222,64,32,32,0,10,0,0.15625,0,empty,CD-0722-1
"E1,G1",844483,1003480,621179,382301,467119,265266,2,265580,214929,50651,4.24333182,159461,85310,18755,6204,6132,72,1198,4,0.036692759,0,hg38,CD-0722-1
"E1,G2",6739,7443,4722,2721,3565,1851,0,1851,1230,621,1.980676329,1100,547,157,93,93,0,33,0,0.021505376,0,empty,CD-0722-1
"E1,G3",12725,13850,9457,4393,6625,3337,0,3342,2061,1281,1.608899297,1833,2850,791,316,309,7,106,2,0.074433657,0,empty,CD-0722-1
"E1,G4",23873,27131,17365,9766,13031,7254,0,7265,4311,2954,1.459377116,4222,285,33,25,25,0,18,0,0,0,empty,CD-0722-1
"E1,G5",7771,8952,5845,3107,4230,2106,0,2108,1404,704,1.994318182,1224,1829,457,153,150,3,64,1,0.166666667,0,empty,CD-0722-1
"E1,G6",11112,12154,8323,3831,5848,2801,1,2806,1831,975,1.877948718,1612,279,27,22,22,0,12,0,0,0,empty,CD-0722-1
"E1,G7",9582,10475,7290,3185,5033,2339,0,2348,1597,751,2.126498003,1307,2909,558,230,227,3,102,2,0.140969163,0,empty,CD-0722-1
"E1,G8",6552,7321,4835,2486,3568,1792,0,1796,1169,627,1.864433812,1073,2381,601,251,250,1,65,1,0.08,0,empty,CD-0722-1
"E1,G9",8216,9049,6101,2948,4346,2134,0,2137,1326,811,1.635018496,1237,2847,632,218,212,6,92,2,0.089622642,0,empty,CD-0722-1
"E1,G10",10157,11175,7617,3558,5400,2774,2,2783,1796,987,1.819655522,1539,2742,595,242,241,1,103,1,0.033195021,0,empty,CD-0722-1
"E1,G11",9852,10835,7442,3393,5257,2498,0,2505,1707,798,2.139097744,1435,1645,408,149,148,1,54,1,0.040540541,0,empty,CD-0722-1
"E1,G12",14136,16134,10392,5742,7543,3896,0,3900,2778,1122,2.475935829,2248,4894,985,313,312,1,86,1,0.022435897,0,empty,CD-0722-1
"E1,H1",8766,9909,6499,3410,4652,2289,0,2295,1528,767,1.992177314,1355,1395,269,89,89,0,36,0,0.033707865,0,empty,CD-0722-1
"E1,H2",9209,10125,6995,3130,4815,2369,0,2371,1505,866,1.737875289,1306,2212,538,182,180,2,65,1,0.016666667,0,empty,CD-0722-1
"E1,H3",8005,8816,5819,2997,4172,2100,0,2102,1339,763,1.75491481,1202,1499,385,147,142,5,55,1,0.084507042,0,empty,CD-0722-1
"E1,H4",11472,13252,8657,4595,6153,3097,0,3099,2017,1082,1.864140481,1837,162,24,17,17,0,15,0,0.058823529,0,empty,CD-0722-1
"E1,H5",11867,13069,8798,4271,6209,3109,1,3119,1928,1191,1.618807725,1812,1812,542,190,189,1,58,1,0.074074074,0,empty,CD-0722-1
"E1,H6",7168,7877,5300,2577,3833,1944,0,1949,1253,696,1.800287356,1137,2046,530,172,172,0,50,0,0.104651163,0,empty,CD-0722-1
"E1,H7",9643,10419,7247,3172,4896,2298,0,2300,1466,834,1.757793765,1283,2120,519,212,211,1,74,1,0.09478673,0,empty,CD-0722-1
"E1,H8",9760,10806,7225,3581,5090,2589,0,2590,1679,911,1.843029638,1485,2547,608,216,213,3,70,1,0.084507042,0,empty,CD-0722-1
"E1,H9",12917,15049,9273,5776,7057,4040,0,4050,2749,1301,2.112990008,2354,1314,351,100,97,3,34,2,0.092783505,0,empty,CD-0722-1
"E1,H10",7114,7730,5255,2475,3637,1767,0,1767,1136,631,1.800316957,1027,1408,386,144,144,0,52,0,0.097222222,0,empty,CD-0722-1
"E1,H11",9307,10878,6483,4395,5291,3257,0,3264,1787,1477,1.209884902,1989,77,8,7,7,0,5,0,0,0,empty,CD-0722-1
"E1,H12",8654,9719,6383,3336,4511,2328,0,2332,1572,760,2.068421053,1359,2481,486,216,215,1,67,1,0.148837209,0,empty,CD-0722-1
"E2,A1",653320,787473,470797,316676,366723,225467,0,225671,161069,64602,2.493250983,135907,45185,2112,803,726,77,181,3,0.415977961,0,hg38,CD-0722-1
"E2,A2",9320,10684,6862,3822,4910,2583,0,2584,1615,969,1.666666667,1482,1672,396,158,157,1,57,1,0.076433121,0,empty,CD-0722-1
"E2,A3",5355,5811,3996,1815,2844,1420,0,1422,923,499,1.849699399,811,928,258,120,116,4,36,2,0.025862069,0,empty,CD-0722-1
"E2,A4",10302,11533,7629,3904,5442,2733,0,2733,1788,945,1.892063492,1551,664,110,45,44,1,25,1,0.022727273,0,empty,CD-0722-1
"E2,A5",8391,9307,6298,3009,4539,2267,0,2270,1511,759,1.990777339,1302,2082,468,172,170,2,72,2,0.070588235,0,empty,CD-0722-1
"E2,A6",7430,8723,5651,3072,4028,2090,2,2099,1324,775,1.708387097,1214,2527,400,190,189,1,77,1,0.058201058,0,empty,CD-0722-1
"E2,A7",610896,713050,459358,253692,330784,177288,4,177477,137054,40423,3.39049551,104616,76332,10921,3775,3683,92,813,5,0.036926419,0,hg38,CD-0722-1
"E2,A8",4152,4623,3037,1586,2215,1118,0,1120,736,384,1.916666667,638,1366,420,163,160,3,67,2,0.05,0,empty,CD-0722-1
"E2,A9",6891,7645,5162,2483,3683,1890,0,1894,1218,676,1.801775148,1053,1984,504,184,183,1,70,1,0.344262295,0,empty,CD-0722-1
"E2,A10",7485,8016,5808,2208,3869,1872,0,1872,1190,682,1.744868035,992,334,61,35,34,1,22,1,0.235294118,0,empty,CD-0722-1
"E2,A11",6150,6925,4679,2246,3233,1563,0,1563,1036,527,1.965844402,870,1626,228,120,120,0,61,0,0.133333333,0,empty,CD-0722-1
"E2,A12",7762,8372,5855,2517,4061,2014,0,2019,1269,750,1.692,1163,2550,572,231,223,8,87,2,0.053811659,0,empty,CD-0722-1
"E2,B1",6793,7623,5052,2571,3490,1759,0,1762,1090,672,1.62202381,1007,1013,188,78,76,2,23,2,0,0,empty,CD-0722-1
"E2,B2",7343,8334,4907,3427,3877,2133,0,2135,1337,798,1.675438596,1298,527,92,40,40,0,17,0,0.3,0,empty,CD-0722-1
"E2,B3",5812,6437,4286,2151,3070,1574,1,1576,1024,552,1.855072464,885,1160,331,94,91,3,33,2,0,0,empty,CD-0722-1
"E2,B4",353123,378594,278322,100272,180686,74710,0,74801,57579,17222,3.343339914,40238,136343,29015,9246,9119,127,1409,6,0.037833096,0,hg38,CD-0722-1
"E2,B5",25635,24137,14831,9306,12422,7031,0,7043,5271,1772,2.974604966,4240,648,89,50,49,1,23,1,0.040816327,0,empty,CD-0722-1
"E2,B6",7292,8178,5281,2897,3937,2096,0,2098,1310,788,1.662436548,1222,988,287,133,131,2,42,1,0.175572519,0,empty,CD-0722-1
"E2,B7",7009,7645,5336,2309,3546,1704,0,1705,1156,549,2.10564663,899,1100,253,111,111,0,24,0,0,0,empty,CD-0722-1
"E2,B8",5023,5480,3798,1682,2693,1264,0,1266,817,449,1.819599109,725,1219,398,135,135,0,45,0,0,0,empty,CD-0722-1
"E2,B9",9248,10478,6831,3647,4924,2617,0,2620,1654,966,1.712215321,1528,650,167,76,75,1,41,1,0.026666667,0,empty,CD-0722-1
"E2,B10",5014,5255,3542,1713,2619,1313,3,1316,845,471,1.794055202,747,483,135,43,43,0,15,0,0,0,empty,CD-0722-1
"E2,B11",13399,15263,9891,5372,7218,3928,2,3937,2487,1450,1.715172414,2312,227,21,11,11,0,8,0,0.090909091,0,empty,CD-0722-1
"E2,B12",6086,6849,4548,2301,3222,1593,1,1598,1077,521,2.067178503,947,1285,190,83,82,1,42,1,0.048780488,0,empty,CD-0722-1
"E2,C1",708183,811054,529576,281478,371714,204798,0,205004,151217,53787,2.811404243,117696,24467,3742,1212,1195,17,293,2,0.081171548,0,hg38,CD-0722-1
"E2,C2",9488,10778,6955,3823,5074,2615,0,2621,1688,933,1.809217578,1545,1699,434,163,162,1,54,1,0.018518519,0,empty,CD-0722-1
"E2,C3",535607,684246,356522,327724,318200,222641,1,222829,169417,53412,3.171890212,140926,1470,442,160,159,1,52,1,0.037735849,0,hg38,CD-0722-1
"E2,C4",6577,7158,5004,2154,3408,1622,0,1622,1040,582,1.786941581,904,1668,376,152,150,2,63,1,0.06,0,empty,CD-0722-1
"E2,C5",810352,947215,602263,344952,432133,237857,2,238145,185685,52460,3.539553946,141688,94786,16045,5294,5203,91,967,4,0.052854123,0,hg38,CD-0722-1
"E2,C6",7792,8598,5716,2882,4201,2076,3,2080,1390,690,2.014492754,1201,1345,247,125,124,1,59,1,0.032258065,0,empty,CD-0722-1
"E2,C7",10812,12224,7904,4320,5739,3104,0,3110,1847,1263,1.462391132,1852,591,184,81,79,2,30,1,0.088607595,0,empty,CD-0722-1
"E2,C8",11412,12814,8499,4315,5967,3004,0,3011,1981,1030,1.923300971,1766,2408,499,188,186,2,88,1,0.134408602,0,empty,CD-0722-1
"E2,C9",2211433,2680813,1627879,1052934,1202984,703986,6,704673,547896,156777,3.494747316,431727,269371,43287,14118,13825,293,2171,6,0.060253165,0,hg38,CD-0722-1
"E2,C10",9276,10344,7027,3317,4811,2345,0,2346,1459,887,1.644870349,1298,1801,411,168,165,3,49,2,0.03030303,0,empty,CD-0722-1
"E2,C11",846074,1003087,625794,377293,457290,251387,2,251675,202269,49406,4.094016921,152908,148726,28563,9514,9374,140,1468,6,0.071154256,0,hg38,CD-0722-1
"E2,C12",11696,12527,8678,3849,5824,2724,0,2731,1819,912,1.994517544,1539,1945,516,171,170,1,53,1,0.1,0,empty,CD-0722-1
"E2,D1",10117,11266,7315,3951,5293,2761,0,2764,1641,1123,1.46126447,1608,655,102,37,37,0,25,0,0,0,empty,CD-0722-1
"E2,D2",9495,10375,7221,3154,5019,2419,0,2421,1563,858,1.821678322,1333,2709,725,286,281,5,119,1,0.035587189,0,empty,CD-0722-1
"E2,D3",8263,9045,5909,3136,4264,2161,0,2166,1414,752,1.880319149,1234,1494,287,116,110,6,45,1,0.109090909,0,empty,CD-0722-1
"E2,D4",5794,6598,4296,2302,3037,1526,0,1527,1052,475,2.214736842,887,948,156,76,73,3,37,1,0.054794521,0,empty,CD-0722-1
"E2,D5",6663,7327,5003,2324,3499,1708,0,1710,1157,553,2.092224231,942,1516,215,103,101,2,60,2,0.099009901,0,empty,CD-0722-1
"E2,D6",10329,11455,7367,4088,5393,2921,0,2921,1802,1119,1.610366399,1729,1603,442,165,164,1,52,1,0.048780488,0,empty,CD-0722-1
"E2,D7",5563,6157,4247,1910,2903,1392,0,1393,877,516,1.699612403,782,1363,319,123,122,1,48,1,0.032786885,0,empty,CD-0722-1
"E2,D8",6843,7536,5113,2423,3451,1688,0,1693,1043,650,1.604615385,972,1049,234,88,88,0,38,0,0.079545455,0,empty,CD-0722-1
"E2,D9",5096,5615,3815,1800,2635,1252,0,1253,890,363,2.451790634,711,1623,344,153,150,3,60,2,0.133333333,0,empty,CD-0722-1
"E2,D10",6497,7248,4896,2352,3389,1728,0,1732,1114,618,1.802588997,999,758,185,69,69,0,18,0,0.028985507,0,empty,CD-0722-1
"E2,D11",2947673,3442263,2208403,1233860,1517020,857662,3,858583,716315,142268,5.034969213,501421,576161,96821,31793,31307,486,3768,10,0.064298719,0,hg38,CD-0722-1
"E2,D12",9768,10502,7307,3195,4887,2399,0,2405,1600,805,1.98757764,1296,3463,924,320,319,1,117,1,0.090909091,0,empty,CD-0722-1
"E2,E1",11756,13000,8645,4355,6170,3143,0,3151,1956,1195,1.636820084,1846,2656,466,209,206,3,90,2,0.024271845,0,empty,CD-0722-1
"E2,E2",8496,9683,6213,3470,4535,2278,0,2284,1443,841,1.715814507,1371,1749,459,161,161,0,46,0,0.167701863,0,empty,CD-0722-1
"E2,E3",739249,885784,552068,333716,403762,228190,5,228442,184750,43692,4.228462876,136439,70622,14081,4659,4610,49,948,5,0.080694143,0,hg38,CD-0722-1
"E2,E4",7839,8899,5916,2983,4264,2068,0,2072,1358,714,1.901960784,1210,2637,630,252,249,3,102,2,0.068273092,0,empty,CD-0722-1
"E2,E5",7017,7919,5387,2532,3720,1756,0,1759,1177,582,2.02233677,1026,1328,345,128,128,0,46,0,0.0625,0,empty,CD-0722-1
"E2,E6",12363,13445,9219,4226,6331,3223,0,3228,2085,1143,1.824146982,1781,2316,514,208,208,0,65,0,0.182692308,0,empty,CD-0722-1
"E2,E7",11343,12482,8692,3790,5810,2722,0,2724,1746,978,1.785276074,1491,2479,518,163,160,3,68,2,0.1,0,empty,CD-0722-1
"E2,E8",9140,10241,7057,3184,4794,2218,0,2220,1488,732,2.032786885,1237,2342,491,194,193,1,62,1,0.015544041,0,empty,CD-0722-1
"E2,E9",5856,6391,4456,1935,3042,1451,1,1453,982,471,2.08492569,824,2247,521,193,193,0,75,0,0.051813472,0,empty,CD-0722-1
"E2,E10",6663,7345,5086,2259,3511,1649,0,1654,1061,593,1.78920742,952,1658,313,128,127,1,66,1,0.007874016,0,empty,CD-0722-1
"E2,E11",8229,9297,6134,3163,4229,2103,4,2107,1420,687,2.066957787,1201,1893,180,67,66,1,40,1,0.075757576,0,empty,CD-0722-1
"E2,E12",1047590,1192010,802812,389198,544302,284901,2,285208,233886,51322,4.55722692,164220,64686,9818,3217,3165,52,710,7,0.044865719,0,hg38,CD-0722-1
"E2,F1",10167,11305,7510,3795,5265,2518,0,2522,1586,936,1.694444444,1431,1866,522,145,141,4,54,2,0.106382979,0,empty,CD-0722-1
"E2,F2",536693,568697,424378,144319,263398,113093,0,113232,87221,26011,3.35323517,59914,88384,15805,5152,5058,94,960,6,0.024713325,0,hg38,CD-0722-1
"E2,F3",7735,8528,5801,2727,4020,1894,2,1904,1238,666,1.858858859,1079,2800,626,224,223,1,84,1,0.147982063,0,empty,CD-0722-1
"E2,F4",12279,13330,9168,4162,6253,3025,0,3030,1999,1031,1.938894277,1655,591,110,54,54,0,31,0,0.018518519,0,empty,CD-0722-1
"E2,F5",850439,932936,661472,271464,421707,203166,2,203401,161031,42370,3.80059004,113037,73807,13501,4280,4206,74,834,5,0.025202092,0,hg38,CD-0722-1
"E2,F6",733916,888856,531563,357293,405360,238788,0,239002,189965,49037,3.873911536,146619,122065,28169,9364,9246,118,1540,4,0.038827601,0,hg38,CD-0722-1
"E2,F7",10689,11580,8048,3532,5552,2764,0,2767,1812,955,1.897382199,1514,1364,323,126,126,0,56,0,0.007936508,0,empty,CD-0722-1
"E2,F8",7251,7982,5451,2531,3751,1843,0,1847,1160,687,1.688500728,1045,293,35,18,18,0,12,0,0,0,empty,CD-0722-1
"E2,F9",644869,752723,483802,268921,351333,196161,6,196328,145665,50663,2.875175177,115639,30514,7573,2363,2346,17,475,6,0.041346974,0,hg38,CD-0722-1
"E2,F10",10289,10923,7695,3228,5110,2368,0,2374,1511,863,1.750869061,1254,1620,326,112,112,0,33,0,0.160714286,0,empty,CD-0722-1
"E2,F11",580962,662565,436528,226037,303843,159108,1,159288,121813,37475,3.250513676,92430,64439,6495,2225,2166,59,516,3,0.074792244,0,hg38,CD-0722-1
"E2,F12",952352,1154384,675955,478429,521245,330709,1,331027,235809,95218,2.476517045,200906,1643,554,189,189,0,56,0,0.047619048,0,hg38,CD-0722-1
"E2,G1",9812,10551,7347,3204,5035,2387,2,2400,1548,852,1.816901408,1312,2778,783,272,269,3,93,2,0.007434944,0,empty,CD-0722-1
"E2,G2",299526,367383,196196,171187,176476,116366,4,116464,87271,29193,2.989449526,74863,1113,373,103,102,1,44,1,0.098039216,0,hg38,CD-0722-1
"E2,G3",12167,13344,9085,4259,6341,3173,0,3182,2034,1148,1.771777003,1760,2449,424,169,169,0,86,0,0.01183432,0,empty,CD-0722-1
"E2,G4",18639,21216,13538,7678,10028,5503,0,5515,3292,2223,1.480881691,3283,237,40,33,32,1,26,1,0.03125,0,empty,CD-0722-1
"E2,G5",6778,7725,5093,2632,3734,1917,0,1920,1257,663,1.895927602,1124,1484,235,107,107,0,48,0,0.065420561,0,empty,CD-0722-1
"E2,G6",9367,10146,7123,3023,4651,2183,4,2187,1364,823,1.657351154,1187,157,37,10,10,0,7,0,0,0,empty,CD-0722-1
"E2,G7",8304,8974,6254,2720,4249,1975,0,1975,1258,717,1.754532775,1111,2968,677,214,212,2,71,1,0.023584906,0,empty,CD-0722-1
"E2,G8",5618,6286,4145,2141,2992,1492,0,1493,949,544,1.744485294,897,1376,371,133,133,0,49,0,0.045112782,0,empty,CD-0722-1
"E2,G9",7035,7857,5218,2639,3641,1787,0,1795,1192,603,1.976782753,989,2544,787,274,270,4,79,1,0.148148148,0,empty,CD-0722-1
"E2,G10",8227,9040,6093,2947,4381,2220,0,2221,1480,741,1.997300945,1284,2316,580,272,271,1,115,1,0.077490775,0,empty,CD-0722-1
"E2,G11",8205,8896,6260,2636,4224,1986,0,1993,1282,711,1.803094233,1092,1326,343,124,123,1,49,1,0.154471545,0,empty,CD-0722-1
"E2,G12",711636,837460,534255,303205,389139,207697,1,207912,160392,47520,3.375252525,124247,116811,20402,6686,6599,87,1201,3,0.045612972,0,hg38,CD-0722-1
"E2,H1",6978,7696,5168,2528,3604,1724,6,1737,1154,583,1.97941681,1013,1050,181,64,63,1,27,1,0,0,empty,CD-0722-1
"E2,H2",905932,1064124,671393,392731,483760,269949,5,270234,211974,58260,3.638414006,161612,219266,31559,10627,10374,253,1655,6,0.096009254,0,hg38,CD-0722-1
"E2,H3",6550,7124,4788,2336,3335,1651,0,1652,1085,567,1.913580247,966,1290,285,123,122,1,58,1,0.155737705,0,empty,CD-0722-1
"E2,H4",829533,1000161,607599,392562,455525,263427,1,263663,213578,50085,4.264310672,160353,10129,1318,412,400,12,102,2,0.1175,0,hg38,CD-0722-1
"E2,H5",10277,11073,7717,3356,5225,2482,0,2486,1565,921,1.699239957,1372,1541,471,124,124,0,41,0,0.008064516,0,empty,CD-0722-1
"E2,H6",6066,6901,4491,2410,3232,1687,0,1689,1114,575,1.937391304,988,1533,306,105,102,3,46,2,0.039215686,0,empty,CD-0722-1
"E2,H7",7713,8700,5835,2865,4162,1978,0,1978,1318,660,1.996969697,1174,1347,233,101,101,0,54,0,0.02970297,0,empty,CD-0722-1
"E2,H8",8069,8856,5912,2944,4194,2179,0,2181,1390,791,1.757269279,1247,1584,407,119,119,0,44,0,0.016806723,0,empty,CD-0722-1
"E2,H9",10051,11239,7738,3501,5398,2665,0,2670,1949,721,2.703190014,1457,1092,211,60,60,0,29,0,0,0,empty,CD-0722-1
"E2,H10",5671,6351,4313,2038,2906,1429,0,1429,931,498,1.869477912,789,1075,197,79,79,0,31,0,0.063291139,0,empty,CD-0722-1
"E2,H11",7617,8751,5421,3330,4193,2497,0,2505,1350,1155,1.168831169,1493,52,5,3,3,0,3,0,0,0,empty,CD-0722-1
"E2,H12",6509,7297,4645,2652,3364,1775,0,1781,1193,588,2.028911565,1061,1705,333,89,85,4,51,2,0.094117647,0,empty,CD-0722-1
"E3,A1",694830,804847,528823,276024,377913,195769,1,195966,149809,46157,3.245639881,114549,123170,16452,5486,5333,153,1015,5,0.06000375,0,hg38,CD-0722-1
"E3,A2",11046,12366,8138,4228,5963,3040,0,3045,1901,1144,1.661713287,1767,2955,805,301,298,3,104,1,0.151006711,0,empty,CD-0722-1
"E3,A3",6567,7148,5035,2113,3488,1707,0,1709,1094,615,1.778861789,968,1806,405,156,155,1,54,1,0.019354839,0,empty,CD-0722-1
"E3,A4",11712,13051,8817,4234,6294,3176,0,3182,2048,1134,1.805996473,1847,1678,489,153,153,0,56,0,0.013071895,0,empty,CD-0722-1
"E3,A5",700624,823002,518248,304754,384635,215540,1,215748,175900,39848,4.414274242,127189,21345,8171,2664,2653,11,675,3,0.041839427,0,hg38,CD-0722-1
"E3,A6",10931,12371,8210,4161,5990,3108,0,3116,2129,987,2.15704154,1772,3991,934,377,372,5,132,2,0.045698925,0,empty,CD-0722-1
"E3,A7",7547,8372,5560,2812,4019,2075,0,2075,1293,782,1.653452685,1178,2328,397,144,138,6,63,2,0.108695652,0,empty,CD-0722-1
"E3,A8",4708,5431,3527,1904,2629,1287,2,1296,858,438,1.95890411,777,3313,721,269,268,1,99,1,0.093283582,0,empty,CD-0722-1
"E3,A9",989898,1154055,753667,400388,528595,282578,1,282872,229345,53527,4.284660078,163320,355541,53449,17618,17228,390,2392,8,0.079928024,0,hg38,CD-0722-1
"E3,A10",8810,9526,6686,2840,4517,2195,0,2198,1415,783,1.80715198,1187,526,106,50,50,0,24,0,0.1,0,empty,CD-0722-1
"E3,A11",7141,8041,5423,2618,3817,1826,0,1829,1182,647,1.826893354,1047,2438,560,183,181,2,82,1,0.016574586,0,empty,CD-0722-1
"E3,A12",9397,10084,7102,2982,4807,2290,0,2296,1508,788,1.913705584,1241,3936,837,288,286,2,96,2,0.066433566,0,empty,CD-0722-1
"E3,B1",8202,9029,6113,2916,4352,2156,1,2158,1406,752,1.869680851,1205,1441,270,134,129,5,56,1,0.03875969,0,empty,CD-0722-1
"E3,B2",8784,9617,6067,3550,4681,2478,0,2479,1497,982,1.524439919,1437,948,109,42,41,1,21,1,0.12195122,0,empty,CD-0722-1
"E3,B3",8086,9094,6070,3024,4375,2264,0,2264,1482,782,1.895140665,1264,2705,593,217,212,5,60,2,0.136792453,0,empty,CD-0722-1
"E3,B4",689216,803021,515380,287641,371667,198896,2,199125,159177,39948,3.984604986,117656,161749,22007,7404,7193,211,1306,7,0.050743779,0,hg38,CD-0722-1
"E3,B5",9381,6485,3899,2586,3798,2118,0,2127,1448,679,2.132547865,1361,1290,252,80,80,0,40,0,0.025,0,empty,CD-0722-1
"E3,B6",665878,784251,488095,296156,362672,204133,1,204313,160968,43345,3.713646326,121786,143554,25014,8438,8323,115,1402,3,0.041090953,0,hg38,CD-0722-1
"E3,B7",8294,8983,6324,2659,4365,2068,1,2069,1368,701,1.95149786,1123,1552,447,173,171,2,53,2,0.023391813,0,empty,CD-0722-1
"E3,B8",557374,627549,427997,199552,291582,145129,2,145330,106104,39226,2.704940601,82560,39271,5012,1705,1667,38,414,4,0.013197361,0,hg38,CD-0722-1
"E3,B9",11549,13284,8365,4919,6323,3321,0,3325,2053,1272,1.613993711,1934,1488,255,100,97,3,38,2,0.164948454,0,empty,CD-0722-1
"E3,B10",747003,811143,511012,300131,392874,216187,22,217131,161726,55405,2.918978432,130933,8855,689,244,237,7,83,2,0.071729958,0,hg38,CD-0722-1
"E3,B11",12438,14014,9105,4909,6677,3709,0,3711,2142,1569,1.365200765,2147,373,78,20,20,0,15,0,0.15,0,empty,CD-0722-1
"E3,B12",7170,8332,5268,3064,4037,2109,0,2118,1330,788,1.687817259,1279,2379,670,248,241,7,64,2,0.062240664,0,empty,CD-0722-1
"E3,C1",1008812,1183844,750462,433382,536604,300815,0,301120,238016,63104,3.771805274,177818,28003,7418,2325,2306,19,545,3,0.063313096,0,hg38,CD-0722-1
"E3,C2",11389,12519,8241,4278,5911,2952,1,2953,1903,1050,1.812380952,1708,2869,641,213,211,2,69,1,0.037914692,0,empty,CD-0722-1
"E3,C3",11891,13180,8817,4363,6456,3196,0,3202,2045,1157,1.767502161,1837,1188,197,70,68,2,35,2,0.191176471,0,empty,CD-0722-1
"E3,C4",606942,750545,429591,320954,354425,222433,1,222651,177939,44712,3.979669887,138941,49579,24483,7564,7546,18,1358,2,0.021335807,0,hg38,CD-0722-1
"E3,C5",11603,12980,8651,4329,6322,3185,0,3190,2051,1139,1.800702371,1852,3142,460,212,210,2,100,2,0.076190476,0,empty,CD-0722-1
"E3,C6",9925,10925,7190,3735,5340,2703,1,2706,1705,1001,1.703296703,1538,2749,741,280,279,1,88,1,0.064516129,0,empty,CD-0722-1
"E3,C7",13410,15430,9818,5612,7470,4082,0,4085,2431,1654,1.469770254,2416,960,243,89,89,0,43,0,0.06741573,0,empty,CD-0722-1
"E3,C8",13872,15530,10359,5171,7512,3857,0,3865,2461,1404,1.752849003,2249,4484,1127,389,387,2,127,1,0.033591731,0,empty,CD-0722-1
"E3,C9",9555,10671,7159,3512,5090,2492,0,2496,1631,865,1.885549133,1433,2161,360,126,123,3,59,2,0.024390244,0,empty,CD-0722-1
"E3,C10",10864,11954,8178,3776,5681,2795,0,2799,1776,1023,1.736070381,1576,2481,512,168,165,3,84,1,0.096969697,0,empty,CD-0722-1
"E3,C11",10195,11310,7499,3811,5408,2715,0,2722,1751,971,1.803295572,1583,2767,726,233,233,0,82,0,0.180257511,0,empty,CD-0722-1
"E3,C12",14036,15520,10525,4995,7323,3509,2,3523,2317,1206,1.921227197,1997,2930,796,262,259,3,78,2,0.135135135,0,empty,CD-0722-1
"E3,D1",12207,13648,8952,4696,6571,3453,0,3456,2115,1341,1.577181208,2042,1360,324,84,81,3,36,3,0.061728395,0,empty,CD-0722-1
"E3,D2",10083,10957,7671,3286,5311,2411,0,2416,1531,885,1.729943503,1353,5111,1292,442,439,3,162,2,0.111617312,0,empty,CD-0722-1
"E3,D3",673378,796080,498611,297469,380284,221977,2,222183,159859,62324,2.564966947,132493,11193,2771,847,840,7,236,1,0.030952381,0,hg38,CD-0722-1
"E3,D4",6848,7701,5197,2504,3663,1790,0,1791,1169,622,1.879421222,1001,2545,513,220,218,2,74,1,0.036697248,0,empty,CD-0722-1
"E3,D5",7811,8680,5754,2926,4280,2180,0,2184,1429,755,1.892715232,1294,2386,414,158,154,4,86,1,0.064935065,0,empty,CD-0722-1
"E3,D6",11896,13411,8607,4804,6293,3454,0,3459,2075,1384,1.499277457,2016,1987,573,223,223,0,68,0,0.040358744,0,empty,CD-0722-1
"E3,D7",6752,7323,4977,2346,3555,1704,0,1707,1078,629,1.713831479,979,3132,875,234,233,1,84,1,0.081545064,0,empty,CD-0722-1
"E3,D8",8375,8929,6233,2696,4465,2194,0,2195,1443,752,1.918882979,1227,2271,474,194,192,2,73,1,0.072916667,0,empty,CD-0722-1
"E3,D9",4784,4905,3635,1270,2418,1107,1,1109,755,354,2.132768362,562,2694,753,270,268,2,98,1,0.078358209,0,empty,CD-0722-1
"E3,D10",8671,9891,6325,3566,4643,2404,0,2405,1497,908,1.648678414,1407,1260,305,89,82,7,29,2,0.024390244,0,empty,CD-0722-1
"E3,D11",726469,837930,541532,296398,386733,209996,0,210219,160645,49574,3.240509138,123226,188799,29230,9160,8969,191,1605,6,0.03701639,0,hg38,CD-0722-1
"E3,D12",11337,12377,8671,3706,5996,2867,0,2871,1844,1027,1.795520935,1581,4691,1209,463,459,4,157,2,0.045751634,0,empty,CD-0722-1
"E3,E1",14558,16062,10906,5156,7691,3899,0,3901,2470,1431,1.726065688,2171,4462,632,264,261,3,118,2,0.026819923,0,empty,CD-0722-1
"E3,E2",1021961,1136842,777740,359102,527874,267210,4,267522,217428,50094,4.340400048,152852,131098,19916,6718,6555,163,1131,8,0.037681159,0,hg38,CD-0722-1
"E3,E3",6789,7639,5051,2588,3623,1807,0,1808,1186,622,1.906752412,1044,3952,980,401,398,3,127,2,0.08040201,0,empty,CD-0722-1
"E3,E4",1130350,1402265,814686,587579,638455,384207,3,384606,298387,86219,3.460803303,240093,91422,21907,6996,6930,66,1341,6,0.053823954,0,hg38,CD-0722-1
"E3,E5",8456,9303,6533,2770,4492,2059,3,2066,1355,711,1.905766526,1151,2218,660,260,260,0,87,0,0.080769231,0,empty,CD-0722-1
"E3,E6",14716,16425,10706,5719,7664,3914,0,3919,2514,1405,1.789323843,2305,4453,972,354,353,1,113,1,0.065155807,0,empty,CD-0722-1
"E3,E7",13348,14548,10006,4542,7098,3378,0,3382,2210,1172,1.885665529,1897,4237,1180,408,401,7,143,2,0.117206983,0,empty,CD-0722-1
"E3,E8",10882,11796,8350,3446,5516,2541,0,2543,1674,869,1.926352129,1352,5442,1377,436,433,3,118,1,0.076212471,0,empty,CD-0722-1
"E3,E9",7324,7964,5538,2426,3913,1876,0,1882,1254,628,1.996815287,1059,3787,844,330,326,4,113,2,0.119631902,0,empty,CD-0722-1
"E3,E10",8163,8893,6088,2805,4292,2049,0,2051,1344,707,1.900990099,1172,3003,662,216,215,1,83,1,0.041860465,0,empty,CD-0722-1
"E3,E11",9671,10828,7221,3607,5169,2588,0,2590,1686,904,1.865044248,1469,3941,1044,327,314,13,88,2,0.047770701,0,empty,CD-0722-1
"E3,E12",10543,11968,7882,4086,5755,2845,0,2846,1830,1016,1.801181102,1678,3419,822,324,322,2,87,2,0.173913043,0,empty,CD-0722-1
"E3,F1",12323,13607,9077,4530,6329,3125,0,3131,1957,1174,1.666950596,1766,2869,647,189,187,2,74,2,0.080213904,0,empty,CD-0722-1
"E3,F2",9779,10845,7350,3495,5162,2517,0,2521,1662,859,1.934807916,1409,4572,996,424,419,5,135,2,0.081145585,0,empty,CD-0722-1
"E3,F3",779216,907308,581125,326183,422224,228489,3,228723,173970,54753,3.177360145,136568,184690,28372,9390,9241,149,1613,9,0.077805432,0,hg38,CD-0722-1
"E3,F4",13979,14749,10490,4259,7084,3362,1,3372,2198,1174,1.872231687,1868,922,137,72,72,0,37,0,0,0,empty,CD-0722-1
"E3,F5",10722,11652,8194,3458,5629,2561,0,2565,1683,882,1.908163265,1407,3327,820,272,268,4,98,2,0.048507463,0,empty,CD-0722-1
"E3,F6",11371,12601,8491,4110,5965,3024,0,3026,1955,1071,1.825396825,1676,4151,829,284,283,1,119,1,0.03180212,0,empty,CD-0722-1
"E3,F7",13176,14498,10079,4419,7020,3460,0,3467,2249,1218,1.846469622,1952,1745,451,181,179,2,81,1,0.078212291,0,empty,CD-0722-1
"E3,F8",8303,9275,6362,2913,4459,2188,0,2188,1386,802,1.728179551,1242,381,69,33,33,0,19,0,0.03030303,0,empty,CD-0722-1
"E3,F9",307395,347642,234633,113009,161306,80359,1,80463,64804,15659,4.138450731,45785,27623,9262,2674,2646,28,532,2,0.072940287,0,hg38,CD-0722-1
"E3,F10",12300,13289,9424,3865,6259,2860,0,2865,1882,983,1.914547304,1533,2396,671,192,185,7,58,2,0,0,empty,CD-0722-1
"E3,F11",9627,10536,7275,3261,5033,2377,0,2380,1552,828,1.874396135,1311,2265,484,201,200,1,58,1,0.125,0,empty,CD-0722-1
"E3,F12",909363,1041871,680258,361613,473098,249101,3,249391,194537,54854,3.546450578,146429,4886,616,238,237,1,67,1,0.063291139,0,hg38,CD-0722-1
"E3,G1",11780,12775,8991,3784,6111,2901,0,2907,1919,988,1.942307692,1589,4237,965,400,395,5,173,2,0.025316456,0,empty,CD-0722-1
"E3,G2",6933,7578,4940,2638,3499,1788,1,1789,1125,664,1.694277108,1011,573,90,37,36,1,31,1,0,0,empty,CD-0722-1
"E3,G3",1752316,2105188,1276279,828909,962626,561346,4,561913,450030,111883,4.022326895,342760,344217,65011,21156,20831,325,2767,4,0.04901349,0,hg38,CD-0722-1
"E3,G4",845587,1008145,599286,408859,464643,291907,2,292170,220350,71820,3.068086884,173795,667,41,28,27,1,24,1,0,0,empty,CD-0722-1
"E3,G5",1533173,1809146,1141745,667401,826213,464239,1,464700,367452,97248,3.778504442,277357,174562,33425,10951,10781,170,1818,8,0.033855858,0,hg38,CD-0722-1
"E3,G6",11097,11909,8343,3566,5653,2758,0,2758,1881,877,2.144811859,1557,249,22,9,9,0,9,0,0.111111111,0,empty,CD-0722-1
"E3,G7",9512,10193,7363,2830,4895,2243,0,2249,1446,803,1.800747198,1191,3879,851,308,304,4,127,2,0.016447368,0,empty,CD-0722-1
"E3,G8",6814,7498,5088,2410,3588,1765,0,1768,1173,595,1.971428571,997,1891,380,161,159,2,71,1,0.201257862,0,empty,CD-0722-1
"E3,G9",797956,954190,589734,364456,441483,249865,6,250083,194418,55665,3.492643492,150941,242411,37649,12226,12003,223,1849,9,0.075647755,0,hg38,CD-0722-1
"E3,G10",9861,10731,7380,3351,5180,2563,0,2564,1691,873,1.936998855,1412,3650,1064,393,390,3,128,1,0.056410256,0,empty,CD-0722-1
"E3,G11",1478835,1646454,1140784,505670,751235,374620,3,375116,294945,80171,3.678948747,210350,133289,21460,6348,6199,149,1178,7,0.051782546,0,hg38,CD-0722-1
"E3,G12",7754,8849,5832,3017,4308,2182,0,2187,1387,800,1.73375,1236,2759,476,184,169,15,74,2,0.065088757,0,empty,CD-0722-1
"E3,H1",698176,806504,518842,287662,374660,201669,1,201885,161263,40622,3.969843927,119296,60985,9018,2993,2931,62,633,4,0.073694985,0,hg38,CD-0722-1
"E3,H2",10425,11513,7860,3653,5405,2631,0,2633,1698,935,1.816042781,1454,3183,729,267,262,5,86,2,0.099236641,0,empty,CD-0722-1
"E3,H3",7921,8674,5842,2832,4128,2024,0,2024,1250,774,1.61498708,1151,2302,455,154,153,1,63,1,0.091503268,0,empty,CD-0722-1
"E3,H4",11274,12400,8367,4033,5974,2903,0,2903,1901,1002,1.897205589,1639,577,88,46,46,0,24,0,0,0,empty,CD-0722-1
"E3,H5",12372,14097,9127,4970,6702,3395,0,3399,2125,1274,1.667974882,2034,2270,693,260,256,4,86,2,0.0078125,0,empty,CD-0722-1
"E3,H6",7830,8876,5787,3089,4215,2222,1,2227,1466,761,1.926412615,1325,2830,634,223,219,4,73,2,0.132420091,0,empty,CD-0722-1
"E3,H7",9252,9921,6905,3016,4895,2308,0,2314,1517,797,1.903387704,1299,3352,748,309,306,3,104,2,0.065359477,0,empty,CD-0722-1
"E3,H8",9934,10992,7447,3545,5147,2605,0,2619,1660,959,1.73096976,1468,3453,660,278,274,4,109,2,0.032846715,0,empty,CD-0722-1
"E3,H9",8300,8858,6407,2451,4171,1920,1,1923,1327,596,2.226510067,1002,2194,383,157,157,0,62,0,0.070063694,0,empty,CD-0722-1
"E3,H10",2153724,2583308,1596631,986677,1159450,672615,7,673368,543969,129399,4.203811467,405040,330524,52544,17157,16831,326,2497,9,0.066840948,0,hg38,CD-0722-1
"E3,H11",9029,10262,6217,4045,4983,3006,0,3008,1617,1391,1.162473041,1845,75,12,10,10,0,5,0,0,0,empty,CD-0722-1
"E3,H12",707615,789499,539571,249928,366981,183131,1,183361,145057,38304,3.786993525,104762,64712,7507,2489,2397,92,545,3,0.037546934,0,hg38,CD-0722-1
"E4,A1",8209,9347,5949,3398,4456,2343,0,2347,1511,836,1.807416268,1411,1255,345,128,128,0,43,0,0.0859375,0,empty,CD-0722-1
"E4,A2",12393,13637,9201,4436,6485,3317,0,3320,2100,1220,1.721311475,1843,2180,579,220,217,3,75,2,0.078341014,0,empty,CD-0722-1
"E4,A3",1437387,1776908,994419,782489,819362,542165,4,542643,394135,148508,2.65396477,336083,32433,9162,2898,2874,24,573,3,0.057759221,0,hg38,CD-0722-1
"E4,A4",12542,14296,9578,4718,6717,3368,0,3371,2209,1162,1.901032702,1911,794,155,62,62,0,27,0,0.048387097,0,empty,CD-0722-1
"E4,A5",11282,12435,8470,3965,5895,2846,8,2854,1795,1059,1.694995279,1560,2194,376,136,135,1,43,1,0.266666667,0,empty,CD-0722-1
"E4,A6",542057,634996,413847,221149,295180,154055,2,154221,117580,36641,3.208973554,90073,94603,12662,4232,4132,100,868,6,0.056631171,0,hg38,CD-0722-1
"E4,A7",8289,9516,6255,3261,4446,2320,3,2323,1465,858,1.707459207,1334,1300,272,140,138,2,55,1,0.014492754,0,empty,CD-0722-1
"E4,A8",4838,5129,3664,1465,2528,1211,0,1213,801,412,1.944174757,649,1709,322,140,140,0,66,0,0.085714286,0,empty,CD-0722-1
"E4,A9",8978,10162,6750,3412,4771,2337,0,2344,1539,805,1.911801242,1362,1892,490,163,162,1,57,1,0.055555556,0,empty,CD-0722-1
"E4,A10",1098499,1245664,842940,402724,572156,288461,5,288820,216314,72506,2.983394478,165105,45840,4969,1627,1575,52,354,3,0.076190476,0,hg38,CD-0722-1
"E4,A11",7792,8582,6031,2551,4197,1978,0,1980,1315,665,1.977443609,1077,1682,447,163,160,3,49,2,0.00625,0,empty,CD-0722-1
"E4,A12",10475,11633,7961,3672,5388,2615,0,2617,1709,908,1.88215859,1490,3163,705,234,233,1,80,1,0.128755365,0,empty,CD-0722-1
"E4,B1",8777,9866,6622,3244,4709,2378,0,2381,1508,873,1.727376861,1374,1213,305,94,94,0,45,0,0.20212766,0,empty,CD-0722-1
"E4,B2",10387,11913,7064,4849,5719,3238,0,3250,2043,1207,1.692626346,2027,692,147,55,55,0,26,0,0.218181818,0,empty,CD-0722-1
"E4,B3",1433888,1652478,1064138,588340,763997,420589,5,421071,354530,66541,5.327993267,249516,143312,16682,5828,5660,168,1092,7,0.051590106,0,hg38,CD-0722-1
"E4,B4",1719996,2060664,1258656,802008,933732,543624,5,544177,432726,111451,3.882656952,328697,220417,42297,14327,14154,173,2139,8,0.073124205,0,hg38,CD-0722-1
"E4,B5",8569,4628,2630,1998,3004,1684,0,1698,1081,617,1.752025932,1161,878,142,65,64,1,23,1,0.15625,0,empty,CD-0722-1
"E4,B6",10003,11257,7370,3887,5414,2854,0,2860,1758,1102,1.595281307,1640,1528,421,127,127,0,40,0,0.031496063,0,empty,CD-0722-1
"E4,B7",995146,1166650,744972,421678,531487,291453,1,291720,225672,66048,3.416787791,171413,70961,11985,3860,3782,78,810,4,0.040190375,0,hg38,CD-0722-1
"E4,B8",7110,7783,5402,2381,3724,1783,0,1785,1183,602,1.965116279,998,1414,335,144,143,1,50,1,0.034965035,0,empty,CD-0722-1
"E4,B9",12348,13270,9104,4166,6475,3383,0,3393,2077,1316,1.578267477,1916,969,275,113,113,0,38,0,0.168141593,0,empty,CD-0722-1
"E4,B10",6324,6683,4601,2082,3273,1589,0,1590,1019,571,1.784588441,847,467,62,29,29,0,14,0,0.137931034,0,empty,CD-0722-1
"E4,B11",13569,15436,10013,5423,7183,3915,0,3915,2219,1696,1.308372642,2241,254,63,36,36,0,12,0,0.083333333,0,empty,CD-0722-1
"E4,B12",8145,9163,6059,3104,4358,2223,0,2231,1495,736,2.03125,1296,1818,480,176,175,1,49,1,0.097142857,0,empty,CD-0722-1
"E4,C1",15182,16154,11588,4566,7492,3518,0,3522,2242,1280,1.7515625,1861,907,154,64,63,1,27,1,0.015873016,0,empty,CD-0722-1
"E4,C2",12651,13868,9397,4471,6496,3259,0,3262,2092,1170,1.788034188,1828,1785,335,135,130,5,50,1,0.007692308,0,empty,CD-0722-1
"E4,C3",15404,17703,11622,6081,8205,4102,0,4114,2760,1354,2.038404727,2340,612,157,74,74,0,25,0,0.027027027,0,empty,CD-0722-1
"E4,C4",8667,9383,6568,2815,4490,2094,0,2104,1329,775,1.71483871,1164,1828,341,124,122,2,50,2,0,0,empty,CD-0722-1
"E4,C5",12381,13837,9252,4585,6550,3265,0,3268,2155,1113,1.936208446,1896,1672,221,108,105,3,58,3,0.028571429,0,empty,CD-0722-1
"E4,C6",11476,12447,8488,3959,6099,2987,0,2992,1949,1043,1.86864813,1667,1729,299,113,112,1,54,1,0.080357143,0,empty,CD-0722-1
"E4,C7",14098,15994,10244,5750,7604,4181,0,4187,2493,1694,1.471664699,2500,562,124,42,42,0,20,0,0,0,empty,CD-0722-1
"E4,C8",15710,17181,11712,5469,8149,4106,0,4117,2709,1408,1.924005682,2286,2751,561,219,214,5,81,1,0.158878505,0,empty,CD-0722-1
"E4,C9",14943,17279,11158,6121,8025,4103,1,4111,2732,1379,1.981145758,2459,3904,644,211,208,3,70,1,0.086538462,0,empty,CD-0722-1
"E4,C10",1119866,1292415,842940,449475,581355,309534,3,309826,254031,55795,4.552934851,179816,120317,20175,6825,6735,90,1222,5,0.065478842,0,hg38,CD-0722-1
"E4,C11",1931143,2291507,1406580,884927,1042679,621853,2,622444,427785,194659,2.197612235,376989,62826,10853,3643,3573,70,700,3,0.076406381,0,hg38,CD-0722-1
"E4,C12",786532,851390,593920,257470,395801,213689,3,213907,141269,72638,1.944836036,110176,5209,1337,523,519,4,265,1,0.052023121,0,hg38,CD-0722-1
"E4,D1",13413,15030,9692,5338,7250,3928,0,3931,2492,1439,1.731758165,2335,857,186,70,70,0,23,0,0.028571429,0,empty,CD-0722-1
"E4,D2",10681,11748,8152,3596,5519,2568,0,2574,1592,982,1.621181263,1417,2413,569,215,212,3,92,2,0.066037736,0,empty,CD-0722-1
"E4,D3",10698,12297,7892,4405,5749,3006,3,3016,1959,1057,1.853358562,1768,1385,242,91,88,3,52,1,0.113636364,0,empty,CD-0722-1
"E4,D4",8115,8847,6071,2776,4362,2151,0,2154,1478,676,2.186390533,1242,1601,417,158,156,2,50,1,0.166666667,0,empty,CD-0722-1
"E4,D5",8694,9867,6492,3375,4719,2355,0,2357,1538,819,1.877899878,1361,1842,435,135,132,3,49,2,0.075757576,0,empty,CD-0722-1
"E4,D6",13011,14799,9300,5499,7064,3836,0,3842,2280,1562,1.459667093,2337,1835,518,180,180,0,58,0,0.077777778,0,empty,CD-0722-1
"E4,D7",7221,8045,5492,2553,3877,1874,0,1878,1198,680,1.761764706,1037,2264,550,194,192,2,69,2,0.078125,0,empty,CD-0722-1
"E4,D8",9926,11210,7392,3818,5283,2612,0,2620,1725,895,1.927374302,1510,1292,272,96,95,1,47,1,0.031578947,0,empty,CD-0722-1
"E4,D9",552750,647722,405155,242567,298918,166296,1,166512,132719,33793,3.927411002,99147,114144,22639,7533,7418,115,1233,5,0.057967107,0,hg38,CD-0722-1
"E4,D10",554901,582488,438563,143925,272779,115613,0,115753,88693,27060,3.277642276,61525,18513,3135,1001,975,26,245,3,0.018461538,0,hg38,CD-0722-1
"E4,D11",10436,11548,7830,3718,5544,2698,0,2702,1723,979,1.759959142,1559,2505,620,258,257,1,100,1,0.077821012,0,empty,CD-0722-1
"E4,D12",12256,13457,9039,4418,6243,3063,1,3071,2035,1036,1.964285714,1780,3083,711,262,257,5,106,2,0.035019455,0,empty,CD-0722-1
"E4,E1",949312,1087853,712801,375052,495432,264091,0,264375,207394,56981,3.639704463,154411,118836,17703,5392,5254,138,1025,5,0.042443852,0,hg38,CD-0722-1
"E4,E2",825880,977473,611982,365491,449897,249394,3,249683,198504,51179,3.878622091,150838,108200,9622,3235,3107,128,698,7,0.054393305,0,hg38,CD-0722-1
"E4,E3",7601,8538,5667,2871,4110,2031,0,2037,1312,725,1.809655172,1192,2278,521,171,168,3,60,2,0.029761905,0,empty,CD-0722-1
"E4,E4",10549,11744,7898,3846,5686,2773,1,2775,1835,940,1.95212766,1569,2567,529,199,195,4,78,1,0.107692308,0,empty,CD-0722-1
"E4,E5",9262,9921,7157,2764,4686,2187,0,2188,1413,775,1.823225806,1183,1376,355,113,113,0,44,0,0,0,empty,CD-0722-1
"E4,E6",15413,17136,11480,5656,8028,4004,0,4006,2563,1443,1.776160776,2271,3451,901,319,306,13,84,2,0.120915033,0,empty,CD-0722-1
"E4,E7",15863,17226,12036,5190,8047,3741,0,3741,2463,1278,1.927230047,2111,2524,620,222,220,2,65,2,0.1,0,empty,CD-0722-1
"E4,E8",12031,13122,9240,3882,6100,2745,0,2751,1811,940,1.926595745,1526,2798,686,247,245,2,51,1,0.126530612,0,empty,CD-0722-1
"E4,E9",8159,8978,6157,2821,4272,2133,0,2133,1406,727,1.933975241,1225,2678,613,247,242,5,71,2,0.123966942,0,empty,CD-0722-1
"E4,E10",788453,874514,606118,268396,402966,197982,2,198227,148840,49387,3.013748557,111948,114896,11002,3777,3617,160,819,6,0.029029583,0,hg38,CD-0722-1
"E4,E11",770082,936636,540564,396072,436299,284238,5,284506,195971,88535,2.213486192,172486,19393,1855,627,596,31,112,3,0.521812081,0,hg38,CD-0722-1
"E4,E12",12299,13838,9091,4747,6488,3257,0,3258,2153,1105,1.94841629,1844,2023,477,185,184,1,51,1,0.10326087,0,empty,CD-0722-1
"E4,F1",13426,14089,10024,4065,6582,3116,0,3120,1967,1153,1.705984389,1705,2112,466,192,192,0,55,0,0.005208333,0,empty,CD-0722-1
"E4,F2",844378,945115,645242,299873,435194,217437,1,217685,174315,43370,4.01925294,123992,66280,13561,4432,4373,59,857,6,0.030413903,0,hg38,CD-0722-1
"E4,F3",10543,11897,7795,4102,5508,2654,1,2665,1726,939,1.838125666,1542,3117,582,202,199,3,83,1,0.140703518,0,empty,CD-0722-1
"E4,F4",15274,16266,11261,5005,7698,3680,0,3685,2351,1334,1.762368816,2027,767,177,58,57,1,33,1,0.122807018,0,empty,CD-0722-1
"E4,F5",11855,12649,9037,3612,5958,2723,0,2730,1860,870,2.137931034,1455,2109,378,161,152,9,67,2,0.019736842,0,empty,CD-0722-1
"E4,F6",12553,13810,9189,4621,6633,3388,0,3388,2245,1143,1.964129484,1959,2789,688,220,213,7,76,2,0.093896714,0,empty,CD-0722-1
"E4,F7",977643,1163481,717700,445781,533490,306222,1,306530,246823,59707,4.133903897,184045,86674,12656,4269,4182,87,821,3,0.098278336,0,hg38,CD-0722-1
"E4,F8",695882,760605,549135,211470,354550,161454,1,161666,129400,32266,4.010413438,88480,4213,705,247,245,2,77,1,0.032653061,0,hg38,CD-0722-1
"E4,F9",10494,11776,8034,3742,5418,2560,0,2562,1713,849,2.017667845,1411,3050,680,226,225,1,69,1,0.164444444,0,empty,CD-0722-1
"E4,F10",13049,14163,9908,4255,6616,3142,0,3142,1997,1145,1.744104803,1728,1640,393,147,146,1,43,1,0.006849315,0,empty,CD-0722-1
"E4,F11",12789,14126,9866,4260,6616,3235,0,3238,2269,969,2.341589267,1801,1616,242,91,88,3,33,1,0.090909091,0,empty,CD-0722-1
"E4,F12",11503,12404,8470,3934,5911,2918,0,2920,1942,978,1.985685072,1696,226,21,12,11,1,9,1,0,0,empty,CD-0722-1
"E4,G1",1125346,1310261,846506,463755,594946,324535,6,324855,254749,70106,3.633768864,190454,162248,30611,10017,9836,181,1666,8,0.06547377,0,hg38,CD-0722-1
"E4,G2",7414,8251,5182,3069,3883,2049,0,2054,1287,767,1.677966102,1252,535,149,50,50,0,23,0,0.02,0,empty,CD-0722-1
"E4,G3",13416,14523,9832,4691,6869,3479,0,3484,2094,1390,1.50647482,1952,2441,617,220,217,3,91,2,0.032258065,0,empty,CD-0722-1
"E4,G4",24363,27750,17911,9839,13065,7211,0,7222,4485,2737,1.638655462,4148,201,15,11,10,1,8,1,0.1,0,empty,CD-0722-1
"E4,G5",8754,10005,6476,3529,4681,2380,0,2382,1544,838,1.8424821,1407,1636,338,118,117,1,50,1,0.025641026,0,empty,CD-0722-1
"E4,G6",11738,13335,8879,4456,6047,2984,0,2990,1936,1054,1.836812144,1693,148,11,9,9,0,6,0,0,0,empty,CD-0722-1
"E4,G7",15413,16253,11636,4617,7659,3693,0,3698,2593,1105,2.346606335,1980,2918,716,278,274,4,96,1,0.054744526,0,empty,CD-0722-1
"E4,G8",410917,536419,267394,269025,255797,186121,2,186246,118884,67362,1.764852588,120288,1851,431,170,166,4,63,3,0.192771084,0,hg38,CD-0722-1
"E4,G9",8601,9414,6473,2941,4503,2161,0,2165,1356,809,1.676143387,1223,2356,424,190,186,4,64,2,0.155913978,0,empty,CD-0722-1
"E4,G10",705554,874206,501063,373143,410117,255741,1,255940,197757,58183,3.398879398,159742,25220,12038,3671,3663,8,782,2,0.015015015,0,hg38,CD-0722-1
"E4,G11",10994,12122,8337,3785,5702,2707,0,2707,1736,971,1.78784758,1556,1287,257,103,98,5,37,2,0.030612245,0,empty,CD-0722-1
"E4,G12",9045,10176,6657,3519,4858,2448,0,2453,1535,918,1.67211329,1491,2226,499,177,173,4,58,1,0.040462428,0,empty,CD-0722-1
"E4,H1",9767,10764,7206,3558,5181,2527,0,2531,1675,856,1.956775701,1444,1120,281,101,101,0,27,0,0,0,empty,CD-0722-1
"E4,H2",10186,11410,7624,3786,5381,2665,0,2673,1687,986,1.710953347,1594,2120,427,127,119,8,48,2,0.042016807,0,empty,CD-0722-1
"E4,H3",8767,9609,6458,3151,4513,2235,0,2237,1427,810,1.761728395,1245,1244,288,108,107,1,41,1,0.028037383,0,empty,CD-0722-1
"E4,H4",12932,14015,9707,4308,6480,3138,0,3142,1979,1163,1.701633706,1758,148,28,18,18,0,11,0,0,0,empty,CD-0722-1
"E4,H5",13358,14557,9994,4563,6732,3308,0,3311,2155,1156,1.864186851,1843,1412,256,99,99,0,46,0,0.070707071,0,empty,CD-0722-1
"E4,H6",8098,9079,6085,2994,4218,2119,0,2122,1422,700,2.031428571,1195,1574,415,170,168,2,63,1,0.160714286,0,empty,CD-0722-1
"E4,H7",1343240,1585659,1000874,584785,726696,411469,29,412011,337884,74127,4.558177182,243636,200312,26867,8771,8586,185,1504,6,0.067085954,0,hg38,CD-0722-1
"E4,H8",755165,933732,519806,413926,431601,287566,2,287790,185728,102062,1.819756619,177780,2485,861,241,236,5,68,2,0.088983051,0,hg38,CD-0722-1
"E4,H9",8604,9378,6660,2718,4351,1942,0,1944,1247,697,1.789096126,1090,1043,228,61,61,0,21,0,0.049180328,0,empty,CD-0722-1
"E4,H10",7472,8301,5618,2683,3816,1866,0,1866,1244,622,2,1069,1158,197,73,72,1,36,1,0.097222222,0,empty,CD-0722-1
"E4,H11",10104,11724,7217,4507,5523,3284,0,3288,1898,1390,1.365467626,1938,132,4,2,2,0,2,0,0,0,empty,CD-0722-1
"E4,H12",648608,791152,444135,347017,369435,245394,2,245618,174977,70641,2.476989284,151810,4661,595,197,185,12,68,4,0.07027027,0,hg38,CD-0722-1
"E5,A1",7197,7834,5394,2440,3811,1960,0,1960,1341,619,2.166397415,1043,1271,230,88,88,0,41,0,0.045454545,0,empty,CD-0722-1
"E5,A2",11485,12732,8543,4189,6087,3112,0,3116,1930,1186,1.627318718,1772,2468,614,234,233,1,84,1,0.064377682,0,empty,CD-0722-1
"E5,A3",6356,7029,4666,2363,3433,1756,2,1762,1159,603,1.922056385,996,1173,230,81,80,1,32,1,0.05,0,empty,CD-0722-1
"E5,A4",10926,12138,8179,3959,5872,2899,0,2908,1885,1023,1.842619746,1642,1002,205,75,75,0,28,0,0.2,0,empty,CD-0722-1
"E5,A5",9895,10761,7427,3334,5418,2606,0,2606,1726,880,1.961363636,1492,2984,677,252,246,6,76,2,0.089430894,0,empty,CD-0722-1
"E5,A6",10315,11769,7809,3960,5880,3068,0,3070,2113,957,2.207941484,1750,4723,1276,464,456,8,145,2,0.111842105,0,empty,CD-0722-1
"E5,A7",7188,7946,5331,2615,3931,2027,0,2029,1319,710,1.857746479,1137,1586,317,128,127,1,46,1,0.094488189,0,empty,CD-0722-1
"E5,A8",4313,4916,3217,1699,2431,1195,1,1199,822,377,2.180371353,683,2283,527,196,194,2,69,2,0.06185567,0,empty,CD-0722-1
"E5,A9",1075383,1273551,802984,470567,603898,336088,2,336383,269764,66619,4.049355289,202441,69178,15988,4906,4845,61,977,3,0.042724458,0,hg38,CD-0722-1
"E5,A10",703735,837965,522033,315932,394100,223273,2,223488,182796,40692,4.492185196,132875,8375,1447,436,434,2,142,1,0.076036866,0,hg38,CD-0722-1
"E5,A11",1084559,1227388,849129,378259,575875,283528,4,283844,229225,54619,4.196799648,160360,216936,25993,8716,8460,256,1504,9,0.073877069,0,hg38,CD-0722-1
"E5,A12",9079,10147,6928,3219,4905,2363,0,2366,1571,795,1.976100629,1365,4317,846,317,311,6,98,2,0.022508039,0,empty,CD-0722-1
"E5,B1",7697,8554,5684,2870,4184,2181,1,2184,1406,778,1.807197943,1227,1472,298,106,106,0,35,0,0.226415094,0,empty,CD-0722-1
"E5,B2",7895,8832,5327,3505,4424,2469,0,2471,1518,953,1.592864638,1567,802,139,66,66,0,22,0,0.03030303,0,empty,CD-0722-1
"E5,B3",6461,7082,4821,2261,3515,1743,0,1748,1126,622,1.810289389,1000,1496,376,122,121,1,37,1,0.190082645,0,empty,CD-0722-1
"E5,B4",8167,9504,6052,3452,4715,2534,1,2540,1614,926,1.742980562,1536,2042,523,157,151,6,63,2,0.139072848,0,empty,CD-0722-1
"E5,B5",7110,3605,2126,1479,2448,1338,0,1355,885,470,1.882978723,894,1165,216,81,80,1,29,1,0.2125,0,empty,CD-0722-1
"E5,B6",8631,9554,6315,3239,4746,2526,0,2528,1558,970,1.606185567,1489,1813,415,138,138,0,41,0,0,0,empty,CD-0722-1
"E5,B7",7730,8683,5911,2772,4214,2042,0,2042,1341,701,1.912981455,1158,1459,405,103,100,3,35,1,0.13,0,empty,CD-0722-1
"E5,B8",534566,607193,408907,198286,287749,144522,3,144694,114307,30387,3.761707309,82915,123516,18320,6216,6128,88,1113,6,0.091873368,0,hg38,CD-0722-1
"E5,B9",10918,12095,8059,4036,5838,3062,1,3063,1962,1101,1.782016349,1711,1286,355,131,131,0,46,0,0.038167939,0,empty,CD-0722-1
"E5,B10",5923,6042,4024,2018,3196,1593,0,1603,1001,602,1.662790698,940,746,209,83,83,0,20,0,0,0,empty,CD-0722-1
"E5,B11",11535,12876,8358,4518,6246,3425,0,3425,1929,1496,1.289438503,1970,340,43,12,11,1,8,1,0,0,empty,CD-0722-1
"E5,B12",7291,8289,5492,2797,4000,1978,0,1979,1273,706,1.803116147,1164,1888,407,158,155,3,54,2,0,0,empty,CD-0722-1
"E5,C1",13179,14278,10090,4188,6783,3261,0,3263,2111,1152,1.832465278,1777,1592,418,139,138,1,41,1,0.02173913,0,empty,CD-0722-1
"E5,C2",10207,11332,7678,3654,5538,2742,0,2753,1748,1005,1.739303483,1591,2282,483,203,202,1,63,1,0.064356436,0,empty,CD-0722-1
"E5,C3",11755,12800,8826,3974,6353,3165,0,3180,2014,1166,1.727272727,1726,1210,236,88,86,2,37,2,0.023255814,0,empty,CD-0722-1
"E5,C4",10050,11285,7537,3748,5511,2722,0,2726,1995,731,2.729138167,1568,4237,832,272,271,1,79,1,0.121771218,0,empty,CD-0722-1
"E5,C5",12420,14047,9289,4758,6949,3574,0,3577,2512,1065,2.358685446,2084,2408,499,205,204,1,87,1,0.102941176,0,empty,CD-0722-1
"E5,C6",664928,728237,516016,212221,355102,164115,5,164350,127756,36594,3.491173416,90259,49821,11655,3614,3573,41,822,4,0.043101036,0,hg38,CD-0722-1
"E5,C7",525633,587868,404374,183494,287110,142365,3,142514,109926,32588,3.373204861,80026,4732,1628,528,526,2,133,1,0.024714829,0,hg38,CD-0722-1
"E5,C8",13758,15222,10170,5052,7391,3654,0,3656,2402,1254,1.915470494,2139,4090,1036,345,342,3,115,1,0.093567251,0,empty,CD-0722-1
"E5,C9",9497,10715,7135,3580,5228,2654,0,2665,1709,956,1.787656904,1531,2073,375,88,85,3,39,2,0.035294118,0,empty,CD-0722-1
"E5,C10",10589,11432,8071,3361,5595,2727,0,2729,1790,939,1.90628328,1498,2891,620,222,218,4,64,2,0.050458716,0,empty,CD-0722-1
"E5,C11",797578,970456,575129,395327,460716,271233,1,271482,225721,45761,4.932606368,167773,177196,34734,11575,11424,151,1800,6,0.068014706,0,hg38,CD-0722-1
"E5,C12",781808,857973,598892,259081,401086,195313,4,195553,150409,45144,3.331760588,110095,70140,12460,3902,3830,72,748,4,0.021409922,0,hg38,CD-0722-1
"E5,D1",11671,13241,8591,4650,6516,3481,0,3483,2135,1348,1.583827893,2063,1221,254,88,86,2,34,2,0.093023256,0,empty,CD-0722-1
"E5,D2",8891,9583,6859,2724,4777,2246,0,2250,1432,818,1.750611247,1208,3837,1081,346,341,5,108,3,0.076246334,0,empty,CD-0722-1
"E5,D3",9143,10128,6778,3350,5007,2510,0,2520,1671,849,1.96819788,1445,2168,461,149,147,2,65,1,0.136054422,0,empty,CD-0722-1
"E5,D4",6585,7528,4905,2623,3725,1919,0,1921,1241,680,1.825,1135,1627,300,129,128,1,49,1,0.109375,0,empty,CD-0722-1
"E5,D5",7952,8876,6033,2843,4369,2090,0,2100,1433,667,2.148425787,1208,2048,439,173,167,6,72,1,0.107784431,0,empty,CD-0722-1
"E5,D6",661611,785116,482039,303077,372224,211478,0,211682,173076,38606,4.483137336,128748,88714,17075,5486,5394,92,1040,5,0.029106415,0,hg38,CD-0722-1
"E5,D7",6507,7029,4940,2089,3372,1547,0,1552,1028,524,1.961832061,873,2163,494,213,208,5,64,2,0.057692308,0,empty,CD-0722-1
"E5,D8",8361,9208,6320,2888,4388,2116,0,2116,1328,788,1.685279188,1195,1962,531,185,185,0,46,0,0.064864865,0,empty,CD-0722-1
"E5,D9",395059,448703,299854,148849,214261,107196,1,107313,84593,22720,3.723283451,62504,182916,27510,9295,9109,186,1478,5,0.056208146,0,hg38,CD-0722-1
"E5,D10",8517,9736,6315,3421,4788,2515,0,2517,1704,813,2.095940959,1500,985,308,111,111,0,32,0,0.072072072,0,empty,CD-0722-1
"E5,D11",8968,9948,6742,3206,4980,2445,0,2454,1646,808,2.037128713,1404,3836,916,327,326,1,125,1,0.049079755,0,empty,CD-0722-1
"E5,D12",10779,12212,8187,4025,5916,2942,0,2942,1890,1052,1.796577947,1697,3641,722,234,231,3,96,2,0.077922078,0,empty,CD-0722-1
"E5,E1",14274,15631,10801,4830,7476,3662,0,3668,2393,1275,1.876862745,2005,4237,781,319,310,9,93,2,0.161290323,0,empty,CD-0722-1
"E5,E2",9805,11068,7254,3814,5392,2767,0,2770,1847,923,2.001083424,1643,2706,565,213,209,4,68,2,0.138755981,0,empty,CD-0722-1
"E5,E3",6795,7459,5198,2261,3624,1744,0,1749,1190,559,2.128801431,953,2736,729,275,270,5,89,1,0.07037037,0,empty,CD-0722-1
"E5,E4",9561,10681,7255,3426,5161,2507,0,2515,1609,906,1.77593819,1408,2836,677,260,258,2,100,2,0.050387597,0,empty,CD-0722-1
"E5,E5",7822,8535,6088,2447,4172,1915,0,1920,1231,689,1.786647315,1052,1926,549,171,171,0,54,0,0.035087719,0,empty,CD-0722-1
"E5,E6",13612,15177,10129,5048,7144,3606,0,3610,2266,1344,1.686011905,2065,3891,957,350,343,7,95,2,0.10787172,0,empty,CD-0722-1
"E5,E7",12954,14131,9704,4427,7021,3399,1,3415,2287,1128,2.02748227,1959,3315,606,211,208,3,77,2,0.177884615,0,empty,CD-0722-1
"E5,E8",10232,11113,7821,3292,5385,2492,2,2495,1689,806,2.095533499,1409,2944,748,262,252,10,67,2,0.051587302,0,empty,CD-0722-1
"E5,E9",7117,7920,5476,2444,3868,1882,5,1891,1263,628,2.011146497,1043,2803,724,239,237,2,80,2,0.016877637,0,empty,CD-0722-1
"E5,E10",7659,8399,5875,2524,4100,1974,0,1974,1350,624,2.163461538,1079,2302,597,242,240,2,77,2,0.016666667,0,empty,CD-0722-1
"E5,E11",9467,10414,6997,3417,4925,2509,0,2515,1632,883,1.848244621,1412,2789,722,204,203,1,76,1,0.019704433,0,empty,CD-0722-1
"E5,E12",10651,11836,7831,4005,5773,2921,1,2923,1961,962,2.038461538,1698,2632,504,194,189,5,74,2,0.042328042,0,empty,CD-0722-1
"E5,F1",11336,12256,8371,3885,5897,2872,0,2883,1849,1034,1.788201161,1649,3250,797,210,207,3,64,1,0.086956522,0,empty,CD-0722-1
"E5,F2",9602,10573,7105,3468,5210,2463,0,2471,1608,863,1.863267671,1460,3429,812,318,310,8,114,2,0.064516129,0,empty,CD-0722-1
"E5,F3",8773,9797,6540,3257,4750,2242,0,2247,1484,763,1.944954128,1289,2785,625,244,239,5,97,2,0.083682008,0,empty,CD-0722-1
"E5,F4",12466,13604,9307,4297,6858,3337,1,3353,2172,1181,1.83911939,1931,859,158,34,34,0,21,0,0,0,empty,CD-0722-1
"E5,F5",626202,672098,487611,184487,316768,145460,3,145625,109410,36215,3.021123844,79346,70164,13616,4526,4447,79,836,5,0.020013492,0,hg38,CD-0722-1
"E5,F6",11525,13143,8597,4546,6264,3255,1,3258,2131,1127,1.890860692,1862,4249,1237,429,424,5,116,2,0.047169811,0,empty,CD-0722-1
"E5,F7",12498,14197,9218,4979,6984,3605,0,3606,2418,1188,2.035353535,2098,1294,277,124,122,2,53,2,0.024590164,0,empty,CD-0722-1
"E5,F8",8299,9233,6256,2977,4470,2187,0,2189,1419,770,1.842857143,1250,200,24,14,13,1,10,1,0.076923077,0,empty,CD-0722-1
"E5,F9",8970,10003,6868,3135,4818,2321,0,2322,1493,829,1.800965018,1291,2980,571,225,221,4,71,1,0.018099548,0,empty,CD-0722-1
"E5,F10",11103,12302,8466,3836,5842,2745,0,2747,1764,983,1.794506612,1533,2002,436,153,153,0,52,0,0.111111111,0,empty,CD-0722-1
"E5,F11",9974,10707,7892,2815,5157,2317,3,2326,1580,746,2.117962466,1239,1988,378,132,130,2,54,1,0.038461538,0,empty,CD-0722-1
"E5,F12",10197,11430,7505,3925,5434,2740,0,2743,1815,928,1.955818966,1591,200,45,23,23,0,15,0,0.043478261,0,empty,CD-0722-1
"E5,G1",870807,1034330,645284,389046,484689,270394,4,270663,226123,44540,5.076852268,162183,233788,40749,13734,13489,245,2156,11,0.060716139,0,hg38,CD-0722-1
"E5,G2",6039,6829,4393,2436,3342,1771,0,1774,1124,650,1.729230769,1044,735,154,77,76,1,28,1,0.078947368,0,empty,CD-0722-1
"E5,G3",13087,14150,9661,4489,6889,3464,0,3466,2125,1341,1.58463833,1895,3416,913,285,280,5,97,2,0.046428571,0,empty,CD-0722-1
"E5,G4",1778794,2038456,1363475,674981,936353,495156,3,495672,406856,88816,4.580886327,284453,5311,732,264,258,6,65,2,0.065891473,0,hg38,CD-0722-1
"E5,G5",7484,8557,5603,2954,4156,2126,0,2129,1352,777,1.74002574,1242,1804,402,137,137,0,54,0,0.04379562,0,empty,CD-0722-1
"E5,G6",10162,10890,7717,3173,5289,2575,1,2580,1794,786,2.282442748,1366,138,16,12,12,0,10,0,0.083333333,0,empty,CD-0722-1
"E5,G7",8786,9763,6879,2884,4634,2125,0,2126,1396,730,1.912328767,1188,3512,747,261,250,11,83,1,0.12,0,empty,CD-0722-1
"E5,G8",6370,7069,4817,2252,3366,1587,0,1591,1021,570,1.79122807,895,2306,335,125,124,1,62,1,0.016129032,0,empty,CD-0722-1
"E5,G9",544493,625708,411525,214183,298687,153951,1,154150,117494,36656,3.205314273,90364,212857,23774,7807,7565,242,1410,9,0.052081956,0,hg38,CD-0722-1
"E5,G10",9627,10797,7213,3584,5183,2635,0,2635,1772,863,2.053302433,1492,3366,931,357,354,3,115,2,0.059322034,0,empty,CD-0722-1
"E5,G11",9628,10534,7402,3132,5150,2485,1,2490,1660,830,2,1364,1751,322,112,111,1,47,1,0.045045045,0,empty,CD-0722-1
"E5,G12",7535,8522,5552,2970,4035,2065,0,2067,1331,736,1.808423913,1208,2275,576,210,208,2,66,2,0.129807692,0,empty,CD-0722-1
"E5,H1",705888,835836,516036,319800,396026,223659,5,223864,179256,44608,4.018472023,135515,126206,20924,6733,6601,132,1255,4,0.063778215,0,hg38,CD-0722-1
"E5,H2",8464,9481,6343,3138,4628,2280,1,2285,1460,825,1.76969697,1330,3278,697,209,204,5,76,3,0.058823529,0,empty,CD-0722-1
"E5,H3",7661,8517,5625,2892,4114,2030,0,2032,1317,715,1.841958042,1162,1626,338,128,128,0,51,0,0,0,empty,CD-0722-1
"E5,H4",11170,12675,8287,4388,5922,2958,0,2961,1956,1005,1.946268657,1746,328,114,39,35,4,18,2,0,0,empty,CD-0722-1
"E5,H5",931601,1083441,695630,387811,502792,270326,4,270633,213007,57626,3.696369694,159520,219872,29330,9871,9632,239,1560,8,0.056582226,0,hg38,CD-0722-1
"E5,H6",7229,7943,5390,2553,3819,1873,0,1874,1253,621,2.017713366,1094,2102,596,192,187,5,51,2,0.122994652,0,empty,CD-0722-1
"E5,H7",8697,9511,6451,3060,4641,2290,0,2294,1534,760,2.018421053,1276,3299,795,235,233,2,75,2,0.163090129,0,empty,CD-0722-1
"E5,H8",9384,10578,6933,3645,5097,2621,0,2626,1691,935,1.80855615,1546,2868,749,240,237,3,72,1,0.071729958,0,empty,CD-0722-1
"E5,H9",7333,8186,5520,2666,3893,1883,0,1887,1245,642,1.939252336,1093,1375,265,108,107,1,34,1,0.121495327,0,empty,CD-0722-1
"E5,H10",7380,8566,5585,2981,4066,2061,0,2069,1431,638,2.242946708,1202,1581,323,104,101,3,37,1,0.099009901,0,empty,CD-0722-1
"E5,H11",8932,10144,6141,4003,5019,3029,0,3035,1624,1411,1.150956768,1838,113,12,7,7,0,6,0,0,0,empty,CD-0722-1
"E5,H12",8060,9044,5911,3133,4298,2295,0,2297,1525,772,1.975388601,1338,1914,336,141,139,2,45,1,0.028776978,0,empty,CD-0722-1
"E6,A1",5045,5671,3771,1900,2562,1269,0,1273,795,478,1.663179916,698,1129,275,84,83,1,33,1,0.192771084,0,empty,CD-0722-1
"E6,A2",7708,8558,5870,2688,4069,2077,0,2077,1347,730,1.845205479,1164,1746,357,122,118,4,40,1,0.194915254,0,empty,CD-0722-1
"E6,A3",4506,5289,3194,2095,2446,1313,0,1314,799,515,1.551456311,809,1494,374,90,87,3,30,1,0.218390805,0,empty,CD-0722-1
"E6,A4",597178,686189,457234,228955,309930,161254,0,161445,124681,36764,3.391388315,92496,45316,5106,1762,1701,61,433,4,0.051734274,0,hg38,CD-0722-1
"E6,A5",7097,7859,5284,2575,3677,1800,0,1800,1122,678,1.654867257,1040,1883,375,133,133,0,43,0,0.127819549,0,empty,CD-0722-1
"E6,A6",5411,6460,4072,2388,3024,1616,0,1619,1086,533,2.037523452,940,2215,578,199,197,2,72,2,0.162436548,0,empty,CD-0722-1
"E6,A7",5098,5545,3731,1814,2609,1362,0,1362,855,507,1.686390533,763,1219,322,96,96,0,33,0,0.03125,0,empty,CD-0722-1
"E6,A8",314670,375053,233995,141058,174271,96584,4,96685,79304,17381,4.56268339,57802,71246,12278,3941,3879,62,849,3,0.041763341,0,hg38,CD-0722-1
"E6,A9",5289,5798,4032,1766,2663,1243,0,1245,758,487,1.556468172,687,1687,377,107,102,5,38,1,0,0,empty,CD-0722-1
"E6,A10",6226,7019,4716,2303,3256,1664,0,1665,1031,634,1.626182965,939,331,33,25,24,1,13,1,0.125,0,empty,CD-0722-1
"E6,A11",4775,5337,3620,1717,2432,1157,0,1157,753,404,1.863861386,639,1467,353,137,134,3,61,2,0.02238806,0,empty,CD-0722-1
"E6,A12",6402,6937,4901,2036,3302,1525,0,1529,998,531,1.879472693,846,2882,465,181,177,4,49,3,0.146892655,0,empty,CD-0722-1
"E6,B1",5279,5781,3893,1888,2719,1346,0,1346,846,500,1.692,784,662,126,50,48,2,26,1,0,0,empty,CD-0722-1
"E6,B2",5812,6542,3995,2547,3022,1673,0,1675,995,680,1.463235294,1029,478,57,31,30,1,16,1,0.133333333,0,empty,CD-0722-1
"E6,B3",4403,4868,3249,1619,2271,1128,0,1131,726,405,1.792592593,632,997,152,57,56,1,30,1,0.321428571,0,empty,CD-0722-1
"E6,B4",5491,6090,3882,2208,2909,1579,0,1579,998,581,1.717728055,921,877,283,81,81,0,30,0,0.172839506,0,empty,CD-0722-1
"E6,B5",667203,354865,191071,163794,227309,140601,7,141574,105130,36444,2.884699813,94635,15890,3491,940,924,16,234,2,0.014069264,0,hg38,CD-0722-1
"E6,B6",5959,6555,4359,2196,3128,1647,0,1647,1005,642,1.565420561,926,1550,440,135,134,1,37,1,0.074626866,0,empty,CD-0722-1
"E6,B7",5560,6134,4139,1995,2924,1425,0,1425,955,470,2.031914894,826,719,204,69,68,1,20,1,0,0,empty,CD-0722-1
"E6,B8",4138,4760,3225,1535,2188,1069,0,1069,699,370,1.889189189,610,995,176,77,77,0,38,0,0.038961039,0,empty,CD-0722-1
"E6,B9",7759,8698,5577,3121,4033,2134,6,2147,1299,848,1.531839623,1259,878,220,77,76,1,31,1,0.223684211,0,empty,CD-0722-1
"E6,B10",440722,450383,300939,149444,218857,110792,22,111802,89371,22431,3.984262851,65499,17849,2064,702,683,19,159,2,0.064421669,0,hg38,CD-0722-1
"E6,B11",592487,677168,447469,229699,300134,156417,0,156590,120257,36333,3.309856054,91163,10554,1096,405,382,23,92,3,0.096858639,0,hg38,CD-0722-1
"E6,B12",4975,5664,3667,1997,2674,1405,0,1405,897,508,1.765748031,830,1568,310,106,106,0,35,0,0.103773585,0,empty,CD-0722-1
"E6,C1",9571,10330,7305,3025,4823,2308,0,2308,1466,842,1.741092637,1220,876,215,65,65,0,22,0,0.015384615,0,empty,CD-0722-1
"E6,C2",7839,8800,5787,3013,4021,2034,0,2038,1277,761,1.678055191,1150,2041,486,147,146,1,41,1,0.136986301,0,empty,CD-0722-1
"E6,C3",8027,8666,5969,2697,3997,1919,0,1924,1244,680,1.829411765,1028,698,157,58,58,0,24,0,0.017241379,0,empty,CD-0722-1
"E6,C4",5310,5590,4099,1491,2660,1171,0,1173,775,398,1.947236181,614,1253,242,84,83,1,35,1,0.036144578,0,empty,CD-0722-1
"E6,C5",7520,8635,5606,3029,3970,2014,0,2014,1327,687,1.931586608,1198,2127,538,158,155,3,53,2,0.04516129,0,empty,CD-0722-1
"E6,C6",6245,6883,4591,2292,3380,1708,0,1712,1099,613,1.792822186,1020,1544,295,125,124,1,50,1,0.072580645,0,empty,CD-0722-1
"E6,C7",9964,11772,7093,4679,5511,3066,0,3068,1715,1353,1.267553585,1941,1945,357,122,119,3,44,2,0.075630252,0,empty,CD-0722-1
"E6,C8",9511,10145,7111,3034,4785,2329,2,2333,1505,828,1.81763285,1246,2648,572,213,210,3,77,1,0.085714286,0,empty,CD-0722-1
"E6,C9",521259,642253,374356,267897,293155,174983,0,175112,138963,36149,3.84417273,108756,105327,18467,5906,5809,97,1024,4,0.047512481,0,hg38,CD-0722-1
"E6,C10",788501,960825,563542,397283,439939,270198,3,270472,219708,50764,4.328027736,166501,17643,5425,1648,1632,16,370,2,0.121936275,0,hg38,CD-0722-1
"E6,C11",6586,7328,4836,2492,3419,1659,0,1667,1035,632,1.637658228,989,1565,584,209,209,0,59,0,0.181818182,0,empty,CD-0722-1
"E6,C12",9387,10214,7002,3212,4754,2329,0,2342,1496,846,1.768321513,1311,1427,350,102,102,0,36,0,0.098039216,0,empty,CD-0722-1
"E6,D1",8301,9213,6178,3035,4271,2211,1,2216,1325,891,1.487093154,1267,1124,337,81,81,0,26,0,0.012345679,0,empty,CD-0722-1
"E6,D2",6689,7488,5063,2425,3426,1623,0,1631,985,646,1.524767802,945,2871,529,201,197,4,76,2,0.091370558,0,empty,CD-0722-1
"E6,D3",6219,7069,4664,2405,3255,1653,0,1657,1063,594,1.78956229,954,1488,237,82,76,6,41,2,0.013157895,0,empty,CD-0722-1
"E6,D4",4589,4915,3418,1497,2302,1104,0,1106,726,380,1.910526316,616,1429,384,147,143,4,47,2,0.020979021,0,empty,CD-0722-1
"E6,D5",1580461,1813752,1186688,627064,814031,440200,6,440700,367068,73632,4.985169492,257826,252300,34400,10870,10613,257,1844,8,0.066333742,0,hg38,CD-0722-1
"E6,D6",8157,9022,5908,3114,4270,2324,0,2329,1431,898,1.593541203,1363,1486,334,115,115,0,43,0,0.026086957,0,empty,CD-0722-1
"E6,D7",4498,4883,3412,1471,2299,1096,0,1096,714,382,1.869109948,611,1318,211,62,62,0,37,0,0.129032258,0,empty,CD-0722-1
"E6,D8",5745,6236,4236,2000,2855,1400,0,1402,887,515,1.722330097,774,1105,209,74,73,1,25,1,0,0,empty,CD-0722-1
"E6,D9",280531,310739,217253,93486,144544,68589,1,68657,53283,15374,3.465786393,38481,28189,6553,1836,1804,32,420,2,0.008314856,0,hg38,CD-0722-1
"E6,D10",5187,5783,3844,1939,2674,1383,0,1383,873,510,1.711764706,763,705,114,43,43,0,19,0,0.023255814,0,empty,CD-0722-1
"E6,D11",6212,7114,4663,2451,3263,1583,0,1583,1050,533,1.969981238,910,2289,487,200,199,1,75,1,0.040201005,0,empty,CD-0722-1
"E6,D12",696911,821120,520226,300894,367825,202662,4,202891,158553,44338,3.576007037,120845,237100,34647,11604,11358,246,1866,11,0.070082761,0,hg38,CD-0722-1
"E6,E1",9972,11120,7495,3625,5017,2485,1,2490,1491,999,1.492492492,1378,2499,457,173,167,6,65,1,0.125748503,0,empty,CD-0722-1
"E6,E2",6989,7816,5057,2759,3665,1882,0,1882,1179,703,1.677098151,1127,2092,425,143,142,1,46,1,0.014084507,0,empty,CD-0722-1
"E6,E3",4878,5433,3695,1738,2472,1192,1,1196,795,401,1.982543641,649,2028,525,154,153,1,50,1,0.013071895,0,empty,CD-0722-1
"E6,E4",1099909,1369525,780430,589095,616347,386757,4,387113,313581,73532,4.264551488,240644,123817,26029,8718,8585,133,1400,6,0.085614444,0,hg38,CD-0722-1
"E6,E5",5844,6299,4518,1781,2982,1354,0,1357,921,436,2.112385321,742,1398,308,100,98,2,40,1,0.051020408,0,empty,CD-0722-1
"E6,E6",9963,11068,7331,3737,4995,2498,0,2498,1580,918,1.721132898,1441,3071,748,274,267,7,80,2,0.071161049,0,empty,CD-0722-1
"E6,E7",9166,10201,7025,3176,4789,2245,0,2249,1436,813,1.766297663,1238,2566,812,268,268,0,75,0,0.048507463,0,empty,CD-0722-1
"E6,E8",553213,628371,421285,207086,283791,145326,0,145530,113864,31666,3.595780964,83036,205472,29980,9918,9684,234,1592,6,0.078273441,0,hg38,CD-0722-1
"E6,E9",4862,5536,3618,1918,2535,1276,0,1278,816,462,1.766233766,713,1861,366,155,147,8,59,1,0.013605442,0,empty,CD-0722-1
"E6,E10",5629,6291,4170,2121,2822,1316,0,1320,859,461,1.863340564,773,1692,425,139,138,1,49,1,0.014492754,0,empty,CD-0722-1
"E6,E11",6267,6740,4781,1959,3330,1628,0,1630,1049,581,1.805507745,919,1841,509,145,144,1,49,1,0.020833333,0,empty,CD-0722-1
"E6,E12",7606,8497,5601,2896,4065,2012,0,2018,1265,753,1.679946879,1185,1549,398,132,131,1,48,1,0.175572519,0,empty,CD-0722-1
"E6,F1",7800,8741,5715,3026,4154,2029,0,2031,1257,774,1.624031008,1230,1512,280,87,87,0,45,0,0.034482759,0,empty,CD-0722-1
"E6,F2",6410,6995,4761,2234,3277,1569,0,1569,1020,549,1.857923497,878,2299,519,188,183,5,76,1,0.081967213,0,empty,CD-0722-1
"E6,F3",6423,7059,4878,2181,3284,1514,0,1519,968,551,1.756805808,844,2460,690,257,255,2,69,1,0.11372549,0,empty,CD-0722-1
"E6,F4",9382,10494,6968,3526,4863,2390,0,2392,1522,870,1.749425287,1403,637,108,49,49,0,27,0,0,0,empty,CD-0722-1
"E6,F5",7412,8006,5638,2368,3713,1761,0,1768,1122,646,1.736842105,992,1888,496,149,148,1,49,1,0.040540541,0,empty,CD-0722-1
"E6,F6",7883,8653,5886,2767,3952,1985,0,1987,1241,746,1.663538874,1095,2417,580,224,223,1,70,1,0.170403587,0,empty,CD-0722-1
"E6,F7",8849,9956,6612,3344,4639,2370,0,2374,1483,891,1.664421998,1375,1032,196,83,83,0,37,0,0.048192771,0,empty,CD-0722-1
"E6,F8",6131,6618,4692,1926,3037,1458,0,1460,955,505,1.891089109,763,297,61,36,36,0,13,0,0.055555556,0,empty,CD-0722-1
"E6,F9",584688,695117,430350,264767,314002,178144,1,178333,142509,35824,3.978031487,106658,110556,21392,6679,6569,110,1259,6,0.06195768,0,hg38,CD-0722-1
"E6,F10",8263,8846,6445,2401,4157,1876,0,1878,1183,695,1.702158273,1037,1572,277,117,113,4,41,2,0.008849558,0,empty,CD-0722-1
"E6,F11",6452,6930,4998,1932,3337,1572,0,1578,1024,554,1.848375451,829,1136,229,80,79,1,32,1,0.164556962,0,empty,CD-0722-1
"E6,F12",7211,7763,5262,2501,3549,1730,0,1737,1165,572,2.036713287,977,102,21,17,17,0,7,0,0,0,empty,CD-0722-1
"E6,G1",7865,8655,5992,2663,4048,1933,0,1939,1235,704,1.754261364,1080,2072,605,207,207,0,83,0,0.057971014,0,empty,CD-0722-1
"E6,G2",4373,4674,3164,1510,2283,1150,0,1150,745,405,1.839506173,654,407,33,17,16,1,13,1,0.0625,0,empty,CD-0722-1
"E6,G3",8659,9396,6402,2994,4385,2173,0,2176,1301,875,1.486857143,1189,1700,380,136,131,5,65,2,0,0,empty,CD-0722-1
"E6,G4",14978,17213,10914,6299,7964,4458,0,4476,2662,1814,1.467475193,2609,186,31,24,24,0,14,0,0.041666667,0,empty,CD-0722-1
"E6,G5",5409,5897,4019,1878,2745,1305,0,1307,847,460,1.841304348,762,1289,273,113,112,1,49,1,0.008928571,0,empty,CD-0722-1
"E6,G6",7284,8124,5438,2686,3774,1872,3,1877,1219,658,1.852583587,1111,179,74,19,19,0,9,0,0,0,empty,CD-0722-1
"E6,G7",6150,6690,4812,1878,3197,1492,0,1496,997,499,1.997995992,805,2208,575,176,176,0,61,0,0.005681818,0,empty,CD-0722-1
"E6,G8",4538,4839,3412,1427,2310,1116,0,1121,709,412,1.720873786,631,1124,234,62,62,0,30,0,0.032258065,0,empty,CD-0722-1
"E6,G9",5402,5953,4035,1918,2668,1247,0,1247,794,453,1.752759382,693,2097,515,198,193,5,58,2,0.088082902,0,empty,CD-0722-1
"E6,G10",6663,7673,4932,2741,3713,1914,0,1915,1239,676,1.832840237,1185,2083,580,199,197,2,78,1,0.182741117,0,empty,CD-0722-1
"E6,G11",6781,7344,5122,2222,3464,1586,0,1589,1039,550,1.889090909,892,1393,520,165,164,1,49,1,0.237804878,0,empty,CD-0722-1
"E6,G12",5708,6766,4204,2562,3064,1573,1,1576,1030,546,1.886446886,939,2156,514,187,186,1,44,1,0.209677419,0,empty,CD-0722-1
"E6,H1",5791,6289,4252,2037,2998,1496,0,1499,979,520,1.882692308,866,1345,373,132,130,2,42,2,0.007692308,0,empty,CD-0722-1
"E6,H2",6281,7064,4672,2392,3196,1577,0,1579,990,589,1.680814941,905,2403,734,209,202,7,59,2,0.133663366,0,empty,CD-0722-1
"E6,H3",1203842,1379010,891617,487393,632467,346232,2,346639,257909,88730,2.906671926,204816,68820,12596,3824,3742,82,864,5,0.029396045,0,hg38,CD-0722-1
"E6,H4",7816,8965,5709,3256,4068,2033,0,2043,1318,725,1.817931034,1206,171,31,14,14,0,10,0,0.071428571,0,empty,CD-0722-1
"E6,H5",8499,9324,6305,3019,4197,2091,0,2104,1336,768,1.739583333,1202,1822,372,139,138,1,43,1,0.137681159,0,empty,CD-0722-1
"E6,H6",5164,5656,3730,1926,2592,1285,0,1290,856,434,1.97235023,741,1580,428,148,145,3,41,1,0.082758621,0,empty,CD-0722-1
"E6,H7",6305,6745,4752,1993,3046,1376,0,1381,830,551,1.506352087,752,1791,488,180,174,6,53,1,0.114942529,0,empty,CD-0722-1
"E6,H8",6767,7847,5053,2794,3513,1795,0,1799,1166,633,1.842022117,1057,1467,208,87,84,3,25,2,0.071428571,0,empty,CD-0722-1
"E6,H9",5461,6047,4113,1934,2712,1297,0,1298,880,418,2.105263158,763,997,230,66,65,1,19,1,0.123076923,0,empty,CD-0722-1
"E6,H10",4690,5253,3473,1780,2463,1248,0,1254,762,492,1.548780488,735,1008,211,59,59,0,28,0,0.016949153,0,empty,CD-0722-1
"E6,H11",6214,7356,4284,3072,3502,2172,0,2179,1178,1001,1.176823177,1337,87,34,18,18,0,7,0,0,0,empty,CD-0722-1
"E6,H12",5325,5846,3961,1885,2744,1380,5,1388,880,508,1.732283465,792,2823,580,178,174,4,59,2,0.028735632,0,empty,CD-0722-1
"E7,A1",7812,8695,5808,2887,4257,2224,0,2232,1426,806,1.769230769,1269,2198,539,164,162,2,65,2,0.067901235,0,empty,CD-0722-1
"E7,A2",1061644,1298218,737447,560771,600558,397660,3,398011,288774,109237,2.643554839,242435,12790,1799,634,623,11,194,2,0.11717496,0,hg38,CD-0722-1
"E7,A3",7032,7978,5180,2798,3777,1936,0,1941,1285,656,1.958841463,1155,1386,285,101,100,1,34,1,0.04,0,empty,CD-0722-1
"E7,A4",12125,13272,9150,4122,6477,3197,0,3200,1982,1218,1.6272578,1837,1284,200,117,114,3,48,1,0.035087719,0,empty,CD-0722-1
"E7,A5",549735,616735,417165,199570,287477,143791,1,143947,111721,32226,3.466796996,82330,276945,33168,11093,10819,274,1739,6,0.079397357,0,hg38,CD-0722-1
"E7,A6",1284327,1579875,947888,631987,726587,426251,3,426739,347882,78857,4.411555093,260074,308491,59427,19021,18774,247,2650,4,0.06903164,0,hg38,CD-0722-1
"E7,A7",7910,8915,5873,3042,4273,2188,0,2188,1366,822,1.661800487,1273,2284,446,158,156,2,55,1,0.025641026,0,empty,CD-0722-1
"E7,A8",1426914,1708566,1047631,660935,793577,461032,3,461507,363211,98296,3.695074062,276704,597563,91404,31221,30602,619,3619,14,0.068263512,0,hg38,CD-0722-1
"E7,A9",8404,9190,6359,2831,4533,2263,0,2263,1465,798,1.835839599,1239,2813,615,204,200,4,71,2,0.08,0,empty,CD-0722-1
"E7,A10",622962,789267,440141,349126,372142,247777,0,247947,168320,79627,2.113855853,152973,9340,420,158,146,12,56,3,0.239726027,0,hg38,CD-0722-1
"E7,A11",7432,8364,5647,2717,4047,1958,0,1961,1296,665,1.94887218,1113,2519,370,161,156,5,80,3,0.032051282,0,empty,CD-0722-1
"E7,A12",10432,11383,7880,3503,5289,2552,0,2553,1688,865,1.951445087,1437,4653,1033,345,341,4,120,2,0.046920821,0,empty,CD-0722-1
"E7,B1",8186,8896,6212,2684,4157,2047,0,2051,1276,775,1.646451613,1081,1536,413,165,165,0,57,0,0.048484848,0,empty,CD-0722-1
"E7,B2",605805,692018,421777,270241,328866,185617,1,185794,145254,40540,3.582979773,112867,38382,4560,1734,1695,39,409,5,0.086135693,0,hg38,CD-0722-1
"E7,B3",7603,8657,5390,3267,4129,2150,0,2153,1410,743,1.897711978,1289,1691,254,102,102,0,64,0,0.049019608,0,empty,CD-0722-1
"E7,B4",1517122,1801559,1118531,683028,825893,472990,3,473492,386113,87379,4.418830611,285242,214209,29941,10023,9783,240,1638,8,0.087192068,0,hg38,CD-0722-1
"E7,B5",796801,392702,215580,177122,259733,147041,24,148470,109065,39405,2.767795965,101032,83804,12478,4003,3921,82,748,3,0.057128284,0,hg38,CD-0722-1
"E7,B6",9980,11292,7256,4036,5491,2952,0,2958,1861,1097,1.69644485,1754,4252,1192,327,327,0,86,0,0.094801223,0,empty,CD-0722-1
"E7,B7",8494,9514,6567,2947,4684,2281,0,2285,1416,869,1.629459148,1332,1870,443,166,161,5,56,2,0.00621118,0,empty,CD-0722-1
"E7,B8",560653,641861,425420,216441,298221,154648,1,154813,117057,37756,3.10035491,89834,92246,12210,3954,3861,93,799,4,0.073297073,0,hg38,CD-0722-1
"E7,B9",12055,13409,9047,4362,6336,3326,0,3331,2099,1232,1.703733766,1897,1677,482,186,182,4,54,2,0.032967033,0,empty,CD-0722-1
"E7,B10",6082,6712,4336,2376,3295,1652,0,1661,1030,631,1.632329635,958,790,115,47,45,2,15,1,0.111111111,0,empty,CD-0722-1
"E7,B11",12927,14028,9387,4641,6636,3549,1,3550,2059,1491,1.380952381,2018,448,123,49,49,0,18,0,0.06122449,0,empty,CD-0722-1
"E7,B12",7611,8365,5639,2726,3990,2002,0,2002,1325,677,1.957163959,1123,2883,585,213,210,3,63,2,0.180952381,0,empty,CD-0722-1
"E7,C1",14581,15604,11298,4306,7451,3634,0,3642,2269,1373,1.652585579,1935,1476,342,146,143,3,58,2,0,0,empty,CD-0722-1
"E7,C2",11891,12884,8906,3978,5986,2984,0,2987,1943,1044,1.861111111,1616,2905,841,262,258,4,68,2,0.147286822,0,empty,CD-0722-1
"E7,C3",12781,14493,9540,4953,6818,3364,0,3365,2133,1232,1.731331169,1925,1400,277,131,128,3,48,2,0.125,0,empty,CD-0722-1
"E7,C4",8151,9030,6145,2885,4312,2024,1,2028,1315,713,1.844319776,1167,2671,482,175,175,0,64,0,0.142857143,0,empty,CD-0722-1
"E7,C5",14426,16460,10773,5687,7825,4043,0,4046,2720,1326,2.051282051,2306,3173,657,289,286,3,113,2,0.017482517,0,empty,CD-0722-1
"E7,C6",853066,997063,625654,371409,473107,267726,2,268017,222199,45818,4.849600594,159605,42316,8116,2431,2392,39,623,3,0.056856187,0,hg38,CD-0722-1
"E7,C7",803816,940097,600778,339319,433542,236849,0,237044,179249,57795,3.101462064,140652,35885,5133,1719,1682,37,413,3,0.049346017,0,hg38,CD-0722-1
"E7,C8",14652,16311,11015,5296,7718,3880,0,3887,2515,1372,1.833090379,2228,4373,878,361,360,1,138,1,0.063888889,0,empty,CD-0722-1
"E7,C9",10673,12106,8036,4070,5738,2833,0,2836,1907,929,2.052744887,1616,2085,414,159,158,1,55,1,0.101265823,0,empty,CD-0722-1
"E7,C10",11264,12534,8478,4056,6029,2982,0,2982,1892,1090,1.735779817,1729,2880,794,298,297,1,103,1,0.164983165,0,empty,CD-0722-1
"E7,C11",10087,11331,7483,3848,5450,2738,0,2741,1702,1039,1.638113571,1614,3094,848,273,273,0,93,0,0.054945055,0,empty,CD-0722-1
"E7,C12",14369,15524,10765,4759,7380,3551,0,3553,2332,1221,1.90990991,1950,2819,685,268,265,3,90,2,0.033962264,0,empty,CD-0722-1
"E7,D1",12582,14437,9321,5116,6836,3688,0,3697,2272,1425,1.594385965,2137,1204,241,95,95,0,39,0,0.084210526,0,empty,CD-0722-1
"E7,D2",830909,924615,640320,284295,424204,208011,4,208315,161613,46702,3.46051561,116794,285774,32171,10473,10185,288,1800,10,0.066077565,0,hg38,CD-0722-1
"E7,D3",609489,685107,459590,225517,321656,165122,1,165329,123869,41460,2.987674867,94993,47597,9186,2940,2878,62,592,4,0.033356498,0,hg38,CD-0722-1
"E7,D4",7276,8065,5475,2590,3947,1970,0,1973,1228,745,1.648322148,1138,2186,478,184,183,1,60,1,0.076502732,0,empty,CD-0722-1
"E7,D5",8767,9946,6564,3382,4669,2261,0,2261,1427,834,1.711031175,1304,2908,599,273,272,1,96,1,0.084558824,0,empty,CD-0722-1
"E7,D6",766316,905624,555677,349947,419556,239909,1,240148,199080,41068,4.847569884,145490,30440,7229,2313,2282,31,569,2,0.039000876,0,hg38,CD-0722-1
"E7,D7",7124,7933,5408,2525,3821,1873,0,1879,1182,697,1.695839311,1098,2904,683,220,213,7,73,2,0.051643192,0,empty,CD-0722-1
"E7,D8",9337,10489,7078,3411,5102,2557,0,2559,1774,785,2.259872611,1477,2172,465,183,181,2,77,2,0.011049724,0,empty,CD-0722-1
"E7,D9",5061,5718,3771,1947,2795,1375,0,1376,910,466,1.9527897,821,2804,720,268,266,2,91,1,0.082706767,0,empty,CD-0722-1
"E7,D10",9205,10462,6839,3623,4909,2567,0,2567,1750,817,2.141982864,1479,1149,219,68,68,0,26,0,0.205882353,0,empty,CD-0722-1
"E7,D11",1252936,1423844,955091,468753,650624,335700,6,336048,260056,75992,3.4221497,193312,208480,38113,11998,11825,173,1843,9,0.030697674,0,hg38,CD-0722-1
"E7,D12",11955,13467,8946,4521,6410,3202,2,3214,2140,1074,1.99255121,1856,4669,1296,441,438,3,148,1,0.043378995,0,empty,CD-0722-1
"E7,E1",15164,16543,11338,5205,7775,3719,0,3726,2417,1309,1.84644767,2099,4367,951,402,397,5,148,2,0.080604534,0,empty,CD-0722-1
"E7,E2",10632,11883,7808,4075,5728,2914,0,2918,1875,1043,1.797698945,1693,2946,855,231,229,2,81,2,0.043668122,0,empty,CD-0722-1
"E7,E3",7232,8148,5467,2681,3925,1959,0,1960,1255,705,1.780141844,1125,3633,782,302,300,2,115,1,0.05,0,empty,CD-0722-1
"E7,E4",734993,849591,551892,297699,395144,210938,5,211177,162734,48443,3.359288236,124517,206365,29017,9503,9301,202,1639,7,0.055800452,0,hg38,CD-0722-1
"E7,E5",8945,9821,6749,3072,4614,2210,0,2210,1437,773,1.858990944,1251,2303,616,212,212,0,63,0,0.103773585,0,empty,CD-0722-1
"E7,E6",14777,16588,11115,5473,7794,3942,0,3952,2412,1540,1.566233766,2226,4242,1032,363,355,8,107,2,0.022535211,0,empty,CD-0722-1
"E7,E7",575054,696846,400878,295968,324521,210894,2,211074,148529,62545,2.374754177,127717,12651,1717,557,547,10,183,3,0.067641682,0,hg38,CD-0722-1
"E7,E8",10894,11795,8338,3457,5633,2590,0,2591,1674,917,1.825517993,1409,3454,736,286,281,5,95,2,0.117437722,0,empty,CD-0722-1
"E7,E9",7594,8482,5702,2780,4057,1998,1,2003,1315,688,1.911337209,1147,3715,834,296,296,0,119,0,0.050675676,0,empty,CD-0722-1
"E7,E10",764575,899315,563654,335661,417547,233655,2,233897,185347,48550,3.817651905,140200,138190,24297,7868,7770,98,1375,5,0.053153153,0,hg38,CD-0722-1
"E7,E11",10063,11417,7407,4010,5458,2740,0,2742,1825,917,1.990185387,1614,3437,714,269,268,1,81,1,0.145522388,0,empty,CD-0722-1
"E7,E12",11281,12939,8307,4632,6084,3038,0,3047,2027,1020,1.987254902,1857,2642,346,151,147,4,75,2,0.027210884,0,empty,CD-0722-1
"E7,F1",12558,13481,9517,3964,6295,2951,0,2958,1818,1140,1.594736842,1619,2682,660,232,230,2,97,1,0.026086957,0,empty,CD-0722-1
"E7,F2",10348,11283,7751,3532,5472,2627,0,2639,1705,934,1.825481799,1481,4483,986,306,304,2,125,1,0.029605263,0,empty,CD-0722-1
"E7,F3",9454,10167,7098,3069,5013,2387,0,2393,1589,804,1.976368159,1324,4394,875,362,354,8,152,3,0.025423729,0,empty,CD-0722-1
"E7,F4",15065,16131,11205,4926,7597,3589,3,3601,2382,1219,1.954060705,2041,1200,86,63,62,1,35,1,0.064516129,0,empty,CD-0722-1
"E7,F5",11272,11989,8486,3503,5723,2634,0,2636,1668,968,1.723140496,1453,3366,1026,301,300,1,101,1,0.06,0,empty,CD-0722-1
"E7,F6",12188,13741,8924,4817,6655,3482,0,3493,2276,1217,1.870172555,2047,4709,1164,395,387,8,123,2,0.051679587,0,empty,CD-0722-1
"E7,F7",13931,15792,10712,5080,7583,3745,0,3748,2408,1340,1.797014925,2128,1811,504,195,192,3,59,2,0.083333333,0,empty,CD-0722-1
"E7,F8",10100,11119,7647,3472,5312,2670,0,2680,1865,815,2.288343558,1500,416,70,31,30,1,17,1,0.033333333,0,empty,CD-0722-1
"E7,F9",10321,11239,7982,3257,5170,2373,0,2378,1625,753,2.158034529,1296,4157,1158,335,331,4,97,1,0.033232628,0,empty,CD-0722-1
"E7,F10",13072,14476,10053,4423,6767,3249,0,3252,2095,1157,1.810717373,1788,2681,671,227,225,2,70,2,0.04,0,empty,CD-0722-1
"E7,F11",10421,11037,8059,2978,5351,2481,0,2490,1658,832,1.992788462,1327,2412,405,143,137,6,57,1,0.072992701,0,empty,CD-0722-1
"E7,F12",11022,12017,8185,3832,5698,2788,0,2798,1813,985,1.840609137,1610,258,27,14,13,1,13,1,0.076923077,0,empty,CD-0722-1
"E7,G1",12052,12922,9073,3849,6221,2974,0,2976,1978,998,1.981963928,1598,3731,850,320,316,4,140,2,0.060126582,0,empty,CD-0722-1
"E7,G2",6861,7638,4835,2803,3576,1831,0,1832,1173,659,1.779969651,1068,757,219,87,86,1,36,1,0.046511628,0,empty,CD-0722-1
"E7,G3",13321,14296,9986,4310,7069,3550,1,3556,2238,1318,1.698027314,1925,3458,672,264,261,3,112,1,0.14559387,0,empty,CD-0722-1
"E7,G4",23029,26694,16761,9933,12638,6952,1,6969,4224,2745,1.538797814,4112,338,46,28,28,0,22,0,0,0,empty,CD-0722-1
"E7,G5",8511,9358,6445,2913,4518,2263,1,2268,1431,837,1.709677419,1254,2864,711,273,273,0,97,0,0.120879121,0,empty,CD-0722-1
"E7,G6",2095651,2460710,1561451,899259,1101021,619517,5,620212,507831,112381,4.518833255,365497,24385,5287,1773,1760,13,366,2,0.069318182,0,hg38,CD-0722-1
"E7,G7",9954,10995,7499,3496,5296,2480,0,2485,1635,850,1.923529412,1390,3680,785,307,301,6,111,2,0.099667774,0,empty,CD-0722-1
"E7,G8",7080,8021,5333,2688,3730,1848,0,1857,1243,614,2.024429967,1046,2642,618,226,223,3,64,2,0.044843049,0,empty,CD-0722-1
"E7,G9",8783,9632,6531,3101,4638,2359,0,2364,1529,835,1.831137725,1369,3260,633,248,247,1,107,1,0.064777328,0,empty,CD-0722-1
"E7,G10",10161,11318,7550,3768,5519,2749,0,2752,1767,985,1.793908629,1582,2974,691,279,276,3,125,2,0.02173913,0,empty,CD-0722-1
"E7,G11",10406,11430,7731,3699,5445,2652,0,2654,1713,941,1.820403826,1506,2186,494,213,213,0,84,0,0.0657277,0,empty,CD-0722-1
"E7,G12",9051,9945,6717,3228,4860,2465,0,2470,1609,861,1.868757259,1436,3309,671,288,285,3,94,1,0.056140351,0,empty,CD-0722-1
"E7,H1",9109,10257,6624,3633,4823,2430,0,2433,1577,856,1.84228972,1441,2101,404,157,157,0,46,0,0.082802548,0,empty,CD-0722-1
"E7,H2",861072,977823,646086,331737,453801,238523,5,238816,193982,44834,4.326671722,138370,226014,34421,11173,10934,239,1797,6,0.045637461,0,hg38,CD-0722-1
"E7,H3",8288,9212,6189,3023,4305,2121,2,2123,1384,739,1.872801083,1197,2240,469,174,174,0,69,0,0.045977011,0,empty,CD-0722-1
"E7,H4",12331,13295,9197,4098,6274,3039,0,3045,1990,1055,1.886255924,1703,386,69,43,42,1,24,1,0.071428571,0,empty,CD-0722-1
"E7,H5",12151,13275,9088,4187,6218,3054,1,3060,1965,1095,1.794520548,1654,2211,512,198,196,2,63,1,0.270408163,0,empty,CD-0722-1
"E7,H6",7509,8292,5493,2799,3996,2086,0,2091,1414,677,2.088626292,1220,2677,723,200,198,2,67,1,0.075757576,0,empty,CD-0722-1
"E7,H7",9158,9965,6938,3027,4825,2299,1,2300,1435,865,1.658959538,1342,3010,774,267,265,2,92,1,0.128301887,0,empty,CD-0722-1
"E7,H8",9964,11077,7291,3786,5260,2771,0,2773,1759,1014,1.734714004,1603,2927,561,216,214,2,78,2,0.191588785,0,empty,CD-0722-1
"E7,H9",10114,11198,7650,3548,5308,2553,1,2559,1708,851,2.007050529,1476,1777,536,186,186,0,53,0,0,0,empty,CD-0722-1
"E7,H10",6965,7700,5315,2385,3673,1763,0,1765,1153,612,1.883986928,988,1964,537,156,154,2,57,1,0.045454545,0,empty,CD-0722-1
"E7,H11",9369,10913,6462,4451,5391,3271,0,3279,1804,1475,1.223050847,2041,90,6,5,5,0,4,0,0,0,empty,CD-0722-1
"E7,H12",2749076,3277280,1907736,1369544,1513268,1003312,10,1004263,683681,320582,2.132624414,611695,10186,2149,687,680,7,291,2,0.063235294,0,hg38,CD-0722-1
"E8,A1",8962,9864,6554,3310,4752,2384,0,2389,1585,804,1.971393035,1379,1767,497,182,179,3,48,2,0.027932961,0,empty,CD-0722-1
"E8,A2",14397,16106,10604,5502,7619,3886,0,3892,2517,1375,1.830545455,2242,2696,667,236,232,4,80,1,0.051724138,0,empty,CD-0722-1
"E8,A3",7546,8248,5636,2612,4014,1957,0,1961,1300,661,1.966717095,1079,1703,275,87,85,2,39,1,0.047058824,0,empty,CD-0722-1
"E8,A4",1147743,1315336,878949,436387,589250,304693,3,305016,242677,62339,3.892860007,175136,35430,5091,1549,1510,39,360,6,0.034437086,0,hg38,CD-0722-1
"E8,A5",12559,14223,9330,4893,6818,3453,0,3460,2179,1281,1.701014832,2051,2566,445,179,179,0,72,0,0.100558659,0,empty,CD-0722-1
"E8,A6",33352,38620,25383,13237,17617,8882,1,8894,6438,2456,2.621335505,5080,23760,4383,1553,1524,29,343,2,0.141076115,0,empty,CD-0722-1
"E8,A7",8972,10164,6631,3533,4855,2518,0,2520,1704,816,2.088235294,1474,2273,483,202,196,6,68,2,0.066326531,0,empty,CD-0722-1
"E8,A8",5767,6349,4396,1953,3104,1541,1,1545,1057,488,2.165983607,863,2515,526,178,175,3,79,2,0.051428571,0,empty,CD-0722-1
"E8,A9",1487869,1722528,1121024,601504,783878,427846,4,428322,358057,70265,5.095808724,247830,198411,34168,11417,11235,182,1780,7,0.07129506,0,hg38,CD-0722-1
"E8,A10",11041,12137,8316,3821,5838,2937,0,2939,1881,1058,1.777882798,1666,453,62,29,29,0,20,0,0.137931034,0,empty,CD-0722-1
"E8,A11",9203,10442,6965,3477,5027,2409,1,2412,1642,770,2.132467532,1412,2228,389,138,136,2,61,2,0.117647059,0,empty,CD-0722-1
"E8,A12",998410,1128135,760741,367394,506377,256945,1,257228,198172,59056,3.355662422,147361,219620,31803,10407,10164,243,1676,7,0.058736718,0,hg38,CD-0722-1
"E8,B1",9782,10858,7316,3542,5010,2556,0,2557,1679,878,1.912300683,1431,1570,454,150,148,2,49,1,0.155405405,0,empty,CD-0722-1
"E8,B2",9638,10362,6653,3709,4995,2658,0,2661,1718,943,1.821845175,1556,881,215,80,78,2,26,2,0.08974359,0,empty,CD-0722-1
"E8,B3",8470,9500,6163,3337,4512,2359,0,2365,1574,791,1.98988622,1415,2152,487,185,182,3,53,1,0.010989011,0,empty,CD-0722-1
"E8,B4",10717,11997,7838,4159,5774,3084,0,3089,1940,1149,1.688424717,1769,1841,452,147,146,1,68,1,0.068493151,0,empty,CD-0722-1
"E8,B5",8881,4890,2696,2194,3152,1803,0,1818,1152,666,1.72972973,1237,998,258,113,111,2,36,2,0.108108108,0,empty,CD-0722-1
"E8,B6",10625,11802,7783,4019,5714,3009,1,3016,1965,1051,1.869647954,1719,1870,469,174,172,2,47,1,0.093023256,0,empty,CD-0722-1
"E8,B7",9330,10301,7022,3279,4857,2366,0,2371,1549,822,1.884428224,1369,1536,477,145,144,1,38,1,0.041666667,0,empty,CD-0722-1
"E8,B8",7646,8634,5786,2848,4076,1998,0,1999,1335,664,2.010542169,1163,1582,440,156,155,1,50,1,0,0,empty,CD-0722-1
"E8,B9",1250072,1369118,958061,411057,622069,303612,3,303955,243811,60144,4.053787576,171074,47398,7292,2181,2134,47,506,5,0.037956888,0,hg38,CD-0722-1
"E8,B10",7170,7784,4999,2785,3926,2035,0,2047,1374,673,2.041604755,1231,496,117,34,34,0,18,0,0.088235294,0,empty,CD-0722-1
"E8,B11",14998,17114,10987,6127,7964,4338,0,4348,2398,1950,1.22974359,2584,209,40,26,26,0,20,0,0.038461538,0,empty,CD-0722-1
"E8,B12",8731,9608,6532,3076,4569,2267,0,2269,1497,772,1.939119171,1254,1943,298,119,114,5,44,1,0.096491228,0,empty,CD-0722-1
"E8,C1",733361,801843,562887,238956,367631,178360,3,178553,129615,48938,2.648555315,99573,33077,5164,1580,1543,37,363,3,0.036292936,0,hg38,CD-0722-1
"E8,C2",13038,14691,9477,5214,6953,3618,0,3621,2328,1293,1.800464037,2154,3278,789,251,251,0,100,0,0.083665339,0,empty,CD-0722-1
"E8,C3",996319,1198872,732622,466250,549140,316282,4,316572,243170,73402,3.312852511,192901,58361,6859,2341,2264,77,512,5,0.079063604,0,hg38,CD-0722-1
"E8,C4",904980,1022543,684979,337564,464309,239357,0,239671,185926,53745,3.459410178,138221,169567,25038,8128,7949,179,1409,7,0.087558183,0,hg38,CD-0722-1
"E8,C5",14535,16356,10852,5504,7880,4103,0,4109,2736,1373,1.992716679,2419,2814,574,195,189,6,75,1,0.148148148,0,empty,CD-0722-1
"E8,C6",949267,1090346,713997,376349,510595,268134,0,268473,205942,62531,3.293438455,157917,138849,22354,7598,7446,152,1281,5,0.073999463,0,hg38,CD-0722-1
"E8,C7",1229422,1423166,935662,487504,638783,331751,4,332153,261978,70175,3.733209833,193455,30144,4061,1373,1339,34,315,3,0.094100075,0,hg38,CD-0722-1
"E8,C8",17144,19400,12713,6687,9186,4691,0,4691,3067,1624,1.888546798,2717,3762,836,335,331,4,110,2,0.117824773,0,empty,CD-0722-1
"E8,C9",11898,13342,8823,4519,6270,3079,0,3085,1967,1118,1.759391771,1805,1917,447,173,172,1,68,1,0.058139535,0,empty,CD-0722-1
"E8,C10",12954,14325,9832,4493,6725,3303,0,3305,2197,1108,1.982851986,1800,2613,481,181,181,0,67,0,0.060773481,0,empty,CD-0722-1
"E8,C11",11402,12619,8424,4195,5976,2957,0,2966,1957,1009,1.939544103,1710,2446,617,203,202,1,62,1,0.103960396,0,empty,CD-0722-1
"E8,C12",16339,18038,12332,5706,8526,4095,0,4105,2753,1352,2.036242604,2363,2623,666,208,206,2,71,1,0.04368932,0,empty,CD-0722-1
"E8,D1",731397,934835,503838,430997,440583,286043,2,286303,222309,63994,3.473903803,184696,3755,1258,357,353,4,116,2,0.005665722,0,hg38,CD-0722-1
"E8,D2",10892,11903,8335,3568,5824,2781,0,2787,1754,1033,1.697967086,1580,4208,1247,415,400,15,119,2,0.0525,0,empty,CD-0722-1
"E8,D3",11500,13045,8346,4699,6209,3230,0,3236,2104,1132,1.858657244,1935,2148,295,125,120,5,60,2,0.025,0,empty,CD-0722-1
"E8,D4",8185,9163,5962,3201,4428,2257,0,2262,1501,761,1.972404731,1331,1828,448,162,154,8,51,1,0,0,empty,CD-0722-1
"E8,D5",10055,11475,7408,4067,5454,2797,0,2797,1926,871,2.211251435,1679,2328,534,197,190,7,84,2,0.031578947,0,empty,CD-0722-1
"E8,D6",13647,15013,9804,5209,7140,3836,2,3838,2306,1532,1.505221932,2249,2007,480,167,166,1,56,1,0.102409639,0,empty,CD-0722-1
"E8,D7",8263,9197,6203,2994,4312,2083,1,2086,1418,668,2.122754491,1185,2891,840,229,229,0,66,0,0.082969432,0,empty,CD-0722-1
"E8,D8",907613,1095775,665843,429932,502952,289094,2,289398,224233,65165,3.441003606,176840,93342,14161,4699,4624,75,966,3,0.063797578,0,hg38,CD-0722-1
"E8,D9",5994,6935,4525,2410,3196,1568,0,1568,1043,525,1.986666667,892,2492,625,212,208,4,75,2,0.048076923,0,empty,CD-0722-1
"E8,D10",8978,10246,6583,3663,4694,2341,1,2344,1533,811,1.89025894,1346,1361,338,131,130,1,48,1,0.076923077,0,empty,CD-0722-1
"E8,D11",12224,13653,9268,4385,6466,3146,0,3148,2123,1025,2.071219512,1760,3276,633,259,255,4,110,2,0.019607843,0,empty,CD-0722-1
"E8,D12",13624,15805,10162,5643,7135,3636,0,3637,2398,1239,1.9354318,2104,4837,1196,406,401,5,131,3,0.08478803,0,empty,CD-0722-1
"E8,E1",18311,19903,13551,6352,9373,4716,0,4724,3016,1708,1.765807963,2653,331210,19562,7250,6787,463,914,9,0.089435686,0,empty,CD-0722-1
"E8,E2",12278,13617,8970,4647,6541,3300,0,3304,2130,1174,1.814310051,1946,2159,425,158,156,2,67,1,0.025641026,0,empty,CD-0722-1
"E8,E3",8199,9252,6336,2916,4417,2144,0,2147,1435,712,2.015449438,1230,3211,846,270,269,1,87,1,0.074349442,0,empty,CD-0722-1
"E8,E4",11664,13119,8653,4466,6306,3088,0,3098,2043,1055,1.936492891,1810,3323,704,214,207,7,97,1,0.019323671,0,empty,CD-0722-1
"E8,E5",9445,10328,7179,3149,4916,2311,0,2317,1533,784,1.955357143,1285,1760,382,106,105,1,40,1,0.028571429,0,empty,CD-0722-1
"E8,E6",23160,25532,17371,8161,11784,5962,0,5975,4003,1972,2.029918864,3382,19087,3775,1130,1110,20,253,2,0.043243243,0,empty,CD-0722-1
"E8,E7",16788,18710,12646,6064,9043,4430,0,4434,2998,1436,2.087743733,2549,4524,1181,372,368,4,117,2,0.078804348,0,empty,CD-0722-1
"E8,E8",77142,93263,57256,36007,43155,25946,0,25989,20502,5487,3.736468015,15342,6779,950,330,320,10,101,2,0.096875,0,empty,CD-0722-1
"E8,E9",1339440,1576660,1011549,565111,719361,398130,6,398616,328852,69764,4.71377788,235364,259181,32790,11173,10922,251,1931,8,0.052737594,0,hg38,CD-0722-1
"E8,E10",9273,10037,6904,3133,4794,2197,0,2202,1427,775,1.841290323,1239,2950,651,218,214,4,60,3,0.046728972,0,empty,CD-0722-1
"E8,E11",11597,12689,8774,3915,6125,3054,0,3061,1961,1100,1.782727273,1711,2868,652,215,214,1,80,1,0.070093458,0,empty,CD-0722-1
"E8,E12",12779,14383,9460,4923,6941,3469,0,3475,2332,1143,2.040244969,2042,2548,376,168,166,2,65,2,0.102409639,0,empty,CD-0722-1
"E8,F1",14139,15281,10455,4826,7238,3454,0,3456,2196,1260,1.742857143,1939,3026,694,252,246,6,77,2,0.073170732,0,empty,CD-0722-1
"E8,F2",12944,14368,9623,4745,6899,3430,1,3434,2319,1115,2.079820628,1987,4555,832,316,312,4,134,1,0.051282051,0,empty,CD-0722-1
"E8,F3",11430,12782,8598,4184,6123,3015,0,3025,1999,1026,1.94834308,1720,3563,749,283,282,1,79,1,0.010638298,0,empty,CD-0722-1
"E8,F4",15587,17262,11621,5641,8256,3911,2,3921,2493,1428,1.745798319,2290,641,89,55,55,0,33,0,0.109090909,0,empty,CD-0722-1
"E8,F5",12313,13560,9217,4343,6431,3108,0,3114,2081,1033,2.014520813,1808,2322,596,230,227,3,80,2,0.070484581,0,empty,CD-0722-1
"E8,F6",14742,16302,10843,5459,7601,3871,0,3883,2566,1317,1.948367502,2199,4408,900,325,319,6,113,1,0.090909091,0,empty,CD-0722-1
"E8,F7",15483,17604,11522,6082,8388,4298,1,4306,2781,1525,1.823606557,2457,1645,353,119,119,0,50,0,0.109243697,0,empty,CD-0722-1
"E8,F8",25254,28578,19164,9414,13235,6283,0,6292,4441,1851,2.399243652,3645,1749,135,52,47,5,23,2,0.14893617,0,empty,CD-0722-1
"E8,F9",11151,12038,8469,3569,5690,2691,0,2691,1795,896,2.003348214,1455,3580,848,306,305,1,90,1,0.02295082,0,empty,CD-0722-1
"E8,F10",14367,15986,11106,4880,7522,3597,0,3604,2356,1248,1.887820513,2009,3051,698,189,186,3,58,2,0.016129032,0,empty,CD-0722-1
"E8,F11",1333618,1508029,1037240,470789,678403,346349,3,346768,278191,68577,4.056622483,195099,123678,11819,3943,3813,130,931,3,0.019931812,0,hg38,CD-0722-1
"E8,F12",12303,13651,9360,4291,6347,3040,0,3041,2002,1039,1.926852743,1706,259,21,9,9,0,8,0,0,0,empty,CD-0722-1
"E8,G1",13831,15426,10449,4977,7300,3588,0,3592,2389,1203,1.985868662,2034,3635,975,308,300,8,123,2,0.036666667,0,empty,CD-0722-1
"E8,G2",757220,897459,523283,374176,422131,263469,1,263708,201121,62587,3.21346286,159805,14287,4853,1482,1477,5,341,2,0.011509817,0,hg38,CD-0722-1
"E8,G3",14585,15920,10749,5171,7689,3921,0,3924,2440,1484,1.644204852,2211,3274,670,280,279,1,106,1,0.021505376,0,empty,CD-0722-1
"E8,G4",26106,29311,19127,10184,14060,7694,0,7704,4735,2969,1.594813068,4434,265,25,15,15,0,11,0,0.066666667,0,empty,CD-0722-1
"E8,G5",9368,10432,6799,3633,5006,2593,0,2596,1694,902,1.87804878,1522,2603,813,300,299,1,89,1,0.086956522,0,empty,CD-0722-1
"E8,G6",12337,13677,9379,4298,6426,3153,0,3155,2090,1065,1.962441315,1756,258,36,13,11,2,5,1,0.090909091,0,empty,CD-0722-1
"E8,G7",11412,12538,8757,3781,5926,2744,2,2747,1806,941,1.919234857,1504,3940,962,330,330,0,117,0,0.118181818,0,empty,CD-0722-1
"E8,G8",798107,937940,583902,354038,429308,242634,1,242874,187472,55402,3.383848959,146004,144789,16350,5452,5254,198,1121,7,0.02264941,0,hg38,CD-0722-1
"E8,G9",8999,10286,6796,3490,4855,2380,0,2380,1486,894,1.662192394,1365,2935,685,275,275,0,83,0,0.105454545,0,empty,CD-0722-1
"E8,G10",742153,835509,561591,273918,385807,199072,0,199298,152564,46734,3.264518338,113628,113169,16584,5392,5283,109,1041,5,0.028582245,0,hg38,CD-0722-1
"E8,G11",11854,13348,8998,4350,6281,3027,0,3034,2027,1007,2.012909633,1726,1867,375,147,144,3,67,2,0.055555556,0,empty,CD-0722-1
"E8,G12",9181,9940,6774,3166,4859,2437,0,2440,1591,849,1.873969376,1365,3119,777,228,226,2,70,2,0.115044248,0,empty,CD-0722-1
"E8,H1",10517,11515,7826,3689,5473,2675,0,2680,1782,898,1.9844098,1522,1464,390,144,143,1,36,1,0.13986014,0,empty,CD-0722-1
"E8,H2",10630,12164,7877,4287,5631,2854,0,2854,1862,992,1.877016129,1704,3054,720,286,282,4,91,2,0.067375887,0,empty,CD-0722-1
"E8,H3",9647,10767,7126,3641,5022,2484,0,2489,1584,905,1.750276243,1426,2122,348,129,127,2,61,1,0.039370079,0,empty,CD-0722-1
"E8,H4",13994,15815,10356,5459,7169,3587,0,3592,2423,1169,2.072711719,2126,308,91,23,23,0,13,0,0,0,empty,CD-0722-1
"E8,H5",13957,15253,10321,4932,7082,3532,0,3532,2288,1244,1.839228296,1980,2566,642,232,230,2,57,1,0.060869565,0,empty,CD-0722-1
"E8,H6",9336,10289,6967,3322,4901,2504,0,2504,1630,874,1.864988558,1407,2617,688,211,209,2,69,1,0.110047847,0,empty,CD-0722-1
"E8,H7",10965,11729,8255,3474,5584,2670,0,2671,1764,907,1.944873208,1449,2588,574,222,221,1,71,1,0.185520362,0,empty,CD-0722-1
"E8,H8",28890,33540,21814,11726,15848,8286,0,8293,6204,2089,2.96984203,4879,2660,625,211,211,0,68,0,0.061611374,0,empty,CD-0722-1
"E8,H9",9467,10788,7180,3608,5001,2407,0,2413,1625,788,2.062182741,1399,1620,441,134,134,0,46,0,0.029850746,0,empty,CD-0722-1
"E8,H10",8211,8945,6165,2780,4170,2081,0,2086,1398,688,2.031976744,1119,1522,291,126,123,3,43,2,0.081300813,0,empty,CD-0722-1
"E8,H11",11132,13134,7949,5185,6140,3680,0,3686,2069,1617,1.279529994,2258,73,12,6,6,0,5,0,0,0,empty,CD-0722-1
"E8,H12",10565,11654,7843,3811,5452,2738,0,2743,1828,915,1.997814208,1592,1991,385,151,151,0,57,0,0.039735099,0,empty,CD-0722-1
"E9,A1",7199,8030,5270,2760,3966,2091,0,2095,1353,742,1.823450135,1209,1216,347,117,109,8,30,2,0.23853211,0,empty,CD-0722-1
"E9,A2",10935,12103,8119,3984,5648,2884,0,2888,1814,1074,1.689013035,1656,1554,275,118,114,4,53,1,0.026315789,0,empty,CD-0722-1
"E9,A3",805427,922889,610203,312686,422551,217336,5,217545,172115,45430,3.788575831,126442,88813,10619,3641,3573,68,744,4,0.05513574,0,hg38,CD-0722-1
"E9,A4",11817,13073,8734,4339,6051,2976,0,2978,1908,1070,1.78317757,1647,831,162,53,53,0,19,0,0.018867925,0,empty,CD-0722-1
"E9,A5",10236,11192,7637,3555,5241,2534,0,2534,1638,896,1.828125,1399,2601,508,157,155,2,52,1,0.238709677,0,empty,CD-0722-1
"E9,A6",8572,9539,6411,3128,4659,2361,0,2367,1531,836,1.831339713,1357,2834,654,257,255,2,84,2,0.090196078,0,empty,CD-0722-1
"E9,A7",7110,7886,5335,2551,3786,1906,0,1908,1211,697,1.737446198,1099,1384,414,137,136,1,58,1,0.014705882,0,empty,CD-0722-1
"E9,A8",4346,4805,3246,1559,2280,1139,0,1140,756,384,1.96875,620,2024,416,147,142,5,50,2,0.225352113,0,empty,CD-0722-1
"E9,A9",621514,723780,468575,255205,332663,176063,2,176226,138200,38026,3.634355441,103479,96551,14248,4744,4645,99,894,5,0.069752422,0,hg38,CD-0722-1
"E9,A10",8838,9395,6847,2548,4457,2071,0,2073,1323,750,1.764,1077,412,87,31,31,0,19,0,0,0,empty,CD-0722-1
"E9,A11",472380,528145,369071,159074,251978,125283,0,125400,95049,30351,3.131659583,69790,3596,679,181,180,1,87,1,0.016666667,0,hg38,CD-0722-1
"E9,A12",9164,10122,6836,3286,4606,2189,0,2189,1431,758,1.887862797,1210,2866,767,233,228,5,70,3,0.074561404,0,empty,CD-0722-1
"E9,B1",7659,8499,5749,2750,4028,2064,0,2064,1289,775,1.663225806,1140,1180,320,113,113,0,29,0,0.061946903,0,empty,CD-0722-1
"E9,B2",8872,9494,6274,3220,4599,2373,0,2373,1468,905,1.622099448,1380,725,92,53,50,3,21,2,0.1,0,empty,CD-0722-1
"E9,B3",6698,7638,4863,2775,3545,1763,0,1766,1175,591,1.988155668,1049,1315,250,92,90,2,28,1,0,0,empty,CD-0722-1
"E9,B4",7926,9123,5714,3409,4289,2258,0,2258,1492,766,1.947780679,1395,1433,275,113,112,1,42,1,0.125,0,empty,CD-0722-1
"E9,B5",7620,4196,2468,1728,2709,1479,0,1485,949,536,1.770522388,958,870,248,79,79,0,19,0,0.139240506,0,empty,CD-0722-1
"E9,B6",8772,9663,6454,3209,4607,2412,0,2417,1504,913,1.647316539,1375,1606,400,118,117,1,38,1,0.145299145,0,empty,CD-0722-1
"E9,B7",8366,9414,6347,3067,4426,2164,0,2168,1421,747,1.90227577,1239,937,230,64,63,1,29,1,0.063492063,0,empty,CD-0722-1
"E9,B8",6046,6727,4622,2105,3077,1442,0,1445,919,526,1.747148289,822,1037,245,62,62,0,26,0,0.016129032,0,empty,CD-0722-1
"E9,B9",11130,12222,8196,4026,5737,2959,0,2962,1768,1194,1.480737018,1667,834,197,74,74,0,29,0,0.108108108,0,empty,CD-0722-1
"E9,B10",5774,6146,4077,2069,3058,1541,1,1547,991,556,1.782374101,914,630,201,60,57,3,16,2,0,0,empty,CD-0722-1
"E9,B11",12449,13904,9158,4746,6474,3485,0,3488,1967,1521,1.293228139,1960,136,17,11,11,0,10,0,0,0,empty,CD-0722-1
"E9,B12",7144,8120,5470,2650,3749,1859,0,1860,1182,678,1.743362832,1056,1892,571,166,165,1,38,1,0.212121212,0,empty,CD-0722-1
"E9,C1",14096,15104,10772,4332,6930,3305,1,3311,2141,1170,1.82991453,1780,920,332,90,90,0,28,0,0.022222222,0,empty,CD-0722-1
"E9,C2",11387,12305,8363,3942,5877,3027,0,3036,1971,1065,1.850704225,1718,1683,355,114,112,2,45,1,0.080357143,0,empty,CD-0722-1
"E9,C3",931568,1109453,696065,413388,505792,279137,2,279451,206022,73429,2.805730706,168429,25149,2929,965,947,18,229,3,0.083421331,0,hg38,CD-0722-1
"E9,C4",7863,8816,5961,2855,4103,1956,0,1966,1306,660,1.978787879,1148,1528,350,113,113,0,47,0,0.097345133,0,empty,CD-0722-1
"E9,C5",1356442,1669483,988179,681304,760146,459499,4,459891,374335,85556,4.375321427,282135,146432,31705,10468,10334,134,1690,4,0.072769499,0,hg38,CD-0722-1
"E9,C6",9235,10106,6806,3300,4859,2392,0,2404,1575,829,1.899879373,1332,1911,470,158,155,3,50,2,0.083870968,0,empty,CD-0722-1
"E9,C7",12514,14865,9037,5828,6924,3888,0,3895,2353,1542,1.525940337,2383,576,152,40,37,3,12,1,0.162162162,0,empty,CD-0722-1
"E9,C8",13785,15173,10268,4905,7147,3611,0,3612,2370,1242,1.90821256,2073,2913,595,240,234,6,79,2,0.222222222,0,empty,CD-0722-1
"E9,C9",9367,10925,7050,3875,5115,2619,0,2626,1721,905,1.901657459,1574,1664,347,165,163,2,47,2,0.024539877,0,empty,CD-0722-1
"E9,C10",11014,12199,8323,3876,5569,2777,2,2784,1678,1106,1.517179024,1548,1841,497,155,152,3,51,1,0.092105263,0,empty,CD-0722-1
"E9,C11",720407,837275,532475,304800,387001,211301,3,211531,164762,46769,3.522889093,126531,91876,17513,5660,5581,79,1049,3,0.0503494,0,hg38,CD-0722-1
"E9,C12",13725,14857,10055,4802,6952,3388,0,3392,2175,1217,1.787181594,1936,1945,522,180,178,2,49,1,0.033707865,0,empty,CD-0722-1
"E9,D1",12030,13579,8713,4866,6364,3389,0,3392,2090,1302,1.605222734,1991,903,158,56,56,0,26,0,0.053571429,0,empty,CD-0722-1
"E9,D2",10356,11375,7928,3447,5376,2534,0,2534,1674,860,1.946511628,1391,3410,1117,356,354,2,88,1,0.152542373,0,empty,CD-0722-1
"E9,D3",9127,9945,6740,3205,4790,2386,0,2394,1582,812,1.948275862,1355,1816,515,174,173,1,45,1,0.057803468,0,empty,CD-0722-1
"E9,D4",6712,7391,4996,2395,3539,1800,0,1802,1132,670,1.689552239,1027,1328,140,73,71,2,41,1,0.028169014,0,empty,CD-0722-1
"E9,D5",8217,9075,6133,2942,4350,2156,0,2156,1430,726,1.96969697,1205,2108,532,196,195,1,47,1,0.133333333,0,empty,CD-0722-1
"E9,D6",12068,13276,8688,4588,6274,3323,0,3325,2019,1306,1.545941807,1942,1978,605,163,162,1,46,1,0.141975309,0,empty,CD-0722-1
"E9,D7",6584,7165,4960,2205,3333,1547,0,1548,980,568,1.725352113,864,2188,376,147,142,5,55,2,0.056338028,0,empty,CD-0722-1
"E9,D8",7951,8541,6100,2441,4049,1882,0,1887,1190,697,1.707317073,1053,1408,368,140,139,1,49,1,0.021582734,0,empty,CD-0722-1
"E9,D9",4359,4683,3208,1475,2323,1107,0,1107,725,382,1.897905759,636,1556,333,110,108,2,51,1,0.083333333,0,empty,CD-0722-1
"E9,D10",7564,8181,5660,2521,3848,1854,0,1860,1163,697,1.668579627,1019,770,106,33,32,1,10,1,0,0,empty,CD-0722-1
"E9,D11",526856,577913,407888,170025,267609,126255,1,126383,97801,28582,3.421768945,70590,43245,9226,2792,2750,42,597,6,0.021090909,0,hg38,CD-0722-1
"E9,D12",11173,12297,8414,3883,5778,2895,1,2898,1842,1056,1.744318182,1634,3102,677,227,225,2,74,2,0.08,0,empty,CD-0722-1
"E9,E1",14030,15264,10429,4835,7191,3568,0,3571,2187,1384,1.580202312,2056,2403,417,158,153,5,71,3,0.006535948,0,empty,CD-0722-1
"E9,E2",703055,784105,537657,246448,364521,181108,2,181341,143847,37494,3.836533845,103004,45598,8111,2669,2619,50,564,5,0.035127911,0,hg38,CD-0722-1
"E9,E3",7040,7687,5313,2374,3667,1760,0,1764,1111,653,1.701378254,977,2780,685,228,224,4,68,2,0.075892857,0,empty,CD-0722-1
"E9,E4",9180,10118,6934,3184,4782,2277,3,2283,1504,779,1.930680359,1247,2481,518,199,197,2,74,2,0.065989848,0,empty,CD-0722-1
"E9,E5",637872,780479,446196,334283,362619,237405,1,237601,170022,67579,2.51589991,144400,3043,522,195,188,7,58,1,0.069148936,0,hg38,CD-0722-1
"E9,E6",1708900,1968488,1246751,721737,913531,552197,2,552675,388923,163752,2.375073282,318590,7783,2048,789,778,11,338,3,0.052699229,0,hg38,CD-0722-1
"E9,E7",13558,14675,10135,4540,7027,3359,1,3365,2149,1216,1.767269737,1919,2533,533,210,208,2,66,1,0.096153846,0,empty,CD-0722-1
"E9,E8",10776,12035,8221,3814,5444,2518,0,2519,1636,883,1.852774632,1388,2848,561,178,178,0,58,0,0.04494382,0,empty,CD-0722-1
"E9,E9",7105,7812,5369,2443,3694,1831,0,1832,1169,663,1.763197587,1015,2198,442,189,188,1,63,1,0.090425532,0,empty,CD-0722-1
"E9,E10",8172,8959,6117,2842,4172,1973,0,1979,1269,710,1.787323944,1116,2034,438,148,147,1,54,1,0.102040816,0,empty,CD-0722-1
"E9,E11",9263,10151,6976,3175,4777,2312,0,2314,1454,860,1.690697674,1316,2417,705,226,222,4,56,2,0.072072072,0,empty,CD-0722-1
"E9,E12",10298,11357,7614,3743,5234,2600,0,2606,1664,942,1.766454352,1497,1780,424,172,172,0,54,0,0.01744186,0,empty,CD-0722-1
"E9,F1",11926,13275,8793,4482,6192,3086,0,3091,1942,1149,1.690165361,1761,1887,516,157,155,2,52,2,0,0,empty,CD-0722-1
"E9,F2",10284,11364,7647,3717,5309,2586,0,2591,1681,910,1.847252747,1476,3300,893,247,246,1,104,1,0.024390244,0,empty,CD-0722-1
"E9,F3",9252,10053,6920,3133,4784,2277,1,2282,1454,828,1.756038647,1290,3029,713,240,233,7,78,2,0.094420601,0,empty,CD-0722-1
"E9,F4",13581,14686,10086,4600,6903,3299,2,3315,2128,1187,1.792754844,1894,539,156,66,66,0,23,0,0,0,empty,CD-0722-1
"E9,F5",10904,11666,8218,3448,5476,2598,0,2607,1729,878,1.969248292,1427,2113,756,263,262,1,59,1,0.133587786,0,empty,CD-0722-1
"E9,F6",10892,12139,7955,4184,5704,2948,0,2950,1917,1033,1.855759923,1720,2794,432,165,164,1,68,1,0.091463415,0,empty,CD-0722-1
"E9,F7",1396815,1746283,999387,746896,801732,527535,2,527952,370451,157501,2.352054908,324075,1817,509,153,151,2,43,2,0.463576159,0,hg38,CD-0722-1
"E9,F8",8456,9288,6467,2821,4290,2057,6,2065,1355,710,1.908450704,1105,266,73,19,19,0,7,0,0,0,empty,CD-0722-1
"E9,F9",9177,9735,7021,2714,4577,2091,0,2096,1310,786,1.666666667,1136,2725,685,229,226,3,60,1,0.097345133,0,empty,CD-0722-1
"E9,F10",12300,13176,9488,3688,6106,2800,0,2805,1825,980,1.862244898,1460,1755,522,158,158,0,54,0,0.050632911,0,empty,CD-0722-1
"E9,F11",9935,10847,7627,3220,5019,2348,0,2351,1569,782,2.006393862,1282,1440,221,104,102,2,38,2,0.166666667,0,empty,CD-0722-1
"E9,F12",12067,13594,8673,4921,6545,3598,0,3598,2375,1223,1.941946034,2150,142,21,11,10,1,9,1,0,0,empty,CD-0722-1
"E9,G1",896801,968528,704786,263742,440559,204666,1,204942,161770,43172,3.747104605,111251,230513,27698,9378,9103,275,1621,6,0.032846314,0,hg38,CD-0722-1
"E9,G2",6555,7366,4719,2647,3513,1825,0,1827,1153,674,1.710682493,1078,546,80,36,36,0,15,0,0.083333333,0,empty,CD-0722-1
"E9,G3",12692,13590,9359,4231,6551,3311,7,3327,2137,1190,1.795798319,1818,2586,572,169,167,2,60,2,0.161676647,0,empty,CD-0722-1
"E9,G4",21458,24211,15650,8561,11414,6278,0,6289,3721,2568,1.448987539,3635,124,38,20,20,0,8,0,0,0,empty,CD-0722-1
"E9,G5",7514,8231,5615,2616,3918,1960,0,1961,1253,708,1.769774011,1089,1548,496,191,190,1,58,1,0.1,0,empty,CD-0722-1
"E9,G6",10990,12044,8171,3873,5544,2704,0,2708,1796,912,1.969298246,1548,109,18,11,11,0,9,0,0.181818182,0,empty,CD-0722-1
"E9,G7",9277,10483,6969,3514,4800,2270,0,2271,1508,763,1.976408912,1290,2257,452,170,168,2,64,1,0.071428571,0,empty,CD-0722-1
"E9,G8",6414,6983,4754,2229,3344,1622,0,1622,1062,560,1.896428571,935,1553,352,113,112,1,38,1,0,0,empty,CD-0722-1
"E9,G9",14516,15381,10528,4853,7300,3641,0,3641,2758,883,3.123442809,2073,3632,968,312,308,4,80,2,0.146103896,0,empty,CD-0722-1
"E9,G10",9587,10296,7300,2996,4972,2448,0,2452,1582,870,1.818390805,1325,2355,485,161,160,1,65,1,0.06875,0,empty,CD-0722-1
"E9,G11",9541,10085,7420,2665,4858,2266,0,2269,1487,782,1.901534527,1207,1433,248,85,82,3,31,1,0.036585366,0,empty,CD-0722-1
"E9,G12",7819,8710,5845,2865,4177,2114,0,2116,1308,808,1.618811881,1236,1804,416,150,148,2,44,2,0.128378378,0,empty,CD-0722-1
"E9,H1",7828,8503,5905,2598,4066,1900,0,1904,1222,682,1.791788856,1064,1080,323,126,124,2,33,2,0.161290323,0,empty,CD-0722-1
"E9,H2",10237,11432,7637,3795,5445,2731,0,2731,1757,974,1.803901437,1613,2155,625,187,186,1,58,1,0.016129032,0,empty,CD-0722-1
"E9,H3",832530,975393,620288,355105,445412,243669,2,243911,191986,51925,3.697371208,145952,93316,13243,4368,4283,85,899,3,0.057202895,0,hg38,CD-0722-1
"E9,H4",11646,13056,8678,4378,5974,3044,0,3056,1933,1123,1.72128228,1742,202,62,14,14,0,3,0,0,0,empty,CD-0722-1
"E9,H5",11905,13028,8767,4261,6127,3090,0,3092,1992,1100,1.810909091,1789,1664,421,147,145,2,40,1,0.172413793,0,empty,CD-0722-1
"E9,H6",7180,8104,5305,2799,3720,1961,0,1964,1282,682,1.879765396,1129,1553,344,113,109,4,42,3,0.073394495,0,empty,CD-0722-1
"E9,H7",9083,10189,6728,3461,4752,2291,1,2296,1509,787,1.917407878,1352,2571,609,258,258,0,72,0,0.143410853,0,empty,CD-0722-1
"E9,H8",9513,11143,7005,4138,4936,2561,0,2562,1650,912,1.809210526,1495,2156,526,144,138,6,42,2,0.02173913,0,empty,CD-0722-1
"E9,H9",8040,8679,6052,2627,4130,1960,0,1961,1328,633,2.097946288,1071,1099,270,89,89,0,24,0,0.112359551,0,empty,CD-0722-1
"E9,H10",13780,15948,10736,5212,7414,3786,0,3790,2965,825,3.593939394,2129,1344,301,112,110,2,48,2,0.063636364,0,empty,CD-0722-1
"E9,H11",49911,57087,37208,19879,26385,13665,0,13675,10860,2815,3.857904085,8204,60,19,10,10,0,7,0,0,0,empty,CD-0722-1
"E9,H12",1051543,1238573,784344,454229,565145,313220,8,313579,258441,55138,4.687166745,186730,303411,45806,15739,15457,282,2257,9,0.065795432,0,hg38,CD-0722-1
"E10,A1",7474,8364,5414,2950,3996,2076,1,2077,1357,720,1.884722222,1138,1609,320,102,100,2,38,1,0.06,0,empty,CD-0722-1
"E10,A2",11631,13062,8749,4313,6316,3256,3,3265,2063,1202,1.716306156,1890,2237,672,269,269,0,102,0,0.037174721,0,empty,CD-0722-1
"E10,A3",6694,7298,4961,2337,3409,1682,0,1682,1116,566,1.971731449,955,2022,545,187,187,0,47,0,0.139037433,0,empty,CD-0722-1
"E10,A4",1505162,1751801,1154293,597508,783924,417785,3,418183,344211,73972,4.653260693,241446,133634,18668,6268,6117,151,1109,4,0.072257643,0,hg38,CD-0722-1
"E10,A5",10372,11722,7752,3970,5534,2723,0,2728,1769,959,1.844629823,1579,3589,776,259,254,5,74,2,0.078740157,0,empty,CD-0722-1
"E10,A6",9205,10570,6929,3641,5056,2685,0,2687,1776,911,1.949506037,1550,3649,907,305,301,4,102,3,0.063122924,0,empty,CD-0722-1
"E10,A7",7534,8417,5629,2788,4036,2088,0,2093,1360,733,1.855388813,1211,2095,440,174,166,8,74,2,0.084337349,0,empty,CD-0722-1
"E10,A8",403752,473267,305062,168205,222465,120473,2,120595,98168,22427,4.377223882,70725,147996,26776,8681,8546,135,1445,7,0.028551369,0,hg38,CD-0722-1
"E10,A9",9181,10232,6921,3311,4787,2431,0,2431,1605,826,1.943099274,1319,2250,633,205,203,2,74,2,0.172413793,0,empty,CD-0722-1
"E10,A10",9222,10122,7030,3092,4872,2402,0,2403,1503,900,1.67,1360,747,193,90,90,0,31,0,0.088888889,0,empty,CD-0722-1
"E10,A11",7442,8262,5595,2667,4005,1970,1,1977,1266,711,1.780590717,1112,2275,441,158,158,0,70,0,0.075949367,0,empty,CD-0722-1
"E10,A12",9884,10881,7618,3263,5018,2429,0,2435,1617,818,1.976772616,1352,4178,902,324,320,4,92,2,0.090625,0,empty,CD-0722-1
"E10,B1",8014,9011,5984,3027,4230,2152,0,2154,1322,832,1.588942308,1215,1838,399,137,136,1,53,1,0.014705882,0,empty,CD-0722-1
"E10,B2",7902,8519,5360,3159,4111,2181,1,2186,1333,853,1.562719812,1294,760,172,59,57,2,19,2,0.280701754,0,empty,CD-0722-1
"E10,B3",9985,11615,7403,4212,5497,2883,0,2885,2004,881,2.274687855,1690,1847,486,196,190,6,48,2,0.136842105,0,empty,CD-0722-1
"E10,B4",548673,623936,418379,205557,288932,144650,2,144801,112949,31852,3.546056763,84109,167826,18427,6100,5926,174,1100,6,0.091461357,0,hg38,CD-0722-1
"E10,B5",638110,332958,179816,153142,217261,127174,10,128149,99570,28579,3.484026733,86732,64500,8811,2765,2703,62,648,6,0.045874954,0,hg38,CD-0722-1
"E10,B6",8949,9938,6538,3400,4724,2503,0,2507,1519,988,1.537449393,1426,1754,512,148,147,1,50,1,0.136054422,0,empty,CD-0722-1
"E10,B7",7990,9151,6092,3059,4368,2140,0,2142,1411,731,1.930232558,1236,1425,306,111,111,0,45,0,0.054054054,0,empty,CD-0722-1
"E10,B8",6078,6622,4583,2039,3191,1502,0,1504,1005,499,2.014028056,863,1564,238,80,78,2,48,1,0.102564103,0,empty,CD-0722-1
"E10,B9",11432,12821,8391,4430,6161,3211,0,3215,1992,1223,1.628781684,1905,1439,240,102,100,2,49,2,0.13,0,empty,CD-0722-1
"E10,B10",5833,6290,4178,2112,3229,1640,1,1647,1042,605,1.72231405,974,651,190,57,57,0,26,0,0.01754386,0,empty,CD-0722-1
"E10,B11",12472,13867,8953,4914,6599,3593,1,3607,2051,1556,1.318123393,2112,269,51,33,33,0,18,0,0.121212121,0,empty,CD-0722-1
"E10,B12",747614,920327,536251,384076,426743,255301,1,255557,207650,47907,4.334439643,159578,64357,14417,4368,4306,62,861,3,0.091732466,0,hg38,CD-0722-1
"E10,C1",13077,13940,10035,3905,6576,3075,0,3087,1989,1098,1.81147541,1629,1423,413,142,140,2,49,2,0.05,0,empty,CD-0722-1
"E10,C2",11099,12201,8116,4085,5575,2773,1,2780,1782,998,1.785571142,1574,2850,678,228,223,5,65,2,0.040358744,0,empty,CD-0722-1
"E10,C3",13712,14959,10237,4722,7245,3551,0,3559,2365,1194,1.980737018,1910,1326,273,130,129,1,43,1,0.007751938,0,empty,CD-0722-1
"E10,C4",8125,9025,6150,2875,4205,1977,1,1980,1338,642,2.08411215,1112,2480,580,240,235,5,84,2,0.055319149,0,empty,CD-0722-1
"E10,C5",11614,13263,8674,4589,6278,3219,0,3228,2155,1073,2.008387698,1868,2678,568,208,205,3,93,1,0.034146341,0,empty,CD-0722-1
"E10,C6",2139404,2405726,1602916,802810,1106976,611587,6,612205,472162,140043,3.371550167,350499,191389,27001,8782,8544,238,1486,6,0.044241573,0,hg38,CD-0722-1
"E10,C7",542994,687168,375699,311469,318851,215030,3,215194,158298,56896,2.782234252,134199,1567,200,67,64,3,37,2,0.015625,0,empty,CD-0722-1
"E10,C8",14425,16198,10817,5381,7754,3922,1,3930,2515,1415,1.777385159,2268,4656,1035,366,365,1,110,1,0.010958904,0,empty,CD-0722-1
"E10,C9",9926,11117,7512,3605,5312,2602,0,2606,1667,939,1.775292865,1507,2124,483,171,168,3,62,2,0.077380952,0,empty,CD-0722-1
"E10,C10",10815,11917,8234,3683,5732,2829,0,2834,1847,987,1.871327254,1636,2464,538,195,193,2,66,2,0.025906736,0,empty,CD-0722-1
"E10,C11",9699,10300,7207,3093,4944,2393,0,2395,1556,839,1.854588796,1353,2544,494,182,178,4,76,2,0.050561798,0,empty,CD-0722-1
"E10,C12",2014055,2212124,1540355,671769,987418,495172,9,495764,404346,91418,4.42304579,278821,156193,28609,9028,8824,204,1424,5,0.02674524,0,hg38,CD-0722-1
"E10,D1",12064,13893,8775,5118,6623,3642,0,3647,2246,1401,1.603140614,2165,1319,294,112,111,1,37,1,0.189189189,0,empty,CD-0722-1
"E10,D2",9518,10058,7170,2888,4915,2288,1,2298,1471,827,1.778718259,1253,4597,1371,412,411,1,114,1,0.0486618,0,empty,CD-0722-1
"E10,D3",9796,10982,7177,3805,5239,2680,0,2684,1780,904,1.969026549,1624,2230,435,188,188,0,80,0,0.111702128,0,empty,CD-0722-1
"E10,D4",720914,882728,523290,359438,405050,237861,2,238081,191522,46559,4.113533366,146866,106543,20945,6947,6872,75,1154,4,0.083090803,0,hg38,CD-0722-1
"E10,D5",8534,9332,6399,2933,4377,2123,0,2126,1380,746,1.849865952,1201,2783,592,207,206,1,76,1,0.063106796,0,empty,CD-0722-1
"E10,D6",11476,12995,8381,4614,5968,3169,0,3175,1969,1206,1.632669983,1821,2632,579,220,219,1,67,1,0.01369863,0,empty,CD-0722-1
"E10,D7",6819,7250,5030,2220,3433,1624,3,1627,1106,521,2.122840691,927,2804,687,235,232,3,90,2,0.112068966,0,empty,CD-0722-1
"E10,D8",9177,10145,6702,3443,4965,2507,0,2508,1671,837,1.996415771,1458,1865,473,156,155,1,65,1,0.135483871,0,empty,CD-0722-1
"E10,D9",992768,1164202,748645,415557,529804,290158,1,290443,235373,55070,4.274069366,170593,252121,35052,11207,10954,253,1804,11,0.065090378,0,hg38,CD-0722-1
"E10,D10",8353,9352,6324,3028,4308,2217,1,2222,1464,758,1.931398417,1242,1033,253,106,101,5,27,1,0.198019802,0,empty,CD-0722-1
"E10,D11",9791,10526,7529,2997,5021,2346,0,2348,1597,751,2.126498003,1245,4485,1095,394,387,7,117,3,0.028423773,0,empty,CD-0722-1
"E10,D12",11240,12552,8588,3964,5964,2926,1,2931,1876,1055,1.778199052,1646,4731,1345,436,431,5,145,1,0.078886311,0,empty,CD-0722-1
"E10,E1",14859,16539,11118,5421,7795,3937,1,3944,2465,1479,1.666666667,2243,3710,676,279,270,9,100,3,0.02962963,0,empty,CD-0722-1
"E10,E2",10107,11388,7404,3984,5428,2712,0,2717,1759,958,1.83611691,1597,2686,733,280,275,5,68,2,0.072727273,0,empty,CD-0722-1
"E10,E3",6946,7701,5213,2488,3619,1765,0,1770,1161,609,1.906403941,1023,3113,781,264,262,2,102,2,0.095419847,0,empty,CD-0722-1
"E10,E4",9507,10280,7145,3135,4921,2345,0,2355,1572,783,2.007662835,1305,3102,623,236,234,2,107,2,0.081196581,0,empty,CD-0722-1
"E10,E5",7934,8660,6143,2517,4144,1933,0,1935,1247,688,1.8125,1085,2092,561,195,193,2,63,2,0.005181347,0,empty,CD-0722-1
"E10,E6",14153,15724,10515,5209,7374,3806,0,3810,2327,1483,1.569116655,2199,3991,1146,391,388,3,90,2,0.103092784,0,empty,CD-0722-1
"E10,E7",13780,15132,10278,4854,7119,3539,0,3543,2345,1198,1.957429048,1975,3911,1009,347,343,4,114,1,0.034985423,0,empty,CD-0722-1
"E10,E8",10450,11642,8076,3566,5435,2620,0,2620,1727,893,1.933930571,1464,3367,767,253,250,3,80,1,0.048,0,empty,CD-0722-1
"E10,E9",434898,485476,334602,150874,226398,111670,4,111817,87069,24748,3.518223695,63339,60838,12364,3927,3879,48,756,3,0.023975251,0,hg38,CD-0722-1
"E10,E10",7677,8534,5727,2807,4055,1971,0,1971,1268,703,1.803698435,1134,2545,562,190,189,1,72,1,0.095238095,0,empty,CD-0722-1
"E10,E11",9378,10846,7014,3832,5082,2624,0,2626,1669,957,1.743991641,1524,3447,773,289,284,5,80,2,0.211267606,0,empty,CD-0722-1
"E10,E12",693004,791620,525100,266520,367123,190199,2,190408,144636,45772,3.159923097,111034,92411,10228,3358,3217,141,757,6,0.04724899,0,hg38,CD-0722-1
"E10,F1",12130,13200,8969,4231,6258,3113,0,3117,2012,1105,1.82081448,1795,3213,841,327,322,5,88,2,0.040372671,0,empty,CD-0722-1
"E10,F2",724329,855983,527963,328020,392708,221731,3,221978,172990,48988,3.531272965,134252,157291,31008,10050,9911,139,1594,7,0.071133084,0,hg38,CD-0722-1
"E10,F3",1982938,2325492,1489751,835741,1048992,585610,2,586175,469979,116196,4.04470894,347901,442647,63464,20693,20214,479,2825,9,0.053527258,0,hg38,CD-0722-1
"E10,F4",13267,14535,9962,4573,6887,3361,0,3369,2163,1206,1.793532338,1895,1188,265,113,112,1,41,1,0.026785714,0,empty,CD-0722-1
"E10,F5",10495,11705,7916,3789,5362,2582,0,2586,1676,910,1.841758242,1491,2710,493,197,195,2,80,2,0.076923077,0,empty,CD-0722-1
"E10,F6",12055,13249,8915,4334,6274,3204,3,3209,2130,1079,1.974050046,1836,3752,916,347,342,5,116,1,0.119883041,0,empty,CD-0722-1
"E10,F7",12925,14255,9734,4521,6883,3527,3,3535,2349,1186,1.980607083,2025,1707,392,172,169,3,64,2,0.047337278,0,empty,CD-0722-1
"E10,F8",8208,8634,6204,2430,4091,1932,0,1934,1257,677,1.856720827,1061,309,49,30,30,0,13,0,0.366666667,0,empty,CD-0722-1
"E10,F9",9469,10507,7170,3337,4913,2294,0,2295,1473,822,1.791970803,1269,3912,936,279,270,9,97,2,0.044444444,0,empty,CD-0722-1
"E10,F10",11471,12724,8678,4046,6034,2879,0,2880,1909,971,1.966014418,1647,2507,815,198,198,0,63,0,0.151515152,0,empty,CD-0722-1
"E10,F11",10199,11132,7785,3347,5200,2447,0,2449,1652,797,2.072772898,1362,2722,678,221,217,4,60,2,0.101382488,0,empty,CD-0722-1
"E10,F12",10115,11465,7508,3957,5307,2660,0,2664,1714,950,1.804210526,1586,322,39,21,20,1,9,1,0,0,empty,CD-0722-1
"E10,G1",11359,12171,8740,3431,5871,2728,0,2736,1815,921,1.970684039,1492,3392,659,252,240,12,116,2,0.120833333,0,empty,CD-0722-1
"E10,G2",6599,7297,4701,2596,3451,1811,4,1817,1142,675,1.691851852,1072,565,102,47,47,0,22,0,0,0,empty,CD-0722-1
"E10,G3",12089,13274,8907,4367,6335,3215,0,3225,1994,1231,1.619821284,1743,3301,660,284,278,6,109,3,0.068345324,0,empty,CD-0722-1
"E10,G4",21700,24704,15631,9073,11803,6474,0,6486,3957,2529,1.564650059,3867,270,68,36,36,0,21,0,0,0,empty,CD-0722-1
"E10,G5",584564,711670,407930,303740,328783,213683,4,213920,159307,54613,2.917016095,130921,11062,1165,459,443,16,150,2,0.128668172,0,hg38,CD-0722-1
"E10,G6",10359,11388,7877,3511,5352,2647,0,2648,1734,914,1.897155361,1510,178,18,11,11,0,9,0,0.181818182,0,empty,CD-0722-1
"E10,G7",9580,10130,7404,2726,4820,2262,0,2262,1502,760,1.976315789,1207,3349,744,267,263,4,99,2,0.155893536,0,empty,CD-0722-1
"E10,G8",6435,6911,4808,2103,3351,1662,1,1663,1093,570,1.91754386,921,2104,554,199,197,2,59,1,0.197969543,0,empty,CD-0722-1
"E10,G9",8142,8826,6164,2662,4217,1980,0,1982,1313,669,1.962630792,1107,2868,463,184,181,3,82,1,0.093922652,0,empty,CD-0722-1
"E10,G10",10249,11591,7549,4042,5404,2776,1,2778,1776,1002,1.77245509,1630,3373,811,303,299,4,111,3,0.053511706,0,empty,CD-0722-1
"E10,G11",1290997,1505550,956374,549176,685501,381129,4,381525,298580,82945,3.599734764,226902,100235,14846,4629,4516,113,956,4,0.050708592,0,hg38,CD-0722-1
"E10,G12",7659,8606,5473,3133,4089,2114,1,2115,1369,746,1.835120643,1267,3137,693,275,271,4,86,2,0.088560886,0,empty,CD-0722-1
"E10,H1",752938,888636,551151,337485,408187,229507,3,229726,188375,41351,4.555512563,138709,92853,16884,5522,5434,88,1008,3,0.068641884,0,hg38,CD-0722-1
"E10,H2",11921,13312,8912,4400,6255,3097,0,3097,2137,960,2.226041667,1805,11354,1494,486,449,37,135,2,0.093541203,0,empty,CD-0722-1
"E10,H3",8286,9436,6138,3298,4415,2248,1,2253,1476,777,1.8996139,1355,2335,514,184,182,2,59,1,0.159340659,0,empty,CD-0722-1
"E10,H4",11297,12618,8372,4246,5930,2937,0,2941,1925,1016,1.894685039,1654,285,37,20,20,0,13,0,0,0,empty,CD-0722-1
"E10,H5",12217,13439,9037,4402,6270,3151,1,3156,1959,1197,1.636591479,1864,2247,618,215,212,3,65,1,0.075471698,0,empty,CD-0722-1
"E10,H6",7320,8299,5336,2963,4013,2123,0,2125,1397,728,1.918956044,1284,2459,668,215,214,1,65,1,0.056074766,0,empty,CD-0722-1
"E10,H7",9159,9835,6904,2931,4663,2236,1,2240,1515,725,2.089655172,1233,3192,842,279,276,3,94,2,0.115942029,0,empty,CD-0722-1
"E10,H8",16157,18275,12054,6221,8582,4395,0,4395,3006,1389,2.164146868,2583,2890,464,191,189,2,60,1,0.08994709,0,empty,CD-0722-1
"E10,H9",8048,8673,6159,2514,4082,1893,0,1895,1291,604,2.137417219,1042,1645,212,70,67,3,34,2,0.194029851,0,empty,CD-0722-1
"E10,H10",6914,7758,5195,2563,3557,1833,0,1835,1149,686,1.674927114,1024,1427,310,120,119,1,52,1,0.033613445,0,empty,CD-0722-1
"E10,H11",9191,10374,6467,3907,5021,2987,0,2990,1611,1379,1.168237854,1764,66,3,3,3,0,3,0,0,0,empty,CD-0722-1
"E10,H12",8423,9530,6178,3352,4509,2376,0,2378,1546,832,1.858173077,1387,1572,294,115,113,2,56,1,0.044247788,0,empty,CD-0722-1
"E11,A1",6155,6788,4521,2267,3344,1676,0,1682,1079,603,1.789386401,1026,1557,335,121,121,0,40,0,0.173553719,0,empty,CD-0722-1
"E11,A2",12286,13376,9274,4102,6234,3022,0,3030,1962,1068,1.837078652,1667,3945,680,231,231,0,71,0,0.142857143,0,empty,CD-0722-1
"E11,A3",5408,5703,4025,1678,2789,1329,0,1335,843,492,1.713414634,737,1127,340,121,117,4,35,3,0.034188034,0,empty,CD-0722-1
"E11,A4",9710,10500,7260,3240,5116,2515,0,2518,1655,863,1.917728853,1378,1087,130,48,47,1,26,1,0,0,empty,CD-0722-1
"E11,A5",8192,8939,6169,2770,4298,2106,0,2106,1364,742,1.838274933,1116,2673,523,198,189,9,60,2,0.037037037,0,empty,CD-0722-1
"E11,A6",12686,14363,9520,4843,6828,3514,0,3517,2440,1077,2.265552461,2009,2293,441,175,166,9,70,2,0.090361446,0,empty,CD-0722-1
"E11,A7",673712,804267,498289,305978,370901,209109,1,209332,163146,46186,3.532369116,125435,92690,23803,7815,7724,91,1335,6,0.055800104,0,hg38,CD-0722-1
"E11,A8",3631,3973,2711,1262,1970,956,0,956,691,265,2.60754717,556,1665,402,151,147,4,58,2,0.238095238,0,empty,CD-0722-1
"E11,A9",6094,6696,4674,2022,3249,1553,0,1556,1001,555,1.803603604,851,1928,589,210,209,1,49,1,0.172248804,0,empty,CD-0722-1
"E11,A10",7215,7996,5529,2467,3810,1870,0,1872,1126,746,1.509383378,1052,358,19,14,13,1,10,1,0.153846154,0,empty,CD-0722-1
"E11,A11",5466,5927,4259,1668,2948,1361,0,1364,927,437,2.121281465,759,1468,213,110,109,1,45,1,0.04587156,0,empty,CD-0722-1
"E11,A12",7648,8329,5810,2519,3873,1823,0,1826,1190,636,1.871069182,1008,3483,728,279,271,8,75,2,0.077490775,0,empty,CD-0722-1
"E11,B1",6096,6680,4544,2136,3229,1645,0,1648,989,659,1.500758725,897,1204,249,87,87,0,32,0,0.045977011,0,empty,CD-0722-1
"E11,B2",7307,7774,5170,2604,3800,2023,0,2023,1246,777,1.603603604,1168,691,109,46,44,2,20,1,0,0,empty,CD-0722-1
"E11,B3",5194,5822,3877,1945,2711,1341,0,1341,849,492,1.725609756,787,1638,214,92,85,7,31,2,0.058823529,0,empty,CD-0722-1
"E11,B4",6181,6947,4478,2469,3368,1792,0,1792,1090,702,1.552706553,1040,1336,339,142,142,0,52,0,0.049295775,0,empty,CD-0722-1
"E11,B5",6417,3532,2051,1481,2329,1275,0,1283,834,449,1.857461024,857,898,349,106,105,1,29,1,0.057142857,0,empty,CD-0722-1
"E11,B6",7473,8516,5423,3093,3923,2085,0,2085,1231,854,1.441451991,1222,1675,414,125,124,1,48,1,0,0,empty,CD-0722-1
"E11,B7",7208,8012,5509,2503,3725,1810,0,1813,1146,667,1.71814093,987,1397,365,114,113,1,28,1,0.274336283,0,empty,CD-0722-1
"E11,B8",1264453,1460581,949709,510872,673306,366729,1,367072,285422,81650,3.495676669,215452,155767,20451,6888,6708,180,1283,10,0.044573643,0,hg38,CD-0722-1
"E11,B9",9125,9892,6654,3238,4676,2364,0,2367,1553,814,1.907862408,1367,974,164,63,60,3,29,1,0,0,empty,CD-0722-1
"E11,B10",5260,5554,3748,1806,2793,1380,0,1381,940,441,2.131519274,801,525,72,37,37,0,17,0,0.027027027,0,empty,CD-0722-1
"E11,B11",10130,11175,7414,3761,5274,2861,0,2864,1657,1207,1.372825186,1656,286,64,34,34,0,16,0,0,0,empty,CD-0722-1
"E11,B12",6135,6992,4527,2465,3248,1638,0,1638,1068,570,1.873684211,935,1631,268,104,103,1,44,1,0.009708738,0,empty,CD-0722-1
"E11,C1",12134,13262,9125,4137,6161,3002,0,3008,1984,1024,1.9375,1657,1049,248,77,77,0,27,0,0.064935065,0,empty,CD-0722-1
"E11,C2",9896,11082,7209,3873,5086,2587,0,2593,1667,926,1.800215983,1499,2190,512,178,173,5,56,2,0.098265896,0,empty,CD-0722-1
"E11,C3",10124,11423,7585,3838,5407,2665,0,2668,1707,961,1.776274714,1537,1022,189,71,69,2,20,1,0.086956522,0,empty,CD-0722-1
"E11,C4",6492,7199,4826,2373,3457,1641,0,1646,1057,589,1.794567063,947,1795,285,106,104,2,49,1,0.038461538,0,empty,CD-0722-1
"E11,C5",9016,10047,6761,3286,4878,2402,0,2411,1541,870,1.771264368,1373,2158,360,146,144,2,58,1,0.027777778,0,empty,CD-0722-1
"E11,C6",8039,9155,5901,3254,4339,2251,0,2259,1464,795,1.841509434,1315,1645,404,153,153,0,60,0,0.14379085,0,empty,CD-0722-1
"E11,C7",10439,12057,7511,4546,5707,3177,0,3179,1917,1262,1.519017433,1907,579,104,48,48,0,19,0,0.041666667,0,empty,CD-0722-1
"E11,C8",587180,650750,458166,192584,301842,141218,0,141374,103835,37539,2.766056634,78777,220860,19424,6641,6364,277,1255,6,0.051382778,0,hg38,CD-0722-1
"E11,C9",7878,9000,5931,3069,4134,2086,8,2097,1340,757,1.77014531,1185,1467,267,113,113,0,36,0,0.221238938,0,empty,CD-0722-1
"E11,C10",9278,10267,6933,3334,4838,2382,0,2383,1538,845,1.820118343,1322,2238,541,215,213,2,59,1,0.107981221,0,empty,CD-0722-1
"E11,C11",7877,8642,5748,2894,4096,2047,0,2055,1279,776,1.648195876,1180,1981,472,178,177,1,52,1,0,0,empty,CD-0722-1
"E11,C12",11082,11878,8284,3594,5576,2707,1,2708,1776,932,1.905579399,1463,1945,420,144,144,0,52,0,0.020833333,0,empty,CD-0722-1
"E11,D1",10106,11334,7268,4066,5362,2865,1,2867,1722,1145,1.503930131,1727,966,158,41,41,0,21,0,0,0,empty,CD-0722-1
"E11,D2",607776,679470,471769,207701,313361,152050,3,152222,113755,38467,2.957210076,85197,134227,16257,5218,5059,159,1075,8,0.040324175,0,hg38,CD-0722-1
"E11,D3",7498,8077,5456,2621,3866,1966,0,1969,1305,664,1.965361446,1145,1738,397,141,141,0,49,0,0.092198582,0,empty,CD-0722-1
"E11,D4",6034,6585,4559,2026,3075,1540,0,1546,1034,512,2.01953125,833,1226,269,113,111,2,32,1,0.144144144,0,empty,CD-0722-1
"E11,D5",6816,7562,5154,2408,3637,1837,0,1838,1237,601,2.058236273,1054,2089,454,170,166,4,49,2,0.006024096,0,empty,CD-0722-1
"E11,D6",10145,11412,7357,4055,5332,2915,0,2919,1734,1185,1.463291139,1686,1731,386,125,122,3,40,2,0.155737705,0,empty,CD-0722-1
"E11,D7",5562,6068,4119,1949,2898,1419,0,1421,970,451,2.150776053,798,1782,352,148,144,4,46,1,0.284722222,0,empty,CD-0722-1
"E11,D8",6747,7508,5042,2466,3531,1776,0,1780,1141,639,1.785602504,1011,1073,226,109,109,0,38,0,0.036697248,0,empty,CD-0722-1
"E11,D9",3668,4025,2658,1367,1892,907,0,908,615,293,2.098976109,530,1782,442,149,146,3,60,2,0.02739726,0,empty,CD-0722-1
"E11,D10",6961,7951,5067,2884,3719,1955,0,1958,1226,732,1.674863388,1194,560,80,26,24,2,18,1,0.166666667,0,empty,CD-0722-1
"E11,D11",7652,8689,5633,3056,4066,2052,0,2056,1333,723,1.843706777,1210,3086,788,280,278,2,97,1,0.097122302,0,empty,CD-0722-1
"E11,D12",9525,10487,7028,3459,4833,2403,0,2405,1556,849,1.832744405,1350,3199,673,251,244,7,92,1,0.053278689,0,empty,CD-0722-1
"E11,E1",11734,12648,8801,3847,5964,2928,0,2935,1844,1091,1.690192484,1599,3141,891,260,256,4,89,2,0.02734375,0,empty,CD-0722-1
"E11,E2",8473,9441,6307,3134,4467,2247,0,2249,1429,820,1.742682927,1293,1920,584,203,202,1,57,1,0.064356436,0,empty,CD-0722-1
"E11,E3",5896,6590,4457,2133,3120,1482,1,1486,947,539,1.756957328,866,2238,683,243,240,3,71,2,0.104166667,0,empty,CD-0722-1
"E11,E4",8072,8820,5807,3013,4139,2104,2,2109,1311,798,1.642857143,1191,2522,529,210,208,2,74,2,0.081730769,0,empty,CD-0722-1
"E11,E5",6921,7678,5224,2454,3591,1670,0,1673,1060,613,1.729200653,954,1165,226,80,78,2,35,2,0.051282051,0,empty,CD-0722-1
"E11,E6",2096458,2378470,1586768,791702,1053058,572120,8,572762,426690,146072,2.921093707,327779,201344,29360,9735,9530,205,1641,7,0.048898216,0,hg38,CD-0722-1
"E11,E7",11022,12282,8177,4105,5767,2797,0,2802,1780,1022,1.741682975,1585,3480,939,302,300,2,84,2,0.053333333,0,empty,CD-0722-1
"E11,E8",8744,9601,6706,2895,4588,2175,0,2176,1413,763,1.851900393,1256,2623,710,269,268,1,70,1,0.070895522,0,empty,CD-0722-1
"E11,E9",5703,6359,4246,2113,3051,1488,0,1489,972,517,1.880077369,895,2348,452,167,166,1,65,1,0.024096386,0,empty,CD-0722-1
"E11,E10",6604,7315,4889,2426,3439,1669,0,1671,1086,585,1.856410256,979,1890,400,145,142,3,61,1,0.042253521,0,empty,CD-0722-1
"E11,E11",7905,8786,6028,2758,4229,2093,0,2093,1341,752,1.783244681,1128,1958,406,157,153,4,51,2,0.026143791,0,empty,CD-0722-1
"E11,E12",8323,9238,6117,3121,4478,2284,0,2290,1454,836,1.73923445,1345,1647,340,129,126,3,54,2,0.103174603,0,empty,CD-0722-1
"E11,F1",716420,836144,529117,307027,382804,211541,3,211764,169088,42676,3.962133283,125859,53959,7914,2494,2430,64,607,6,0.018106996,0,hg38,CD-0722-1
"E11,F2",8131,8980,5921,3059,4292,2076,1,2084,1341,743,1.804845222,1196,3095,875,290,285,5,90,1,0.140350877,0,empty,CD-0722-1
"E11,F3",7576,8214,5768,2446,3967,1879,0,1886,1195,691,1.729377713,1045,2723,714,263,259,4,71,2,0.127413127,0,empty,CD-0722-1
"E11,F4",11465,12118,8548,3570,5770,2691,3,2696,1735,961,1.80541103,1527,561,112,50,50,0,29,0,0.08,0,empty,CD-0722-1
"E11,F5",8907,9717,6627,3090,4654,2238,0,2239,1430,809,1.767614339,1280,2254,430,147,147,0,57,0,0.034013605,0,empty,CD-0722-1
"E11,F6",9497,10471,6972,3499,4942,2566,0,2572,1673,899,1.860956618,1499,3590,778,263,261,2,72,2,0.137931034,0,empty,CD-0722-1
"E11,F7",52582,59547,40882,18665,27413,13566,1,13586,9810,3776,2.597987288,7517,4076,647,260,254,6,69,2,0.07480315,0,empty,CD-0722-1
"E11,F8",7394,8154,5699,2455,3712,1773,0,1775,1218,557,2.186714542,951,203,18,8,8,0,5,0,0,0,empty,CD-0722-1
"E11,F9",7821,8623,5937,2686,4084,1948,0,1949,1296,653,1.984686064,1090,3181,852,293,290,3,100,1,0.106896552,0,empty,CD-0722-1
"E11,F10",10347,11271,7828,3443,5237,2485,3,2492,1641,851,1.928319624,1386,1572,274,102,102,0,37,0,0.009803922,0,empty,CD-0722-1
"E11,F11",7997,8595,6058,2537,4056,1862,0,1870,1185,685,1.729927007,1025,1696,341,135,131,4,46,1,0.145038168,0,empty,CD-0722-1
"E11,F12",8964,9767,6553,3214,4596,2269,0,2271,1534,737,2.081411126,1308,130,32,21,21,0,11,0,0,0,empty,CD-0722-1
"E11,G1",10084,10869,7558,3311,5123,2453,0,2457,1652,805,2.052173913,1335,2899,618,279,274,5,92,2,0.02919708,0,empty,CD-0722-1
"E11,G2",5506,5894,3863,2031,2808,1439,0,1442,921,521,1.767754319,860,488,90,39,38,1,16,1,0.131578947,0,empty,CD-0722-1
"E11,G3",1312081,1598896,969992,628904,723643,421270,5,421679,352564,69115,5.10112132,256313,297449,46161,15290,14964,326,2251,8,0.059877038,0,hg38,CD-0722-1
"E11,G4",19015,21493,13674,7819,10082,5591,0,5599,3393,2206,1.538077969,3308,167,18,14,14,0,7,0,0,0,empty,CD-0722-1
"E11,G5",6307,6847,4641,2206,3272,1627,1,1628,1048,580,1.806896552,940,1642,314,105,103,2,47,2,0.029126214,0,empty,CD-0722-1
"E11,G6",9485,10310,7074,3236,4828,2379,0,2379,1548,831,1.862815884,1368,139,31,18,18,0,9,0,0,0,empty,CD-0722-1
"E11,G7",7727,8232,5886,2346,3942,1844,0,1852,1230,622,1.977491961,1011,2993,637,217,216,1,71,1,0.074074074,0,empty,CD-0722-1
"E11,G8",5243,5752,3842,1910,2646,1288,0,1293,827,466,1.774678112,742,1686,368,121,118,3,36,1,0.186440678,0,empty,CD-0722-1
"E11,G9",6271,6873,4669,2204,3340,1613,1,1614,991,623,1.590690209,930,2966,644,213,211,2,61,2,0.090047393,0,empty,CD-0722-1
"E11,G10",8304,9179,6282,2897,4413,2234,0,2236,1424,812,1.753694581,1260,2384,470,175,172,3,67,2,0.040697674,0,empty,CD-0722-1
"E11,G11",7856,8917,5932,2985,4168,2013,0,2020,1337,683,1.957540264,1159,1594,397,157,157,0,44,0,0.031847134,0,empty,CD-0722-1
"E11,G12",6934,7623,5038,2585,3655,1876,0,1876,1192,684,1.742690058,1096,2614,554,170,166,4,58,2,0.096385542,0,empty,CD-0722-1
"E11,H1",360183,423814,259268,164546,202379,117678,0,117820,90979,26841,3.389553295,71399,6305,2341,733,730,3,179,2,0.016438356,0,hg38,CD-0722-1
"E11,H2",7784,8523,5798,2725,3978,1924,0,1926,1217,709,1.716502116,1095,2754,487,190,190,0,62,0,0.089473684,0,empty,CD-0722-1
"E11,H3",6521,7379,4839,2540,3459,1716,0,1719,1109,610,1.818032787,1001,1213,234,108,107,1,45,1,0.046728972,0,empty,CD-0722-1
"E11,H4",9796,10680,7505,3175,4949,2385,0,2385,1606,779,2.061617458,1339,241,29,21,21,0,8,0,0.095238095,0,empty,CD-0722-1
"E11,H5",10396,11408,7623,3785,5298,2700,0,2706,1721,985,1.747208122,1523,1580,384,151,145,6,52,1,0.075862069,0,empty,CD-0722-1
"E11,H6",6086,6810,4454,2356,3152,1627,1,1628,1090,538,2.026022305,961,2315,687,179,175,4,51,3,0.148571429,0,empty,CD-0722-1
"E11,H7",10942,12633,8072,4561,5953,3176,0,3176,2332,844,2.763033175,1838,4156,713,205,205,0,55,0,0.292682927,0,empty,CD-0722-1
"E11,H8",609694,706295,456264,250031,324088,171877,1,172063,145437,26626,5.462217382,101356,102517,16599,5569,5448,121,1088,5,0.059654919,0,hg38,CD-0722-1
"E11,H9",6182,6683,4680,2003,3277,1536,0,1537,1020,517,1.972920696,883,824,138,53,52,1,21,1,0.115384615,0,empty,CD-0722-1
"E11,H10",5543,6113,4136,1977,2940,1443,0,1443,952,491,1.938900204,864,962,171,77,77,0,33,0,0.038961039,0,empty,CD-0722-1
"E11,H11",7577,8937,5285,3652,4281,2661,1,2667,1456,1211,1.202312139,1634,70,14,9,9,0,4,0,0.444444444,0,empty,CD-0722-1
"E11,H12",6116,6696,4454,2242,3178,1692,0,1696,1140,556,2.050359712,983,1662,315,167,164,3,52,1,0.054878049,0,empty,CD-0722-1
"E12,A1",7122,8141,5225,2916,3905,2051,2,2054,1297,757,1.71334214,1228,1863,349,126,124,2,49,1,0.225806452,0,empty,CD-0722-1
"E12,A2",723561,840829,541207,299622,382686,207733,3,207960,163831,44129,3.712547304,121914,71344,13950,4892,4830,62,971,7,0.042028986,0,hg38,CD-0722-1
"E12,A3",6316,7173,4619,2554,3343,1682,0,1684,1059,625,1.6944,1002,1421,362,137,136,1,36,1,0.051470588,0,empty,CD-0722-1
"E12,A4",11851,12952,8983,3969,6092,3028,0,3035,1902,1133,1.678729038,1708,1013,213,79,79,0,33,0,0,0,empty,CD-0722-1
"E12,A5",1416226,1632245,1065118,567127,745661,403262,4,403696,305384,98312,3.106273903,235885,171510,30522,10080,9878,202,1710,7,0.053857056,0,hg38,CD-0722-1
"E12,A6",10393,11732,7807,3925,5567,2862,0,2865,1943,922,2.107375271,1609,3776,1065,311,305,6,103,2,0.081967213,0,empty,CD-0722-1
"E12,A7",7599,8346,5620,2726,3921,1974,1,1980,1248,732,1.704918033,1121,1699,378,161,158,3,58,1,0.044303797,0,empty,CD-0722-1
"E12,A8",4446,5127,3416,1711,2446,1221,0,1221,815,406,2.007389163,701,2574,386,139,135,4,62,2,0.051851852,0,empty,CD-0722-1
"E12,A9",1392015,1590707,1058437,532270,723648,380399,2,380813,294816,85997,3.428212612,219790,288750,37383,12554,12259,295,1972,8,0.05604046,0,hg38,CD-0722-1
"E12,A10",8520,9307,6565,2742,4516,2124,0,2132,1383,749,1.846461949,1229,251,45,25,25,0,15,0,0.04,0,empty,CD-0722-1
"E12,A11",6951,7621,5254,2367,3604,1746,0,1748,1183,565,2.09380531,984,1896,331,132,131,1,52,1,0.06870229,0,empty,CD-0722-1
"E12,A12",8989,9963,6780,3183,4634,2231,0,2232,1496,736,2.032608696,1263,3932,962,312,309,3,77,2,0.061488673,0,empty,CD-0722-1
"E12,B1",7730,9019,5722,3297,4165,2143,0,2152,1291,861,1.49941928,1318,1189,315,106,106,0,41,0,0.150943396,0,empty,CD-0722-1
"E12,B2",8689,9591,5929,3662,4547,2452,2,2456,1543,913,1.690032859,1452,727,95,46,46,0,21,0,0.152173913,0,empty,CD-0722-1
"E12,B3",6392,7113,4679,2434,3407,1708,0,1709,1103,606,1.820132013,1008,1144,267,117,117,0,45,0,0.085470085,0,empty,CD-0722-1
"E12,B4",7802,8812,5615,3197,4300,2305,0,2311,1423,888,1.602477477,1369,1670,313,123,120,3,58,2,0.091666667,0,empty,CD-0722-1
"E12,B5",7659,4211,2519,1692,2691,1465,0,1473,934,539,1.73283859,968,905,209,88,82,6,37,1,0,0,empty,CD-0722-1
"E12,B6",8469,9671,6164,3507,4592,2448,0,2448,1553,895,1.735195531,1449,1751,411,146,145,1,47,1,0.048275862,0,empty,CD-0722-1
"E12,B7",8490,9630,6414,3216,4609,2287,0,2289,1465,824,1.777912621,1325,1199,297,90,90,0,31,0,0,0,empty,CD-0722-1
"E12,B8",612190,703310,457827,245483,321460,170611,2,170796,139288,31508,4.420718548,99213,90277,14427,4849,4741,108,929,5,0.077620755,0,hg38,CD-0722-1
"E12,B9",10993,12410,8253,4157,5755,2948,0,2951,1853,1098,1.687613843,1674,1075,238,86,83,3,34,2,0.192771084,0,empty,CD-0722-1
"E12,B10",5915,6337,4321,2016,3090,1491,2,1499,903,596,1.515100671,839,437,88,45,42,3,19,1,0.142857143,0,empty,CD-0722-1
"E12,B11",11514,13102,8410,4692,6195,3359,1,3369,1836,1533,1.197651663,2006,216,52,20,20,0,13,0,0,0,empty,CD-0722-1
"E12,B12",6949,7585,5245,2340,3616,1770,0,1772,1134,638,1.777429467,966,1759,283,102,101,1,45,1,0.059405941,0,empty,CD-0722-1
"E12,C1",13771,15167,10286,4881,6916,3333,1,3348,2107,1241,1.697824335,1874,1023,313,89,88,1,30,1,0.011363636,0,empty,CD-0722-1
"E12,C2",734292,897565,516550,381015,414943,268995,1,269200,191541,77659,2.466436601,165832,8887,1160,297,288,9,90,2,0.142361111,0,hg38,CD-0722-1
"E12,C3",13286,14953,9909,5044,7181,3779,0,3786,2442,1344,1.816964286,2176,1062,275,85,85,0,31,0,0.247058824,0,empty,CD-0722-1
"E12,C4",7407,8014,5636,2378,3873,1862,0,1864,1214,650,1.867692308,1004,2042,511,189,186,3,66,1,0.193548387,0,empty,CD-0722-1
"E12,C5",11495,13051,8624,4427,6178,3146,7,3160,1999,1161,1.721791559,1817,2299,389,177,171,6,68,3,0.16374269,0,empty,CD-0722-1
"E12,C6",907572,1086896,654492,432404,510298,297783,1,298076,234093,63983,3.658674961,182514,103010,19680,6706,6608,98,1198,5,0.044340194,0,hg38,CD-0722-1
"E12,C7",12734,14716,9109,5607,6868,3819,0,3823,2276,1547,1.471234648,2282,808,231,79,79,0,35,0,0,0,empty,CD-0722-1
"E12,C8",13593,15183,10051,5132,7008,3543,0,3544,2293,1251,1.832933653,2052,3343,750,257,250,7,77,2,0.1,0,empty,CD-0722-1
"E12,C9",9217,10321,6868,3453,4821,2409,0,2423,1538,885,1.737853107,1389,1864,358,116,114,2,44,1,0.149122807,0,empty,CD-0722-1
"E12,C10",10537,11624,8122,3502,5543,2659,0,2664,1700,964,1.763485477,1468,2556,727,258,257,1,77,1,0.073929961,0,empty,CD-0722-1
"E12,C11",9772,10543,7274,3269,4960,2426,2,2429,1570,859,1.827706636,1357,2414,663,181,179,2,59,1,0.016759777,0,empty,CD-0722-1
"E12,C12",862762,1011834,635462,376372,457438,252078,4,252385,207087,45298,4.571658793,150756,103999,19064,6469,6374,95,1149,5,0.058048321,0,hg38,CD-0722-1
"E12,D1",11607,12937,8558,4379,6236,3291,0,3296,1983,1313,1.510281797,1888,897,174,64,63,1,28,1,0,0,empty,CD-0722-1
"E12,D2",10495,11264,7999,3265,5248,2390,0,2391,1518,873,1.738831615,1266,3264,900,332,328,4,100,2,0.024390244,0,empty,CD-0722-1
"E12,D3",8730,9707,6475,3232,4626,2307,0,2311,1514,797,1.899623588,1316,1772,449,159,156,3,62,2,0.096153846,0,empty,CD-0722-1
"E12,D4",6301,7201,4684,2517,3529,1790,0,1793,1173,620,1.891935484,1104,1640,291,97,96,1,39,1,0.104166667,0,empty,CD-0722-1
"E12,D5",621157,677312,483209,194103,314754,149697,0,149851,112715,37136,3.035194959,82862,32008,6380,2104,2075,29,464,2,0.026987952,0,hg38,CD-0722-1
"E12,D6",11612,12738,8358,4380,6040,3248,0,3251,1960,1291,1.518202943,1863,1799,326,125,120,5,46,2,0.125,0,empty,CD-0722-1
"E12,D7",6569,7143,4956,2187,3426,1632,0,1636,1057,579,1.825561313,900,2318,752,259,258,1,72,1,0.065891473,0,empty,CD-0722-1
"E12,D8",8473,9321,6305,3016,4383,2187,0,2191,1428,763,1.871559633,1257,1747,389,163,162,1,58,1,0.055555556,0,empty,CD-0722-1
"E12,D9",4874,5189,3700,1489,2547,1196,0,1196,833,363,2.29476584,633,2079,424,169,169,0,66,0,0.088757396,0,empty,CD-0722-1
"E12,D10",7725,8619,5659,2960,3950,1944,0,1946,1173,773,1.517464424,1151,947,143,49,49,0,17,0,0.183673469,0,empty,CD-0722-1
"E12,D11",9127,9981,6929,3052,4790,2292,0,2298,1468,830,1.768674699,1304,2723,673,270,269,1,115,1,0.055762082,0,empty,CD-0722-1
"E12,D12",11624,12789,8768,4021,6116,3034,0,3039,1948,1091,1.785517874,1752,4062,802,281,280,1,91,1,0.135714286,0,empty,CD-0722-1
"E12,E1",1368961,1480846,1070437,410409,666575,300385,2,300775,221679,79096,2.80265753,164712,403794,44055,15070,14598,472,2198,6,0.067749007,0,hg38,CD-0722-1
"E12,E2",10421,11606,7779,3827,5544,2726,0,2727,1729,998,1.73246493,1618,2452,546,182,180,2,55,1,0.177777778,0,empty,CD-0722-1
"E12,E3",6864,7521,5321,2200,3601,1689,1,1691,1141,550,2.074545455,900,2620,612,223,221,2,73,2,0.108597285,0,empty,CD-0722-1
"E12,E4",9025,9995,6883,3112,4752,2354,0,2359,1525,834,1.82853717,1326,2836,641,236,230,6,98,2,0.082608696,0,empty,CD-0722-1
"E12,E5",990976,1146000,750690,395310,520246,275831,3,276130,222507,53623,4.149469444,160810,133105,26175,8711,8589,122,1425,6,0.053556875,0,hg38,CD-0722-1
"E12,E6",13996,15864,10428,5436,7321,3711,0,3711,2281,1430,1.595104895,2177,2885,745,263,258,5,94,2,0.03875969,0,empty,CD-0722-1
"E12,E7",12702,13970,9461,4509,6625,3230,0,3237,2020,1217,1.659819228,1835,3654,686,301,296,5,93,2,0.121621622,0,empty,CD-0722-1
"E12,E8",16394,18798,12582,6216,8672,4316,0,4325,3009,1316,2.286474164,2456,4614,946,333,325,8,92,2,0.046153846,0,empty,CD-0722-1
"E12,E9",6756,7671,4993,2678,3565,1773,0,1773,1186,587,2.02044293,1025,2185,532,240,236,4,94,2,0.122881356,0,empty,CD-0722-1
"E12,E10",8087,9169,6144,3025,4239,2008,0,2011,1312,699,1.876967096,1137,2300,514,203,202,1,76,1,0.02970297,0,empty,CD-0722-1
"E12,E11",1569386,1856433,1135541,720892,848103,505150,5,505632,381575,124057,3.075803864,303149,251963,28689,10120,9814,306,1627,7,0.071224781,0,hg38,CD-0722-1
"E12,E12",10404,11479,7742,3737,5389,2651,0,2651,1775,876,2.026255708,1525,2340,571,196,187,9,58,2,0.07486631,0,empty,CD-0722-1
"E12,F1",11977,13162,8807,4355,6121,2990,0,3000,1882,1118,1.683363148,1772,2124,395,117,115,2,55,1,0.104347826,0,empty,CD-0722-1
"E12,F2",590145,709658,408774,300884,335915,217392,0,217587,138433,79154,1.748907194,134171,3661,1056,345,341,4,122,1,0.11143695,0,hg38,CD-0722-1
"E12,F3",9343,10460,6922,3538,4900,2412,0,2418,1503,915,1.642622951,1381,3009,599,256,252,4,110,2,0.05952381,0,empty,CD-0722-1
"E12,F4",956119,1158465,667127,491338,538048,349900,10,350201,242224,107977,2.243292553,214290,932,249,70,67,3,36,2,0.044776119,0,empty,CD-0722-1
"E12,F5",797031,959942,552677,407265,437692,282911,1,283129,202791,80338,2.524222659,172585,5762,863,304,295,9,89,3,0.118644068,0,hg38,CD-0722-1
"E12,F6",10885,11936,7848,4088,5634,2926,0,2931,1881,1050,1.791428571,1659,3589,741,288,282,6,92,2,0.163120567,0,empty,CD-0722-1
"E12,F7",12548,13765,9469,4296,6511,3203,0,3206,2071,1135,1.824669604,1745,1682,411,146,146,0,52,0,0.04109589,0,empty,CD-0722-1
"E12,F8",10853,12271,8125,4146,5715,2948,0,2949,1841,1108,1.661552347,1715,142,37,23,23,0,11,0,0.173913043,0,empty,CD-0722-1
"E12,F9",817361,935725,619290,316435,430034,224271,1,224507,171978,52529,3.273962954,130399,155845,26492,8906,8723,183,1399,5,0.056058695,0,hg38,CD-0722-1
"E12,F10",12038,13263,9305,3958,6171,2919,5,2930,1848,1082,1.707948244,1605,1617,403,162,161,1,48,1,0.037267081,0,empty,CD-0722-1
"E12,F11",9491,10007,7250,2757,4709,2140,0,2145,1435,710,2.021126761,1134,2142,364,150,140,10,46,2,0.078571429,0,empty,CD-0722-1
"E12,F12",10452,11372,7694,3678,5226,2557,0,2559,1666,893,1.865621501,1493,217,48,22,22,0,9,0,0,0,empty,CD-0722-1
"E12,G1",11595,12914,8796,4118,6078,2885,0,2887,1864,1023,1.822091887,1635,3204,681,279,269,10,107,2,0.026022305,0,empty,CD-0722-1
"E12,G2",6636,7316,4617,2699,3483,1797,0,1797,1147,650,1.764615385,1049,710,154,60,60,0,28,0,0.066666667,0,empty,CD-0722-1
"E12,G3",13523,14596,10270,4326,6973,3524,0,3536,2192,1344,1.630952381,1888,2621,622,244,236,8,87,2,0.038135593,0,empty,CD-0722-1
"E12,G4",21742,24876,15765,9111,11670,6456,0,6457,3927,2530,1.552173913,3739,149,22,16,16,0,13,0,0,0,empty,CD-0722-1
"E12,G5",7541,8310,5490,2820,3987,2007,0,2011,1318,693,1.901875902,1159,1884,397,157,155,2,59,2,0.051612903,0,empty,CD-0722-1
"E12,G6",10856,11963,8118,3845,5674,2744,0,2745,1754,991,1.769929364,1548,241,54,30,30,0,18,0,0.1,0,empty,CD-0722-1
"E12,G7",9350,10275,7056,3219,4880,2276,0,2281,1442,839,1.718712753,1341,2669,749,276,267,9,90,3,0.108614232,0,empty,CD-0722-1
"E12,G8",6505,7400,4802,2598,3480,1733,0,1733,1099,634,1.733438486,1015,1848,271,98,98,0,43,0,0.091836735,0,empty,CD-0722-1
"E12,G9",1442373,1596877,1114510,482367,725845,353533,4,353983,290137,63846,4.544325408,198679,98136,20675,6523,6452,71,1225,5,0.012244265,0,hg38,CD-0722-1
"E12,G10",9327,10243,6943,3300,4970,2521,1,2527,1615,912,1.770833333,1410,2692,605,268,267,1,112,1,0.08988764,0,empty,CD-0722-1
"E12,G11",9558,10732,7172,3560,5039,2389,0,2389,1578,811,1.945745993,1394,1762,338,150,150,0,57,0,0.073333333,0,empty,CD-0722-1
"E12,G12",7930,8712,5917,2795,4071,2037,0,2040,1319,721,1.829403606,1148,2396,373,165,162,3,60,1,0.104938272,0,empty,CD-0722-1
"E12,H1",7734,8422,5802,2620,4017,1903,1,1910,1215,695,1.748201439,1066,1238,368,150,149,1,53,1,0.060402685,0,empty,CD-0722-1
"E12,H2",9133,10221,6808,3413,4813,2392,0,2392,1482,910,1.628571429,1354,2482,585,207,199,8,71,1,0.135678392,0,empty,CD-0722-1
"E12,H3",7368,8456,5405,3051,3899,1948,0,1953,1232,721,1.708737864,1174,2075,300,123,121,2,54,1,0.181818182,0,empty,CD-0722-1
"E12,H4",10915,11842,8037,3805,5641,2773,0,2776,1770,1006,1.75944334,1581,232,52,32,30,2,18,2,0,0,empty,CD-0722-1
"E12,H5",11948,13078,8683,4395,6020,2949,0,2951,1841,1110,1.658558559,1678,2046,400,149,147,2,52,2,0.068027211,0,empty,CD-0722-1
"E12,H6",7316,8407,5347,3060,3922,2012,0,2013,1232,781,1.577464789,1190,2572,643,197,194,3,63,1,0.082474227,0,empty,CD-0722-1
"E12,H7",8747,9533,6523,3010,4512,2216,2,2222,1478,744,1.98655914,1245,2138,487,161,159,2,59,1,0.081761006,0,empty,CD-0722-1
"E12,H8",9718,10988,7239,3749,4988,2505,0,2515,1608,907,1.772877619,1460,2181,638,232,231,1,58,1,0.125541126,0,empty,CD-0722-1
"E12,H9",7536,8300,5781,2519,3849,1787,0,1790,1174,616,1.905844156,990,1217,172,70,68,2,31,1,0.044117647,0,empty,CD-0722-1
"E12,H10",7107,7893,5324,2569,3628,1862,0,1865,1230,635,1.937007874,1071,1456,227,70,66,4,31,2,0.075757576,0,empty,CD-0722-1
"E12,H11",8711,9978,6114,3864,4777,2883,0,2884,1553,1331,1.166791886,1762,149,35,12,12,0,4,0,0,0,empty,CD-0722-1
"E12,H12",7443,8469,5496,2973,3935,2024,0,2035,1331,704,1.890625,1165,1829,301,114,112,2,47,2,0.026785714,0,empty,CD-0722-1
"F1,A1",6557,7713,4827,2886,3528,1902,0,1902,1246,656,1.899390244,1106,1292,187,78,77,1,41,1,0.103896104,0,empty,CD-0722-1
"F1,A2",9485,10776,6855,3921,5112,2691,0,2696,1725,971,1.776519053,1586,2317,657,255,254,1,75,1,0.031496063,0,empty,CD-0722-1
"F1,A3",561726,687287,390726,296561,319842,207180,5,207380,166004,41376,4.0120843,126628,34182,1375,516,464,52,161,2,0.088362069,0,hg38,CD-0722-1
"F1,A4",10498,11471,7889,3582,5444,2690,0,2692,1779,913,1.948521358,1487,970,131,63,62,1,31,1,0,0,empty,CD-0722-1
"F1,A5",8864,9750,6641,3109,4671,2285,0,2290,1502,788,1.906091371,1267,2278,506,181,175,6,68,2,0.068571429,0,empty,CD-0722-1
"F1,A6",412191,480448,315291,165157,225447,116644,0,116746,87758,28988,3.027390644,67755,113496,14200,4845,4704,141,898,6,0.057610544,0,hg38,CD-0722-1
"F1,A7",530212,599608,400154,199454,280476,144341,1,144516,123088,21428,5.744259847,83212,84519,19198,5891,5792,99,1026,5,0.044026243,0,hg38,CD-0722-1
"F1,A8",4070,4480,3137,1343,2173,1047,0,1049,686,363,1.889807163,577,2195,441,162,161,1,67,1,0.037267081,0,empty,CD-0722-1
"F1,A9",6626,7404,5190,2214,3565,1739,1,1740,1118,622,1.797427653,981,2126,484,173,170,3,49,3,0.088235294,0,empty,CD-0722-1
"F1,A10",7309,7729,5572,2157,3616,1744,0,1744,1099,645,1.703875969,914,199,31,25,25,0,19,0,0,0,empty,CD-0722-1
"F1,A11",6041,6581,4552,2029,3116,1476,0,1487,1009,478,2.110878661,819,1332,306,123,122,1,48,1,0.032786885,0,empty,CD-0722-1
"F1,A12",7964,8680,6170,2510,4083,1918,0,1922,1226,696,1.761494253,1079,3674,935,360,355,5,86,1,0.154929577,0,empty,CD-0722-1
"F1,B1",6995,7900,5025,2875,3771,2003,0,2005,1197,808,1.481435644,1175,1231,234,64,64,0,23,0,0.171875,0,empty,CD-0722-1
"F1,B2",7812,8875,5450,3425,4314,2359,0,2369,1459,910,1.603296703,1423,501,24,14,14,0,12,0,0,0,empty,CD-0722-1
"F1,B3",5674,6476,4227,2249,3054,1559,0,1559,991,568,1.74471831,920,1326,198,66,65,1,36,1,0.015384615,0,empty,CD-0722-1
"F1,B4",6379,7106,4590,2516,3535,1875,0,1879,1131,748,1.512032086,1107,1553,334,137,135,2,48,2,0.140740741,0,empty,CD-0722-1
"F1,B5",6885,3666,2078,1588,2403,1271,0,1278,840,438,1.917808219,872,1564,322,123,120,3,31,2,0.075,0,empty,CD-0722-1
"F1,B6",7359,8123,5301,2822,4004,2114,0,2117,1350,767,1.760104302,1256,1543,322,153,149,4,40,1,0.087248322,0,empty,CD-0722-1
"F1,B7",7640,8521,5800,2721,4039,2026,0,2029,1285,744,1.727150538,1149,1376,431,127,127,0,39,0,0.173228346,0,empty,CD-0722-1
"F1,B8",6607,7350,4859,2491,3486,1727,0,1730,1171,559,2.094812165,1006,1175,164,81,80,1,43,1,0.0625,0,empty,CD-0722-1
"F1,B9",9410,10374,6923,3451,4919,2600,0,2602,1695,907,1.868798236,1441,946,278,83,83,0,34,0,0.13253012,0,empty,CD-0722-1
"F1,B10",4805,5190,3390,1800,2632,1328,0,1339,848,491,1.727087576,789,570,123,57,57,0,25,0,0.035087719,0,empty,CD-0722-1
"F1,B11",10231,11679,7468,4211,5605,3139,0,3139,1783,1356,1.314896755,1872,167,20,12,12,0,9,0,0,0,empty,CD-0722-1
"F1,B12",6117,6906,4585,2321,3221,1562,0,1565,991,574,1.726480836,875,1707,459,139,131,8,47,2,0.114503817,0,empty,CD-0722-1
"F1,C1",12531,13723,9401,4322,6358,3108,0,3116,1962,1154,1.70017331,1753,1309,291,105,105,0,32,0,0.161904762,0,empty,CD-0722-1
"F1,C2",10194,11212,7397,3815,5191,2666,2,2670,1708,962,1.775467775,1544,2528,664,218,218,0,56,0,0.009174312,0,empty,CD-0722-1
"F1,C3",11831,13124,8865,4259,6277,3060,0,3061,2021,1040,1.943269231,1742,1202,157,35,35,0,17,0,0.2,0,empty,CD-0722-1
"F1,C4",6675,7363,5079,2284,3471,1650,0,1651,1075,576,1.866319444,928,1657,397,131,131,0,49,0,0.183206107,0,empty,CD-0722-1
"F1,C5",11219,13189,8242,4947,6273,3366,0,3373,2391,982,2.434826884,1989,1844,314,128,126,2,57,1,0.126984127,0,empty,CD-0722-1
"F1,C6",8508,9639,6080,3559,4614,2423,0,2423,1524,899,1.695216908,1475,2097,534,207,204,3,77,2,0.06372549,0,empty,CD-0722-1
"F1,C7",586179,646831,458806,188025,300681,139608,2,139777,111345,28432,3.916185988,77983,5191,926,298,291,7,87,1,0.034364261,0,hg38,CD-0722-1
"F1,C8",11910,13408,8765,4643,6356,3284,0,3288,2112,1176,1.795918367,1889,3836,669,239,239,0,87,0,0.0041841,0,empty,CD-0722-1
"F1,C9",8299,9347,6186,3161,4345,2138,0,2138,1378,760,1.813157895,1239,1988,479,153,153,0,45,0,0.006535948,0,empty,CD-0722-1
"F1,C10",1540005,1731098,1166513,564585,786152,413697,3,414102,348245,65857,5.287896503,237156,57644,8331,2699,2647,52,609,3,0.029467321,0,hg38,CD-0722-1
"F1,C11",8676,9474,6583,2891,4471,2150,0,2154,1404,750,1.872,1208,2122,490,175,169,6,59,2,0.100591716,0,empty,CD-0722-1
"F1,C12",1400872,1649766,1020752,629014,749755,425806,8,426314,334626,91688,3.649616089,257827,141507,21263,6941,6799,142,1267,7,0.067215767,0,hg38,CD-0722-1
"F1,D1",10184,11350,7601,3749,5359,2822,0,2828,1733,1095,1.582648402,1623,839,97,46,46,0,19,0,0,0,empty,CD-0722-1
"F1,D2",9064,9801,6859,2942,4689,2245,0,2249,1417,832,1.703125,1251,3356,975,310,306,4,107,2,0.022875817,0,empty,CD-0722-1
"F1,D3",7697,8495,5771,2724,4122,2092,0,2100,1413,687,2.056768559,1199,1569,371,147,146,1,54,1,0.143835616,0,empty,CD-0722-1
"F1,D4",6045,6765,4535,2230,3254,1647,0,1655,1099,556,1.976618705,927,1763,531,187,186,1,50,1,0.053763441,0,empty,CD-0722-1
"F1,D5",6953,7777,5175,2602,3641,1823,0,1825,1215,610,1.991803279,1061,2063,437,155,154,1,54,1,0.175324675,0,empty,CD-0722-1
"F1,D6",10581,11939,7497,4442,5651,3081,0,3088,1844,1244,1.482315113,1891,1579,354,123,121,2,47,2,0.033057851,0,empty,CD-0722-1
"F1,D7",6315,7163,4744,2419,3307,1604,1,1605,1037,568,1.825704225,930,2206,396,141,139,2,50,1,0.035971223,0,empty,CD-0722-1
"F1,D8",6860,7518,5180,2338,3577,1730,0,1731,1090,641,1.700468019,968,1472,401,130,128,2,50,1,0.0234375,0,empty,CD-0722-1
"F1,D9",3940,4405,2924,1481,2123,1037,0,1041,711,330,2.154545455,607,2313,650,240,237,3,67,2,0.084388186,0,empty,CD-0722-1
"F1,D10",7276,7755,5377,2378,3696,1806,0,1810,1117,693,1.611832612,1018,708,139,49,49,0,21,0,0.081632653,0,empty,CD-0722-1
"F1,D11",525650,638076,367452,270624,297183,192537,2,192722,154927,37795,4.099140098,115652,43809,24248,6619,6602,17,881,4,0.003786731,0,hg38,CD-0722-1
"F1,D12",10175,11375,7526,3849,5370,2675,1,2680,1747,933,1.872454448,1557,3777,884,276,276,0,101,0,0.170289855,0,empty,CD-0722-1
"F1,E1",1106987,1216823,865346,351477,559064,264272,3,264627,215277,49350,4.36224924,144653,196055,31008,10450,10286,164,1665,6,0.079817227,0,hg38,CD-0722-1
"F1,E2",504128,538201,397086,141115,255635,112546,1,112738,87816,24922,3.523633737,60426,13170,1529,523,510,13,189,2,0.017647059,0,hg38,CD-0722-1
"F1,E3",6595,7561,4853,2708,3553,1804,0,1805,1160,645,1.798449612,1083,2916,675,234,232,2,90,1,0.068965517,0,empty,CD-0722-1
"F1,E4",7932,8799,6040,2759,4250,2086,0,2088,1310,778,1.683804627,1160,2300,378,168,167,1,92,1,0.047904192,0,empty,CD-0722-1
"F1,E5",7446,8146,5644,2502,3876,1830,0,1832,1127,705,1.59858156,1011,1300,269,119,119,0,43,0,0.084033613,0,empty,CD-0722-1
"F1,E6",12218,13640,8972,4668,6448,3305,0,3310,2070,1240,1.669354839,1903,3221,841,258,256,2,73,1,0.078125,0,empty,CD-0722-1
"F1,E7",22203,24419,17048,7371,11199,4983,0,4986,3447,1539,2.239766082,2822,15181,2495,806,789,17,198,2,0.091254753,0,empty,CD-0722-1
"F1,E8",771372,895685,579496,316189,410489,221775,1,221981,175456,46525,3.771219774,129295,165457,27639,9399,9230,169,1521,6,0.030010834,0,hg38,CD-0722-1
"F1,E9",658745,806559,478608,327951,371961,218323,3,218511,180854,37657,4.802666171,134765,192751,33746,11040,10846,194,1803,4,0.059745528,0,hg38,CD-0722-1
"F1,E10",7243,8050,5529,2521,3787,1787,0,1788,1153,635,1.815748031,1028,2039,680,222,216,6,59,3,0.194444444,0,empty,CD-0722-1
"F1,E11",8387,9126,6280,2846,4461,2162,1,2167,1356,811,1.672009864,1218,2287,432,175,173,2,49,2,0.063583815,0,empty,CD-0722-1
"F1,E12",8710,10094,6335,3759,4677,2374,0,2376,1454,922,1.577006508,1459,1691,305,143,141,2,59,2,0.085106383,0,empty,CD-0722-1
"F1,F1",10818,11726,8077,3649,5477,2699,0,2703,1721,982,1.752545825,1489,2166,578,204,200,4,65,2,0.055,0,empty,CD-0722-1
"F1,F2",636718,724590,480643,243947,338301,172733,4,172915,130193,42722,3.047446281,101385,186843,24947,8277,8073,204,1382,8,0.076675338,0,hg38,CD-0722-1
"F1,F3",18399,20322,13017,7305,9466,5097,0,5099,3437,1662,2.067990373,2998,4260,722,286,280,6,90,1,0.278571429,0,empty,CD-0722-1
"F1,F4",12181,13129,9206,3923,6238,2949,0,2956,1911,1045,1.828708134,1650,547,76,42,40,2,21,2,0.125,0,empty,CD-0722-1
"F1,F5",9643,10514,7205,3309,4983,2391,0,2391,1509,882,1.710884354,1332,1943,415,163,163,0,61,0,0.104294479,0,empty,CD-0722-1
"F1,F6",9431,10466,6900,3566,5049,2526,1,2537,1625,912,1.781798246,1475,3453,887,317,316,1,89,1,0.10443038,0,empty,CD-0722-1
"F1,F7",11360,12208,8420,3788,5821,2790,0,2792,1833,959,1.911366006,1579,1611,446,175,175,0,59,0,0.068571429,0,empty,CD-0722-1
"F1,F8",7585,8501,5700,2801,4039,2013,0,2015,1262,753,1.675962815,1158,352,136,34,34,0,10,0,0.470588235,0,empty,CD-0722-1
"F1,F9",744523,858159,562000,296159,398616,210439,0,210699,167360,43339,3.861648861,122282,168149,24786,8099,7931,168,1490,5,0.05863069,0,hg38,CD-0722-1
"F1,F10",11281,12290,8576,3714,5618,2674,0,2680,1759,921,1.909880565,1461,1707,530,165,164,1,48,1,0.036585366,0,empty,CD-0722-1
"F1,F11",7977,8645,6075,2570,4120,1895,0,1899,1268,631,2.009508716,1073,2119,425,138,133,5,39,2,0.187969925,0,empty,CD-0722-1
"F1,F12",9181,10299,6940,3359,4670,2309,0,2309,1429,880,1.623863636,1291,194,56,32,32,0,13,0,0,0,empty,CD-0722-1
"F1,G1",10303,11447,7857,3590,5407,2522,1,2524,1702,822,2.070559611,1437,2956,747,292,288,4,92,1,0.131944444,0,empty,CD-0722-1
"F1,G2",5819,6321,4058,2263,3064,1578,0,1578,970,608,1.595394737,929,357,84,52,51,1,26,1,0.352941176,0,empty,CD-0722-1
"F1,G3",10942,11848,8156,3692,5748,2882,0,2884,1743,1141,1.527607362,1560,2310,562,196,195,1,79,1,0.112820513,0,empty,CD-0722-1
"F1,G4",19854,21813,14517,7296,10567,5816,0,5826,3496,2330,1.500429185,3296,210,29,18,18,0,13,0,0,0,empty,CD-0722-1
"F1,G5",6874,7611,5170,2441,3640,1836,0,1841,1209,632,1.912974684,1030,1734,564,162,158,4,66,2,0.075949367,0,empty,CD-0722-1
"F1,G6",877889,1035435,650252,385183,472874,263356,1,263670,205771,57899,3.553964663,157642,5440,769,255,252,3,73,1,0.043650794,0,hg38,CD-0722-1
"F1,G7",8092,8643,6317,2326,4194,1934,0,1939,1278,661,1.933434191,1043,2484,470,161,158,3,67,2,0.215189873,0,empty,CD-0722-1
"F1,G8",5529,6265,4114,2151,2995,1459,0,1459,944,515,1.833009709,844,1879,398,148,143,5,52,2,0.167832168,0,empty,CD-0722-1
"F1,G9",606936,725605,446038,279567,338223,191962,1,192126,154061,38065,4.047313805,116646,157446,29878,9939,9787,152,1634,6,0.052723,0,hg38,CD-0722-1
"F1,G10",650198,751916,490939,260977,347610,181939,1,182140,139962,42178,3.318365024,106507,224385,33039,11340,11110,230,1688,6,0.056345635,0,hg38,CD-0722-1
"F1,G11",8295,9148,6321,2827,4414,2073,0,2084,1339,745,1.797315436,1163,1526,518,166,165,1,53,1,0.072727273,0,empty,CD-0722-1
"F1,G12",17057,19191,13157,6034,8799,4271,0,4274,3011,1263,2.384006334,2450,4023,1188,396,390,6,109,1,0.056410256,0,empty,CD-0722-1
"F1,H1",6760,7477,5051,2426,3549,1709,0,1713,1040,673,1.545319465,987,989,94,53,53,0,32,0,0.056603774,0,empty,CD-0722-1
"F1,H2",8779,9873,6452,3421,4517,2310,0,2311,1495,816,1.832107843,1327,2380,459,184,184,0,57,0,0.032608696,0,empty,CD-0722-1
"F1,H3",6765,7629,4958,2671,3505,1730,0,1732,1136,596,1.906040268,1045,1554,275,113,111,2,50,2,0.126126126,0,empty,CD-0722-1
"F1,H4",10387,11221,7909,3312,5258,2517,0,2522,1662,860,1.93255814,1367,162,30,18,18,0,13,0,0.055555556,0,empty,CD-0722-1
"F1,H5",10895,12302,8157,4145,5689,2835,0,2839,1789,1050,1.703809524,1632,2059,447,202,198,4,48,2,0.227272727,0,empty,CD-0722-1
"F1,H6",6007,6608,4513,2095,3139,1577,0,1581,1105,476,2.321428571,871,2030,518,149,147,2,45,2,0.068027211,0,empty,CD-0722-1
"F1,H7",8043,8722,6031,2691,4127,1971,0,1976,1316,660,1.993939394,1120,2376,508,169,169,0,64,0,0.017751479,0,empty,CD-0722-1
"F1,H8",15035,17744,11060,6684,8540,4701,0,4709,3443,1266,2.719589258,2801,2580,507,175,167,8,47,2,0.137724551,0,empty,CD-0722-1
"F1,H9",6932,7782,5241,2541,3666,1808,0,1810,1254,556,2.255395683,1015,1306,328,124,122,2,39,2,0.090163934,0,empty,CD-0722-1
"F1,H10",5742,6307,4338,1969,2995,1457,1,1459,973,486,2.002057613,818,1546,411,139,139,0,40,0,0.079136691,0,empty,CD-0722-1
"F1,H11",364964,433563,259460,174103,213102,130535,1,130616,96612,34004,2.841195154,79237,89,32,11,11,0,5,0,0,0,empty,CD-0722-1
"F1,H12",6348,6929,4621,2308,3283,1677,0,1679,1061,618,1.716828479,932,1480,398,140,140,0,42,0,0.221428571,0,empty,CD-0722-1
"F2,A1",660841,787433,487471,299962,364550,206011,2,206216,157880,48336,3.266302549,124131,137121,23139,7535,7403,132,1339,3,0.050384979,0,hg38,CD-0722-1
"F2,A2",521541,579838,397116,182722,266873,131314,2,131463,94404,37059,2.547397393,74968,63170,7430,2328,2243,85,554,4,0.032991529,0,hg38,CD-0722-1
"F2,A3",5890,6568,4388,2180,3025,1490,0,1491,1004,487,2.061601643,853,1251,228,82,82,0,25,0,0.048780488,0,empty,CD-0722-1
"F2,A4",10207,11332,7624,3708,5449,2649,0,2651,1732,919,1.884657236,1489,1220,298,101,101,0,37,0,0.079207921,0,empty,CD-0722-1
"F2,A5",8829,9419,6589,2830,4536,2189,0,2189,1431,758,1.887862797,1218,2741,613,207,203,4,80,1,0.118226601,0,empty,CD-0722-1
"F2,A6",7731,9010,5781,3229,4233,2185,0,2185,1362,823,1.654921021,1292,3429,744,281,280,1,103,1,0.114285714,0,empty,CD-0722-1
"F2,A7",6370,7244,4816,2428,3459,1784,0,1784,1134,650,1.744615385,1018,1790,264,110,109,1,51,1,0.137614679,0,empty,CD-0722-1
"F2,A8",3940,4357,2976,1381,2062,1030,0,1030,712,318,2.238993711,567,2045,393,135,135,0,56,0,0.111111111,0,empty,CD-0722-1
"F2,A9",7336,8024,5476,2548,3982,1921,0,1923,1315,608,2.162828947,1079,2204,618,195,193,2,56,1,0.264248705,0,empty,CD-0722-1
"F2,A10",7881,8704,5908,2796,4115,2014,0,2014,1265,749,1.688918558,1118,593,149,58,58,0,18,0,0.017241379,0,empty,CD-0722-1
"F2,A11",6168,6656,4684,1972,3216,1530,0,1532,1044,488,2.139344262,813,2414,594,222,216,6,69,2,0.106481481,0,empty,CD-0722-1
"F2,A12",8898,10059,6568,3491,4739,2301,0,2309,1484,825,1.798787879,1368,3559,1184,341,336,5,78,3,0.056547619,0,empty,CD-0722-1
"F2,B1",7195,7967,5315,2652,3759,1880,0,1881,1223,658,1.858662614,1066,1971,568,165,157,8,47,2,0.089171975,0,empty,CD-0722-1
"F2,B2",7321,8065,5089,2976,3766,2013,0,2013,1242,771,1.610894942,1153,623,134,62,59,3,15,1,0,0,empty,CD-0722-1
"F2,B3",785168,966586,563863,402723,447061,268744,3,268992,209165,59827,3.496163939,166723,92659,14643,4729,4660,69,938,4,0.034549356,0,hg38,CD-0722-1
"F2,B4",6950,7958,5027,2931,3838,2063,0,2064,1233,831,1.483754513,1212,1967,458,154,151,3,57,1,0.225165563,0,empty,CD-0722-1
"F2,B5",6489,3380,1966,1414,2234,1258,0,1275,807,468,1.724358974,849,883,159,38,38,0,12,0,0.236842105,0,empty,CD-0722-1
"F2,B6",7694,8800,5698,3102,4167,2190,0,2196,1332,864,1.541666667,1300,2049,514,152,150,2,31,1,0.066666667,0,empty,CD-0722-1
"F2,B7",7083,7972,5245,2727,3706,1783,0,1783,1218,565,2.155752212,1026,1406,311,119,112,7,36,2,0.125,0,empty,CD-0722-1
"F2,B8",5216,5719,3912,1807,2782,1290,0,1292,832,460,1.808695652,719,1263,223,92,92,0,45,0,0.010869565,0,empty,CD-0722-1
"F2,B9",9990,10927,7346,3581,5490,2873,0,2875,1882,993,1.895266868,1606,1584,374,96,95,1,32,1,0.042105263,0,empty,CD-0722-1
"F2,B10",5190,5418,3715,1703,2742,1375,0,1381,872,509,1.713163065,778,500,133,39,38,1,13,1,0.236842105,0,empty,CD-0722-1
"F2,B11",10808,12055,7951,4104,5701,3143,0,3143,1770,1373,1.289147851,1823,258,62,10,9,1,4,1,0.666666667,0,empty,CD-0722-1
"F2,B12",6613,7322,4882,2440,3438,1657,0,1661,1091,570,1.914035088,928,1558,352,119,115,4,44,1,0.026086957,0,empty,CD-0722-1
"F2,C1",11818,12669,8924,3745,6081,2961,0,2963,1856,1107,1.676603433,1569,938,192,73,73,0,22,0,0.068493151,0,empty,CD-0722-1
"F2,C2",10126,11453,7463,3990,5198,2629,2,2636,1645,991,1.659939455,1511,2465,600,173,172,1,59,1,0.046511628,0,empty,CD-0722-1
"F2,C3",11063,11882,8319,3563,5824,2849,0,2857,1884,973,1.936279548,1558,1015,162,77,75,2,21,2,0,0,empty,CD-0722-1
"F2,C4",595086,669109,449973,219136,311781,160308,5,160485,134663,25822,5.215049183,91700,129616,14618,4632,4478,154,911,4,0.079946405,0,hg38,CD-0722-1
"F2,C5",10106,11451,7452,3999,5432,2734,0,2736,1775,961,1.847034339,1620,2349,560,143,141,2,50,1,0.028368794,0,empty,CD-0722-1
"F2,C6",9831,10811,7301,3510,5220,2598,0,2604,1704,900,1.893333333,1438,2525,567,224,221,3,75,2,0.085972851,0,empty,CD-0722-1
"F2,C7",11571,12929,8373,4556,6219,3311,0,3316,2146,1170,1.834188034,1875,682,97,42,40,2,26,1,0.075,0,empty,CD-0722-1
"F2,C8",12298,13925,8995,4930,6428,3275,2,3282,2130,1152,1.848958333,1891,3855,888,300,300,0,102,0,0.11,0,empty,CD-0722-1
"F2,C9",8811,10148,6524,3624,4714,2370,3,2374,1561,813,1.9200492,1423,1856,464,163,159,4,41,2,0.031446541,0,empty,CD-0722-1
"F2,C10",1293017,1466440,983151,483289,666369,345486,6,345877,261702,84175,3.109022869,198491,225705,30486,10251,10000,251,1668,10,0.0604,0,hg38,CD-0722-1
"F2,C11",8078,8973,5946,3027,4313,2111,0,2117,1366,751,1.818908123,1263,2525,636,219,219,0,61,0,0.082191781,0,empty,CD-0722-1
"F2,C12",11768,12886,8697,4189,6140,2979,0,2985,2041,944,2.162076271,1722,2137,636,172,169,3,52,1,0.195266272,0,empty,CD-0722-1
"F2,D1",10971,12503,7868,4635,5877,3239,0,3245,1953,1292,1.511609907,1939,1012,310,90,90,0,27,0,0.088888889,0,empty,CD-0722-1
"F2,D2",8362,9148,6288,2860,4280,2049,0,2056,1296,760,1.705263158,1115,3098,848,355,352,3,106,2,0.03125,0,empty,CD-0722-1
"F2,D3",7992,9018,5953,3065,4310,2175,1,2179,1450,729,1.989026063,1256,1595,368,141,136,5,46,2,0,0,empty,CD-0722-1
"F2,D4",487562,554713,371631,183082,261548,134367,1,134477,105418,29059,3.627722909,77379,21529,3276,961,945,16,267,5,0.011640212,0,hg38,CD-0722-1
"F2,D5",6819,7579,5098,2481,3708,1826,0,1830,1176,654,1.798165138,1086,1921,432,160,160,0,55,0,0.06875,0,empty,CD-0722-1
"F2,D6",10333,11530,7438,4092,5361,2904,0,2910,1747,1163,1.502149613,1675,2177,481,180,176,4,51,2,0.1875,0,empty,CD-0722-1
"F2,D7",5392,5858,4066,1792,2813,1304,2,1306,833,473,1.761099366,731,2072,501,168,167,1,38,1,0.05988024,0,empty,CD-0722-1
"F2,D8",7228,7547,5477,2070,3782,1826,0,1828,1149,679,1.692194404,958,1381,194,90,87,3,33,2,0.091954023,0,empty,CD-0722-1
"F2,D9",368223,425543,272143,153400,197143,105587,0,105712,82764,22948,3.606588809,62889,223916,23956,8113,7896,217,1387,9,0.059017224,0,hg38,CD-0722-1
"F2,D10",571202,636741,433735,203006,296505,147877,2,148080,114311,33769,3.385086914,84600,28901,5033,1810,1786,24,381,3,0.045352744,0,hg38,CD-0722-1
"F2,D11",8045,9014,6046,2968,4230,2046,0,2050,1335,715,1.867132867,1203,3664,1018,333,331,2,107,1,0.048338369,0,empty,CD-0722-1
"F2,D12",9734,10710,7308,3402,5058,2497,0,2502,1587,915,1.73442623,1413,4101,798,267,265,2,83,1,0.113207547,0,empty,CD-0722-1
"F2,E1",12169,13490,9005,4485,6422,3228,0,3231,2020,1211,1.66804294,1830,3128,601,224,222,2,79,2,0.09009009,0,empty,CD-0722-1
"F2,E2",8741,9397,6474,2923,4540,2287,1,2291,1431,860,1.663953488,1277,2354,570,210,207,3,49,2,0.207729469,0,empty,CD-0722-1
"F2,E3",6158,6866,4673,2193,3136,1491,0,1495,948,547,1.73308958,848,3278,647,204,195,9,64,2,0.123076923,0,empty,CD-0722-1
"F2,E4",8179,9079,6210,2869,4310,2105,0,2119,1320,799,1.652065081,1169,3329,814,315,315,0,99,0,0.079365079,0,empty,CD-0722-1
"F2,E5",7359,8089,5541,2548,3708,1665,0,1668,1093,575,1.900869565,919,1819,656,165,163,2,56,1,0.006134969,0,empty,CD-0722-1
"F2,E6",608733,683960,459506,224454,312748,160470,2,160651,124177,36474,3.404534737,91438,79508,16904,5440,5370,70,945,2,0.040223464,0,hg38,CD-0722-1
"F2,E7",12301,13644,9268,4376,6419,3078,0,3085,2080,1005,2.069651741,1721,3474,814,284,280,4,81,2,0.035714286,0,empty,CD-0722-1
"F2,E8",9266,10251,7083,3168,4769,2246,1,2252,1406,846,1.661938534,1207,3789,909,300,295,5,80,2,0.216949153,0,empty,CD-0722-1
"F2,E9",7019,7871,5177,2694,3899,1969,0,1973,1374,599,2.293823038,1146,3337,866,270,264,6,83,2,0.018939394,0,empty,CD-0722-1
"F2,E10",7144,7688,5496,2192,3644,1654,0,1659,1065,594,1.792929293,918,2421,484,138,137,1,50,1,0.131386861,0,empty,CD-0722-1
"F2,E11",8287,8874,6152,2722,4281,2089,0,2091,1311,780,1.680769231,1164,2646,572,192,191,1,62,1,0.02617801,0,empty,CD-0722-1
"F2,E12",706649,892630,494566,398064,414195,260124,4,260334,199950,60384,3.311307631,166968,22644,10891,3342,3338,4,686,2,0.014080288,0,hg38,CD-0722-1
"F2,F1",10434,11543,7855,3688,5404,2622,0,2624,1650,974,1.694045175,1503,2105,502,193,193,0,61,0,0.010362694,0,empty,CD-0722-1
"F2,F2",8611,9480,6321,3159,4338,2088,0,2089,1377,712,1.933988764,1195,3506,927,275,272,3,92,1,0.055147059,0,empty,CD-0722-1
"F2,F3",8299,8981,6195,2786,4183,2033,0,2034,1291,743,1.737550471,1111,3774,1061,358,348,10,96,2,0.034482759,0,empty,CD-0722-1
"F2,F4",11563,12287,8728,3559,5840,2692,0,2692,1745,947,1.842661035,1485,683,121,64,63,1,27,1,0,0,empty,CD-0722-1
"F2,F5",9551,10496,7237,3259,4884,2346,0,2346,1544,802,1.925187032,1314,2782,1016,346,336,10,69,2,0.089285714,0,empty,CD-0722-1
"F2,F6",9707,10786,7264,3522,5120,2603,0,2608,1706,902,1.89135255,1471,3225,673,260,258,2,81,2,0.100775194,0,empty,CD-0722-1
"F2,F7",11218,12288,8414,3874,5831,2874,0,2876,1909,967,1.974146846,1578,1349,358,123,122,1,48,1,0.081967213,0,empty,CD-0722-1
"F2,F8",8168,8858,6106,2752,4237,2022,0,2023,1276,747,1.708165997,1173,295,58,24,24,0,8,0,0.041666667,0,empty,CD-0722-1
"F2,F9",8280,9100,6303,2797,4214,2018,0,2018,1278,740,1.727027027,1095,3587,861,311,306,5,77,2,0.026143791,0,empty,CD-0722-1
"F2,F10",10517,11455,8036,3419,5201,2476,0,2478,1569,909,1.726072607,1389,2264,484,184,179,5,46,2,0.106145251,0,empty,CD-0722-1
"F2,F11",9725,10646,7341,3305,5165,2447,0,2450,1636,814,2.00982801,1399,1908,281,107,104,3,35,2,0.307692308,0,empty,CD-0722-1
"F2,F12",8855,9885,6465,3420,4570,2244,0,2248,1439,809,1.778739184,1297,266,53,12,9,3,7,1,0.333333333,0,empty,CD-0722-1
"F2,G1",767983,898920,572715,326205,415086,230173,1,230412,176607,53805,3.282352941,136457,166579,25433,8246,8101,145,1503,4,0.06048636,0,hg38,CD-0722-1
"F2,G2",6074,6561,4198,2363,3213,1695,0,1700,1105,595,1.857142857,992,430,77,27,26,1,15,1,0.115384615,0,empty,CD-0722-1
"F2,G3",10857,12007,8068,3939,5656,2887,0,2892,1731,1161,1.490956072,1601,2875,720,265,263,2,82,2,0.076045627,0,empty,CD-0722-1
"F2,G4",20834,23734,15197,8537,11054,6241,0,6245,3730,2515,1.483101392,3593,207,16,14,14,0,9,0,0.214285714,0,empty,CD-0722-1
"F2,G5",6495,7063,4795,2268,3392,1631,1,1634,1086,548,1.981751825,930,1848,427,161,159,2,55,1,0.06918239,0,empty,CD-0722-1
"F2,G6",843021,953667,643613,310054,434968,219229,1,219484,172540,46944,3.675443081,126509,12439,1264,433,427,6,114,2,0.112412178,0,hg38,CD-0722-1
"F2,G7",640245,740019,474823,265196,344895,187923,0,188093,155952,32141,4.852120345,110565,113808,26788,8139,8033,106,1407,4,0.031495083,0,hg38,CD-0722-1
"F2,G8",6231,6775,4578,2197,3278,1593,0,1600,1045,555,1.882882883,914,2070,525,168,168,0,44,0,0.196428571,0,empty,CD-0722-1
"F2,G9",6956,7567,5280,2287,3567,1700,0,1704,1078,626,1.722044728,931,2818,473,138,135,3,51,1,0.02962963,0,empty,CD-0722-1
"F2,G10",8875,10282,6527,3755,4927,2485,1,2491,1616,875,1.846857143,1503,3104,700,213,206,7,80,2,0.053398058,0,empty,CD-0722-1
"F2,G11",8613,9553,6534,3019,4520,2200,0,2200,1423,777,1.831402831,1241,1886,511,173,170,3,46,1,0.047058824,0,empty,CD-0722-1
"F2,G12",6701,7380,4871,2509,3535,1769,0,1770,1131,639,1.769953052,1041,2606,606,184,182,2,54,1,0,0,empty,CD-0722-1
"F2,H1",7542,8291,5630,2661,3907,1881,0,1883,1230,653,1.883614089,1096,1361,305,94,94,0,36,0,0.053191489,0,empty,CD-0722-1
"F2,H2",8274,9223,6138,3085,4309,2120,0,2122,1372,750,1.829333333,1236,2704,522,196,194,2,72,1,0.056701031,0,empty,CD-0722-1
"F2,H3",6847,7417,5034,2383,3532,1719,0,1719,1121,598,1.87458194,959,1234,205,66,65,1,34,1,0.184615385,0,empty,CD-0722-1
"F2,H4",10956,12205,8088,4117,5780,2906,0,2908,2004,904,2.216814159,1653,226,24,15,15,0,12,0,0.066666667,0,empty,CD-0722-1
"F2,H5",10467,11776,7770,4006,5479,2707,1,2717,1703,1014,1.679487179,1577,2541,622,203,199,4,48,1,0.120603015,0,empty,CD-0722-1
"F2,H6",6389,7244,4768,2476,3410,1695,0,1696,1129,567,1.991181658,998,2769,680,227,226,1,60,1,0.154867257,0,empty,CD-0722-1
"F2,H7",8222,9154,5979,3175,4251,2027,5,2035,1286,749,1.716955941,1198,2321,437,143,142,1,59,1,0.169014085,0,empty,CD-0722-1
"F2,H8",8304,9296,6119,3177,4360,2204,0,2208,1409,799,1.763454318,1255,2341,619,212,210,2,53,2,0.133333333,0,empty,CD-0722-1
"F2,H9",6850,7345,5193,2152,3483,1577,0,1577,1028,549,1.872495446,882,1064,198,85,82,3,28,1,0.085365854,0,empty,CD-0722-1
"F2,H10",5973,6746,4505,2241,3191,1572,0,1575,996,579,1.720207254,911,1132,245,101,98,3,32,2,0.020408163,0,empty,CD-0722-1
"F2,H11",7936,9061,5621,3440,4355,2614,0,2615,1392,1223,1.138184791,1520,100,30,14,14,0,3,0,0.071428571,0,empty,CD-0722-1
"F2,H12",6736,7660,4795,2865,3623,1920,0,1923,1289,634,2.033123028,1148,1871,323,110,109,1,42,1,0.018348624,0,empty,CD-0722-1
"F3,A1",7963,8671,5823,2848,4258,2201,1,2202,1445,757,1.908850727,1268,2285,358,157,151,6,54,2,0.218543046,0,empty,CD-0722-1
"F3,A2",11726,13206,8703,4503,6243,3225,1,3230,2035,1195,1.70292887,1888,2025,408,199,195,4,92,1,0.020512821,0,empty,CD-0722-1
"F3,A3",6774,7501,5031,2470,3635,1852,6,1859,1249,610,2.047540984,1078,1173,229,93,93,0,31,0,0.075268817,0,empty,CD-0722-1
"F3,A4",11289,12322,8427,3895,5845,2898,0,2899,1860,1039,1.790182868,1597,962,221,68,68,0,32,0,0.147058824,0,empty,CD-0722-1
"F3,A5",10556,11372,7940,3432,5493,2655,0,2658,1708,950,1.797894737,1459,2299,442,171,165,6,81,3,0.066666667,0,empty,CD-0722-1
"F3,A6",23060,25450,17464,7986,12360,5914,1,5921,4338,1583,2.740366393,3371,3035,646,265,260,5,107,2,0.023076923,0,empty,CD-0722-1
"F3,A7",7733,8462,5799,2663,4124,2136,0,2140,1404,736,1.907608696,1172,1484,300,149,149,0,71,0,0.073825503,0,empty,CD-0722-1
"F3,A8",4514,5123,3388,1735,2461,1285,0,1286,867,419,2.069212411,740,2289,289,134,132,2,61,1,0.098484848,0,empty,CD-0722-1
"F3,A9",7995,8834,5979,2855,4173,2009,4,2018,1351,667,2.025487256,1120,2525,551,220,217,3,84,1,0.02764977,0,empty,CD-0722-1
"F3,A10",9707,10612,7352,3260,5031,2435,0,2444,1499,945,1.586243386,1376,545,168,67,66,1,28,1,0.166666667,0,empty,CD-0722-1
"F3,A11",7396,8240,5679,2561,3989,1903,0,1910,1271,639,1.989045383,1072,2158,404,128,120,8,63,2,0.075,0,empty,CD-0722-1
"F3,A12",9802,10386,7452,2934,5000,2338,0,2341,1452,889,1.633295838,1304,3869,887,301,300,1,91,1,0.113333333,0,empty,CD-0722-1
"F3,B1",800893,896347,612495,283852,409071,205048,6,205272,159089,46183,3.444752398,116314,100735,12175,4041,3956,85,753,5,0.071789687,0,hg38,CD-0722-1
"F3,B2",9244,10507,6282,4225,4957,2711,0,2713,1691,1022,1.654598826,1707,636,161,51,51,0,23,0,0.254901961,0,empty,CD-0722-1
"F3,B3",10025,11105,7350,3755,5439,2762,0,2764,1952,812,2.403940887,1577,1768,476,181,180,1,50,1,0.083333333,0,empty,CD-0722-1
"F3,B4",1472589,1740967,1084818,656149,794195,447786,7,448268,369174,79094,4.667534832,268896,158517,25129,7988,7821,167,1424,7,0.059711034,0,hg38,CD-0722-1
"F3,B5",7680,4195,2523,1672,2695,1437,2,1460,970,490,1.979591837,936,973,190,80,79,1,27,1,0.063291139,0,empty,CD-0722-1
"F3,B6",8763,9810,6485,3325,4786,2531,0,2537,1574,963,1.634475597,1491,2099,434,126,125,1,38,1,0.112,0,empty,CD-0722-1
"F3,B7",10225,10153,6900,3253,4794,2346,0,2347,1536,811,1.893958076,1345,2100,378,129,127,2,40,2,0.188976378,0,empty,CD-0722-1
"F3,B8",6125,6836,4526,2310,3273,1569,1,1570,1054,516,2.042635659,910,1491,467,188,187,1,61,1,0.331550802,0,empty,CD-0722-1
"F3,B9",261924,336904,178562,158342,167753,117957,0,118051,84027,34024,2.469639078,75077,2566,601,197,197,0,67,0,0.030456853,0,hg38,CD-0722-1
"F3,B10",5967,6542,4234,2308,3304,1665,0,1669,1131,538,2.102230483,1003,651,122,47,43,4,18,1,0,0,empty,CD-0722-1
"F3,B11",12723,14433,9147,5286,6861,3845,0,3849,2148,1701,1.262786596,2274,243,28,19,19,0,15,0,0,0,empty,CD-0722-1
"F3,B12",7017,7511,5247,2264,3618,1749,0,1753,1138,615,1.850406504,952,1970,477,191,188,3,74,2,0.042553191,0,empty,CD-0722-1
"F3,C1",834087,932486,639753,292733,424639,210417,5,210680,160996,49684,3.240399324,119378,78821,12511,3808,3735,73,737,6,0.051137885,0,hg38,CD-0722-1
"F3,C2",11593,12888,8637,4251,6010,3105,0,3115,1959,1156,1.694636678,1782,2022,402,132,128,4,46,2,0.0390625,0,empty,CD-0722-1
"F3,C3",13909,15547,10379,5168,7607,3844,0,3846,2576,1270,2.028346457,2282,1241,251,110,110,0,42,0,0.190909091,0,empty,CD-0722-1
"F3,C4",7683,8644,5903,2741,4172,1992,0,1995,1298,697,1.862266858,1180,2216,497,199,198,1,66,1,0.075757576,0,empty,CD-0722-1
"F3,C5",2043351,2477307,1481862,995445,1113297,665334,7,666068,537424,128644,4.177606418,407492,193026,36518,11943,11763,180,1931,6,0.037915498,0,hg38,CD-0722-1
"F3,C6",9723,10899,7204,3695,5198,2662,0,2664,1753,911,1.924259056,1526,2087,385,157,154,3,80,2,0.019480519,0,empty,CD-0722-1
"F3,C7",12879,14934,9471,5463,7128,3987,5,3993,2488,1505,1.653156146,2368,587,67,36,34,2,23,2,0.117647059,0,empty,CD-0722-1
"F3,C8",14418,16145,10839,5306,7461,3742,0,3749,2476,1273,1.945011783,2118,2865,630,243,241,2,97,1,0.066390041,0,empty,CD-0722-1
"F3,C9",10115,11029,7585,3444,5215,2571,0,2577,1722,855,2.014035088,1392,1838,428,174,173,1,56,1,0.011560694,0,empty,CD-0722-1
"F3,C10",10628,11581,8018,3563,5520,2571,0,2574,1708,866,1.972286374,1460,2475,797,247,244,3,88,2,0.020491803,0,empty,CD-0722-1
"F3,C11",777038,905882,577060,328822,417275,224228,3,224464,175904,48560,3.622405272,133909,133129,20429,6673,6490,183,1286,7,0.041756549,0,hg38,CD-0722-1
"F3,C12",1478719,1750896,1053487,697409,792400,480736,15,481311,370618,110693,3.34816113,291019,82917,9187,2590,2500,90,605,3,0.0876,0,hg38,CD-0722-1
"F3,D1",12927,14902,9378,5524,6940,3793,1,3799,2316,1483,1.561699258,2268,1075,312,137,135,2,51,1,0.02962963,0,empty,CD-0722-1
"F3,D2",9834,10792,7491,3301,5140,2417,0,2418,1550,868,1.785714286,1349,3345,970,287,286,1,121,1,0.073426573,0,empty,CD-0722-1
"F3,D3",9528,10941,7043,3898,5146,2642,0,2645,1731,914,1.893873085,1577,1692,357,129,128,1,56,1,0.0234375,0,empty,CD-0722-1
"F3,D4",6905,7820,5173,2647,3706,1885,0,1885,1250,635,1.968503937,1082,1884,491,155,151,4,48,2,0.026490066,0,empty,CD-0722-1
"F3,D5",8431,9492,6279,3213,4424,2211,0,2216,1471,745,1.974496644,1282,2217,520,219,214,5,67,2,0.140186916,0,empty,CD-0722-1
"F3,D6",11699,13184,8430,4754,6091,3286,0,3290,1969,1321,1.490537472,1917,1479,336,151,150,1,61,1,0.013333333,0,empty,CD-0722-1
"F3,D7",6750,7425,5195,2230,3589,1724,0,1725,1160,565,2.053097345,998,2134,484,189,189,0,65,0,0.074074074,0,empty,CD-0722-1
"F3,D8",9378,10259,7099,3160,4917,2409,1,2413,1509,904,1.669247788,1377,1601,349,156,153,3,62,1,0.006535948,0,empty,CD-0722-1
"F3,D9",4717,5288,3554,1734,2491,1182,0,1182,786,396,1.984848485,648,2284,484,207,207,0,74,0,0.028985507,0,empty,CD-0722-1
"F3,D10",8114,8930,5967,2963,4153,2116,0,2117,1305,812,1.607142857,1213,819,203,86,80,6,29,1,0,0,empty,CD-0722-1
"F3,D11",9553,10580,7214,3366,5123,2505,0,2508,1591,917,1.735005453,1416,4207,1182,431,428,3,161,2,0.077102804,0,empty,CD-0722-1
"F3,D12",11557,12749,8551,4198,6094,3128,0,3129,2031,1098,1.849726776,1807,3354,667,267,264,3,108,1,0.03030303,0,empty,CD-0722-1
"F3,E1",992057,1150857,741964,408893,522295,282612,2,282925,223286,59639,3.74395949,165832,176093,31715,10266,10121,145,1653,6,0.087540757,0,hg38,CD-0722-1
"F3,E2",10597,11628,7811,3817,5599,2815,0,2818,1760,1058,1.663516068,1622,2553,376,163,161,2,63,2,0.037267081,0,empty,CD-0722-1
"F3,E3",7192,7963,5465,2498,3700,1773,0,1777,1198,579,2.069084629,982,2796,733,239,233,6,79,1,0.025751073,0,empty,CD-0722-1
"F3,E4",2314697,2572519,1791115,781404,1137378,574407,5,575099,453693,121406,3.736989935,323288,412856,53261,17765,17356,409,2554,11,0.055139433,0,hg38,CD-0722-1
"F3,E5",857198,992213,644628,347585,454876,242591,0,242815,189492,53323,3.553663522,142227,119674,20489,6701,6592,109,1187,5,0.047026699,0,hg38,CD-0722-1
"F3,E6",14613,16210,10759,5451,7653,3894,0,3899,2553,1346,1.896731055,2243,3666,733,300,294,6,89,2,0.115646259,0,empty,CD-0722-1
"F3,E7",1215492,1339293,936788,402505,606976,296936,4,297278,238322,58956,4.042370581,167028,105027,15396,4839,4732,107,961,7,0.036770921,0,hg38,CD-0722-1
"F3,E8",11048,11930,8646,3284,5668,2566,0,2571,1620,951,1.703470032,1373,2650,365,152,152,0,61,0,0.059210526,0,empty,CD-0722-1
"F3,E9",559348,651775,422350,229425,302572,158759,2,158908,122988,35920,3.423942094,93776,169288,23430,7979,7788,191,1357,6,0.087955829,0,hg38,CD-0722-1
"F3,E10",7891,8551,6054,2497,4016,1903,0,1906,1270,636,1.996855346,1013,1913,558,232,228,4,78,2,0.109649123,0,empty,CD-0722-1
"F3,E11",9825,10682,7296,3386,5095,2571,0,2573,1601,972,1.647119342,1428,2056,474,151,150,1,63,1,0.12,0,empty,CD-0722-1
"F3,E12",825225,993453,601428,392025,456947,262338,0,262581,215449,47132,4.57118306,161021,126467,18728,6057,5937,120,1206,5,0.037561058,0,hg38,CD-0722-1
"F3,F1",11584,12717,8747,3970,6100,2977,0,2984,1881,1103,1.705349048,1703,2460,634,208,205,3,72,1,0.043902439,0,empty,CD-0722-1
"F3,F2",765834,899215,560452,338763,414788,230760,2,230982,190261,40721,4.672306672,139426,196254,29383,9284,9071,213,1604,6,0.0540183,0,hg38,CD-0722-1
"F3,F3",1624230,1894031,1196196,697835,860653,484168,0,484700,399155,85545,4.66602373,289117,433853,68714,23050,22551,499,3029,11,0.070285131,0,hg38,CD-0722-1
"F3,F4",14444,15309,10678,4631,7247,3458,2,3465,2313,1152,2.0078125,1923,728,84,42,42,0,34,0,0.047619048,0,empty,CD-0722-1
"F3,F5",826766,959229,609295,349934,436917,241816,3,242101,190431,51670,3.685523515,143338,149614,24714,8127,7946,181,1375,7,0.05373773,0,hg38,CD-0722-1
"F3,F6",11653,13149,8593,4556,6315,3276,0,3279,2124,1155,1.838961039,1903,3103,668,225,223,2,101,1,0.098654709,0,empty,CD-0722-1
"F3,F7",13230,14492,10017,4475,7003,3442,0,3446,2246,1200,1.871666667,1916,1567,289,122,120,2,52,2,0.225,0,empty,CD-0722-1
"F3,F8",8437,9559,6289,3270,4490,2233,0,2239,1401,838,1.671837709,1298,223,42,20,20,0,14,0,0,0,empty,CD-0722-1
"F3,F9",9720,10722,7324,3398,4982,2334,3,2340,1539,801,1.921348315,1337,3536,865,327,321,6,101,2,0.040498442,0,empty,CD-0722-1
"F3,F10",11835,13119,9052,4067,6154,2977,2,2981,1877,1104,1.700181159,1638,1724,450,163,161,2,57,1,0.031055901,0,empty,CD-0722-1
"F3,F11",10013,10977,7594,3383,5118,2366,0,2373,1562,811,1.926017263,1312,1716,273,116,113,3,48,1,0.017699115,0,empty,CD-0722-1
"F3,F12",10986,12041,8083,3958,5703,2797,0,2803,1870,933,2.004287245,1638,233,26,10,10,0,6,0,0.1,0,empty,CD-0722-1
"F3,G1",11967,13217,9009,4208,6279,2994,0,2996,1949,1047,1.861509074,1724,3863,886,320,315,5,127,2,0.114285714,0,empty,CD-0722-1
"F3,G2",6794,7401,4871,2530,3472,1806,0,1809,1165,644,1.809006211,1051,419,99,32,30,2,22,2,0.066666667,0,empty,CD-0722-1
"F3,G3",14043,15119,10379,4740,7394,3768,0,3775,2388,1387,1.721701514,2046,3095,606,241,239,2,116,1,0.037656904,0,empty,CD-0722-1
"F3,G4",3348246,3869575,2515110,1354465,1691515,947650,8,948768,799394,149374,5.351627459,555512,1895,171,64,59,5,27,1,0.101694915,0,empty,CD-0722-1
"F3,G5",7530,8385,5619,2766,4128,2105,0,2108,1350,758,1.781002639,1202,1909,476,184,183,1,71,1,0.087431694,0,empty,CD-0722-1
"F3,G6",11000,12078,8322,3756,5625,2737,1,2741,1819,922,1.972885033,1505,129,9,7,7,0,6,0,0,0,empty,CD-0722-1
"F3,G7",10435,11531,7892,3639,5497,2648,0,2652,1640,1012,1.62055336,1448,2747,645,231,231,0,88,0,0.173160173,0,empty,CD-0722-1
"F3,G8",7013,7806,5210,2596,3735,1911,0,1915,1271,644,1.973602484,1077,1514,345,132,132,0,46,0,0.106060606,0,empty,CD-0722-1
"F3,G9",7896,8844,5917,2927,4148,2036,0,2040,1358,682,1.991202346,1148,2934,683,267,259,8,98,1,0.127413127,0,empty,CD-0722-1
"F3,G10",9622,10447,7234,3213,5065,2509,1,2512,1637,875,1.870857143,1389,2984,650,272,268,4,113,1,0.074626866,0,empty,CD-0722-1
"F3,G11",9989,10919,7639,3280,5238,2528,0,2532,1643,889,1.848143982,1330,1812,421,167,164,3,71,2,0.036585366,0,empty,CD-0722-1
"F3,G12",8093,8973,6005,2968,4227,2115,0,2118,1372,746,1.839142091,1202,2826,549,216,212,4,72,1,0,0,empty,CD-0722-1
"F3,H1",9112,10107,6788,3319,4752,2337,3,2341,1496,845,1.770414201,1380,1184,249,66,66,0,30,0,0.393939394,0,empty,CD-0722-1
"F3,H2",9503,10509,6980,3529,4893,2436,0,2443,1625,818,1.986552567,1385,2410,435,178,177,1,76,1,0.028248588,0,empty,CD-0722-1
"F3,H3",8156,8870,6157,2713,4143,2050,0,2050,1397,653,2.139356815,1151,1523,369,167,167,0,61,0,0.065868263,0,empty,CD-0722-1
"F3,H4",11741,12941,8867,4074,6113,3012,0,3015,1967,1048,1.876908397,1681,229,26,18,17,1,13,1,0.058823529,0,empty,CD-0722-1
"F3,H5",11909,12901,8954,3947,6025,2890,0,2896,1856,1040,1.784615385,1572,1865,391,146,144,2,44,1,0.076388889,0,empty,CD-0722-1
"F3,H6",7492,8748,5490,3258,4024,2139,0,2139,1436,703,2.042674253,1285,2082,573,162,158,4,52,2,0.050632911,0,empty,CD-0722-1
"F3,H7",9437,10455,7167,3288,4927,2371,0,2380,1630,750,2.173333333,1343,2610,590,201,201,0,79,0,0.014925373,0,empty,CD-0722-1
"F3,H8",17606,20023,13238,6785,9552,4824,0,4826,3383,1443,2.344421344,2819,2775,598,213,212,1,64,1,0.051886792,0,empty,CD-0722-1
"F3,H9",8040,8876,6166,2710,4221,2004,0,2008,1348,660,2.042424242,1150,1331,273,96,95,1,33,1,0.042105263,0,empty,CD-0722-1
"F3,H10",9140,10018,6875,3143,4818,2336,0,2338,1685,653,2.580398162,1301,1745,285,88,87,1,39,1,0.195402299,0,empty,CD-0722-1
"F3,H11",9112,10702,6290,4412,5076,3042,0,3044,1630,1414,1.152758133,1837,138,44,13,13,0,4,0,0,0,empty,CD-0722-1
"F3,H12",8162,9073,6136,2937,4309,2179,0,2183,1442,741,1.946018893,1252,1688,314,132,131,1,50,1,0.145038168,0,empty,CD-0722-1
"F4,A1",8841,10048,6431,3617,4945,2604,0,2608,1649,959,1.719499479,1543,1301,289,78,77,1,27,1,0.207792208,0,empty,CD-0722-1
"F4,A2",15039,16928,11056,5872,8090,4203,0,4218,2769,1449,1.910973085,2473,1766,447,166,165,1,51,1,0.012121212,0,empty,CD-0722-1
"F4,A3",8114,9034,6092,2942,4294,2126,0,2131,1344,787,1.707750953,1246,1172,393,150,149,1,38,1,0.046979866,0,empty,CD-0722-1
"F4,A4",13720,14637,10391,4246,7086,3434,0,3437,2191,1246,1.758426966,1817,889,152,55,55,0,23,0,0.145454545,0,empty,CD-0722-1
"F4,A5",12776,14005,9532,4473,6775,3326,1,3333,2154,1179,1.82697201,1860,1817,347,154,154,0,60,0,0.006493506,0,empty,CD-0722-1
"F4,A6",13702,15931,10260,5671,7684,4054,0,4054,2756,1298,2.123266564,2384,2331,517,180,174,6,60,3,0.172413793,0,empty,CD-0722-1
"F4,A7",9042,9841,6678,3163,4790,2436,0,2437,1561,876,1.78196347,1379,1243,373,132,131,1,42,1,0.061068702,0,empty,CD-0722-1
"F4,A8",5418,6024,4087,1937,3012,1518,0,1518,1010,508,1.988188976,863,1246,264,102,99,3,40,1,0.060606061,0,empty,CD-0722-1
"F4,A9",9827,11075,7456,3619,5231,2558,0,2566,1724,842,2.047505938,1446,2414,558,169,167,2,63,1,0.095808383,0,empty,CD-0722-1
"F4,A10",15226,17184,11471,5713,8248,4358,0,4358,2960,1398,2.117310443,2468,461,96,44,44,0,19,0,0.045454545,0,empty,CD-0722-1
"F4,A11",3202996,3679974,2464651,1215323,1608530,872423,11,873364,708898,164466,4.310301217,499003,254704,35921,11870,11629,241,1897,6,0.058818471,0,hg38,CD-0722-1
"F4,A12",12284,13187,9305,3882,6307,2935,0,2942,1974,968,2.039256198,1630,4054,694,219,209,10,78,3,0.043062201,0,empty,CD-0722-1
"F4,B1",9634,10647,7151,3496,5062,2588,0,2588,1675,913,1.834611172,1464,1084,315,91,91,0,33,0,0.10989011,0,empty,CD-0722-1
"F4,B2",1484562,1731514,1004517,726997,804265,478458,5,478886,399289,79597,5.016382527,299755,30434,6016,1909,1884,25,401,3,0.064755839,0,hg38,CD-0722-1
"F4,B3",11848,14277,8673,5604,6827,3626,3,3639,2513,1126,2.231793961,2240,1464,336,117,111,6,41,1,0.171171171,0,empty,CD-0722-1
"F4,B4",10799,12348,7867,4481,6022,3265,0,3267,2074,1193,1.738474434,1962,1566,265,128,126,2,45,1,0.031746032,0,empty,CD-0722-1
"F4,B5",856433,439317,249384,189933,285677,158723,11,160025,118679,41346,2.870386494,107341,67770,9189,3119,3051,68,620,2,0.045231072,0,hg38,CD-0722-1
"F4,B6",11326,13022,8300,4722,6204,3350,0,3352,2057,1295,1.588416988,2010,1450,332,130,129,1,45,1,0.139534884,0,empty,CD-0722-1
"F4,B7",9882,10971,7637,3334,5233,2554,0,2558,1689,869,1.943613349,1419,938,230,96,96,0,28,0,0.020833333,0,empty,CD-0722-1
"F4,B8",646074,798883,472241,326642,370430,221048,1,221254,172646,48608,3.551802172,136284,6660,1757,549,545,4,160,2,0.044036697,0,hg38,CD-0722-1
"F4,B9",13762,15342,10142,5200,7369,3931,0,3940,2465,1475,1.671186441,2273,1155,318,93,91,2,26,2,0.065934066,0,empty,CD-0722-1
"F4,B10",7362,7961,5247,2714,3920,1986,0,1992,1277,715,1.786013986,1177,416,109,44,43,1,11,1,0.093023256,0,empty,CD-0722-1
"F4,B11",16383,18649,11901,6748,8550,4652,0,4658,2657,2001,1.327836082,2789,248,14,9,9,0,8,0,0,0,empty,CD-0722-1
"F4,B12",9334,10319,6958,3361,4942,2423,0,2424,1667,757,2.202113606,1341,1728,328,147,143,4,46,2,0.020979021,0,empty,CD-0722-1
"F4,C1",1360770,1660004,996886,663118,751051,448903,1,449334,350230,99104,3.53396432,275367,8934,3160,998,994,4,290,3,0.014084507,0,hg38,CD-0722-1
"F4,C2",14192,15775,10498,5277,7169,3691,0,3700,2357,1343,1.755026061,2087,1611,337,134,130,4,45,3,0.038461538,0,empty,CD-0722-1
"F4,C3",14805,16611,11012,5599,8016,4015,0,4020,2665,1355,1.966789668,2275,666,132,57,56,1,25,1,0.071428571,0,empty,CD-0722-1
"F4,C4",10003,10957,7482,3475,5201,2495,1,2500,1588,912,1.74122807,1430,1323,277,96,96,0,39,0,0.197916667,0,empty,CD-0722-1
"F4,C5",14464,16492,10724,5768,7853,4028,0,4037,2797,1240,2.255645161,2312,1900,398,154,153,1,61,1,0.013071895,0,empty,CD-0722-1
"F4,C6",12080,13472,9010,4462,6631,3376,1,3379,2166,1213,1.7856554,1959,1589,447,152,149,3,60,1,0.020134228,0,empty,CD-0722-1
"F4,C7",15522,17833,11127,6706,8468,4738,0,4743,2891,1852,1.561015119,2833,404,72,43,43,0,19,0,0,0,empty,CD-0722-1
"F4,C8",18157,20078,13511,6567,9491,4746,0,4755,3084,1671,1.845601436,2738,2987,708,239,237,2,79,1,0.021097046,0,empty,CD-0722-1
"F4,C9",27024,32127,20423,11704,14308,7297,0,7312,4990,2322,2.149009475,4410,2713,453,174,167,7,59,2,0.089820359,0,empty,CD-0722-1
"F4,C10",13334,14706,10246,4460,6983,3349,0,3356,2198,1158,1.898100173,1892,2422,480,162,159,3,42,1,0.132075472,0,empty,CD-0722-1
"F4,C11",11843,13089,8830,4259,6308,3135,0,3139,1962,1177,1.666949873,1823,2185,575,180,180,0,58,0,0.166666667,0,empty,CD-0722-1
"F4,C12",16591,18644,12286,6358,8916,4433,0,4441,2986,1455,2.052233677,2616,1828,304,115,114,1,45,1,0.035087719,0,empty,CD-0722-1
"F4,D1",15367,18017,10986,7031,8340,4618,0,4621,2804,1817,1.543203082,2801,884,211,68,68,0,29,0,0.014705882,0,empty,CD-0722-1
"F4,D2",11895,12731,9097,3634,6032,2831,0,2836,1867,969,1.926728586,1523,2506,564,197,197,0,81,0,0.035532995,0,empty,CD-0722-1
"F4,D3",11955,13340,8770,4570,6557,3388,0,3390,2286,1104,2.070652174,2008,1555,302,104,103,1,45,1,0.009708738,0,empty,CD-0722-1
"F4,D4",622119,681370,485301,196069,317560,150021,2,150196,113823,36373,3.129326698,82961,34240,5981,1808,1775,33,383,3,0.051267606,0,hg38,CD-0722-1
"F4,D5",10200,11435,7563,3872,5589,2809,1,2814,1909,905,2.109392265,1633,1589,442,129,128,1,45,1,0.0078125,0,empty,CD-0722-1
"F4,D6",14633,16429,10439,5990,7764,4240,0,4245,2595,1650,1.572727273,2542,1667,497,183,176,7,46,1,0.073863636,0,empty,CD-0722-1
"F4,D7",8587,8920,6299,2621,4408,2061,0,2062,1325,737,1.797829037,1131,1613,513,195,195,0,53,0,0.097435897,0,empty,CD-0722-1
"F4,D8",10194,11662,7790,3872,5500,2665,0,2673,1692,981,1.724770642,1506,1567,393,141,141,0,54,0,0.028368794,0,empty,CD-0722-1
"F4,D9",6171,6855,4609,2246,3303,1595,0,1597,1099,498,2.206827309,912,2205,370,136,135,1,53,1,0.162962963,0,empty,CD-0722-1
"F4,D10",8808,9718,6501,3217,4599,2365,0,2368,1469,899,1.63403782,1360,762,97,37,37,0,16,0,0.054054054,0,empty,CD-0722-1
"F4,D11",12171,13393,9175,4218,6521,3191,0,3193,2134,1059,2.015108593,1814,3283,555,241,237,4,88,1,0.046413502,0,empty,CD-0722-1
"F4,D12",13629,15557,10300,5257,7377,3710,3,3713,2438,1275,1.912156863,2136,3100,674,250,248,2,87,2,0.084677419,0,empty,CD-0722-1
"F4,E1",18477,20253,13852,6401,9644,4770,0,4777,3162,1615,1.957894737,2722,2941,558,226,226,0,71,0,0.10619469,0,empty,CD-0722-1
"F4,E2",12646,14215,9313,4902,6869,3484,1,3492,2211,1281,1.725995316,2084,1968,606,194,194,0,52,0,0.144329897,0,empty,CD-0722-1
"F4,E3",8749,9693,6663,3030,4647,2280,0,2282,1530,752,2.034574468,1257,2564,589,151,147,4,58,2,0.020408163,0,empty,CD-0722-1
"F4,E4",1120188,1359292,813977,545315,614980,359394,2,359742,292838,66904,4.376987923,220380,132234,18335,6231,6085,146,1196,5,0.063599014,0,hg38,CD-0722-1
"F4,E5",9831,10656,7556,3100,5143,2380,0,2381,1570,811,1.935881628,1288,1259,235,78,76,2,33,1,0,0,empty,CD-0722-1
"F4,E6",18268,20535,13635,6900,9669,4909,0,4918,3113,1805,1.72465374,2899,2814,605,265,263,2,75,2,0.068441065,0,empty,CD-0722-1
"F4,E7",17857,20100,13367,6733,9437,4628,0,4636,3049,1587,1.921235035,2653,2785,706,261,258,3,88,3,0.19379845,0,empty,CD-0722-1
"F4,E8",12745,14064,9847,4217,6548,3030,0,3036,2041,995,2.051256281,1657,3366,843,284,282,2,104,1,0.031914894,0,empty,CD-0722-1
"F4,E9",9455,10409,7119,3290,5063,2520,1,2530,1636,894,1.829977629,1435,2369,473,161,159,2,65,1,0.044025157,0,empty,CD-0722-1
"F4,E10",9670,10637,7358,3279,5050,2404,0,2413,1597,816,1.957107843,1375,1797,428,150,144,6,57,2,0.118055556,0,empty,CD-0722-1
"F4,E11",11944,13032,8889,4143,6226,3104,0,3110,1962,1148,1.709059233,1748,2229,406,154,153,1,49,1,0.261437908,0,empty,CD-0722-1
"F4,E12",795147,905005,598359,306646,420019,218477,0,218677,170546,48131,3.543371216,128450,26004,6032,1925,1874,51,427,2,0.029882604,0,hg38,CD-0722-1
"F4,F1",14955,16415,11047,5368,7705,3767,0,3774,2447,1327,1.844009043,2216,2396,457,150,150,0,57,0,0.166666667,0,empty,CD-0722-1
"F4,F2",12724,13930,9442,4488,6750,3269,0,3269,2140,1129,1.895482728,1875,2932,724,233,231,2,85,1,0.004329004,0,empty,CD-0722-1
"F4,F3",2355465,2771134,1762199,1008935,1232003,696314,5,697042,568721,128321,4.432018142,413957,488018,50659,17080,16477,603,2654,12,0.085695212,0,hg38,CD-0722-1
"F4,F4",1215163,1389655,912885,476770,632241,337338,13,337739,262551,75188,3.491926903,196149,32508,4135,1406,1382,24,337,3,0.045586107,0,hg38,CD-0722-1
"F4,F5",12419,13462,9359,4103,6399,2961,3,2968,1967,1001,1.965034965,1645,1387,410,157,157,0,44,0,0.089171975,0,empty,CD-0722-1
"F4,F6",14790,16422,10873,5549,7737,3987,0,3987,2670,1317,2.027334852,2313,2293,446,170,169,1,72,1,0.147928994,0,empty,CD-0722-1
"F4,F7",985087,1214351,676443,537908,558814,375671,3,375999,258720,117279,2.206021538,231338,1084,319,106,105,1,51,1,0.019047619,0,hg38,CD-0722-1
"F4,F8",10100,11110,7672,3438,5303,2552,0,2556,1662,894,1.859060403,1459,171,17,6,6,0,5,0,0,0,empty,CD-0722-1
"F4,F9",11894,13106,8963,4143,6212,2992,0,2997,1989,1008,1.973214286,1694,2874,651,207,202,5,57,2,0.252475248,0,empty,CD-0722-1
"F4,F10",14052,15448,10734,4714,7206,3405,0,3411,2227,1184,1.880912162,1890,1524,319,68,66,2,31,1,0.03030303,0,empty,CD-0722-1
"F4,F11",1058486,1208939,806087,402852,540477,282164,3,282474,222360,60114,3.698971953,162844,155951,19726,6732,6557,175,1223,6,0.112551472,0,hg38,CD-0722-1
"F4,F12",13142,14548,9872,4676,6649,3178,0,3190,2089,1101,1.897366031,1801,135,26,7,7,0,5,0,0,0,empty,CD-0722-1
"F4,G1",1055028,1277832,741213,536619,585545,379857,5,380289,287555,92734,3.100858369,228471,24417,1165,450,431,19,160,3,0.199535963,0,hg38,CD-0722-1
"F4,G2",790943,874745,583137,291608,404666,207639,1,207873,157965,49908,3.165123828,120906,14504,2311,719,702,17,161,2,0.04985755,0,hg38,CD-0722-1
"F4,G3",15532,17067,11566,5501,8218,4225,0,4227,2637,1590,1.658490566,2352,2144,524,192,191,1,69,1,0.010471204,0,empty,CD-0722-1
"F4,G4",27244,31044,19780,11264,14696,8161,0,8162,4995,3167,1.5772024,4830,221,54,19,19,0,12,0,0.052631579,0,empty,CD-0722-1
"F4,G5",9601,10673,6955,3718,5094,2567,0,2567,1697,870,1.950574713,1551,1646,456,179,174,5,60,2,0.017241379,0,empty,CD-0722-1
"F4,G6",12828,13959,9527,4432,6648,3329,0,3338,2206,1132,1.948763251,1860,138,54,29,28,1,7,1,0,0,empty,CD-0722-1
"F4,G7",11718,12677,8986,3691,6119,2845,0,2854,1888,966,1.954451346,1560,2357,572,208,206,2,64,2,0.140776699,0,empty,CD-0722-1
"F4,G8",8005,8984,5965,3019,4167,2100,0,2103,1330,773,1.720569211,1231,1803,367,129,129,0,34,0,0.139534884,0,empty,CD-0722-1
"F4,G9",9853,10894,7425,3469,5241,2574,4,2585,1666,919,1.812840044,1449,2217,402,158,157,1,58,1,0.089171975,0,empty,CD-0722-1
"F4,G10",12949,14560,9702,4858,7135,3705,0,3709,2398,1311,1.829138063,2175,2663,618,224,223,1,71,1,0.080717489,0,empty,CD-0722-1
"F4,G11",12322,13962,9311,4651,6564,3202,0,3207,2086,1121,1.860838537,1796,1016,281,93,93,0,47,0,0,0,empty,CD-0722-1
"F4,G12",9639,10790,7079,3711,5073,2623,1,2624,1689,935,1.806417112,1522,2079,416,170,166,4,57,2,0.072289157,0,empty,CD-0722-1
"F4,H1",10602,11468,7911,3557,5437,2615,1,2619,1761,858,2.052447552,1464,996,228,68,67,1,27,1,0,0,empty,CD-0722-1
"F4,H2",11024,12737,8252,4485,5883,2964,2,2971,1933,1038,1.862235067,1772,2038,514,176,175,1,47,1,0.005714286,0,empty,CD-0722-1
"F4,H3",10212,11573,7570,4003,5335,2737,0,2741,1849,892,2.072869955,1584,1611,346,124,122,2,41,1,0.073770492,0,empty,CD-0722-1
"F4,H4",14490,16048,10956,5092,7572,3717,0,3717,2428,1289,1.883630721,2122,165,27,7,7,0,7,0,0,0,empty,CD-0722-1
"F4,H5",14754,16540,11027,5513,7729,3935,0,3942,2554,1388,1.840057637,2220,1423,402,147,144,3,38,1,0.111111111,0,empty,CD-0722-1
"F4,H6",9572,10746,7146,3600,5014,2596,0,2602,1763,839,2.101311085,1491,1636,384,118,116,2,49,2,0.034482759,0,empty,CD-0722-1
"F4,H7",11368,12208,8396,3812,5942,2857,1,2859,1871,988,1.893724696,1584,2540,450,148,143,5,60,2,0.055944056,0,empty,CD-0722-1
"F4,H8",18201,22042,12893,9149,10494,6440,0,6450,3443,3007,1.144995012,3983,1941,397,174,172,2,53,2,0.005813953,0,empty,CD-0722-1
"F4,H9",9900,10787,7594,3193,5079,2330,0,2338,1559,779,2.001283697,1311,1389,267,95,92,3,29,2,0.163043478,0,empty,CD-0722-1
"F4,H10",8675,9383,6593,2790,4414,2128,0,2133,1392,741,1.87854251,1187,1244,279,82,82,0,25,0,0.024390244,0,empty,CD-0722-1
"F4,H11",11631,13523,8366,5157,6326,3800,0,3804,2089,1715,1.218075802,2257,43,10,8,8,0,6,0,0.375,0,empty,CD-0722-1
"F4,H12",11450,12827,8318,4509,6168,3248,0,3250,2166,1084,1.998154982,1926,1760,326,108,106,2,37,1,0.018867925,0,empty,CD-0722-1
"F5,A1",1533021,1759199,1146114,613085,803895,452195,2,452648,357862,94786,3.775473171,262426,126224,16741,5328,5148,180,1057,6,0.036907537,0,hg38,CD-0722-1
"F5,A2",12835,14110,9445,4665,6876,3555,0,3558,2390,1168,2.046232877,2084,1904,428,173,172,1,51,1,0.063953488,0,empty,CD-0722-1
"F5,A3",6882,7401,5119,2282,3516,1734,0,1736,1132,604,1.874172185,963,1152,256,93,92,1,29,1,0.065217391,0,empty,CD-0722-1
"F5,A4",11600,12492,8678,3814,5991,2963,6,2973,1872,1101,1.70027248,1652,723,181,65,63,2,32,1,0.015873016,0,empty,CD-0722-1
"F5,A5",11399,12791,8470,4321,6039,2969,0,2972,1906,1066,1.787992495,1712,1930,470,150,149,1,56,1,0.134228188,0,empty,CD-0722-1
"F5,A6",9890,11259,7392,3867,5441,2831,0,2834,1848,986,1.874239351,1618,2808,742,232,230,2,72,2,0.017391304,0,empty,CD-0722-1
"F5,A7",8291,9254,6160,3094,4444,2324,0,2326,1534,792,1.936868687,1325,1432,274,105,104,1,38,1,0.019230769,0,empty,CD-0722-1
"F5,A8",4934,5530,3623,1907,2627,1352,0,1352,924,428,2.158878505,786,2066,569,165,164,1,47,1,0,0,empty,CD-0722-1
"F5,A9",9697,10907,7381,3526,5102,2518,0,2527,1689,838,2.015513126,1456,1670,394,172,172,0,61,0,0.069767442,0,empty,CD-0722-1
"F5,A10",10668,11868,8104,3764,5618,2803,0,2810,1756,1054,1.666034156,1561,534,143,48,48,0,16,0,0.208333333,0,empty,CD-0722-1
"F5,A11",8041,8994,6096,2898,4327,2070,3,2075,1411,664,2.125,1169,1952,450,134,133,1,48,1,0.105263158,0,empty,CD-0722-1
"F5,A12",10787,11887,8100,3787,5657,2764,0,2771,1743,1028,1.695525292,1615,2787,833,241,236,5,70,3,0.131355932,0,empty,CD-0722-1
"F5,B1",841319,971594,626251,345343,441346,240818,5,241061,199167,41894,4.754069795,140665,152541,25974,8549,8404,145,1424,5,0.065445026,0,hg38,CD-0722-1
"F5,B2",8677,9550,6046,3504,4585,2452,0,2458,1577,881,1.790011351,1463,642,94,47,47,0,18,0,0,0,empty,CD-0722-1
"F5,B3",7025,7996,5199,2797,3828,1928,8,1939,1302,637,2.043956044,1152,2090,259,100,99,1,34,1,0.141414141,0,empty,CD-0722-1
"F5,B4",9419,10771,6944,3827,5343,2878,0,2880,1825,1055,1.72985782,1709,1639,365,144,143,1,50,1,0.090909091,0,empty,CD-0722-1
"F5,B5",13499,11067,6626,4441,5944,3274,0,3288,2398,890,2.694382022,2060,1132,271,102,99,3,31,1,0.101010101,0,empty,CD-0722-1
"F5,B6",9844,10840,7180,3660,5137,2699,0,2704,1655,1049,1.577693041,1570,1630,422,159,159,0,47,0,0.106918239,0,empty,CD-0722-1
"F5,B7",8531,9314,6542,2772,4612,2300,2,2311,1506,805,1.870807453,1308,1300,310,86,86,0,28,0,0.11627907,0,empty,CD-0722-1
"F5,B8",6873,7881,5110,2771,3635,1789,1,1792,1204,588,2.047619048,1025,1257,291,101,101,0,43,0,0.01980198,0,empty,CD-0722-1
"F5,B9",11998,13341,8864,4477,6275,3271,0,3272,2097,1175,1.784680851,1847,1143,363,97,93,4,24,3,0.247311828,0,empty,CD-0722-1
"F5,B10",6474,7240,4594,2646,3584,1823,0,1827,1162,665,1.747368421,1091,572,104,38,37,1,13,1,0.243243243,0,empty,CD-0722-1
"F5,B11",14640,16419,10675,5744,7697,4218,0,4220,2476,1744,1.419724771,2386,250,53,27,20,7,7,1,0.25,0,empty,CD-0722-1
"F5,B12",7807,9021,5786,3235,4311,2129,0,2129,1308,821,1.59317905,1273,1796,493,172,167,5,45,1,0.077844311,0,empty,CD-0722-1
"F5,C1",903638,1001469,697234,304235,455163,227671,0,227910,178838,49072,3.644400065,127541,14158,2371,679,669,10,172,2,0.02690583,0,hg38,CD-0722-1
"F5,C2",854019,981807,644831,336976,447579,233126,2,233403,176700,56703,3.116237236,137858,113997,14464,4695,4594,101,938,6,0.051806704,0,hg38,CD-0722-1
"F5,C3",12920,14405,9773,4632,6946,3472,0,3476,2265,1211,1.870355078,1998,1020,285,67,64,3,27,2,0.0625,0,empty,CD-0722-1
"F5,C4",9943,10957,7658,3299,5119,2455,0,2457,1663,794,2.094458438,1374,2483,519,196,192,4,56,2,0.041666667,0,empty,CD-0722-1
"F5,C5",12781,14639,9520,5119,6879,3532,1,3541,2347,1194,1.965661642,2082,1749,325,125,123,2,49,2,0.130081301,0,empty,CD-0722-1
"F5,C6",10451,11789,7747,4042,5795,2956,0,2958,1954,1004,1.946215139,1746,2317,545,197,197,0,64,0,0.060913706,0,empty,CD-0722-1
"F5,C7",818304,1019698,561704,457994,468602,315339,2,315652,223692,91960,2.432492388,195644,6678,354,142,139,3,46,1,0.273381295,0,hg38,CD-0722-1
"F5,C8",15671,17547,11656,5891,8214,4134,0,4136,2737,1399,1.956397427,2363,3782,940,289,287,2,81,1,0.108013937,0,empty,CD-0722-1
"F5,C9",828111,1018437,593564,424873,467812,280270,3,280563,228789,51774,4.41899409,175034,147442,21437,7143,6977,166,1188,6,0.088146768,0,hg38,CD-0722-1
"F5,C10",11477,12406,8857,3549,5882,2801,0,2807,1820,987,1.843971631,1499,2421,515,191,189,2,50,2,0.08994709,0,empty,CD-0722-1
"F5,C11",10231,11655,7564,4091,5573,2790,1,2797,1811,986,1.836713996,1654,2199,507,199,195,4,58,2,0.143589744,0,empty,CD-0722-1
"F5,C12",15015,16263,11384,4879,7602,3579,0,3590,2353,1237,1.9021827,2004,1823,411,148,147,1,47,1,0.108843537,0,empty,CD-0722-1
"F5,D1",13105,14739,9385,5354,7012,3831,0,3835,2390,1445,1.653979239,2247,884,275,92,92,0,29,0,0.076086957,0,empty,CD-0722-1
"F5,D2",9917,10556,7664,2892,4967,2291,0,2294,1480,814,1.818181818,1218,3446,942,331,331,0,88,0,0.027190332,0,empty,CD-0722-1
"F5,D3",10470,11448,7775,3673,5366,2686,1,2690,1787,903,1.978959025,1472,1930,369,134,132,2,60,2,0.166666667,0,empty,CD-0722-1
"F5,D4",7202,8147,5421,2726,3908,1900,0,1902,1226,676,1.813609467,1107,1424,312,110,108,2,42,1,0.083333333,0,empty,CD-0722-1
"F5,D5",8891,10182,6654,3528,4775,2477,0,2480,1660,820,2.024390244,1430,1640,279,114,111,3,45,2,0,0,empty,CD-0722-1
"F5,D6",12386,13753,8887,4866,6498,3435,0,3443,2131,1312,1.624237805,2069,1873,540,151,146,5,46,2,0.082191781,0,empty,CD-0722-1
"F5,D7",733692,859656,541733,317923,392235,218444,3,218643,173555,45088,3.849250355,130197,169899,26749,8804,8652,152,1415,7,0.072353213,0,hg38,CD-0722-1
"F5,D8",8978,9980,6719,3261,4765,2318,0,2323,1539,784,1.963010204,1319,1784,406,126,125,1,51,1,0.112,0,empty,CD-0722-1
"F5,D9",5225,5644,3927,1717,2709,1290,0,1291,901,390,2.31025641,720,2338,360,144,141,3,55,2,0.014184397,0,empty,CD-0722-1
"F5,D10",7933,8806,5886,2920,4121,2067,0,2069,1299,770,1.687012987,1176,738,141,46,45,1,12,1,0.022222222,0,empty,CD-0722-1
"F5,D11",10198,11241,7794,3447,5514,2653,0,2654,1750,904,1.935840708,1476,3239,826,261,258,3,94,1,0.034883721,0,empty,CD-0722-1
"F5,D12",11661,12680,8776,3904,6112,3001,0,3002,1952,1050,1.859047619,1700,3795,791,252,250,2,87,2,0.08,0,empty,CD-0722-1
"F5,E1",1394142,1611722,1064586,547136,721111,386265,3,386746,313080,73666,4.249993213,222777,299910,50770,16452,16134,318,2283,10,0.07084418,0,hg38,CD-0722-1
"F5,E2",837789,976539,622633,353906,448867,238626,2,238848,189546,49302,3.844590483,141737,5058,1396,429,420,9,194,2,0.021428571,0,hg38,CD-0722-1
"F5,E3",7444,8325,5709,2616,4024,2020,0,2022,1327,695,1.909352518,1141,2427,575,216,214,2,82,1,0.023364486,0,empty,CD-0722-1
"F5,E4",10737,11771,8083,3688,5602,2704,0,2710,1776,934,1.901498929,1495,2654,512,208,206,2,70,1,0.029126214,0,empty,CD-0722-1
"F5,E5",848199,976969,641795,335174,447502,238169,6,238454,185806,52648,3.529212886,137521,110430,19742,6455,6331,124,1078,4,0.087979782,0,hg38,CD-0722-1
"F5,E6",839123,940240,647721,292519,424045,209515,2,209768,151413,58355,2.594687687,118621,60653,8027,2577,2501,76,595,5,0.047980808,0,hg38,CD-0722-1
"F5,E7",15598,17411,11686,5725,8137,3908,0,3914,2623,1291,2.031758327,2286,2845,723,227,222,5,79,3,0.058558559,0,empty,CD-0722-1
"F5,E8",10990,11908,8445,3463,5652,2571,1,2574,1723,851,2.024676851,1447,3582,894,283,279,4,77,2,0.161290323,0,empty,CD-0722-1
"F5,E9",8780,9863,6536,3327,4702,2360,0,2365,1576,789,1.997465146,1356,2458,616,196,191,5,61,2,0.015706806,0,empty,CD-0722-1
"F5,E10",8282,9150,6282,2868,4367,2066,4,2071,1399,672,2.081845238,1186,2281,528,152,145,7,68,2,0.013793103,0,empty,CD-0722-1
"F5,E11",10393,11253,7758,3495,5439,2676,0,2679,1695,984,1.722560976,1501,2495,518,180,178,2,53,1,0.02247191,0,empty,CD-0722-1
"F5,E12",11582,13059,8664,4395,6237,3141,0,3148,2044,1104,1.851449275,1857,1694,335,126,123,3,50,2,0.113821138,0,empty,CD-0722-1
"F5,F1",12775,13656,9545,4111,6424,3138,0,3145,1994,1151,1.732406603,1729,2710,508,182,181,1,44,1,0.060773481,0,empty,CD-0722-1
"F5,F2",10766,11938,7954,3984,5777,2790,0,2799,1830,969,1.888544892,1651,3463,785,245,240,5,76,2,0.0375,0,empty,CD-0722-1
"F5,F3",10305,11294,7759,3535,5397,2666,0,2670,1746,924,1.88961039,1513,4520,948,359,357,2,93,1,0.067226891,0,empty,CD-0722-1
"F5,F4",14020,15164,10603,4561,7297,3483,1,3494,2327,1167,1.994001714,1923,791,119,48,48,0,26,0,0,0,empty,CD-0722-1
"F5,F5",11032,11521,8308,3213,5354,2462,0,2469,1611,858,1.877622378,1274,2414,588,207,206,1,49,1,0,0,empty,CD-0722-1
"F5,F6",13221,14713,9798,4915,6957,3541,0,3544,2366,1178,2.008488964,2038,2977,554,197,192,5,72,2,0.078125,0,empty,CD-0722-1
"F5,F7",13473,14890,10109,4781,7148,3531,0,3534,2362,1172,2.015358362,1977,1502,309,110,109,1,39,1,0.027522936,0,empty,CD-0722-1
"F5,F8",8972,9761,6947,2814,4562,2130,0,2133,1383,750,1.844,1143,336,82,17,17,0,7,0,0,0,empty,CD-0722-1
"F5,F9",10227,11087,7839,3248,5321,2478,0,2485,1713,772,2.218911917,1377,3029,688,256,253,3,74,2,0.023715415,0,empty,CD-0722-1
"F5,F10",11991,13020,9190,3830,6136,2878,0,2883,1902,981,1.93883792,1576,1763,566,171,170,1,44,1,0.011764706,0,empty,CD-0722-1
"F5,F11",11071,12223,8511,3712,5653,2590,1,2595,1715,880,1.948863636,1430,1563,274,102,101,1,35,1,0.158415842,0,empty,CD-0722-1
"F5,F12",10869,12010,8164,3846,5662,2823,0,2828,1867,961,1.94276795,1602,230,27,18,18,0,11,0,0.055555556,0,empty,CD-0722-1
"F5,G1",12202,13564,9103,4461,6500,3239,0,3244,2106,1138,1.850615114,1844,3096,867,285,263,22,96,2,0.053231939,0,empty,CD-0722-1
"F5,G2",654359,756487,465163,291324,353176,198554,1,198709,151259,47450,3.187755532,120047,38762,7617,2501,2466,35,510,3,0.031224655,0,hg38,CD-0722-1
"F5,G3",32998,36276,25696,10580,16680,7785,0,7798,5595,2203,2.539718566,4236,2885,654,257,250,7,96,2,0.04,0,empty,CD-0722-1
"F5,G4",23833,27321,17358,9963,12856,7024,0,7031,4420,2611,1.692837993,4111,257,37,24,24,0,10,0,0.208333333,0,empty,CD-0722-1
"F5,G5",8050,9098,5891,3207,4396,2243,0,2243,1491,752,1.982712766,1344,2065,437,154,154,0,47,0,0.181818182,0,empty,CD-0722-1
"F5,G6",11106,12316,8347,3969,5729,2804,1,2809,1914,895,2.138547486,1591,122,19,9,9,0,8,0,0,0,empty,CD-0722-1
"F5,G7",9855,10837,7538,3299,5171,2419,0,2419,1599,820,1.95,1370,2833,693,227,226,1,76,1,0.048672566,0,empty,CD-0722-1
"F5,G8",6887,7641,5232,2409,3636,1774,0,1779,1110,669,1.659192825,1029,1999,455,167,162,5,47,2,0.148148148,0,empty,CD-0722-1
"F5,G9",8430,9291,6337,2954,4330,2107,0,2110,1382,728,1.898351648,1165,2742,664,271,269,2,76,2,0.026022305,0,empty,CD-0722-1
"F5,G10",10840,12180,8201,3979,5768,2942,0,2945,1922,1023,1.878787879,1650,3118,828,271,267,4,84,2,0.026217228,0,empty,CD-0722-1
"F5,G11",10619,11376,8083,3293,5447,2563,0,2564,1690,874,1.933638444,1374,1573,354,108,106,2,45,2,0.20754717,0,empty,CD-0722-1
"F5,G12",8245,9420,6061,3359,4397,2224,0,2227,1368,859,1.592549476,1302,2219,596,200,200,0,59,0,0.04,0,empty,CD-0722-1
"F5,H1",9420,10474,6996,3478,4808,2260,0,2260,1534,726,2.112947658,1283,1508,494,142,142,0,44,0,0.190140845,0,empty,CD-0722-1
"F5,H2",9727,10746,7081,3665,4975,2489,2,2500,1608,892,1.802690583,1461,2673,513,199,196,3,51,1,0.051020408,0,empty,CD-0722-1
"F5,H3",8649,9835,6382,3453,4569,2353,0,2355,1522,833,1.827130852,1403,1733,352,136,135,1,46,1,0.014814815,0,empty,CD-0722-1
"F5,H4",11995,13097,8857,4240,6080,2951,0,2952,1952,1000,1.952,1697,250,36,18,17,1,10,1,0,0,empty,CD-0722-1
"F5,H5",12586,13836,9202,4634,6515,3347,1,3353,2222,1131,1.964633068,1974,2262,644,216,214,2,52,1,0.11682243,0,empty,CD-0722-1
"F5,H6",7903,8650,5800,2850,4108,2056,0,2060,1440,620,2.322580645,1144,2200,478,133,132,1,48,1,0.098484848,0,empty,CD-0722-1
"F5,H7",9695,10492,7288,3204,5041,2377,0,2380,1570,810,1.938271605,1338,2609,702,208,208,0,63,0,0.048076923,0,empty,CD-0722-1
"F5,H8",10762,12291,8033,4258,5586,2919,0,2923,1881,1042,1.805182342,1635,2192,440,166,163,3,53,1,0.085889571,0,empty,CD-0722-1
"F5,H9",8470,9122,6427,2695,4281,2032,1,2036,1352,684,1.976608187,1117,1193,394,173,170,3,51,1,0.052941176,0,empty,CD-0722-1
"F5,H10",7315,8253,5446,2807,3868,1917,0,1921,1235,686,1.800291545,1168,1157,219,73,71,2,27,1,0.056338028,0,empty,CD-0722-1
"F5,H11",10760,12513,7338,5175,6085,3793,0,3798,2107,1691,1.246008279,2376,80,24,8,8,0,6,0,0,0,empty,CD-0722-1
"F5,H12",9227,10199,6779,3420,4869,2516,0,2526,1689,837,2.017921147,1491,1469,332,101,101,0,35,0,0.089108911,0,empty,CD-0722-1
"F6,A1",5352,5995,3875,2120,3017,1606,0,1606,1023,583,1.754716981,945,1331,257,95,81,14,43,1,0.049382716,0,empty,CD-0722-1
"F6,A2",8602,9607,6465,3142,4645,2258,0,2263,1452,811,1.790382244,1271,2083,561,213,206,7,86,2,0.067961165,0,empty,CD-0722-1
"F6,A3",4947,5422,3663,1759,2611,1271,0,1274,852,422,2.018957346,698,1237,256,100,100,0,39,0,0,0,empty,CD-0722-1
"F6,A4",8350,9248,6299,2949,4461,2193,6,2201,1432,769,1.862158648,1261,1055,175,81,80,1,48,1,0.15,0,empty,CD-0722-1
"F6,A5",312148,336259,235799,100460,161367,77733,2,77822,61662,16160,3.815717822,43318,117403,17346,5632,5498,134,1052,4,0.018915969,0,hg38,CD-0722-1
"F6,A6",6440,7275,4789,2486,3689,1980,0,1982,1301,681,1.910425844,1169,3114,630,241,237,4,100,2,0.025316456,0,empty,CD-0722-1
"F6,A7",5298,5787,3981,1806,2969,1496,3,1505,979,526,1.86121673,885,1451,272,133,133,0,63,0,0.007518797,0,empty,CD-0722-1
"F6,A8",3499,3871,2646,1225,1933,931,0,934,648,286,2.265734266,536,2008,464,164,159,5,66,2,0.018867925,0,empty,CD-0722-1
"F6,A9",7044,7869,5241,2628,3876,1987,0,1987,1376,611,2.252045827,1156,1916,466,183,183,0,61,0,0.071038251,0,empty,CD-0722-1
"F6,A10",910301,1011979,705373,306606,481083,235175,1,235405,194643,40762,4.77510917,130428,27041,4729,1587,1564,23,355,3,0.015345269,0,hg38,CD-0722-1
"F6,A11",5642,6124,4222,1902,3140,1507,3,1512,1047,465,2.251612903,853,1751,458,170,167,3,59,2,0.119760479,0,empty,CD-0722-1
"F6,A12",1182342,1338366,897956,440410,614321,319633,2,319948,251407,68541,3.667979749,183159,386140,49116,16055,15657,398,2395,6,0.057546145,0,hg38,CD-0722-1
"F6,B1",5980,6753,4344,2409,3234,1727,1,1728,1116,612,1.823529412,992,1582,397,127,127,0,52,0,0.133858268,0,empty,CD-0722-1
"F6,B2",6406,7053,4375,2678,3514,1967,0,1968,1276,692,1.843930636,1205,643,129,55,54,1,18,1,0.018518519,0,empty,CD-0722-1
"F6,B3",5605,6518,4065,2453,3168,1658,2,1660,1098,562,1.953736655,991,1395,338,97,97,0,39,0,0.18556701,0,empty,CD-0722-1
"F6,B4",6224,7174,4568,2606,3560,1942,0,1947,1240,707,1.753889675,1136,1766,432,134,134,0,59,0,0.119402985,0,empty,CD-0722-1
"F6,B5",5417,2894,1642,1252,1950,1017,0,1020,656,364,1.802197802,707,823,141,63,61,2,28,1,0,0,empty,CD-0722-1
"F6,B6",672570,721606,522846,198760,345856,159401,4,159604,130062,29542,4.402613229,87441,69854,10739,3551,3445,106,730,5,0.027866473,0,hg38,CD-0722-1
"F6,B7",5765,6312,4364,1948,3089,1542,0,1544,986,558,1.76702509,857,1108,298,102,102,0,36,0,0,0,empty,CD-0722-1
"F6,B8",4542,5215,3329,1886,2499,1211,0,1213,820,393,2.086513995,728,1489,209,109,105,4,49,1,0.104761905,0,empty,CD-0722-1
"F6,B9",511739,591870,380710,211160,279814,151395,1,151564,119617,31947,3.744232635,89367,50324,7395,2446,2402,44,529,4,0.050791007,0,hg38,CD-0722-1
"F6,B10",4357,4565,3194,1371,2380,1151,0,1157,707,450,1.571111111,672,476,70,35,35,0,16,0,0.4,0,empty,CD-0722-1
"F6,B11",10333,11440,7498,3942,5529,3062,1,3071,1841,1230,1.496747967,1766,330,30,21,21,0,18,0,0,0,empty,CD-0722-1
"F6,B12",5526,6358,4052,2306,2995,1581,0,1584,1002,582,1.721649485,906,1750,412,113,111,2,46,2,0.036036036,0,empty,CD-0722-1
"F6,C1",10273,11330,7686,3644,5528,2733,0,2736,1785,951,1.876971609,1558,1426,489,115,112,3,36,2,0.008928571,0,empty,CD-0722-1
"F6,C2",8027,8896,5945,2951,4293,2212,0,2220,1398,822,1.700729927,1262,1905,627,220,218,2,58,2,0.123853211,0,empty,CD-0722-1
"F6,C3",8654,9371,6565,2806,4605,2238,1,2245,1431,814,1.757985258,1206,959,191,80,78,2,30,1,0.384615385,0,empty,CD-0722-1
"F6,C4",5998,6530,4432,2098,3144,1481,0,1481,948,533,1.778611632,792,1814,417,166,160,6,67,2,0.10625,0,empty,CD-0722-1
"F6,C5",8619,9703,6442,3261,4594,2319,0,2321,1524,797,1.91217064,1314,2371,505,214,209,5,90,1,0.110047847,0,empty,CD-0722-1
"F6,C6",6959,7877,5104,2773,3971,1977,0,1984,1319,665,1.983458647,1192,1978,497,218,210,8,83,2,0.10952381,0,empty,CD-0722-1
"F6,C7",10017,11856,7152,4704,5730,3245,0,3249,1941,1308,1.483944954,2013,577,74,47,46,1,21,1,0.065217391,0,empty,CD-0722-1
"F6,C8",10430,11566,7716,3850,5596,2809,0,2817,1899,918,2.068627451,1647,3134,674,268,265,3,83,2,0.098113208,0,empty,CD-0722-1
"F6,C9",7381,8162,5543,2619,4093,2070,0,2070,1279,791,1.616940582,1188,1867,330,119,116,3,48,1,0.034482759,0,empty,CD-0722-1
"F6,C10",8045,8822,6114,2708,4252,2047,0,2047,1321,726,1.819559229,1131,2037,436,177,174,3,57,2,0.034482759,0,empty,CD-0722-1
"F6,C11",7006,7838,5216,2622,3830,1926,0,1936,1269,667,1.902548726,1149,1923,390,138,136,2,65,1,0.022058824,0,empty,CD-0722-1
"F6,C12",10174,11294,7490,3804,5303,2516,0,2516,1580,936,1.688034188,1474,2033,619,209,207,2,62,1,0.082125604,0,empty,CD-0722-1
"F6,D1",8781,10155,6422,3733,5023,2743,0,2747,1681,1066,1.576923077,1647,973,155,64,64,0,29,0,0.03125,0,empty,CD-0722-1
"F6,D2",6719,7183,5333,1850,3600,1603,0,1609,1048,561,1.868092692,842,3277,732,281,273,8,98,2,0.062271062,0,empty,CD-0722-1
"F6,D3",7031,7986,5179,2807,3896,2015,0,2019,1376,643,2.139968896,1190,1538,241,103,95,8,64,2,0.052631579,0,empty,CD-0722-1
"F6,D4",5948,6682,4476,2206,3291,1610,0,1612,1074,538,1.996282528,946,1295,270,123,123,0,47,0,0,0,empty,CD-0722-1
"F6,D5",631195,747045,468877,278168,349872,194182,2,194379,152707,41672,3.664498944,116188,94364,13564,4474,4356,118,915,5,0.059687787,0,hg38,CD-0722-1
"F6,D6",8479,9344,6196,3148,4495,2442,0,2444,1488,956,1.556485356,1373,2084,499,180,179,1,48,1,0,0,empty,CD-0722-1
"F6,D7",4767,4897,3624,1273,2455,1112,0,1113,726,387,1.875968992,592,2182,407,162,162,0,58,0,0.043209877,0,empty,CD-0722-1
"F6,D8",6168,6696,4558,2138,3276,1602,0,1605,1050,555,1.891891892,941,1455,471,163,162,1,45,1,0.043209877,0,empty,CD-0722-1
"F6,D9",349568,401611,266236,135375,190846,97295,0,97397,73169,24228,3.020018161,56929,75619,7856,2504,2430,74,602,5,0.032921811,0,hg38,CD-0722-1
"F6,D10",5309,5726,3884,1842,2783,1365,0,1370,843,527,1.599620493,765,815,150,66,66,0,17,0,0,0,empty,CD-0722-1
"F6,D11",6730,7310,5093,2217,3647,1780,0,1782,1184,598,1.97993311,1018,3526,887,288,287,1,107,1,0.059233449,0,empty,CD-0722-1
"F6,D12",8625,9684,6439,3245,4634,2289,0,2291,1448,843,1.71767497,1323,3662,933,271,269,2,99,1,0.081784387,0,empty,CD-0722-1
"F6,E1",10740,11948,7974,3974,5784,2864,0,2864,1826,1038,1.759152216,1618,3090,434,194,190,4,93,2,0.152631579,0,empty,CD-0722-1
"F6,E2",7378,8336,5381,2955,4085,2126,0,2128,1351,777,1.738738739,1252,1941,476,165,164,1,60,1,0.134146341,0,empty,CD-0722-1
"F6,E3",4947,5510,3762,1748,2736,1345,0,1349,868,481,1.804573805,767,2650,506,213,211,2,74,1,0.132701422,0,empty,CD-0722-1
"F6,E4",562354,677967,412437,265530,318948,182278,1,182496,145698,36798,3.959399967,111430,149065,23549,7651,7499,152,1389,6,0.047739699,0,hg38,CD-0722-1
"F6,E5",6073,6435,4625,1810,3205,1513,0,1515,982,533,1.842401501,807,1621,261,109,109,0,46,0,0.128440367,0,empty,CD-0722-1
"F6,E6",475774,531216,368487,162729,247889,121495,1,121622,95819,25803,3.713482928,68252,82137,14029,4409,4304,105,860,3,0.031366171,0,hg38,CD-0722-1
"F6,E7",10346,11307,7864,3443,5456,2670,0,2678,1723,955,1.804188482,1442,3041,748,242,233,9,79,2,0.090128755,0,empty,CD-0722-1
"F6,E8",7415,7996,5716,2280,3946,1780,0,1780,1150,630,1.825396825,962,2914,453,157,155,2,62,2,0.180645161,0,empty,CD-0722-1
"F6,E9",5684,6346,4257,2089,3063,1519,0,1524,995,529,1.880907372,872,2351,624,245,245,0,89,0,0.032653061,0,empty,CD-0722-1
"F6,E10",451551,514858,340134,174724,245031,127109,1,127248,96927,30321,3.19669536,74049,96403,19549,6298,6206,92,1102,5,0.022881083,0,hg38,CD-0722-1
"F6,E11",7200,8259,5303,2956,3900,2011,0,2013,1272,741,1.71659919,1215,2314,421,180,177,3,62,2,0.13559322,0,empty,CD-0722-1
"F6,E12",8878,9697,6476,3221,4777,2391,0,2391,1572,819,1.919413919,1372,1843,416,168,165,3,67,1,0.006060606,0,empty,CD-0722-1
"F6,F1",8582,9497,6351,3146,4702,2358,0,2364,1539,825,1.865454545,1420,2178,418,187,186,1,61,1,0.032258065,0,empty,CD-0722-1
"F6,F2",7355,7767,5478,2289,3902,1824,0,1828,1227,601,2.041597338,998,3440,928,324,317,7,114,1,0.104100946,0,empty,CD-0722-1
"F6,F3",545482,646586,401364,245222,303923,170655,1,170796,129454,41342,3.131295051,103773,150060,26461,8674,8480,194,1397,6,0.067688679,0,hg38,CD-0722-1
"F6,F4",9830,10475,7444,3031,5157,2452,1,2455,1578,877,1.799315849,1369,726,167,49,48,1,28,1,0.020833333,0,empty,CD-0722-1
"F6,F5",7577,8238,5705,2533,4072,1980,0,1985,1251,734,1.704359673,1133,2001,574,212,206,6,66,2,0.04368932,0,empty,CD-0722-1
"F6,F6",8334,9620,6015,3605,4650,2473,0,2476,1557,919,1.694232862,1500,3419,902,294,291,3,105,1,0.054982818,0,empty,CD-0722-1
"F6,F7",10703810,12661221,7897955,4763266,5130735,3363989,21,3367211,2589240,777971,3.328196038,2022835,378782,45078,13777,13428,349,2603,10,0.034852547,0,hg38,CD-0722-1
"F6,F8",6170,6826,4688,2138,3325,1639,0,1643,1055,588,1.794217687,930,235,21,17,17,0,13,0,0.058823529,0,empty,CD-0722-1
"F6,F9",6670,7292,5122,2170,3575,1722,0,1726,1108,618,1.792880259,947,2843,441,167,164,3,66,3,0.091463415,0,empty,CD-0722-1
"F6,F10",8656,9326,6534,2792,4490,2156,0,2158,1367,791,1.728192162,1224,2023,385,144,143,1,48,1,0.076923077,0,empty,CD-0722-1
"F6,F11",7137,7748,5571,2177,3798,1733,0,1735,1121,614,1.825732899,934,1549,160,74,72,2,36,1,0.069444444,0,empty,CD-0722-1
"F6,F12",543073,619860,410329,209531,286737,148455,3,148625,113418,35207,3.221461641,86974,4939,569,208,201,7,56,2,0.029850746,0,hg38,CD-0722-1
"F6,G1",8487,9287,6326,2961,4564,2229,1,2235,1444,791,1.825537295,1239,2513,487,191,190,1,107,1,0.015789474,0,empty,CD-0722-1
"F6,G2",4751,5093,3268,1825,2526,1292,0,1295,809,486,1.664609053,769,508,89,27,26,1,19,1,0.038461538,0,empty,CD-0722-1
"F6,G3",9279,10185,6772,3413,5023,2615,2,2620,1568,1052,1.490494297,1498,2626,639,259,257,2,98,2,0.073929961,0,empty,CD-0722-1
"F6,G4",690358,782573,524649,257924,364127,185855,0,186040,145251,40789,3.561033612,107352,1802,130,58,57,1,27,1,0.175438596,0,empty,CD-0722-1
"F6,G5",579327,709437,418738,290699,331569,196035,4,196274,157001,39273,3.997682886,121365,120188,18422,6293,6191,102,1139,6,0.109352286,0,hg38,CD-0722-1
"F6,G6",7667,8559,5794,2765,4156,2072,0,2072,1468,604,2.430463576,1184,147,47,27,27,0,9,0,0,0,empty,CD-0722-1
"F6,G7",476128,528823,367330,161493,253851,123507,2,123660,97240,26420,3.680545042,69366,95781,15658,5061,4945,116,947,7,0.025075834,0,hg38,CD-0722-1
"F6,G8",5065,5581,3842,1739,2686,1291,1,1295,844,451,1.871396896,734,2001,450,159,159,0,61,0,0.018867925,0,empty,CD-0722-1
"F6,G9",5799,6291,4398,1893,3152,1537,0,1540,989,551,1.79491833,883,2651,676,252,251,1,87,1,0.067729084,0,empty,CD-0722-1
"F6,G10",7452,8437,5494,2943,4135,2132,0,2132,1412,720,1.961111111,1265,2404,523,268,266,2,111,1,0.063909774,0,empty,CD-0722-1
"F6,G11",522125,593653,398064,195589,278850,142493,1,142652,107591,35061,3.0686803,82161,73858,17230,5664,5612,52,996,4,0.046329294,0,hg38,CD-0722-1
"F6,G12",478398,587505,329695,257810,283794,186918,2,187066,133962,53104,2.52263483,116445,5137,1016,308,306,2,91,2,0.04248366,0,hg38,CD-0722-1
"F6,H1",6157,6542,4654,1888,3175,1448,0,1450,915,535,1.710280374,760,1131,263,51,50,1,26,1,0.02,0,empty,CD-0722-1
"F6,H2",6916,7838,5181,2657,3656,1890,0,1890,1182,708,1.669491525,1115,2712,737,265,261,4,76,1,0.049808429,0,empty,CD-0722-1
"F6,H3",6524,7274,4755,2519,3455,1731,0,1733,1124,609,1.845648604,1025,4225,603,198,196,2,62,2,0.183673469,0,empty,CD-0722-1
"F6,H4",8702,9933,6464,3469,4762,2335,0,2340,1539,801,1.921348315,1410,260,37,24,24,0,17,0,0.083333333,0,empty,CD-0722-1
"F6,H5",8871,9710,6622,3088,4650,2407,0,2414,1550,864,1.793981481,1384,1740,719,214,213,1,66,1,0.018779343,0,empty,CD-0722-1
"F6,H6",640011,775125,468517,306608,361628,207685,2,207868,165175,42693,3.868901225,126970,80143,19856,6465,6401,64,1118,3,0.060459303,0,hg38,CD-0722-1
"F6,H7",6588,7264,4889,2375,3564,1758,1,1765,1180,585,2.017094017,1000,1974,497,185,183,2,61,1,0.06557377,0,empty,CD-0722-1
"F6,H8",7294,8086,5434,2652,3875,1975,0,1981,1253,728,1.721153846,1136,1941,413,143,141,2,47,1,0.063829787,0,empty,CD-0722-1
"F6,H9",5602,6132,4181,1951,3005,1430,0,1430,952,478,1.991631799,844,971,207,87,86,1,38,1,0.011627907,0,empty,CD-0722-1
"F6,H10",5587,6164,4221,1943,2909,1445,0,1447,943,504,1.871031746,789,1255,242,106,103,3,33,2,0.029126214,0,empty,CD-0722-1
"F6,H11",6762,7899,4716,3183,3884,2393,1,2397,1344,1053,1.276353276,1447,90,10,9,9,0,5,0,0.111111111,0,empty,CD-0722-1
"F6,H12",826445,958728,626794,331934,445924,234550,5,234844,193459,41385,4.674616407,137021,282028,44517,14524,14240,284,2188,9,0.056882022,0,hg38,CD-0722-1
"F7,A1",9223,10484,6953,3531,5122,2656,0,2667,1720,947,1.81626188,1518,975,133,63,61,2,36,1,0.081967213,0,empty,CD-0722-1
"F7,A2",1598229,1941686,1138824,802862,884331,563201,6,563721,421295,142426,2.957992221,340291,17106,5169,1678,1668,10,362,2,0.012589928,0,hg38,CD-0722-1
"F7,A3",7981,8903,5959,2944,4171,2067,1,2073,1331,742,1.793800539,1172,1007,202,79,79,0,28,0,0.139240506,0,empty,CD-0722-1
"F7,A4",15010,16666,11236,5430,7864,3824,3,3835,2479,1356,1.828171091,2184,1049,216,95,95,0,33,0,0.178947368,0,empty,CD-0722-1
"F7,A5",13626,15294,10192,5102,7139,3451,0,3454,2230,1224,1.821895425,1977,2785,685,245,240,5,77,2,0.05,0,empty,CD-0722-1
"F7,A6",664492,813548,492787,320761,374217,212142,2,212337,170003,42334,4.015755657,129721,165714,31132,10098,9928,170,1585,5,0.057312651,0,hg38,CD-0722-1
"F7,A7",9581,10966,7055,3911,5198,2684,0,2685,1732,953,1.817418678,1567,1739,290,96,95,1,43,1,0.052631579,0,empty,CD-0722-1
"F7,A8",5578,6390,4129,2261,3104,1539,0,1539,1069,470,2.274468085,916,1869,367,139,135,4,72,1,0.022222222,0,empty,CD-0722-1
"F7,A9",20967,24398,15507,8891,11472,6090,0,6097,4567,1530,2.98496732,3632,1990,548,202,201,1,66,1,0.069651741,0,empty,CD-0722-1
"F7,A10",11771,12783,9117,3666,6155,2960,0,2966,1891,1075,1.759069767,1564,459,106,53,53,0,23,0,0.075471698,0,empty,CD-0722-1
"F7,A11",624726,706827,478762,228065,327948,166122,1,166313,131180,35133,3.733811516,94195,55259,7855,2577,2511,66,601,3,0.020310633,0,hg38,CD-0722-1
"F7,A12",12626,13760,9589,4171,6485,3104,0,3104,2051,1053,1.947768281,1715,3317,1023,248,243,5,88,1,0.041152263,0,empty,CD-0722-1
"F7,B1",10257,11652,7605,4047,5442,2790,0,2797,1764,1033,1.707647628,1585,1027,180,45,44,1,28,1,0,0,empty,CD-0722-1
"F7,B2",10264,11507,7026,4481,5546,3046,0,3050,1889,1161,1.62704565,1853,673,110,48,47,1,17,1,0.446808511,0,empty,CD-0722-1
"F7,B3",8738,9891,6557,3334,4725,2433,0,2437,1585,852,1.860328638,1431,1373,207,52,52,0,27,0,0.076923077,0,empty,CD-0722-1
"F7,B4",11017,12613,7953,4660,6054,3222,0,3223,2082,1141,1.824715162,1929,1800,407,134,133,1,60,1,0.037593985,0,empty,CD-0722-1
"F7,B5",9309,5073,2959,2114,3233,1767,0,1784,1156,628,1.840764331,1188,858,104,40,40,0,18,0,0.025,0,empty,CD-0722-1
"F7,B6",11976,13766,8572,5194,6576,3658,0,3661,2311,1350,1.711851852,2188,1543,361,135,132,3,38,2,0.075757576,0,empty,CD-0722-1
"F7,B7",9866,11079,7508,3571,5338,2655,0,2665,1693,972,1.741769547,1550,1030,257,64,61,3,28,1,0,0,empty,CD-0722-1
"F7,B8",8496,9261,6352,2909,4455,2176,0,2180,1479,701,2.109843081,1201,1206,255,86,86,0,42,0,0.058139535,0,empty,CD-0722-1
"F7,B9",14504,16541,10838,5703,7697,4106,0,4116,2617,1499,1.745830554,2365,953,158,54,53,1,32,1,0.018867925,0,empty,CD-0722-1
"F7,B10",7599,7936,5442,2494,3976,1976,0,1986,1284,702,1.829059829,1125,517,119,64,59,5,25,1,0.338983051,0,empty,CD-0722-1
"F7,B11",15714,17641,11510,6131,8398,4535,0,4538,2589,1949,1.328373525,2652,158,10,9,9,0,9,0,0,0,empty,CD-0722-1
"F7,B12",9376,10530,6988,3542,5057,2559,0,2563,1670,893,1.870100784,1471,1657,431,124,122,2,38,1,0,0,empty,CD-0722-1
"F7,C1",16755,18405,12581,5824,8595,4170,0,4178,2699,1479,1.824881677,2414,1153,488,149,149,0,46,0,0.093959732,0,empty,CD-0722-1
"F7,C2",959646,1125142,716930,408212,515274,280648,5,280911,220519,60392,3.651460458,167847,79369,9973,3196,3105,91,770,3,0.037359098,0,hg38,CD-0722-1
"F7,C3",15426,17136,11501,5635,8386,4222,0,4230,2732,1498,1.82376502,2415,710,130,58,54,4,24,1,0,0,empty,CD-0722-1
"F7,C4",10205,11368,7636,3732,5324,2528,0,2538,1585,953,1.66316894,1449,1482,288,106,105,1,52,1,0.142857143,0,empty,CD-0722-1
"F7,C5",15030,16676,11109,5567,8009,4028,0,4033,2663,1370,1.94379562,2319,2100,434,150,148,2,64,2,0.02027027,0,empty,CD-0722-1
"F7,C6",13704,15674,10342,5332,7590,3867,0,3874,2615,1259,2.077045274,2225,1615,408,151,151,0,63,0,0.013245033,0,empty,CD-0722-1
"F7,C7",19560,23277,14244,9033,10933,6071,0,6081,3983,2098,1.898474738,3673,838,208,70,66,4,28,1,0.166666667,0,empty,CD-0722-1
"F7,C8",18362,20203,13733,6470,9692,4877,0,4882,3132,1750,1.789714286,2824,2693,605,228,225,3,84,2,0.053333333,0,empty,CD-0722-1
"F7,C9",12485,14426,9309,5117,6827,3557,1,3561,2311,1250,1.8488,2108,1569,257,91,90,1,39,1,0.033333333,0,empty,CD-0722-1
"F7,C10",13779,15179,10401,4778,7155,3502,0,3512,2210,1302,1.697388633,1989,2024,408,152,152,0,61,0,0.013157895,0,empty,CD-0722-1
"F7,C11",11870,13244,8868,4376,6321,3225,0,3227,2123,1104,1.923007246,1834,2025,373,153,153,0,60,0,0.08496732,0,empty,CD-0722-1
"F7,C12",876426,1038248,620274,417974,479944,297324,4,297601,204353,93248,2.191500086,180259,18748,10243,3011,3003,8,570,2,0.02997003,0,hg38,CD-0722-1
"F7,D1",948028,1104105,708935,395170,504634,273772,2,274097,213913,60184,3.554316762,161851,88193,10359,3429,3322,107,687,3,0.086393739,0,hg38,CD-0722-1
"F7,D2",11861,13151,9199,3952,6302,2929,0,2935,1878,1057,1.776726585,1630,2758,728,268,265,3,104,2,0.052830189,0,empty,CD-0722-1
"F7,D3",12335,13732,8994,4738,6779,3551,1,3560,2400,1160,2.068965517,2106,1605,338,127,127,0,51,0,0.078740157,0,empty,CD-0722-1
"F7,D4",8782,10144,6600,3544,4816,2347,0,2349,1586,763,2.078636959,1408,1286,285,94,93,1,36,1,0.053763441,0,empty,CD-0722-1
"F7,D5",851189,1017543,628851,388692,470926,262835,1,263092,213189,49903,4.272067812,159715,71412,11718,3881,3832,49,835,5,0.058455115,0,hg38,CD-0722-1
"F7,D6",14428,15913,10487,5426,7425,3892,0,3903,2396,1507,1.589913736,2250,1692,434,137,136,1,57,1,0.058823529,0,empty,CD-0722-1
"F7,D7",8597,9246,6564,2682,4407,2073,0,2076,1358,718,1.891364903,1113,2465,789,209,206,3,63,2,0.082524272,0,empty,CD-0722-1
"F7,D8",10643,11767,7936,3831,5625,2849,0,2853,1939,914,2.121444201,1650,1479,312,120,117,3,50,2,0.008547009,0,empty,CD-0722-1
"F7,D9",6190,6704,4595,2109,3320,1669,0,1670,1129,541,2.086876155,934,1595,294,137,135,2,63,2,0.007407407,0,empty,CD-0722-1
"F7,D10",907968,1066967,677654,389313,487438,264195,6,264468,202842,61626,3.291500341,158292,43362,5665,1900,1861,39,419,3,0.068780226,0,hg38,CD-0722-1
"F7,D11",813232,956346,601691,354655,437919,245487,2,245732,187775,57957,3.239901996,145696,171623,32246,10311,10158,153,1695,5,0.038393385,0,hg38,CD-0722-1
"F7,D12",825034,945513,623472,322041,433885,226595,20,226848,166243,60605,2.743057504,132320,210841,27993,8985,8720,265,1478,6,0.03956422,0,hg38,CD-0722-1
"F7,E1",18734,20633,14046,6587,9748,4824,0,4827,3042,1785,1.704201681,2729,2916,585,200,197,3,88,2,0.025380711,0,empty,CD-0722-1
"F7,E2",13091,14628,9631,4997,6931,3589,1,3597,2298,1299,1.769053118,2123,1570,274,108,107,1,57,1,0.009345794,0,empty,CD-0722-1
"F7,E3",771506,922643,574033,348610,424000,237882,1,238111,179939,58172,3.093223544,143322,140733,24169,8045,7878,167,1336,5,0.045823813,0,hg38,CD-0722-1
"F7,E4",12516,14191,9436,4755,6624,3276,0,3286,2133,1153,1.849956635,1878,2135,420,177,174,3,85,2,0.017241379,0,empty,CD-0722-1
"F7,E5",10228,10966,7856,3110,5118,2280,0,2284,1467,817,1.795593635,1218,1199,373,158,156,2,57,1,0.038461538,0,empty,CD-0722-1
"F7,E6",18069,20058,13427,6631,9434,4748,0,4757,3062,1695,1.806489676,2712,3142,803,308,301,7,93,2,0.003322259,0,empty,CD-0722-1
"F7,E7",803059,925973,602026,323947,420834,223438,5,223675,178610,45065,3.96338622,131564,130016,17884,5983,5843,140,1125,6,0.047920589,0,hg38,CD-0722-1
"F7,E8",12979,14155,9887,4268,6676,3126,0,3128,2067,1061,1.948162111,1717,2475,712,267,265,2,66,2,0.030188679,0,empty,CD-0722-1
"F7,E9",9616,10691,7187,3504,5105,2554,0,2558,1747,811,2.154130703,1434,1951,385,154,151,3,62,2,0.066225166,0,empty,CD-0722-1
"F7,E10",867692,1038639,626685,411954,480349,280146,3,280463,237707,42756,5.559617364,171364,84901,17517,5656,5580,76,1072,4,0.046057348,0,hg38,CD-0722-1
"F7,E11",12185,13565,9058,4507,6360,3198,0,3201,2013,1188,1.694444444,1797,2121,548,223,218,5,67,1,0.155963303,0,empty,CD-0722-1
"F7,E12",698248,737678,550789,186889,342193,148473,1,148687,110312,38375,2.874579805,79508,23601,4568,1447,1415,32,321,3,0.01130742,0,hg38,CD-0722-1
"F7,F1",15050,16317,11123,5194,7820,3823,0,3834,2484,1350,1.84,2190,2009,424,161,158,3,60,2,0.069620253,0,empty,CD-0722-1
"F7,F2",12520,13638,9412,4226,6658,3247,0,3257,2101,1156,1.817474048,1850,2636,699,263,261,2,99,1,0.038314176,0,empty,CD-0722-1
"F7,F3",12049,13430,9121,4309,6423,3110,0,3113,1992,1121,1.776984835,1841,2937,544,209,206,3,95,2,0.038834951,0,empty,CD-0722-1
"F7,F4",16621,18264,12381,5883,8659,4251,0,4258,2778,1480,1.877027027,2438,634,83,52,51,1,33,1,0.078431373,0,empty,CD-0722-1
"F7,F5",13429,14319,10226,4093,6626,3065,0,3075,2046,1029,1.988338192,1661,1898,422,159,159,0,56,0,0.075471698,0,empty,CD-0722-1
"F7,F6",15215,17270,11173,6097,8285,4304,0,4308,2841,1467,1.936605317,2590,3077,686,221,218,3,84,1,0.110091743,0,empty,CD-0722-1
"F7,F7",16724,18824,12505,6319,9074,4572,0,4577,2985,1592,1.875,2640,1335,257,101,100,1,52,1,0,0,empty,CD-0722-1
"F7,F8",12334,13977,9459,4518,6545,3346,1,3356,2228,1128,1.975177305,1861,199,71,33,33,0,16,0,0,0,empty,CD-0722-1
"F7,F9",11964,13087,9131,3956,6180,2978,0,2980,2017,963,2.094496366,1710,2749,724,215,211,4,59,2,0.047393365,0,empty,CD-0722-1
"F7,F10",14538,15793,11230,4563,7403,3418,0,3424,2229,1195,1.865271967,1813,1537,455,143,143,0,45,0,0.083916084,0,empty,CD-0722-1
"F7,F11",12661,13996,9796,4200,6577,3042,0,3044,2036,1008,2.01984127,1659,1657,414,133,127,6,46,1,0.023622047,0,empty,CD-0722-1
"F7,F12",13024,14609,9836,4773,6715,3297,0,3301,2192,1109,1.976555455,1833,222,35,25,24,1,9,1,0.041666667,0,empty,CD-0722-1
"F7,G1",14481,16238,10999,5239,7833,3809,0,3811,2495,1316,1.895896657,2152,2806,672,250,246,4,93,2,0.052845528,0,empty,CD-0722-1
"F7,G2",8273,8900,5969,2931,4196,2184,0,2188,1393,795,1.752201258,1244,419,131,47,47,0,19,0,0.021276596,0,empty,CD-0722-1
"F7,G3",15676,17313,11740,5573,8322,4307,0,4316,2706,1610,1.680745342,2374,2456,568,200,198,2,79,2,0.060606061,0,empty,CD-0722-1
"F7,G4",27882,31703,20406,11297,15095,8378,1,8385,5238,3147,1.664442326,4832,218,24,16,16,0,13,0,0,0,empty,CD-0722-1
"F7,G5",5753518,6915650,4219152,2696498,2946520,1811742,10,1813501,1474413,339088,4.348172156,1099160,422554,83050,27898,27539,359,3506,9,0.061440139,0,hg38,CD-0722-1
"F7,G6",13432,14980,10249,4731,6975,3381,0,3382,2186,1196,1.827759197,1920,322,118,28,27,1,7,1,0.148148148,0,empty,CD-0722-1
"F7,G7",11786,12919,8993,3926,6125,2893,0,2894,1927,967,1.992761117,1579,2054,410,175,174,1,89,1,0.068965517,0,empty,CD-0722-1
"F7,G8",8317,9273,6197,3076,4285,2084,0,2088,1357,731,1.856361149,1199,1519,364,114,111,3,49,1,0.045045045,0,empty,CD-0722-1
"F7,G9",10320,11465,7759,3706,5376,2638,0,2646,1711,935,1.829946524,1511,2410,615,219,217,2,86,1,0.087557604,0,empty,CD-0722-1
"F7,G10",12834,14668,9542,5126,6912,3534,0,3548,2323,1225,1.896326531,2074,2227,442,193,192,1,82,1,0.026041667,0,empty,CD-0722-1
"F7,G11",12517,13740,9544,4196,6607,3143,0,3150,2117,1033,2.049370765,1773,1277,255,101,95,6,39,2,0.084210526,0,empty,CD-0722-1
"F7,G12",9423,10865,6965,3900,5183,2658,0,2667,1680,987,1.70212766,1600,2208,627,229,227,2,59,2,0.035242291,0,empty,CD-0722-1
"F7,H1",10720,11482,8054,3428,5381,2494,0,2499,1664,835,1.992814371,1376,974,211,70,70,0,25,0,0.028571429,0,empty,CD-0722-1
"F7,H2",12607,13869,9588,4281,6619,3266,0,3269,2136,1133,1.885260371,1878,2771,693,220,217,3,73,2,0.124423963,0,empty,CD-0722-1
"F7,H3",10243,11516,7522,3994,5441,2727,0,2729,1736,993,1.748237664,1633,1762,283,119,116,3,46,1,0.00862069,0,empty,CD-0722-1
"F7,H4",14637,16147,10773,5374,7702,3898,0,3903,2544,1359,1.87196468,2191,231,32,18,18,0,13,0,0,0,empty,CD-0722-1
"F7,H5",14503,16072,10707,5365,7432,3736,0,3746,2420,1326,1.825037707,2131,1387,297,105,104,1,32,1,0.201923077,0,empty,CD-0722-1
"F7,H6",792000,1012411,549478,462933,474879,308653,1,308891,234486,74405,3.151481755,198569,14381,6006,1661,1655,6,446,2,0.01510574,0,hg38,CD-0722-1
"F7,H7",11511,12670,8605,4065,6056,2882,1,2886,1901,985,1.929949239,1652,2002,553,202,199,3,73,2,0.015075377,0,empty,CD-0722-1
"F7,H8",11991,13323,9016,4307,6380,3244,1,3250,2067,1183,1.747252747,1866,3083,843,243,242,1,70,1,0.103305785,0,empty,CD-0722-1
"F7,H9",10481,11318,8079,3239,5383,2509,0,2511,1665,846,1.968085106,1370,1526,418,122,121,1,37,1,0.041322314,0,empty,CD-0722-1
"F7,H10",8909,9905,6598,3307,4682,2342,1,2346,1575,771,2.042801556,1363,1080,197,52,51,1,21,1,0.137254902,0,empty,CD-0722-1
"F7,H11",11550,13531,8193,5338,6515,3923,0,3926,2193,1733,1.265435661,2365,92,3,3,3,0,3,0,0,0,empty,CD-0722-1
"F7,H12",11948,13255,8802,4453,6187,3283,0,3286,2185,1101,1.984559491,1855,1522,387,133,132,1,49,1,0.075757576,0,empty,CD-0722-1
"F8,A1",7680,8469,5578,2891,3997,2118,0,2120,1367,753,1.815405046,1205,1041,329,114,113,1,36,1,0.026548673,0,empty,CD-0722-1
"F8,A2",11267,12590,8316,4274,5831,2955,0,2966,1810,1156,1.565743945,1728,2088,527,174,172,2,49,2,0.011627907,0,empty,CD-0722-1
"F8,A3",6920,7538,5209,2329,3684,1844,1,1850,1224,626,1.955271565,1067,1214,343,116,112,4,28,2,0.098214286,0,empty,CD-0722-1
"F8,A4",12523,13915,9368,4547,6419,3141,0,3144,1985,1159,1.712683348,1754,930,268,76,76,0,21,0,0,0,empty,CD-0722-1
"F8,A5",10428,11521,7862,3659,5447,2689,0,2694,1673,1021,1.638589618,1535,2652,704,238,237,1,61,1,0.025316456,0,empty,CD-0722-1
"F8,A6",8588,9858,6456,3402,4683,2468,0,2470,1600,870,1.83908046,1423,2720,732,275,275,0,74,0,0.090909091,0,empty,CD-0722-1
"F8,A7",7351,8131,5396,2735,4033,2067,0,2067,1350,717,1.882845188,1195,1125,228,69,68,1,33,1,0.117647059,0,empty,CD-0722-1
"F8,A8",4820,5058,3675,1383,2517,1238,3,1241,830,411,2.01946472,653,1745,304,125,122,3,39,2,0.106557377,0,empty,CD-0722-1
"F8,A9",549177,623966,421065,202901,290439,145545,3,145754,113918,31836,3.578276165,83586,88234,15011,4754,4677,77,857,6,0.055591191,0,hg38,CD-0722-1
"F8,A10",8354,9379,6309,3070,4465,2262,0,2266,1442,824,1.75,1303,600,123,51,51,0,19,0,0.274509804,0,empty,CD-0722-1
"F8,A11",532791,649165,377493,271672,302569,194108,1,194299,141035,53264,2.647848453,116971,3105,259,104,99,5,46,2,0.090909091,0,empty,CD-0722-1
"F8,A12",9109,10220,6960,3260,4848,2369,0,2374,1505,869,1.731875719,1376,3664,1021,368,362,6,83,3,0.129834254,0,empty,CD-0722-1
"F8,B1",7862,8715,5687,3028,4138,2159,0,2165,1353,812,1.666256158,1274,886,164,68,64,4,15,1,0.265625,0,empty,CD-0722-1
"F8,B2",650666,799213,435346,363867,377907,257113,3,257318,190845,66473,2.871015299,159046,5555,492,166,152,14,51,2,0.25,0,hg38,CD-0722-1
"F8,B3",9551,10921,6817,4104,5319,2899,0,2899,1953,946,2.06448203,1772,1313,284,105,100,5,31,2,0,0,empty,CD-0722-1
"F8,B4",7666,8567,5705,2862,4179,2226,0,2229,1391,838,1.659904535,1288,1474,284,87,87,0,38,0,0.08045977,0,empty,CD-0722-1
"F8,B5",7689,4096,2516,1580,2720,1456,0,1470,945,525,1.8,939,998,265,80,76,4,22,2,0.039473684,0,empty,CD-0722-1
"F8,B6",8841,9938,6536,3402,4756,2529,1,2537,1606,931,1.725026853,1462,2012,466,144,143,1,39,1,0.111888112,0,empty,CD-0722-1
"F8,B7",8474,9315,6415,2900,4415,2163,0,2165,1372,793,1.730138714,1227,1315,177,59,59,0,25,0,0.084745763,0,empty,CD-0722-1
"F8,B8",5922,6426,4536,1890,3107,1459,0,1459,969,490,1.97755102,812,1197,243,92,92,0,41,0,0.043478261,0,empty,CD-0722-1
"F8,B9",1105692,1308812,793988,514824,605561,361877,0,362203,285105,77098,3.697955848,218000,45064,9133,2787,2740,47,576,5,0.033576642,0,hg38,CD-0722-1
"F8,B10",5771,6270,4106,2164,3068,1548,0,1554,986,568,1.735915493,897,509,86,24,24,0,11,0,0,0,empty,CD-0722-1
"F8,B11",11951,13502,8808,4694,6465,3512,0,3517,1960,1557,1.258831085,2091,105,8,7,7,0,6,0,0,0,empty,CD-0722-1
"F8,B12",7112,7763,5288,2475,3696,1791,0,1802,1169,633,1.846761453,1028,1608,362,109,108,1,34,1,0,0,empty,CD-0722-1
"F8,C1",908322,1115126,632769,482357,511948,344000,3,344294,257321,86973,2.958630839,207100,2379,501,150,148,2,49,1,0.074324324,0,hg38,CD-0722-1
"F8,C2",11960,13586,8898,4688,6157,3105,0,3110,1982,1128,1.757092199,1799,2564,507,172,167,5,50,1,0.095808383,0,empty,CD-0722-1
"F8,C3",13127,14697,9662,5035,6915,3435,0,3436,2196,1240,1.770967742,2010,799,143,69,68,1,21,1,0.014705882,0,empty,CD-0722-1
"F8,C4",7760,8297,5841,2456,3988,1894,0,1897,1245,652,1.909509202,1045,2092,518,155,153,2,47,1,0.130718954,0,empty,CD-0722-1
"F8,C5",11251,12804,8312,4492,6159,3140,0,3141,2108,1033,2.040658277,1855,1552,319,106,102,4,41,1,0.068627451,0,empty,CD-0722-1
"F8,C6",9577,10769,7036,3733,5177,2604,0,2611,1668,943,1.768822906,1559,2095,663,245,243,2,64,1,0.037037037,0,empty,CD-0722-1
"F8,C7",12670,14246,9221,5025,6859,3847,0,3853,2333,1520,1.534868421,2280,522,102,34,30,4,12,1,0.3,0,empty,CD-0722-1
"F8,C8",721389,870558,509760,360798,404701,258873,5,259114,182405,76709,2.377882647,156668,9302,1219,363,355,8,109,2,0.033802817,0,hg38,CD-0722-1
"F8,C9",9282,10487,6889,3598,4911,2469,0,2469,1594,875,1.821714286,1427,1431,290,100,98,2,32,2,0.132653061,0,empty,CD-0722-1
"F8,C10",11337,12380,8535,3845,5851,2849,0,2851,1858,993,1.871097684,1557,2120,723,254,252,2,65,1,0.051587302,0,empty,CD-0722-1
"F8,C11",9953,11163,7452,3711,5261,2635,5,2641,1653,988,1.673076923,1542,1905,593,183,183,0,50,0,0.071038251,0,empty,CD-0722-1
"F8,C12",895181,1047904,655687,392217,476758,265973,4,266239,214201,52038,4.116241977,159898,93104,13502,4408,4276,132,917,4,0.059167446,0,hg38,CD-0722-1
"F8,D1",12241,14246,8974,5272,6558,3456,0,3458,2118,1340,1.580597015,2104,655,39,20,18,2,13,1,0,0,empty,CD-0722-1
"F8,D2",10719,11671,8130,3541,5562,2601,0,2609,1684,925,1.820540541,1501,2967,864,307,303,4,91,1,0.066006601,0,empty,CD-0722-1
"F8,D3",9086,10386,6656,3730,4881,2499,1,2502,1644,858,1.916083916,1447,1727,364,125,123,2,38,1,0.243902439,0,empty,CD-0722-1
"F8,D4",9008,9992,6827,3165,4702,2357,0,2359,1550,809,1.915945612,1295,1408,353,88,86,2,24,1,0.046511628,0,empty,CD-0722-1
"F8,D5",8111,9167,6009,3158,4374,2209,0,2209,1400,809,1.73053152,1310,1469,290,124,124,0,48,0,0.024193548,0,empty,CD-0722-1
"F8,D6",11720,13085,8486,4599,6166,3270,1,3276,2013,1263,1.593824228,1909,1307,449,163,163,0,53,0,0.049079755,0,empty,CD-0722-1
"F8,D7",6822,7438,5129,2309,3562,1692,0,1694,1163,531,2.190207156,952,1879,554,202,202,0,43,0,0.004950495,0,empty,CD-0722-1
"F8,D8",8352,9023,6355,2668,4288,2090,0,2096,1324,772,1.715025907,1163,1218,291,123,123,0,48,0,0.097560976,0,empty,CD-0722-1
"F8,D9",4515,4739,3327,1412,2296,1096,0,1097,687,410,1.675609756,602,1593,462,136,135,1,38,1,0.044444444,0,empty,CD-0722-1
"F8,D10",7761,8613,5844,2769,4065,2063,0,2068,1273,795,1.601257862,1183,660,109,46,46,0,14,0,0.195652174,0,empty,CD-0722-1
"F8,D11",9762,10820,7391,3429,5168,2519,4,2524,1637,887,1.845546787,1404,2898,764,278,277,1,81,1,0.086642599,0,empty,CD-0722-1
"F8,D12",11666,12734,8630,4104,6008,2946,1,2949,1921,1028,1.868677043,1657,3849,1255,397,392,5,88,2,0.119897959,0,empty,CD-0722-1
"F8,E1",14208,15766,10594,5172,7431,3782,0,3784,2422,1362,1.778267254,2116,2525,546,187,184,3,68,2,0.184782609,0,empty,CD-0722-1
"F8,E2",10249,11194,7740,3454,5432,2714,0,2719,1699,1020,1.665686275,1499,1789,299,110,107,3,46,1,0.08411215,0,empty,CD-0722-1
"F8,E3",7325,7996,5596,2400,3817,1847,0,1849,1230,619,1.987075929,1044,2074,325,119,117,2,52,2,0.034188034,0,empty,CD-0722-1
"F8,E4",9408,10514,7095,3419,5147,2544,0,2546,1687,859,1.963911525,1487,2565,662,250,248,2,70,2,0.088709677,0,empty,CD-0722-1
"F8,E5",9154,9916,7081,2835,4569,2122,0,2123,1404,719,1.9527121,1138,1409,339,128,127,1,33,1,0.047244094,0,empty,CD-0722-1
"F8,E6",27797,30291,20842,9449,13916,6882,0,6889,5075,1814,2.797684675,3842,9600,2843,786,784,2,173,1,0.095663265,0,empty,CD-0722-1
"F8,E7",13400,14724,10097,4627,6839,3273,0,3281,2136,1145,1.865502183,1851,3325,679,246,241,5,77,2,0.095435685,0,empty,CD-0722-1
"F8,E8",57600,65162,43592,21570,29545,15675,0,15699,10721,4978,2.153676175,8789,3836,720,253,251,2,71,2,0.179282869,0,empty,CD-0722-1
"F8,E9",6583,7243,4995,2248,3475,1684,1,1685,1147,538,2.13197026,949,2271,549,187,180,7,58,3,0.038888889,0,empty,CD-0722-1
"F8,E10",8192,9078,6140,2938,4324,2098,0,2100,1315,785,1.675159236,1217,1507,456,193,191,2,52,1,0.005235602,0,empty,CD-0722-1
"F8,E11",9865,11289,7499,3790,5336,2724,0,2727,1729,998,1.73246493,1594,2298,413,147,145,2,45,1,0.082758621,0,empty,CD-0722-1
"F8,E12",10484,11810,7766,4044,5556,2864,0,2868,1764,1104,1.597826087,1684,1686,346,95,95,0,36,0,0.010526316,0,empty,CD-0722-1
"F8,F1",12160,13265,9075,4190,6291,3035,6,3043,1913,1130,1.692920354,1681,2255,649,193,192,1,45,1,0.057291667,0,empty,CD-0722-1
"F8,F2",10038,11039,7370,3669,5145,2439,0,2443,1576,867,1.817762399,1439,2669,613,231,228,3,77,1,0.114035088,0,empty,CD-0722-1
"F8,F3",2052516,2491939,1444268,1047671,1153408,736094,7,736756,487512,249244,1.955962832,457316,133044,23173,7307,7145,162,1334,7,0.055703289,0,hg38,CD-0722-1
"F8,F4",14762,15814,10812,5002,7488,3538,1,3545,2362,1183,1.996618766,2022,796,179,63,63,0,25,0,0,0,empty,CD-0722-1
"F8,F5",11458,12358,8638,3720,5814,2691,0,2694,1745,949,1.838777661,1519,2008,518,156,153,3,51,2,0.078431373,0,empty,CD-0722-1
"F8,F6",11295,12540,8379,4161,5861,2989,0,2994,1950,1044,1.867816092,1699,2750,576,215,209,6,74,2,0.129186603,0,empty,CD-0722-1
"F8,F7",728306,814666,564302,250364,376166,183945,1,184168,140090,44078,3.178229502,103766,39475,5705,1864,1830,34,395,4,0.078688525,0,hg38,CD-0722-1
"F8,F8",662952,743845,511666,232179,343821,171246,1,171464,129059,42405,3.043485438,96776,5216,594,197,193,4,61,2,0.025906736,0,hg38,CD-0722-1
"F8,F9",9618,10508,7365,3143,4960,2340,0,2345,1584,761,2.081471748,1308,2075,475,154,153,1,55,1,0.071895425,0,empty,CD-0722-1
"F8,F10",877798,951761,690661,261100,436482,196806,2,197031,160038,36993,4.326169816,107192,37015,11314,3433,3389,44,603,3,0.012097964,0,hg38,CD-0722-1
"F8,F11",9415,10103,7219,2884,4796,2283,0,2286,1534,752,2.039893617,1189,1759,440,127,126,1,31,1,0.055555556,0,empty,CD-0722-1
"F8,F12",10590,11580,7788,3792,5428,2673,0,2679,1744,935,1.865240642,1551,133,3,3,2,1,2,1,0,0,empty,CD-0722-1
"F8,G1",12141,13323,9185,4138,6309,3033,0,3036,1977,1059,1.866855524,1697,2710,705,232,232,0,82,0,0.086206897,0,empty,CD-0722-1
"F8,G2",7311,8055,5170,2885,3792,2018,0,2020,1242,778,1.596401028,1173,485,202,52,51,1,14,1,0,0,empty,CD-0722-1
"F8,G3",13004,13944,9827,4117,6697,3341,0,3341,2022,1319,1.53297953,1783,2360,739,230,228,2,78,2,0.026315789,0,empty,CD-0722-1
"F8,G4",23039,26087,16769,9318,12275,6827,0,6833,4082,2751,1.483824064,3965,98,27,16,15,1,9,1,0.4,0,empty,CD-0722-1
"F8,G5",8076,9048,5905,3143,4367,2162,0,2162,1379,783,1.761174968,1288,1444,315,121,121,0,39,0,0.049586777,0,empty,CD-0722-1
"F8,G6",1020147,1142529,788199,354330,518624,256765,2,257047,204178,52869,3.861960695,145272,18617,2764,826,806,20,190,2,0.052109181,0,hg38,CD-0722-1
"F8,G7",719123,814668,542731,271937,378690,197776,4,198008,152618,45390,3.362370566,114164,59976,10386,3384,3306,78,678,4,0.031760436,0,hg38,CD-0722-1
"F8,G8",2063020,2455472,1474494,980978,1120427,697042,7,697710,515082,182628,2.820388987,424086,148203,16525,5643,5440,203,1115,6,0.075367647,0,hg38,CD-0722-1
"F8,G9",8222,8964,6062,2902,4314,2128,0,2129,1326,803,1.651307597,1229,2256,435,141,135,6,47,2,0.118518519,0,empty,CD-0722-1
"F8,G10",10244,11459,7597,3862,5414,2700,0,2716,1841,875,2.104,1584,2422,581,193,192,1,62,1,0.057291667,0,empty,CD-0722-1
"F8,G11",9526,10502,7258,3244,4969,2375,0,2379,1550,829,1.869722557,1331,1347,313,110,110,0,40,0,0.036363636,0,empty,CD-0722-1
"F8,G12",8274,9201,6114,3087,4308,2143,0,2143,1337,806,1.658808933,1262,1976,507,178,175,3,61,2,0.028571429,0,empty,CD-0722-1
"F8,H1",7993,8859,6013,2846,4176,2046,0,2050,1305,745,1.751677852,1175,974,267,88,88,0,23,0,0,0,empty,CD-0722-1
"F8,H2",9523,10492,7084,3408,4854,2345,0,2348,1468,880,1.668181818,1335,2824,743,238,236,2,71,1,0.059322034,0,empty,CD-0722-1
"F8,H3",8125,9142,5967,3175,4317,2239,0,2241,1470,771,1.906614786,1344,1179,279,76,76,0,33,0,0.131578947,0,empty,CD-0722-1
"F8,H4",11849,13071,8841,4230,6124,3010,0,3011,1954,1057,1.848628193,1726,181,46,25,24,1,11,1,0,0,empty,CD-0722-1
"F8,H5",12857,14093,9576,4517,6311,3133,0,3136,2043,1093,1.869167429,1754,1966,679,208,208,0,49,0,0.024038462,0,empty,CD-0722-1
"F8,H6",7162,7829,5361,2468,3697,1912,1,1916,1261,655,1.92519084,1075,2133,565,155,154,1,41,1,0.064935065,0,empty,CD-0722-1
"F8,H7",8746,9386,6601,2785,4429,2076,2,2080,1381,699,1.975679542,1105,1986,492,148,147,1,54,1,0.006802721,0,empty,CD-0722-1
"F8,H8",9442,10574,7081,3493,4949,2545,6,2551,1636,915,1.787978142,1416,2229,461,166,162,4,39,2,0.018518519,0,empty,CD-0722-1
"F8,H9",7662,8339,5857,2482,3854,1767,0,1770,1222,548,2.229927007,964,908,222,69,65,4,18,2,0.384615385,0,empty,CD-0722-1
"F8,H10",7510,8237,5534,2703,3842,1914,1,1919,1256,663,1.894419306,1058,1273,309,82,79,3,30,2,0.126582278,0,empty,CD-0722-1
"F8,H11",8567,9913,6064,3849,4713,2801,1,2808,1512,1296,1.166666667,1661,66,17,3,3,0,3,0,0,0,empty,CD-0722-1
"F8,H12",7483,8502,5415,3087,3937,2038,0,2040,1329,711,1.869198312,1229,245261,12043,3929,3643,286,638,6,0.018665935,0,empty,CD-0722-1
"F9,A1",6732,7405,4948,2457,3570,1866,0,1866,1240,626,1.980830671,1015,1595,454,155,152,3,59,1,0.072368421,0,empty,CD-0722-1
"F9,A2",9787,10558,7292,3266,5106,2549,0,2551,1614,937,1.722518677,1397,2148,496,199,196,3,80,1,0.137755102,0,empty,CD-0722-1
"F9,A3",6408,6940,4760,2180,3297,1648,0,1650,1057,593,1.782462057,925,1016,292,105,99,6,33,1,0.01010101,0,empty,CD-0722-1
"F9,A4",864496,1066625,607720,458905,488448,322909,6,323190,230423,92767,2.483889745,195716,2667,246,81,78,3,44,1,0.038461538,0,empty,CD-0722-1
"F9,A5",8942,9586,6666,2920,4782,2327,0,2327,1506,821,1.834348356,1297,2771,572,222,217,5,71,2,0.082949309,0,empty,CD-0722-1
"F9,A6",9903,11268,7459,3809,5434,2772,1,2779,1890,889,2.125984252,1607,3194,714,299,292,7,115,2,0.044520548,0,empty,CD-0722-1
"F9,A7",6868,7539,5080,2459,3724,1943,0,1945,1301,644,2.020186335,1122,1367,285,130,130,0,65,0,0.084615385,0,empty,CD-0722-1
"F9,A8",4452,5034,3290,1744,2437,1239,0,1242,862,380,2.268421053,716,2447,579,215,214,1,84,1,0.102803738,0,empty,CD-0722-1
"F9,A9",7052,7958,5482,2476,3737,1874,0,1876,1251,625,2.0016,1073,2048,363,158,156,2,53,2,0.096153846,0,empty,CD-0722-1
"F9,A10",7747,8575,5826,2749,4120,2019,0,2021,1277,744,1.716397849,1180,571,67,37,32,5,15,2,0,0,empty,CD-0722-1
"F9,A11",6182,6872,4730,2142,3357,1592,0,1595,1078,517,2.085106383,927,2026,340,132,127,5,53,2,0.149606299,0,empty,CD-0722-1
"F9,A12",8021,8762,6159,2603,3988,1884,1,1886,1246,640,1.946875,980,3226,744,263,261,2,81,2,0.057471264,0,empty,CD-0722-1
"F9,B1",7540,8332,5557,2775,3955,2014,5,2029,1251,778,1.607969152,1123,1707,379,149,146,3,51,2,0.226027397,0,empty,CD-0722-1
"F9,B2",360515,443602,237032,206570,210250,143220,2,143355,101941,41414,2.4615106,90038,1407,160,72,72,0,40,0,0.013888889,0,empty,CD-0722-1
"F9,B3",6020,6617,4511,2106,3116,1541,0,1543,1034,509,2.031434185,870,1430,339,125,125,0,43,0,0.032,0,empty,CD-0722-1
"F9,B4",6714,7682,4931,2751,3707,2004,0,2009,1227,782,1.569053708,1186,1815,383,166,162,4,50,2,0.12345679,0,empty,CD-0722-1
"F9,B5",7159,3702,2239,1463,2420,1285,2,1303,783,520,1.505769231,845,1242,250,96,96,0,34,0,0.010416667,0,empty,CD-0722-1
"F9,B6",7741,8787,5485,3302,4183,2224,0,2232,1420,812,1.748768473,1362,1858,402,137,135,2,47,1,0.140740741,0,empty,CD-0722-1
"F9,B7",972340,1183274,713526,469748,541818,317274,2,317603,247738,69865,3.545952909,191915,25500,5971,1697,1679,18,490,3,0.016081001,0,hg38,CD-0722-1
"F9,B8",586719,659458,453690,205768,305768,154200,5,154348,118952,35396,3.360605718,86077,85952,12763,4300,4201,99,812,6,0.032611283,0,hg38,CD-0722-1
"F9,B9",463651,561315,322683,238632,265584,165850,0,166003,135138,30865,4.378357363,102863,6675,1876,453,446,7,184,3,0.01793722,0,hg38,CD-0722-1
"F9,B10",5143,5331,3598,1733,2750,1369,0,1374,900,474,1.898734177,783,497,50,26,25,1,13,1,0.16,0,empty,CD-0722-1
"F9,B11",11701,13171,8447,4724,6254,3440,1,3445,1983,1462,1.356361149,2050,381,130,54,54,0,21,0,0.018518519,0,empty,CD-0722-1
"F9,B12",6676,7591,4986,2605,3621,1865,0,1865,1242,623,1.993579454,1081,1692,304,128,125,3,57,2,0.08,0,empty,CD-0722-1
"F9,C1",13259,14248,10096,4152,6626,3159,0,3159,1994,1165,1.711587983,1675,1289,283,100,99,1,30,1,0.060606061,0,empty,CD-0722-1
"F9,C2",10709,12007,7888,4119,5614,2847,0,2847,1861,986,1.887423935,1681,1842,444,148,148,0,53,0,0.222972973,0,empty,CD-0722-1
"F9,C3",12816,14633,9421,5212,7010,3698,0,3709,2394,1315,1.820532319,2142,1236,213,67,67,0,32,0,0.328358209,0,empty,CD-0722-1
"F9,C4",6947,7618,5250,2368,3626,1680,0,1680,1078,602,1.790697674,942,1810,375,148,147,1,75,1,0.013605442,0,empty,CD-0722-1
"F9,C5",10266,11765,7572,4193,5593,2894,0,2894,1951,943,2.06892895,1733,2755,611,220,217,3,92,2,0.101382488,0,empty,CD-0722-1
"F9,C6",874712,1012989,651875,361114,476592,257459,3,257771,204793,52978,3.865623466,150974,168021,27625,9155,8984,171,1563,5,0.047974176,0,hg38,CD-0722-1
"F9,C7",12017,13854,8864,4990,6410,3489,0,3491,2193,1298,1.689522342,2032,930,143,70,68,2,34,1,0,0,empty,CD-0722-1
"F9,C8",14581,16514,10923,5591,7875,4005,0,4010,2699,1311,2.058733791,2326,3247,669,235,233,2,91,2,0.158798283,0,empty,CD-0722-1
"F9,C9",8984,9961,6830,3131,4777,2335,0,2338,1524,814,1.872235872,1306,1839,342,149,148,1,53,1,0.060810811,0,empty,CD-0722-1
"F9,C10",10468,11595,7865,3730,5448,2674,0,2675,1684,991,1.699293643,1514,2602,601,189,187,2,64,1,0.053475936,0,empty,CD-0722-1
"F9,C11",9021,10325,6612,3713,4924,2485,0,2489,1530,959,1.595411887,1478,2098,449,147,147,0,68,0,0.034013605,0,empty,CD-0722-1
"F9,C12",674027,817967,464021,353946,377038,246924,3,247131,172298,74833,2.302433418,150522,6155,1041,331,325,6,106,2,0.329230769,0,hg38,CD-0722-1
"F9,D1",10788,12220,7915,4305,5887,3090,0,3092,1898,1194,1.58961474,1828,876,174,68,66,2,24,1,0.045454545,0,empty,CD-0722-1
"F9,D2",9971,10954,7499,3455,5240,2511,0,2513,1599,914,1.749452954,1388,3053,717,264,263,1,97,1,0.015209125,0,empty,CD-0722-1
"F9,D3",7884,8634,5843,2791,4212,2052,0,2055,1380,675,2.044444444,1168,2027,427,168,163,5,71,2,0.09202454,0,empty,CD-0722-1
"F9,D4",1588839,1996841,1089305,907536,929097,637787,4,638250,479777,158473,3.027499953,397277,9776,1307,419,411,8,142,2,0.111922141,0,hg38,CD-0722-1
"F9,D5",1707584,2032340,1276501,755839,927311,530448,1,530953,442151,88802,4.979065787,317395,231117,37777,12111,11928,183,1951,6,0.059607646,0,hg38,CD-0722-1
"F9,D6",11062,12313,7913,4400,5735,3101,0,3103,1912,1191,1.605373636,1843,2388,667,220,217,3,87,1,0.013824885,0,empty,CD-0722-1
"F9,D7",517015,575351,394921,180430,268621,133854,7,134024,100080,33944,2.948385576,76345,49986,13285,4166,4124,42,721,5,0.020126091,0,hg38,CD-0722-1
"F9,D8",7471,8359,5567,2792,3996,1974,0,1983,1327,656,2.022865854,1141,1392,329,142,136,6,65,1,0,0,empty,CD-0722-1
"F9,D9",4896,5385,3568,1817,2515,1204,0,1204,844,360,2.344444444,680,2297,532,195,195,0,69,0,0.112820513,0,empty,CD-0722-1
"F9,D10",7278,8159,5356,2803,3822,1917,0,1917,1248,669,1.865470852,1109,930,108,50,48,2,17,1,0,0,empty,CD-0722-1
"F9,D11",8218,9052,6165,2887,4421,2206,0,2208,1424,784,1.816326531,1237,3774,772,286,280,6,125,2,0.014285714,0,empty,CD-0722-1
"F9,D12",854996,1005128,634542,370586,459137,252569,4,252885,204808,48077,4.259999584,150650,175318,27994,8677,8513,164,1640,7,0.041113591,0,hg38,CD-0722-1
"F9,E1",13101,14630,9667,4963,6897,3559,0,3559,2272,1287,1.765345765,2038,3285,462,240,235,5,120,2,0.042553191,0,empty,CD-0722-1
"F9,E2",9848,11061,7174,3887,5219,2687,0,2689,1736,953,1.82161595,1595,2533,553,161,158,3,73,1,0.063291139,0,empty,CD-0722-1
"F9,E3",567981,661161,430127,231034,306725,162726,2,162864,126952,35912,3.535085765,95794,110943,12667,4060,3935,125,923,4,0.040660737,0,hg38,CD-0722-1
"F9,E4",8776,9498,6506,2992,4643,2237,0,2240,1446,794,1.82115869,1285,3537,646,237,232,5,95,2,0.120689655,0,empty,CD-0722-1
"F9,E5",8203,9154,6225,2929,4369,2054,1,2061,1287,774,1.662790698,1175,1443,299,120,119,1,60,1,0.067226891,0,empty,CD-0722-1
"F9,E6",13172,14857,9872,4985,7056,3544,0,3550,2223,1327,1.675207234,2129,4279,1009,332,325,7,89,2,0.104615385,0,empty,CD-0722-1
"F9,E7",11749,12889,8787,4102,6164,2971,0,2975,1897,1078,1.75974026,1673,3721,786,306,304,2,95,2,0.092105263,0,empty,CD-0722-1
"F9,E8",797905,897127,612713,284414,410775,207338,4,207568,159848,47720,3.349706622,117380,426036,40668,13857,13344,513,2176,6,0.051109113,0,hg38,CD-0722-1
"F9,E9",669330,806056,488187,317869,372041,213709,0,213952,173089,40863,4.235836821,129749,124587,26239,8407,8325,82,1516,3,0.047327327,0,hg38,CD-0722-1
"F9,E10",8138,8915,6139,2776,4109,1966,0,1968,1281,687,1.864628821,1092,2516,766,274,271,3,98,2,0.070110701,0,empty,CD-0722-1
"F9,E11",8828,9731,6556,3175,4575,2233,0,2235,1465,770,1.902597403,1220,2383,398,166,164,2,59,1,0.036585366,0,empty,CD-0722-1
"F9,E12",9425,10246,7081,3165,4927,2439,0,2442,1617,825,1.96,1354,2314,349,145,143,2,54,1,0.048951049,0,empty,CD-0722-1
"F9,F1",11249,12256,8438,3818,5773,2808,0,2812,1794,1018,1.762278978,1627,2152,496,217,216,1,86,1,0.018518519,0,empty,CD-0722-1
"F9,F2",749758,893777,530022,363755,413959,257027,5,257275,187037,70238,2.662903272,156504,48577,2254,939,852,87,284,4,0.178403756,0,hg38,CD-0722-1
"F9,F3",8410,9218,6275,2943,4530,2235,0,2236,1517,719,2.109874826,1266,3122,881,324,319,5,104,2,0.087774295,0,empty,CD-0722-1
"F9,F4",13005,13837,9666,4171,6595,3119,0,3125,2043,1082,1.888170055,1710,1097,231,106,105,1,63,1,0.038095238,0,empty,CD-0722-1
"F9,F5",10678,11406,8033,3373,5400,2472,0,2474,1595,879,1.814562002,1368,2504,681,258,254,4,77,2,0.023622047,0,empty,CD-0722-1
"F9,F6",9813,11114,7278,3836,5380,2753,0,2762,1743,1019,1.710500491,1619,3258,615,253,249,4,97,1,0.084337349,0,empty,CD-0722-1
"F9,F7",2188948,2604338,1619868,984470,1166489,671434,2,672124,537347,134777,3.986933972,403513,137979,19794,6443,6257,186,1186,5,0.057056097,0,hg38,CD-0722-1
"F9,F8",815603,966581,604319,362262,445241,249768,7,250067,194444,55623,3.495748162,149495,11079,1638,651,630,21,150,2,0.022222222,0,hg38,CD-0722-1
"F9,F9",8719,9186,6548,2638,4376,2006,0,2006,1339,667,2.007496252,1092,2708,557,195,193,2,67,2,0.015544041,0,empty,CD-0722-1
"F9,F10",11919,13097,9237,3860,6115,2880,0,2884,1861,1023,1.819159335,1553,2138,693,232,230,2,62,1,0.017391304,0,empty,CD-0722-1
"F9,F11",8195,8958,6284,2674,4282,1982,0,1987,1329,658,2.019756839,1076,2075,450,160,158,2,50,2,0.278481013,0,empty,CD-0722-1
"F9,F12",9601,10511,7130,3381,5018,2468,0,2473,1556,917,1.696837514,1441,197,90,52,51,1,19,1,0.137254902,0,empty,CD-0722-1
"F9,G1",11095,12115,8398,3717,5814,2785,0,2791,1870,921,2.030401737,1600,3264,858,293,292,1,110,1,0.058219178,0,empty,CD-0722-1
"F9,G2",6433,7098,4564,2534,3308,1721,0,1723,1072,651,1.646697389,1019,532,108,50,50,0,24,0,0,0,empty,CD-0722-1
"F9,G3",2580476,2994235,1921281,1072954,1333996,745606,3,746385,601348,145037,4.146169598,442940,428767,61941,20432,19998,434,2722,11,0.050005001,0,hg38,CD-0722-1
"F9,G4",20247,23233,14644,8589,10941,6029,0,6034,3679,2355,1.562208068,3532,190,18,14,14,0,13,0,0.214285714,0,empty,CD-0722-1
"F9,G5",7594,8468,5719,2749,3956,1940,0,1942,1258,684,1.839181287,1095,1826,324,160,159,1,60,1,0.100628931,0,empty,CD-0722-1
"F9,G6",10579,11690,8062,3628,5588,2729,0,2735,1824,911,2.00219539,1571,185,22,16,16,0,12,0,0.125,0,empty,CD-0722-1
"F9,G7",8832,9296,6673,2623,4499,2142,0,2143,1430,713,2.005610098,1143,2819,720,237,235,2,82,2,0.029787234,0,empty,CD-0722-1
"F9,G8",6154,6759,4628,2131,3122,1518,0,1518,973,545,1.785321101,822,1979,446,149,147,2,50,1,0.088435374,0,empty,CD-0722-1
"F9,G9",7682,8365,5642,2723,3962,1929,0,1933,1210,723,1.673582296,1126,2908,778,293,293,0,98,0,0.105802048,0,empty,CD-0722-1
"F9,G10",696625,791105,522357,268748,365821,193717,1,193945,154081,39864,3.865166566,111671,84763,18852,5946,5868,78,1103,5,0.025903204,0,hg38,CD-0722-1
"F9,G11",8901,9976,6734,3242,4665,2251,0,2257,1457,800,1.82125,1266,1911,441,167,164,3,69,2,0.158536585,0,empty,CD-0722-1
"F9,G12",7417,8498,5519,2979,3871,1973,0,1973,1286,687,1.871906841,1122,2257,412,132,131,1,63,1,0.06870229,0,empty,CD-0722-1
"F9,H1",7635,8274,5569,2705,4035,1966,0,1966,1338,628,2.130573248,1084,1436,362,154,150,4,39,2,0.02,0,empty,CD-0722-1
"F9,H2",8647,9730,6423,3307,4485,2255,0,2256,1436,820,1.751219512,1279,2707,650,219,216,3,80,1,0.046296296,0,empty,CD-0722-1
"F9,H3",6922,7284,5223,2061,3479,1704,0,1709,1103,606,1.820132013,885,2002,287,128,126,2,56,2,0.103174603,0,empty,CD-0722-1
"F9,H4",10446,11519,7787,3732,5443,2680,0,2683,1724,959,1.797705944,1553,254,79,41,40,1,18,1,0.05,0,empty,CD-0722-1
"F9,H5",11834,13221,8803,4418,6056,3064,0,3065,1947,1118,1.741502683,1745,1839,462,141,140,1,53,1,0.028571429,0,empty,CD-0722-1
"F9,H6",6240,6785,4559,2226,3355,1714,3,1719,1101,618,1.781553398,1001,1873,436,165,164,1,67,1,0.048780488,0,empty,CD-0722-1
"F9,H7",1489683,1647998,1138934,509064,753273,380597,24,381086,302430,78656,3.844970504,214360,288190,52690,16687,16418,269,2327,5,0.056157876,0,hg38,CD-0722-1
"F9,H8",15265,17296,11299,5997,8183,4402,1,4408,3130,1278,2.44913928,2481,2377,457,141,139,2,42,2,0.064748201,0,empty,CD-0722-1
"F9,H9",6885,7590,5155,2435,3547,1702,1,1704,1127,577,1.953206239,964,1570,251,104,102,2,40,1,0.107843137,0,empty,CD-0722-1
"F9,H10",6275,6875,4549,2326,3226,1607,1,1613,1077,536,2.009328358,901,1577,365,140,139,1,41,1,0.035971223,0,empty,CD-0722-1
"F9,H11",7657,8794,5366,3428,4167,2519,0,2521,1423,1098,1.295992714,1485,170,21,13,13,0,9,0,0.076923077,0,empty,CD-0722-1
"F9,H12",6468,6820,4675,2145,3351,1727,1,1730,1097,633,1.733017378,986,2084,377,174,171,3,58,1,0.005847953,0,empty,CD-0722-1
"F10,A1",696615,874325,473067,401258,412743,272322,1,272596,228415,44181,5.169982572,173737,6389,1866,515,513,2,154,1,0.04288499,0,hg38,CD-0722-1
"F10,A2",12775,14100,9520,4580,6731,3412,0,3419,2187,1232,1.775162338,1895,1957,415,153,152,1,59,1,0.052631579,0,empty,CD-0722-1
"F10,A3",7066,7629,5277,2352,3670,1788,0,1789,1147,642,1.786604361,986,1108,271,102,102,0,29,0,0.068627451,0,empty,CD-0722-1
"F10,A4",1038525,1195399,792280,403119,539678,283966,3,284275,229179,55096,4.159630463,163182,74292,10390,3326,3254,72,662,4,0.069452981,0,hg38,CD-0722-1
"F10,A5",11125,12282,8248,4034,5848,2827,3,2838,1807,1031,1.752667313,1628,2954,645,259,256,3,72,2,0.08203125,0,empty,CD-0722-1
"F10,A6",9429,10878,7038,3840,5233,2826,2,2833,1856,977,1.899692938,1659,3150,666,223,223,0,88,0,0.058295964,0,empty,CD-0722-1
"F10,A7",8133,8979,6036,2943,4368,2252,0,2256,1446,810,1.785185185,1239,1865,572,193,193,0,65,0,0.082901554,0,empty,CD-0722-1
"F10,A8",5071,5647,3878,1769,2720,1346,1,1348,949,399,2.378446115,713,2206,456,160,158,2,55,1,0.082278481,0,empty,CD-0722-1
"F10,A9",10658,11792,7927,3865,5827,3015,0,3021,2061,960,2.146875,1691,2326,535,211,208,3,69,1,0.0625,0,empty,CD-0722-1
"F10,A10",9959,10924,7507,3417,5166,2524,0,2525,1657,868,1.908986175,1384,426,100,55,54,1,24,1,0.203703704,0,empty,CD-0722-1
"F10,A11",8188,8743,6184,2559,4254,2010,0,2013,1312,701,1.871611983,1107,1680,302,114,114,0,55,0,0.096491228,0,empty,CD-0722-1
"F10,A12",10694,11730,8148,3582,5527,2672,0,2672,1705,967,1.763185109,1504,3977,936,342,339,3,99,2,0.04719764,0,empty,CD-0722-1
"F10,B1",897586,1035577,676253,359324,470382,249164,2,249438,195251,54187,3.60328123,145478,119574,16857,5553,5442,111,1097,7,0.057148107,0,hg38,CD-0722-1
"F10,B2",9192,9950,6502,3448,4831,2569,0,2574,1635,939,1.741214058,1463,863,271,119,118,1,30,1,0.050847458,0,empty,CD-0722-1
"F10,B3",7489,8504,5543,2961,4146,2100,1,2105,1378,727,1.895460798,1304,1893,375,143,133,10,49,2,0.135338346,0,empty,CD-0722-1
"F10,B4",726088,849375,541531,307844,391459,210956,4,211179,165869,45310,3.660759214,125689,124870,17235,5855,5724,131,1105,7,0.073025856,0,hg38,CD-0722-1
"F10,B5",699460,349740,208267,141473,229783,122407,10,123335,102478,20857,4.91336242,80608,5466,2271,746,738,8,170,3,0.010840108,0,hg38,CD-0722-1
"F10,B6",9941,11232,7092,4140,5331,2870,0,2878,1772,1106,1.602169982,1754,1885,526,195,195,0,48,0,0.061538462,0,empty,CD-0722-1
"F10,B7",8740,9840,6646,3194,4643,2319,0,2325,1537,788,1.950507614,1345,1415,322,98,98,0,29,0,0.132653061,0,empty,CD-0722-1
"F10,B8",6428,6945,4979,1966,3421,1622,0,1625,1126,499,2.256513026,879,1385,299,124,116,8,40,2,0.120689655,0,empty,CD-0722-1
"F10,B9",624297,682030,485578,196452,314354,147523,2,147702,109168,38534,2.83303057,81788,21411,4067,1219,1194,25,269,3,0.015075377,0,hg38,CD-0722-1
"F10,B10",6372,6623,4427,2196,3359,1702,2,1716,1082,634,1.706624606,968,567,117,30,29,1,15,1,0.103448276,0,empty,CD-0722-1
"F10,B11",13221,14924,9699,5225,7051,3899,1,3903,2275,1628,1.397420147,2275,249,16,11,11,0,7,0,0.363636364,0,empty,CD-0722-1
"F10,B12",8290,9176,6206,2970,4359,2154,3,2158,1444,714,2.022408964,1230,2100,420,136,135,1,49,1,0.081481481,0,empty,CD-0722-1
"F10,C1",14522,16268,10951,5317,7612,3733,0,3738,2365,1373,1.722505462,2145,1170,241,73,73,0,28,0,0.123287671,0,empty,CD-0722-1
"F10,C2",11848,12806,8716,4090,5932,2956,0,2959,1910,1049,1.820781697,1648,2502,764,229,228,1,72,1,0.048245614,0,empty,CD-0722-1
"F10,C3",12791,14134,9581,4553,6809,3329,0,3331,2117,1214,1.743822076,1861,1111,168,78,76,2,35,2,0.263157895,0,empty,CD-0722-1
"F10,C4",8703,9340,6607,2733,4484,2086,0,2088,1373,715,1.92027972,1169,1752,296,110,110,0,45,0,0.154545455,0,empty,CD-0722-1
"F10,C5",12884,14130,9450,4680,6878,3456,1,3464,2328,1136,2.049295775,1948,1847,280,112,110,2,52,1,0.054545455,0,empty,CD-0722-1
"F10,C6",10452,11699,7712,3987,5828,2972,0,2979,2002,977,2.04912999,1756,1865,408,166,163,3,61,2,0.036809816,0,empty,CD-0722-1
"F10,C7",14665,16382,10575,5807,7882,4347,1,4356,2751,1605,1.714018692,2576,779,106,65,65,0,25,0,0.030769231,0,empty,CD-0722-1
"F10,C8",15387,16551,11362,5189,7939,3941,1,3949,2631,1318,1.996206373,2148,3235,650,245,245,0,79,0,0.155102041,0,empty,CD-0722-1
"F10,C9",809144,985862,587990,397872,454256,264808,1,265047,206816,58231,3.551647748,163924,98423,13156,4564,4465,99,852,5,0.069428891,0,hg38,CD-0722-1
"F10,C10",12150,13405,9127,4278,6290,3015,1,3018,2027,991,2.045408678,1657,2495,482,170,170,0,49,0,0.005882353,0,empty,CD-0722-1
"F10,C11",10106,11220,7543,3677,5435,2710,1,2715,1764,951,1.85488959,1559,2535,688,275,274,1,71,1,0.156934307,0,empty,CD-0722-1
"F10,C12",15642,16498,11499,4999,8122,3877,0,3882,2592,1290,2.009302326,2175,2416,514,149,148,1,47,1,0.027027027,0,empty,CD-0722-1
"F10,D1",836425,948040,632990,315050,437214,226803,4,227096,181413,45683,3.971127115,131176,24979,3382,1034,1010,24,240,2,0.027722772,0,hg38,CD-0722-1
"F10,D2",708156,794550,542536,252014,366679,185894,2,186115,140422,45693,3.073162191,105507,90845,17759,5585,5488,97,961,5,0.026239067,0,hg38,CD-0722-1
"F10,D3",10330,11554,7580,3974,5509,2820,0,2820,1834,986,1.860040568,1646,2307,421,153,147,6,48,2,0.027210884,0,empty,CD-0722-1
"F10,D4",690660,781289,523933,257356,366919,199094,1,199309,147327,51982,2.834192605,112849,34240,9506,2851,2830,21,535,3,0.012367491,0,hg38,CD-0722-1
"F10,D5",9208,10676,6822,3854,5030,2516,1,2520,1659,861,1.926829268,1484,2287,495,209,207,2,77,1,0.096618357,0,empty,CD-0722-1
"F10,D6",12606,14540,9059,5481,6640,3556,0,3562,2172,1390,1.562589928,2095,1898,439,173,171,2,54,1,0.087719298,0,empty,CD-0722-1
"F10,D7",7362,7974,5567,2407,3840,1859,0,1866,1231,635,1.938582677,1036,2017,625,216,215,1,61,1,0.004651163,0,empty,CD-0722-1
"F10,D8",973871,1156495,723479,433016,526543,294616,9,294935,229030,65905,3.47515363,177181,69300,11067,3696,3630,66,718,5,0.055371901,0,hg38,CD-0722-1
"F10,D9",5410,5783,4113,1670,2895,1367,1,1369,934,435,2.147126437,746,2256,548,186,185,1,60,1,0.178378378,0,empty,CD-0722-1
"F10,D10",7920,8448,5795,2653,3940,1904,1,1906,1229,677,1.815361891,1031,798,67,31,30,1,13,1,0.166666667,0,empty,CD-0722-1
"F10,D11",744896,872816,551785,321031,401106,224417,3,224646,179391,45255,3.964003977,132839,127746,27484,8491,8383,108,1402,3,0.030418705,0,hg38,CD-0722-1
"F10,D12",12877,14571,9530,5041,6921,3497,1,3510,2196,1314,1.671232877,2050,6883,1090,389,376,13,155,2,0.045212766,0,empty,CD-0722-1
"F10,E1",977387,1109548,739779,369769,503077,259469,2,259749,202687,57062,3.552048649,149643,171056,27721,9080,8873,207,1520,9,0.052856982,0,hg38,CD-0722-1
"F10,E2",10952,12344,8001,4343,5941,3022,0,3025,1895,1130,1.67699115,1796,2118,426,140,137,3,51,1,0.080291971,0,empty,CD-0722-1
"F10,E3",7664,8448,5866,2582,4046,1997,0,1999,1296,703,1.843527738,1098,2884,741,239,238,1,76,1,0.201680672,0,empty,CD-0722-1
"F10,E4",1793576,2072025,1357989,714036,929641,506609,6,507146,403906,103240,3.912301434,294953,258922,42124,14032,13746,286,2110,7,0.04044813,0,hg38,CD-0722-1
"F10,E5",8833,9563,6665,2898,4522,2129,1,2131,1387,744,1.864247312,1157,1792,351,125,125,0,46,0,0.032,0,empty,CD-0722-1
"F10,E6",15472,16981,11611,5370,7972,4021,0,4024,2529,1495,1.691638796,2225,3134,968,287,287,0,87,0,0.097560976,0,empty,CD-0722-1
"F10,E7",15030,16514,11382,5132,7692,3677,2,3683,2371,1312,1.807164634,1984,2742,624,222,221,1,71,1,0.036199095,0,empty,CD-0722-1
"F10,E8",11554,12850,8866,3984,5975,2858,3,2863,1906,957,1.991640543,1582,3114,797,235,234,1,71,1,0.025641026,0,empty,CD-0722-1
"F10,E9",8006,8469,5985,2484,4090,1956,0,1957,1273,684,1.861111111,1060,2839,767,297,296,1,75,1,0.057432432,0,empty,CD-0722-1
"F10,E10",8465,9309,6372,2937,4456,2104,1,2105,1381,724,1.907458564,1193,2252,507,176,175,1,60,1,0.057142857,0,empty,CD-0722-1
"F10,E11",10414,11527,7879,3648,5485,2721,1,2722,1729,993,1.741188318,1564,2868,626,227,223,4,64,2,0.080717489,0,empty,CD-0722-1
"F10,E12",612083,667501,475984,191517,313111,142846,1,143070,107760,35310,3.051826678,79164,88509,9755,3134,3070,64,608,5,0.116286645,0,hg38,CD-0722-1
"F10,F1",12718,14144,9628,4516,6620,3228,0,3232,2026,1206,1.679933665,1857,2230,353,129,128,1,61,1,0.0234375,0,empty,CD-0722-1
"F10,F2",11046,12116,8297,3819,5791,2811,0,2818,1855,963,1.926272066,1571,3504,972,355,355,0,104,0,0.115492958,0,empty,CD-0722-1
"F10,F3",9899,10735,7377,3358,5224,2524,0,2529,1709,820,2.084146341,1433,2490,361,173,171,2,81,2,0.035087719,0,empty,CD-0722-1
"F10,F4",14811,16088,11048,5040,7723,3707,1,3717,2395,1322,1.811649017,2131,624,56,33,32,1,24,1,0,0,empty,CD-0722-1
"F10,F5",11545,12789,8652,4137,5962,2861,0,2871,1831,1040,1.760576923,1652,2419,462,163,161,2,61,2,0.068322981,0,empty,CD-0722-1
"F10,F6",1004296,1223764,727830,495934,557563,328767,4,329092,256380,72712,3.525965453,202050,138272,33128,10529,10432,97,1692,4,0.061062117,0,hg38,CD-0722-1
"F10,F7",1357772,1628147,1012939,615208,728581,410142,5,410583,327877,82706,3.964367761,247342,84572,10160,3331,3245,86,805,6,0.029892142,0,hg38,CD-0722-1
"F10,F8",9693,10638,7205,3433,4982,2475,0,2482,1613,869,1.856156502,1437,175,43,19,19,0,11,0,0,0,empty,CD-0722-1
"F10,F9",10109,10933,7773,3160,5181,2376,0,2379,1543,836,1.84569378,1279,3087,872,282,281,1,72,1,0.085409253,0,empty,CD-0722-1
"F10,F10",13263,14336,10065,4271,6747,3271,0,3273,2114,1159,1.823986195,1802,2607,861,192,189,3,52,2,0.116402116,0,empty,CD-0722-1
"F10,F11",10603,11331,7969,3362,5503,2600,1,2609,1743,866,2.012702079,1394,2427,557,189,187,2,42,1,0.048128342,0,empty,CD-0722-1
"F10,F12",11185,12044,8326,3718,5707,2790,0,2796,1835,961,1.909469303,1614,218,22,18,18,0,12,0,0.055555556,0,empty,CD-0722-1
"F10,G1",12876,14011,9773,4238,6789,3212,0,3215,2183,1032,2.115310078,1828,3143,804,274,272,2,109,1,0.158088235,0,empty,CD-0722-1
"F10,G2",7349,8225,5146,3079,3902,2076,0,2078,1305,773,1.688227684,1281,486,142,49,49,0,18,0,0.081632653,0,empty,CD-0722-1
"F10,G3",13819,14815,9973,4842,7382,3732,0,3736,2375,1361,1.745040411,2105,2813,393,162,161,1,76,1,0.068322981,0,empty,CD-0722-1
"F10,G4",24105,26896,17309,9587,12856,7020,0,7033,4397,2636,1.668057663,4106,227,26,22,22,0,11,0,0,0,empty,CD-0722-1
"F10,G5",874970,1053603,630512,423091,489295,307612,3,307884,229029,78855,2.904432186,184286,11237,6705,1987,1983,4,366,2,0.005042864,0,hg38,CD-0722-1
"F10,G6",11617,13113,8807,4306,6088,2987,0,2996,1950,1046,1.864244742,1749,280,82,28,28,0,12,0,0.107142857,0,empty,CD-0722-1
"F10,G7",10602,11767,7955,3812,5698,2719,0,2721,1701,1020,1.667647059,1602,3054,683,273,270,3,77,1,0.022222222,0,empty,CD-0722-1
"F10,G8",6916,7710,5131,2579,3662,1813,0,1818,1156,662,1.746223565,1066,1621,484,164,160,4,65,1,0.04375,0,empty,CD-0722-1
"F10,G9",8456,9136,6378,2758,4310,2066,0,2068,1382,686,2.014577259,1109,2926,787,246,238,8,82,2,0.058823529,0,empty,CD-0722-1
"F10,G10",10453,11674,7700,3974,5659,2858,0,2858,1883,975,1.931282051,1597,2918,1003,376,374,2,102,2,0.077540107,0,empty,CD-0722-1
"F10,G11",10551,11272,8007,3265,5470,2537,0,2540,1695,845,2.00591716,1429,1576,443,159,158,1,60,1,0.037974684,0,empty,CD-0722-1
"F10,G12",8201,9349,6010,3339,4526,2311,0,2315,1460,855,1.707602339,1382,2003,539,156,153,3,59,2,0.006535948,0,empty,CD-0722-1
"F10,H1",9234,9910,6912,2998,4760,2216,0,2217,1445,772,1.871761658,1228,1343,386,149,145,4,39,2,0.027586207,0,empty,CD-0722-1
"F10,H2",10755,12032,8032,4000,5640,2749,0,2749,1763,986,1.788032454,1592,3056,799,306,299,7,97,2,0.023411371,0,empty,CD-0722-1
"F10,H3",8678,9645,6453,3192,4524,2229,0,2234,1496,738,2.027100271,1256,1976,347,134,131,3,53,2,0.030534351,0,empty,CD-0722-1
"F10,H4",12683,13958,9439,4519,6493,3287,0,3293,2173,1120,1.940178571,1871,315,65,37,37,0,13,0,0.081081081,0,empty,CD-0722-1
"F10,H5",12669,14204,9352,4852,6544,3319,0,3327,2107,1220,1.72704918,1908,1814,475,151,151,0,45,0,0.059602649,0,empty,CD-0722-1
"F10,H6",8049,9260,5965,3295,4367,2288,0,2290,1552,738,2.10298103,1365,2094,488,180,174,6,55,2,0.028735632,0,empty,CD-0722-1
"F10,H7",9800,11001,7378,3623,5066,2401,0,2409,1571,838,1.874701671,1368,2181,560,201,201,0,74,0,0.059701493,0,empty,CD-0722-1
"F10,H8",10412,11458,7634,3824,5412,2744,0,2753,1778,975,1.823589744,1594,2278,668,210,207,3,58,1,0.048309179,0,empty,CD-0722-1
"F10,H9",9162,10404,6813,3591,4897,2424,0,2426,1702,724,2.350828729,1431,1348,231,80,79,1,31,1,0,0,empty,CD-0722-1
"F10,H10",843357,1015366,612796,402570,461177,267956,2,268242,216357,51885,4.169933507,163601,54730,12893,4022,3983,39,755,3,0.061009289,0,hg38,CD-0722-1
"F10,H11",1460737,1745908,1082779,663129,779764,448122,8,448632,352659,95973,3.674564721,269862,4267,700,171,166,5,47,3,0.024096386,0,hg38,CD-0722-1
"F10,H12",8746,9435,6429,3006,4439,2298,0,2301,1552,749,2.072096128,1263,1542,335,120,117,3,47,2,0.094017094,0,empty,CD-0722-1
"F11,A1",5967,6792,4441,2351,3228,1697,0,1700,1087,613,1.77324633,993,690,188,63,62,1,23,1,0.129032258,0,empty,CD-0722-1
"F11,A2",147556,160320,109098,51222,74162,37292,0,37330,28748,8582,3.349801911,21044,4796,875,302,301,1,88,1,0.043189369,0,empty,CD-0722-1
"F11,A3",5398,5779,3998,1781,2740,1328,0,1332,830,502,1.653386454,731,1067,127,55,53,2,17,1,0,0,empty,CD-0722-1
"F11,A4",682348,807605,495283,312322,374680,230685,6,230885,183282,47603,3.850219524,134150,6712,3902,1103,1103,0,268,0,0.00543971,0,hg38,CD-0722-1
"F11,A5",8900,9661,6598,3063,4742,2363,1,2372,1515,857,1.767794632,1356,1277,230,103,103,0,44,0,0.038834951,0,empty,CD-0722-1
"F11,A6",6915,7641,5223,2418,3612,1883,0,1886,1213,673,1.802377415,1042,1949,557,196,194,2,59,2,0.036082474,0,empty,CD-0722-1
"F11,A7",6167,7120,4515,2605,3282,1682,0,1682,1114,568,1.961267606,994,837,149,74,74,0,32,0,0.297297297,0,empty,CD-0722-1
"F11,A8",3689,4172,2833,1339,2080,1059,0,1059,679,380,1.786842105,613,1191,261,118,118,0,45,0,0.042372881,0,empty,CD-0722-1
"F11,A9",6171,6848,4694,2154,3198,1573,0,1577,972,605,1.60661157,835,1197,412,115,113,2,33,1,0.185840708,0,empty,CD-0722-1
"F11,A10",7399,8131,5752,2379,3803,1842,0,1842,1169,673,1.736998514,1015,246,29,20,20,0,14,0,0,0,empty,CD-0722-1
"F11,A11",904005,1021318,689701,331617,471769,242396,6,242649,199238,43411,4.589574071,138609,82244,14025,4651,4575,76,881,4,0.015956284,0,hg38,CD-0722-1
"F11,A12",7706,8692,5919,2773,4022,1917,0,1920,1231,689,1.786647315,1058,2459,430,167,159,8,68,2,0.031446541,0,empty,CD-0722-1
"F11,B1",6269,6875,4677,2198,3266,1596,0,1597,1005,592,1.697635135,896,701,136,58,56,2,19,1,0,0,empty,CD-0722-1
"F11,B2",6556,7034,4524,2510,3438,1864,0,1868,1166,702,1.660968661,1082,405,103,52,48,4,18,2,0.020833333,0,empty,CD-0722-1
"F11,B3",5298,6038,3929,2109,2846,1486,0,1486,1016,470,2.161702128,880,1256,370,123,123,0,37,0,0.040650407,0,empty,CD-0722-1
"F11,B4",6308,7132,4635,2497,3446,1841,7,1851,1157,694,1.667146974,1055,833,111,58,54,4,26,1,0.12962963,0,empty,CD-0722-1
"F11,B5",7582,4935,2987,1948,2883,1567,0,1570,1024,546,1.875457875,1017,590,148,55,55,0,15,0,0.127272727,0,empty,CD-0722-1
"F11,B6",530493,631971,386762,245209,290767,165705,2,165860,131559,34301,3.835427539,99990,39232,6474,2256,2228,28,536,3,0.064183124,0,hg38,CD-0722-1
"F11,B7",6458,7197,5065,2132,3434,1657,0,1660,1086,574,1.891986063,887,776,218,85,84,1,21,1,0.130952381,0,empty,CD-0722-1
"F11,B8",4781,5162,3668,1494,2553,1246,0,1246,838,408,2.053921569,736,961,294,129,128,1,30,1,0.0078125,0,empty,CD-0722-1
"F11,B9",8783,9850,6189,3661,4824,2607,0,2608,1613,995,1.621105528,1563,687,135,53,52,1,22,1,0.057692308,0,empty,CD-0722-1
"F11,B10",487030,499891,338104,161787,243650,119035,30,120163,89453,30710,2.912829697,70253,22499,2249,781,758,23,188,3,0.060686016,0,hg38,CD-0722-1
"F11,B11",10137,11180,7472,3708,5289,2824,2,2831,1642,1189,1.380992431,1614,224,18,12,11,1,5,1,0,0,empty,CD-0722-1
"F11,B12",5792,6388,4310,2078,3081,1550,0,1554,1010,544,1.856617647,894,889,124,37,36,1,23,1,0,0,empty,CD-0722-1
"F11,C1",12587,13597,9599,3998,6347,2996,0,3000,1933,1067,1.811621368,1649,711,155,49,49,0,25,0,0.040816327,0,empty,CD-0722-1
"F11,C2",9462,10236,7051,3185,4764,2419,1,2422,1580,842,1.876484561,1372,1150,147,60,58,2,20,1,0,0,empty,CD-0722-1
"F11,C3",788231,947572,576883,370689,435112,248287,2,248519,197548,50971,3.875694022,151175,29443,4727,1519,1487,32,308,4,0.083389375,0,hg38,CD-0722-1
"F11,C4",6592,7180,5025,2155,3311,1499,0,1502,974,528,1.84469697,820,1253,263,105,105,0,30,0,0.076190476,0,empty,CD-0722-1
"F11,C5",9269,10115,6982,3133,4722,2358,0,2359,1543,816,1.890931373,1315,1437,257,110,108,2,46,2,0.12037037,0,empty,CD-0722-1
"F11,C6",591252,715197,414380,300817,342451,222133,3,222352,167685,54667,3.067389833,134837,3771,682,199,186,13,70,3,0.177419355,0,hg38,CD-0722-1
"F11,C7",10247,11692,7333,4359,5511,3018,0,3020,1778,1242,1.431561997,1799,484,195,64,64,0,18,0,0,0,empty,CD-0722-1
"F11,C8",685520,805735,506204,299531,371017,206935,2,207152,163734,43418,3.771108757,122862,74407,14921,4978,4916,62,1010,5,0.064686737,0,hg38,CD-0722-1
"F11,C9",7808,8935,5840,3095,4210,2094,0,2096,1370,726,1.887052342,1220,1114,304,108,107,1,34,1,0.08411215,0,empty,CD-0722-1
"F11,C10",8930,9731,6763,2968,4587,2222,0,2224,1410,814,1.732186732,1201,1242,187,98,97,1,39,1,0.041237113,0,empty,CD-0722-1
"F11,C11",7813,8526,5744,2782,4100,2045,0,2047,1304,743,1.755047106,1149,1342,311,114,114,0,40,0,0.026315789,0,empty,CD-0722-1
"F11,C12",10885,11804,8013,3791,5679,2756,0,2764,1809,955,1.894240838,1586,1312,315,147,146,1,32,1,0.047945205,0,empty,CD-0722-1
"F11,D1",9802,10963,7215,3748,5144,2702,0,2707,1639,1068,1.534644195,1548,531,135,37,36,1,10,1,0,0,empty,CD-0722-1
"F11,D2",18937,21142,14646,6496,9456,4484,0,4489,3033,1456,2.083104396,2493,3804,921,340,339,1,93,1,0.08259587,0,empty,CD-0722-1
"F11,D3",7170,7882,5337,2545,3818,1941,0,1941,1307,634,2.061514196,1063,1422,339,117,116,1,39,1,0.068965517,0,empty,CD-0722-1
"F11,D4",7052,7834,5336,2498,3706,1787,0,1793,1222,571,2.140105079,1021,577,79,48,48,0,23,0,0.166666667,0,empty,CD-0722-1
"F11,D5",6279,7223,4644,2579,3419,1706,0,1709,1126,583,1.931389365,987,1338,284,86,85,1,39,1,0.047058824,0,empty,CD-0722-1
"F11,D6",9790,10780,7108,3672,4957,2627,0,2628,1599,1029,1.55393586,1462,1087,267,102,102,0,34,0,0.039215686,0,empty,CD-0722-1
"F11,D7",5614,6129,4260,1869,2874,1361,1,1362,877,485,1.808247423,745,1127,393,123,123,0,43,0,0.032520325,0,empty,CD-0722-1
"F11,D8",6993,7625,5280,2345,3665,1826,0,1830,1205,625,1.928,999,938,121,44,44,0,27,0,0.090909091,0,empty,CD-0722-1
"F11,D9",3681,4287,2743,1544,2053,1038,0,1040,719,321,2.239875389,615,1078,231,88,88,0,34,0,0.102272727,0,empty,CD-0722-1
"F11,D10",6429,7036,4674,2362,3331,1694,0,1696,1055,641,1.645865835,1018,837,273,89,80,9,15,2,0.025,0,empty,CD-0722-1
"F11,D11",7258,8318,5418,2900,3956,1977,0,1979,1259,720,1.748611111,1159,2360,832,262,261,1,76,1,0.183908046,0,empty,CD-0722-1
"F11,D12",9385,10203,7076,3127,4870,2371,0,2373,1588,785,2.022929936,1369,2476,510,175,175,0,52,0,0.131428571,0,empty,CD-0722-1
"F11,E1",1944503,2214824,1476071,738753,994485,533156,3,533760,430661,103099,4.177159817,306561,200079,29431,9880,9677,203,1721,9,0.057869174,0,hg38,CD-0722-1
"F11,E2",701456,844422,514348,330074,390193,222730,1,222961,174457,48504,3.596754907,136034,130242,17061,5685,5547,138,1046,5,0.07751938,0,hg38,CD-0722-1
"F11,E3",5893,6629,4424,2205,3112,1496,0,1505,995,510,1.950980392,863,1724,454,132,131,1,53,1,0.076335878,0,empty,CD-0722-1
"F11,E4",7551,8389,5688,2701,3995,1967,0,1971,1289,682,1.890029326,1122,1553,197,97,91,6,48,1,0.010989011,0,empty,CD-0722-1
"F11,E5",6977,7494,5281,2213,3516,1640,0,1641,995,646,1.540247678,919,979,191,84,82,2,28,1,0,0,empty,CD-0722-1
"F11,E6",11887,13316,8866,4450,6309,3213,0,3213,1989,1224,1.625,1854,1855,497,182,180,2,47,1,0.088888889,0,empty,CD-0722-1
"F11,E7",11247,12037,8492,3545,5612,2662,0,2662,1731,931,1.859291085,1427,1821,335,123,118,5,52,3,0.144067797,0,empty,CD-0722-1
"F11,E8",8701,9394,6721,2673,4461,2036,0,2044,1311,733,1.788540246,1067,1716,457,164,163,1,50,1,0.263803681,0,empty,CD-0722-1
"F11,E9",419829,516990,290145,226845,242049,159357,2,159536,117960,41576,2.837213777,97515,37942,22812,6714,6709,5,989,3,0.011328067,0,hg38,CD-0722-1
"F11,E10",6541,7074,4947,2127,3333,1558,0,1560,1043,517,2.017408124,855,1072,169,70,64,6,31,1,0.296875,0,empty,CD-0722-1
"F11,E11",7797,8448,5738,2710,4025,1980,0,1980,1330,650,2.046153846,1140,1418,163,71,71,0,36,0,0.183098592,0,empty,CD-0722-1
"F11,E12",8471,9434,6220,3214,4504,2201,0,2208,1369,839,1.63170441,1308,1373,429,128,126,2,30,2,0.261904762,0,empty,CD-0722-1
"F11,F1",822567,956689,609744,346945,435206,238430,7,238688,195933,42755,4.582692083,140364,102050,14887,4720,4615,105,980,6,0.069555796,0,hg38,CD-0722-1
"F11,F2",8759,10113,6389,3724,4658,2332,0,2333,1516,817,1.855569155,1398,1795,314,127,123,4,57,3,0.040650407,0,empty,CD-0722-1
"F11,F3",7395,8027,5574,2453,3757,1814,0,1814,1182,632,1.870253165,1001,1567,398,131,129,2,61,1,0.054263566,0,empty,CD-0722-1
"F11,F4",10964,12006,8189,3817,5693,2725,1,2730,1778,952,1.867647059,1543,427,72,43,43,0,22,0,0.093023256,0,empty,CD-0722-1
"F11,F5",8533,9008,6313,2695,4276,1992,0,1999,1309,690,1.897101449,1100,1263,282,100,100,0,41,0,0,0,empty,CD-0722-1
"F11,F6",723036,851740,538283,313457,391681,212392,2,212624,163775,48849,3.352678663,127183,89603,10933,3756,3684,72,796,3,0.064603692,0,hg38,CD-0722-1
"F11,F7",1320946,1613900,970531,643369,729608,434088,3,434540,343004,91536,3.747203286,263877,14821,2895,946,943,3,279,1,0.024390244,0,hg38,CD-0722-1
"F11,F8",7122,7973,5336,2637,3754,1856,0,1857,1185,672,1.763392857,1065,113,11,9,9,0,5,0,0,0,empty,CD-0722-1
"F11,F9",7752,8199,5883,2316,3845,1773,0,1775,1169,606,1.929042904,921,1985,446,145,139,6,43,2,0.014388489,0,empty,CD-0722-1
"F11,F10",9765,10554,7577,2977,4828,2171,0,2174,1445,729,1.982167353,1154,1151,228,101,101,0,37,0,0.03960396,0,empty,CD-0722-1
"F11,F11",7892,8921,6055,2866,4226,2053,0,2053,1359,694,1.958213256,1197,1411,257,96,95,1,36,1,0.094736842,0,empty,CD-0722-1
"F11,F12",8367,9126,6252,2874,4237,2059,0,2066,1364,702,1.943019943,1146,144,13,10,10,0,5,0,0,0,empty,CD-0722-1
"F11,G1",9381,10158,6973,3185,4866,2338,0,2340,1548,792,1.954545455,1299,1629,322,133,133,0,56,0,0.015037594,0,empty,CD-0722-1
"F11,G2",5321,5897,3830,2067,2737,1409,1,1413,902,511,1.765166341,799,343,19,11,9,2,7,2,0,0,empty,CD-0722-1
"F11,G3",10195,11018,7411,3607,5278,2721,0,2721,1628,1093,1.4894785,1490,2271,532,195,195,0,60,0,0.117948718,0,empty,CD-0722-1
"F11,G4",17866,20132,13204,6928,9566,5230,0,5243,3225,2018,1.598116947,3021,82,7,5,5,0,4,0,0,0,empty,CD-0722-1
"F11,G5",6613,7513,4940,2573,3625,1842,0,1850,1231,619,1.988691438,1065,865,153,74,74,0,41,0,0.027027027,0,empty,CD-0722-1
"F11,G6",9119,10172,7012,3160,4783,2366,0,2366,1542,824,1.871359223,1321,164,46,14,14,0,11,0,0,0,empty,CD-0722-1
"F11,G7",588552,655122,455292,199830,306189,147085,2,147245,113752,33493,3.396291762,82758,24766,4398,1531,1515,16,373,3,0.04620462,0,hg38,CD-0722-1
"F11,G8",669076,804730,487205,317525,372157,213863,1,214097,169664,44433,3.818423244,131046,91849,14511,4925,4840,85,940,4,0.093595041,0,hg38,CD-0722-1
"F11,G9",480839,548258,358535,189723,257057,138699,1,138860,104426,34434,3.032642156,80680,34182,5225,1651,1602,49,400,4,0.028714107,0,hg38,CD-0722-1
"F11,G10",7801,8435,5823,2612,4078,2024,5,2030,1278,752,1.699468085,1132,1313,259,104,103,1,42,1,0.019417476,0,empty,CD-0722-1
"F11,G11",8087,8840,6085,2755,4221,1999,0,2004,1302,702,1.854700855,1108,848,182,67,66,1,32,1,0.196969697,0,empty,CD-0722-1
"F11,G12",249207,324664,161160,163504,158894,115992,0,116051,83987,32064,2.61935504,74519,22037,6834,2023,2021,2,483,2,0.015338941,0,hg38,CD-0722-1
"F11,H1",6889,7424,5177,2247,3516,1659,0,1664,1094,570,1.919298246,964,762,130,40,36,4,16,2,0,0,empty,CD-0722-1
"F11,H2",7673,8578,5804,2774,3969,1993,0,1993,1320,673,1.961367013,1164,1735,383,140,139,1,43,1,0.208633094,0,empty,CD-0722-1
"F11,H3",615723,724248,454711,269537,335310,183905,1,184118,145365,38753,3.751064434,110383,72316,13102,4377,4313,64,847,4,0.069557153,0,hg38,CD-0722-1
"F11,H4",9508,10126,7099,3027,4741,2233,0,2239,1455,784,1.855867347,1257,117,13,10,9,1,6,1,0,0,empty,CD-0722-1
"F11,H5",9881,11114,7230,3884,5131,2591,0,2596,1691,905,1.868508287,1520,1736,482,155,155,0,45,0,0.148387097,0,empty,CD-0722-1
"F11,H6",5991,6872,4372,2500,3194,1668,0,1669,1093,576,1.897569444,975,964,124,63,63,0,32,0,0.063492063,0,empty,CD-0722-1
"F11,H7",7405,7896,5610,2286,3751,1770,0,1773,1173,600,1.955,970,1435,225,85,84,1,33,1,0.023809524,0,empty,CD-0722-1
"F11,H8",13402,15621,9550,6071,7551,4374,0,4381,3029,1352,2.240384615,2614,1202,214,75,75,0,33,0,0.04,0,empty,CD-0722-1
"F11,H9",6070,6386,4619,1767,3083,1424,0,1426,951,475,2.002105263,764,807,184,57,57,0,17,0,0,0,empty,CD-0722-1
"F11,H10",5669,6388,4305,2083,2907,1443,0,1443,930,513,1.812865497,813,939,224,91,90,1,31,1,0.122222222,0,empty,CD-0722-1
"F11,H11",7277,8532,5143,3389,4093,2443,0,2444,1311,1133,1.157105031,1511,40,3,3,3,0,2,0,0,0,empty,CD-0722-1
"F11,H12",6202,6712,4637,2075,3194,1576,0,1578,1109,469,2.364605544,891,991,170,56,54,2,27,1,0.037037037,0,empty,CD-0722-1
"F12,A1",8500,9484,6297,3187,4427,2291,0,2294,1473,821,1.794153471,1316,1446,220,75,74,1,33,1,0.121621622,0,empty,CD-0722-1
"F12,A2",13255,14874,9875,4999,7027,3535,0,3537,2261,1276,1.771943574,2069,1999,593,210,208,2,67,1,0.038461538,0,empty,CD-0722-1
"F12,A3",7371,8334,5567,2767,4003,2025,0,2027,1226,801,1.530586767,1176,1346,353,116,114,2,35,1,0.140350877,0,empty,CD-0722-1
"F12,A4",1031224,1186378,787567,398811,535353,278271,2,278580,222749,55831,3.989701062,159909,71485,9492,3298,3215,83,640,2,0.052877138,0,hg38,CD-0722-1
"F12,A5",11430,12266,8482,3784,5877,2834,0,2835,1855,980,1.892857143,1595,2469,649,247,245,2,74,2,0.053061224,0,empty,CD-0722-1
"F12,A6",402147,512499,278920,233579,238270,160719,2,160850,113882,46968,2.424672117,99192,12439,1152,399,393,6,117,3,0.211195929,0,hg38,CD-0722-1
"F12,A7",8581,9715,6392,3323,4561,2340,1,2346,1503,843,1.782918149,1382,1705,420,153,151,2,61,1,0.039735099,0,empty,CD-0722-1
"F12,A8",4788,5343,3645,1698,2537,1274,1,1275,869,406,2.140394089,692,2672,574,212,209,3,74,1,0.138755981,0,empty,CD-0722-1
"F12,A9",8738,9656,6671,2985,4569,2218,0,2229,1389,840,1.653571429,1206,2391,542,138,135,3,53,2,0.022222222,0,empty,CD-0722-1
"F12,A10",263844,333695,179072,154623,159262,107314,1,107421,80740,26681,3.026123459,67583,2303,846,292,292,0,82,0,0.034246575,0,hg38,CD-0722-1
"F12,A11",8183,9075,6262,2813,4452,2116,0,2117,1422,695,2.046043165,1194,1933,478,182,180,2,60,2,0.138888889,0,empty,CD-0722-1
"F12,A12",11263,12015,8536,3479,5547,2591,0,2591,1717,874,1.964530892,1406,3807,1175,405,404,1,85,1,0.173267327,0,empty,CD-0722-1
"F12,B1",8948,9881,6531,3350,4672,2381,0,2384,1503,881,1.706015891,1354,1777,392,115,115,0,31,0,0.217391304,0,empty,CD-0722-1
"F12,B2",8995,9416,6220,3196,4557,2412,3,2416,1533,883,1.73612684,1367,842,249,74,72,2,22,2,0,0,empty,CD-0722-1
"F12,B3",7461,8476,5516,2960,4102,2062,0,2065,1313,752,1.746010638,1247,1508,327,120,119,1,42,1,0.058823529,0,empty,CD-0722-1
"F12,B4",9631,10885,6986,3899,5189,2766,0,2772,1754,1018,1.722986248,1631,1515,286,137,135,2,51,1,0.051851852,0,empty,CD-0722-1
"F12,B5",10739,7355,4510,2845,4362,2448,0,2472,1693,779,2.173299101,1596,1301,252,94,93,1,31,1,0.075268817,0,empty,CD-0722-1
"F12,B6",10141,11253,7369,3884,5436,2881,0,2886,1834,1052,1.743346008,1683,1998,504,187,182,5,48,1,0.06043956,0,empty,CD-0722-1
"F12,B7",9209,10102,7039,3063,4771,2287,0,2287,1473,814,1.80958231,1277,1336,298,117,117,0,27,0,0.239316239,0,empty,CD-0722-1
"F12,B8",501820,616509,351374,265135,289770,181478,3,181656,144031,37625,3.828066445,112445,4134,1633,516,512,4,164,2,0.021484375,0,hg38,CD-0722-1
"F12,B9",12663,14493,9271,5222,6717,3532,0,3542,2223,1319,1.685367703,2123,1131,363,75,75,0,24,0,0.066666667,0,empty,CD-0722-1
"F12,B10",917123,979299,646190,333109,461326,237072,32,238261,185363,52898,3.504158947,139679,21982,2515,917,901,16,228,2,0.064372919,0,hg38,CD-0722-1
"F12,B11",920039,1054126,695831,358295,475498,249742,6,250047,191383,58664,3.262358516,145794,13204,1565,555,544,11,136,2,0.069852941,0,hg38,CD-0722-1
"F12,B12",8187,9020,6239,2781,4284,2018,0,2021,1308,713,1.834502104,1149,1712,470,139,136,3,46,1,0.014705882,0,empty,CD-0722-1
"F12,C1",1069517,1214277,812978,401299,545058,280894,2,281265,241327,39938,6.042540938,160308,85911,16324,5100,5007,93,935,4,0.112642301,0,hg38,CD-0722-1
"F12,C2",12689,14109,9367,4742,6540,3356,0,3360,2203,1157,1.90406223,1908,2671,585,206,198,8,58,2,0.02020202,0,empty,CD-0722-1
"F12,C3",1219697,1468196,896004,572192,661912,382721,3,383064,301092,81972,3.67310789,231899,114585,12409,4160,4035,125,831,5,0.06394052,0,hg38,CD-0722-1
"F12,C4",9119,10267,6848,3419,4905,2389,0,2396,1587,809,1.961681088,1384,1840,362,137,134,3,51,2,0.156716418,0,empty,CD-0722-1
"F12,C5",1174171,1407831,864768,543063,635655,362720,2,363134,302108,61026,4.950480123,219288,120089,20055,6397,6262,135,1257,5,0.062599808,0,hg38,CD-0722-1
"F12,C6",10716,11823,7934,3889,5682,2856,0,2857,1886,971,1.942327497,1640,2213,459,170,169,1,86,1,0.029585799,0,empty,CD-0722-1
"F12,C7",14164,16587,10072,6515,7900,4433,0,4435,2676,1759,1.521318931,2770,599,158,73,73,0,32,0,0.01369863,0,empty,CD-0722-1
"F12,C8",1141778,1432987,805377,627610,668044,448035,5,448372,313131,135241,2.31535555,276293,49864,24736,7491,7484,7,1271,2,0.009620524,0,hg38,CD-0722-1
"F12,C9",11342,12666,8484,4182,5894,2929,0,2936,1872,1064,1.759398496,1675,2105,472,156,155,1,37,1,0,0,empty,CD-0722-1
"F12,C10",14005,15847,10663,5184,7385,3716,0,3719,2530,1189,2.12783852,2103,2401,642,227,225,2,76,1,0.017777778,0,empty,CD-0722-1
"F12,C11",10923,11986,8151,3835,5638,2809,0,2814,1916,898,2.13363029,1558,2235,483,157,151,6,51,1,0.092715232,0,empty,CD-0722-1
"F12,C12",15427,16998,11498,5500,7970,3925,3,3947,2608,1339,1.947722181,2293,2036,407,147,144,3,51,1,0.027777778,0,empty,CD-0722-1
"F12,D1",14124,15952,10277,5675,7622,4102,2,4110,2443,1667,1.465506899,2435,970,171,54,54,0,20,0,0.018518519,0,empty,CD-0722-1
"F12,D2",10595,11265,8134,3131,5383,2451,0,2451,1585,866,1.830254042,1287,3114,1067,336,333,3,94,2,0.006006006,0,empty,CD-0722-1
"F12,D3",10516,11593,7782,3811,5491,2759,0,2759,1807,952,1.898109244,1550,1798,358,152,152,0,58,0,0.065789474,0,empty,CD-0722-1
"F12,D4",8609,10097,6340,3757,4751,2435,0,2435,1538,897,1.714604236,1462,1795,494,177,177,0,40,0,0.056497175,0,empty,CD-0722-1
"F12,D5",2157682,2615914,1585687,1030227,1171927,692593,4,693325,566190,127135,4.453454989,420332,365340,67364,21573,21243,330,2846,8,0.072494469,0,hg38,CD-0722-1
"F12,D6",13007,14875,9399,5476,6996,3848,1,3853,2355,1498,1.572096128,2328,2196,546,191,188,3,50,3,0.170212766,0,empty,CD-0722-1
"F12,D7",7550,8184,5697,2487,3836,1789,0,1793,1174,619,1.896607431,981,1631,461,159,158,1,45,1,0.113924051,0,empty,CD-0722-1
"F12,D8",9583,10524,7180,3344,4974,2512,0,2512,1658,854,1.941451991,1400,1912,458,152,149,3,49,1,0.040268456,0,empty,CD-0722-1
"F12,D9",5353,6051,4077,1974,2892,1477,0,1479,1001,478,2.094142259,825,1753,566,171,166,5,59,2,0.006024096,0,empty,CD-0722-1
"F12,D10",8437,9449,6163,3286,4309,2179,0,2185,1364,821,1.661388551,1290,751,134,63,63,0,16,0,0.206349206,0,empty,CD-0722-1
"F12,D11",10852,12036,8164,3872,5715,2768,0,2773,1872,901,2.077691454,1612,3736,825,285,283,2,101,1,0.067137809,0,empty,CD-0722-1
"F12,D12",12580,13948,9521,4427,6566,3279,0,3283,2134,1149,1.857267189,1868,4424,1176,403,394,9,106,2,0.045685279,0,empty,CD-0722-1
"F12,E1",16353,17900,12174,5726,8304,4147,0,4150,2657,1493,1.779638312,2344,3732,608,259,251,8,97,2,0.09561753,0,empty,CD-0722-1
"F12,E2",12080,13721,8788,4933,6258,3223,1,3224,1993,1231,1.619008936,1925,2506,490,180,180,0,63,0,0.027777778,0,empty,CD-0722-1
"F12,E3",684577,794736,514214,280522,365558,196442,3,196616,151706,44910,3.378000445,115812,59096,10731,3474,3426,48,713,4,0.025977817,0,hg38,CD-0722-1
"F12,E4",11214,12494,8434,4060,5804,2852,0,2856,1851,1005,1.841791045,1635,3058,687,301,299,2,100,1,0.090301003,0,empty,CD-0722-1
"F12,E5",8709,9751,6580,3171,4680,2256,1,2266,1480,786,1.882951654,1290,2587,417,131,124,7,55,2,0.008064516,0,empty,CD-0722-1
"F12,E6",16912,18846,12490,6356,8646,4402,0,4414,2742,1672,1.639952153,2563,3711,1110,337,331,6,80,2,0.009063444,0,empty,CD-0722-1
"F12,E7",15841,17369,12099,5270,8330,4027,2,4035,2683,1352,1.984467456,2242,3569,1065,370,362,8,98,2,0.080110497,0,empty,CD-0722-1
"F12,E8",12207,13468,9405,4063,6191,2851,0,2859,1850,1009,1.833498513,1555,3015,749,221,220,1,63,1,0.05,0,empty,CD-0722-1
"F12,E9",588455,676319,446150,230169,313196,161803,2,161989,124988,37001,3.377962758,94448,244129,30764,10320,10043,277,1669,9,0.059344817,0,hg38,CD-0722-1
"F12,E10",8700,9612,6634,2978,4551,2159,0,2163,1395,768,1.81640625,1216,2415,752,235,230,5,72,2,0.043478261,0,empty,CD-0722-1
"F12,E11",10812,12057,8231,3826,5679,2757,0,2757,1783,974,1.830595483,1541,2403,561,187,184,3,61,1,0.054347826,0,empty,CD-0722-1
"F12,E12",855378,1005840,633717,372123,463574,254884,2,255203,197898,57305,3.453415932,153833,185794,23912,8068,7847,221,1374,8,0.040270167,0,hg38,CD-0722-1
"F12,F1",13630,14568,10196,4372,6919,3360,0,3363,2116,1247,1.696872494,1925,2404,543,179,178,1,61,1,0.073033708,0,empty,CD-0722-1
"F12,F2",12069,13082,9064,4018,6269,3088,0,3094,1979,1115,1.774887892,1734,3494,889,355,352,3,110,2,0.051136364,0,empty,CD-0722-1
"F12,F3",11033,12193,8243,3950,5726,2822,0,2825,1820,1005,1.810945274,1621,3311,747,290,289,1,89,1,0.138408304,0,empty,CD-0722-1
"F12,F4",15842,17534,11963,5571,8112,3855,1,3865,2488,1377,1.806826434,2213,604,89,56,56,0,33,0,0.107142857,0,empty,CD-0722-1
"F12,F5",11841,13003,9082,3921,6008,2792,0,2793,1787,1006,1.776341948,1595,2635,691,221,214,7,65,2,0.074766355,0,empty,CD-0722-1
"F12,F6",13208,14635,9823,4812,6914,3542,0,3551,2313,1238,1.868336026,2036,3463,817,279,279,0,90,0,0.05734767,0,empty,CD-0722-1
"F12,F7",1226509,1486456,892045,594411,673630,415210,1,415616,283192,132424,2.138524739,251837,26718,7597,2437,2420,17,499,2,0.040495868,0,hg38,CD-0722-1
"F12,F8",9993,11229,7680,3549,5254,2589,0,2589,1689,900,1.876666667,1455,235,26,18,18,0,11,0,0.166666667,0,empty,CD-0722-1
"F12,F9",11036,12224,8401,3823,5601,2647,0,2649,1667,982,1.697556008,1502,2918,693,266,260,6,66,3,0.096153846,0,empty,CD-0722-1
"F12,F10",13331,14200,10215,3985,6695,3116,0,3121,2007,1114,1.801615799,1650,2407,602,219,218,1,59,1,0.013761468,0,empty,CD-0722-1
"F12,F11",11316,12310,8665,3645,5747,2686,0,2688,1822,866,2.103926097,1453,1777,419,146,144,2,39,2,0.013888889,0,empty,CD-0722-1
"F12,F12",11418,12811,8419,4392,5936,2886,0,2895,1922,973,1.975334018,1679,106,27,17,16,1,9,1,0,0,empty,CD-0722-1
"F12,G1",748893,816378,586509,229869,378651,173458,0,173682,142827,30855,4.628974234,95449,74967,16305,5039,4975,64,936,4,0.014070352,0,hg38,CD-0722-1
"F12,G2",7419,7959,5380,2579,3769,1928,0,1930,1221,709,1.722143865,1081,630,293,87,87,0,27,0,0.022988506,0,empty,CD-0722-1
"F12,G3",14092,15244,10390,4854,7301,3713,0,3717,2311,1406,1.643669986,2050,3219,772,263,258,5,93,2,0.058139535,0,empty,CD-0722-1
"F12,G4",24756,28184,18041,10143,13062,7174,1,7180,4398,2782,1.580877067,4158,218,42,22,22,0,12,0,0.136363636,0,empty,CD-0722-1
"F12,G5",8971,9836,6625,3211,4774,2404,0,2405,1522,883,1.723669309,1399,2021,412,193,192,1,63,1,0.088541667,0,empty,CD-0722-1
"F12,G6",12228,13383,9285,4098,6228,3005,3,3011,2026,985,2.056852792,1690,228,41,22,22,0,13,0,0.045454545,0,empty,CD-0722-1
"F12,G7",10770,12061,8241,3820,5734,2831,1,2837,1851,986,1.877281947,1628,5125,1128,394,390,4,115,1,0.043589744,0,empty,CD-0722-1
"F12,G8",7049,7909,5362,2547,3762,1812,0,1813,1162,651,1.784946237,1011,2337,678,200,199,1,55,1,0.095477387,0,empty,CD-0722-1
"F12,G9",8954,9900,6692,3208,4638,2278,0,2281,1400,881,1.589103292,1302,2631,648,195,191,4,63,2,0.015706806,0,empty,CD-0722-1
"F12,G10",11194,12362,8473,3889,5744,2881,0,2884,1881,1003,1.875373878,1561,2925,656,243,238,5,97,2,0.016806723,0,empty,CD-0722-1
"F12,G11",10784,12137,8119,4018,5736,2779,0,2785,1849,936,1.97542735,1579,1791,530,186,177,9,56,2,0.197740113,0,empty,CD-0722-1
"F12,G12",9065,10333,6775,3558,4687,2369,0,2374,1505,869,1.731875719,1401,2294,341,121,115,6,46,2,0.034782609,0,empty,CD-0722-1
"F12,H1",9652,10837,7188,3649,4995,2438,0,2444,1599,845,1.892307692,1449,1819,376,143,142,1,44,1,0.112676056,0,empty,CD-0722-1
"F12,H2",10296,11465,7625,3840,5203,2596,0,2598,1674,924,1.811688312,1510,2892,910,253,253,0,68,0,0.007905138,0,empty,CD-0722-1
"F12,H3",9378,10463,6963,3500,4815,2382,0,2387,1518,869,1.746835443,1381,1509,428,161,161,0,54,0,0.198757764,0,empty,CD-0722-1
"F12,H4",630527,777149,445692,331457,355781,230638,1,230856,164894,65962,2.499833237,142303,386,62,21,21,0,14,0,0.047619048,0,empty,CD-0722-1
"F12,H5",13208,14674,9641,5033,6660,3307,0,3310,2120,1190,1.781512605,1928,1774,347,134,132,2,48,2,0.03030303,0,empty,CD-0722-1
"F12,H6",652338,727172,500923,226249,335035,163777,1,163968,124224,39744,3.125603865,93550,44236,7608,2266,2202,64,518,4,0.023614896,0,hg38,CD-0722-1
"F12,H7",10310,10829,7594,3235,5176,2370,0,2373,1579,794,1.988664987,1330,2009,314,122,119,3,45,1,0.033613445,0,empty,CD-0722-1
"F12,H8",19673,22771,14661,8110,10759,5592,0,5594,3839,1755,2.187464387,3329,2707,662,245,242,3,70,3,0.115702479,0,empty,CD-0722-1
"F12,H9",8965,9981,6698,3283,4517,2136,0,2142,1431,711,2.012658228,1202,1464,282,114,113,1,35,1,0.088495575,0,empty,CD-0722-1
"F12,H10",7461,8470,5582,2888,3911,1959,0,1965,1270,695,1.827338129,1180,1587,425,156,153,3,37,2,0.078431373,0,empty,CD-0722-1
"F12,H11",10489,12102,7514,4588,5710,3422,0,3425,1916,1509,1.269715043,2012,52,6,3,3,0,3,0,0,0,empty,CD-0722-1
"F12,H12",9692,10880,7158,3722,5030,2597,0,2605,1725,880,1.960227273,1515,1771,290,109,108,1,48,1,0.027777778,0,empty,CD-0722-1
"G1,A1",7483,8373,5548,2825,3992,2070,0,2072,1355,717,1.889818689,1189,982,209,79,77,2,32,1,0.194805195,0,empty,CD-0722-1
"G1,A2",955896,1119465,692255,427210,520614,303167,4,303453,230479,72974,3.158371475,181411,79683,17063,5782,5724,58,1051,3,0.0407058,0,hg38,CD-0722-1
"G1,A3",6599,7108,5043,2065,3453,1656,0,1658,1042,616,1.691558442,895,1162,246,89,89,0,29,0,0.112359551,0,empty,CD-0722-1
"G1,A4",11476,12696,8637,4059,5937,2887,0,2889,1878,1011,1.857566766,1594,555,51,30,30,0,18,0,0,0,empty,CD-0722-1
"G1,A5",10372,11627,7811,3816,5675,2822,1,2827,1835,992,1.849798387,1620,2125,568,220,219,1,73,1,0.109589041,0,empty,CD-0722-1
"G1,A6",31554,35681,23806,11875,17088,8872,0,8881,6406,2475,2.588282828,5050,2083,456,182,182,0,60,0,0.043956044,0,empty,CD-0722-1
"G1,A7",7541,8702,5607,3095,4175,2184,0,2184,1482,702,2.111111111,1329,1468,266,117,117,0,47,0,0.153846154,0,empty,CD-0722-1
"G1,A8",4810,5265,3705,1560,2538,1235,0,1236,826,410,2.014634146,681,1438,375,141,140,1,55,1,0.007142857,0,empty,CD-0722-1
"G1,A9",8127,8919,6074,2845,4300,2143,1,2144,1394,750,1.858666667,1202,1418,247,110,109,1,50,1,0.119266055,0,empty,CD-0722-1
"G1,A10",9191,10000,6926,3074,4760,2301,0,2303,1520,783,1.941251596,1264,292,64,30,30,0,12,0,0.233333333,0,empty,CD-0722-1
"G1,A11",7689,8442,5824,2618,4168,2032,0,2035,1385,650,2.130769231,1143,1355,313,117,117,0,54,0,0.085470085,0,empty,CD-0722-1
"G1,A12",9801,10689,7340,3349,4929,2323,0,2327,1535,792,1.938131313,1287,2782,780,277,277,0,78,0,0.046931408,0,empty,CD-0722-1
"G1,B1",8395,8916,6327,2589,4216,2116,0,2116,1363,753,1.810092961,1100,1088,281,100,99,1,35,1,0.101010101,0,empty,CD-0722-1
"G1,B2",8624,9390,5941,3449,4398,2277,0,2278,1474,804,1.833333333,1346,580,206,70,70,0,20,0,0.157142857,0,empty,CD-0722-1
"G1,B3",6795,7865,4969,2896,3810,1987,0,1990,1298,692,1.875722543,1209,875,180,74,74,0,25,0,0.094594595,0,empty,CD-0722-1
"G1,B4",8458,9693,6112,3581,4633,2551,0,2553,1579,974,1.621149897,1506,1710,508,136,136,0,47,0,0.088235294,0,empty,CD-0722-1
"G1,B5",702278,363306,212083,151223,236544,129612,13,130650,97263,33387,2.913199748,86263,58667,8491,2834,2792,42,539,3,0.054799427,0,hg38,CD-0722-1
"G1,B6",8782,10126,6338,3788,4823,2537,1,2542,1606,936,1.715811966,1535,1480,353,134,125,9,44,2,0.008,0,empty,CD-0722-1
"G1,B7",7724,8498,5870,2628,4101,2032,0,2034,1317,717,1.836820084,1082,1342,402,121,121,0,30,0,0.041322314,0,empty,CD-0722-1
"G1,B8",6219,6731,4739,1992,3233,1527,0,1530,997,533,1.87054409,853,893,140,67,67,0,30,0,0.134328358,0,empty,CD-0722-1
"G1,B9",11414,12800,8472,4328,6003,3076,0,3076,1928,1148,1.679442509,1771,1108,316,117,115,2,32,1,0.008695652,0,empty,CD-0722-1
"G1,B10",5960,6289,4290,1999,3168,1556,0,1570,1046,524,1.996183206,909,410,20,13,13,0,8,0,0,0,empty,CD-0722-1
"G1,B11",14742,16871,10689,6182,8090,4510,0,4521,2566,1955,1.312531969,2708,181,12,5,5,0,4,0,0,0,empty,CD-0722-1
"G1,B12",7113,7916,5274,2642,3779,1866,0,1871,1177,694,1.695965418,1072,1567,498,162,160,2,50,1,0.05625,0,empty,CD-0722-1
"G1,C1",13636,14874,10375,4499,7009,3397,0,3403,2147,1256,1.709394904,1844,1314,350,109,107,2,36,2,0.177570093,0,empty,CD-0722-1
"G1,C2",11347,12812,8348,4464,6080,3191,0,3193,2019,1174,1.719761499,1866,2024,577,226,224,2,52,2,0.196428571,0,empty,CD-0722-1
"G1,C3",2949065,3518015,2184786,1333229,1559830,904230,8,905200,715926,189274,3.782484652,545048,136049,18149,6045,5897,148,1172,7,0.076309988,0,hg38,CD-0722-1
"G1,C4",8010,8960,6105,2855,4310,2091,0,2091,1361,730,1.864383562,1155,1912,551,208,204,4,53,2,0.245098039,0,empty,CD-0722-1
"G1,C5",1008153,1178941,751943,426998,539821,299765,4,300046,242112,57934,4.179100356,177371,74111,10456,3571,3521,50,790,5,0.072138597,0,hg38,CD-0722-1
"G1,C6",9631,10777,7140,3637,5217,2635,0,2640,1723,917,1.878953108,1523,1515,492,156,155,1,56,1,0.032258065,0,empty,CD-0722-1
"G1,C7",12556,14648,9123,5525,7024,3924,0,3927,2364,1563,1.512476008,2362,444,138,58,58,0,16,0,0.155172414,0,empty,CD-0722-1
"G1,C8",14095,15821,10481,5340,7524,3819,0,3823,2527,1296,1.949845679,2219,3019,721,269,266,3,86,1,0.07518797,0,empty,CD-0722-1
"G1,C9",953802,1156181,701757,454424,531381,311351,2,311723,244243,67480,3.619487255,190069,112148,14869,4879,4757,122,982,5,0.038469624,0,hg38,CD-0722-1
"G1,C10",11071,11991,8304,3687,5685,2747,6,2761,1815,946,1.918604651,1495,1991,422,144,142,2,54,2,0.014084507,0,empty,CD-0722-1
"G1,C11",9430,10495,7118,3377,4906,2404,0,2407,1530,877,1.744583808,1342,1937,424,153,147,6,45,1,0.12244898,0,empty,CD-0722-1
"G1,C12",14188,15406,10539,4867,7256,3501,0,3503,2267,1236,1.834142395,1960,2064,618,166,164,2,55,2,0.054878049,0,empty,CD-0722-1
"G1,D1",12512,14122,9021,5101,6864,3626,0,3635,2170,1465,1.481228669,2170,547,60,37,36,1,18,1,0,0,empty,CD-0722-1
"G1,D2",9647,10833,7478,3355,5132,2402,1,2410,1591,819,1.942612943,1346,2814,730,261,257,4,79,2,0.031128405,0,empty,CD-0722-1
"G1,D3",9246,10289,6867,3422,5019,2520,0,2526,1701,825,2.061818182,1432,1764,411,142,140,2,43,1,0.014285714,0,empty,CD-0722-1
"G1,D4",7093,7701,5248,2453,3761,1867,0,1867,1193,674,1.770029674,1058,1188,229,75,75,0,28,0,0.08,0,empty,CD-0722-1
"G1,D5",8163,9039,6104,2935,4413,2208,0,2213,1475,738,1.998644986,1264,1640,262,106,104,2,39,1,0.009615385,0,empty,CD-0722-1
"G1,D6",11926,13746,8688,5058,6415,3488,0,3491,2105,1386,1.518759019,2112,1876,361,123,119,4,46,2,0.058823529,0,empty,CD-0722-1
"G1,D7",1532944,1869039,1078486,790553,874317,570333,2,570795,355821,214974,1.655181557,349050,5019,1327,406,404,2,207,1,0.051980198,0,hg38,CD-0722-1
"G1,D8",8059,9047,6009,3038,4286,2139,0,2141,1467,674,2.176557864,1237,1367,233,96,94,2,44,1,0.085106383,0,empty,CD-0722-1
"G1,D9",325418,368669,247304,121365,172178,87336,1,87414,63572,23842,2.666387048,50419,31525,4448,1339,1313,26,290,3,0.045696877,0,hg38,CD-0722-1
"G1,D10",7439,8243,5643,2600,3951,1992,0,1992,1221,771,1.583657588,1111,795,208,90,90,0,25,0,0.177777778,0,empty,CD-0722-1
"G1,D11",9364,10497,7127,3370,5046,2483,0,2485,1661,824,2.015776699,1435,2637,563,209,200,9,78,2,0.095,0,empty,CD-0722-1
"G1,D12",11473,12809,8598,4211,6139,3079,0,3083,2035,1048,1.941793893,1798,3649,856,298,297,1,91,1,0.047138047,0,empty,CD-0722-1
"G1,E1",14573,16179,10805,5374,7811,3994,0,4000,2556,1444,1.770083102,2296,3164,616,281,276,5,81,2,0.163043478,0,empty,CD-0722-1
"G1,E2",10498,11706,7632,4074,5570,2897,0,2900,1888,1012,1.865612648,1704,1913,509,152,149,3,59,2,0.11409396,0,empty,CD-0722-1
"G1,E3",617265,727530,466309,261221,337961,181726,2,181982,143516,38466,3.730983206,107257,152966,22977,7802,7651,151,1401,6,0.03777284,0,hg38,CD-0722-1
"G1,E4",9221,10011,6944,3067,4937,2395,1,2403,1611,792,2.034090909,1366,2618,689,251,250,1,79,1,0.036,0,empty,CD-0722-1
"G1,E5",8241,9122,6371,2751,4330,2014,0,2014,1270,744,1.706989247,1104,1431,464,140,134,6,38,3,0.044776119,0,empty,CD-0722-1
"G1,E6",14701,16170,11033,5137,7606,3814,0,3823,2413,1410,1.711347518,2185,3630,974,351,350,1,88,1,0.108571429,0,empty,CD-0722-1
"G1,E7",2498070,2881349,1859076,1022273,1289188,726405,8,727208,539138,188070,2.866687935,424041,188312,33711,10889,10711,178,1822,7,0.035290823,0,hg38,CD-0722-1
"G1,E8",840229,1002413,604381,398032,463274,291517,2,291774,209634,82140,2.552154858,171503,5980,1091,355,338,17,110,3,0.056213018,0,hg38,CD-0722-1
"G1,E9",1125716,1342287,823444,518843,619416,355543,2,355894,289189,66705,4.335342178,214922,366574,59562,20016,19624,392,2678,11,0.052894415,0,hg38,CD-0722-1
"G1,E10",7968,8891,6008,2883,4172,2011,0,2017,1326,691,1.918958032,1160,2131,500,160,155,5,45,2,0.096774194,0,empty,CD-0722-1
"G1,E11",9527,10612,7027,3585,5064,2540,0,2542,1603,939,1.70713525,1452,1608,323,110,110,0,42,0,0.054545455,0,empty,CD-0722-1
"G1,E12",628629,802712,413908,388804,376714,265285,3,265512,199881,65631,3.045527266,168068,3567,557,195,185,10,76,2,0.07027027,0,hg38,CD-0722-1
"G1,F1",12388,13132,9214,3918,6198,2882,1,2888,1874,1014,1.848126233,1611,1887,636,198,189,9,53,2,0.132275132,0,empty,CD-0722-1
"G1,F2",25300,28658,19391,9267,13125,6408,1,6418,4599,1819,2.528312259,3656,5136,1129,352,351,1,91,1,0.11965812,0,empty,CD-0722-1
"G1,F3",34273,39696,24337,15359,17667,10002,0,10010,6860,3150,2.177777778,5941,7196,790,275,267,8,94,1,0.209737828,0,empty,CD-0722-1
"G1,F4",13627,15022,10303,4719,7165,3470,2,3478,2281,1197,1.905597327,1980,638,242,109,108,1,33,1,0.101851852,0,empty,CD-0722-1
"G1,F5",10802,11660,8129,3531,5530,2637,0,2638,1697,941,1.803400638,1465,1809,402,168,168,0,55,0,0.017857143,0,empty,CD-0722-1
"G1,F6",12072,13632,8823,4809,6459,3381,0,3391,2208,1183,1.866441251,2023,2732,662,224,223,1,72,1,0.089686099,0,empty,CD-0722-1
"G1,F7",1053368,1219466,800906,418560,557632,293708,5,294079,230941,63138,3.657718015,171784,48349,4836,1642,1586,56,467,6,0.033417402,0,hg38,CD-0722-1
"G1,F8",9878,10879,7393,3486,5302,2718,0,2724,1791,933,1.919614148,1540,168,8,7,7,0,5,0,0,0,empty,CD-0722-1
"G1,F9",9632,10699,7279,3420,5076,2419,0,2423,1572,851,1.847238543,1434,2828,556,166,162,4,56,2,0.117283951,0,empty,CD-0722-1
"G1,F10",12028,12897,9153,3744,6009,2795,0,2801,1822,979,1.861082737,1470,1507,420,124,124,0,35,0,0.153225806,0,empty,CD-0722-1
"G1,F11",9897,10877,7550,3327,5192,2439,1,2446,1595,851,1.87426557,1370,1383,254,92,89,3,33,1,0.06741573,0,empty,CD-0722-1
"G1,F12",10257,11487,7716,3771,5441,2702,0,2706,1770,936,1.891025641,1559,176,26,18,18,0,10,0,0.055555556,0,empty,CD-0722-1
"G1,G1",11757,12675,8880,3795,6214,2963,0,2970,1903,1067,1.783505155,1705,2445,659,226,226,0,91,0,0.03539823,0,empty,CD-0722-1
"G1,G2",6744,7395,4697,2698,3511,1812,0,1818,1163,655,1.775572519,1048,519,65,37,37,0,21,0,0,0,empty,CD-0722-1
"G1,G3",12777,14020,9441,4579,6599,3397,4,3403,2160,1243,1.737731295,1873,2346,620,216,213,3,81,1,0.070422535,0,empty,CD-0722-1
"G1,G4",22196,24889,16105,8784,12027,6583,1,6589,4022,2567,1.566809505,3829,184,27,21,20,1,12,1,0.05,0,empty,CD-0722-1
"G1,G5",7922,8719,5901,2818,4211,2029,0,2035,1265,770,1.642857143,1199,1399,202,88,88,0,49,0,0.181818182,0,empty,CD-0722-1
"G1,G6",10851,12218,8218,4000,5647,2805,0,2811,1911,900,2.123333333,1584,126,8,6,6,0,5,0,0,0,empty,CD-0722-1
"G1,G7",9939,10960,7560,3400,5213,2439,0,2444,1589,855,1.858479532,1398,2591,619,230,228,2,67,1,0.087719298,0,empty,CD-0722-1
"G1,G8",6460,7175,4819,2356,3371,1650,0,1655,1043,612,1.704248366,941,1436,333,126,123,3,55,1,0.024390244,0,empty,CD-0722-1
"G1,G9",8359,9079,6297,2782,4280,2100,5,2110,1386,724,1.914364641,1153,2205,375,139,138,1,62,1,0.094202899,0,empty,CD-0722-1
"G1,G10",9990,11025,7544,3481,5379,2668,0,2672,1744,928,1.879310345,1515,2744,711,266,264,2,96,2,0.079545455,0,empty,CD-0722-1
"G1,G11",10107,10982,7669,3313,5197,2501,0,2504,1675,829,2.020506634,1363,1283,263,108,107,1,45,1,0.018691589,0,empty,CD-0722-1
"G1,G12",11033,12482,8269,4213,5837,2994,0,2996,1972,1024,1.92578125,1765,2594,566,204,203,1,62,1,0.034482759,0,empty,CD-0722-1
"G1,H1",8479,9290,6183,3107,4575,2263,3,2274,1401,873,1.604810997,1361,797,176,53,53,0,16,0,0.075471698,0,empty,CD-0722-1
"G1,H2",9325,10345,7006,3339,4851,2355,0,2357,1512,845,1.789349112,1316,2444,484,167,164,3,62,1,0.12804878,0,empty,CD-0722-1
"G1,H3",7872,8696,5774,2922,4158,2080,0,2085,1350,735,1.836734694,1217,1314,270,93,92,1,29,1,0.010869565,0,empty,CD-0722-1
"G1,H4",11666,12843,8765,4078,6041,2954,0,2963,1956,1007,1.942403178,1658,137,20,13,12,1,8,1,0.166666667,0,empty,CD-0722-1
"G1,H5",12197,13771,9035,4736,6424,3292,0,3296,2183,1113,1.961365678,1877,1714,451,156,155,1,50,1,0.012903226,0,empty,CD-0722-1
"G1,H6",7743,8652,5609,3043,3990,2053,0,2054,1321,733,1.80218281,1195,1523,494,184,183,1,63,1,0.043715847,0,empty,CD-0722-1
"G1,H7",828454,962611,617538,345073,446340,243431,13,243716,189589,54127,3.502669647,142756,85344,17216,5395,5327,68,988,5,0.063450347,0,hg38,CD-0722-1
"G1,H8",26008,29855,19247,10608,14272,7623,0,7640,5730,1910,3,4373,1862,460,138,138,0,40,0,0.057971014,0,empty,CD-0722-1
"G1,H9",7544,8207,5755,2452,3831,1799,0,1805,1183,622,1.90192926,979,1209,370,116,116,0,34,0,0.051724138,0,empty,CD-0722-1
"G1,H10",6605,7362,4974,2388,3432,1608,0,1608,1044,564,1.85106383,888,1149,258,110,104,6,41,2,0.019230769,0,empty,CD-0722-1
"G1,H11",9166,10723,6393,4330,5145,3174,0,3178,1722,1456,1.182692308,1933,123,5,1,1,0,1,0,0,0,empty,CD-0722-1
"G1,H12",8207,9520,5967,3553,4425,2285,0,2285,1482,803,1.845579078,1377,1123,207,82,81,1,45,1,0.024691358,0,empty,CD-0722-1
"G2,A1",6361,7159,4729,2430,3405,1743,3,1751,1151,600,1.918333333,1021,1246,223,67,65,2,30,2,0.030769231,0,empty,CD-0722-1
"G2,A2",8967,9844,6676,3168,4756,2348,0,2352,1479,873,1.694158076,1328,2140,551,237,236,1,79,1,0.088983051,0,empty,CD-0722-1
"G2,A3",5827,6479,4303,2176,3006,1434,1,1439,898,541,1.659889094,825,970,241,76,76,0,30,0,0.144736842,0,empty,CD-0722-1
"G2,A4",523324,617891,384443,233448,288914,171668,1,171800,103580,68220,1.518323072,102818,11709,545,247,228,19,100,2,0.030701754,0,hg38,CD-0722-1
"G2,A5",8461,9043,6302,2741,4454,2088,0,2088,1372,716,1.916201117,1150,2830,836,276,274,2,60,2,0.182481752,0,empty,CD-0722-1
"G2,A6",194789,237576,130629,106947,115686,79909,0,79971,55563,24408,2.276425762,48656,14428,3249,1003,992,11,277,2,0.047379032,0,hg38,CD-0722-1
"G2,A7",6281,7006,4621,2385,3305,1762,0,1764,1111,653,1.701378254,1021,1634,374,144,144,0,49,0,0.013888889,0,empty,CD-0722-1
"G2,A8",3696,4138,2732,1406,1988,976,0,976,671,305,2.2,568,2141,489,197,195,2,60,1,0.169230769,0,empty,CD-0722-1
"G2,A9",6351,6853,4748,2105,3353,1594,0,1599,1016,583,1.74271012,923,2231,692,211,211,0,51,0,0.052132701,0,empty,CD-0722-1
"G2,A10",7175,7679,5516,2163,3684,1802,0,1804,1122,682,1.64516129,979,289,28,17,17,0,10,0,0.176470588,0,empty,CD-0722-1
"G2,A11",6041,6527,4631,1896,3165,1499,0,1501,1013,488,2.075819672,817,1925,392,154,154,0,53,0,0.071428571,0,empty,CD-0722-1
"G2,A12",7542,8144,5782,2362,3830,1799,0,1802,1185,617,1.920583468,974,5467,611,217,208,9,79,3,0.043269231,0,empty,CD-0722-1
"G2,B1",6927,7609,5228,2381,3580,1768,0,1772,1128,644,1.751552795,992,1264,277,134,130,4,42,1,0.076923077,0,empty,CD-0722-1
"G2,B2",7273,7874,5050,2824,3787,2020,0,2020,1196,824,1.451456311,1205,533,127,36,36,0,20,0,0.055555556,0,empty,CD-0722-1
"G2,B3",1389152,1660359,1016842,643517,763654,440394,3,440815,360327,80488,4.476779147,268447,101005,12399,3956,3826,130,860,5,0.058285416,0,hg38,CD-0722-1
"G2,B4",6495,7051,4701,2350,3331,1721,0,1721,1090,631,1.727416799,990,1436,298,126,126,0,48,0,0.055555556,0,empty,CD-0722-1
"G2,B5",6473,3354,1964,1390,2192,1177,0,1197,749,448,1.671875,803,936,188,53,52,1,28,1,0.134615385,0,empty,CD-0722-1
"G2,B6",7380,8169,5399,2770,3875,2035,0,2038,1254,784,1.599489796,1147,1509,339,111,110,1,36,1,0.118181818,0,empty,CD-0722-1
"G2,B7",7037,7950,5380,2570,3724,1836,0,1836,1194,642,1.859813084,1063,1378,377,120,120,0,30,0,0.075,0,empty,CD-0722-1
"G2,B8",5106,5652,3818,1834,2691,1293,0,1293,838,455,1.841758242,730,1338,178,86,85,1,43,1,0.070588235,0,empty,CD-0722-1
"G2,B9",9198,10242,6789,3453,4772,2478,0,2479,1547,932,1.659871245,1442,1033,287,110,110,0,39,0,0.063636364,0,empty,CD-0722-1
"G2,B10",4773,5232,3510,1722,2539,1265,0,1267,799,468,1.707264957,723,535,121,46,46,0,20,0,0.173913043,0,empty,CD-0722-1
"G2,B11",10299,12014,7463,4551,5519,3013,0,3017,1733,1284,1.349688474,1886,252,39,25,25,0,13,0,0,0,empty,CD-0722-1
"G2,B12",6009,6744,4479,2265,3151,1588,0,1590,1072,518,2.069498069,915,3014,444,152,149,3,40,2,0.033557047,0,empty,CD-0722-1
"G2,C1",12101,13020,9242,3778,6038,2806,3,2811,1780,1031,1.726479146,1550,1286,237,92,91,1,35,1,0.098901099,0,empty,CD-0722-1
"G2,C2",9989,10913,7401,3512,5115,2604,0,2607,1659,948,1.75,1492,2021,567,192,189,3,54,2,0.026455026,0,empty,CD-0722-1
"G2,C3",10132,11038,7547,3491,5348,2555,1,2560,1626,934,1.740899358,1406,980,201,62,61,1,26,1,0.06557377,0,empty,CD-0722-1
"G2,C4",6455,7044,4954,2090,3371,1534,0,1535,960,575,1.669565217,859,1743,239,105,105,0,41,0,0.171428571,0,empty,CD-0722-1
"G2,C5",1681630,1990839,1240249,750590,899570,510956,3,511486,442839,68647,6.450959255,308145,190220,28841,9885,9696,189,1559,8,0.087355611,0,hg38,CD-0722-1
"G2,C6",7899,8960,5760,3200,4398,2239,0,2241,1453,788,1.843908629,1309,2214,680,225,225,0,62,0,0.062222222,0,empty,CD-0722-1
"G2,C7",10227,11743,7486,4257,5661,3111,0,3112,1847,1265,1.460079051,1883,648,240,62,62,0,25,0,0,0,empty,CD-0722-1
"G2,C8",11614,12775,8519,4256,6120,3087,1,3091,1996,1095,1.82283105,1764,3010,689,248,247,1,71,1,0.064777328,0,empty,CD-0722-1
"G2,C9",7998,8930,5969,2961,4239,2156,0,2156,1342,814,1.648648649,1246,1268,390,112,112,0,40,0,0.285714286,0,empty,CD-0722-1
"G2,C10",9182,10091,6957,3134,4844,2327,0,2330,1491,839,1.777115614,1286,2157,341,138,137,1,53,1,0.080291971,0,empty,CD-0722-1
"G2,C11",8414,9578,6231,3347,4456,2229,0,2232,1406,826,1.702179177,1341,2263,485,163,162,1,62,1,0.061728395,0,empty,CD-0722-1
"G2,C12",11524,12572,8647,3925,5945,2856,1,2865,1878,987,1.902735562,1609,3741,522,171,166,5,56,2,0.054216867,0,empty,CD-0722-1
"G2,D1",9731,10971,6989,3982,5289,2878,0,2880,1810,1070,1.691588785,1770,694,117,57,57,0,25,0,0.315789474,0,empty,CD-0722-1
"G2,D2",8879,9560,6658,2902,4573,2135,1,2140,1402,738,1.899728997,1198,2329,451,162,161,1,70,1,0.062111801,0,empty,CD-0722-1
"G2,D3",7478,8378,5567,2811,4049,2044,1,2046,1342,704,1.90625,1170,1716,206,91,90,1,52,1,0.044444444,0,empty,CD-0722-1
"G2,D4",5702,6464,4195,2269,3077,1565,0,1565,1017,548,1.855839416,933,1515,250,108,103,5,35,2,0,0,empty,CD-0722-1
"G2,D5",6855,7633,5155,2478,3587,1788,0,1789,1148,641,1.790951638,1013,1992,344,134,133,1,64,1,0.052631579,0,empty,CD-0722-1
"G2,D6",9798,10735,6999,3736,5019,2652,0,2656,1621,1035,1.566183575,1514,1843,543,185,180,5,56,2,0.066666667,0,empty,CD-0722-1
"G2,D7",5688,6143,4387,1756,2942,1373,0,1373,906,467,1.940042827,761,1865,231,104,104,0,50,0,0.057692308,0,empty,CD-0722-1
"G2,D8",763358,928185,551241,376944,424937,248399,1,248624,202904,45720,4.437970254,153111,106139,20688,6796,6703,93,1150,5,0.053408921,0,hg38,CD-0722-1
"G2,D9",3687,4122,2729,1393,2025,985,0,985,656,329,1.993920973,566,1859,269,137,137,0,57,0,0.072992701,0,empty,CD-0722-1
"G2,D10",6336,7014,4589,2425,3356,1724,0,1725,1073,652,1.645705521,1041,855,318,109,106,3,29,1,0.028301887,0,empty,CD-0722-1
"G2,D11",620195,729135,461094,268041,334994,185327,0,185503,148522,36981,4.016170466,109696,122831,23575,7643,7527,116,1324,5,0.044639299,0,hg38,CD-0722-1
"G2,D12",9784,10857,7385,3472,5106,2602,0,2606,1692,914,1.851203501,1466,5401,986,344,338,6,87,2,0.073964497,0,empty,CD-0722-1
"G2,E1",11765,12822,8788,4034,5926,2893,0,2896,1862,1034,1.800773694,1587,2742,642,210,207,3,73,2,0.033816425,0,empty,CD-0722-1
"G2,E2",728584,889915,522579,367336,415353,253250,8,253545,206841,46704,4.428764132,155347,33260,3768,1331,1313,18,422,4,0.059405941,0,hg38,CD-0722-1
"G2,E3",5624,6263,4264,1999,2989,1372,0,1373,861,512,1.681640625,770,2643,686,251,250,1,76,1,0.04,0,empty,CD-0722-1
"G2,E4",7699,8444,5809,2635,4041,1932,1,1936,1258,678,1.855457227,1090,2597,691,251,245,6,91,2,0.040816327,0,empty,CD-0722-1
"G2,E5",7379,8196,5667,2529,3860,1837,0,1837,1234,603,2.046434494,1031,1802,299,127,127,0,45,0,0.031496063,0,empty,CD-0722-1
"G2,E6",20269,22448,15474,6974,10556,5056,1,5062,3303,1759,1.877771461,2844,45724,7084,2310,2247,63,493,5,0.080551847,0,empty,CD-0722-1
"G2,E7",11624,12674,8847,3827,5931,2746,2,2754,1830,924,1.980519481,1515,3826,982,325,323,2,88,2,0.108359133,0,empty,CD-0722-1
"G2,E8",9237,10294,7039,3255,4747,2272,0,2275,1479,796,1.858040201,1243,3233,535,199,197,2,89,1,0.101522843,0,empty,CD-0722-1
"G2,E9",5512,6126,4190,1936,2906,1442,0,1444,975,469,2.078891258,805,2700,561,193,190,3,73,2,0.094736842,0,empty,CD-0722-1
"G2,E10",7056,7660,5378,2282,3580,1708,0,1712,1075,637,1.687598116,945,2423,644,214,207,7,59,3,0.1352657,0,empty,CD-0722-1
"G2,E11",7917,8714,5893,2821,4104,2014,0,2016,1262,754,1.673740053,1142,2389,469,166,165,1,54,1,0.090909091,0,empty,CD-0722-1
"G2,E12",658752,814861,464910,349951,380431,232025,1,232239,192295,39944,4.814114761,145999,51827,7666,2552,2498,54,605,5,0.049639712,0,hg38,CD-0722-1
"G2,F1",10058,11089,7445,3644,5341,2619,0,2626,1645,981,1.676860347,1515,2123,535,185,184,1,59,1,0.070652174,0,empty,CD-0722-1
"G2,F2",8164,9094,5995,3099,4249,2114,0,2119,1440,679,2.120765832,1207,2672,709,276,273,3,94,2,0.073260073,0,empty,CD-0722-1
"G2,F3",7671,8296,5734,2562,4076,1915,0,1916,1242,674,1.84272997,1064,3310,815,300,298,2,94,1,0.070469799,0,empty,CD-0722-1
"G2,F4",11960,12563,8862,3701,5949,2763,2,2774,1854,920,2.015217391,1533,742,136,51,51,0,28,0,0,0,empty,CD-0722-1
"G2,F5",9216,9841,6972,2869,4617,2111,1,2116,1350,766,1.762402089,1179,2006,506,187,185,2,56,1,0.010810811,0,empty,CD-0722-1
"G2,F6",9409,10374,7006,3368,4888,2460,0,2463,1591,872,1.824541284,1375,2790,537,208,194,14,69,2,0.051546392,0,empty,CD-0722-1
"G2,F7",11024,12314,8293,4021,5794,2810,0,2818,1753,1065,1.64600939,1612,1161,237,91,91,0,38,0,0.032967033,0,empty,CD-0722-1
"G2,F8",7323,8192,5600,2592,3798,1814,0,1817,1247,570,2.187719298,1010,224,15,10,9,1,8,1,0,0,empty,CD-0722-1
"G2,F9",7982,8662,6104,2558,4141,1886,0,1891,1216,675,1.801481481,1042,2703,695,203,199,4,54,2,0.170854271,0,empty,CD-0722-1
"G2,F10",780369,878247,601771,276476,400990,198716,1,198952,155689,43263,3.598663985,112701,80192,12303,3799,3695,104,817,5,0.038971583,0,hg38,CD-0722-1
"G2,F11",8015,8771,6069,2702,4070,1907,4,1911,1211,700,1.73,1065,2135,373,129,129,0,40,0,0.108527132,0,empty,CD-0722-1
"G2,F12",8479,9324,6318,3006,4358,2138,0,2142,1367,775,1.763870968,1225,179,37,16,16,0,9,0,0.125,0,empty,CD-0722-1
"G2,G1",1344618,1573686,1005623,568063,713138,393813,3,394252,302224,92028,3.284043987,233104,235079,43367,14430,14190,240,2112,7,0.049612403,0,hg38,CD-0722-1
"G2,G2",5697,6051,3961,2090,2892,1494,0,1500,958,542,1.767527675,881,378,61,17,16,1,9,1,0,0,empty,CD-0722-1
"G2,G3",10489,11385,7848,3537,5436,2711,0,2715,1609,1106,1.454792043,1478,2559,584,229,229,0,85,0,0.100436681,0,empty,CD-0722-1
"G2,G4",18797,21583,13718,7865,9967,5501,0,5507,3376,2131,1.584232755,3203,203,39,20,20,0,13,0,0.05,0,empty,CD-0722-1
"G2,G5",6219,6988,4594,2394,3259,1664,0,1668,1105,563,1.962699822,954,1490,293,116,116,0,47,0,0.094827586,0,empty,CD-0722-1
"G2,G6",9289,10004,7082,2922,4733,2199,0,2206,1432,774,1.850129199,1230,135,63,16,15,1,9,1,0.4,0,empty,CD-0722-1
"G2,G7",14733,15864,11249,4615,7595,3526,1,3534,2373,1161,2.043927649,1949,5920,1072,372,366,6,129,2,0.046448087,0,empty,CD-0722-1
"G2,G8",661679,783958,488798,295160,361028,200545,1,200753,161890,38863,4.165658853,120288,178727,24630,8548,8384,164,1499,6,0.05629771,0,hg38,CD-0722-1
"G2,G9",6975,7994,5165,2829,3827,1890,0,1892,1218,674,1.807121662,1127,2292,628,211,207,4,67,1,0.043478261,0,empty,CD-0722-1
"G2,G10",8538,9526,6327,3199,4494,2278,0,2280,1457,823,1.770352369,1318,2670,609,244,241,3,88,2,0.091286307,0,empty,CD-0722-1
"G2,G11",7957,8623,6031,2592,4188,2000,0,2002,1312,690,1.901449275,1106,1553,432,161,160,1,48,1,0.075,0,empty,CD-0722-1
"G2,G12",6640,7492,4837,2655,3627,1839,0,1839,1169,670,1.744776119,1081,3447,385,169,165,4,62,2,0.036363636,0,empty,CD-0722-1
"G2,H1",6692,7367,5116,2251,3553,1708,0,1710,1102,608,1.8125,973,1186,284,104,103,1,35,1,0.009708738,0,empty,CD-0722-1
"G2,H2",11581,13057,8637,4420,6389,3277,2,3285,2306,979,2.35546476,1985,2220,405,164,162,2,69,1,0.037037037,0,empty,CD-0722-1
"G2,H3",6591,7221,4876,2345,3337,1691,0,1693,1161,532,2.182330827,922,1744,430,183,182,1,53,1,0.230769231,0,empty,CD-0722-1
"G2,H4",10084,11276,7546,3730,5147,2515,0,2519,1654,865,1.912138728,1433,193,53,22,22,0,14,0,0.045454545,0,empty,CD-0722-1
"G2,H5",10638,11691,8012,3679,5371,2710,0,2716,1777,939,1.892438765,1533,2494,727,198,197,1,61,1,0.020304569,0,empty,CD-0722-1
"G2,H6",665365,789266,488326,300940,364780,207204,0,207394,167909,39485,4.252475624,124809,187982,34253,11102,10902,200,1666,7,0.060447624,0,hg38,CD-0722-1
"G2,H7",7981,8763,5911,2852,4159,2066,0,2068,1418,650,2.181538462,1143,2276,547,208,205,3,63,2,0.024390244,0,empty,CD-0722-1
"G2,H8",7989,9027,5825,3202,4180,2178,0,2181,1390,791,1.757269279,1253,2436,600,231,231,0,66,0,0.060606061,0,empty,CD-0722-1
"G2,H9",1062540,1239067,798107,440960,562132,309140,2,309495,255920,53575,4.776854876,180649,135758,18005,6019,5904,115,1137,6,0.063177507,0,hg38,CD-0722-1
"G2,H10",5880,6402,4513,1889,3031,1466,0,1469,973,496,1.961693548,801,1249,206,84,84,0,31,0,0.178571429,0,empty,CD-0722-1
"G2,H11",7062,8080,4942,3138,3933,2319,0,2321,1296,1025,1.264390244,1393,43,6,3,3,0,2,0,0,0,empty,CD-0722-1
"G2,H12",6008,6556,4369,2187,3126,1580,0,1582,996,586,1.699658703,929,2576,389,139,137,2,59,2,0.01459854,0,empty,CD-0722-1
"G3,A1",6907,7777,5195,2582,3713,1885,0,1887,1198,689,1.738751814,1036,1565,357,120,116,4,31,3,0.25862069,0,empty,CD-0722-1
"G3,A2",10242,11345,7541,3804,5313,2697,0,2703,1637,1066,1.53564728,1507,1742,453,176,175,1,65,1,0.154285714,0,empty,CD-0722-1
"G3,A3",6205,6780,4554,2226,3218,1564,0,1571,1062,509,2.086444008,873,927,320,115,114,1,35,1,0.254385965,0,empty,CD-0722-1
"G3,A4",11586,12758,8819,3939,6131,2955,0,2965,1884,1081,1.742830712,1646,1030,242,93,93,0,34,0,0.021505376,0,empty,CD-0722-1
"G3,A5",9443,10350,7144,3206,4994,2398,0,2400,1596,804,1.985074627,1291,2072,498,191,188,3,50,1,0.037234043,0,empty,CD-0722-1
"G3,A6",7630,8541,5792,2749,4161,2148,0,2151,1397,754,1.852785146,1220,2292,419,119,117,2,46,2,0.051282051,0,empty,CD-0722-1
"G3,A7",6995,7817,5160,2657,3705,1920,0,1921,1266,655,1.932824427,1098,974,203,100,99,1,34,1,0.101010101,0,empty,CD-0722-1
"G3,A8",4194,4844,3193,1651,2303,1136,0,1136,736,400,1.84,661,1734,402,144,143,1,53,1,0.020979021,0,empty,CD-0722-1
"G3,A9",7413,8233,5638,2595,3830,1905,1,1909,1231,678,1.815634218,1048,1492,357,133,131,2,47,2,0.167938931,0,empty,CD-0722-1
"G3,A10",8588,9260,6563,2697,4437,2148,0,2148,1401,747,1.875502008,1162,317,65,23,23,0,11,0,0.043478261,0,empty,CD-0722-1
"G3,A11",6215,6879,4750,2129,3447,1632,1,1637,1063,574,1.851916376,920,2124,568,152,150,2,43,1,0.073333333,0,empty,CD-0722-1
"G3,A12",9013,10003,6771,3232,4673,2277,0,2285,1484,801,1.852684145,1339,3244,717,233,231,2,67,1,0.043290043,0,empty,CD-0722-1
"G3,B1",7377,8169,5562,2607,3860,1974,1,1975,1214,761,1.595269382,1099,895,164,70,68,2,23,1,0.088235294,0,empty,CD-0722-1
"G3,B2",9028,10327,6004,4323,5019,2840,0,2842,1801,1041,1.730067243,1775,472,81,29,29,0,11,0,0,0,empty,CD-0722-1
"G3,B3",7412,8543,5513,3030,3993,2062,4,2067,1407,660,2.131818182,1177,1460,417,135,129,6,32,2,0.015503876,0,empty,CD-0722-1
"G3,B4",7260,8294,5343,2951,4096,2207,0,2207,1327,880,1.507954545,1345,1450,251,103,102,1,44,1,0.137254902,0,empty,CD-0722-1
"G3,B5",7549,3982,2449,1533,2620,1390,0,1403,905,498,1.817269076,926,1093,219,91,91,0,32,0,0.10989011,0,empty,CD-0722-1
"G3,B6",8380,9412,6100,3312,4400,2316,0,2319,1416,903,1.568106312,1371,1563,470,143,141,2,45,1,0.226950355,0,empty,CD-0722-1
"G3,B7",7873,8936,6068,2868,4245,2043,0,2043,1326,717,1.849372385,1158,791,169,72,72,0,22,0,0,0,empty,CD-0722-1
"G3,B8",5670,6271,4325,1946,2982,1470,0,1471,962,509,1.889980354,826,874,181,68,67,1,26,1,0.059701493,0,empty,CD-0722-1
"G3,B9",10851,11909,8112,3797,5579,2867,0,2870,1803,1067,1.689784442,1578,688,95,35,33,2,18,1,0.242424242,0,empty,CD-0722-1
"G3,B10",5405,5548,3890,1658,2828,1322,0,1327,877,450,1.948888889,759,429,57,27,27,0,15,0,0,0,empty,CD-0722-1
"G3,B11",11531,13359,8346,5013,6147,3340,0,3342,1838,1504,1.222074468,2035,226,10,8,8,0,6,0,0,0,empty,CD-0722-1
"G3,B12",6948,7570,4957,2613,3625,1820,0,1824,1140,684,1.666666667,1067,1153,231,102,102,0,33,0,0.176470588,0,empty,CD-0722-1
"G3,C1",13063,14010,9868,4142,6642,3205,0,3213,2045,1168,1.750856164,1761,892,149,57,57,0,26,0,0.052631579,0,empty,CD-0722-1
"G3,C2",10819,11935,7902,4033,5570,2885,0,2894,1725,1169,1.475620188,1696,1901,621,182,182,0,49,0,0.06043956,0,empty,CD-0722-1
"G3,C3",12334,13954,9086,4868,6713,3442,0,3444,2286,1158,1.974093264,2053,985,286,90,90,0,24,0,0.111111111,0,empty,CD-0722-1
"G3,C4",7329,7652,5542,2110,3651,1741,0,1742,1120,622,1.800643087,913,1845,398,160,159,1,59,1,0.13836478,0,empty,CD-0722-1
"G3,C5",11091,12615,8357,4258,5913,2919,0,2926,1920,1006,1.908548708,1703,2349,685,216,215,1,48,1,0.237209302,0,empty,CD-0722-1
"G3,C6",8863,9876,6477,3399,4811,2426,0,2428,1576,852,1.849765258,1434,1549,329,150,146,4,62,2,0.04109589,0,empty,CD-0722-1
"G3,C7",908220,1084768,667912,416856,499221,283404,1,283708,222242,61466,3.615689975,171626,31772,4330,1421,1384,37,365,4,0.048410405,0,hg38,CD-0722-1
"G3,C8",12632,13931,9421,4510,6690,3307,0,3309,2169,1140,1.902631579,1848,3065,847,308,308,0,64,0,0.025974026,0,empty,CD-0722-1
"G3,C9",9116,10222,6814,3408,4887,2439,0,2442,1517,925,1.64,1431,1564,407,137,137,0,34,0,0.204379562,0,empty,CD-0722-1
"G3,C10",10609,11714,7865,3849,5341,2615,0,2616,1698,918,1.849673203,1480,1521,316,120,120,0,37,0,0.091666667,0,empty,CD-0722-1
"G3,C11",9210,10254,6994,3260,4830,2298,0,2301,1444,857,1.684947491,1285,1568,446,144,143,1,52,1,0.034965035,0,empty,CD-0722-1
"G3,C12",12851,14264,9629,4635,6655,3207,0,3218,2044,1174,1.741056218,1773,1816,556,213,212,1,54,1,0,0,empty,CD-0722-1
"G3,D1",11407,12918,8350,4568,6127,3258,0,3258,1936,1322,1.464447806,1905,656,80,24,24,0,17,0,0,0,empty,CD-0722-1
"G3,D2",9588,10363,7382,2981,4934,2280,0,2285,1451,834,1.739808153,1256,2614,768,233,232,1,74,1,0.094827586,0,empty,CD-0722-1
"G3,D3",669147,827860,471865,355995,386273,238668,2,238890,183097,55793,3.281719929,149860,15928,6637,1953,1946,7,428,1,0.085817061,0,hg38,CD-0722-1
"G3,D4",6177,6835,4611,2224,3262,1592,0,1593,1043,550,1.896363636,901,1363,286,99,98,1,32,1,0.010204082,0,empty,CD-0722-1
"G3,D5",1142586,1323084,878593,444491,608439,323077,1,323455,255634,67821,3.769245514,185369,151994,23670,7918,7759,159,1331,4,0.055548395,0,hg38,CD-0722-1
"G3,D6",11432,13001,8259,4742,5990,3184,0,3189,1938,1251,1.549160671,1887,1646,367,128,128,0,37,0,0.1640625,0,empty,CD-0722-1
"G3,D7",6337,7145,4620,2525,3309,1619,0,1623,1046,577,1.812824957,979,1549,483,149,136,13,40,2,0.066176471,0,empty,CD-0722-1
"G3,D8",8042,8590,5967,2623,4148,2047,0,2050,1397,653,2.139356815,1108,1094,309,130,128,2,48,1,0.0703125,0,empty,CD-0722-1
"G3,D9",4154,4438,3081,1357,2186,1077,0,1079,712,367,1.940054496,619,1780,398,152,151,1,47,1,0.079470199,0,empty,CD-0722-1
"G3,D10",8219,9666,6128,3538,4587,2487,4,2494,1516,978,1.550102249,1500,836,156,58,57,1,22,1,0.175438596,0,empty,CD-0722-1
"G3,D11",766920,896040,571623,324417,411907,226469,0,226710,176009,50701,3.471509438,133500,136742,20521,6535,6383,152,1290,5,0.042143193,0,hg38,CD-0722-1
"G3,D12",10828,11687,8139,3548,5584,2775,0,2778,1790,988,1.811740891,1576,3248,739,258,258,0,82,0,0.007751938,0,empty,CD-0722-1
"G3,E1",13391,14717,10051,4666,6953,3489,0,3492,2216,1276,1.736677116,1932,2522,609,213,211,2,74,2,0.042654028,0,empty,CD-0722-1
"G3,E2",9693,10668,7066,3602,5091,2583,0,2586,1569,1017,1.542772861,1497,1814,498,170,169,1,52,1,0.088757396,0,empty,CD-0722-1
"G3,E3",6811,7702,4998,2704,3533,1727,0,1733,1079,654,1.649847095,1000,2271,382,128,128,0,57,0,0.0546875,0,empty,CD-0722-1
"G3,E4",9305,10102,6715,3387,4981,2529,0,2529,1644,885,1.857627119,1486,2567,527,217,217,0,67,0,0.004608295,0,empty,CD-0722-1
"G3,E5",9522,10495,7400,3095,4909,2305,11,2321,1505,816,1.844362745,1296,3627,576,204,199,5,52,3,0.025125628,0,empty,CD-0722-1
"G3,E6",13776,14806,10357,4449,6966,3414,1,3419,2134,1285,1.660700389,1873,2888,887,257,256,1,65,1,0.08203125,0,empty,CD-0722-1
"G3,E7",12257,13476,9363,4113,6369,3048,0,3049,2053,996,2.06124498,1681,2876,566,186,179,7,65,2,0.05027933,0,empty,CD-0722-1
"G3,E8",10637,11751,8243,3508,5475,2553,0,2556,1676,880,1.904545455,1401,2660,629,193,192,1,56,1,0.020833333,0,empty,CD-0722-1
"G3,E9",554930,644551,417044,227507,301199,160475,1,160658,124716,35942,3.469923766,94685,137598,20443,6804,6625,179,1209,8,0.046641509,0,hg38,CD-0722-1
"G3,E10",8045,8844,6035,2809,3980,1868,2,1879,1276,603,2.116086235,1062,2087,384,131,125,6,46,2,0.072,0,empty,CD-0722-1
"G3,E11",9128,10009,6738,3271,4869,2518,0,2518,1566,952,1.644957983,1411,1920,472,156,156,0,43,0,0.012820513,0,empty,CD-0722-1
"G3,E12",9179,10628,6821,3807,5035,2532,0,2537,1552,985,1.575634518,1486,1468,323,133,132,1,40,1,0.159090909,0,empty,CD-0722-1
"G3,F1",11870,13037,8850,4187,6144,3058,1,3063,1928,1135,1.698678414,1710,2265,714,201,200,1,59,1,0.055,0,empty,CD-0722-1
"G3,F2",571424,692189,394468,297721,323329,210038,0,210246,148626,61620,2.411976631,128994,5487,1017,340,331,9,115,2,0.075528701,0,hg38,CD-0722-1
"G3,F3",884687,1057851,644612,413239,487640,281273,3,281574,217781,63793,3.41386986,171047,193707,35875,12048,11884,164,1785,8,0.072702794,0,hg38,CD-0722-1
"G3,F4",1175554,1369602,866499,503103,627902,353793,24,354166,280119,74047,3.782989183,209536,36349,6749,2043,2001,42,468,2,0.035482259,0,hg38,CD-0722-1
"G3,F5",691043,819579,492650,326929,378999,226445,0,226645,171447,55198,3.106036451,137478,22991,8586,2630,2608,22,553,3,0.057515337,0,hg38,CD-0722-1
"G3,F6",723496,822970,550101,272869,381103,195936,2,196185,151711,44474,3.411229033,113115,156756,19579,6614,6441,173,1161,9,0.052786834,0,hg38,CD-0722-1
"G3,F7",12384,13861,9117,4744,6664,3340,0,3344,2175,1169,1.860564585,1906,863,282,105,104,1,34,1,0.269230769,0,empty,CD-0722-1
"G3,F8",7872,8670,6014,2656,4170,2030,1,2031,1298,733,1.770804911,1143,174,45,18,17,1,6,1,0.117647059,0,empty,CD-0722-1
"G3,F9",9005,9678,6826,2852,4552,2160,0,2160,1369,791,1.730720607,1164,2252,599,194,194,0,52,0,0.072164948,0,empty,CD-0722-1
"G3,F10",11670,12483,9046,3437,6034,2740,0,2747,1763,984,1.791666667,1453,1499,358,115,109,6,32,1,0.036697248,0,empty,CD-0722-1
"G3,F11",8981,9641,6874,2767,4672,2158,0,2158,1398,760,1.839473684,1197,1353,247,107,107,0,36,0,0.158878505,0,empty,CD-0722-1
"G3,F12",10005,10799,7459,3340,5112,2492,0,2493,1528,965,1.583419689,1377,225,70,40,40,0,11,0,0,0,empty,CD-0722-1
"G3,G1",1218217,1422415,920948,501467,647968,354282,4,354671,286739,67932,4.220970971,206554,194283,32139,10684,10484,200,1745,6,0.036818008,0,hg38,CD-0722-1
"G3,G2",6063,6860,4221,2639,3248,1741,2,1747,1052,695,1.513669065,1061,199,53,29,29,0,14,0,0,0,empty,CD-0722-1
"G3,G3",12678,14263,9273,4990,6735,3491,1,3496,2186,1310,1.66870229,2002,2493,595,218,215,3,66,2,0.051162791,0,empty,CD-0722-1
"G3,G4",21986,24751,15854,8897,11810,6492,0,6509,3917,2592,1.511188272,3814,177,37,14,14,0,7,0,0.071428571,0,empty,CD-0722-1
"G3,G5",7880,8969,5765,3204,4309,2202,0,2208,1428,780,1.830769231,1313,1533,582,151,148,3,49,1,0.006756757,0,empty,CD-0722-1
"G3,G6",10157,11037,7606,3431,5196,2512,0,2514,1626,888,1.831081081,1384,99,31,19,19,0,7,0,0,0,empty,CD-0722-1
"G3,G7",9218,10048,7011,3037,4930,2395,0,2402,1523,879,1.732650739,1379,2420,524,194,193,1,83,1,0.051813472,0,empty,CD-0722-1
"G3,G8",6086,6649,4531,2118,3114,1490,1,1495,996,499,1.995991984,856,1697,677,204,202,2,46,2,0.108910891,0,empty,CD-0722-1
"G3,G9",7732,8741,5780,2961,4113,2129,0,2129,1385,744,1.86155914,1239,2168,696,159,158,1,54,1,0.063291139,0,empty,CD-0722-1
"G3,G10",9024,10318,6678,3640,4875,2448,0,2450,1563,887,1.762119504,1379,2283,571,213,212,1,65,1,0.004716981,0,empty,CD-0722-1
"G3,G11",9281,10038,7100,2938,4857,2282,1,2291,1476,815,1.811042945,1249,1511,313,103,100,3,45,2,0,0,empty,CD-0722-1
"G3,G12",7500,8404,5506,2898,3932,1962,0,1971,1247,724,1.722375691,1147,1879,369,154,154,0,41,0,0.032467532,0,empty,CD-0722-1
"G3,H1",7882,8619,5844,2775,4038,1950,1,1957,1253,704,1.779829545,1105,871,288,111,111,0,31,0,0.054054054,0,empty,CD-0722-1
"G3,H2",9398,10493,6917,3576,4946,2478,0,2489,1602,887,1.806087937,1404,2058,569,165,164,1,43,1,0.012195122,0,empty,CD-0722-1
"G3,H3",7315,8398,5339,3059,3868,1918,0,1920,1231,689,1.786647315,1144,1292,335,124,123,1,47,1,0.089430894,0,empty,CD-0722-1
"G3,H4",10897,12009,8103,3906,5543,2700,2,2702,1690,1012,1.669960474,1548,183,23,12,12,0,7,0,0.583333333,0,empty,CD-0722-1
"G3,H5",12217,13292,8929,4363,6252,3084,0,3088,1898,1190,1.594957983,1739,1568,386,130,129,1,37,1,0.015503876,0,empty,CD-0722-1
"G3,H6",6563,7329,4911,2418,3486,1797,0,1800,1165,635,1.834645669,1002,1625,302,115,113,2,48,2,0.008849558,0,empty,CD-0722-1
"G3,H7",8414,8888,6343,2545,4304,2043,0,2044,1363,681,2.001468429,1079,2060,484,133,133,0,53,0,0.07518797,0,empty,CD-0722-1
"G3,H8",17184,19423,12738,6685,9287,4803,0,4807,3331,1476,2.256775068,2825,1815,388,140,140,0,48,0,0.221428571,0,empty,CD-0722-1
"G3,H9",8044,8964,6111,2853,4202,2001,0,2004,1327,677,1.960118168,1125,1188,306,113,111,2,34,2,0.18018018,0,empty,CD-0722-1
"G3,H10",6450,6969,4906,2063,3291,1594,1,1597,1073,524,2.047709924,846,1209,351,128,127,1,36,1,0.015748031,0,empty,CD-0722-1
"G3,H11",8527,10201,5967,4234,4841,2954,1,2956,1516,1440,1.052777778,1826,65,12,5,5,0,2,0,0,0,empty,CD-0722-1
"G3,H12",6888,7598,4914,2684,3687,1931,0,1938,1283,655,1.958778626,1156,1229,251,93,93,0,41,0,0.021505376,0,empty,CD-0722-1
"G4,A1",8315,9366,6219,3147,4435,2306,0,2314,1452,862,1.684454756,1331,1518,233,94,93,1,36,1,0.139784946,0,empty,CD-0722-1
"G4,A2",12937,14306,9600,4706,6686,3448,0,3452,2215,1237,1.790622474,1901,2240,408,123,119,4,55,1,0.092436975,0,empty,CD-0722-1
"G4,A3",7546,8287,5592,2695,3824,1908,0,1913,1223,690,1.772463768,1063,1337,304,116,116,0,31,0,0.00862069,0,empty,CD-0722-1
"G4,A4",12512,13854,9444,4410,6454,3197,0,3206,2064,1142,1.807355517,1758,1258,264,94,92,2,23,1,0.065217391,0,empty,CD-0722-1
"G4,A5",10915,11882,7979,3903,5690,2752,0,2755,1744,1011,1.725024728,1575,2915,507,187,186,1,70,1,0.021505376,0,empty,CD-0722-1
"G4,A6",13871,15500,10425,5075,7422,3767,0,3769,2667,1102,2.420145191,2084,3037,359,166,163,3,73,2,0.012269939,0,empty,CD-0722-1
"G4,A7",8363,9304,6310,2994,4308,2171,0,2174,1397,777,1.797940798,1253,1847,390,145,143,2,58,1,0.118881119,0,empty,CD-0722-1
"G4,A8",5081,5837,3720,2117,2662,1366,0,1368,937,431,2.174013921,790,2758,641,221,214,7,66,2,0.177570093,0,empty,CD-0722-1
"G4,A9",8496,9446,6391,3055,4422,2159,0,2159,1437,722,1.990304709,1213,2025,523,228,228,0,80,0,0.021929825,0,empty,CD-0722-1
"G4,A10",246335,318489,167828,150661,159235,108991,0,109058,61523,47535,1.294267382,70611,446,107,35,35,0,19,0,0.057142857,0,empty,CD-0722-1
"G4,A11",8047,9212,6070,3142,4383,2145,0,2146,1422,724,1.964088398,1270,2773,572,198,197,1,77,1,0.040609137,0,empty,CD-0722-1
"G4,A12",10372,11265,7892,3373,5337,2580,0,2582,1721,861,1.99883856,1436,3849,1083,379,378,1,101,1,0.087301587,0,empty,CD-0722-1
"G4,B1",8897,10007,6561,3446,4702,2393,2,2396,1503,893,1.683090705,1390,1281,341,131,130,1,45,1,0.092307692,0,empty,CD-0722-1
"G4,B2",9240,9840,6376,3464,4798,2481,0,2484,1517,967,1.56876939,1433,714,192,77,77,0,26,0,0.311688312,0,empty,CD-0722-1
"G4,B3",7114,7870,5358,2512,3811,1920,1,1922,1238,684,1.80994152,1101,1644,399,127,127,0,43,0,0.039370079,0,empty,CD-0722-1
"G4,B4",8921,10123,6596,3527,4841,2547,1,2552,1609,943,1.706256628,1506,1877,369,159,158,1,64,1,0.03164557,0,empty,CD-0722-1
"G4,B5",8280,4623,2701,1922,2960,1659,1,1682,1109,573,1.935427574,1106,900,198,78,77,1,23,1,0.181818182,0,empty,CD-0722-1
"G4,B6",9495,10608,6833,3775,5029,2689,0,2692,1679,1013,1.65745311,1593,1808,398,135,135,0,55,0,0.022222222,0,empty,CD-0722-1
"G4,B7",8618,9287,6639,2648,4493,2194,0,2197,1396,801,1.742821473,1195,1320,284,102,102,0,34,0,0.049019608,0,empty,CD-0722-1
"G4,B8",1481122,1718672,1108596,610076,777701,428527,2,428949,353392,75557,4.677157643,249249,175800,29536,9670,9486,184,1644,6,0.069259962,0,hg38,CD-0722-1
"G4,B9",868438,986234,650271,335963,443005,228512,3,228804,181501,47303,3.836987083,132622,3399,963,361,358,3,186,2,0.039106145,0,hg38,CD-0722-1
"G4,B10",6597,7170,4887,2283,3473,1682,4,1695,1076,619,1.738287561,918,360,91,25,25,0,14,0,0,0,empty,CD-0722-1
"G4,B11",16957,19684,12399,7285,9111,5003,0,5008,3106,1902,1.633017876,2990,309,38,16,15,1,7,1,0.066666667,0,empty,CD-0722-1
"G4,B12",8071,9084,6009,3075,4311,2132,0,2132,1344,788,1.705583756,1233,1812,440,173,171,2,45,1,0.01754386,0,empty,CD-0722-1
"G4,C1",15284,16538,11585,4953,7621,3637,1,3643,2288,1355,1.688560886,2015,1322,341,121,120,1,37,1,0.25,0,empty,CD-0722-1
"G4,C2",12482,13803,9255,4548,6463,3275,0,3279,2115,1164,1.817010309,1889,2025,447,175,174,1,61,1,0.109195402,0,empty,CD-0722-1
"G4,C3",13050,14220,9810,4410,6688,3274,0,3280,2091,1189,1.75862069,1800,771,194,79,79,0,29,0,0.037974684,0,empty,CD-0722-1
"G4,C4",814162,909547,625200,284347,417550,203758,6,204016,147219,56797,2.592020705,115942,101922,12372,4143,4047,96,866,7,0.070669632,0,hg38,CD-0722-1
"G4,C5",13717,15644,10221,5423,7419,3837,2,3843,2545,1298,1.960708783,2275,2419,488,179,175,4,62,2,0.125714286,0,empty,CD-0722-1
"G4,C6",10531,11633,7783,3850,5618,2822,0,2826,1866,960,1.94375,1577,2311,743,260,255,5,85,2,0.043137255,0,empty,CD-0722-1
"G4,C7",1056563,1244709,793187,451522,565991,304653,2,305034,243982,61052,3.996298238,181705,25984,3723,1282,1255,27,282,2,0.093227092,0,hg38,CD-0722-1
"G4,C8",15414,16935,11577,5358,7966,3975,1,3983,2609,1374,1.898835517,2210,3994,944,381,374,7,107,2,0.082887701,0,empty,CD-0722-1
"G4,C9",29619,33891,22686,11205,14962,7317,1,7326,4988,2338,2.133447391,4179,5692,999,318,315,3,80,2,0.120634921,0,empty,CD-0722-1
"G4,C10",11690,12788,8930,3858,6002,2840,1,2844,1831,1013,1.807502468,1539,2166,613,219,217,2,61,1,0.092165899,0,empty,CD-0722-1
"G4,C11",10178,11319,7537,3782,5351,2717,0,2718,1736,982,1.767820774,1580,2204,452,147,146,1,50,1,0.089041096,0,empty,CD-0722-1
"G4,C12",15126,16895,11453,5442,7854,3840,5,3849,2478,1371,1.807439825,2236,1849,402,120,119,1,53,1,0.092436975,0,empty,CD-0722-1
"G4,D1",13475,15509,9752,5757,7296,3916,0,3922,2371,1551,1.528691167,2331,707,91,52,50,2,23,1,0.08,0,empty,CD-0722-1
"G4,D2",11029,12035,8462,3573,5652,2734,0,2734,1795,939,1.911608094,1509,3180,942,299,290,9,90,2,0.079310345,0,empty,CD-0722-1
"G4,D3",10116,11511,7439,4072,5436,2799,0,2799,1872,927,2.019417476,1628,2391,725,269,267,2,79,2,0.157303371,0,empty,CD-0722-1
"G4,D4",7736,8640,5695,2945,4028,2016,0,2018,1248,770,1.620779221,1183,1768,261,109,108,1,52,1,0.018518519,0,empty,CD-0722-1
"G4,D5",9002,9917,6747,3170,4723,2300,0,2300,1518,782,1.941176471,1330,2401,528,162,155,7,62,1,0.058064516,0,empty,CD-0722-1
"G4,D6",725935,824732,548405,276327,377801,190371,4,190592,151300,39292,3.850656622,110001,174838,32125,10894,10703,191,1689,6,0.046248715,0,hg38,CD-0722-1
"G4,D7",7181,7984,5425,2559,3730,1801,0,1801,1184,617,1.918962723,999,1958,433,142,140,2,56,2,0.064285714,0,empty,CD-0722-1
"G4,D8",8940,9836,6623,3213,4626,2292,0,2293,1475,818,1.803178484,1323,1394,380,137,133,4,51,1,0.045112782,0,empty,CD-0722-1
"G4,D9",5836,6518,4378,2140,3226,1600,0,1601,1047,554,1.889891697,925,2132,619,215,213,2,63,1,0.169014085,0,empty,CD-0722-1
"G4,D10",9266,10646,6755,3891,5038,2594,0,2594,1643,951,1.7276551,1589,1181,287,98,96,2,19,2,0.15625,0,empty,CD-0722-1
"G4,D11",742184,858556,555120,303436,394410,213272,5,213507,168291,45216,3.721934713,124234,188975,32046,10822,10647,175,1638,7,0.049403588,0,hg38,CD-0722-1
"G4,D12",12364,13962,9263,4699,6551,3279,1,3286,2120,1166,1.818181818,1915,3820,892,305,304,1,111,1,0.065789474,0,empty,CD-0722-1
"G4,E1",15739,17347,11706,5641,8131,4122,0,4130,2611,1519,1.718894009,2311,3245,780,287,285,2,98,1,0.084210526,0,empty,CD-0722-1
"G4,E2",1051416,1267881,764605,503276,578696,337148,2,337473,267127,70346,3.797330339,206290,107939,16490,5376,5252,124,1017,7,0.04950495,0,hg38,CD-0722-1
"G4,E3",7643,8441,5774,2667,4005,1969,0,1973,1251,722,1.732686981,1137,2964,627,246,244,2,84,1,0.040983607,0,empty,CD-0722-1
"G4,E4",1040385,1289628,745445,544183,586682,352565,2,352905,277990,74915,3.710738837,222447,166662,29431,9689,9532,157,1565,6,0.049937054,0,hg38,CD-0722-1
"G4,E5",9591,10782,7306,3476,4972,2327,0,2329,1484,845,1.756213018,1328,1389,269,119,117,2,35,1,0.111111111,0,empty,CD-0722-1
"G4,E6",15711,17720,11794,5926,8314,4270,0,4276,2664,1612,1.652605459,2451,3705,801,289,287,2,89,1,0.108013937,0,empty,CD-0722-1
"G4,E7",14768,16449,11110,5339,7707,3709,2,3718,2432,1286,1.891135303,2113,3677,895,352,351,1,103,1,0.034188034,0,empty,CD-0722-1
"G4,E8",11880,12924,9120,3804,6079,2795,0,2802,1786,1016,1.757874016,1528,3343,891,337,333,4,89,1,0.066066066,0,empty,CD-0722-1
"G4,E9",8110,8957,6011,2946,4309,2143,0,2147,1484,663,2.238310709,1229,3187,868,310,308,2,96,1,0.074675325,0,empty,CD-0722-1
"G4,E10",8616,9255,6484,2771,4497,2070,0,2078,1345,733,1.834924966,1153,2122,544,200,195,5,64,1,0.107692308,0,empty,CD-0722-1
"G4,E11",10502,11486,7907,3579,5421,2677,0,2679,1691,988,1.711538462,1459,2105,526,192,189,3,72,3,0.153439153,0,empty,CD-0722-1
"G4,E12",11326,12468,8548,3920,5911,3043,0,3044,1986,1058,1.877126654,1721,2109,474,140,138,2,55,2,0.086956522,0,empty,CD-0722-1
"G4,F1",13614,14717,10092,4625,6868,3328,0,3333,2113,1220,1.731967213,1867,3222,1171,353,349,4,81,1,0.137535817,0,empty,CD-0722-1
"G4,F2",11021,12205,8183,4022,5713,2777,1,2782,1819,963,1.888888889,1606,4117,1180,429,417,12,126,3,0.081534772,0,empty,CD-0722-1
"G4,F3",10121,11069,7691,3378,5354,2574,0,2579,1646,933,1.764201501,1483,4152,900,319,314,5,113,3,0.149681529,0,empty,CD-0722-1
"G4,F4",14898,16029,11222,4807,7609,3501,3,3508,2322,1186,1.957841484,1983,922,122,60,60,0,32,0,0.116666667,0,empty,CD-0722-1
"G4,F5",11581,12213,8803,3410,5706,2644,0,2653,1713,940,1.822340426,1420,2012,430,165,161,4,56,1,0.099378882,0,empty,CD-0722-1
"G4,F6",847924,1010506,622941,387565,461493,256514,2,256776,207884,48892,4.251902152,156403,310466,48161,16013,15672,341,2368,12,0.05442828,0,hg38,CD-0722-1
"G4,F7",14187,15823,10542,5281,7550,3801,0,3805,2528,1277,1.979639781,2235,1312,294,118,116,2,55,1,0.043103448,0,empty,CD-0722-1
"G4,F8",9536,10548,7299,3249,4834,2315,0,2315,1467,848,1.72995283,1261,224,23,13,13,0,6,0,0,0,empty,CD-0722-1
"G4,F9",10434,11246,7968,3278,5414,2558,1,2560,1685,875,1.925714286,1402,2980,722,246,245,1,74,1,0.065306122,0,empty,CD-0722-1
"G4,F10",13090,14288,10039,4249,6656,3145,2,3149,2043,1106,1.847197107,1711,1995,365,143,142,1,41,1,0.112676056,0,empty,CD-0722-1
"G4,F11",685871,766816,520881,245935,349421,174748,4,174961,136755,38206,3.579411611,99148,138927,15086,5290,5134,156,1002,8,0.094663031,0,hg38,CD-0722-1
"G4,F12",11327,12588,8534,4054,5843,2840,0,2844,1823,1021,1.785504407,1639,199,53,25,25,0,9,0,0,0,empty,CD-0722-1
"G4,G1",12505,13807,9622,4185,6601,3096,0,3105,1992,1113,1.789757412,1726,3342,836,326,325,1,124,1,0.043076923,0,empty,CD-0722-1
"G4,G2",7392,8243,5305,2938,3882,2010,0,2011,1289,722,1.78531856,1207,511,88,31,31,0,18,0,0.032258065,0,empty,CD-0722-1
"G4,G3",13658,14795,10078,4717,7107,3658,0,3663,2245,1418,1.583215797,1998,3295,689,290,287,3,103,2,0.031358885,0,empty,CD-0722-1
"G4,G4",24053,27500,17364,10136,12998,7217,1,7226,4451,2775,1.603963964,4257,273,57,37,37,0,12,0,0,0,empty,CD-0722-1
"G4,G5",8423,9296,6173,3123,4535,2272,0,2276,1448,828,1.748792271,1344,2021,439,155,154,1,58,1,0.136363636,0,empty,CD-0722-1
"G4,G6",11582,12799,8770,4029,6030,2952,2,2963,1948,1015,1.919211823,1679,233,25,16,16,0,13,0,0.1875,0,empty,CD-0722-1
"G4,G7",10198,11008,7843,3165,5196,2367,1,2371,1491,880,1.694318182,1283,4216,859,291,284,7,108,2,0.066901408,0,empty,CD-0722-1
"G4,G8",7221,8118,5309,2809,3725,1839,0,1840,1198,642,1.866043614,1087,1725,435,169,162,7,58,2,0.00617284,0,empty,CD-0722-1
"G4,G9",8576,9511,6456,3055,4402,2093,1,2103,1366,737,1.853459973,1167,2273,373,125,125,0,55,0,0.048,0,empty,CD-0722-1
"G4,G10",1010277,1266301,716536,549765,579878,374318,2,374619,274724,99895,2.750127634,233655,58832,27281,8481,8455,26,1366,4,0.014784151,0,hg38,CD-0722-1
"G4,G11",10958,11867,8497,3370,5521,2565,0,2569,1712,857,1.997666278,1321,2282,593,186,185,1,65,1,0.032432432,0,empty,CD-0722-1
"G4,G12",798567,930932,582935,347997,435858,245536,0,245743,187674,58069,3.231913758,148017,139423,25648,8278,8155,123,1342,7,0.028203556,0,hg38,CD-0722-1
"G4,H1",9755,10803,7123,3680,5027,2446,1,2458,1598,860,1.858139535,1441,877,132,67,66,1,29,1,0.090909091,0,empty,CD-0722-1
"G4,H2",11057,12444,8112,4332,5778,2972,0,2977,1990,987,2.01621074,1747,2562,492,198,195,3,57,2,0.235897436,0,empty,CD-0722-1
"G4,H3",8762,9702,6384,3318,4500,2225,0,2231,1371,860,1.594186047,1293,1806,302,103,103,0,36,0,0.213592233,0,empty,CD-0722-1
"G4,H4",1018683,1204457,744827,459630,546686,312131,4,312449,257853,54596,4.72292842,187457,5763,1063,342,331,11,93,2,0,0,hg38,CD-0722-1
"G4,H5",12789,13987,9612,4375,6444,3163,0,3166,1991,1175,1.694468085,1755,1793,418,152,152,0,35,0,0.217105263,0,empty,CD-0722-1
"G4,H6",8622,9611,6417,3194,4556,2338,0,2338,1535,803,1.911581569,1336,2018,441,145,144,1,58,1,0.013888889,0,empty,CD-0722-1
"G4,H7",735933,890469,507768,382701,414730,273618,11,273872,198642,75230,2.640462581,165977,12624,1293,443,436,7,129,2,0.153669725,0,hg38,CD-0722-1
"G4,H8",10751,12058,7916,4142,5545,2769,0,2779,1773,1006,1.762425447,1609,2419,338,153,148,5,55,1,0.114864865,0,empty,CD-0722-1
"G4,H9",8955,9751,6750,3001,4613,2193,0,2198,1496,702,2.131054131,1250,986,318,132,131,1,35,1,0,0,empty,CD-0722-1
"G4,H10",695864,804052,517735,286317,373130,201333,1,201550,161542,40008,4.037742452,118709,36957,8335,2485,2444,41,478,4,0.025368249,0,hg38,CD-0722-1
"G4,H11",9822,11602,6962,4640,5444,3254,0,3256,1717,1539,1.115659519,1994,133,16,14,14,0,7,0,0,0,empty,CD-0722-1
"G4,H12",8364,9123,6139,2984,4466,2288,1,2289,1516,773,1.961190168,1321,1800,291,108,108,0,38,0,0.055555556,0,empty,CD-0722-1
"G5,A1",7930,8834,5904,2930,4166,2108,0,2111,1373,738,1.860433604,1219,1095,313,82,79,3,25,2,0.050632911,0,empty,CD-0722-1
"G5,A2",12572,13877,9415,4462,6553,3405,0,3415,2171,1244,1.745176849,1913,1640,349,127,119,8,46,2,0.092436975,0,empty,CD-0722-1
"G5,A3",6933,7830,5145,2685,3560,1812,0,1814,1164,650,1.790769231,1027,899,211,77,77,0,25,0,0.051948052,0,empty,CD-0722-1
"G5,A4",11370,12525,8515,4010,5970,2965,2,2969,1905,1064,1.790413534,1618,726,184,58,58,0,19,0,0.068965517,0,empty,CD-0722-1
"G5,A5",697570,850967,486712,364255,389724,252595,3,252834,167822,85012,1.974097774,153984,9149,807,300,282,18,71,3,0.265957447,0,hg38,CD-0722-1
"G5,A6",11093,12735,8520,4215,5979,2694,3,2702,1794,908,1.975770925,1587,2362,471,148,146,2,62,1,0.054794521,0,empty,CD-0722-1
"G5,A7",8015,8892,5985,2907,4186,2174,0,2174,1371,803,1.707347447,1221,954,112,45,45,0,28,0,0.111111111,0,empty,CD-0722-1
"G5,A8",5091,5835,3795,2040,2741,1423,0,1429,957,472,2.027542373,826,1396,365,122,122,0,51,0,0.163934426,0,empty,CD-0722-1
"G5,A9",9814,10944,7535,3409,5080,2447,0,2451,1704,747,2.281124498,1374,1436,297,87,86,1,35,1,0.023255814,0,empty,CD-0722-1
"G5,A10",398728,438731,310720,128011,205267,97397,1,97530,73754,23776,3.102035666,54126,11926,1415,517,499,18,121,4,0.134268537,0,hg38,CD-0722-1
"G5,A11",7909,8740,6068,2672,4079,1945,0,1945,1274,671,1.898658718,1067,1319,326,117,117,0,33,0,0,0,empty,CD-0722-1
"G5,A12",10463,11338,8064,3274,5149,2431,0,2435,1566,869,1.802071346,1314,2457,474,155,153,2,51,2,0.026143791,0,empty,CD-0722-1
"G5,B1",8211,9323,5970,3353,4349,2222,0,2226,1390,836,1.662679426,1329,975,264,75,75,0,29,0,0,0,empty,CD-0722-1
"G5,B2",7932,8616,5560,3056,4108,2161,0,2161,1344,817,1.64504284,1250,338,90,34,33,1,18,1,0,0,empty,CD-0722-1
"G5,B3",7145,7998,5315,2683,3725,1885,0,1885,1213,672,1.805059524,1051,1301,137,60,59,1,28,1,0.084745763,0,empty,CD-0722-1
"G5,B4",9030,10121,6728,3393,4833,2560,0,2561,1577,984,1.602642276,1459,1148,265,87,87,0,38,0,0.011494253,0,empty,CD-0722-1
"G5,B5",9519,6473,3967,2506,3796,2031,1,2049,1331,718,1.853760446,1333,762,157,66,64,2,20,1,0.28125,0,empty,CD-0722-1
"G5,B6",9907,11325,7146,4179,5215,2799,0,2800,1745,1055,1.654028436,1676,1263,424,122,121,1,34,1,0.049586777,0,empty,CD-0722-1
"G5,B7",8188,9155,6194,2961,4227,2074,0,2075,1378,697,1.977044476,1148,959,230,86,86,0,21,0,0.151162791,0,empty,CD-0722-1
"G5,B8",6682,7394,5167,2227,3522,1682,0,1683,1143,540,2.116666667,934,1380,388,143,142,1,41,1,0,0,empty,CD-0722-1
"G5,B9",1483591,1774606,1058527,716079,810022,512665,4,513130,405269,107861,3.757326559,307052,25385,9443,3008,2987,21,599,4,0.025443589,0,hg38,CD-0722-1
"G5,B10",615001,630390,433853,196537,303319,143825,26,144995,104239,40756,2.557635686,83611,38150,4280,1479,1443,36,317,2,0.071379071,0,hg38,CD-0722-1
"G5,B11",13177,14474,9688,4786,6694,3634,0,3635,2015,1620,1.24382716,2015,281,84,31,30,1,9,1,0,0,empty,CD-0722-1
"G5,B12",7684,8231,5682,2549,4029,2002,0,2006,1323,683,1.93704246,1148,1232,314,103,103,0,27,0,0.048543689,0,empty,CD-0722-1
"G5,C1",13851,14898,10655,4243,6976,3284,1,3293,2068,1225,1.688163265,1772,480,89,43,43,0,22,0,0.209302326,0,empty,CD-0722-1
"G5,C2",11808,13377,8709,4668,6107,3164,0,3166,2026,1140,1.777192982,1826,1683,396,113,113,0,30,0,0.371681416,0,empty,CD-0722-1
"G5,C3",12511,13852,9209,4643,6573,3162,0,3166,1963,1203,1.631753948,1841,548,162,56,55,1,24,1,0,0,empty,CD-0722-1
"G5,C4",10092,11254,7485,3769,5205,2530,1,2535,1701,834,2.039568345,1482,1927,356,127,127,0,41,0,0.118110236,0,empty,CD-0722-1
"G5,C5",12519,14229,9357,4872,6639,3361,0,3366,2229,1137,1.960422164,1901,1270,287,112,110,2,48,2,0.145454545,0,empty,CD-0722-1
"G5,C6",10093,11087,7615,3472,5339,2615,0,2617,1724,893,1.930571109,1458,1468,382,137,136,1,41,1,0.066176471,0,empty,CD-0722-1
"G5,C7",13984,16308,9944,6364,7681,4347,0,4353,2720,1633,1.66564605,2638,429,108,44,44,0,21,0,0.022727273,0,empty,CD-0722-1
"G5,C8",15108,16610,11454,5156,7796,3873,0,3879,2506,1373,1.825200291,2144,2568,703,222,218,4,68,1,0.036697248,0,empty,CD-0722-1
"G5,C9",10354,11530,7897,3633,5466,2669,0,2671,1759,912,1.92872807,1489,1185,269,111,110,1,34,1,0,0,empty,CD-0722-1
"G5,C10",11254,12289,8512,3777,5801,2780,0,2780,1764,1016,1.736220472,1598,1661,345,159,154,5,39,2,0.227272727,0,empty,CD-0722-1
"G5,C11",9940,10939,7355,3584,5100,2513,0,2515,1627,888,1.832207207,1434,1847,444,141,139,2,46,2,0.007194245,0,empty,CD-0722-1
"G5,C12",13874,15049,10326,4723,7139,3437,1,3449,2230,1219,1.829368335,1939,1517,298,107,105,2,26,1,0.095238095,0,empty,CD-0722-1
"G5,D1",12374,14369,9048,5321,6847,3666,1,3671,2305,1366,1.687408492,2200,745,111,54,52,2,19,1,0.307692308,0,empty,CD-0722-1
"G5,D2",605321,680160,460259,219901,312424,159502,2,159691,128080,31611,4.051754136,90249,150696,26292,8674,8535,139,1331,6,0.024838899,0,hg38,CD-0722-1
"G5,D3",636214,718621,486116,232505,333831,165577,2,165822,125166,40656,3.078659976,95937,68046,7111,2292,2219,73,518,4,0.061739522,0,hg38,CD-0722-1
"G5,D4",7310,8082,5542,2540,3794,1853,0,1853,1240,613,2.022838499,1035,925,149,62,57,5,28,1,0.01754386,0,empty,CD-0722-1
"G5,D5",8653,9964,6398,3566,4688,2302,3,2309,1563,746,2.095174263,1392,1250,307,109,106,3,39,1,0.103773585,0,empty,CD-0722-1
"G5,D6",11833,13479,8461,5018,6319,3462,0,3467,2110,1357,1.554900516,2057,1346,268,81,81,0,22,0,0.098765432,0,empty,CD-0722-1
"G5,D7",7119,7530,5359,2171,3620,1704,0,1708,1086,622,1.745980707,966,1425,400,143,143,0,43,0,0.062937063,0,empty,CD-0722-1
"G5,D8",8652,9598,6431,3167,4556,2286,0,2286,1508,778,1.938303342,1348,1076,274,105,105,0,35,0,0.019047619,0,empty,CD-0722-1
"G5,D9",5155,5700,3903,1797,2802,1415,0,1415,945,470,2.010638298,821,1261,240,106,106,0,38,0,0.075471698,0,empty,CD-0722-1
"G5,D10",7325,8297,5463,2834,3864,1935,2,1939,1190,749,1.588785047,1130,616,147,52,51,1,15,1,0,0,empty,CD-0722-1
"G5,D11",9745,10643,7459,3184,5146,2468,0,2468,1633,835,1.955688623,1369,1899,507,186,186,0,60,0,0.02688172,0,empty,CD-0722-1
"G5,D12",11553,12851,8616,4235,6078,3053,0,3059,1978,1081,1.829787234,1771,2664,633,216,214,2,64,1,0.028037383,0,empty,CD-0722-1
"G5,E1",795261,900189,590710,309479,410426,216360,1,216634,184889,31745,5.824192786,125708,200588,32531,10898,10676,222,1698,9,0.088141626,0,hg38,CD-0722-1
"G5,E2",10359,11567,7615,3952,5600,2892,0,2896,1789,1107,1.616079494,1714,1704,176,77,76,1,38,1,0.092105263,0,empty,CD-0722-1
"G5,E3",6986,7499,5275,2224,3716,1765,0,1765,1134,631,1.797147385,972,1593,367,134,133,1,47,1,0.127819549,0,empty,CD-0722-1
"G5,E4",9873,10972,7449,3523,5082,2454,0,2457,1542,915,1.685245902,1388,1756,305,119,118,1,51,1,0.050847458,0,empty,CD-0722-1
"G5,E5",8581,9536,6500,3036,4535,2126,0,2133,1373,760,1.806578947,1192,889,215,71,70,1,31,1,0.028571429,0,empty,CD-0722-1
"G5,E6",15249,16834,11500,5334,7935,4063,0,4065,2503,1562,1.602432778,2351,2526,616,165,164,1,56,1,0.018292683,0,empty,CD-0722-1
"G5,E7",134986,125229,118860,6369,61434,6431,0,6456,4351,2105,2.066983373,2551,2795,748,294,294,0,111,0,0.051020408,0,empty,CD-0722-1
"G5,E8",10663,11422,8106,3316,5401,2489,1,2496,1632,864,1.888888889,1398,2234,411,136,135,1,43,1,0.177777778,0,empty,CD-0722-1
"G5,E9",7813,8806,5736,3070,4112,2082,0,2089,1403,686,2.045189504,1167,1869,427,197,193,4,65,2,0.025906736,0,empty,CD-0722-1
"G5,E10",7898,8879,5849,3030,4254,2112,1,2119,1374,745,1.844295302,1230,1804,498,159,159,0,48,0,0.025157233,0,empty,CD-0722-1
"G5,E11",10246,11867,7642,4225,5423,2740,0,2741,1734,1007,1.721946375,1631,1685,342,148,147,1,46,1,0.013605442,0,empty,CD-0722-1
"G5,E12",937757,1093912,704849,389063,500762,270764,1,271022,200875,70147,2.863629236,161565,59190,9874,3204,3147,57,667,3,0.068319034,0,hg38,CD-0722-1
"G5,F1",12855,13910,9428,4482,6504,3188,0,3192,2052,1140,1.8,1795,1854,326,142,131,11,45,1,0.061068702,0,empty,CD-0722-1
"G5,F2",10089,11017,7587,3430,5304,2566,0,2583,1690,893,1.8924972,1467,2665,723,226,224,2,66,1,0.147321429,0,empty,CD-0722-1
"G5,F3",9502,10426,7183,3243,4983,2379,0,2383,1584,799,1.982478098,1344,1975,528,156,153,3,60,1,0.071895425,0,empty,CD-0722-1
"G5,F4",982418,1115314,735603,379711,511423,271171,15,271499,217790,53709,4.055000093,157319,13126,2128,632,620,12,165,3,0.020967742,0,hg38,CD-0722-1
"G5,F5",435196,528050,300225,227825,254682,163694,0,163807,90081,73726,1.221834902,103510,1526,388,107,105,2,44,2,0.038095238,0,hg38,CD-0722-1
"G5,F6",12313,13861,9268,4593,6598,3382,1,3388,2168,1220,1.77704918,1962,2438,650,207,205,2,50,1,0.224390244,0,empty,CD-0722-1
"G5,F7",13139,14643,9800,4843,7045,3654,0,3664,2396,1268,1.889589905,2070,1117,273,100,100,0,34,0,0.05,0,empty,CD-0722-1
"G5,F8",8828,9706,6805,2901,4483,2125,0,2128,1385,743,1.864064603,1170,187,55,21,21,0,11,0,0.285714286,0,empty,CD-0722-1
"G5,F9",761251,844602,581373,263229,388846,195631,2,195821,150224,45597,3.294602715,109952,61333,12013,3678,3633,45,720,3,0.02449766,0,hg38,CD-0722-1
"G5,F10",1283798,1486701,966517,520184,669973,378742,2,379167,276653,102514,2.698685058,219190,19365,5421,1652,1631,21,361,5,0.008583691,0,hg38,CD-0722-1
"G5,F11",10430,11485,7984,3501,5319,2544,0,2544,1715,829,2.068757539,1400,1252,316,124,121,3,38,1,0,0,empty,CD-0722-1
"G5,F12",10903,12117,8039,4078,5490,2752,0,2759,1850,909,2.03520352,1605,101,33,8,8,0,5,0,0,0,empty,CD-0722-1
"G5,G1",12422,13478,9412,4066,6334,3007,0,3010,1962,1048,1.872137405,1629,2264,636,205,205,0,68,0,0.185365854,0,empty,CD-0722-1
"G5,G2",7157,7914,5178,2736,3729,1876,0,1882,1232,650,1.895384615,1130,449,169,61,61,0,14,0,0.114754098,0,empty,CD-0722-1
"G5,G3",13286,14279,9789,4490,6652,3417,0,3423,2066,1357,1.52247605,1848,2727,566,217,215,2,65,1,0.018604651,0,empty,CD-0722-1
"G5,G4",22895,25725,16659,9066,12047,6559,0,6568,4052,2516,1.610492846,3850,123,47,13,13,0,5,0,0,0,empty,CD-0722-1
"G5,G5",824862,962539,625150,337389,437035,230470,2,230766,182287,48479,3.76012294,136066,84901,13574,4438,4353,85,830,3,0.03606708,0,hg38,CD-0722-1
"G5,G6",11085,12094,8299,3795,5506,2632,0,2634,1755,879,1.996587031,1478,103,14,9,9,0,6,0,0,0,empty,CD-0722-1
"G5,G7",9862,10559,7626,2933,5073,2364,1,2370,1497,873,1.714776632,1275,2587,729,254,253,1,69,1,0.106719368,0,empty,CD-0722-1
"G5,G8",739258,812802,563456,249346,375065,190706,1,190919,148613,42306,3.512811422,107078,19452,2724,864,858,6,272,2,0.016317016,0,hg38,CD-0722-1
"G5,G9",7852,8823,5971,2852,4131,2020,0,2020,1311,709,1.849083216,1152,1692,437,142,140,2,47,2,0.15,0,empty,CD-0722-1
"G5,G10",10580,11559,7822,3737,5438,2726,0,2728,1746,982,1.778004073,1562,1765,365,133,131,2,60,2,0.045801527,0,empty,CD-0722-1
"G5,G11",9980,10865,7585,3280,5106,2426,0,2434,1594,840,1.897619048,1359,1063,380,156,156,0,34,0,0.032051282,0,empty,CD-0722-1
"G5,G12",7870,8741,5781,2960,4160,2112,0,2114,1360,754,1.803713528,1237,1475,241,80,80,0,31,0,0.0125,0,empty,CD-0722-1
"G5,H1",8951,9976,6754,3222,4612,2163,0,2166,1413,753,1.876494024,1204,772,151,78,78,0,31,0,0.038461538,0,empty,CD-0722-1
"G5,H2",9582,10451,7151,3300,4848,2423,1,2426,1542,884,1.744343891,1391,2215,656,199,198,1,54,1,0.050505051,0,empty,CD-0722-1
"G5,H3",853237,958300,660185,298115,434035,208116,1,208367,160164,48203,3.322697757,118603,134924,15155,5146,4998,148,981,4,0.041416567,0,hg38,CD-0722-1
"G5,H4",11969,13260,9016,4244,6229,2981,0,2985,1971,1014,1.943786982,1726,181,65,11,11,0,3,0,0.818181818,0,empty,CD-0722-1
"G5,H5",12221,13473,8981,4492,6165,3034,0,3048,1927,1121,1.719000892,1745,1923,591,196,196,0,50,0,0.117346939,0,empty,CD-0722-1
"G5,H6",8183,9322,6063,3259,4284,2151,0,2155,1398,757,1.84676354,1243,1228,276,104,103,1,39,1,0.009708738,0,empty,CD-0722-1
"G5,H7",9969,11136,7417,3719,5215,2601,2,2604,1721,883,1.949037373,1529,1709,329,136,135,1,41,1,0.125925926,0,empty,CD-0722-1
"G5,H8",10230,11463,7406,4057,5364,2817,0,2821,1774,1047,1.694364852,1682,1515,283,75,75,0,28,0,0.053333333,0,empty,CD-0722-1
"G5,H9",8154,9006,6242,2764,4105,1982,3,1987,1369,618,2.215210356,1086,1165,354,105,103,2,30,2,0.009708738,0,empty,CD-0722-1
"G5,H10",7071,7713,5398,2315,3625,1776,0,1776,1230,546,2.252747253,943,1187,341,103,103,0,26,0,0.203883495,0,empty,CD-0722-1
"G5,H11",10123,11858,7133,4725,5655,3464,0,3469,1840,1629,1.129527317,2148,35,6,4,4,0,2,0,0,0,empty,CD-0722-1
"G5,H12",8621,9818,6298,3520,4518,2379,0,2382,1619,763,2.121887287,1405,1048,161,53,51,2,23,2,0,0,empty,CD-0722-1
"G6,A1",5206,5747,3836,1911,2730,1404,0,1406,921,485,1.898969072,812,812,132,47,46,1,11,1,0,0,empty,CD-0722-1
"G6,A2",7732,8429,5812,2617,4127,2068,0,2068,1292,776,1.664948454,1156,1169,237,69,63,6,25,2,0.126984127,0,empty,CD-0722-1
"G6,A3",4746,5066,3641,1425,2370,1153,2,1155,751,404,1.858910891,624,708,189,33,33,0,15,0,0,0,empty,CD-0722-1
"G6,A4",490762,545115,380637,164478,251406,120984,0,121119,94034,27085,3.471810965,68001,11798,1993,628,623,5,150,2,0.006420546,0,hg38,CD-0722-1
"G6,A5",7156,7654,5341,2313,3705,1801,0,1808,1149,659,1.743550835,1025,1615,401,146,145,1,38,1,0.075862069,0,empty,CD-0722-1
"G6,A6",5738,6695,4260,2435,3202,1702,0,1702,1085,617,1.758508914,1022,2096,496,224,222,2,53,1,0.148648649,0,empty,CD-0722-1
"G6,A7",5103,5613,3742,1871,2706,1408,1,1409,866,543,1.594843462,810,818,96,55,55,0,21,0,0.090909091,0,empty,CD-0722-1
"G6,A8",5650,6797,3784,3013,3166,1896,0,1897,1295,602,2.151162791,1207,1006,175,85,83,2,32,2,0.144578313,0,empty,CD-0722-1
"G6,A9",5735,6620,4371,2249,3066,1506,3,1512,979,533,1.836772983,848,1088,137,55,55,0,25,0,0.036363636,0,empty,CD-0722-1
"G6,A10",6101,6571,4734,1837,3177,1540,0,1541,978,563,1.737122558,829,188,17,10,10,0,7,0,0,0,empty,CD-0722-1
"G6,A11",5000,5621,3760,1861,2619,1265,0,1266,847,419,2.021479714,714,955,192,63,63,0,16,0,0.222222222,0,empty,CD-0722-1
"G6,A12",6674,7183,4921,2262,3510,1690,0,1692,1118,574,1.947735192,974,2994,989,281,281,0,62,0,0.110320285,0,empty,CD-0722-1
"G6,B1",679537,779723,513683,266040,352979,185552,1,185764,147702,38062,3.880563291,107462,68556,10683,3528,3455,73,708,4,0.05065123,0,hg38,CD-0722-1
"G6,B2",5747,6465,3938,2527,3094,1675,0,1678,1082,596,1.815436242,1015,449,108,25,24,1,6,1,0,0,empty,CD-0722-1
"G6,B3",4653,5169,3506,1663,2503,1280,0,1282,859,423,2.030732861,738,862,133,44,44,0,15,0,0,0,empty,CD-0722-1
"G6,B4",5670,6360,4213,2147,2969,1533,0,1538,982,556,1.76618705,863,1130,315,112,112,0,33,0,0.053571429,0,empty,CD-0722-1
"G6,B5",7066,4900,2948,1952,2885,1618,0,1626,1153,473,2.437632135,1050,760,141,24,23,1,12,1,0,0,empty,CD-0722-1
"G6,B6",6562,7460,4752,2708,3441,1845,0,1850,1157,693,1.66955267,1086,1137,265,101,101,0,22,0,0.247524752,0,empty,CD-0722-1
"G6,B7",5791,6225,4459,1766,2990,1443,2,1448,945,503,1.878727634,790,686,156,71,71,0,14,0,0.394366197,0,empty,CD-0722-1
"G6,B8",4149,4585,3277,1308,2167,981,0,981,634,347,1.827089337,545,548,92,49,49,0,18,0,0,0,empty,CD-0722-1
"G6,B9",7764,8697,5687,3010,4098,2120,0,2124,1243,881,1.410896708,1248,646,224,95,92,3,26,1,0.076086957,0,empty,CD-0722-1
"G6,B10",749684,763672,526092,237580,368531,178631,28,179779,137681,42098,3.270487909,102828,39338,5096,1747,1704,43,333,2,0.082746479,0,hg38,CD-0722-1
"G6,B11",8549,9500,6130,3370,4461,2447,0,2450,1398,1052,1.328897338,1424,147,6,4,4,0,2,0,0,0,empty,CD-0722-1
"G6,B12",5173,5889,3836,2053,2738,1400,0,1403,913,490,1.863265306,847,1191,467,154,150,4,28,1,0.293333333,0,empty,CD-0722-1
"G6,C1",1546176,1789521,1132154,657367,805788,462345,5,462857,364717,98140,3.716293051,273111,37928,9517,2980,2948,32,639,3,0.065807327,0,hg38,CD-0722-1
"G6,C2",7874,8910,5763,3147,4080,2071,0,2081,1283,798,1.607769424,1187,1669,343,112,112,0,37,0,0.107142857,0,empty,CD-0722-1
"G6,C3",511883,568788,396202,172586,264541,126650,0,126836,91483,35353,2.587701185,71199,5395,889,266,263,3,82,1,0.034220532,0,hg38,CD-0722-1
"G6,C4",5448,5975,4234,1741,2941,1355,0,1355,898,457,1.964989059,746,1200,201,69,69,0,25,0,0.101449275,0,empty,CD-0722-1
"G6,C5",7778,8707,5806,2901,4150,2057,0,2061,1352,709,1.906911142,1163,1590,473,166,166,0,35,0,0.084337349,0,empty,CD-0722-1
"G6,C6",6431,6972,4699,2273,3393,1667,0,1670,1089,581,1.874354561,939,1233,288,103,101,2,38,1,0.01980198,0,empty,CD-0722-1
"G6,C7",8727,10106,6320,3786,4785,2682,0,2686,1650,1036,1.592664093,1611,320,32,16,16,0,10,0,0,0,empty,CD-0722-1
"G6,C8",10340,11598,7779,3819,5497,2855,1,2861,1869,992,1.884072581,1614,1655,355,163,163,0,58,0,0.085889571,0,empty,CD-0722-1
"G6,C9",6836,7609,5182,2427,3562,1740,0,1742,1119,623,1.796147673,996,1560,326,108,108,0,28,0,0,0,empty,CD-0722-1
"G6,C10",7721,8442,5793,2649,3834,1881,1,1882,1219,663,1.838612368,1036,1467,276,116,115,1,38,1,0.043478261,0,empty,CD-0722-1
"G6,C11",6518,7102,4965,2137,3464,1683,0,1683,1058,625,1.6928,954,1344,349,115,115,0,38,0,0.139130435,0,empty,CD-0722-1
"G6,C12",9544,10290,7103,3187,4861,2340,0,2343,1545,798,1.936090226,1310,1363,370,122,122,0,31,0,0.008196721,0,empty,CD-0722-1
"G6,D1",8561,9669,6218,3451,4693,2593,0,2595,1503,1092,1.376373626,1498,467,80,35,32,3,16,2,0,0,empty,CD-0722-1
"G6,D2",6872,7429,5298,2131,3547,1617,0,1619,1041,578,1.801038062,850,2758,843,240,239,1,59,1,0.079497908,0,empty,CD-0722-1
"G6,D3",6499,7282,4822,2460,3455,1771,0,1773,1213,560,2.166071429,1026,1090,310,96,92,4,35,2,0.076086957,0,empty,CD-0722-1
"G6,D4",5648,6120,4347,1773,2999,1422,0,1422,979,443,2.20993228,776,889,155,50,48,2,16,2,0,0,empty,CD-0722-1
"G6,D5",5596,6101,4193,1908,2956,1445,0,1446,946,500,1.892,798,1456,285,92,91,1,33,1,0.021978022,0,empty,CD-0722-1
"G6,D6",8601,9891,6192,3699,4579,2509,0,2511,1523,988,1.541497976,1506,1117,289,80,77,3,29,1,0.012987013,0,empty,CD-0722-1
"G6,D7",4743,5197,3586,1611,2450,1124,1,1129,732,397,1.843828715,654,1296,221,90,89,1,33,1,0.06741573,0,empty,CD-0722-1
"G6,D8",5726,6666,4175,2491,3211,1646,0,1646,1039,607,1.71169687,1009,1344,279,88,88,0,28,0,0.011363636,0,empty,CD-0722-1
"G6,D9",3176,3488,2408,1080,1721,866,0,869,562,307,1.830618893,499,940,199,74,73,1,24,1,0.01369863,0,empty,CD-0722-1
"G6,D10",5250,5911,3904,2007,2751,1383,0,1390,809,581,1.39242685,792,498,118,30,30,0,17,0,0,0,empty,CD-0722-1
"G6,D11",6416,7150,4812,2338,3405,1645,0,1646,1077,569,1.892794376,970,2125,569,255,254,1,69,1,0.098425197,0,empty,CD-0722-1
"G6,D12",7918,8641,6072,2569,4142,2059,0,2063,1321,742,1.78032345,1131,2553,647,251,249,2,68,2,0.068273092,0,empty,CD-0722-1
"G6,E1",496317,565178,371256,193922,260419,137019,1,137192,106139,31053,3.417995041,79771,72002,11248,3617,3555,62,689,3,0.044444444,0,hg38,CD-0722-1
"G6,E2",7499,8366,5495,2871,3834,1950,0,1956,1273,683,1.863836018,1119,1395,258,99,96,3,44,1,0.052083333,0,empty,CD-0722-1
"G6,E3",4910,5614,3696,1918,2596,1302,0,1302,791,511,1.547945205,760,1416,342,117,117,0,49,0,0.034188034,0,empty,CD-0722-1
"G6,E4",6930,7653,5189,2464,3660,1796,0,1799,1149,650,1.767692308,1006,1777,252,108,107,1,34,1,0.074766355,0,empty,CD-0722-1
"G6,E5",5760,6230,4455,1775,2939,1368,0,1372,915,457,2.002188184,729,1261,160,72,72,0,21,0,0.097222222,0,empty,CD-0722-1
"G6,E6",10361,11460,7729,3731,5270,2603,0,2604,1683,921,1.827361564,1507,2030,396,129,126,3,41,1,0.126984127,0,empty,CD-0722-1
"G6,E7",9605,10493,7160,3333,4903,2354,5,2364,1514,850,1.781176471,1322,2106,560,216,214,2,54,1,0.014018692,0,empty,CD-0722-1
"G6,E8",690927,786535,530792,255743,357417,183049,1,183306,146223,37083,3.943127579,104313,108728,11334,3803,3643,160,850,4,0.048860829,0,hg38,CD-0722-1
"G6,E9",4984,5865,3786,2079,2691,1389,0,1392,879,513,1.713450292,822,1267,248,102,100,2,36,1,0.13,0,empty,CD-0722-1
"G6,E10",5716,6289,4376,1913,2982,1410,0,1410,938,472,1.987288136,801,1248,378,142,137,5,36,1,0.087591241,0,empty,CD-0722-1
"G6,E11",6669,7545,4962,2583,3564,1800,0,1802,1131,671,1.685543964,1015,1461,186,74,74,0,28,0,0.418918919,0,empty,CD-0722-1
"G6,E12",7189,8106,5359,2747,3829,1913,0,1922,1229,693,1.773448773,1101,1251,197,77,74,3,28,1,0.027027027,0,empty,CD-0722-1
"G6,F1",8224,8807,6199,2608,4200,2015,1,2018,1289,729,1.768175583,1118,1551,501,162,161,1,39,1,0.043478261,0,empty,CD-0722-1
"G6,F2",6898,7534,5080,2454,3670,1790,0,1791,1149,642,1.789719626,1027,2174,412,163,160,3,53,2,0.03125,0,empty,CD-0722-1
"G6,F3",6687,7338,4998,2340,3408,1661,0,1661,1053,608,1.731907895,940,2313,491,171,171,0,54,0,0.023391813,0,empty,CD-0722-1
"G6,F4",8983,9732,6715,3017,4669,2240,2,2249,1515,734,2.064032698,1297,533,118,42,42,0,15,0,0,0,empty,CD-0722-1
"G6,F5",7345,7978,5617,2361,3765,1782,0,1786,1166,620,1.880645161,995,1198,312,112,111,1,41,1,0.027027027,0,empty,CD-0722-1
"G6,F6",7925,9109,5753,3356,4277,2259,1,2260,1504,756,1.989417989,1335,2301,687,211,207,4,57,2,0.09178744,0,empty,CD-0722-1
"G6,F7",13599,14968,9996,4972,6947,3501,0,3503,2092,1411,1.482636428,2002,2264,347,119,118,1,35,1,0.050847458,0,empty,CD-0722-1
"G6,F8",5938,6442,4475,1967,3094,1482,0,1484,935,549,1.703096539,804,186,39,13,13,0,6,0,0,0,empty,CD-0722-1
"G6,F9",6714,7239,5122,2117,3364,1584,0,1591,1091,500,2.182,869,1451,389,128,127,1,43,1,0.102362205,0,empty,CD-0722-1
"G6,F10",8155,8896,6167,2729,4208,1967,0,1968,1268,700,1.811428571,1101,1438,335,126,125,1,37,1,0.088,0,empty,CD-0722-1
"G6,F11",6703,7208,5089,2119,3351,1511,0,1514,991,523,1.894837476,832,1029,211,99,99,0,24,0,0.080808081,0,empty,CD-0722-1
"G6,F12",7471,8526,5493,3033,3905,1983,0,1984,1265,719,1.759388039,1157,52,16,10,10,0,3,0,0,0,empty,CD-0722-1
"G6,G1",8081,9093,6091,3002,4325,2126,0,2127,1300,827,1.571946796,1267,2069,444,167,166,1,56,1,0.114457831,0,empty,CD-0722-1
"G6,G2",4824,5410,3377,2033,2460,1319,0,1321,815,506,1.610671937,784,223,55,31,31,0,10,0,0.096774194,0,empty,CD-0722-1
"G6,G3",507734,583402,379831,203571,270630,143479,5,143626,112457,31169,3.607975873,84438,55244,12516,4057,4008,49,783,2,0.015219561,0,hg38,CD-0722-1
"G6,G4",15401,17597,11186,6411,8167,4505,0,4506,2786,1720,1.619767442,2603,64,20,15,15,0,7,0,0.4,0,empty,CD-0722-1
"G6,G5",5265,5820,3926,1894,2783,1377,0,1385,901,484,1.861570248,793,1039,182,70,69,1,27,1,0,0,empty,CD-0722-1
"G6,G6",7679,8383,5775,2608,3867,1870,3,1886,1201,685,1.753284672,1056,96,1,1,1,0,1,0,0,0,empty,CD-0722-1
"G6,G7",513982,579478,395112,184366,268971,133602,3,133729,102993,30736,3.350891463,76074,168826,19077,6561,6358,203,1206,6,0.045454545,0,hg38,CD-0722-1
"G6,G8",4590,5236,3387,1849,2488,1233,1,1238,755,483,1.563146998,770,1155,179,66,66,0,26,0,0.03030303,0,empty,CD-0722-1
"G6,G9",6656,7674,4894,2780,3586,1849,0,1855,1156,699,1.65379113,1097,1902,413,143,142,1,40,1,0.049295775,0,empty,CD-0722-1
"G6,G10",577237,634177,445745,188432,288268,143071,4,143239,114600,28639,4.001536366,77781,141162,16161,5540,5416,124,943,6,0.119091581,0,hg38,CD-0722-1
"G6,G11",6833,7433,5204,2229,3600,1700,0,1700,1073,627,1.711323764,951,840,241,78,78,0,25,0,0.102564103,0,empty,CD-0722-1
"G6,G12",5720,6609,4134,2475,3099,1643,1,1644,1060,584,1.815068493,1022,1456,319,101,99,2,38,1,0.050505051,0,empty,CD-0722-1
"G6,H1",5886,6416,4405,2011,3015,1431,0,1433,945,488,1.93647541,799,1013,269,106,106,0,33,0,0.226415094,0,empty,CD-0722-1
"G6,H2",6568,7278,4758,2520,3434,1760,0,1761,1112,649,1.713405239,1034,1997,516,214,214,0,59,0,0.060747664,0,empty,CD-0722-1
"G6,H3",486669,553723,368163,185560,256001,132045,1,132187,108073,24114,4.481753338,77056,17907,4251,1336,1320,16,300,2,0.027272727,0,hg38,CD-0722-1
"G6,H4",8099,9058,6054,3004,4242,2139,0,2139,1385,754,1.836870027,1273,155,30,12,12,0,8,0,0,0,empty,CD-0722-1
"G6,H5",8474,9510,6274,3236,4274,2143,0,2146,1372,774,1.772609819,1227,1171,334,118,118,0,26,0,0.118644068,0,empty,CD-0722-1
"G6,H6",442765,545198,304939,240259,256180,169799,1,169971,124731,45240,2.757095491,105154,4374,675,182,178,4,67,1,0.264044944,0,hg38,CD-0722-1
"G6,H7",6106,6632,4635,1997,3155,1462,0,1463,988,475,2.08,784,1239,395,131,131,0,39,0,0.152671756,0,empty,CD-0722-1
"G6,H8",6628,7428,4885,2543,3410,1747,0,1752,1158,594,1.949494949,1003,1289,186,91,91,0,33,0,0,0,empty,CD-0722-1
"G6,H9",5042,5380,3837,1543,2491,1112,0,1112,717,395,1.815189873,612,661,153,51,51,0,13,0,0.039215686,0,empty,CD-0722-1
"G6,H10",4681,5291,3506,1785,2552,1280,0,1281,850,431,1.972157773,755,770,144,34,29,5,14,2,0.275862069,0,empty,CD-0722-1
"G6,H11",6189,7135,4269,2866,3341,2025,0,2030,1155,875,1.32,1228,62,1,1,1,0,1,0,0,0,empty,CD-0722-1
"G6,H12",5137,5760,3765,1995,2779,1455,0,1457,935,522,1.791187739,847,1062,189,80,79,1,24,1,0.417721519,0,empty,CD-0722-1
"G7,A1",7332,8122,5322,2800,3997,2084,2,2090,1312,778,1.686375321,1242,1301,325,109,106,3,42,2,0.056603774,0,empty,CD-0722-1
"G7,A2",521512,582221,400205,182016,272875,132697,1,132842,101060,31782,3.179787301,75143,81542,10361,3633,3517,116,735,5,0.052601649,0,hg38,CD-0722-1
"G7,A3",6087,6532,4586,1946,3131,1493,0,1495,996,499,1.995991984,800,1961,569,185,183,2,38,1,0.114754098,0,empty,CD-0722-1
"G7,A4",3286664,3872930,2466090,1406840,1700582,972265,8,973312,784464,188848,4.153943913,570893,146176,31052,10355,10211,144,1770,7,0.053275879,0,hg38,CD-0722-1
"G7,A5",628615,765472,442679,322793,360573,230749,1,230969,158185,72784,2.173348538,141408,27288,1484,597,561,36,146,5,0.368983957,0,hg38,CD-0722-1
"G7,A6",14378,17210,10031,7179,8431,5132,0,5134,3627,1507,2.406768414,3110,3921,737,313,304,9,101,2,0.141447368,0,empty,CD-0722-1
"G7,A7",7305,7972,5383,2589,3858,1974,2,1976,1280,696,1.83908046,1129,1696,430,183,180,3,77,2,0.066666667,0,empty,CD-0722-1
"G7,A8",4428,5228,3320,1908,2469,1265,0,1265,804,461,1.744034707,758,2168,458,201,199,2,87,1,0.025125628,0,empty,CD-0722-1
"G7,A9",7097,8145,5319,2826,3841,1941,0,1944,1297,647,2.004636785,1124,2062,422,154,152,2,65,2,0.105263158,0,empty,CD-0722-1
"G7,A10",449418,522489,339007,183482,247192,130670,1,130824,101645,29179,3.483498406,77337,11654,1477,520,508,12,111,3,0.05511811,0,hg38,CD-0722-1
"G7,A11",6553,7049,4988,2061,3492,1615,0,1615,1090,525,2.076190476,899,2529,604,222,217,5,74,2,0.059907834,0,empty,CD-0722-1
"G7,A12",8620,9309,6562,2747,4371,2061,0,2069,1366,703,1.943100996,1104,3654,816,311,309,2,100,2,0.035598706,0,empty,CD-0722-1
"G7,B1",7748,8478,5791,2687,4063,2061,0,2069,1337,732,1.826502732,1169,1248,266,103,102,1,51,1,0.098039216,0,empty,CD-0722-1
"G7,B2",8704,9717,6003,3714,4673,2493,1,2501,1584,917,1.727371865,1491,784,87,31,31,0,16,0,0.032258065,0,empty,CD-0722-1
"G7,B3",6015,6645,4416,2229,3224,1635,1,1637,1056,581,1.817555938,914,1550,371,150,150,0,55,0,0.033333333,0,empty,CD-0722-1
"G7,B4",6961,7704,5154,2550,3735,1909,0,1919,1207,712,1.695224719,1079,1740,343,134,133,1,67,1,0.15037594,0,empty,CD-0722-1
"G7,B5",7619,4228,2350,1878,2724,1495,0,1514,988,526,1.878326996,1035,998,228,98,98,0,36,0,0.081632653,0,empty,CD-0722-1
"G7,B6",8250,9415,6182,3233,4518,2376,0,2378,1474,904,1.630530973,1372,1790,456,166,166,0,45,0,0,0,empty,CD-0722-1
"G7,B7",7937,8974,6036,2938,4380,2163,0,2163,1369,794,1.72418136,1280,1087,203,60,59,1,24,1,0,0,empty,CD-0722-1
"G7,B8",5675,6038,4305,1733,2931,1359,0,1360,939,421,2.2304038,756,1640,469,160,157,3,59,2,0.070063694,0,empty,CD-0722-1
"G7,B9",10576,11677,7944,3733,5605,2893,0,2896,1891,1005,1.88159204,1638,1356,292,106,103,3,48,2,0.067961165,0,empty,CD-0722-1
"G7,B10",5860,6017,4100,1917,3079,1525,0,1537,991,546,1.815018315,898,492,82,37,37,0,16,0,0,0,empty,CD-0722-1
"G7,B11",11608,13001,8459,4542,6250,3379,0,3382,1942,1440,1.348611111,1966,280,28,10,10,0,9,0,0,0,empty,CD-0722-1
"G7,B12",6628,7442,4896,2546,3573,1743,0,1746,1104,642,1.719626168,1021,2020,381,119,119,0,43,0,0.12605042,0,empty,CD-0722-1
"G7,C1",14388,15844,11007,4837,7325,3518,0,3518,2212,1306,1.693721286,1904,1415,319,113,113,0,38,0,0.008849558,0,empty,CD-0722-1
"G7,C2",11517,12400,8503,3897,5893,2868,0,2872,1834,1038,1.766859345,1628,2846,982,286,278,8,70,1,0.010791367,0,empty,CD-0722-1
"G7,C3",813921,1043631,567583,476048,491753,317805,0,318050,248928,69122,3.601284685,203032,8627,1632,499,495,4,145,2,0.096969697,0,hg38,CD-0722-1
"G7,C4",7414,8032,5585,2447,3891,1828,1,1830,1152,678,1.699115044,1027,1897,410,145,143,2,52,1,0.013986014,0,empty,CD-0722-1
"G7,C5",1623166,1932556,1214451,718105,887357,500524,5,501038,417877,83161,5.024915525,300166,127061,19959,6547,6420,127,1329,6,0.047975078,0,hg38,CD-0722-1
"G7,C6",9191,10256,6845,3411,5052,2487,0,2487,1671,816,2.047794118,1461,2165,602,232,231,1,77,1,0.108225108,0,empty,CD-0722-1
"G7,C7",12233,13702,8904,4798,6668,3674,0,3675,2234,1441,1.550312283,2112,622,126,40,40,0,23,0,0.125,0,empty,CD-0722-1
"G7,C8",13343,14376,10017,4359,6899,3456,0,3461,2320,1141,2.033304119,1846,3930,946,282,279,3,92,2,0.150537634,0,empty,CD-0722-1
"G7,C9",9218,10446,6913,3533,4989,2527,0,2533,1645,888,1.852477477,1496,1990,387,137,137,0,47,0,0.211678832,0,empty,CD-0722-1
"G7,C10",11232,12722,8419,4303,5773,2837,0,2838,1830,1008,1.81547619,1588,2234,466,171,167,4,53,2,0.19760479,0,empty,CD-0722-1
"G7,C11",9556,10543,7081,3462,5087,2483,0,2487,1593,894,1.781879195,1424,2817,600,209,208,1,55,1,0.091346154,0,empty,CD-0722-1
"G7,C12",13142,14409,9795,4614,6799,3291,2,3299,2138,1161,1.841515935,1891,2004,600,204,204,0,59,0,0.049019608,0,empty,CD-0722-1
"G7,D1",797955,959115,576664,382451,448350,259951,3,260232,212414,47818,4.442134761,159245,64154,9343,3137,3074,63,621,6,0.067664281,0,hg38,CD-0722-1
"G7,D2",10389,11265,8020,3245,5435,2452,0,2453,1582,871,1.8163031,1314,3146,771,290,289,1,96,1,0.141868512,0,empty,CD-0722-1
"G7,D3",8633,9314,6375,2939,4608,2262,0,2262,1498,764,1.960732984,1279,2020,321,143,140,3,59,2,0.057142857,0,empty,CD-0722-1
"G7,D4",799498,912245,611566,300679,426194,220495,4,220739,165730,55009,3.012779727,126374,79152,9354,3108,3042,66,683,6,0.039119001,0,hg38,CD-0722-1
"G7,D5",7777,8501,5960,2541,4183,1987,0,1988,1329,659,2.016691958,1104,2254,611,233,226,7,85,2,0.039823009,0,empty,CD-0722-1
"G7,D6",11609,12778,8427,4351,6058,3196,0,3203,2002,1201,1.666944213,1844,2181,458,152,146,6,48,2,0.082191781,0,empty,CD-0722-1
"G7,D7",6495,7377,4808,2569,3580,1788,0,1788,1151,637,1.806907378,1107,2710,723,244,242,2,63,2,0.070247934,0,empty,CD-0722-1
"G7,D8",7888,8612,5914,2698,4226,2067,0,2068,1391,677,2.05465288,1177,1621,344,123,123,0,50,0,0.178861789,0,empty,CD-0722-1
"G7,D9",4323,4538,3291,1247,2285,1087,2,1090,722,368,1.961956522,589,1959,300,131,130,1,68,1,0.076923077,0,empty,CD-0722-1
"G7,D10",8086,9101,5891,3210,4206,2144,0,2144,1377,767,1.795306389,1251,1205,373,120,119,1,26,1,0.092436975,0,empty,CD-0722-1
"G7,D11",8815,9824,6669,3155,4759,2291,0,2293,1494,799,1.869837297,1298,3229,691,283,280,3,108,3,0.128571429,0,empty,CD-0722-1
"G7,D12",11789,13058,8813,4245,6118,3083,1,3088,1969,1119,1.759606792,1760,4657,1155,416,412,4,126,2,0.024271845,0,empty,CD-0722-1
"G7,E1",757664,845641,578571,267070,393023,197187,2,197365,150327,47038,3.195862919,110967,107112,14006,4742,4652,90,1011,5,0.027730009,0,hg38,CD-0722-1
"G7,E2",9814,10835,7333,3502,5316,2666,0,2667,1719,948,1.813291139,1542,2207,487,173,169,4,61,2,0.059171598,0,empty,CD-0722-1
"G7,E3",6936,7517,5219,2298,3609,1704,0,1707,1143,564,2.026595745,943,3056,547,207,204,3,86,3,0.088235294,0,empty,CD-0722-1
"G7,E4",9468,10547,6920,3627,5142,2621,0,2627,1687,940,1.794680851,1531,2912,685,285,282,3,111,2,0.070921986,0,empty,CD-0722-1
"G7,E5",8431,9204,6535,2669,4403,2018,0,2023,1307,716,1.825418994,1149,1544,381,141,141,0,58,0,0.014184397,0,empty,CD-0722-1
"G7,E6",14157,15778,10657,5121,7389,3678,1,3688,2293,1395,1.643727599,2096,3828,1073,358,356,2,73,1,0.056179775,0,empty,CD-0722-1
"G7,E7",663807,847236,452624,394612,401312,279294,5,279517,215928,63589,3.395681643,173829,18750,1845,633,618,15,168,4,0.286407767,0,hg38,CD-0722-1
"G7,E8",10679,11755,8195,3560,5582,2665,0,2667,1762,905,1.946961326,1461,2657,785,286,284,2,81,1,0.038732394,0,empty,CD-0722-1
"G7,E9",6281,6647,4686,1961,3202,1505,0,1508,994,514,1.93385214,784,2691,576,224,217,7,97,3,0.059907834,0,empty,CD-0722-1
"G7,E10",9234,9963,6958,3005,4796,2313,0,2317,1509,808,1.867574257,1265,2285,525,187,182,5,59,2,0.197802198,0,empty,CD-0722-1
"G7,E11",9458,10406,7029,3377,4933,2464,0,2466,1581,885,1.786440678,1390,2234,453,160,159,1,60,1,0.031446541,0,empty,CD-0722-1
"G7,E12",9776,11030,7228,3802,5269,2662,0,2666,1686,980,1.720408163,1624,2446,509,207,206,1,66,1,0.053398058,0,empty,CD-0722-1
"G7,F1",11667,12777,8767,4010,6224,3087,1,3098,1930,1168,1.65239726,1779,2438,629,214,209,5,64,2,0.110047847,0,empty,CD-0722-1
"G7,F2",10011,11132,7476,3656,5289,2620,0,2628,1722,906,1.900662252,1483,3701,831,340,338,2,108,1,0.100591716,0,empty,CD-0722-1
"G7,F3",8990,9668,6635,3033,4709,2268,0,2268,1492,776,1.922680412,1346,3563,934,321,313,8,104,2,0.099041534,0,empty,CD-0722-1
"G7,F4",14038,14682,10415,4267,7055,3309,2,3320,2060,1260,1.634920635,1847,504,111,63,62,1,32,1,0.129032258,0,empty,CD-0722-1
"G7,F5",11710,12712,8957,3755,6053,2899,0,2905,1872,1033,1.812197483,1544,2424,454,162,160,2,58,1,0.01875,0,empty,CD-0722-1
"G7,F6",713022,839842,525363,314479,392552,217933,3,218167,172859,45308,3.815198199,131103,166533,29701,10138,9959,179,1618,6,0.063560598,0,hg38,CD-0722-1
"G7,F7",2044723,2351378,1549789,801589,1064470,572219,5,572838,442854,129984,3.406988552,334121,108546,14790,4814,4689,125,1016,5,0.043079548,0,hg38,CD-0722-1
"G7,F8",13093,14306,9819,4487,6806,3344,0,3352,2139,1213,1.763396538,1859,306,39,16,16,0,11,0,0,0,empty,CD-0722-1
"G7,F9",8865,9772,6652,3120,4576,2191,0,2197,1413,784,1.802295918,1202,3231,606,242,241,1,77,1,0.10373444,0,empty,CD-0722-1
"G7,F10",12305,13466,9485,3981,6290,2859,0,2863,1785,1078,1.655844156,1547,2523,655,197,196,1,47,1,0.132653061,0,empty,CD-0722-1
"G7,F11",9313,9988,7087,2901,4721,2196,0,2202,1420,782,1.815856777,1209,2250,529,140,138,2,52,1,0.072463768,0,empty,CD-0722-1
"G7,F12",10498,11474,7878,3596,5349,2602,0,2607,1679,928,1.809267241,1492,227,25,10,10,0,10,0,0.1,0,empty,CD-0722-1
"G7,G1",938231,1130461,684211,446250,526948,309579,1,309862,247070,62792,3.934736909,188703,32829,10753,3238,3228,10,792,2,0.055452292,0,hg38,CD-0722-1
"G7,G2",6612,7010,4801,2209,3456,1765,0,1765,1130,635,1.779527559,972,486,89,43,43,0,18,0,0.023255814,0,empty,CD-0722-1
"G7,G3",2763610,3375501,1984104,1391397,1513879,935709,8,936530,709542,226988,3.125900929,575809,371134,69730,22902,22572,330,2994,6,0.064061669,0,hg38,CD-0722-1
"G7,G4",21730,24080,15822,8258,11557,6239,0,6252,3783,2469,1.532199271,3558,244,37,22,22,0,15,0,0.045454545,0,empty,CD-0722-1
"G7,G5",8046,9122,5978,3144,4415,2267,0,2270,1461,809,1.805933251,1329,2057,377,126,124,2,55,2,0.10483871,0,empty,CD-0722-1
"G7,G6",10898,11740,8123,3617,5630,2692,0,2698,1746,952,1.834033613,1505,299,79,24,24,0,13,0,0.083333333,0,empty,CD-0722-1
"G7,G7",797893,924944,596592,328352,430900,234037,1,234306,181592,52714,3.44485336,137643,146430,23534,7797,7628,169,1376,6,0.051651809,0,hg38,CD-0722-1
"G7,G8",6474,6877,4802,2075,3423,1709,0,1712,1104,608,1.815789474,930,1991,469,147,146,1,50,1,0.034246575,0,empty,CD-0722-1
"G7,G9",7710,8546,5826,2720,4135,2010,0,2015,1296,719,1.802503477,1143,2747,750,261,257,4,78,2,0.027237354,0,empty,CD-0722-1
"G7,G10",9203,10438,6915,3523,5070,2550,0,2553,1615,938,1.721748401,1484,2823,572,232,232,0,98,0,0.107758621,0,empty,CD-0722-1
"G7,G11",9509,10236,7288,2948,4967,2324,0,2330,1501,829,1.810615199,1274,1769,366,161,156,5,72,1,0.070512821,0,empty,CD-0722-1
"G7,G12",7917,8650,5907,2743,4168,2081,0,2081,1302,779,1.671373556,1159,2116,479,163,160,3,62,2,0,0,empty,CD-0722-1
"G7,H1",7848,8784,5858,2926,4219,2054,0,2054,1336,718,1.860724234,1191,1507,528,177,176,1,48,1,0.0625,0,empty,CD-0722-1
"G7,H2",9331,10337,6874,3463,4797,2309,3,2313,1485,828,1.793478261,1328,2407,625,207,205,2,69,2,0.029268293,0,empty,CD-0722-1
"G7,H3",7151,8009,5352,2657,3811,1934,0,1939,1293,646,2.001547988,1097,1464,310,127,127,0,54,0,0.204724409,0,empty,CD-0722-1
"G7,H4",11793,12846,8681,4165,5994,2917,3,2927,1872,1055,1.774407583,1629,239,43,20,20,0,14,0,0,0,empty,CD-0722-1
"G7,H5",12192,13156,9065,4091,6125,2965,3,2970,1899,1071,1.773109244,1598,2689,616,211,206,5,59,2,0.04368932,0,empty,CD-0722-1
"G7,H6",657273,797573,473006,324567,372461,216637,0,216860,179502,37358,4.80491461,133928,312042,49001,16146,15801,345,2359,10,0.072463768,0,hg38,CD-0722-1
"G7,H7",668260,776464,493169,283295,364429,197902,13,198171,156801,41370,3.790210297,118154,193139,30472,9991,9763,228,1603,8,0.084707569,0,hg38,CD-0722-1
"G7,H8",8963,9887,6691,3196,4737,2424,0,2426,1572,854,1.840749415,1363,2501,632,239,233,6,61,2,0.103004292,0,empty,CD-0722-1
"G7,H9",6945,7605,5267,2338,3619,1676,0,1676,1121,555,2.01981982,917,1608,436,124,119,5,37,1,0,0,empty,CD-0722-1
"G7,H10",6475,7185,4712,2473,3389,1671,0,1673,1055,618,1.707119741,994,1594,487,190,183,7,52,2,0.180327869,0,empty,CD-0722-1
"G7,H11",8094,9279,5678,3601,4497,2690,0,2691,1515,1176,1.288265306,1609,85,19,8,8,0,1,0,0,0,empty,CD-0722-1
"G7,H12",7003,7606,5169,2437,3703,1883,0,1893,1267,626,2.023961661,1051,1736,307,96,94,2,49,1,0.159574468,0,empty,CD-0722-1
"G8,A1",7591,8311,5580,2731,3989,2019,0,2021,1303,718,1.814763231,1159,1779,307,106,106,0,44,0,0.08490566,0,empty,CD-0722-1
"G8,A2",2250349,2563858,1720250,843608,1136410,601835,7,602544,472867,129677,3.646498608,343634,318886,44752,15250,14918,332,2329,7,0.054900121,0,hg38,CD-0722-1
"G8,A3",6889,7527,5151,2376,3564,1715,0,1716,1089,627,1.736842105,990,1273,302,93,92,1,34,1,0,0,empty,CD-0722-1
"G8,A4",1954270,2266738,1502772,763966,1002561,536696,3,537276,438156,99120,4.420460048,309546,87754,10598,3778,3672,106,711,3,0.111383442,0,hg38,CD-0722-1
"G8,A5",10708,11716,7874,3842,5608,2800,0,2802,1773,1029,1.72303207,1615,2265,437,167,164,3,55,1,0.115853659,0,empty,CD-0722-1
"G8,A6",8766,10027,6619,3408,4798,2561,0,2562,1667,895,1.862569832,1443,2729,575,223,220,3,77,3,0.1,0,empty,CD-0722-1
"G8,A7",7683,8573,5752,2821,4095,2080,1,2083,1353,730,1.853424658,1189,1279,186,74,73,1,36,1,0.02739726,0,empty,CD-0722-1
"G8,A8",4438,4980,3354,1626,2427,1222,0,1223,859,364,2.35989011,691,1811,475,147,144,3,52,1,0.027777778,0,empty,CD-0722-1
"G8,A9",8520,9637,6454,3183,4518,2175,3,2180,1480,700,2.114285714,1239,4015,596,256,252,4,61,1,0.01984127,0,empty,CD-0722-1
"G8,A10",8227,8966,6335,2631,4392,2134,1,2137,1346,791,1.701643489,1173,373,67,34,34,0,16,0,0,0,empty,CD-0722-1
"G8,A11",7366,7779,5487,2292,3880,1821,3,1824,1224,600,2.04,1020,1703,439,165,162,3,54,2,0.030864198,0,empty,CD-0722-1
"G8,A12",10088,10867,7682,3185,5009,2339,1,2345,1577,768,2.053385417,1275,3502,964,309,308,1,70,1,0.133116883,0,empty,CD-0722-1
"G8,B1",8224,9336,6087,3249,4449,2327,0,2327,1450,877,1.65336374,1389,1166,256,95,95,0,40,0,0.021052632,0,empty,CD-0722-1
"G8,B2",9307,9990,6386,3604,4751,2558,0,2565,1542,1023,1.507331378,1538,671,80,41,40,1,19,1,0.05,0,empty,CD-0722-1
"G8,B3",6872,7837,5010,2827,3746,1900,0,1907,1219,688,1.771802326,1121,1274,261,77,76,1,30,1,0.026315789,0,empty,CD-0722-1
"G8,B4",247916,268723,196439,72284,131376,57215,6,57290,39267,18023,2.178716085,31587,11040,3424,1147,1135,12,263,2,0.024669604,0,hg38,CD-0722-1
"G8,B5",8017,4428,2570,1858,2892,1560,0,1569,1052,517,2.034816248,1030,878,232,77,77,0,35,0,0.077922078,0,empty,CD-0722-1
"G8,B6",8714,9871,6388,3483,4803,2569,0,2571,1585,986,1.607505071,1515,1815,429,130,129,1,35,1,0.170542636,0,empty,CD-0722-1
"G8,B7",8781,9514,6651,2863,4471,2096,0,2097,1348,749,1.799732977,1148,1045,165,65,65,0,25,0,0.046153846,0,empty,CD-0722-1
"G8,B8",6422,6976,4961,2015,3257,1533,0,1535,966,569,1.69771529,850,1127,223,111,111,0,34,0,0.018018018,0,empty,CD-0722-1
"G8,B9",11191,12151,8248,3903,5748,2938,1,2944,1849,1095,1.688584475,1657,982,234,77,74,3,32,1,0.013513514,0,empty,CD-0722-1
"G8,B10",5771,6072,4136,1936,3064,1522,1,1523,905,618,1.464401294,885,530,51,20,20,0,8,0,0,0,empty,CD-0722-1
"G8,B11",12106,13510,8908,4602,6338,3484,0,3486,2024,1462,1.384404925,1976,227,14,12,11,1,9,1,0,0,empty,CD-0722-1
"G8,B12",774754,946370,556795,389575,439642,260724,5,260973,206979,53994,3.833370374,161640,37988,8997,2761,2721,40,571,3,0.049246601,0,hg38,CD-0722-1
"G8,C1",15515,16614,11844,4770,7754,3663,0,3665,2319,1346,1.722882615,1990,1000,186,80,79,1,27,1,0.189873418,0,empty,CD-0722-1
"G8,C2",12039,13335,8864,4471,6249,3128,1,3131,2077,1054,1.970588235,1800,1872,491,171,171,0,49,0,0.070175439,0,empty,CD-0722-1
"G8,C3",1838180,2190715,1356123,834592,987272,563161,10,563798,448299,115499,3.881410229,339951,90363,10283,3446,3366,80,744,5,0.036838978,0,hg38,CD-0722-1
"G8,C4",7880,8328,6008,2320,4133,1943,0,1946,1240,706,1.756373938,1071,1841,398,154,149,5,45,1,0.033557047,0,empty,CD-0722-1
"G8,C5",11660,13241,8832,4409,6356,3240,0,3244,2172,1072,2.026119403,1962,2093,457,173,170,3,55,2,0.076470588,0,empty,CD-0722-1
"G8,C6",9868,10694,7303,3391,5262,2672,0,2681,1729,952,1.816176471,1512,1902,612,209,208,1,72,1,0.052884615,0,empty,CD-0722-1
"G8,C7",13556,15737,9852,5885,7294,3920,1,3925,2400,1525,1.573770492,2322,1657,250,108,108,0,44,0,0.009259259,0,empty,CD-0722-1
"G8,C8",14694,16325,10966,5359,7841,3961,2,3966,2613,1353,1.931263858,2305,3427,675,247,243,4,90,2,0.020576132,0,empty,CD-0722-1
"G8,C9",10595,12170,7966,4204,5666,2894,0,2898,1828,1070,1.708411215,1691,1580,445,162,161,1,58,1,0.118012422,0,empty,CD-0722-1
"G8,C10",783471,891769,591506,300263,406212,210604,2,210899,163836,47063,3.481206043,121924,95710,16994,5719,5618,101,1042,3,0.03737985,0,hg38,CD-0722-1
"G8,C11",10371,11240,7745,3495,5371,2593,0,2597,1707,890,1.917977528,1473,2019,540,153,151,2,48,1,0.086092715,0,empty,CD-0722-1
"G8,C12",14257,15628,10643,4985,7494,3700,0,3707,2466,1241,1.987107172,2141,1598,401,166,165,1,52,1,0.024242424,0,empty,CD-0722-1
"G8,D1",633574,788746,431238,357508,367840,247134,3,247364,180423,66941,2.69525403,154180,2197,240,89,83,6,39,1,0.060240964,0,empty,CD-0722-1
"G8,D2",10817,11759,8278,3481,5566,2645,0,2647,1690,957,1.765935214,1453,2965,994,291,290,1,86,1,0.062068966,0,empty,CD-0722-1
"G8,D3",9141,10101,6656,3445,4944,2531,5,2538,1678,860,1.951162791,1489,1109,187,71,71,0,30,0,0.028169014,0,empty,CD-0722-1
"G8,D4",7205,8129,5507,2622,3840,1901,0,1904,1222,682,1.791788856,1100,1272,197,79,79,0,37,0,0.063291139,0,empty,CD-0722-1
"G8,D5",8310,9379,6192,3187,4514,2290,0,2292,1520,772,1.968911917,1343,1639,321,156,153,3,54,1,0.045751634,0,empty,CD-0722-1
"G8,D6",12684,14579,9073,5506,6874,3789,0,3796,2310,1486,1.554508748,2289,2003,469,157,154,3,48,2,0.077922078,0,empty,CD-0722-1
"G8,D7",6960,7716,5413,2303,3619,1695,0,1695,1108,587,1.887563884,907,2045,543,171,170,1,52,1,0.064705882,0,empty,CD-0722-1
"G8,D8",8625,9516,6527,2989,4509,2213,1,2216,1454,762,1.908136483,1251,1377,336,130,130,0,52,0,0.030769231,0,empty,CD-0722-1
"G8,D9",480131,543773,365026,178747,252931,128150,4,128313,97638,30675,3.182982885,73978,83566,12157,3895,3782,113,739,5,0.09386568,0,hg38,CD-0722-1
"G8,D10",8340,9495,6182,3313,4431,2252,0,2254,1403,851,1.648648649,1325,845,120,51,51,0,16,0,0.019607843,0,empty,CD-0722-1
"G8,D11",687242,791482,516850,274632,364689,192756,0,192961,147627,45334,3.256430052,112931,153714,23520,7753,7595,158,1355,6,0.059381172,0,hg38,CD-0722-1
"G8,D12",11896,12901,8884,4017,6053,2926,0,2931,1901,1030,1.845631068,1605,3755,817,274,272,2,89,1,0.1875,0,empty,CD-0722-1
"G8,E1",907629,1133758,607953,525805,522866,359976,3,360285,259791,100494,2.585139411,224019,4830,1366,400,390,10,181,2,0.064102564,0,hg38,CD-0722-1
"G8,E2",10838,12000,7831,4169,5699,2921,0,2921,1863,1058,1.760869565,1698,1848,509,168,168,0,53,0,0.208333333,0,empty,CD-0722-1
"G8,E3",7587,8611,5750,2861,4075,2004,0,2004,1231,773,1.592496766,1173,2216,374,151,149,2,62,2,0.020134228,0,empty,CD-0722-1
"G8,E4",9790,10886,7340,3546,5205,2545,0,2550,1661,889,1.868391451,1445,2856,788,286,283,3,86,1,0.070671378,0,empty,CD-0722-1
"G8,E5",9217,10299,7041,3258,4846,2274,0,2274,1522,752,2.02393617,1263,1277,387,104,104,0,31,0,0.067307692,0,empty,CD-0722-1
"G8,E6",23168,25639,17149,8490,11764,5903,0,5911,4208,1703,2.470933647,3357,7924,1939,589,582,7,149,2,0.080756014,0,empty,CD-0722-1
"G8,E7",13620,14670,10516,4154,6895,3188,0,3188,2173,1015,2.1408867,1672,2980,797,264,262,2,73,1,0.030534351,0,empty,CD-0722-1
"G8,E8",861211,941742,674412,267330,431727,201868,4,202135,156611,45524,3.440185397,110312,65289,12122,3828,3747,81,728,3,0.039498265,0,hg38,CD-0722-1
"G8,E9",6845,7591,4964,2627,3586,1783,1,1790,1210,580,2.086206897,1051,2116,442,140,138,2,62,1,0.057971014,0,empty,CD-0722-1
"G8,E10",8323,9265,6362,2903,4407,2072,0,2075,1357,718,1.889972145,1184,1887,531,191,191,0,56,0,0.041884817,0,empty,CD-0722-1
"G8,E11",9848,10796,7262,3534,5170,2557,0,2557,1639,918,1.78540305,1489,2077,450,160,159,1,57,1,0.169811321,0,empty,CD-0722-1
"G8,E12",11460,13113,8447,4666,6188,3079,0,3088,1937,1151,1.682884448,1860,1756,462,182,179,3,54,2,0.089385475,0,empty,CD-0722-1
"G8,F1",12850,13700,9558,4142,6498,3061,0,3063,1942,1121,1.732381802,1698,2878,557,163,163,0,55,0,0.042944785,0,empty,CD-0722-1
"G8,F2",11558,12815,8595,4220,6246,3142,1,3148,2094,1054,1.986717268,1809,2861,693,267,265,2,92,1,0.01509434,0,empty,CD-0722-1
"G8,F3",9677,10326,7328,2998,5096,2449,0,2453,1554,899,1.728587319,1391,2285,465,177,177,0,74,0,0.101694915,0,empty,CD-0722-1
"G8,F4",14925,16342,11245,5097,7657,3618,0,3624,2392,1232,1.941558442,2076,756,84,28,28,0,17,0,0,0,empty,CD-0722-1
"G8,F5",904864,1004664,692357,312307,454338,221998,2,222277,168114,54163,3.103853184,125773,106432,13724,4562,4436,126,854,7,0.059738503,0,hg38,CD-0722-1
"G8,F6",11333,12801,8231,4570,6090,3171,3,3176,2046,1130,1.810619469,1839,2537,531,215,214,1,75,1,0.056074766,0,empty,CD-0722-1
"G8,F7",13500,14976,10174,4802,7216,3581,0,3587,2295,1292,1.776315789,2040,1152,188,95,93,2,40,2,0.11827957,0,empty,CD-0722-1
"G8,F8",11816,12641,8913,3728,6006,2851,0,2854,1941,913,2.125958379,1568,200,62,27,26,1,9,1,0,0,empty,CD-0722-1
"G8,F9",9984,11206,7561,3645,5239,2544,0,2544,1695,849,1.996466431,1458,3089,746,265,262,3,72,2,0.091603053,0,empty,CD-0722-1
"G8,F10",13172,14495,10122,4373,6771,3148,5,3159,2071,1088,1.903492647,1756,1536,411,155,155,0,49,0,0.012903226,0,empty,CD-0722-1
"G8,F11",9741,10616,7288,3328,5017,2398,0,2398,1619,779,2.07830552,1342,1813,267,108,108,0,32,0,0.018518519,0,empty,CD-0722-1
"G8,F12",10575,11703,7884,3819,5544,2705,0,2709,1769,940,1.881914894,1580,104,13,10,10,0,5,0,0,0,empty,CD-0722-1
"G8,G1",12644,13955,9551,4404,6635,3189,0,3194,2090,1104,1.893115942,1821,2920,580,222,220,2,85,2,0.031818182,0,empty,CD-0722-1
"G8,G2",8057,8868,5739,3129,4221,2213,0,2217,1376,841,1.636147444,1267,367,125,40,40,0,17,0,0.05,0,empty,CD-0722-1
"G8,G3",14898,15948,11132,4816,7631,3805,0,3808,2428,1380,1.75942029,2092,3053,1019,344,343,1,94,1,0.166180758,0,empty,CD-0722-1
"G8,G4",22746,25955,16513,9442,12249,6839,0,6844,4162,2682,1.551826995,3929,134,34,23,21,2,18,1,0.047619048,0,empty,CD-0722-1
"G8,G5",8026,9019,6026,2993,4218,2055,0,2055,1362,693,1.965367965,1160,1476,237,93,91,2,45,1,0.032967033,0,empty,CD-0722-1
"G8,G6",11987,12729,9201,3528,6009,2825,0,2827,1947,880,2.2125,1510,144,24,8,8,0,6,0,0,0,empty,CD-0722-1
"G8,G7",9997,11066,7565,3501,5166,2442,2,2447,1625,822,1.976885645,1418,3063,809,239,232,7,66,2,0.081896552,0,empty,CD-0722-1
"G8,G8",6746,7314,4960,2354,3458,1676,0,1678,1116,562,1.985765125,943,1609,349,159,157,2,53,2,0,0,empty,CD-0722-1
"G8,G9",8284,8911,6215,2696,4244,2040,0,2041,1332,709,1.878702398,1133,1649,283,121,117,4,49,1,0.05982906,0,empty,CD-0722-1
"G8,G10",749530,867850,562272,305578,400052,214211,6,214450,163880,50570,3.240656516,125667,143392,18442,6117,5926,191,1134,5,0.062605467,0,hg38,CD-0722-1
"G8,G11",10381,11422,7823,3599,5479,2731,0,2735,1808,927,1.950377562,1502,1660,476,177,176,1,59,1,0.005681818,0,empty,CD-0722-1
"G8,G12",8398,9492,6225,3267,4477,2235,0,2240,1394,846,1.647754137,1327,2212,556,199,196,3,59,1,0.056122449,0,empty,CD-0722-1
"G8,H1",8437,9248,6159,3089,4510,2228,0,2229,1448,781,1.854033291,1311,1135,195,74,73,1,32,1,0,0,empty,CD-0722-1
"G8,H2",10380,11503,7787,3716,5494,2789,0,2794,1737,1057,1.64333018,1605,2197,556,204,203,1,61,1,0.078817734,0,empty,CD-0722-1
"G8,H3",8092,8842,6010,2832,4265,2152,0,2152,1386,766,1.809399478,1243,2283,594,187,183,4,54,1,0.005464481,0,empty,CD-0722-1
"G8,H4",14917,15655,10992,4663,7463,3712,0,3720,2278,1442,1.579750347,2024,145,19,12,12,0,9,0,0.166666667,0,empty,CD-0722-1
"G8,H5",13234,15105,9749,5356,6845,3514,0,3516,2179,1337,1.629768138,2080,1792,373,122,120,2,41,2,0.083333333,0,empty,CD-0722-1
"G8,H6",7362,8284,5410,2874,3887,1956,0,1958,1262,696,1.813218391,1142,1897,445,161,158,3,47,1,0.14556962,0,empty,CD-0722-1
"G8,H7",1215951,1353188,927185,426003,623469,310246,31,310600,234037,76563,3.056789833,177912,177955,30394,9612,9446,166,1592,5,0.044886725,0,hg38,CD-0722-1
"G8,H8",9686,10898,7203,3695,5008,2574,0,2577,1593,984,1.618902439,1495,2285,514,196,196,0,64,0,0.107142857,0,empty,CD-0722-1
"G8,H9",8360,9120,6404,2716,4337,1971,0,1976,1334,642,2.07788162,1068,1038,238,104,104,0,31,0,0.182692308,0,empty,CD-0722-1
"G8,H10",6889,7801,5151,2650,3684,1802,0,1805,1182,623,1.897271268,1068,1313,290,93,92,1,32,1,0.043478261,0,empty,CD-0722-1
"G8,H11",8684,10103,6189,3914,4842,2826,0,2833,1649,1184,1.392736486,1736,88,2,2,2,0,2,0,0,0,empty,CD-0722-1
"G8,H12",7773,8662,5732,2930,4073,2145,0,2145,1424,721,1.975034674,1216,1615,353,129,125,4,42,1,0.024,0,empty,CD-0722-1
"G9,A1",6689,7316,4948,2368,3479,1770,0,1775,1141,634,1.799684543,994,1361,313,125,123,2,28,2,0.235772358,0,empty,CD-0722-1
"G9,A2",9498,10604,7023,3581,5072,2653,0,2653,1625,1028,1.5807393,1527,2203,693,220,220,0,73,0,0.031818182,0,empty,CD-0722-1
"G9,A3",5899,6586,4315,2271,3005,1509,0,1511,941,570,1.650877193,876,1124,296,135,134,1,31,1,0.201492537,0,empty,CD-0722-1
"G9,A4",11251,12547,8538,4009,5913,2888,0,2891,1838,1053,1.745489079,1606,887,166,55,54,1,32,1,0.074074074,0,empty,CD-0722-1
"G9,A5",9224,10208,6811,3397,4861,2362,0,2365,1505,860,1.75,1350,1933,413,155,152,3,48,2,0.072368421,0,empty,CD-0722-1
"G9,A6",439293,529527,326030,203497,246440,138691,0,138819,110976,27843,3.985777395,83658,92931,14766,5536,5434,102,1058,5,0.046742731,0,hg38,CD-0722-1
"G9,A7",6556,7433,4889,2544,3523,1780,0,1782,1128,654,1.724770642,1038,1525,387,151,151,0,50,0,0.059602649,0,empty,CD-0722-1
"G9,A8",4078,4689,3031,1658,2195,1091,0,1096,727,369,1.970189702,641,1708,233,111,110,1,44,1,0.3,0,empty,CD-0722-1
"G9,A9",7073,8080,5310,2770,3801,1947,0,1947,1203,744,1.616935484,1144,2047,510,182,177,5,61,2,0.039548023,0,empty,CD-0722-1
"G9,A10",956339,1128835,716514,412321,519596,286690,3,286941,226177,60764,3.722220394,169827,49280,6296,2226,2156,70,490,3,0.054267161,0,hg38,CD-0722-1
"G9,A11",6494,7139,4964,2175,3364,1545,1,1549,1051,498,2.110441767,850,1719,380,163,162,1,61,1,0.024691358,0,empty,CD-0722-1
"G9,A12",7940,8503,6032,2471,3922,1828,0,1833,1161,672,1.727678571,969,3230,703,232,230,2,75,2,0.047826087,0,empty,CD-0722-1
"G9,B1",7662,8453,5704,2749,3860,1942,0,1943,1194,749,1.594125501,1066,1782,392,152,151,1,60,1,0.013245033,0,empty,CD-0722-1
"G9,B2",8195,9053,5613,3440,4353,2342,0,2343,1439,904,1.591814159,1409,675,96,47,47,0,16,0,0.106382979,0,empty,CD-0722-1
"G9,B3",5695,6251,4236,2015,3013,1477,3,1482,963,519,1.855491329,882,1455,322,126,126,0,32,0,0.142857143,0,empty,CD-0722-1
"G9,B4",6454,7120,4746,2374,3443,1789,2,1795,1097,698,1.571633238,1031,1723,447,163,163,0,55,0,0.134969325,0,empty,CD-0722-1
"G9,B5",7249,3997,2158,1839,2555,1445,0,1454,950,504,1.884920635,989,936,203,83,83,0,28,0,0,0,empty,CD-0722-1
"G9,B6",7583,8462,5498,2964,4024,2118,0,2121,1368,753,1.816733068,1193,1377,293,144,144,0,41,0,0.118055556,0,empty,CD-0722-1
"G9,B7",7680,8573,5800,2773,4088,1989,0,1992,1220,772,1.580310881,1126,1255,344,128,127,1,36,1,0.125984252,0,empty,CD-0722-1
"G9,B8",5316,5731,4057,1674,2689,1227,0,1227,803,424,1.893867925,661,1263,262,102,99,3,43,2,0.131313131,0,empty,CD-0722-1
"G9,B9",9722,10668,7144,3524,5103,2626,1,2628,1638,990,1.654545455,1478,1040,248,82,82,0,35,0,0.024390244,0,empty,CD-0722-1
"G9,B10",5147,5492,3678,1814,2755,1345,0,1348,852,496,1.717741935,798,587,110,38,37,1,16,1,0.081081081,0,empty,CD-0722-1
"G9,B11",12259,14097,8907,5190,6669,3713,0,3714,2301,1413,1.628450106,2203,238,61,25,25,0,11,0,0,0,empty,CD-0722-1
"G9,B12",592409,695917,436339,259578,328671,181788,4,181980,139978,42002,3.332650826,109530,171510,19334,7019,6812,207,1204,6,0.065619495,0,hg38,CD-0722-1
"G9,C1",14671,16306,11124,5182,7794,4009,0,4018,2696,1322,2.039334342,2306,1030,163,66,61,5,24,1,0,0,empty,CD-0722-1
"G9,C2",10731,12304,7921,4383,5716,2972,0,2976,1941,1035,1.875362319,1747,1864,469,187,186,1,53,1,0.086021505,0,empty,CD-0722-1
"G9,C3",833637,974436,628797,345639,447522,238339,5,238646,179303,59343,3.021468412,140428,36488,5935,2181,2159,22,476,3,0.053265401,0,hg38,CD-0722-1
"G9,C4",6793,7468,5191,2277,3605,1719,0,1721,1119,602,1.858803987,981,1712,375,129,123,6,54,2,0.032520325,0,empty,CD-0722-1
"G9,C5",11515,12724,8652,4072,6036,2990,0,2992,2132,860,2.479069767,1709,2002,338,145,138,7,57,1,0.043478261,0,empty,CD-0722-1
"G9,C6",797254,907764,604281,303483,427657,219120,7,219400,166842,52558,3.174435861,127779,145170,18306,6591,6419,172,1149,5,0.057797165,0,hg38,CD-0722-1
"G9,C7",11370,12681,8303,4378,5935,3161,0,3164,1985,1179,1.683630195,1827,606,208,78,78,0,25,0,0.012820513,0,empty,CD-0722-1
"G9,C8",12999,14633,9580,5053,7080,3795,0,3801,2505,1296,1.93287037,2220,3018,773,279,278,1,94,1,0.071942446,0,empty,CD-0722-1
"G9,C9",8151,9258,6108,3150,4429,2254,0,2254,1437,817,1.758873929,1306,1530,260,111,110,1,44,1,0.072727273,0,empty,CD-0722-1
"G9,C10",10319,11053,7812,3241,5203,2456,3,2467,1595,872,1.82912844,1335,1949,458,168,166,2,57,1,0.042168675,0,empty,CD-0722-1
"G9,C11",738287,866388,547397,318991,399637,216467,2,216662,172110,44552,3.863126235,130708,126484,18660,6705,6570,135,1153,5,0.097564688,0,hg38,CD-0722-1
"G9,C12",675614,756555,513695,242860,347127,173548,5,173776,130082,43694,2.977113563,100166,106689,13008,4692,4559,133,928,5,0.04386927,0,hg38,CD-0722-1
"G9,D1",11062,12473,8194,4279,5900,3140,0,3142,1952,1190,1.640336134,1808,1109,220,75,73,2,30,1,0.04109589,0,empty,CD-0722-1
"G9,D2",9191,9891,6955,2936,4705,2182,0,2190,1416,774,1.829457364,1199,3205,958,319,317,2,93,2,0.041009464,0,empty,CD-0722-1
"G9,D3",1934835,2323071,1427956,895115,1049263,598790,4,599357,495919,103438,4.794359906,364264,106910,11809,4151,4042,109,938,5,0.061603167,0,hg38,CD-0722-1
"G9,D4",5966,6789,4503,2286,3321,1607,0,1610,1012,598,1.692307692,941,1446,221,113,109,4,47,1,0.036697248,0,empty,CD-0722-1
"G9,D5",7020,7669,5255,2414,3820,1937,3,1941,1283,658,1.949848024,1099,2082,569,225,223,2,74,2,0.062780269,0,empty,CD-0722-1
"G9,D6",10577,11741,7593,4148,5637,3059,0,3064,1835,1229,1.493083808,1791,1906,373,136,136,0,51,0,0.036764706,0,empty,CD-0722-1
"G9,D7",1230147,1418312,921634,496678,646562,348879,2,349181,275923,73258,3.766455541,203857,257917,38621,13921,13634,287,2174,7,0.052662461,0,hg38,CD-0722-1
"G9,D8",752747,909590,547656,361934,421242,243254,3,243492,190235,53257,3.572018702,150159,68421,10319,3576,3510,66,807,5,0.036182336,0,hg38,CD-0722-1
"G9,D9",3867,4057,2841,1216,2006,992,0,994,623,371,1.679245283,562,1708,282,135,132,3,52,2,0.174242424,0,empty,CD-0722-1
"G9,D10",6839,7668,5012,2656,3555,1784,0,1787,1089,698,1.56017192,1016,716,213,78,78,0,20,0,0.179487179,0,empty,CD-0722-1
"G9,D11",8204,9352,6177,3175,4421,2155,0,2157,1384,773,1.790426908,1255,2976,714,304,298,6,110,1,0.043624161,0,empty,CD-0722-1
"G9,D12",10199,10982,7827,3155,5256,2507,0,2511,1695,816,2.077205882,1360,3454,871,343,342,1,122,1,0.052631579,0,empty,CD-0722-1
"G9,E1",741747,867012,549083,317929,396895,219492,0,219779,173534,46245,3.752492161,129715,59771,14177,4947,4883,64,1020,4,0.052017203,0,hg38,CD-0722-1
"G9,E2",9926,10742,7358,3384,5087,2544,0,2547,1657,890,1.861797753,1451,2270,502,182,176,6,54,2,0.1875,0,empty,CD-0722-1
"G9,E3",6475,7329,4938,2391,3392,1605,0,1606,1062,544,1.952205882,904,2361,451,192,192,0,66,0,0.052083333,0,empty,CD-0722-1
"G9,E4",839237,1025014,607641,417373,471825,278947,1,279206,217945,61261,3.55764679,172339,73289,15619,5473,5425,48,1102,7,0.031152074,0,hg38,CD-0722-1
"G9,E5",7962,8651,6148,2503,4010,1864,3,1871,1230,641,1.918876755,1029,1331,290,109,108,1,41,1,0.046296296,0,empty,CD-0722-1
"G9,E6",12742,14273,9483,4790,6787,3508,0,3519,2262,1257,1.799522673,2028,3170,883,343,342,1,99,1,0.040935673,0,empty,CD-0722-1
"G9,E7",11965,13275,8965,4310,6255,3028,0,3028,2092,936,2.235042735,1692,3007,829,327,325,2,85,2,0.086153846,0,empty,CD-0722-1
"G9,E8",9608,10555,7393,3162,5025,2366,0,2369,1581,788,2.006345178,1289,2654,575,210,209,1,69,1,0.062200957,0,empty,CD-0722-1
"G9,E9",5861,6445,4369,2076,3069,1551,1,1552,1030,522,1.973180077,841,2928,653,285,285,0,103,0,0.087719298,0,empty,CD-0722-1
"G9,E10",7998,8852,6065,2787,4109,1915,0,1919,1240,679,1.826215022,1112,2011,382,183,182,1,61,1,0.021978022,0,empty,CD-0722-1
"G9,E11",676449,768730,514018,254712,357107,184343,3,184546,141928,42618,3.33023605,106418,130518,20562,7279,7140,139,1294,5,0.044537815,0,hg38,CD-0722-1
"G9,E12",600666,700969,448112,252857,330602,176056,0,176264,132728,43536,3.048695333,105612,113370,14662,5315,5189,126,936,6,0.08016959,0,hg38,CD-0722-1
"G9,F1",11060,12105,8326,3779,5715,2726,0,2731,1742,989,1.761375126,1512,2133,497,221,220,1,73,1,0.054545455,0,empty,CD-0722-1
"G9,F2",9172,10166,6873,3293,4817,2372,1,2375,1546,829,1.864897467,1384,2978,659,263,261,2,102,2,0.038314176,0,empty,CD-0722-1
"G9,F3",8193,8781,6170,2611,4258,2011,0,2012,1330,682,1.950146628,1125,3032,627,265,262,3,93,2,0.026717557,0,empty,CD-0722-1
"G9,F4",13635,13554,9869,3685,6468,2955,12,2977,1915,1062,1.803201507,1568,658,106,45,45,0,25,0,0.066666667,0,empty,CD-0722-1
"G9,F5",10076,10762,7659,3103,5021,2316,1,2323,1495,828,1.805555556,1235,2607,566,209,206,3,70,1,0.077669903,0,empty,CD-0722-1
"G9,F6",9500,10476,7020,3456,5061,2578,0,2580,1676,904,1.853982301,1445,3336,689,269,268,1,96,1,0.048507463,0,empty,CD-0722-1
"G9,F7",11910,13640,8920,4720,6390,3158,0,3160,2052,1108,1.85198556,1816,1530,310,116,114,2,57,1,0.043859649,0,empty,CD-0722-1
"G9,F8",7873,8586,5877,2709,4048,1993,0,1994,1275,719,1.773296245,1099,149,26,14,14,0,8,0,0.071428571,0,empty,CD-0722-1
"G9,F9",8221,8942,6265,2677,4296,2094,0,2108,1379,729,1.891632373,1169,2524,649,225,219,6,76,2,0.095890411,0,empty,CD-0722-1
"G9,F10",11629,12902,8890,4012,5938,2777,0,2786,1851,935,1.979679144,1552,1699,445,139,139,0,50,0,0.050359712,0,empty,CD-0722-1
"G9,F11",8438,9108,6397,2711,4265,1972,0,1977,1364,613,2.225122349,1070,1533,393,164,161,3,48,2,0.099378882,0,empty,CD-0722-1
"G9,F12",9918,11093,7378,3715,5184,2578,0,2580,1713,867,1.975778547,1525,175,42,13,13,0,6,0,0,0,empty,CD-0722-1
"G9,G1",10623,11742,8191,3551,5574,2630,0,2638,1735,903,1.9213732,1423,3116,729,273,271,2,101,2,0.166051661,0,empty,CD-0722-1
"G9,G2",6129,6772,4252,2520,3270,1744,0,1744,1086,658,1.650455927,1044,591,140,57,54,3,16,1,0.018518519,0,empty,CD-0722-1
"G9,G3",11734,12732,8830,3902,6012,2991,0,2992,1828,1164,1.570446735,1621,3214,650,259,254,5,85,3,0.169291339,0,empty,CD-0722-1
"G9,G4",19286,22373,13798,8575,10648,6034,0,6038,3703,2335,1.585867238,3557,152,22,18,17,1,10,1,0,0,empty,CD-0722-1
"G9,G5",7147,7721,5326,2395,3578,1739,0,1741,1125,616,1.826298701,980,2291,677,197,196,1,55,1,0.137755102,0,empty,CD-0722-1
"G9,G6",820739,909026,638029,270997,414277,197502,0,197760,151689,46071,3.292505047,109737,6683,974,312,306,6,82,2,0.009803922,0,hg38,CD-0722-1
"G9,G7",8314,9006,6375,2631,4313,2024,0,2032,1344,688,1.953488372,1114,2587,638,243,239,4,75,2,0.041841004,0,empty,CD-0722-1
"G9,G8",6023,6494,4562,1932,3087,1431,0,1433,925,508,1.820866142,788,1487,325,146,145,1,48,1,0.131034483,0,empty,CD-0722-1
"G9,G9",6759,7224,5017,2207,3544,1691,0,1693,1101,592,1.859797297,945,1872,375,165,165,0,79,0,0.012121212,0,empty,CD-0722-1
"G9,G10",8613,9544,6480,3064,4599,2260,0,2268,1484,784,1.892857143,1319,2378,626,249,248,1,88,1,0.008064516,0,empty,CD-0722-1
"G9,G11",8945,9835,6861,2974,4634,2168,0,2171,1444,727,1.986244842,1236,1490,371,140,140,0,51,0,0.078571429,0,empty,CD-0722-1
"G9,G12",7450,8601,5421,3180,3989,2007,0,2012,1272,740,1.718918919,1177,2332,535,190,190,0,64,0,0.163157895,0,empty,CD-0722-1
"G9,H1",6866,7221,5259,1962,3472,1638,0,1639,1041,598,1.740802676,881,1417,299,127,125,2,32,1,0.096,0,empty,CD-0722-1
"G9,H2",8815,9761,6597,3164,4444,2136,0,2137,1373,764,1.797120419,1195,2327,645,248,238,10,65,2,0.092436975,0,empty,CD-0722-1
"G9,H3",6728,7243,4958,2285,3489,1721,0,1724,1128,596,1.89261745,965,1602,411,159,159,0,58,0,0.062893082,0,empty,CD-0722-1
"G9,H4",10459,11625,7698,3927,5480,2720,0,2720,1725,995,1.733668342,1590,221,15,10,10,0,9,0,0,0,empty,CD-0722-1
"G9,H5",11297,12369,8392,3977,5745,2865,1,2871,1828,1043,1.752636625,1624,1747,398,149,147,2,55,2,0.054421769,0,empty,CD-0722-1
"G9,H6",6165,6792,4524,2268,3328,1691,1,1696,1110,586,1.894197952,1020,1841,498,151,146,5,48,3,0.006849315,0,empty,CD-0722-1
"G9,H7",7719,8554,5707,2847,4015,1943,0,1943,1278,665,1.921804511,1142,2272,649,261,256,5,62,2,0.05859375,0,empty,CD-0722-1
"G9,H8",8546,9536,6072,3464,4396,2273,2,2275,1462,813,1.798277983,1375,2265,427,177,175,2,45,2,0.251428571,0,empty,CD-0722-1
"G9,H9",6654,7400,4937,2463,3470,1698,0,1705,1200,505,2.376237624,968,1583,319,119,111,8,38,2,0.108108108,0,empty,CD-0722-1
"G9,H10",5922,6214,4423,1791,2990,1413,0,1414,962,452,2.128318584,785,1329,258,125,124,1,44,1,0.14516129,0,empty,CD-0722-1
"G9,H11",7607,8385,5466,2919,4160,2458,0,2465,1381,1084,1.27398524,1431,68,21,7,7,0,3,0,0,0,empty,CD-0722-1
"G9,H12",6216,6786,4655,2131,3269,1632,0,1636,1033,603,1.713101161,907,1135,187,74,74,0,38,0,0.040540541,0,empty,CD-0722-1
"G10,A1",693085,814415,518658,295757,379235,205164,2,205366,154933,50433,3.072055995,122244,95651,11804,3757,3640,117,769,6,0.032967033,0,hg38,CD-0722-1
"G10,A2",682179,788734,508823,279911,360056,195156,0,195372,152405,42967,3.547024461,114086,81744,12238,4149,4026,123,865,5,0.046944858,0,hg38,CD-0722-1
"G10,A3",6528,7172,4841,2331,3371,1626,1,1629,1043,586,1.779863481,933,1036,370,115,115,0,28,0,0.034782609,0,empty,CD-0722-1
"G10,A4",11917,13088,9248,3840,5932,2862,0,2864,1782,1082,1.646950092,1511,982,191,72,71,1,30,1,0,0,empty,CD-0722-1
"G10,A5",650373,705937,501321,204616,327650,155004,1,155196,123878,31318,3.955488856,85821,66017,6563,2105,2024,81,482,4,0.032114625,0,hg38,CD-0722-1
"G10,A6",7784,8886,5767,3119,4301,2258,0,2261,1509,752,2.006648936,1316,2988,662,223,217,6,76,3,0.050691244,0,empty,CD-0722-1
"G10,A7",7818,8844,5821,3023,4173,2204,0,2205,1446,759,1.90513834,1273,1488,265,117,116,1,49,1,0.034482759,0,empty,CD-0722-1
"G10,A8",4237,4733,3256,1477,2266,1125,0,1128,741,387,1.914728682,634,2093,523,196,189,7,45,2,0.063492063,0,empty,CD-0722-1
"G10,A9",7404,8291,5522,2769,4011,1974,0,1980,1250,730,1.712328767,1126,1805,429,147,147,0,58,0,0.034013605,0,empty,CD-0722-1
"G10,A10",8189,9084,6235,2849,4242,2038,0,2043,1305,738,1.768292683,1122,214,41,20,20,0,13,0,0.15,0,empty,CD-0722-1
"G10,A11",6790,7393,5205,2188,3574,1679,0,1679,1106,573,1.930191972,927,1675,375,142,142,0,61,0,0.028169014,0,empty,CD-0722-1
"G10,A12",8793,9534,6738,2796,4490,2107,0,2111,1395,716,1.948324022,1152,3685,856,299,294,5,76,2,0.047619048,0,empty,CD-0722-1
"G10,B1",7477,8619,5468,3151,4003,2084,0,2088,1329,759,1.750988142,1237,1387,372,143,138,5,43,2,0.014492754,0,empty,CD-0722-1
"G10,B2",8823,9491,6138,3353,4637,2479,1,2480,1604,876,1.831050228,1453,890,139,40,39,1,19,1,0.076923077,0,empty,CD-0722-1
"G10,B3",6075,6860,4472,2388,3295,1618,1,1624,1030,594,1.734006734,948,1347,217,69,65,4,33,1,0.015384615,0,empty,CD-0722-1
"G10,B4",7643,8809,5581,3228,4242,2275,0,2277,1417,860,1.647674419,1319,1384,298,122,119,3,45,2,0.134453782,0,empty,CD-0722-1
"G10,B5",8144,4642,2869,1773,2939,1550,0,1571,1001,570,1.756140351,1006,1021,207,65,63,2,26,1,0.015873016,0,empty,CD-0722-1
"G10,B6",8215,9393,6026,3367,4465,2400,0,2404,1466,938,1.562899787,1418,1610,448,163,161,2,43,1,0.111801242,0,empty,CD-0722-1
"G10,B7",7847,8793,6004,2789,4122,1966,2,1970,1240,730,1.698630137,1092,1325,272,91,90,1,28,1,0,0,empty,CD-0722-1
"G10,B8",5736,6284,4373,1911,2933,1378,0,1378,908,470,1.931914894,737,1332,254,100,99,1,41,1,0.060606061,0,empty,CD-0722-1
"G10,B9",10721,11898,7827,4071,5584,2927,0,2927,1783,1144,1.558566434,1709,904,274,93,93,0,34,0,0.043010753,0,empty,CD-0722-1
"G10,B10",5419,5873,3936,1937,2905,1410,0,1411,888,523,1.69789675,807,450,56,31,30,1,12,1,0,0,empty,CD-0722-1
"G10,B11",690478,833456,481658,351798,378479,244826,1,245083,177650,67433,2.634466804,147740,1780,800,242,241,1,63,1,0,0,hg38,CD-0722-1
"G10,B12",6946,7720,5107,2613,3689,1837,0,1840,1191,649,1.835130971,1062,1942,370,141,139,2,40,2,0.043165468,0,empty,CD-0722-1
"G10,C1",13506,14696,10296,4400,6945,3368,3,3377,2076,1301,1.595695619,1854,865,171,64,64,0,29,0,0.015625,0,empty,CD-0722-1
"G10,C2",11508,12833,8454,4379,5971,3076,0,3079,1874,1205,1.555186722,1780,2418,844,271,267,4,58,1,0.04494382,0,empty,CD-0722-1
"G10,C3",12329,13829,9365,4464,6588,3295,0,3305,1991,1314,1.5152207,1867,1184,212,85,85,0,32,0,0.082352941,0,empty,CD-0722-1
"G10,C4",7668,8256,5736,2520,3902,1785,0,1787,1173,614,1.910423453,1023,1747,476,160,158,2,59,1,0,0,empty,CD-0722-1
"G10,C5",10729,12073,7929,4144,5681,2875,1,2877,1853,1024,1.809570313,1684,1848,392,169,165,4,53,1,0.193939394,0,empty,CD-0722-1
"G10,C6",8964,9872,6725,3147,4693,2323,0,2323,1492,831,1.795427196,1302,1486,355,122,121,1,61,1,0.066115702,0,empty,CD-0722-1
"G10,C7",12028,13760,8886,4874,6454,3529,0,3529,2096,1433,1.462665736,2069,483,91,49,48,1,24,1,0.020833333,0,empty,CD-0722-1
"G10,C8",13177,14574,9860,4714,6816,3425,0,3436,2266,1170,1.936752137,1927,2803,603,234,234,0,84,0,0.085470085,0,empty,CD-0722-1
"G10,C9",66972,79675,51469,28206,36033,18859,1,18879,13769,5110,2.694520548,11182,9426,1592,538,526,12,137,3,0.039923954,0,empty,CD-0722-1
"G10,C10",10928,11815,8226,3589,5610,2681,0,2686,1719,967,1.777662875,1476,2205,450,118,115,3,41,2,0.07826087,0,empty,CD-0722-1
"G10,C11",9299,10079,6941,3138,4811,2376,0,2379,1513,866,1.747113164,1315,2191,399,153,150,3,45,2,0.033333333,0,empty,CD-0722-1
"G10,C12",13489,14431,10025,4406,6735,3253,0,3266,2144,1122,1.91087344,1854,1674,371,128,126,2,45,1,0,0,empty,CD-0722-1
"G10,D1",11856,13901,8753,5148,6369,3419,1,3421,2078,1343,1.547282204,1996,893,147,53,52,1,18,1,0.134615385,0,empty,CD-0722-1
"G10,D2",10005,10798,7759,3039,5194,2406,0,2409,1597,812,1.966748768,1333,3062,709,259,256,3,93,2,0.05859375,0,empty,CD-0722-1
"G10,D3",8683,9576,6424,3152,4524,2255,0,2261,1454,807,1.80173482,1302,1495,356,103,103,0,38,0,0.038834951,0,empty,CD-0722-1
"G10,D4",675223,792466,505398,287068,365039,198025,0,198250,152591,45659,3.34196982,118554,79195,9046,2886,2821,65,621,5,0.091811414,0,hg38,CD-0722-1
"G10,D5",2185337,2616786,1617515,999271,1167037,675930,7,676677,554287,122390,4.528858567,405407,255474,41900,13921,13684,237,2119,7,0.07147033,0,hg38,CD-0722-1
"G10,D6",11355,12791,8275,4516,5895,3178,0,3184,1866,1318,1.415781487,1839,2149,642,212,211,1,48,1,0.08056872,0,empty,CD-0722-1
"G10,D7",6490,7183,4926,2257,3446,1698,0,1699,1112,587,1.894378194,951,2222,453,154,153,1,62,1,0.013071895,0,empty,CD-0722-1
"G10,D8",8127,9291,6099,3192,4303,2160,0,2161,1397,764,1.828534031,1256,1303,251,119,114,5,41,2,0.00877193,0,empty,CD-0722-1
"G10,D9",5886,6662,4482,2180,3228,1566,1,1569,1060,509,2.082514735,929,1916,377,162,159,3,51,2,0.094339623,0,empty,CD-0722-1
"G10,D10",7663,8664,5685,2979,4046,2039,0,2045,1272,773,1.645536869,1184,629,128,62,61,1,29,1,0.049180328,0,empty,CD-0722-1
"G10,D11",8897,9627,6881,2746,4609,2210,0,2211,1458,753,1.93625498,1169,3192,655,244,240,4,93,2,0.0625,0,empty,CD-0722-1
"G10,D12",11291,12326,8445,3881,5779,2847,2,2849,1858,991,1.874873865,1590,4024,910,299,296,3,118,2,0.023648649,0,empty,CD-0722-1
"G10,E1",833677,940247,631685,308562,428480,219801,2,220043,174128,45915,3.792398998,124968,120594,17952,5580,5479,101,1100,5,0.024639533,0,hg38,CD-0722-1
"G10,E2",9862,10868,7377,3491,5216,2548,0,2552,1624,928,1.75,1445,2379,674,194,192,2,60,1,0.078125,0,empty,CD-0722-1
"G10,E3",645794,778973,478353,300620,356286,203752,4,203975,162804,41171,3.95433679,122323,140639,25165,8231,8123,108,1450,7,0.080758341,0,hg38,CD-0722-1
"G10,E4",3622828,3650313,2945852,704461,1543909,608652,12,609613,417677,191936,2.176126417,302642,128279,23273,7170,7041,129,1371,6,0.069166312,0,hg38,CD-0722-1
"G10,E5",8362,8945,6443,2502,4192,1883,0,1886,1227,659,1.861911988,986,1337,402,119,119,0,40,0,0.12605042,0,empty,CD-0722-1
"G10,E6",14022,15325,10290,5035,7043,3495,0,3497,2203,1294,1.702472952,2015,3611,1080,349,345,4,83,1,0.110144928,0,empty,CD-0722-1
"G10,E7",12643,13504,9451,4053,6366,2954,1,2959,2000,959,2.085505735,1640,3153,736,280,272,8,72,2,0.0625,0,empty,CD-0722-1
"G10,E8",10825,11811,8258,3553,5455,2571,1,2578,1644,934,1.760171306,1408,3053,566,154,151,3,57,1,0.026490066,0,empty,CD-0722-1
"G10,E9",6612,7443,5038,2405,3500,1669,0,1671,1087,584,1.86130137,939,2838,728,242,235,7,83,1,0.025531915,0,empty,CD-0722-1
"G10,E10",7813,8648,5872,2776,4042,2016,0,2019,1259,760,1.656578947,1162,2110,593,202,201,1,55,1,0.07960199,0,empty,CD-0722-1
"G10,E11",9272,10247,6999,3248,4890,2431,0,2438,1536,902,1.702882483,1382,2351,549,202,201,1,60,1,0.124378109,0,empty,CD-0722-1
"G10,E12",9481,10617,7113,3504,5074,2561,0,2564,1584,980,1.616326531,1483,1873,377,101,101,0,47,0,0.01980198,0,empty,CD-0722-1
"G10,F1",11916,13125,8783,4342,6110,2989,5,2996,1794,1202,1.492512479,1692,2229,490,158,155,3,47,2,0.051612903,0,empty,CD-0722-1
"G10,F2",9508,10374,7178,3196,4973,2439,0,2448,1624,824,1.970873786,1360,5195,704,237,236,1,82,1,0.025423729,0,empty,CD-0722-1
"G10,F3",8852,9889,6603,3286,4664,2323,0,2328,1491,837,1.781362007,1387,2510,515,182,178,4,76,3,0.02247191,0,empty,CD-0722-1
"G10,F4",13849,14443,10304,4139,6831,3074,9,3094,1969,1125,1.750222222,1715,647,131,52,51,1,23,1,0,0,empty,CD-0722-1
"G10,F5",11302,12361,8481,3880,5802,2691,2,2697,1666,1031,1.615906887,1537,3981,722,266,257,9,74,2,0.058365759,0,empty,CD-0722-1
"G10,F6",10838,12045,7949,4096,5747,2967,0,2970,1955,1015,1.926108374,1747,3348,588,200,196,4,78,2,0.025510204,0,empty,CD-0722-1
"G10,F7",974639,1138324,722969,415355,519844,288189,1,288424,236233,52191,4.526316798,170720,64950,14071,4563,4482,81,843,4,0.025881303,0,hg38,CD-0722-1
"G10,F8",9262,10381,7039,3342,4884,2371,0,2372,1556,816,1.906862745,1342,156,23,17,17,0,9,0,0,0,empty,CD-0722-1
"G10,F9",9253,10063,7083,2980,4736,2222,0,2226,1471,755,1.948344371,1248,2933,876,294,294,0,77,0,0.088435374,0,empty,CD-0722-1
"G10,F10",11992,13254,9155,4099,6202,2993,0,2998,1910,1088,1.755514706,1716,1655,467,173,170,3,39,2,0.017647059,0,empty,CD-0722-1
"G10,F11",9133,10157,6981,3176,4697,2183,0,2186,1420,766,1.853785901,1218,1647,375,140,140,0,32,0,0.221428571,0,empty,CD-0722-1
"G10,F12",10168,11677,7494,4183,5351,2701,0,2705,1787,918,1.946623094,1640,145,49,25,25,0,13,0,0.16,0,empty,CD-0722-1
"G10,G1",11598,12608,8803,3805,5935,2829,0,2834,1858,976,1.903688525,1615,2901,733,237,233,4,80,2,0.0472103,0,empty,CD-0722-1
"G10,G2",6670,7553,4772,2781,3503,1876,0,1878,1170,708,1.652542373,1087,526,189,66,65,1,24,1,0,0,empty,CD-0722-1
"G10,G3",12256,12967,9031,3936,6319,3165,0,3167,1918,1249,1.535628503,1735,2812,689,262,261,1,90,1,0.091954023,0,empty,CD-0722-1
"G10,G4",21446,24367,15498,8869,11421,6286,0,6290,3853,2437,1.581042265,3645,186,22,15,15,0,13,0,0,0,empty,CD-0722-1
"G10,G5",7595,8706,5724,2982,4065,2046,0,2050,1278,772,1.655440415,1191,1789,337,128,128,0,39,0,0,0,empty,CD-0722-1
"G10,G6",11322,12013,8543,3470,5626,2667,0,2672,1743,929,1.87621098,1477,238,115,45,45,0,13,0,0.111111111,0,empty,CD-0722-1
"G10,G7",9283,10442,7074,3368,4895,2354,0,2356,1509,847,1.781582054,1340,2792,720,248,243,5,77,2,0.111111111,0,empty,CD-0722-1
"G10,G8",6449,7225,4853,2372,3324,1662,1,1668,1073,595,1.803361345,943,1820,543,150,147,3,56,2,0.06122449,0,empty,CD-0722-1
"G10,G9",7791,8608,5761,2847,4064,2040,0,2042,1340,702,1.908831909,1175,2647,648,202,200,2,76,1,0.05,0,empty,CD-0722-1
"G10,G10",921631,1075141,690413,384728,490625,269087,1,269405,217331,52074,4.173503092,157119,201544,35110,11768,11597,171,1937,6,0.047857204,0,hg38,CD-0722-1
"G10,G11",10054,10994,7615,3379,5149,2481,0,2482,1611,871,1.849598163,1366,1938,431,132,128,4,42,1,0.0078125,0,empty,CD-0722-1
"G10,G12",7667,8680,5673,3007,3993,2022,0,2028,1254,774,1.620155039,1149,2894,948,255,254,1,63,1,0.035433071,0,empty,CD-0722-1
"G10,H1",7957,8713,5967,2746,4154,1956,0,1958,1286,672,1.913690476,1123,1271,353,119,119,0,34,0,0.109243697,0,empty,CD-0722-1
"G10,H2",10313,11706,7614,4092,5388,2706,0,2712,1587,1125,1.410666667,1606,5637,1318,474,470,4,110,2,0.09787234,0,empty,CD-0722-1
"G10,H3",7659,8553,5749,2804,3991,1982,0,1985,1285,700,1.835714286,1165,1648,195,72,67,5,38,2,0.074626866,0,empty,CD-0722-1
"G10,H4",903948,1029794,679939,349855,465885,248298,0,248531,185945,62586,2.97103186,144475,3391,395,128,123,5,49,1,0.048780488,0,hg38,CD-0722-1
"G10,H5",11954,13073,8855,4218,6023,2960,0,2967,1849,1118,1.653846154,1750,1977,660,223,221,2,52,1,0.009049774,0,empty,CD-0722-1
"G10,H6",6901,7532,5090,2442,3604,1833,1,1835,1213,622,1.950160772,1039,1878,469,175,173,2,52,1,0.01734104,0,empty,CD-0722-1
"G10,H7",8619,9053,6465,2588,4332,1961,2,1971,1276,695,1.835971223,1081,1776,368,136,136,0,51,0,0.073529412,0,empty,CD-0722-1
"G10,H8",8925,10234,6640,3594,4782,2497,0,2504,1655,849,1.949352179,1464,2454,572,192,188,4,56,2,0.127659574,0,empty,CD-0722-1
"G10,H9",7434,8174,5670,2504,3736,1751,0,1752,1162,590,1.969491525,937,1051,196,69,67,2,23,1,0,0,empty,CD-0722-1
"G10,H10",6563,7167,4872,2295,3289,1612,0,1612,1007,605,1.66446281,876,1631,386,137,135,2,33,2,0.103703704,0,empty,CD-0722-1
"G10,H11",8392,9745,5866,3879,4642,2769,0,2773,1500,1273,1.178318932,1704,50,10,8,8,0,4,0,0.125,0,empty,CD-0722-1
"G10,H12",6962,7539,5226,2313,3564,1778,0,1778,1156,622,1.8585209,968,1428,265,109,108,1,40,1,0.092592593,0,empty,CD-0722-1
"G11,A1",6133,6868,4512,2356,3309,1695,1,1702,1120,582,1.924398625,999,1730,516,163,160,3,47,1,0.15,0,empty,CD-0722-1
"G11,A2",13116,14510,9916,4594,6759,3308,0,3312,2186,1126,1.941385435,1881,3950,668,265,256,9,96,2,0.07421875,0,empty,CD-0722-1
"G11,A3",5397,5868,4009,1859,2833,1432,0,1432,942,490,1.92244898,830,989,131,57,57,0,23,0,0,0,empty,CD-0722-1
"G11,A4",647206,730609,493652,236957,334319,169552,0,169721,135140,34581,3.907926318,97063,23376,4668,1538,1500,38,331,3,0.021333333,0,hg38,CD-0722-1
"G11,A5",319339,352511,235091,117420,162947,84711,0,84805,71494,13311,5.371046503,48265,52868,4496,1551,1492,59,370,4,0.056300268,0,hg38,CD-0722-1
"G11,A6",340969,409702,251024,158678,190734,108493,0,108586,86802,21784,3.984667646,65590,44741,11575,3483,3451,32,747,4,0.052448566,0,hg38,CD-0722-1
"G11,A7",564091,641875,432925,208950,296033,149334,0,149537,112825,36712,3.073245805,85672,95424,14740,4916,4796,120,902,6,0.066096747,0,hg38,CD-0722-1
"G11,A8",3570,4047,2674,1373,1993,975,0,975,671,304,2.207236842,568,1838,431,127,127,0,48,0,0.047244094,0,empty,CD-0722-1
"G11,A9",6452,7365,4975,2390,3447,1665,0,1672,1052,620,1.696774194,964,1568,192,114,113,1,55,1,0.079646018,0,empty,CD-0722-1
"G11,A10",6956,7656,5403,2253,3609,1727,0,1729,1093,636,1.718553459,940,367,24,17,16,1,13,1,0.0625,0,empty,CD-0722-1
"G11,A11",5621,5971,4288,1683,2946,1369,0,1374,908,466,1.948497854,742,1867,454,185,181,4,63,2,0.022099448,0,empty,CD-0722-1
"G11,A12",7304,7982,5506,2476,3763,1780,0,1781,1142,639,1.787167449,998,3615,730,255,254,1,76,1,0.059055118,0,empty,CD-0722-1
"G11,B1",708851,811522,534113,277409,369768,195774,2,195950,152709,43241,3.531578826,113461,96979,14950,4961,4830,131,926,5,0.066459627,0,hg38,CD-0722-1
"G11,B2",7249,8092,4984,3108,3914,2083,0,2085,1314,771,1.704280156,1275,506,56,31,28,3,19,1,0.035714286,0,empty,CD-0722-1
"G11,B3",5268,6020,3897,2123,2872,1479,0,1480,946,534,1.771535581,865,1255,238,107,106,1,30,1,0.094339623,0,empty,CD-0722-1
"G11,B4",6096,6917,4368,2549,3361,1812,1,1813,1123,690,1.627536232,1050,1553,300,132,131,1,66,1,0.038167939,0,empty,CD-0722-1
"G11,B5",443772,247970,121127,126843,159588,108439,6,109142,77744,31398,2.476081279,74233,3147,280,118,111,7,45,2,0.108108108,0,hg38,CD-0722-1
"G11,B6",7258,8016,5273,2743,3775,1938,0,1940,1199,741,1.618083671,1088,1286,298,103,101,2,37,2,0.118811881,0,empty,CD-0722-1
"G11,B7",6921,7820,5308,2512,3619,1756,0,1756,1110,646,1.718266254,969,791,130,62,58,4,22,1,0.413793103,0,empty,CD-0722-1
"G11,B8",4773,5277,3644,1633,2566,1215,0,1215,819,396,2.068181818,673,1014,252,117,116,1,45,1,0.051724138,0,empty,CD-0722-1
"G11,B9",9117,10084,6662,3422,4809,2498,0,2505,1564,941,1.662061637,1461,831,167,55,55,0,28,0,0.163636364,0,empty,CD-0722-1
"G11,B10",1202818,1334590,811016,523574,642068,384432,33,385717,266655,119062,2.239631453,233313,9176,1243,380,375,5,111,1,0.021333333,0,hg38,CD-0722-1
"G11,B11",9762,11055,7138,3917,5055,2751,0,2751,1582,1169,1.353293413,1608,326,61,24,24,0,13,0,0.041666667,0,empty,CD-0722-1
"G11,B12",5771,6620,4282,2338,3076,1566,0,1569,969,600,1.615,918,1770,526,169,157,12,46,2,0.006369427,0,empty,CD-0722-1
"G11,C1",19137,21433,14399,7034,9792,4832,1,4836,3225,1611,2.001862197,2751,1801,426,145,143,2,37,2,0.27972028,0,empty,CD-0722-1
"G11,C2",9616,10497,7065,3432,4917,2549,0,2550,1609,941,1.709883103,1435,2007,557,180,179,1,48,1,0.117318436,0,empty,CD-0722-1
"G11,C3",9797,10609,7378,3231,5239,2576,1,2584,1681,903,1.861572536,1396,984,184,64,64,0,22,0,0,0,empty,CD-0722-1
"G11,C4",565975,649651,429241,220410,299188,154208,1,154384,114674,39710,2.887786452,90158,141833,15126,5320,5159,161,1016,8,0.040899399,0,hg38,CD-0722-1
"G11,C5",1382584,1663511,1034566,628945,754477,431412,4,431843,365013,66830,5.461813557,258175,197889,28725,9900,9697,203,1718,10,0.042074869,0,hg38,CD-0722-1
"G11,C6",7562,8244,5654,2590,4001,1957,0,1962,1317,645,2.041860465,1107,1568,294,123,123,0,54,0,0.06504065,0,empty,CD-0722-1
"G11,C7",10379,12433,7456,4977,5670,3216,0,3217,1897,1320,1.437121212,1948,623,181,64,63,1,22,1,0.19047619,0,empty,CD-0722-1
"G11,C8",579501,655225,439125,216100,301870,155214,6,155392,123343,32049,3.848575619,90051,57840,11165,3469,3417,52,664,4,0.031021364,0,hg38,CD-0722-1
"G11,C9",7910,8949,5890,3059,4308,2241,0,2251,1458,793,1.838587642,1304,1780,536,137,133,4,47,1,0.15037594,0,empty,CD-0722-1
"G11,C10",8982,10176,6728,3448,4783,2374,0,2374,1559,815,1.912883436,1378,1702,320,132,131,1,49,1,0.06870229,0,empty,CD-0722-1
"G11,C11",7802,8722,5679,3043,4097,1998,0,1998,1316,682,1.929618768,1179,1764,227,85,84,1,43,1,0,0,empty,CD-0722-1
"G11,C12",11195,12074,8295,3779,5674,2750,2,2755,1819,936,1.943376068,1553,1806,496,171,170,1,51,1,0.047058824,0,empty,CD-0722-1
"G11,D1",1420572,1615037,1081804,533233,729041,382893,1,383304,292944,90360,3.241965471,221546,48551,5689,1870,1826,44,445,4,0.048192771,0,hg38,CD-0722-1
"G11,D2",24100,27426,18909,8517,12231,5811,0,5815,3870,1945,1.989717224,3271,4498,1588,492,491,1,147,1,0.034623218,0,empty,CD-0722-1
"G11,D3",7268,8194,5429,2765,3860,1942,0,1942,1309,633,2.06793049,1117,1683,389,150,148,2,46,1,0.162162162,0,empty,CD-0722-1
"G11,D4",6283,6843,4701,2142,3086,1484,0,1491,986,505,1.952475248,826,1266,270,93,92,1,32,1,0.010869565,0,empty,CD-0722-1
"G11,D5",622243,720747,463219,257528,333756,182375,1,182541,140039,42502,3.294880241,107578,118260,19543,6376,6243,133,1097,5,0.064872657,0,hg38,CD-0722-1
"G11,D6",773195,882344,578844,303500,399192,205300,2,205552,170113,35439,4.800163662,120348,6206,2465,654,649,5,249,1,0.012326656,0,hg38,CD-0722-1
"G11,D7",5609,5956,4297,1659,2856,1327,0,1329,879,450,1.953333333,713,2045,391,155,147,8,55,3,0.020408163,0,empty,CD-0722-1
"G11,D8",6876,7755,5190,2565,3670,1815,0,1817,1141,676,1.687869822,1056,936,93,54,51,3,35,1,0.098039216,0,empty,CD-0722-1
"G11,D9",3884,4264,3042,1222,2089,999,0,999,695,304,2.286184211,523,1803,387,166,164,2,55,2,0.140243902,0,empty,CD-0722-1
"G11,D10",7256,8225,5353,2872,3833,1950,0,1958,1303,655,1.989312977,1154,755,206,74,73,1,22,1,0.164383562,0,empty,CD-0722-1
"G11,D11",7737,8411,5842,2569,4019,1925,0,1928,1274,654,1.948012232,1073,2669,544,248,246,2,98,1,0.024390244,0,empty,CD-0722-1
"G11,D12",602402,708983,437290,271693,327189,198636,1,198848,138459,60389,2.29278511,118399,21409,1752,524,498,26,169,3,0.108433735,0,hg38,CD-0722-1
"G11,E1",11332,12594,8438,4156,5880,2959,0,2959,1841,1118,1.646690519,1670,2757,655,275,269,6,88,3,0.066914498,0,empty,CD-0722-1
"G11,E2",8643,9177,6322,2855,4350,2178,0,2180,1370,810,1.691358025,1252,2071,459,188,187,1,60,1,0.096256684,0,empty,CD-0722-1
"G11,E3",5798,6503,4307,2196,3185,1600,0,1603,972,631,1.540412044,937,2394,561,222,221,1,73,1,0.07239819,0,empty,CD-0722-1
"G11,E4",7719,8458,5709,2749,4010,1955,0,1958,1221,737,1.656716418,1100,2529,517,214,211,3,104,2,0.028436019,0,empty,CD-0722-1
"G11,E5",6872,7773,5192,2581,3787,1800,0,1806,1118,688,1.625,1076,1049,152,70,67,3,35,2,0.119402985,0,empty,CD-0722-1
"G11,E6",11645,12921,8583,4338,5945,3015,0,3019,1878,1141,1.645924628,1718,2773,697,248,246,2,68,1,0.069105691,0,empty,CD-0722-1
"G11,E7",567586,645133,429329,215804,293005,149513,1,149664,115570,34094,3.389745996,85981,68894,12518,4229,4166,63,814,6,0.078732597,0,hg38,CD-0722-1
"G11,E8",8753,9539,6662,2877,4441,2053,0,2055,1301,754,1.725464191,1077,2322,514,195,193,2,65,1,0.046632124,0,empty,CD-0722-1
"G11,E9",5432,6048,4013,2035,2882,1416,0,1417,940,477,1.970649895,844,2265,458,156,153,3,60,2,0.098039216,0,empty,CD-0722-1
"G11,E10",720412,855246,530468,324778,391597,220196,2,220425,170648,49777,3.428249995,133136,142616,27213,9019,8877,142,1492,6,0.076715106,0,hg38,CD-0722-1
"G11,E11",8048,8680,6087,2593,4093,1991,1,1992,1262,730,1.728767123,1085,1700,421,140,140,0,60,0,0.014285714,0,empty,CD-0722-1
"G11,E12",745625,895916,549996,345920,413222,235863,5,236082,190071,46011,4.130990415,143183,104958,13222,4265,4146,119,944,6,0.039556199,0,hg38,CD-0722-1
"G11,F1",1010540,1039245,800930,238315,473004,191851,2,192140,152005,40135,3.787342718,100506,103274,19459,6220,6123,97,1018,4,0.021231423,0,hg38,CD-0722-1
"G11,F2",8079,8725,6086,2639,4300,2069,0,2076,1392,684,2.035087719,1169,2593,532,181,179,2,81,2,0.027932961,0,empty,CD-0722-1
"G11,F3",9407,10758,6671,4087,5260,2934,0,2943,1831,1112,1.646582734,1792,2953,816,275,273,2,81,2,0.058608059,0,empty,CD-0722-1
"G11,F4",11675,12205,8852,3353,5806,2696,1,2704,1797,907,1.981256891,1378,555,142,61,58,3,21,1,0,0,empty,CD-0722-1
"G11,F5",8953,9311,6819,2492,4451,2081,0,2085,1348,737,1.829036635,1112,1762,544,169,162,7,62,2,0.037037037,0,empty,CD-0722-1
"G11,F6",9198,10197,6812,3385,4834,2433,0,2435,1567,868,1.805299539,1405,2730,614,224,224,0,83,0,0.035714286,0,empty,CD-0722-1
"G11,F7",11045,12759,8213,4546,5964,3068,1,3071,1993,1078,1.848794063,1794,1451,275,133,131,2,64,1,0,0,empty,CD-0722-1
"G11,F8",7208,7917,5454,2463,3739,1792,0,1802,1201,601,1.998336106,1043,189,25,8,8,0,8,0,0,0,empty,CD-0722-1
"G11,F9",932709,1116160,688769,427391,506666,285201,1,285514,241673,43841,5.51248831,171279,183583,36112,11958,11790,168,1932,10,0.085750636,0,hg38,CD-0722-1
"G11,F10",10294,11091,7815,3276,5179,2470,0,2481,1612,869,1.855005754,1397,1910,557,144,143,1,38,1,0.076923077,0,empty,CD-0722-1
"G11,F11",7667,8096,5878,2218,3830,1751,0,1754,1169,585,1.998290598,918,1416,314,105,105,0,38,0,0.142857143,0,empty,CD-0722-1
"G11,F12",8398,9188,6340,2848,4190,1978,0,1980,1290,690,1.869565217,1111,219,82,24,24,0,9,0,0,0,empty,CD-0722-1
"G11,G1",9819,10787,7466,3321,5148,2425,0,2428,1603,825,1.943030303,1371,2883,728,311,309,2,110,2,0.077669903,0,empty,CD-0722-1
"G11,G2",5560,6125,3930,2195,2874,1538,0,1538,1033,505,2.045544554,891,268,84,51,46,5,16,1,0,0,empty,CD-0722-1
"G11,G3",763959,900324,564233,336091,413042,235264,1,235467,187710,47757,3.930523274,140675,82543,13854,4306,4249,57,907,4,0.031772182,0,hg38,CD-0722-1
"G11,G4",18394,21052,13218,7834,9861,5516,0,5521,3356,2165,1.550115473,3235,177,37,13,12,1,10,1,0,0,empty,CD-0722-1
"G11,G5",6409,7005,4789,2216,3404,1681,0,1685,1069,616,1.73538961,969,1991,478,137,135,2,51,2,0.014814815,0,empty,CD-0722-1
"G11,G6",9310,10076,7025,3051,4788,2317,0,2324,1482,842,1.760095012,1326,178,26,19,19,0,10,0,0.368421053,0,empty,CD-0722-1
"G11,G7",7555,8225,5687,2538,3905,1836,0,1837,1232,605,2.036363636,997,2693,688,231,224,7,75,2,0.147321429,0,empty,CD-0722-1
"G11,G8",5462,6074,4041,2033,2776,1385,0,1387,889,498,1.785140562,766,1643,495,151,150,1,60,1,0.033333333,0,empty,CD-0722-1
"G11,G9",6479,7311,4893,2418,3475,1731,0,1734,1088,646,1.684210526,1004,2318,608,234,234,0,64,0,0.102564103,0,empty,CD-0722-1
"G11,G10",1035228,1129737,801097,328640,519806,248637,1,248957,203820,45137,4.515585883,138092,116342,21504,7238,7124,114,1235,5,0.019932622,0,hg38,CD-0722-1
"G11,G11",7952,8460,6009,2451,4074,1890,0,1894,1236,658,1.878419453,1014,1550,384,132,132,0,55,0,0.113636364,0,empty,CD-0722-1
"G11,G12",6787,7552,4936,2616,3521,1786,0,1787,1169,618,1.891585761,1019,2417,544,198,197,1,55,1,0.096446701,0,empty,CD-0722-1
"G11,H1",6614,7038,4900,2138,3342,1611,0,1613,1018,595,1.71092437,882,1125,206,89,83,6,33,2,0,0,empty,CD-0722-1
"G11,H2",7684,8475,5783,2692,3978,1959,0,1963,1243,720,1.726388889,1097,1990,506,155,153,2,63,2,0.150326797,0,empty,CD-0722-1
"G11,H3",6288,6771,4737,2034,3265,1541,0,1544,979,565,1.732743363,866,2118,639,186,184,2,62,2,0.168478261,0,empty,CD-0722-1
"G11,H4",9512,10545,7004,3541,4917,2405,0,2407,1566,841,1.862068966,1415,144,48,25,25,0,15,0,0.04,0,empty,CD-0722-1
"G11,H5",10138,11609,7385,4224,5236,2602,0,2604,1676,928,1.806034483,1584,1825,489,149,148,1,41,1,0.074324324,0,empty,CD-0722-1
"G11,H6",6183,7206,4505,2701,3376,1811,0,1811,1180,631,1.870047544,1067,1694,368,131,130,1,48,1,0.038461538,0,empty,CD-0722-1
"G11,H7",7251,8129,5356,2773,3869,1847,1,1849,1257,592,2.123310811,1109,1793,368,139,139,0,57,0,0.028776978,0,empty,CD-0722-1
"G11,H8",7575,8101,5694,2407,3945,1947,0,1949,1232,717,1.718270572,1084,2590,614,213,209,4,81,2,0.033492823,0,empty,CD-0722-1
"G11,H9",8888,9430,6553,2877,4372,2023,0,2025,1386,639,2.169014085,1107,1344,263,103,101,2,34,1,0.089108911,0,empty,CD-0722-1
"G11,H10",5510,6200,4164,2036,2860,1385,1,1387,877,510,1.719607843,823,1194,210,86,86,0,34,0,0.046511628,0,empty,CD-0722-1
"G11,H11",7110,8409,5018,3391,4068,2496,0,2497,1411,1086,1.299263352,1569,86,10,8,8,0,6,0,0,0,empty,CD-0722-1
"G11,H12",5948,6425,4286,2139,3180,1658,1,1661,1050,611,1.718494272,1004,1488,305,141,138,3,42,2,0.057971014,0,empty,CD-0722-1
"G12,A1",7221,8150,5348,2802,3956,2066,0,2069,1311,758,1.729551451,1228,1465,299,138,138,0,36,0,0,0,empty,CD-0722-1
"G12,A2",11438,12838,8572,4266,6076,3106,0,3108,1941,1167,1.663239075,1736,1935,435,153,151,2,64,1,0.066225166,0,empty,CD-0722-1
"G12,A3",6896,7685,5199,2486,3586,1780,0,1780,1213,567,2.139329806,993,899,118,36,35,1,21,1,0.057142857,0,empty,CD-0722-1
"G12,A4",979576,1104791,747994,356797,498666,246615,1,246897,197765,49132,4.025177074,140876,4207,1379,430,429,1,172,1,0.046620047,0,hg38,CD-0722-1
"G12,A5",10280,11206,7589,3617,5311,2497,0,2502,1620,882,1.836734694,1417,2088,380,154,152,2,59,2,0.138157895,0,empty,CD-0722-1
"G12,A6",8694,9821,6496,3325,4731,2505,0,2508,1604,904,1.774336283,1460,2653,590,199,193,6,81,2,0.119170984,0,empty,CD-0722-1
"G12,A7",7835,8772,5902,2870,4226,2200,0,2202,1406,796,1.766331658,1262,1375,193,83,81,2,45,2,0.049382716,0,empty,CD-0722-1
"G12,A8",4671,5190,3487,1703,2455,1247,1,1248,862,386,2.233160622,731,1700,314,91,89,2,45,2,0.08988764,0,empty,CD-0722-1
"G12,A9",9621,10692,7250,3442,5005,2476,5,2488,1752,736,2.380434783,1394,1750,461,147,146,1,51,1,0.130136986,0,empty,CD-0722-1
"G12,A10",936837,1086033,699755,386278,503854,274330,1,274606,214170,60436,3.543748759,160480,13069,2101,642,628,14,176,4,0.017515924,0,hg38,CD-0722-1
"G12,A11",7203,8088,5548,2540,3936,1871,0,1873,1249,624,2.001602564,1074,2918,477,160,157,3,49,1,0.114649682,0,empty,CD-0722-1
"G12,A12",725341,821315,544640,276675,374197,196645,3,196850,154977,41873,3.701120053,113320,223451,41363,13496,13296,200,2030,10,0.03316787,0,hg38,CD-0722-1
"G12,B1",8147,8904,6164,2740,4248,2145,0,2146,1299,847,1.53364817,1209,1186,297,108,107,1,33,1,0.037383178,0,empty,CD-0722-1
"G12,B2",9153,10257,6430,3827,4804,2592,0,2594,1661,933,1.780278671,1547,696,167,61,61,0,19,0,0.016393443,0,empty,CD-0722-1
"G12,B3",6653,7520,4869,2651,3533,1796,0,1798,1169,629,1.858505564,1058,1317,354,134,134,0,39,0,0.014925373,0,empty,CD-0722-1
"G12,B4",7930,8859,5855,3004,4335,2332,1,2337,1509,828,1.822463768,1355,1617,253,127,125,2,59,2,0.04,0,empty,CD-0722-1
"G12,B5",7786,4152,2323,1829,2680,1544,0,1557,969,588,1.647959184,1056,977,157,52,52,0,22,0,0.019230769,0,empty,CD-0722-1
"G12,B6",8754,9614,6332,3282,4521,2385,0,2386,1520,866,1.755196305,1363,1640,342,118,118,0,32,0,0.237288136,0,empty,CD-0722-1
"G12,B7",8449,9525,6453,3072,4416,2188,0,2188,1470,718,2.04735376,1263,1131,321,109,108,1,33,1,0.12037037,0,empty,CD-0722-1
"G12,B8",6141,6752,4693,2059,3177,1516,0,1517,979,538,1.819702602,838,1133,283,102,101,1,30,1,0.207920792,0,empty,CD-0722-1
"G12,B9",11353,12486,8455,4031,5753,2942,0,2952,1893,1059,1.787535411,1648,879,211,73,71,2,33,1,0.042253521,0,empty,CD-0722-1
"G12,B10",6099,6447,4360,2087,3223,1581,1,1593,1016,577,1.760831889,909,462,87,51,51,0,20,0,0.098039216,0,empty,CD-0722-1
"G12,B11",12537,14335,9036,5299,6634,3706,0,3711,2164,1547,1.398836458,2228,345,75,27,26,1,12,1,0,0,empty,CD-0722-1
"G12,B12",7196,8006,5391,2615,3881,1916,0,1925,1220,705,1.730496454,1115,2072,560,194,193,1,58,1,0.07253886,0,empty,CD-0722-1
"G12,C1",14502,15769,10869,4900,7419,3607,1,3610,2248,1362,1.65051395,2021,1380,313,62,61,1,27,1,0,0,empty,CD-0722-1
"G12,C2",11517,12354,8496,3858,5851,2934,0,2939,1799,1140,1.578070175,1654,2275,576,193,185,8,57,2,0.2,0,empty,CD-0722-1
"G12,C3",12524,13822,9549,4273,6557,3174,0,3177,2021,1156,1.748269896,1829,1057,175,67,63,4,24,2,0.206349206,0,empty,CD-0722-1
"G12,C4",7910,8586,6041,2545,4118,1951,0,1953,1262,691,1.82633864,1094,2007,504,150,148,2,60,2,0.175675676,0,empty,CD-0722-1
"G12,C5",11380,12663,8519,4144,5954,2913,0,2917,1867,1050,1.778095238,1663,1668,323,154,151,3,61,2,0.026490066,0,empty,CD-0722-1
"G12,C6",9658,10710,7147,3563,5147,2584,0,2589,1671,918,1.820261438,1479,1820,533,219,218,1,67,1,0.142201835,0,empty,CD-0722-1
"G12,C7",13219,15677,9483,6194,7362,4137,0,4143,2522,1621,1.555829735,2556,630,152,57,57,0,24,0,0.228070175,0,empty,CD-0722-1
"G12,C8",14024,15641,10422,5219,7333,3622,0,3623,2428,1195,2.031799163,2096,3373,939,351,349,2,115,1,0,0,empty,CD-0722-1
"G12,C9",9766,10809,7305,3504,5180,2636,0,2642,1725,917,1.881134133,1503,1414,210,91,82,9,38,2,0.134146341,0,empty,CD-0722-1
"G12,C10",11402,12560,8726,3834,5958,2938,0,2945,1860,1085,1.714285714,1678,1798,363,133,127,6,48,2,0.047244094,0,empty,CD-0722-1
"G12,C11",9941,11242,7331,3911,5247,2624,0,2629,1688,941,1.793836344,1603,1992,414,162,161,1,61,1,0.080745342,0,empty,CD-0722-1
"G12,C12",13689,14986,10198,4788,7167,3490,0,3493,2331,1162,2.006024096,1994,1780,467,152,152,0,49,0,0.019736842,0,empty,CD-0722-1
"G12,D1",12059,13778,8839,4939,6619,3459,0,3473,2080,1393,1.493180187,2022,939,95,40,38,2,22,2,0,0,empty,CD-0722-1
"G12,D2",10037,10964,7738,3226,5157,2343,0,2349,1510,839,1.799761621,1301,2763,861,322,315,7,103,2,0.022222222,0,empty,CD-0722-1
"G12,D3",9152,9749,6728,3021,4866,2437,0,2437,1663,774,2.148578811,1387,1619,280,129,127,2,52,2,0,0,empty,CD-0722-1
"G12,D4",8587,9434,6536,2898,4512,2191,0,2195,1472,723,2.035961272,1225,1888,274,108,108,0,45,0,0.064814815,0,empty,CD-0722-1
"G12,D5",8647,9078,6477,2601,4417,2159,0,2159,1424,735,1.937414966,1180,1744,459,170,167,3,66,2,0.071856287,0,empty,CD-0722-1
"G12,D6",11842,13502,8580,4922,6284,3373,0,3381,2042,1339,1.525018671,1996,1804,492,202,195,7,49,1,0.138461538,0,empty,CD-0722-1
"G12,D7",6922,7341,5286,2055,3590,1707,0,1708,1106,602,1.837209302,930,1896,473,146,144,2,41,1,0.118055556,0,empty,CD-0722-1
"G12,D8",8221,8870,6262,2608,4098,1917,0,1919,1238,681,1.817914831,994,1583,371,124,123,1,38,1,0.113821138,0,empty,CD-0722-1
"G12,D9",4580,5038,3409,1629,2511,1179,0,1180,777,403,1.928039702,696,1784,429,158,157,1,57,1,0.063694268,0,empty,CD-0722-1
"G12,D10",7800,8655,5615,3040,3915,1934,0,1936,1212,724,1.674033149,1147,692,121,54,54,0,18,0,0.037037037,0,empty,CD-0722-1
"G12,D11",1381566,1577589,1054092,523497,715127,370738,5,371258,298263,72995,4.086074389,213232,280054,51089,16786,16543,243,2428,7,0.062866469,0,hg38,CD-0722-1
"G12,D12",11532,12853,8504,4349,5995,2994,0,2998,2059,939,2.192758253,1703,3116,655,259,256,3,93,2,0.02734375,0,empty,CD-0722-1
"G12,E1",14244,15681,10482,5199,7499,3806,0,3810,2482,1328,1.868975904,2178,3391,779,273,269,4,97,2,0.148698885,0,empty,CD-0722-1
"G12,E2",10323,11645,7612,4033,5584,2824,0,2827,1749,1078,1.62244898,1645,2072,482,132,132,0,57,0,0.015151515,0,empty,CD-0722-1
"G12,E3",7288,7840,5622,2218,3741,1765,0,1765,1160,605,1.917355372,913,2627,736,249,246,3,82,1,0.101626016,0,empty,CD-0722-1
"G12,E4",951752,1174411,684671,489740,534057,319071,1,319356,253560,65796,3.85372971,198809,161031,28009,9501,9325,176,1578,7,0.059088472,0,hg38,CD-0722-1
"G12,E5",8954,9596,6794,2802,4540,2125,1,2130,1335,795,1.679245283,1191,1896,421,153,153,0,48,0,0.071895425,0,empty,CD-0722-1
"G12,E6",14276,15431,10652,4779,7421,3690,0,3694,2376,1318,1.802731411,2044,3158,708,282,272,10,81,1,0.088235294,0,empty,CD-0722-1
"G12,E7",13505,14636,10294,4342,6899,3256,0,3259,2177,1082,2.012014787,1801,3046,809,336,332,4,96,2,0.078313253,0,empty,CD-0722-1
"G12,E8",11198,12142,8782,3360,5631,2584,0,2596,1736,860,2.018604651,1373,3195,757,267,266,1,71,1,0.078947368,0,empty,CD-0722-1
"G12,E9",501441,607316,353989,253327,282593,178988,4,179134,138068,41066,3.362100034,108465,38822,20358,6189,6177,12,927,3,0.014408289,0,hg38,CD-0722-1
"G12,E10",8068,8936,6138,2798,4142,1958,1,1959,1310,649,2.018489985,1105,1768,331,126,126,0,47,0,0.214285714,0,empty,CD-0722-1
"G12,E11",10156,11265,7630,3635,5282,2571,0,2576,1680,896,1.875,1482,2037,360,143,142,1,52,1,0.11971831,0,empty,CD-0722-1
"G12,E12",10404,11959,7696,4263,5550,2828,3,2831,1813,1018,1.780943026,1665,2183,621,203,202,1,57,1,0.103960396,0,empty,CD-0722-1
"G12,F1",816548,934227,606221,328006,425045,228395,2,228641,182308,46333,3.934733343,132714,94685,17177,5557,5474,83,1081,4,0.048045305,0,hg38,CD-0722-1
"G12,F2",9825,10581,7276,3305,5030,2415,0,2416,1573,843,1.865954923,1359,2725,540,209,207,2,87,1,0.024154589,0,empty,CD-0722-1
"G12,F3",9328,10435,6981,3454,4938,2380,0,2380,1572,808,1.945544554,1368,3140,531,185,183,2,60,2,0.038251366,0,empty,CD-0722-1
"G12,F4",14369,15261,10687,4574,7222,3483,1,3492,2235,1257,1.778042959,1919,742,200,76,75,1,23,1,0.2,0,empty,CD-0722-1
"G12,F5",11428,12343,8510,3833,5761,2712,0,2719,1741,978,1.780163599,1519,1850,389,160,158,2,68,1,0.006329114,0,empty,CD-0722-1
"G12,F6",590700,672636,443050,229586,312315,163519,3,163678,129226,34452,3.750899803,95656,83636,14297,4703,4617,86,897,2,0.02772363,0,hg38,CD-0722-1
"G12,F7",1051488,1209457,791096,418361,549912,295109,5,295436,250776,44660,5.615226153,171476,73943,11873,4041,3975,66,796,3,0.079245283,0,hg38,CD-0722-1
"G12,F8",8677,9572,6493,3079,4431,2119,0,2121,1370,751,1.824234354,1189,258,112,48,48,0,16,0,0.0625,0,empty,CD-0722-1
"G12,F9",10027,10849,7538,3311,5062,2329,0,2330,1520,810,1.87654321,1304,3441,837,271,268,3,69,1,0.070895522,0,empty,CD-0722-1
"G12,F10",1604229,1833396,1233120,600276,818426,432373,3,432894,359051,73843,4.862356621,244874,231716,35942,12391,12163,228,1829,6,0.094384609,0,hg38,CD-0722-1
"G12,F11",9685,10291,7488,2803,4800,2160,0,2165,1457,708,2.057909605,1112,2189,401,139,133,6,38,2,0.052631579,0,empty,CD-0722-1
"G12,F12",10587,11799,7924,3875,5442,2679,0,2688,1794,894,2.006711409,1524,160,6,5,5,0,5,0,0,0,empty,CD-0722-1
"G12,G1",12378,13888,9445,4443,6495,3068,1,3076,1939,1137,1.705364996,1774,3282,706,250,249,1,107,1,0.036144578,0,empty,CD-0722-1
"G12,G2",6918,7446,4984,2462,3543,1799,0,1800,1086,714,1.521008403,1007,399,91,34,34,0,17,0,0,0,empty,CD-0722-1
"G12,G3",12781,14265,9440,4825,6688,3450,0,3457,2114,1343,1.574087863,1924,3188,640,239,236,3,81,1,0.038135593,0,empty,CD-0722-1
"G12,G4",903780,1006539,692859,313680,458947,226661,1,226975,175357,51618,3.397206401,128034,3444,405,144,142,2,41,1,0.091549296,0,hg38,CD-0722-1
"G12,G5",838584,991690,610634,381056,454403,259598,1,259851,218744,41107,5.321332133,157372,150341,26282,8209,8045,164,1495,7,0.046364201,0,hg38,CD-0722-1
"G12,G6",11584,12408,8852,3556,5804,2770,0,2776,1789,987,1.812563323,1494,209,32,16,13,3,6,1,0,0,empty,CD-0722-1
"G12,G7",800052,887761,622024,265737,411389,197430,4,197648,146479,51169,2.862651215,110176,95304,10211,3512,3395,117,794,5,0.05832106,0,hg38,CD-0722-1
"G12,G8",6540,7253,4791,2462,3401,1671,0,1678,1060,618,1.715210356,973,2093,632,173,172,1,52,1,0.093023256,0,empty,CD-0722-1
"G12,G9",8142,8807,6071,2736,4244,2052,0,2055,1351,704,1.919034091,1165,2588,604,220,216,4,79,2,0.050925926,0,empty,CD-0722-1
"G12,G10",9727,10457,7422,3035,5062,2459,0,2466,1542,924,1.668831169,1350,2242,554,210,209,1,81,1,0.019138756,0,empty,CD-0722-1
"G12,G11",10254,11266,7803,3463,5425,2576,0,2581,1747,834,2.094724221,1453,1232,303,108,108,0,38,0,0.074074074,0,empty,CD-0722-1
"G12,G12",7907,9131,5864,3267,4357,2257,1,2263,1420,843,1.684460261,1332,2322,507,182,179,3,51,2,0.094972067,0,empty,CD-0722-1
"G12,H1",8137,9181,6042,3139,4314,2159,0,2167,1447,720,2.009722222,1284,1713,303,99,96,3,28,1,0.145833333,0,empty,CD-0722-1
"G12,H2",11075,12355,8254,4101,5794,2861,1,2874,1927,947,2.034846885,1679,2788,698,231,227,4,65,2,0.070484581,0,empty,CD-0722-1
"G12,H3",7656,8738,5617,3121,4182,2072,0,2078,1354,724,1.870165746,1245,2011,397,150,142,8,37,2,0.105633803,0,empty,CD-0722-1
"G12,H4",11586,12990,8704,4286,6008,2915,2,2918,1900,1018,1.866404715,1697,214,74,32,32,0,13,0,0.34375,0,empty,CD-0722-1
"G12,H5",1201951,1364925,910420,454505,614901,327626,8,328016,263068,64948,4.050440352,188337,59485,11605,3581,3523,58,731,3,0.019301731,0,hg38,CD-0722-1
"G12,H6",7469,8346,5453,2893,3975,2030,0,2035,1292,743,1.738896366,1192,1932,341,91,90,1,34,1,0.066666667,0,empty,CD-0722-1
"G12,H7",9263,10421,6832,3589,4825,2361,1,2367,1518,849,1.787985866,1401,1729,557,245,245,0,63,0,0.057142857,0,empty,CD-0722-1
"G12,H8",740053,863748,545168,318580,395084,218972,4,219201,181677,37524,4.841621362,130465,100545,10946,3364,3190,174,750,7,0.082131661,0,hg38,CD-0722-1
"G12,H9",9085,10074,6857,3217,4639,2195,0,2199,1545,654,2.362385321,1255,1037,283,104,103,1,33,1,0.116504854,0,empty,CD-0722-1
"G12,H10",7644,8562,5655,2907,4080,2009,0,2018,1380,638,2.163009404,1167,1159,259,86,81,5,30,1,0.024691358,0,empty,CD-0722-1
"G12,H11",8548,9606,5991,3615,4701,2840,0,2841,1569,1272,1.233490566,1713,40,6,4,4,0,3,0,0,0,empty,CD-0722-1
"G12,H12",7662,8434,5562,2872,3993,2105,1,2107,1391,716,1.94273743,1173,1510,258,107,106,1,44,1,0.103773585,0,empty,CD-0722-1
"H1,A1",9208,10256,6770,3486,4867,2481,0,2483,1607,876,1.834474886,1472,1457,282,114,113,1,34,1,0.345132743,0,empty,CD-0722-1
"H1,A2",15727,17635,11624,6011,8224,4210,0,4215,2615,1600,1.634375,2404,1926,498,183,179,4,55,1,0.033519553,0,empty,CD-0722-1
"H1,A3",8332,9264,6218,3046,4326,2192,0,2199,1364,835,1.633532934,1267,1330,258,72,72,0,18,0,0.138888889,0,empty,CD-0722-1
"H1,A4",12715,14049,9579,4470,6575,3172,1,3175,1997,1178,1.69524618,1804,758,148,74,72,2,36,1,0.041666667,0,empty,CD-0722-1
"H1,A5",13262,14556,9823,4733,6924,3394,0,3397,2121,1276,1.662225705,1938,2111,465,166,164,2,68,1,0.054878049,0,empty,CD-0722-1
"H1,A6",11326,13139,8279,4860,6209,3274,0,3279,2100,1179,1.781170483,1967,2452,633,260,256,4,88,1,0.09375,0,empty,CD-0722-1
"H1,A7",9158,10731,6678,4053,5012,2676,0,2676,1721,955,1.802094241,1630,1512,369,121,120,1,46,1,0.075,0,empty,CD-0722-1
"H1,A8",5584,6274,4104,2170,3052,1535,0,1538,1005,533,1.885553471,906,2035,511,183,180,3,59,2,0.111111111,0,empty,CD-0722-1
"H1,A9",10477,11458,7944,3514,5469,2723,0,2723,1776,947,1.875395987,1511,1872,337,145,144,1,49,1,0.055555556,0,empty,CD-0722-1
"H1,A10",13457,14641,10252,4389,6848,3335,0,3341,2049,1292,1.585913313,1836,419,124,40,39,1,11,1,0.128205128,0,empty,CD-0722-1
"H1,A11",9542,10492,7183,3309,4962,2384,0,2396,1579,817,1.932680539,1332,1980,424,147,146,1,57,1,0.006849315,0,empty,CD-0722-1
"H1,A12",13316,14786,10178,4608,6708,3195,0,3199,1997,1202,1.661397671,1784,8555,2008,585,573,12,153,2,0.02617801,0,empty,CD-0722-1
"H1,B1",10330,11287,7812,3475,5282,2619,1,2624,1567,1057,1.482497635,1490,1280,210,81,79,2,29,1,0.151898734,0,empty,CD-0722-1
"H1,B2",9687,10478,6640,3838,5062,2708,0,2716,1708,1008,1.694444444,1669,844,176,73,67,6,25,2,0.014925373,0,empty,CD-0722-1
"H1,B3",8674,9615,6381,3234,4612,2368,0,2371,1483,888,1.670045045,1352,1431,349,127,125,2,36,1,0,0,empty,CD-0722-1
"H1,B4",11533,13586,8377,5209,6506,3618,0,3625,2210,1415,1.561837456,2222,1680,456,159,158,1,57,1,0.17721519,0,empty,CD-0722-1
"H1,B5",9353,5193,3136,2057,3301,1776,0,1787,1151,636,1.809748428,1116,896,215,89,88,1,25,1,0,0,empty,CD-0722-1
"H1,B6",11808,13077,8700,4377,6202,3341,0,3346,2033,1313,1.548362529,1919,1468,285,116,115,1,37,1,0.095652174,0,empty,CD-0722-1
"H1,B7",1003164,1179866,753265,426601,536386,293245,4,293544,228778,64766,3.5323781,173122,68245,9917,3313,3226,87,651,5,0.053626782,0,hg38,CD-0722-1
"H1,B8",8239,9146,6230,2916,4351,2149,0,2156,1428,728,1.961538462,1209,766,181,78,78,0,38,0,0.051282051,0,empty,CD-0722-1
"H1,B9",15338,17442,11156,6286,8093,4350,0,4357,2674,1683,1.588829471,2527,894,150,71,71,0,27,0,0.070422535,0,empty,CD-0722-1
"H1,B10",7065,7581,5182,2399,3797,1885,0,1893,1227,666,1.842342342,1092,294,52,25,25,0,11,0,0.32,0,empty,CD-0722-1
"H1,B11",17115,19914,12350,7564,9178,5138,0,5144,2871,2273,1.263088429,3149,148,37,11,11,0,8,0,0,0,empty,CD-0722-1
"H1,B12",9465,10594,7082,3512,5083,2504,0,2505,1606,899,1.786429366,1465,3758,802,241,235,6,72,4,0.068085106,0,empty,CD-0722-1
"H1,C1",16558,18320,12545,5775,8386,4084,0,4086,2554,1532,1.667101828,2290,1099,283,100,99,1,33,1,0.02020202,0,empty,CD-0722-1
"H1,C2",13431,15191,9980,5211,6975,3535,0,3543,2209,1334,1.655922039,2093,2024,362,123,114,9,37,1,0.096491228,0,empty,CD-0722-1
"H1,C3",15996,17907,11904,6003,8590,4385,0,4392,2864,1528,1.87434555,2511,1238,145,73,72,1,19,1,0,0,empty,CD-0722-1
"H1,C4",10602,11784,8093,3691,5444,2567,0,2571,1671,900,1.856666667,1402,2034,578,218,214,4,54,2,0.107476636,0,empty,CD-0722-1
"H1,C5",15716,17944,11711,6233,8468,4360,0,4366,2998,1368,2.191520468,2590,2210,544,194,190,4,59,1,0.094736842,0,empty,CD-0722-1
"H1,C6",12295,13653,9011,4642,6461,3275,0,3281,2152,1129,1.906111603,1883,1659,502,181,181,0,56,0,0.044198895,0,empty,CD-0722-1
"H1,C7",16225,19067,11618,7449,8741,4999,0,5006,2991,2015,1.484367246,2988,577,106,57,56,1,20,1,0,0,empty,CD-0722-1
"H1,C8",18445,20724,13880,6844,9660,4903,0,4907,3099,1808,1.714048673,2803,3681,942,300,294,6,84,3,0.12244898,0,empty,CD-0722-1
"H1,C9",13551,15436,10325,5111,6990,3509,0,3511,2231,1280,1.74296875,2024,1439,208,100,97,3,41,1,0.041237113,0,empty,CD-0722-1
"H1,C10",13032,14248,9873,4375,6623,3140,0,3147,1998,1149,1.738903394,1785,2323,504,174,169,5,68,1,0.076923077,0,empty,CD-0722-1
"H1,C11",11356,12627,8634,3993,5995,2918,0,2926,1913,1013,1.888450148,1656,1685,322,159,159,0,59,0,0.144654088,0,empty,CD-0722-1
"H1,C12",17505,19408,13089,6319,8972,4322,0,4331,2904,1427,2.035038542,2484,4425,1049,283,283,0,74,0,0.088339223,0,empty,CD-0722-1
"H1,D1",15689,17930,11087,6843,8320,4655,0,4660,2747,1913,1.435964454,2763,839,116,44,42,2,16,2,0.071428571,0,empty,CD-0722-1
"H1,D2",10748,11713,8253,3460,5700,2636,0,2637,1706,931,1.832438238,1416,2772,886,309,309,0,81,0,0.029126214,0,empty,CD-0722-1
"H1,D3",11952,13712,8659,5053,6308,3263,0,3273,2052,1221,1.680589681,1948,1479,273,99,99,0,28,0,0.282828283,0,empty,CD-0722-1
"H1,D4",1019950,1181180,779262,401918,535229,282886,0,283187,216742,66445,3.26197607,165099,50882,6023,1836,1793,43,475,4,0.034578918,0,hg38,CD-0722-1
"H1,D5",10012,11203,7383,3820,5391,2622,0,2632,1736,896,1.9375,1569,1893,384,126,125,1,50,1,0.192,0,empty,CD-0722-1
"H1,D6",797256,943326,580775,362551,430761,245350,2,245599,196139,49460,3.965608573,148346,114233,19896,6727,6628,99,1177,7,0.044357272,0,hg38,CD-0722-1
"H1,D7",8673,9829,6535,3294,4559,2188,1,2191,1443,748,1.929144385,1299,2617,658,208,204,4,42,2,0.107843137,0,empty,CD-0722-1
"H1,D8",971644,1141951,728198,413753,516936,279061,4,279372,220804,58568,3.770045076,166001,93404,12286,4021,3912,109,830,6,0.041155419,0,hg38,CD-0722-1
"H1,D9",5963,6441,4466,1975,3078,1480,0,1482,1036,446,2.322869955,794,1730,379,134,130,4,46,2,0.015384615,0,empty,CD-0722-1
"H1,D10",9808,11173,7234,3939,5139,2655,0,2657,1667,990,1.683838384,1512,975,389,110,108,2,24,1,0.055555556,0,empty,CD-0722-1
"H1,D11",11711,13011,8977,4034,6230,3036,0,3038,1990,1048,1.898854962,1697,3035,859,292,284,8,88,2,0.042253521,0,empty,CD-0722-1
"H1,D12",2658715,3172279,1979986,1192293,1387831,808119,13,809004,658615,150389,4.379409398,483771,546468,91839,30360,29798,562,3603,10,0.061614873,0,hg38,CD-0722-1
"H1,E1",18922,21486,14050,7436,10077,5147,0,5148,3163,1985,1.593450882,3023,2973,660,271,268,3,75,1,0.108208955,0,empty,CD-0722-1
"H1,E2",12821,14256,9413,4843,6687,3392,2,3397,2093,1304,1.60506135,1949,1764,382,118,115,3,50,1,0.07826087,0,empty,CD-0722-1
"H1,E3",8589,9597,6571,3026,4517,2146,0,2152,1366,786,1.737913486,1202,2027,519,203,202,1,70,1,0.024752475,0,empty,CD-0722-1
"H1,E4",11188,12182,8332,3850,5812,2819,0,2824,1833,991,1.849646821,1543,2276,476,202,194,8,72,2,0.12371134,0,empty,CD-0722-1
"H1,E5",9496,10543,7251,3292,5022,2406,0,2415,1504,911,1.650933041,1370,1280,320,123,121,2,42,2,0.05785124,0,empty,CD-0722-1
"H1,E6",18875,21483,14209,7274,9839,5030,3,5044,3192,1852,1.723542117,2944,2860,562,206,204,2,69,2,0.068627451,0,empty,CD-0722-1
"H1,E7",20287,21844,15190,6654,10287,4958,0,4963,3225,1738,1.855581128,2706,5583,804,321,314,7,94,3,0.162420382,0,empty,CD-0722-1
"H1,E8",13276,14710,10120,4590,6716,3197,0,3201,2026,1175,1.724255319,1794,3365,760,231,228,3,61,2,0.013157895,0,empty,CD-0722-1
"H1,E9",461066,605339,297880,307459,286443,207826,0,207979,116778,91201,1.280446486,136072,3394,758,238,238,0,97,0,0.105042017,0,hg38,CD-0722-1
"H1,E10",9309,10277,7075,3202,4808,2289,0,2296,1470,826,1.779661017,1267,1979,687,194,193,1,64,1,0.067357513,0,empty,CD-0722-1
"H1,E11",12028,13561,8990,4571,6395,3230,0,3237,2107,1130,1.86460177,1876,1950,400,147,146,1,48,1,0.02739726,0,empty,CD-0722-1
"H1,E12",13147,14853,9714,5139,6967,3477,0,3481,2277,1204,1.891196013,2033,2013,518,189,188,1,61,1,0.117021277,0,empty,CD-0722-1
"H1,F1",14963,16293,11157,5136,7590,3729,1,3732,2413,1319,1.829416224,2149,2179,671,207,202,5,61,3,0.069306931,0,empty,CD-0722-1
"H1,F2",765938,926823,531383,395440,427230,275065,5,275297,218175,57122,3.819456602,167728,57816,31897,9242,9226,16,1167,3,0.008237589,0,hg38,CD-0722-1
"H1,F3",43472,49394,31696,17698,22053,12067,0,12081,8147,3934,2.070920183,7065,5057,733,241,237,4,82,2,0.160337553,0,empty,CD-0722-1
"H1,F4",858806,1037320,589918,447402,480629,316142,13,316467,199755,116712,1.711520666,192972,620,151,59,58,1,27,1,0.137931034,0,empty,CD-0722-1
"H1,F5",11943,12920,9025,3895,6143,2952,0,2952,1939,1013,1.914116486,1658,1579,484,150,149,1,53,1,0.040268456,0,empty,CD-0722-1
"H1,F6",1074574,1246744,804709,442035,561088,306489,2,306834,234821,72013,3.26081402,180712,111832,15888,5397,5264,133,1009,3,0.054331307,0,hg38,CD-0722-1
"H1,F7",15753,17649,11714,5935,8112,4072,0,4076,2571,1505,1.708305648,2366,1028,296,115,114,1,47,1,0.043859649,0,empty,CD-0722-1
"H1,F8",11326,12528,8421,4107,5900,2928,0,2931,1871,1060,1.76509434,1687,151,10,9,9,0,8,0,0.111111111,0,empty,CD-0722-1
"H1,F9",12751,14038,9711,4327,6422,2969,0,2969,2011,958,2.099164927,1646,2635,745,243,240,3,78,1,0.066666667,0,empty,CD-0722-1
"H1,F10",13606,14791,10459,4332,6879,3180,0,3185,2063,1122,1.838680927,1724,884,202,61,61,0,23,0,0,0,empty,CD-0722-1
"H1,F11",13995,15115,10855,4260,6933,3198,1,3201,2049,1152,1.778645833,1709,1438,362,126,120,6,32,2,0.325,0,empty,CD-0722-1
"H1,F12",13220,14872,9954,4918,6739,3366,0,3369,2221,1148,1.93466899,1949,208,27,17,17,0,12,0,0,0,empty,CD-0722-1
"H1,G1",15657,17860,11537,6323,8247,4357,0,4359,2814,1545,1.821359223,2497,2869,735,256,249,7,88,2,0.068273092,0,empty,CD-0722-1
"H1,G2",1588734,1928167,1109315,818852,876553,541254,2,541716,447146,94570,4.728201332,335156,35142,9032,2805,2778,27,581,4,0.043916487,0,hg38,CD-0722-1
"H1,G3",15127,16447,11183,5264,7740,3990,0,3993,2448,1545,1.584466019,2234,2510,638,229,229,0,83,0,0.109170306,0,empty,CD-0722-1
"H1,G4",27421,31469,19810,11659,14654,8268,0,8276,4960,3316,1.495778046,4854,144,41,8,8,0,6,0,0,0,empty,CD-0722-1
"H1,G5",9372,10611,7030,3581,4965,2483,0,2486,1595,891,1.790123457,1466,1668,373,134,129,5,56,2,0.031007752,0,empty,CD-0722-1
"H1,G6",12814,14337,9584,4753,6585,3283,1,3287,2161,1126,1.919182948,1888,299,40,19,19,0,10,0,0.052631579,0,empty,CD-0722-1
"H1,G7",11407,12404,8650,3754,5865,2754,0,2758,1732,1026,1.688109162,1553,2604,806,219,216,3,76,1,0.046296296,0,empty,CD-0722-1
"H1,G8",7958,8544,5879,2665,4098,1963,0,1967,1276,691,1.846599132,1118,1856,474,165,160,5,32,2,0.1375,0,empty,CD-0722-1
"H1,G9",10172,11597,7483,4114,5367,2779,0,2783,1814,969,1.872033024,1645,2497,450,175,174,1,68,1,0.097701149,0,empty,CD-0722-1
"H1,G10",1033907,1139834,809716,330118,514422,245623,0,245931,194666,51265,3.797249585,135426,102805,21271,6667,6578,89,1144,6,0.029644269,0,hg38,CD-0722-1
"H1,G11",944020,1060655,729940,330715,480498,237460,3,237743,180140,57603,3.127267677,135588,85369,14222,4521,4432,89,825,4,0.042644404,0,hg38,CD-0722-1
"H1,G12",813383,965224,601844,363380,441977,248099,3,248308,205983,42325,4.866698169,149292,65242,13834,4456,4416,40,893,5,0.027626812,0,hg38,CD-0722-1
"H1,H1",11228,12853,8342,4511,6027,3010,0,3013,1889,1124,1.680604982,1787,1128,229,87,85,2,31,1,0,0,empty,CD-0722-1
"H1,H2",11196,12622,8186,4436,5736,2838,0,2843,1806,1037,1.741562199,1653,2180,544,217,217,0,63,0,0.059907834,0,empty,CD-0722-1
"H1,H3",10029,11371,7496,3875,5248,2675,0,2675,1685,990,1.702020202,1575,1632,351,149,149,0,55,0,0.053691275,0,empty,CD-0722-1
"H1,H4",14453,16176,10819,5357,7318,3530,0,3541,2306,1235,1.867206478,2013,268,100,22,22,0,7,0,0,0,empty,CD-0722-1
"H1,H5",14194,15751,10534,5217,7282,3638,0,3644,2357,1287,1.831390831,2122,2254,653,182,181,1,57,1,0.071823204,0,empty,CD-0722-1
"H1,H6",10667,12219,7927,4292,5596,2945,0,2951,1947,1004,1.939243028,1699,1576,349,133,132,1,39,1,0.03030303,0,empty,CD-0722-1
"H1,H7",12286,13378,9108,4270,6350,3086,0,3090,2063,1027,2.008763389,1783,2495,534,203,199,4,65,2,0.105527638,0,empty,CD-0722-1
"H1,H8",19849,23711,13961,9750,11302,6820,0,6824,4068,2756,1.47605225,4259,1662,352,125,125,0,41,0,0.216,0,empty,CD-0722-1
"H1,H9",10054,11277,7724,3553,5226,2498,0,2503,1644,859,1.913853318,1454,1094,245,99,98,1,32,1,0.020408163,0,empty,CD-0722-1
"H1,H10",8965,9821,6811,3010,4568,2202,0,2204,1472,732,2.010928962,1213,1470,182,92,92,0,31,0,0.065217391,0,empty,CD-0722-1
"H1,H11",18831,20402,12262,8140,9656,5891,1,5900,3543,2357,1.503182011,3568,145,21,4,4,0,4,0,0.25,0,empty,CD-0722-1
"H1,H12",11203,12464,8372,4092,5841,2915,0,2921,1877,1044,1.79789272,1677,2536,469,166,164,2,54,1,0.073170732,0,empty,CD-0722-1
"H2,A1",7904,8814,5808,3006,4240,2201,0,2204,1405,799,1.75844806,1253,1368,247,84,83,1,27,1,0.072289157,0,empty,CD-0722-1
"H2,A2",13376,14604,9878,4726,6979,3565,0,3578,2257,1321,1.708554126,2008,1817,379,137,137,0,58,0,0.058394161,0,empty,CD-0722-1
"H2,A3",6821,7669,5054,2615,3743,1864,0,1867,1222,645,1.894573643,1106,1085,370,108,108,0,38,0,0.138888889,0,empty,CD-0722-1
"H2,A4",10946,12356,8143,4213,5883,2979,0,2981,1926,1055,1.825592417,1738,708,108,44,40,4,23,1,0.025,0,empty,CD-0722-1
"H2,A5",11095,11981,8425,3556,5869,2859,0,2863,1804,1059,1.703493862,1590,2048,451,156,155,1,60,1,0.019354839,0,empty,CD-0722-1
"H2,A6",385099,476316,276395,199921,224202,143605,4,143724,103034,40690,2.532170066,86767,7246,1003,331,321,10,108,2,0.07165109,0,hg38,CD-0722-1
"H2,A7",7679,8590,5630,2960,4197,2227,0,2227,1459,768,1.899739583,1290,1223,206,107,106,1,34,1,0.113207547,0,empty,CD-0722-1
"H2,A8",4970,5421,3621,1800,2802,1413,0,1414,988,426,2.319248826,831,2170,514,167,166,1,64,1,0.06626506,0,empty,CD-0722-1
"H2,A9",8856,9805,6802,3003,4644,2218,0,2224,1498,726,2.063360882,1244,1646,316,135,133,2,56,2,0.015037594,0,empty,CD-0722-1
"H2,A10",10972,11766,8338,3428,5665,2798,0,2798,1778,1020,1.743137255,1537,327,23,17,16,1,11,1,0,0,empty,CD-0722-1
"H2,A11",1646525,1908420,1256920,651500,863632,464290,8,464871,382911,81960,4.671925329,267692,309198,35089,11394,11060,334,1937,9,0.055605787,0,hg38,CD-0722-1
"H2,A12",11298,12530,8560,3970,5738,2799,3,2805,1792,1013,1.769002962,1570,3253,803,266,266,0,82,0,0.033834586,0,empty,CD-0722-1
"H2,B1",8277,9540,6069,3471,4377,2288,0,2290,1428,862,1.656612529,1347,931,227,88,88,0,33,0,0.022727273,0,empty,CD-0722-1
"H2,B2",8048,9059,5606,3453,4324,2348,1,2349,1474,875,1.684571429,1450,664,142,40,40,0,23,0,0,0,empty,CD-0722-1
"H2,B3",1052101,1260250,777880,482370,576664,327084,0,327413,260319,67094,3.879914746,198376,131032,20121,6529,6351,178,1136,7,0.079515037,0,hg38,CD-0722-1
"H2,B4",9680,10958,7103,3855,5316,2847,0,2847,1769,1078,1.641001855,1667,1241,277,102,102,0,44,0,0.166666667,0,empty,CD-0722-1
"H2,B5",7881,4297,2466,1831,2822,1557,1,1575,1001,574,1.743902439,1058,773,136,61,60,1,17,1,0.166666667,0,empty,CD-0722-1
"H2,B6",9865,11327,7066,4261,5459,3007,0,3014,1916,1098,1.744990893,1792,1712,554,177,176,1,38,1,0.096590909,0,empty,CD-0722-1
"H2,B7",8065,9239,5976,3263,4377,2168,0,2175,1371,804,1.705223881,1267,1105,364,124,124,0,30,0,0.008064516,0,empty,CD-0722-1
"H2,B8",6798,7612,5007,2605,3659,1834,0,1834,1171,663,1.766214178,1067,1448,411,160,159,1,45,1,0.106918239,0,empty,CD-0722-1
"H2,B9",12574,14370,9255,5115,6712,3586,0,3592,2169,1423,1.524244554,2115,911,249,103,100,3,31,2,0,0,empty,CD-0722-1
"H2,B10",6413,6818,4607,2211,3429,1722,0,1725,1092,633,1.725118483,999,397,52,26,26,0,8,0,0,0,empty,CD-0722-1
"H2,B11",14233,16069,10314,5755,7735,4333,0,4339,2409,1930,1.248186528,2603,276,45,19,18,1,6,1,0,0,empty,CD-0722-1
"H2,B12",8140,8967,6067,2900,4193,2025,0,2029,1311,718,1.825905292,1176,1423,352,92,92,0,33,0,0.173913043,0,empty,CD-0722-1
"H2,C1",14001,15281,10702,4579,7291,3486,0,3489,2147,1342,1.599850969,1929,1387,359,117,115,2,37,2,0.052173913,0,empty,CD-0722-1
"H2,C2",11442,12802,8567,4235,5884,2949,0,2953,1887,1066,1.770168856,1694,1882,499,188,184,4,56,2,0.179347826,0,empty,CD-0722-1
"H2,C3",600640,743835,421733,322102,352231,221161,4,221350,183713,37637,4.881180753,138724,2552,1062,292,287,5,80,1,0.020905923,0,hg38,CD-0722-1
"H2,C4",8585,9559,6553,3006,4677,2227,0,2234,1459,775,1.882580645,1290,1737,352,159,159,0,57,0,0.094339623,0,empty,CD-0722-1
"H2,C5",13358,14953,10049,4904,7002,3398,0,3400,2230,1170,1.905982906,1980,2453,580,233,226,7,66,2,0.154867257,0,empty,CD-0722-1
"H2,C6",10103,11577,7393,4184,5573,2835,0,2840,1801,1039,1.733397498,1662,1915,387,153,149,4,63,2,0.006711409,0,empty,CD-0722-1
"H2,C7",13615,15879,9644,6235,7558,4294,0,4303,2460,1843,1.33478025,2681,531,139,54,53,1,25,1,0.094339623,0,empty,CD-0722-1
"H2,C8",15425,16973,11735,5238,8007,4003,1,4007,2569,1438,1.78650904,2242,3221,857,263,259,4,85,2,0.011583012,0,empty,CD-0722-1
"H2,C9",11383,12765,8408,4357,6027,3051,0,3061,1969,1092,1.803113553,1773,1672,310,113,111,2,39,1,0.036036036,0,empty,CD-0722-1
"H2,C10",11339,12356,8613,3743,6015,2910,0,2914,1929,985,1.958375635,1665,1928,437,152,151,1,53,1,0.059602649,0,empty,CD-0722-1
"H2,C11",10012,11137,7410,3727,5184,2537,0,2545,1646,899,1.830923248,1477,1617,368,165,164,1,48,1,0.018292683,0,empty,CD-0722-1
"H2,C12",15044,16511,11096,5415,7804,3871,0,3877,2474,1403,1.76336422,2204,1571,265,105,105,0,38,0,0,0,empty,CD-0722-1
"H2,D1",14393,16362,10206,6156,7778,4375,0,4380,2597,1783,1.456533932,2664,897,194,53,53,0,19,0,0.075471698,0,empty,CD-0722-1
"H2,D2",9536,10568,7355,3213,5040,2397,1,2401,1577,824,1.913834951,1324,2821,441,205,205,0,82,0,0.03902439,0,empty,CD-0722-1
"H2,D3",795687,910957,605303,305654,420489,216116,1,216398,167425,48973,3.418720519,125800,93079,13389,4503,4412,91,814,4,0.070716228,0,hg38,CD-0722-1
"H2,D4",7179,8037,5393,2644,4001,1990,0,1990,1335,655,2.038167939,1159,1281,294,134,133,1,36,1,0.308270677,0,empty,CD-0722-1
"H2,D5",8623,9655,6318,3337,4585,2296,0,2298,1453,845,1.719526627,1338,2085,585,241,238,3,77,2,0.088235294,0,empty,CD-0722-1
"H2,D6",12624,14405,9057,5348,6791,3779,0,3785,2248,1537,1.46258946,2223,1863,366,115,115,0,39,0,0.008695652,0,empty,CD-0722-1
"H2,D7",7000,7680,5321,2359,3721,1770,1,1775,1124,651,1.726574501,1054,1565,341,153,150,3,52,2,0.046666667,0,empty,CD-0722-1
"H2,D8",8535,9394,6270,3124,4695,2354,1,2357,1541,816,1.888480392,1368,1158,126,60,60,0,33,0,0.1,0,empty,CD-0722-1
"H2,D9",5798,6321,4354,1967,3126,1492,0,1498,1032,466,2.214592275,870,1666,456,196,193,3,55,2,0.041450777,0,empty,CD-0722-1
"H2,D10",7536,8526,5581,2945,4026,2094,0,2094,1353,741,1.825910931,1224,761,149,41,41,0,23,0,0.048780488,0,empty,CD-0722-1
"H2,D11",10411,11521,7880,3641,5450,2547,1,2559,1623,936,1.733974359,1466,3251,768,282,277,5,88,2,0.010830325,0,empty,CD-0722-1
"H2,D12",1073742,1259625,800325,459300,570635,316311,2,316637,256057,60580,4.226758006,186393,124436,14112,4406,4286,120,1049,7,0.026598227,0,hg38,CD-0722-1
"H2,E1",15943,17847,11891,5956,8421,4255,3,4265,2643,1622,1.62946979,2395,2897,582,195,192,3,78,2,0.15625,0,empty,CD-0722-1
"H2,E2",10942,12159,7901,4258,5781,2931,1,2932,1863,1069,1.742750234,1703,1835,277,130,129,1,48,1,0.069767442,0,empty,CD-0722-1
"H2,E3",6940,8038,5251,2787,3851,1928,0,1929,1259,670,1.879104478,1118,2202,533,188,184,4,64,2,0.054347826,0,empty,CD-0722-1
"H2,E4",9986,11372,7309,4063,5406,2673,4,2685,1645,1040,1.581730769,1600,2650,822,227,221,6,67,2,0.135746606,0,empty,CD-0722-1
"H2,E5",999111,1155114,755760,399354,524926,278853,2,279241,223360,55881,3.997065192,161938,127733,22476,7336,7202,134,1241,9,0.053040822,0,hg38,CD-0722-1
"H2,E6",15941,17728,11678,6050,8301,4204,0,4206,2681,1525,1.758032787,2495,3547,767,246,239,7,77,2,0.058577406,0,empty,CD-0722-1
"H2,E7",2763803,3322230,2040148,1282082,1460009,892758,5,893702,690671,203031,3.40180071,530415,160100,23822,7651,7501,150,1493,7,0.102786295,0,hg38,CD-0722-1
"H2,E8",11036,11983,8434,3549,5625,2615,0,2616,1743,873,1.996563574,1430,2574,684,200,194,6,71,2,0.097938144,0,empty,CD-0722-1
"H2,E9",8508,9387,6412,2975,4544,2211,0,2220,1449,771,1.879377432,1263,2260,507,202,202,0,75,0,0.173267327,0,empty,CD-0722-1
"H2,E10",8281,9018,6173,2845,4411,2152,1,2157,1391,766,1.815926893,1211,1475,345,130,130,0,51,0,0.030769231,0,empty,CD-0722-1
"H2,E11",763334,863261,585699,277562,400841,200417,6,200673,150302,50371,2.983899466,115293,236680,22100,7546,7246,300,1285,7,0.077146012,0,hg38,CD-0722-1
"H2,E12",11639,13166,8594,4572,6108,3119,0,3119,2047,1072,1.909514925,1794,2029,261,80,73,7,40,1,0.02739726,0,empty,CD-0722-1
"H2,F1",12502,13319,9325,3994,6381,2970,0,2973,1887,1086,1.737569061,1639,2073,443,151,148,3,54,1,0.054054054,0,empty,CD-0722-1
"H2,F2",11345,12232,8429,3803,5971,2973,1,2977,1953,1024,1.907226563,1691,2751,726,290,290,0,94,0,0.024137931,0,empty,CD-0722-1
"H2,F3",9844,10770,7472,3298,5227,2536,0,2536,1647,889,1.85264342,1428,2798,580,200,200,0,72,0,0.09,0,empty,CD-0722-1
"H2,F4",14082,14779,10395,4384,7089,3426,1,3438,2337,1101,2.122615804,1910,619,146,49,49,0,25,0,0.020408163,0,empty,CD-0722-1
"H2,F5",10016,10686,7564,3122,5166,2406,0,2409,1616,793,2.037831021,1323,1745,428,134,133,1,49,1,0.015037594,0,empty,CD-0722-1
"H2,F6",704158,875523,482622,392901,406373,271863,3,272120,197475,74645,2.645522138,169668,10192,1184,339,334,5,108,1,0.143712575,0,hg38,CD-0722-1
"H2,F7",12936,14472,9559,4913,7102,3593,0,3601,2400,1201,1.998334721,2096,1106,265,131,131,0,51,0,0.045801527,0,empty,CD-0722-1
"H2,F8",9097,9914,6923,2991,4660,2266,0,2267,1537,730,2.105479452,1239,303,46,23,23,0,11,0,0.347826087,0,empty,CD-0722-1
"H2,F9",1001028,1143027,761027,382000,519531,260583,6,260862,218537,42325,5.163307738,151809,25701,9660,2637,2624,13,761,2,0.044969512,0,hg38,CD-0722-1
"H2,F10",11762,12735,9099,3636,5986,2843,0,2844,1850,994,1.861167002,1520,1840,323,120,120,0,38,0,0.175,0,empty,CD-0722-1
"H2,F11",31458,36478,24358,12120,16850,8801,0,8809,6814,1995,3.415538847,4939,1634,330,125,117,8,46,3,0.008547009,0,empty,CD-0722-1
"H2,F12",884893,1038856,653083,385773,470141,259387,1,259698,201088,58610,3.43095035,156635,9712,1573,479,458,21,107,2,0.06768559,0,hg38,CD-0722-1
"H2,G1",11835,13219,8808,4411,6400,3113,0,3120,2040,1080,1.888888889,1823,2493,614,261,258,3,92,1,0.069767442,0,empty,CD-0722-1
"H2,G2",6749,7267,4874,2393,3714,1945,0,1945,1272,673,1.890044577,1121,337,88,16,16,0,8,0,0,0,empty,CD-0722-1
"H2,G3",13102,14198,9782,4416,6881,3450,0,3454,2189,1265,1.730434783,1895,2695,796,327,324,3,107,2,0.012345679,0,empty,CD-0722-1
"H2,G4",1081461,1283556,783259,500297,583619,355351,0,355654,233765,121889,1.917851488,213777,122,12,10,10,0,9,0,0,0,empty,CD-0722-1
"H2,G5",7828,9143,5773,3370,4301,2232,0,2234,1384,850,1.628235294,1390,1759,463,143,140,3,51,1,0.085714286,0,empty,CD-0722-1
"H2,G6",10925,11965,8321,3644,5675,2751,0,2763,1766,997,1.771313942,1535,283,75,28,28,0,10,0,0.107142857,0,empty,CD-0722-1
"H2,G7",9710,10535,7247,3288,4972,2340,0,2343,1527,816,1.871323529,1302,2464,388,184,182,2,70,2,0.010989011,0,empty,CD-0722-1
"H2,G8",7282,7762,5390,2372,3833,1881,0,1882,1261,621,2.030595813,1062,1261,330,123,122,1,43,1,0,0,empty,CD-0722-1
"H2,G9",8472,9370,6332,3038,4542,2248,0,2250,1485,765,1.941176471,1271,2325,405,179,178,1,64,1,0.050561798,0,empty,CD-0722-1
"H2,G10",10803,11975,8100,3875,5561,2728,0,2728,1732,996,1.738955823,1562,2255,646,223,222,1,86,1,0.108108108,0,empty,CD-0722-1
"H2,G11",1325707,1525967,1019205,506762,689869,361047,3,361462,298782,62680,4.766783663,207120,118296,19126,6056,5964,92,1159,4,0.065392354,0,hg38,CD-0722-1
"H2,G12",879635,1125428,613630,511798,529834,339862,0,340107,264983,75124,3.527274905,218128,46470,16008,4869,4852,17,976,2,0.045754328,0,hg38,CD-0722-1
"H2,H1",10267,11191,7628,3563,5301,2579,0,2587,1657,930,1.78172043,1447,1306,373,142,141,1,30,1,0.184397163,0,empty,CD-0722-1
"H2,H2",9790,10523,7151,3372,4859,2386,0,2389,1567,822,1.906326034,1353,2053,372,133,130,3,49,2,0.146153846,0,empty,CD-0722-1
"H2,H3",8550,9587,6420,3167,4532,2321,0,2331,1469,862,1.704176334,1299,1547,200,68,68,0,26,0,0.073529412,0,empty,CD-0722-1
"H2,H4",12411,13823,9177,4646,6564,3307,3,3316,2167,1149,1.885987815,1900,245,36,17,17,0,8,0,0.058823529,0,empty,CD-0722-1
"H2,H5",12129,13447,9028,4419,6307,3164,0,3167,2004,1163,1.723129837,1789,2020,408,144,143,1,45,1,0.013986014,0,empty,CD-0722-1
"H2,H6",8557,9576,6272,3304,4498,2302,0,2303,1513,790,1.915189873,1340,1653,349,158,156,2,42,1,0.051282051,0,empty,CD-0722-1
"H2,H7",1060078,1291230,770957,520273,592079,349321,25,349684,275436,74248,3.709675681,214673,46643,10522,3132,3095,37,725,3,0.043941842,0,hg38,CD-0722-1
"H2,H8",10603,11815,7829,3986,5493,2803,1,2806,1768,1038,1.70327553,1609,2029,424,153,151,2,43,2,0.033112583,0,empty,CD-0722-1
"H2,H9",8629,9220,6645,2575,4459,2121,0,2121,1355,766,1.768929504,1159,1160,163,55,55,0,23,0,0.036363636,0,empty,CD-0722-1
"H2,H10",8205,9109,6189,2920,4359,2191,1,2197,1406,791,1.777496839,1236,1171,264,75,75,0,31,0,0.053333333,0,empty,CD-0722-1
"H2,H11",10968,12774,7584,5190,6146,3787,0,3790,2078,1712,1.213785047,2347,108,16,10,10,0,4,0,0,0,empty,CD-0722-1
"H2,H12",9754,10856,7141,3715,5157,2694,2,2701,1723,978,1.761758691,1559,1635,375,109,106,3,44,2,0.028301887,0,empty,CD-0722-1
"H3,A1",7474,8354,5528,2826,3939,2007,0,2010,1326,684,1.938596491,1131,1468,249,115,114,1,30,1,0.035087719,0,empty,CD-0722-1
"H3,A2",11013,12344,8108,4236,5865,2994,3,2999,1891,1108,1.7066787,1746,2084,559,188,186,2,58,1,0.053763441,0,empty,CD-0722-1
"H3,A3",6409,6976,4667,2309,3452,1731,1,1744,1098,646,1.699690402,1008,1256,227,77,77,0,24,0,0.233766234,0,empty,CD-0722-1
"H3,A4",1827904,2131414,1343979,787435,964501,583949,5,584541,446149,138392,3.223806289,339452,11650,673,251,232,19,73,2,0.25,0,hg38,CD-0722-1
"H3,A5",1289998,1469569,972935,496634,682761,363241,3,363643,277375,86268,3.215271016,210278,85018,10862,3576,3496,80,791,5,0.074370709,0,hg38,CD-0722-1
"H3,A6",699495,837719,518446,319273,394133,231007,1,231196,175266,55930,3.133667084,137773,49710,10694,3311,3279,32,636,2,0.029887161,0,hg38,CD-0722-1
"H3,A7",7302,8466,5443,3023,3927,2023,0,2023,1296,727,1.782668501,1198,1034,156,60,59,1,28,1,0.016949153,0,empty,CD-0722-1
"H3,A8",4118,4561,3070,1491,2260,1140,0,1140,743,397,1.871536524,671,1625,399,167,166,1,50,1,0.186746988,0,empty,CD-0722-1
"H3,A9",7649,8416,5840,2576,4006,1973,0,1977,1243,734,1.69346049,1110,1842,408,150,150,0,44,0,0.2,0,empty,CD-0722-1
"H3,A10",9201,9841,7060,2781,4710,2296,0,2297,1456,841,1.731272295,1191,300,66,27,27,0,7,0,0,0,empty,CD-0722-1
"H3,A11",7012,7735,5246,2489,3675,1737,0,1740,1131,609,1.857142857,971,1788,382,106,106,0,36,0,0.009433962,0,empty,CD-0722-1
"H3,A12",772028,849197,605967,243230,386431,179473,4,179676,134676,45000,2.9928,98310,147693,30909,10239,10099,140,1548,3,0.031884345,0,hg38,CD-0722-1
"H3,B1",7778,8346,5821,2525,4018,2038,1,2040,1267,773,1.639068564,1116,1182,156,59,52,7,25,3,0.134615385,0,empty,CD-0722-1
"H3,B2",9667,10822,6714,4108,5119,2797,0,2801,1734,1067,1.625117151,1659,478,42,19,15,4,9,1,0.066666667,0,empty,CD-0722-1
"H3,B3",6546,7323,4876,2447,3549,1768,0,1772,1137,635,1.790551181,1051,1671,340,124,122,2,31,2,0.213114754,0,empty,CD-0722-1
"H3,B4",8058,8922,5813,3109,4411,2367,0,2367,1498,869,1.723820483,1376,1399,284,111,111,0,39,0,0.081081081,0,empty,CD-0722-1
"H3,B5",7690,4063,2360,1703,2674,1429,0,1443,926,517,1.791102515,975,956,176,58,57,1,21,1,0.157894737,0,empty,CD-0722-1
"H3,B6",9207,10348,6485,3863,4879,2655,0,2661,1626,1035,1.571014493,1592,1131,229,99,99,0,30,0,0.01010101,0,empty,CD-0722-1
"H3,B7",7875,8668,5914,2754,4156,2031,0,2036,1362,674,2.020771513,1134,1114,258,97,93,4,23,1,0,0,empty,CD-0722-1
"H3,B8",6344,6917,4803,2114,3340,1640,6,1649,1066,583,1.828473413,941,1202,419,127,126,1,28,1,0.134920635,0,empty,CD-0722-1
"H3,B9",10847,11888,8042,3846,5623,2810,0,2817,1736,1081,1.605920444,1580,936,265,76,75,1,24,1,0,0,empty,CD-0722-1
"H3,B10",5667,5868,4134,1734,2958,1462,0,1465,909,556,1.634892086,823,403,76,16,16,0,10,0,0.4375,0,empty,CD-0722-1
"H3,B11",12167,13692,8940,4752,6417,3514,0,3518,1956,1562,1.252240717,2008,256,37,19,19,0,4,0,0,0,empty,CD-0722-1
"H3,B12",7115,7879,5383,2496,3637,1773,0,1777,1132,645,1.75503876,987,1633,361,122,122,0,43,0,0,0,empty,CD-0722-1
"H3,C1",14143,15064,10859,4205,7133,3299,1,3309,2086,1223,1.705641864,1789,1407,346,119,118,1,30,1,0.008474576,0,empty,CD-0722-1
"H3,C2",11196,12341,8282,4059,5837,2962,0,2972,1876,1096,1.711678832,1717,2002,427,126,125,1,39,1,0.024,0,empty,CD-0722-1
"H3,C3",11932,13185,8944,4241,6203,3011,0,3014,1894,1120,1.691071429,1646,817,235,84,79,5,22,2,0,0,empty,CD-0722-1
"H3,C4",7493,8208,5703,2505,3926,1799,2,1804,1154,650,1.775384615,1038,1642,274,84,84,0,36,0,0.011904762,0,empty,CD-0722-1
"H3,C5",11155,12628,8222,4406,5920,3043,0,3047,1918,1129,1.698848539,1817,2037,475,167,166,1,46,1,0.156626506,0,empty,CD-0722-1
"H3,C6",766874,864453,576534,287919,410681,222926,1,223174,160761,62413,2.57576146,127964,37004,8106,2436,2384,52,473,5,0.028104027,0,hg38,CD-0722-1
"H3,C7",12870,15150,9365,5785,7136,3980,3,3988,2373,1615,1.469349845,2393,402,89,44,44,0,26,0,0.022727273,0,empty,CD-0722-1
"H3,C8",13712,15182,10233,4949,7170,3645,0,3653,2362,1291,1.829589466,2083,2828,773,241,240,1,59,1,0.104166667,0,empty,CD-0722-1
"H3,C9",9457,10373,7084,3289,4922,2443,0,2444,1545,899,1.718576196,1362,1229,101,46,45,1,19,1,0,0,empty,CD-0722-1
"H3,C10",11027,12054,8217,3837,5648,2729,0,2731,1782,949,1.87776607,1575,1816,438,135,135,0,39,0,0.051851852,0,empty,CD-0722-1
"H3,C11",10204,11451,7550,3901,5370,2699,1,2706,1788,918,1.947712418,1570,1784,492,142,140,2,32,1,0.171428571,0,empty,CD-0722-1
"H3,C12",13788,15023,10457,4566,6945,3367,0,3373,2216,1157,1.915298185,1829,2006,528,162,160,2,42,1,0.025,0,empty,CD-0722-1
"H3,D1",12416,14300,8971,5329,6627,3588,0,3590,2176,1414,1.538896747,2174,751,146,45,45,0,16,0,0,0,empty,CD-0722-1
"H3,D2",9607,10603,7271,3332,5091,2401,0,2409,1511,898,1.682628062,1377,3278,665,239,235,4,85,2,0.004255319,0,empty,CD-0722-1
"H3,D3",8813,9551,6557,2994,4608,2281,0,2282,1458,824,1.769417476,1277,1328,295,102,101,1,28,1,0.099009901,0,empty,CD-0722-1
"H3,D4",6769,7825,5057,2768,3695,1883,0,1883,1207,676,1.785502959,1115,1348,383,126,125,1,36,1,0.12,0,empty,CD-0722-1
"H3,D5",7955,8730,5908,2822,4112,1949,0,1952,1241,711,1.745428973,1111,1699,320,121,120,1,46,1,0.016666667,0,empty,CD-0722-1
"H3,D6",12007,13448,8669,4779,6248,3374,0,3378,1990,1388,1.433717579,1996,1559,422,138,137,1,42,1,0.02189781,0,empty,CD-0722-1
"H3,D7",6639,7274,4978,2296,3470,1658,0,1661,1095,566,1.934628975,944,2029,546,201,201,0,43,0,0.174129353,0,empty,CD-0722-1
"H3,D8",8079,8644,5985,2659,4120,1954,0,1962,1281,681,1.881057269,1128,1281,260,87,85,2,26,1,0,0,empty,CD-0722-1
"H3,D9",5071,5862,3790,2072,2747,1350,0,1350,905,445,2.033707865,801,1615,366,126,126,0,36,0,0.142857143,0,empty,CD-0722-1
"H3,D10",10604,12279,7553,4726,5804,3088,0,3090,1974,1116,1.768817204,1903,723,217,71,71,0,21,0,0.14084507,0,empty,CD-0722-1
"H3,D11",8873,9743,6716,3027,4595,2228,0,2231,1448,783,1.849297573,1217,2644,603,235,234,1,68,1,0.106837607,0,empty,CD-0722-1
"H3,D12",11184,12463,8300,4163,5732,2813,0,2813,1758,1055,1.666350711,1664,3035,798,286,281,5,62,2,0.096085409,0,empty,CD-0722-1
"H3,E1",14244,15590,10720,4870,7314,3677,3,3684,2294,1390,1.650359712,2056,3122,677,265,263,2,61,2,0.057034221,0,empty,CD-0722-1
"H3,E2",10051,11260,7309,3951,5280,2724,0,2724,1819,905,2.009944751,1608,1938,373,117,116,1,42,1,0.051724138,0,empty,CD-0722-1
"H3,E3",6797,7816,5194,2622,3691,1801,1,1804,1204,600,2.006666667,1015,2037,638,222,215,7,44,1,0.246511628,0,empty,CD-0722-1
"H3,E4",9415,10111,6984,3127,4912,2414,1,2415,1506,909,1.656765677,1357,3313,825,233,232,1,79,1,0.056034483,0,empty,CD-0722-1
"H3,E5",8066,8818,6139,2679,4270,2023,0,2026,1278,748,1.70855615,1121,1225,423,155,155,0,37,0,0.187096774,0,empty,CD-0722-1
"H3,E6",950049,883234,837902,45332,393192,61305,3,61496,47160,14336,3.289620536,19741,5634,1277,500,493,7,191,2,0.054766734,0,hg38,CD-0722-1
"H3,E7",13955,15252,10638,4614,7264,3483,1,3491,2313,1178,1.963497453,1918,3166,594,185,181,4,59,2,0.027624309,0,empty,CD-0722-1
"H3,E8",10854,11593,8425,3168,5403,2499,0,2500,1665,835,1.994011976,1253,3166,682,222,219,3,64,2,0.04109589,0,empty,CD-0722-1
"H3,E9",6929,7529,5176,2353,3488,1667,0,1671,1120,551,2.032667877,871,2505,633,190,184,6,48,2,0.043478261,0,empty,CD-0722-1
"H3,E10",8174,8750,6161,2589,4134,1994,0,1996,1312,684,1.918128655,1138,2048,558,172,172,0,45,0,0.040697674,0,empty,CD-0722-1
"H3,E11",9740,11331,7238,4093,5245,2663,6,2676,1750,926,1.889848812,1601,2485,399,138,135,3,39,1,0.103703704,0,empty,CD-0722-1
"H3,E12",10211,11457,7596,3861,5403,2663,0,2663,1642,1021,1.608227228,1568,1581,265,90,85,5,27,1,0.282352941,0,empty,CD-0722-1
"H3,F1",12060,12830,8956,3874,6139,2988,0,2997,1870,1127,1.659272405,1659,2719,813,287,287,0,60,0,0.069686411,0,empty,CD-0722-1
"H3,F2",9796,10910,7279,3631,5056,2446,0,2453,1619,834,1.941247002,1399,3067,762,289,287,2,68,2,0.048780488,0,empty,CD-0722-1
"H3,F3",9401,10246,6938,3308,4966,2358,0,2364,1493,871,1.714121699,1396,2719,468,113,110,3,49,2,0.1,0,empty,CD-0722-1
"H3,F4",13817,14717,10354,4363,7019,3280,0,3282,2112,1170,1.805128205,1831,668,179,84,84,0,28,0,0.05952381,0,empty,CD-0722-1
"H3,F5",11009,11818,8368,3450,5502,2530,0,2534,1553,981,1.583078491,1374,1617,462,153,149,4,52,1,0.087248322,0,empty,CD-0722-1
"H3,F6",10746,12024,7968,4056,5609,2828,0,2833,1799,1034,1.739845261,1645,2796,432,169,167,2,63,2,0.113772455,0,empty,CD-0722-1
"H3,F7",12817,14291,9552,4739,6810,3415,0,3421,2137,1284,1.664330218,2018,1182,373,124,122,2,35,2,0.139344262,0,empty,CD-0722-1
"H3,F8",8493,9478,6339,3139,4371,2141,0,2142,1406,736,1.910326087,1231,87,9,6,6,0,2,0,0.833333333,0,empty,CD-0722-1
"H3,F9",9418,10373,7183,3190,4874,2324,0,2327,1505,822,1.830900243,1304,2686,671,252,247,5,70,1,0.068825911,0,empty,CD-0722-1
"H3,F10",12302,13697,9378,4319,6395,3125,0,3131,1973,1158,1.703799655,1771,1922,334,160,158,2,55,2,0.006329114,0,empty,CD-0722-1
"H3,F11",9474,10270,7247,3023,4772,2181,0,2184,1445,739,1.955345061,1182,1739,554,176,176,0,40,0,0.221590909,0,empty,CD-0722-1
"H3,F12",825287,966040,603204,362836,441501,249459,0,249707,192549,57158,3.368714791,149449,6549,877,297,290,7,80,3,0.086206897,0,hg38,CD-0722-1
"H3,G1",11748,12548,8876,3672,6151,2940,0,2946,1931,1015,1.902463054,1633,2539,613,177,173,4,58,1,0.023121387,0,empty,CD-0722-1
"H3,G2",6703,7302,4825,2477,3461,1742,1,1747,1143,604,1.892384106,1008,327,42,25,25,0,11,0,0,0,empty,CD-0722-1
"H3,G3",12182,13380,8982,4398,6432,3296,0,3298,1962,1336,1.468562874,1875,2479,631,185,180,5,49,1,0.122222222,0,empty,CD-0722-1
"H3,G4",22537,25457,16384,9073,11902,6612,0,6620,3951,2669,1.480329712,3816,104,31,13,13,0,6,0,0,0,empty,CD-0722-1
"H3,G5",7591,8329,5686,2643,3964,1960,0,1967,1286,681,1.888399413,1117,1569,250,92,84,8,42,2,0,0,empty,CD-0722-1
"H3,G6",10805,11796,8379,3417,5526,2670,0,2677,1752,925,1.894054054,1417,82,17,10,10,0,8,0,0,0,empty,CD-0722-1
"H3,G7",9338,9989,7100,2889,4724,2273,0,2275,1527,748,2.04144385,1212,2439,589,177,173,4,45,2,0.121387283,0,empty,CD-0722-1
"H3,G8",6524,7118,4909,2209,3372,1625,0,1629,1081,548,1.972627737,927,1650,361,117,116,1,39,1,0.077586207,0,empty,CD-0722-1
"H3,G9",8105,9041,6121,2920,4067,1974,0,1974,1272,702,1.811965812,1113,2034,581,174,174,0,54,0,0.074712644,0,empty,CD-0722-1
"H3,G10",9602,10650,7111,3539,5073,2600,0,2603,1656,947,1.748680042,1482,2496,798,299,296,3,63,2,0.037162162,0,empty,CD-0722-1
"H3,G11",9810,10433,7556,2877,4943,2244,0,2251,1467,784,1.871173469,1181,1229,352,110,110,0,37,0,0,0,empty,CD-0722-1
"H3,G12",7915,8656,5821,2835,4125,2059,12,2073,1333,740,1.801351351,1145,2284,526,164,163,1,46,1,0.067484663,0,empty,CD-0722-1
"H3,H1",1513193,1746426,1121072,625354,797210,440959,6,441409,359308,82101,4.376414416,262405,134433,22891,7332,7203,129,1282,5,0.031236985,0,hg38,CD-0722-1
"H3,H2",9454,10427,6941,3486,4838,2322,0,2331,1497,834,1.794964029,1326,1920,480,168,167,1,47,1,0.035928144,0,empty,CD-0722-1
"H3,H3",7607,8624,5550,3074,4159,2112,0,2117,1354,763,1.77457405,1266,1408,406,157,154,3,48,2,0.032467532,0,empty,CD-0722-1
"H3,H4",11721,12979,8715,4264,5969,2946,0,2946,1895,1051,1.803044719,1687,214,27,17,17,0,12,0,0,0,empty,CD-0722-1
"H3,H5",12351,13585,9145,4440,6342,3233,0,3241,2032,1209,1.680727874,1841,1796,408,143,139,4,47,2,0.129496403,0,empty,CD-0722-1
"H3,H6",7180,7943,5300,2643,3718,1911,0,1913,1222,691,1.76845152,1102,1815,347,135,131,4,35,2,0.160305344,0,empty,CD-0722-1
"H3,H7",9265,10016,6802,3214,4850,2346,1,2351,1523,828,1.839371981,1344,1916,347,121,116,5,39,3,0.25862069,0,empty,CD-0722-1
"H3,H8",9679,10631,7167,3464,4975,2555,0,2562,1658,904,1.834070796,1450,2161,348,145,143,2,54,1,0.083916084,0,empty,CD-0722-1
"H3,H9",7990,8880,6130,2750,4045,1884,0,1886,1245,641,1.942277691,1064,1165,315,102,102,0,25,0,0,0,empty,CD-0722-1
"H3,H10",6491,7250,4890,2360,3347,1626,0,1626,1042,584,1.784246575,913,1087,235,84,84,0,29,0,0.119047619,0,empty,CD-0722-1
"H3,H11",8598,9775,6078,3697,4728,2831,0,2832,1614,1218,1.325123153,1674,57,3,3,3,0,2,0,0,0,empty,CD-0722-1
"H3,H12",7840,8494,5733,2761,4010,2076,0,2087,1391,696,1.998563218,1135,1231,148,55,55,0,27,0,0.018181818,0,empty,CD-0722-1
"H4,A1",835066,982249,624720,357529,457104,250177,3,250411,199889,50522,3.956474407,149377,89570,10631,3781,3702,79,810,6,0.060237709,0,hg38,CD-0722-1
"H4,A2",14772,16427,10957,5470,7839,4023,0,4028,2590,1438,1.801112656,2316,1267,336,110,107,3,42,2,0.08411215,0,empty,CD-0722-1
"H4,A3",7984,8665,6030,2635,4154,2016,0,2017,1301,716,1.817039106,1142,802,267,82,82,0,30,0,0.073170732,0,empty,CD-0722-1
"H4,A4",12971,14379,9788,4591,6692,3248,0,3256,2079,1177,1.76635514,1777,590,160,64,63,1,14,1,0.158730159,0,empty,CD-0722-1
"H4,A5",3249673,3870468,2288099,1582369,1767580,1151985,9,1152976,795862,357114,2.22859367,693940,7331,2246,599,596,3,269,2,0.055369128,0,hg38,CD-0722-1
"H4,A6",10673,12265,8115,4150,5903,3075,0,3077,1987,1090,1.82293578,1762,1955,459,173,172,1,52,1,0.069767442,0,empty,CD-0722-1
"H4,A7",864772,1054159,631501,422658,483601,285169,4,285468,218256,67212,3.247277272,174103,19253,5383,1739,1726,13,450,2,0.056778679,0,hg38,CD-0722-1
"H4,A8",5496,6061,4097,1964,3040,1554,0,1554,1015,539,1.883116883,899,1559,322,135,134,1,62,1,0.074626866,0,empty,CD-0722-1
"H4,A9",12035,13267,9166,4101,6397,3114,0,3120,2120,1000,2.12,1778,1678,483,174,170,4,56,1,0.017647059,0,empty,CD-0722-1
"H4,A10",12104,13182,9203,3979,6207,3067,0,3072,1943,1129,1.720992028,1659,400,102,40,40,0,12,0,0.075,0,empty,CD-0722-1
"H4,A11",669162,770028,506650,263378,357232,188035,4,188271,148180,40091,3.696091392,109760,111136,13962,4571,4452,119,879,4,0.058400719,0,hg38,CD-0722-1
"H4,A12",12032,13299,9063,4236,6199,3008,1,3011,1990,1021,1.94906954,1698,2456,558,207,201,6,63,2,0.019900498,0,empty,CD-0722-1
"H4,B1",9739,10424,7204,3220,4935,2439,0,2445,1579,866,1.823325635,1293,801,147,60,59,1,24,1,0.016949153,0,empty,CD-0722-1
"H4,B2",9847,10961,6818,4143,5250,2908,0,2914,1838,1076,1.708178439,1739,534,126,58,58,0,19,0,0,0,empty,CD-0722-1
"H4,B3",8867,10125,6559,3566,4813,2485,0,2486,1634,852,1.917840376,1485,1100,262,82,80,2,35,2,0.1125,0,empty,CD-0722-1
"H4,B4",1627572,1902851,1212764,690087,868846,481492,2,481970,375943,106027,3.545728918,286446,166699,26432,9125,8961,164,1514,4,0.069300301,0,hg38,CD-0722-1
"H4,B5",12241,8643,5208,3435,4996,2852,0,2863,1901,962,1.976091476,1824,691,152,53,53,0,14,0,0,0,empty,CD-0722-1
"H4,B6",11082,12574,8088,4486,6014,3284,0,3286,2089,1197,1.745196324,1903,1111,256,90,90,0,30,0,0,0,empty,CD-0722-1
"H4,B7",9447,10326,7208,3118,4956,2407,0,2417,1557,860,1.810465116,1338,790,189,77,77,0,24,0,0.12987013,0,empty,CD-0722-1
"H4,B8",7698,8650,5786,2864,4168,2078,5,2088,1462,626,2.335463259,1241,998,243,104,103,1,39,1,0.155339806,0,empty,CD-0722-1
"H4,B9",14029,15691,10428,5263,7402,3847,1,3850,2433,1417,1.717007763,2195,781,159,81,80,1,26,1,0.05,0,empty,CD-0722-1
"H4,B10",1295389,1437492,884687,552805,688604,405562,34,407229,293686,113543,2.586561919,245737,5404,464,112,92,20,42,2,0.054347826,0,empty,CD-0722-1
"H4,B11",15713,17618,11349,6269,8251,4507,0,4513,2491,2022,1.231948566,2693,104,28,20,20,0,12,0,0.15,0,empty,CD-0722-1
"H4,B12",8846,9808,6630,3178,4646,2312,0,2313,1521,792,1.920454545,1312,1509,348,87,87,0,22,0,0.137931034,0,empty,CD-0722-1
"H4,C1",16336,17773,12526,5247,8246,3962,0,3964,2489,1475,1.687457627,2186,1086,264,90,88,2,31,1,0.079545455,0,empty,CD-0722-1
"H4,C2",12884,14738,9624,5114,6816,3534,1,3543,2222,1321,1.682059046,2034,1914,553,185,184,1,51,1,0.076086957,0,empty,CD-0722-1
"H4,C3",16993,19114,12820,6294,9021,4441,0,4447,3040,1407,2.160625444,2516,686,148,64,64,0,27,0,0.03125,0,empty,CD-0722-1
"H4,C4",9737,10568,7404,3164,5059,2372,0,2376,1523,853,1.785463072,1355,1739,315,120,118,2,42,2,0.194915254,0,empty,CD-0722-1
"H4,C5",14021,15504,10507,4997,7270,3621,0,3623,2430,1193,2.036881811,1971,1984,500,168,167,1,55,1,0.131736527,0,empty,CD-0722-1
"H4,C6",11649,12590,8639,3951,6293,3142,0,3145,2042,1103,1.851314597,1765,1299,238,98,96,2,43,1,0.041666667,0,empty,CD-0722-1
"H4,C7",944196,1093871,715194,378677,500902,262720,5,263009,195207,67802,2.879074364,155325,29981,3681,1146,1102,44,281,3,0.039927405,0,hg38,CD-0722-1
"H4,C8",1094926,1229988,845581,384407,557902,277372,1,277706,218718,58988,3.707838882,155841,252052,47460,16666,16446,220,2297,6,0.063480482,0,hg38,CD-0722-1
"H4,C9",20875,23974,15857,8117,10883,5303,1,5310,3476,1834,1.895310796,3114,2941,443,153,149,4,44,1,0.187919463,0,empty,CD-0722-1
"H4,C10",13005,14119,9905,4214,6718,3254,2,3263,2098,1165,1.800858369,1852,1577,410,145,136,9,36,2,0.014705882,0,empty,CD-0722-1
"H4,C11",11449,13072,8462,4610,6239,3226,0,3227,2090,1137,1.838170624,1908,1500,225,99,99,0,43,0,0.04040404,0,empty,CD-0722-1
"H4,C12",16853,18487,12501,5986,8803,4294,1,4298,2839,1459,1.945853324,2465,1380,307,120,120,0,42,0,0.016666667,0,empty,CD-0722-1
"H4,D1",15233,17139,10940,6199,8245,4567,0,4572,2734,1838,1.487486398,2747,606,148,46,46,0,21,0,0.02173913,0,empty,CD-0722-1
"H4,D2",11178,11955,8626,3329,5814,2686,4,2696,1698,998,1.701402806,1429,2460,620,236,230,6,81,2,0.060869565,0,empty,CD-0722-1
"H4,D3",11484,12729,8598,4131,6032,3053,0,3055,2048,1007,2.033763654,1677,915,197,70,70,0,38,0,0.028571429,0,empty,CD-0722-1
"H4,D4",9113,9996,6950,3046,4814,2398,0,2403,1610,793,2.030264817,1291,1122,230,91,91,0,28,0,0.032967033,0,empty,CD-0722-1
"H4,D5",9838,11171,7337,3834,5358,2627,0,2631,1736,895,1.939664804,1567,1540,328,125,123,2,48,2,0.016260163,0,empty,CD-0722-1
"H4,D6",13719,15193,9853,5340,7187,3912,0,3913,2440,1473,1.656483367,2251,1702,544,196,190,6,48,2,0.052631579,0,empty,CD-0722-1
"H4,D7",8028,8881,6126,2755,4140,1937,0,1943,1293,650,1.989230769,1068,1433,394,166,166,0,47,0,0,0,empty,CD-0722-1
"H4,D8",913207,1067927,682838,385089,489783,265748,2,266066,200705,65361,3.070714952,158592,53228,8238,2707,2654,53,608,4,0.041446873,0,hg38,CD-0722-1
"H4,D9",7319,8330,5499,2831,3968,2041,0,2041,1371,670,2.046268657,1165,1554,519,160,160,0,50,0,0,0,empty,CD-0722-1
"H4,D10",9010,10278,6561,3717,4891,2559,0,2560,1601,959,1.669447341,1539,377,54,29,28,1,15,1,0,0,empty,CD-0722-1
"H4,D11",1607979,1794209,1233573,560636,810880,407969,5,408434,329606,78828,4.181331507,230014,89700,19381,6138,6024,114,1035,5,0.027390438,0,hg38,CD-0722-1
"H4,D12",13501,15243,10141,5102,7191,3559,0,3563,2306,1257,1.834526651,2079,2729,709,223,220,3,74,3,0.004545455,0,empty,CD-0722-1
"H4,E1",17596,19027,13096,5931,9053,4531,1,4538,2922,1616,1.808168317,2545,2443,664,244,241,3,76,2,0.004149378,0,empty,CD-0722-1
"H4,E2",12169,13055,8923,4132,6275,3123,0,3127,1969,1158,1.700345423,1794,1561,398,111,108,3,34,2,0.148148148,0,empty,CD-0722-1
"H4,E3",8423,9529,6344,3185,4472,2173,0,2176,1407,769,1.829648895,1223,2292,722,234,231,3,64,1,0.116883117,0,empty,CD-0722-1
"H4,E4",11437,12649,8524,4125,6036,2990,0,2996,1948,1048,1.858778626,1674,2344,411,169,167,2,80,1,0.065868263,0,empty,CD-0722-1
"H4,E5",10801,11991,8214,3777,5614,2729,0,2732,1773,959,1.848800834,1566,1170,231,87,85,2,34,2,0,0,empty,CD-0722-1
"H4,E6",17840,19709,13270,6439,9216,4766,0,4774,3067,1707,1.796719391,2729,2389,516,228,225,3,79,2,0.066666667,0,empty,CD-0722-1
"H4,E7",17293,18929,12994,5935,8834,4241,0,4246,2756,1490,1.84966443,2296,2522,626,204,200,4,64,1,0.025,0,empty,CD-0722-1
"H4,E8",12877,14164,9890,4274,6512,2959,0,2968,1906,1062,1.79472693,1678,2002,514,187,185,2,60,2,0.043243243,0,empty,CD-0722-1
"H4,E9",9245,10666,6937,3729,4913,2463,0,2472,1614,858,1.881118881,1426,1968,353,164,162,2,64,1,0.012345679,0,empty,CD-0722-1
"H4,E10",9348,10453,6989,3464,4981,2399,0,2399,1542,857,1.799299883,1387,1526,367,165,163,2,49,1,0.220858896,0,empty,CD-0722-1
"H4,E11",11573,12673,8689,3984,5952,2926,0,2928,1819,1109,1.640216411,1612,1648,426,166,166,0,50,0,0.114457831,0,empty,CD-0722-1
"H4,E12",916322,1117984,659349,458635,516974,304597,3,304840,239752,65088,3.683505408,189733,46336,8045,2674,2622,52,637,4,0.033943555,0,hg38,CD-0722-1
"H4,F1",14508,16058,10900,5158,7496,3634,0,3637,2306,1331,1.732531931,2086,2060,471,164,161,3,56,1,0.031055901,0,empty,CD-0722-1
"H4,F2",1179911,1361664,886953,474711,614477,330856,6,331228,259066,72162,3.590061251,194383,106116,14018,4927,4828,99,1000,5,0.095898923,0,hg38,CD-0722-1
"H4,F3",11806,13432,8951,4481,6362,3199,0,3207,2091,1116,1.873655914,1888,2214,450,175,169,6,75,2,0.112426036,0,empty,CD-0722-1
"H4,F4",18419,19747,13989,5758,9355,4363,0,4371,2919,1452,2.010330579,2407,4064,715,225,222,3,57,2,0.148648649,0,empty,CD-0722-1
"H4,F5",12373,13514,9317,4197,6391,2972,0,2986,1928,1058,1.822306238,1710,1635,351,127,126,1,49,1,0.007936508,0,empty,CD-0722-1
"H4,F6",926365,1087049,680265,406784,499271,283185,8,283452,221344,62108,3.563856508,169777,114978,13293,4607,4452,155,966,6,0.045822102,0,hg38,CD-0722-1
"H4,F7",15412,17105,11697,5408,8178,4082,0,4089,2730,1359,2.008830022,2318,780,118,54,54,0,27,0,0.055555556,0,empty,CD-0722-1
"H4,F8",10086,11264,7548,3716,5260,2538,0,2542,1609,933,1.72454448,1457,109,7,7,7,0,5,0,0,0,empty,CD-0722-1
"H4,F9",11449,12818,8572,4246,5987,2902,0,2907,1934,973,1.987667009,1689,1843,393,146,145,1,48,1,0.15862069,0,empty,CD-0722-1
"H4,F10",849514,1044372,594549,449823,483250,319065,13,319361,215237,104124,2.067121893,193993,6006,1155,332,330,2,56,1,0.536363636,0,hg38,CD-0722-1
"H4,F11",12526,13427,9562,3865,6358,2946,0,2953,2046,907,2.255788313,1562,1274,160,94,89,5,37,2,0.101123596,0,empty,CD-0722-1
"H4,F12",12514,13798,9354,4444,6577,3230,1,3235,2102,1133,1.855251545,1919,257,83,18,18,0,5,0,0,0,empty,CD-0722-1
"H4,G1",14067,15787,10643,5144,7435,3697,1,3702,2453,1249,1.963971177,2140,2550,443,203,197,6,83,3,0.030456853,0,empty,CD-0722-1
"H4,G2",7632,8507,5426,3081,4063,2112,0,2115,1364,751,1.816245007,1230,354,59,30,29,1,16,1,0,0,empty,CD-0722-1
"H4,G3",14935,16386,11010,5376,7764,4032,0,4042,2468,1574,1.56797967,2287,2161,470,160,160,0,61,0,0.14375,0,empty,CD-0722-1
"H4,G4",26134,29679,18972,10707,13965,7642,0,7647,4773,2874,1.660751566,4452,209,32,19,16,3,10,1,0.1875,0,empty,CD-0722-1
"H4,G5",905768,1050672,687451,363221,479731,249396,1,249671,190330,59341,3.20739455,146295,91985,14756,4959,4855,104,953,7,0.040576725,0,hg38,CD-0722-1
"H4,G6",12257,13416,9304,4112,6413,3098,0,3106,2079,1027,2.024342746,1690,125,34,14,14,0,4,0,0,0,empty,CD-0722-1
"H4,G7",11792,13418,9023,4395,6394,3051,0,3061,2022,1039,1.946102021,1771,6448,1239,372,366,6,139,1,0.092896175,0,empty,CD-0722-1
"H4,G8",7809,8414,5885,2529,3928,1913,5,1920,1250,670,1.865671642,1076,1473,419,141,139,2,35,1,0.057553957,0,empty,CD-0722-1
"H4,G9",9855,11323,7268,4055,5257,2652,0,2655,1740,915,1.901639344,1571,1838,377,145,143,2,56,1,0,0,empty,CD-0722-1
"H4,G10",12709,14481,9743,4738,6855,3482,0,3492,2244,1248,1.798076923,2013,1869,448,166,162,4,66,2,0.067901235,0,empty,CD-0722-1
"H4,G11",11919,12952,9099,3853,6172,2918,1,2922,1941,981,1.978593272,1630,1190,291,134,134,0,47,0,0.126865672,0,empty,CD-0722-1
"H4,G12",9237,10341,6900,3441,4960,2480,0,2482,1578,904,1.745575221,1453,1636,338,125,122,3,40,2,0.040983607,0,empty,CD-0722-1
"H4,H1",10224,11101,7712,3389,5357,2506,0,2509,1626,883,1.841449604,1405,745,208,61,60,1,24,1,0,0,empty,CD-0722-1
"H4,H2",12237,13435,9111,4324,6296,3103,0,3108,2023,1085,1.864516129,1749,1651,334,112,112,0,46,0,0.0625,0,empty,CD-0722-1
"H4,H3",9780,11187,7239,3948,5173,2613,0,2614,1694,920,1.841304348,1523,1173,218,95,92,3,38,2,0.054347826,0,empty,CD-0722-1
"H4,H4",13764,15121,10310,4811,7166,3424,0,3427,2355,1072,2.196828358,2008,164,33,15,12,3,6,1,0.166666667,0,empty,CD-0722-1
"H4,H5",14508,16052,10583,5469,7375,3779,3,3785,2421,1364,1.774926686,2178,1352,301,124,123,1,39,1,0.097560976,0,empty,CD-0722-1
"H4,H6",9091,10133,6737,3396,4687,2381,2,2383,1536,847,1.813459268,1385,1493,338,103,102,1,38,1,0.098039216,0,empty,CD-0722-1
"H4,H7",11434,12802,8555,4247,5918,2861,0,2866,1956,910,2.149450549,1641,1750,417,130,128,2,48,1,0.0390625,0,empty,CD-0722-1
"H4,H8",12010,13605,8943,4662,6295,3158,0,3158,2029,1129,1.797165633,1817,1947,493,148,148,0,37,0,0.087837838,0,empty,CD-0722-1
"H4,H9",10905,11681,8380,3301,5544,2569,0,2571,1759,812,2.166256158,1399,1129,248,103,103,0,35,0,0.029126214,0,empty,CD-0722-1
"H4,H10",8219,8956,6309,2647,4168,2009,1,2011,1330,681,1.953010279,1123,1369,288,86,81,5,30,2,0.037037037,0,empty,CD-0722-1
"H4,H11",1067989,1278124,781373,496751,582213,331782,5,332119,263207,68912,3.819465405,202911,2876,342,112,111,1,34,1,0.018018018,0,hg38,CD-0722-1
"H4,H12",10382,11693,7558,4135,5470,2838,1,2845,1892,953,1.985309549,1679,1313,286,119,119,0,54,0,0.109243697,0,empty,CD-0722-1
"H5,A1",6644,7345,4930,2415,3549,1820,0,1822,1197,625,1.9152,1046,1465,286,65,63,2,29,1,0.079365079,0,empty,CD-0722-1
"H5,A2",9027,9954,6752,3202,4791,2457,0,2458,1566,892,1.755605381,1393,2156,512,148,144,4,51,2,0.013888889,0,empty,CD-0722-1
"H5,A3",5478,6098,4057,2041,3011,1456,4,1464,966,498,1.939759036,875,1167,284,109,102,7,25,2,0.12745098,0,empty,CD-0722-1
"H5,A4",10716,11721,7970,3751,5508,2778,0,2780,1733,1047,1.655205349,1600,1133,315,113,113,0,28,0,0.230088496,0,empty,CD-0722-1
"H5,A5",8699,9585,6471,3114,4545,2210,0,2212,1452,760,1.910526316,1284,2108,545,169,167,2,62,1,0.023952096,0,empty,CD-0722-1
"H5,A6",7295,8407,5442,2965,4072,2064,0,2068,1309,759,1.724637681,1222,3588,895,310,305,5,81,2,0.019672131,0,empty,CD-0722-1
"H5,A7",6388,7178,4727,2451,3378,1746,0,1748,1167,581,2.008605852,997,1372,279,98,97,1,40,1,0.082474227,0,empty,CD-0722-1
"H5,A8",3952,4385,3009,1376,2116,1058,0,1058,692,366,1.890710383,597,2125,531,163,161,2,44,1,0,0,empty,CD-0722-1
"H5,A9",6692,7598,5071,2527,3514,1699,0,1700,1103,597,1.847571189,996,2099,534,188,186,2,56,2,0.048387097,0,empty,CD-0722-1
"H5,A10",7108,7741,5450,2291,3634,1734,1,1740,1119,621,1.801932367,969,434,107,35,34,1,16,1,0,0,empty,CD-0722-1
"H5,A11",5640,6211,4262,1949,2942,1338,0,1341,898,443,2.027088036,749,2145,461,165,162,3,48,1,0.037037037,0,empty,CD-0722-1
"H5,A12",7738,8481,5924,2557,3873,1864,0,1874,1212,662,1.83081571,1027,3043,667,224,223,1,83,1,0.183856502,0,empty,CD-0722-1
"H5,B1",6884,7454,5020,2434,3453,1690,3,1694,1083,611,1.772504092,945,1446,414,98,98,0,35,0,0.112244898,0,empty,CD-0722-1
"H5,B2",7349,8040,5037,3003,3858,2085,0,2088,1287,801,1.606741573,1251,629,180,55,48,7,15,2,0.125,0,empty,CD-0722-1
"H5,B3",717204,836889,538307,298582,390718,211291,3,211512,158214,53298,2.968479117,125228,88606,9565,3154,3045,109,636,5,0.065681445,0,hg38,CD-0722-1
"H5,B4",6405,7548,4721,2827,3538,1882,0,1886,1214,672,1.806547619,1143,1531,433,164,163,1,52,1,0.042944785,0,empty,CD-0722-1
"H5,B5",6756,3562,2110,1452,2331,1257,1,1272,816,456,1.789473684,843,1106,180,67,67,0,24,0,0.194029851,0,empty,CD-0722-1
"H5,B6",7438,8358,5479,2879,4030,2176,0,2182,1384,798,1.73433584,1287,1767,419,134,132,2,38,2,0.03030303,0,empty,CD-0722-1
"H5,B7",7180,7918,5418,2500,3790,1841,0,1844,1266,578,2.190311419,1033,2236,508,191,188,3,41,2,0,0,empty,CD-0722-1
"H5,B8",5216,5702,4032,1670,2728,1275,0,1276,840,436,1.926605505,681,1221,221,84,83,1,39,1,0.072289157,0,empty,CD-0722-1
"H5,B9",8972,9901,6664,3237,4832,2511,5,2517,1568,949,1.652265543,1415,1041,196,81,80,1,24,1,0.0375,0,empty,CD-0722-1
"H5,B10",4857,5234,3489,1745,2625,1310,0,1312,843,469,1.797441365,775,518,83,42,42,0,20,0,0.047619048,0,empty,CD-0722-1
"H5,B11",517445,634148,364510,269638,294513,188099,2,188287,135682,52605,2.579260527,115184,3339,1594,483,483,0,101,0,0.002070393,0,hg38,CD-0722-1
"H5,B12",6112,6669,4708,1961,3207,1572,0,1577,995,582,1.709621993,909,1301,190,72,70,2,29,2,0,0,empty,CD-0722-1
"H5,C1",11857,13034,9109,3925,6123,2869,0,2874,1735,1139,1.523266023,1579,1199,346,59,56,3,26,1,0.035714286,0,empty,CD-0722-1
"H5,C2",10023,11273,7288,3985,5191,2647,0,2657,1660,997,1.664994985,1570,2403,616,192,190,2,53,2,0.047368421,0,empty,CD-0722-1
"H5,C3",10187,11344,7581,3763,5606,2803,0,2807,1815,992,1.829637097,1652,1137,228,79,79,0,23,0,0.189873418,0,empty,CD-0722-1
"H5,C4",6705,7632,5097,2535,3581,1730,0,1734,1142,592,1.929054054,1000,2002,462,180,179,1,50,1,0.139664804,0,empty,CD-0722-1
"H5,C5",9701,10628,7303,3325,5071,2508,1,2514,1641,873,1.879725086,1407,2243,540,211,211,0,67,0,0.09478673,0,empty,CD-0722-1
"H5,C6",818267,972120,600829,371291,458827,259170,2,259443,205655,53788,3.823436454,156767,134596,25618,8455,8326,129,1407,9,0.049003123,0,hg38,CD-0722-1
"H5,C7",10648,12041,7779,4262,5747,3137,1,3145,1965,1180,1.665254237,1839,685,120,37,37,0,12,0,0.054054054,0,empty,CD-0722-1
"H5,C8",11890,13434,9012,4422,6324,3141,0,3149,2044,1105,1.849773756,1736,2999,602,191,189,2,77,1,0.079365079,0,empty,CD-0722-1
"H5,C9",8197,9186,6248,2938,4351,2115,0,2119,1354,765,1.769934641,1239,1645,344,107,105,2,25,2,0.219047619,0,empty,CD-0722-1
"H5,C10",9953,10971,7606,3365,5040,2390,0,2404,1583,821,1.928136419,1348,1733,287,109,107,2,39,1,0.177570093,0,empty,CD-0722-1
"H5,C11",8377,9099,6351,2748,4333,2082,0,2083,1368,715,1.913286713,1135,2379,517,148,147,1,51,1,0.013605442,0,empty,CD-0722-1
"H5,C12",11573,12257,8653,3604,5888,2859,0,2865,1845,1020,1.808823529,1582,1927,360,161,160,1,51,1,0.08125,0,empty,CD-0722-1
"H5,D1",10314,11849,7516,4333,5596,2940,0,2943,1745,1198,1.456594324,1781,844,123,51,51,0,18,0,0.509803922,0,empty,CD-0722-1
"H5,D2",8824,9404,6809,2595,4519,2072,1,2076,1300,776,1.675257732,1090,2965,756,259,258,1,71,1,0.186046512,0,empty,CD-0722-1
"H5,D3",7858,8856,5843,3013,4281,2223,0,2224,1429,795,1.797484277,1317,1661,235,85,82,3,41,2,0.036585366,0,empty,CD-0722-1
"H5,D4",7529,8408,5625,2783,3966,1951,0,1955,1309,646,2.026315789,1112,1437,282,76,74,2,31,1,0.013513514,0,empty,CD-0722-1
"H5,D5",6816,7557,5263,2294,3678,1770,0,1771,1155,616,1.875,985,2172,497,169,167,2,57,2,0.05988024,0,empty,CD-0722-1
"H5,D6",10781,12100,7684,4416,5782,3164,1,3167,1950,1217,1.60230074,1933,2173,781,282,282,0,57,0,0.046099291,0,empty,CD-0722-1
"H5,D7",5956,6424,4519,1905,3036,1431,0,1431,906,525,1.725714286,760,2192,392,152,148,4,50,2,0.128378378,0,empty,CD-0722-1
"H5,D8",6705,7554,4995,2559,3638,1833,0,1835,1152,683,1.686676428,1089,1152,341,125,123,2,42,2,0.008130081,0,empty,CD-0722-1
"H5,D9",3751,3957,2752,1205,1961,926,0,927,641,286,2.241258741,513,1657,299,116,115,1,56,1,0.008695652,0,empty,CD-0722-1
"H5,D10",6621,7624,4871,2753,3599,1843,0,1849,1163,686,1.695335277,1096,668,131,47,46,1,14,1,0.195652174,0,empty,CD-0722-1
"H5,D11",7626,8081,5862,2219,4016,1843,0,1844,1218,626,1.945686901,1017,3892,1006,270,267,3,95,2,0.014981273,0,empty,CD-0722-1
"H5,D12",10072,11386,7459,3927,5330,2642,0,2644,1679,965,1.739896373,1563,3388,757,256,251,5,91,1,0.047808765,0,empty,CD-0722-1
"H5,E1",11724,13550,8633,4917,6334,3300,0,3300,2067,1233,1.676399027,1934,2980,706,250,249,1,91,1,0.060240964,0,empty,CD-0722-1
"H5,E2",8880,9749,6554,3195,4690,2395,0,2396,1484,912,1.627192982,1408,2243,458,167,166,1,54,1,0.06626506,0,empty,CD-0722-1
"H5,E3",548328,652181,410273,241908,304020,166447,3,166589,133745,32844,4.072128852,99671,143017,22868,7690,7517,173,1330,6,0.056671544,0,hg38,CD-0722-1
"H5,E4",8032,8812,6091,2721,4213,2100,2,2103,1324,779,1.699614891,1148,2932,663,253,250,3,81,2,0.064,0,empty,CD-0722-1
"H5,E5",944147,1092141,712388,379753,497061,264363,5,264680,210809,53871,3.913218615,153113,128709,15874,4977,4882,95,1028,5,0.11634576,0,hg38,CD-0722-1
"H5,E6",12028,13398,9013,4385,6418,3277,3,3282,2076,1206,1.721393035,1884,3443,970,282,279,3,84,1,0.021505376,0,empty,CD-0722-1
"H5,E7",11385,12291,8479,3812,5866,2920,3,2932,1880,1052,1.787072243,1640,2757,641,223,213,10,69,2,0.023474178,0,empty,CD-0722-1
"H5,E8",9285,10191,7103,3088,4806,2254,2,2258,1464,794,1.843828715,1243,2944,828,252,249,3,54,2,0.112449799,0,empty,CD-0722-1
"H5,E9",5778,6565,4423,2142,3049,1492,1,1493,979,514,1.904669261,849,3045,716,258,257,1,77,1,0.081712062,0,empty,CD-0722-1
"H5,E10",528108,575517,409181,166336,270321,127227,0,127365,98553,28812,3.420553936,70756,79125,11819,3943,3841,102,753,5,0.023171049,0,hg38,CD-0722-1
"H5,E11",7984,9073,5929,3144,4358,2244,0,2248,1429,819,1.744810745,1318,2271,625,189,186,3,52,1,0.177419355,0,empty,CD-0722-1
"H5,E12",8557,9634,6224,3410,4584,2314,3,2317,1490,827,1.801692866,1383,1943,416,147,147,0,52,0,0.183673469,0,empty,CD-0722-1
"H5,F1",10290,11053,7743,3310,5247,2481,0,2485,1546,939,1.646432375,1347,1851,267,106,104,2,42,1,0.182692308,0,empty,CD-0722-1
"H5,F2",8584,9315,6380,2935,4391,2109,0,2109,1352,757,1.785997358,1209,3336,882,278,262,16,82,2,0.13740458,0,empty,CD-0722-1
"H5,F3",8098,9100,6146,2954,4364,2122,0,2130,1359,771,1.762645914,1248,3237,758,209,208,1,72,1,0.091346154,0,empty,CD-0722-1
"H5,F4",11793,12848,8933,3915,6117,2912,0,2914,1875,1039,1.804619827,1632,759,150,76,76,0,22,0,0.026315789,0,empty,CD-0722-1
"H5,F5",9789,10862,7344,3518,5020,2441,1,2447,1560,887,1.758737317,1412,2025,392,158,150,8,52,3,0.193333333,0,empty,CD-0722-1
"H5,F6",1139979,1417339,833150,584189,657627,400438,0,400767,319682,81085,3.94255411,248558,17141,5859,1665,1660,5,503,1,0.015662651,0,hg38,CD-0722-1
"H5,F7",11284,12435,8536,3899,5961,3033,0,3041,1982,1059,1.871576959,1700,1178,339,88,87,1,33,1,0.022988506,0,empty,CD-0722-1
"H5,F8",7384,8342,5526,2816,3920,1912,0,1914,1221,693,1.761904762,1139,140,56,13,13,0,5,0,0.076923077,0,empty,CD-0722-1
"H5,F9",8364,9134,6381,2753,4401,2051,0,2055,1308,747,1.751004016,1170,3112,561,210,209,1,69,1,0.138755981,0,empty,CD-0722-1
"H5,F10",10591,11545,8160,3385,5442,2524,0,2528,1667,861,1.93612079,1404,2088,518,196,195,1,54,1,0.215384615,0,empty,CD-0722-1
"H5,F11",7899,8737,6104,2633,4126,1844,3,1847,1237,610,2.027868852,1053,1562,338,128,128,0,46,0,0.0625,0,empty,CD-0722-1
"H5,F12",8898,9886,6594,3292,4629,2284,0,2288,1504,784,1.918367347,1332,222,59,14,13,1,8,1,0,0,empty,CD-0722-1
"H5,G1",10147,11095,7764,3331,5271,2481,0,2485,1642,843,1.947805457,1342,2759,596,201,195,6,85,1,0.102564103,0,empty,CD-0722-1
"H5,G2",1650004,1865961,1207736,658225,860788,504097,4,504557,359205,145352,2.471276625,292390,9057,2979,919,912,7,196,2,0.014254386,0,hg38,CD-0722-1
"H5,G3",10515,11398,7799,3599,5406,2705,0,2711,1657,1054,1.572106262,1474,2623,553,162,160,2,67,2,0.04375,0,empty,CD-0722-1
"H5,G4",18620,21423,13381,8042,10069,5657,0,5661,3506,2155,1.626914153,3293,106,7,3,3,0,3,0,0,0,empty,CD-0722-1
"H5,G5",6632,7365,4927,2438,3499,1729,0,1730,1092,638,1.711598746,1003,1634,312,117,117,0,47,0,0.145299145,0,empty,CD-0722-1
"H5,G6",9579,10370,7126,3244,4882,2381,0,2387,1585,802,1.976309227,1353,191,42,22,22,0,7,0,0,0,empty,CD-0722-1
"H5,G7",1167572,1341904,886348,455556,612436,321463,7,321859,252673,69186,3.652082791,185633,202104,35188,11407,11139,268,1850,8,0.051171559,0,hg38,CD-0722-1
"H5,G8",5695,6178,4295,1883,2925,1376,0,1382,830,552,1.503623188,787,2038,547,204,201,3,56,2,0.074626866,0,empty,CD-0722-1
"H5,G9",570840,659099,429827,229272,306958,160014,1,160178,126602,33576,3.770609959,93748,195221,25883,8666,8452,214,1491,6,0.047917653,0,hg38,CD-0722-1
"H5,G10",7981,8885,5954,2931,4254,2139,0,2141,1344,797,1.686323714,1239,2743,774,267,263,4,79,1,0.015209125,0,empty,CD-0722-1
"H5,G11",692196,781617,529201,252416,360687,183237,2,183438,146393,37045,3.951761371,104268,100394,17405,5432,5347,85,1074,6,0.025808865,0,hg38,CD-0722-1
"H5,G12",6800,7824,5114,2710,3702,1913,0,1918,1242,676,1.837278107,1096,2076,497,203,202,1,52,1,0.069306931,0,empty,CD-0722-1
"H5,H1",6813,7473,4920,2553,3604,1817,0,1817,1160,657,1.765601218,1086,1403,292,96,96,0,25,0,0,0,empty,CD-0722-1
"H5,H2",7810,8602,5855,2747,4016,1953,0,1956,1239,717,1.728033473,1081,2042,504,180,179,1,49,1,0.089385475,0,empty,CD-0722-1
"H5,H3",6307,7135,4855,2280,3403,1737,0,1742,1094,648,1.688271605,985,1529,237,98,95,3,45,2,0.073684211,0,empty,CD-0722-1
"H5,H4",10014,11346,7385,3961,5203,2586,0,2587,1648,939,1.755058573,1518,155,43,23,23,0,13,0,0,0,empty,CD-0722-1
"H5,H5",10911,12032,8096,3936,5553,2743,3,2756,1732,1024,1.69140625,1583,2100,648,215,215,0,60,0,0.069767442,0,empty,CD-0722-1
"H5,H6",6158,6770,4551,2219,3201,1656,0,1657,1103,554,1.990974729,953,1858,384,156,154,2,47,2,0.025974026,0,empty,CD-0722-1
"H5,H7",7321,7825,5516,2309,3751,1765,0,1775,1167,608,1.919407895,956,2072,564,179,178,1,55,1,0.174157303,0,empty,CD-0722-1
"H5,H8",8077,9138,5973,3165,4175,2152,1,2155,1362,793,1.717528373,1209,2159,412,165,165,0,48,0,0.048484848,0,empty,CD-0722-1
"H5,H9",6056,6416,4685,1731,3055,1373,0,1373,929,444,2.092342342,723,1129,267,98,97,1,24,1,0.010309278,0,empty,CD-0722-1
"H5,H10",5488,6154,4012,2142,2927,1442,0,1442,931,511,1.821917808,884,1542,465,132,131,1,35,1,0.114503817,0,empty,CD-0722-1
"H5,H11",643410,781839,462731,319108,367391,218705,1,218949,162712,56237,2.893326458,135945,2123,476,148,145,3,35,2,0.006896552,0,hg38,CD-0722-1
"H5,H12",6093,6683,4378,2305,3215,1669,1,1670,1100,570,1.929824561,985,1244,172,92,90,2,37,1,0.022222222,0,empty,CD-0722-1
"H6,A1",5664,6478,4167,2311,3117,1633,1,1636,1027,609,1.6863711,958,1247,264,111,110,1,49,1,0.245454545,0,empty,CD-0722-1
"H6,A2",8300,9040,6055,2985,4381,2180,2,2186,1400,786,1.781170483,1242,1723,337,138,137,1,58,1,0.131386861,0,empty,CD-0722-1
"H6,A3",450889,507762,342057,165705,234246,117756,11,117905,93160,24745,3.76480097,67529,87013,14421,4699,4583,116,832,6,0.039057386,0,hg38,CD-0722-1
"H6,A4",9108,10029,6716,3313,4704,2332,0,2334,1522,812,1.874384236,1334,1039,221,85,85,0,39,0,0.094117647,0,empty,CD-0722-1
"H6,A5",7480,8130,5566,2564,3960,1940,0,1942,1226,716,1.712290503,1116,2159,473,226,226,0,74,0,0.008849558,0,empty,CD-0722-1
"H6,A6",6279,7310,4670,2640,3493,1808,0,1814,1173,641,1.829953198,1089,2791,463,163,159,4,91,2,0.037735849,0,empty,CD-0722-1
"H6,A7",5647,6574,4208,2366,3057,1553,0,1553,934,619,1.508885299,931,1358,325,142,142,0,65,0,0.014084507,0,empty,CD-0722-1
"H6,A8",3391,3799,2609,1190,1802,852,0,853,573,280,2.046428571,456,1977,670,189,181,8,63,2,0.149171271,0,empty,CD-0722-1
"H6,A9",438584,500291,335651,164640,231697,116834,5,116963,89128,27835,3.202011856,67398,132779,18296,5833,5704,129,1103,5,0.040848527,0,hg38,CD-0722-1
"H6,A10",366063,434376,270927,163449,200793,112219,2,112304,86678,25626,3.382424101,67152,8541,1323,334,333,1,87,1,0.048048048,0,hg38,CD-0722-1
"H6,A11",5349,5737,4078,1659,2752,1297,0,1299,870,429,2.027972028,706,1395,255,100,99,1,42,1,0.212121212,0,empty,CD-0722-1
"H6,A12",7008,7573,5371,2202,3601,1764,1,1769,1098,671,1.636363636,952,3224,822,259,255,4,73,2,0.105882353,0,empty,CD-0722-1
"H6,B1",5967,6618,4341,2277,3161,1617,1,1622,1031,591,1.744500846,929,941,124,66,65,1,35,1,0.030769231,0,empty,CD-0722-1
"H6,B2",6475,7260,4418,2842,3577,1945,0,1950,1246,704,1.769886364,1212,599,110,53,53,0,25,0,0.094339623,0,empty,CD-0722-1
"H6,B3",5726,6444,4175,2269,3118,1613,0,1615,1034,581,1.779690189,942,1217,198,76,74,2,26,2,0.108108108,0,empty,CD-0722-1
"H6,B4",6336,7163,4697,2466,3479,1865,0,1870,1221,649,1.881355932,1047,1404,332,135,128,7,51,2,0.1953125,0,empty,CD-0722-1
"H6,B5",6216,3648,2173,1475,2351,1238,1,1252,811,441,1.839002268,834,633,75,40,38,2,21,1,0.078947368,0,empty,CD-0722-1
"H6,B6",6584,7449,4777,2672,3575,1923,0,1925,1159,766,1.51305483,1126,1467,339,151,151,0,53,0,0.013245033,0,empty,CD-0722-1
"H6,B7",5991,6662,4574,2088,3194,1563,8,1573,1069,504,2.121031746,877,1100,264,93,93,0,28,0,0.11827957,0,empty,CD-0722-1
"H6,B8",4390,4847,3412,1435,2420,1177,0,1177,752,425,1.769411765,642,1654,506,136,136,0,44,0,0.022058824,0,empty,CD-0722-1
"H6,B9",602338,697644,443677,253967,317759,174035,1,174249,148930,25319,5.882143845,102340,20756,3467,913,893,20,247,2,0.066069429,0,hg38,CD-0722-1
"H6,B10",4471,4617,3158,1459,2328,1117,1,1129,727,402,1.808457711,624,574,109,35,34,1,13,1,0.029411765,0,empty,CD-0722-1
"H6,B11",12127,13460,9026,4434,6386,3488,0,3493,2091,1402,1.491440799,2003,255,52,31,30,1,13,1,0,0,empty,CD-0722-1
"H6,B12",5587,6197,4116,2081,2965,1500,0,1506,968,538,1.799256506,866,1066,322,127,127,0,43,0,0.047244094,0,empty,CD-0722-1
"H6,C1",436884,522841,305744,217097,238419,152996,1,153117,117219,35898,3.265335116,91015,1663,315,111,111,0,39,0,0.009009009,0,hg38,CD-0722-1
"H6,C2",8394,9199,6235,2964,4392,2211,0,2211,1397,814,1.716216216,1247,1702,476,147,146,1,45,1,0.095890411,0,empty,CD-0722-1
"H6,C3",9364,10530,6868,3662,5096,2599,0,2604,1667,937,1.779082177,1550,921,178,75,71,4,23,1,0.197183099,0,empty,CD-0722-1
"H6,C4",518502,603080,383979,219101,278861,153331,0,153516,122746,30770,3.989145271,91154,124754,18206,6035,5887,148,1087,4,0.032614235,0,hg38,CD-0722-1
"H6,C5",8803,9684,6644,3040,4568,2211,0,2216,1450,766,1.892950392,1249,1955,298,156,154,2,63,1,0.077922078,0,empty,CD-0722-1
"H6,C6",7757,8395,5541,2854,4189,2175,0,2175,1488,687,2.165938865,1194,1739,384,142,142,0,50,0,0.049295775,0,empty,CD-0722-1
"H6,C7",9222,10455,6668,3787,5015,2762,0,2771,1664,1107,1.503161698,1600,659,135,49,45,4,20,1,0.2,0,empty,CD-0722-1
"H6,C8",10488,11778,7824,3954,5551,2787,0,2794,1868,926,2.017278618,1614,2451,512,200,200,0,86,0,0.1,0,empty,CD-0722-1
"H6,C9",7300,8221,5573,2648,3801,1909,0,1909,1209,700,1.727142857,1104,1771,584,174,174,0,53,0,0.097701149,0,empty,CD-0722-1
"H6,C10",8165,9077,6104,2973,4294,2174,0,2179,1383,796,1.737437186,1258,2131,470,182,179,3,73,2,0.033519553,0,empty,CD-0722-1
"H6,C11",7577,8453,5541,2912,4029,2086,0,2088,1304,784,1.663265306,1208,1622,424,130,130,0,54,0,0.092307692,0,empty,CD-0722-1
"H6,C12",496196,542321,381211,161110,252212,120580,3,120734,91233,29501,3.092539236,67986,26646,4638,1398,1361,37,319,3,0.041146216,0,hg38,CD-0722-1
"H6,D1",8656,9608,6306,3302,4668,2506,0,2510,1571,939,1.673056443,1457,961,169,53,52,1,28,1,0.019230769,0,empty,CD-0722-1
"H6,D2",1290275,1453487,983467,470020,653484,334476,6,334852,268436,66416,4.041736931,189208,293072,52008,16616,16350,266,2314,6,0.076574924,0,hg38,CD-0722-1
"H6,D3",6915,7924,5059,2865,3743,1935,0,1939,1288,651,1.978494624,1159,1703,437,157,157,0,60,0,0.01910828,0,empty,CD-0722-1
"H6,D4",5141,5655,3761,1894,2762,1397,0,1398,852,546,1.56043956,804,1174,252,95,93,2,42,1,0.053763441,0,empty,CD-0722-1
"H6,D5",6110,6760,4519,2241,3365,1705,0,1708,1115,593,1.880269815,995,1624,315,119,115,4,54,2,0.104347826,0,empty,CD-0722-1
"H6,D6",9024,10053,6578,3475,4651,2451,0,2453,1490,963,1.547248183,1395,1653,211,84,83,1,39,1,0,0,empty,CD-0722-1
"H6,D7",5136,5607,3898,1709,2635,1235,11,1249,813,436,1.864678899,709,2002,465,168,164,4,50,1,0.134146341,0,empty,CD-0722-1
"H6,D8",1188435,1423661,875299,548362,646112,366787,3,367160,287751,79409,3.623657268,223048,140810,23669,7512,7327,185,1316,5,0.070015013,0,hg38,CD-0722-1
"H6,D9",4521,5108,3247,1861,2457,1248,0,1253,844,409,2.063569682,769,2123,422,171,169,2,81,2,0.059171598,0,empty,CD-0722-1
"H6,D10",5684,6375,4130,2245,2919,1536,0,1540,927,613,1.51223491,898,758,122,37,37,0,17,0,0.189189189,0,empty,CD-0722-1
"H6,D11",7100,8054,5315,2739,3818,1934,0,1940,1239,701,1.767475036,1128,2577,614,267,256,11,107,2,0.1015625,0,empty,CD-0722-1
"H6,D12",8882,9676,6518,3158,4567,2228,0,2235,1450,785,1.847133758,1238,3723,1024,363,361,2,119,2,0.077562327,0,empty,CD-0722-1
"H6,E1",1007115,1157957,765414,392543,523190,279359,1,279717,223812,55905,4.003434398,161423,202283,27150,8721,8484,237,1415,8,0.047501179,0,hg38,CD-0722-1
"H6,E2",7935,8668,5911,2757,4087,2007,3,2017,1234,783,1.575989783,1094,1978,426,125,120,5,44,2,0.1,0,empty,CD-0722-1
"H6,E3",5436,6050,4167,1883,2852,1363,0,1363,876,487,1.798767967,776,2281,579,226,226,0,86,0,0.017699115,0,empty,CD-0722-1
"H6,E4",1827427,2123955,1367841,756114,950938,523621,5,524122,419578,104544,4.013410621,308854,110340,25474,7838,7731,107,1369,3,0.049152762,0,hg38,CD-0722-1
"H6,E5",5822,6642,4465,2177,3225,1541,0,1543,930,613,1.517128874,881,1754,480,166,161,5,61,1,0.043478261,0,empty,CD-0722-1
"H6,E6",10736,11557,8033,3524,5524,2727,1,2736,1758,978,1.797546012,1520,2785,762,231,230,1,61,1,0.07826087,0,empty,CD-0722-1
"H6,E7",9780,10820,7442,3378,5116,2438,1,2444,1634,810,2.017283951,1411,2789,655,224,224,0,81,0,0.075892857,0,empty,CD-0722-1
"H6,E8",7998,8632,6233,2399,4057,1878,2,1880,1222,658,1.857142857,985,2421,506,188,186,2,60,1,0.080645161,0,empty,CD-0722-1
"H6,E9",5339,5803,3919,1884,2806,1433,0,1433,955,478,1.99790795,793,2248,423,185,185,0,84,0,0.037837838,0,empty,CD-0722-1
"H6,E10",493987,565425,373339,192086,262747,135951,2,136087,107434,28653,3.74948522,79572,93927,12806,4078,3988,90,803,3,0.085005015,0,hg38,CD-0722-1
"H6,E11",7390,7956,5461,2495,3934,1938,0,1943,1232,711,1.732770745,1062,1763,329,152,147,5,59,2,0.088435374,0,empty,CD-0722-1
"H6,E12",7716,8612,5702,2910,4024,2018,0,2021,1334,687,1.941775837,1152,1539,310,124,124,0,44,0,0.072580645,0,empty,CD-0722-1
"H6,F1",9110,9534,6753,2781,4468,2075,0,2082,1359,723,1.87966805,1087,2157,529,186,185,1,76,1,0.048648649,0,empty,CD-0722-1
"H6,F2",7302,7898,5259,2639,3756,1850,0,1861,1212,649,1.867488444,1063,2691,751,267,258,9,107,2,0.015503876,0,empty,CD-0722-1
"H6,F3",557031,652658,414876,237782,302001,164140,1,164326,120905,43421,2.784482163,98754,97834,10522,3418,3292,126,784,8,0.039185905,0,hg38,CD-0722-1
"H6,F4",9993,10591,7584,3007,5190,2429,0,2435,1613,822,1.962287105,1334,443,86,47,45,2,28,1,0.066666667,0,empty,CD-0722-1
"H6,F5",7872,8495,5944,2551,3992,1826,0,1827,1192,635,1.877165354,998,1851,374,137,135,2,52,1,0.133333333,0,empty,CD-0722-1
"H6,F6",909166,1061347,669138,392209,489807,272478,0,272742,210552,62190,3.385624699,163593,100074,16711,5160,5021,139,1060,5,0.077275443,0,hg38,CD-0722-1
"H6,F7",10351,11562,7627,3935,5577,2846,0,2849,1816,1033,1.757986447,1647,1373,248,123,118,5,39,2,0.059322034,0,empty,CD-0722-1
"H6,F8",6396,6878,4837,2041,3317,1595,2,1597,1071,526,2.036121673,895,149,24,14,14,0,8,0,0,0,empty,CD-0722-1
"H6,F9",7236,7836,5477,2359,3732,1793,0,1793,1182,611,1.934533552,984,2393,606,215,214,1,63,1,0.130841121,0,empty,CD-0722-1
"H6,F10",8805,9627,6647,2980,4461,2058,0,2059,1286,773,1.663648124,1160,1797,546,175,174,1,46,1,0.109195402,0,empty,CD-0722-1
"H6,F11",7116,7605,5368,2237,3532,1616,0,1618,1087,531,2.047080979,856,1663,323,123,120,3,41,2,0.033333333,0,empty,CD-0722-1
"H6,F12",7780,8525,5853,2672,4045,2032,0,2034,1270,764,1.662303665,1141,285,69,16,14,2,11,1,0.142857143,0,empty,CD-0722-1
"H6,G1",1422573,1592687,1102607,490080,719046,358769,11,359219,282963,76256,3.710698175,202765,210499,32043,10453,10259,194,1760,8,0.057413003,0,hg38,CD-0722-1
"H6,G2",4766,5432,3342,2090,2598,1379,2,1383,871,512,1.701171875,850,343,68,41,40,1,19,1,0.025,0,empty,CD-0722-1
"H6,G3",670377,777545,505386,272159,355391,187227,2,187450,142172,45278,3.139979681,110674,91112,10244,3316,3202,114,765,6,0.034041224,0,hg38,CD-0722-1
"H6,G4",674645,778708,507589,271119,354494,187323,0,187508,148335,39173,3.786664284,109851,2150,226,97,96,1,28,1,0.239583333,0,empty,CD-0722-1
"H6,G5",5826,6557,4272,2285,3091,1510,0,1517,1013,504,2.009920635,895,1518,465,193,191,2,64,2,0.062827225,0,empty,CD-0722-1
"H6,G6",8288,9164,6321,2843,4222,2036,0,2040,1340,700,1.914285714,1102,276,89,33,33,0,13,0,0,0,empty,CD-0722-1
"H6,G7",7065,7746,5265,2481,3642,1722,0,1730,1121,609,1.840722496,979,2581,568,189,188,1,78,1,0.037234043,0,empty,CD-0722-1
"H6,G8",4886,5321,3631,1690,2567,1227,0,1229,794,435,1.825287356,710,1680,370,116,107,9,47,2,0.074766355,0,empty,CD-0722-1
"H6,G9",588174,707218,430362,276856,323930,184300,2,184469,148155,36314,4.07983147,112280,94936,16912,5297,5213,84,1032,4,0.046806062,0,hg38,CD-0722-1
"H6,G10",587522,682747,439459,243288,312736,168437,0,168607,131604,37003,3.556576494,99302,140417,24729,8187,8046,141,1410,10,0.057419836,0,hg38,CD-0722-1
"H6,G11",7611,8243,5772,2471,4098,1969,0,1974,1268,706,1.796033994,1113,1421,382,127,126,1,54,1,0.015873016,0,empty,CD-0722-1
"H6,G12",6020,6769,4460,2309,3207,1638,0,1640,1057,583,1.813036021,929,1983,544,174,167,7,59,1,0.071856287,0,empty,CD-0722-1
"H6,H1",6505,6969,4830,2139,3322,1600,0,1607,1065,542,1.964944649,904,1194,251,69,69,0,28,0,0,0,empty,CD-0722-1
"H6,H2",420331,467266,316087,151179,215379,103063,0,103191,80443,22748,3.536266925,59997,152420,53366,14142,14077,65,2223,6,0.009661149,0,hg38,CD-0722-1
"H6,H3",5760,6337,4095,2242,3059,1565,0,1565,997,568,1.75528169,950,1391,300,112,111,1,53,1,0.081081081,0,empty,CD-0722-1
"H6,H4",803253,938055,600274,337781,420157,229465,2,229741,178485,51256,3.482226471,135981,3686,481,153,149,4,58,3,0,0,hg38,CD-0722-1
"H6,H5",9061,9938,6944,2994,4546,2214,0,2220,1396,824,1.694174757,1225,1638,493,162,158,4,44,2,0.094936709,0,empty,CD-0722-1
"H6,H6",5622,6254,4085,2169,2987,1530,0,1533,1039,494,2.103238866,907,1626,263,110,110,0,50,0,0.009090909,0,empty,CD-0722-1
"H6,H7",6536,7297,4809,2488,3450,1640,3,1643,1087,556,1.955035971,943,1819,447,184,179,5,69,2,0.106145251,0,empty,CD-0722-1
"H6,H8",546254,637400,410226,227174,291395,156357,2,156503,120381,36122,3.332622778,92723,81088,15102,4808,4715,93,900,3,0.057051962,0,hg38,CD-0722-1
"H6,H9",6190,6578,4698,1880,3037,1376,0,1377,885,492,1.798780488,738,1008,245,82,73,9,31,1,0.02739726,0,empty,CD-0722-1
"H6,H10",5730,6386,4200,2186,3070,1582,0,1585,990,595,1.663865546,930,1118,139,66,66,0,32,0,0.045454545,0,empty,CD-0722-1
"H6,H11",7143,8264,4976,3288,3903,2383,0,2385,1331,1054,1.262808349,1431,91,17,8,8,0,5,0,0,0,empty,CD-0722-1
"H6,H12",5956,6589,4349,2240,3129,1614,0,1619,1075,544,1.976102941,955,1793,391,113,111,2,42,2,0.018018018,0,empty,CD-0722-1
"H7,A1",7368,8411,5424,2987,3983,2075,1,2077,1311,766,1.711488251,1213,1056,113,49,48,1,25,1,0.083333333,0,empty,CD-0722-1
"H7,A2",12046,13578,8916,4662,6411,3406,0,3411,2097,1314,1.595890411,1959,1871,424,160,158,2,62,2,0.120253165,0,empty,CD-0722-1
"H7,A3",997835,1180040,718697,461343,561427,332401,4,332680,244589,88091,2.77654925,200539,37255,4895,1590,1558,32,428,5,0.035301669,0,hg38,CD-0722-1
"H7,A4",12195,13298,9116,4182,6185,3081,0,3084,1984,1100,1.803636364,1723,801,160,71,71,0,31,0,0.084507042,0,empty,CD-0722-1
"H7,A5",714329,825196,527155,298041,378449,207898,1,208105,166822,41283,4.040936947,122443,51235,9969,3251,3216,35,691,4,0.07431592,0,hg38,CD-0722-1
"H7,A6",9054,10206,6687,3519,4945,2631,1,2632,1728,904,1.911504425,1536,2191,586,188,187,1,71,1,0.064171123,0,empty,CD-0722-1
"H7,A7",7578,8432,5656,2776,3917,1991,0,1992,1338,654,2.04587156,1145,1578,251,124,120,4,46,2,0.141666667,0,empty,CD-0722-1
"H7,A8",4540,5061,3419,1642,2456,1200,0,1202,813,389,2.089974293,678,1511,389,148,147,1,48,1,0.156462585,0,empty,CD-0722-1
"H7,A9",11174,12434,8497,3937,6058,3119,0,3123,2195,928,2.365301724,1781,1267,267,97,95,2,34,2,0.157894737,0,empty,CD-0722-1
"H7,A10",9354,10344,7200,3144,4883,2383,0,2389,1555,834,1.864508393,1289,312,42,20,19,1,10,1,0,0,empty,CD-0722-1
"H7,A11",7303,8217,5499,2718,3878,1888,0,1892,1220,672,1.81547619,1087,1303,255,101,101,0,36,0,0.128712871,0,empty,CD-0722-1
"H7,A12",9911,10649,7546,3103,5020,2365,1,2368,1531,837,1.829151732,1273,2578,618,224,221,3,58,2,0.158371041,0,empty,CD-0722-1
"H7,B1",8433,9381,6175,3206,4434,2261,0,2262,1431,831,1.722021661,1342,1029,136,59,59,0,35,0,0,0,empty,CD-0722-1
"H7,B2",9636,10797,6832,3965,5193,2825,0,2825,1738,1087,1.598896044,1694,898,164,70,69,1,29,1,0.057971014,0,empty,CD-0722-1
"H7,B3",6953,7840,5086,2754,3677,1901,0,1905,1195,710,1.683098592,1118,1420,287,98,96,2,28,1,0.166666667,0,empty,CD-0722-1
"H7,B4",8605,9571,6329,3242,4567,2352,8,2364,1539,825,1.865454545,1368,1323,210,98,98,0,42,0,0.051020408,0,empty,CD-0722-1
"H7,B5",13117,10440,6415,4025,5692,3051,0,3063,2203,860,2.561627907,1913,1029,261,93,93,0,30,0,0.032258065,0,empty,CD-0722-1
"H7,B6",9270,10628,6808,3820,5034,2645,0,2657,1707,950,1.796842105,1602,1520,348,134,131,3,37,2,0,0,empty,CD-0722-1
"H7,B7",8832,9737,6905,2832,4572,2188,3,2192,1450,742,1.954177898,1192,907,155,72,71,1,26,1,0.169014085,0,empty,CD-0722-1
"H7,B8",6179,6947,4653,2294,3243,1553,0,1555,1005,550,1.827272727,902,1042,146,73,72,1,34,1,0.027777778,0,empty,CD-0722-1
"H7,B9",11967,13549,8774,4775,6344,3359,0,3366,2056,1310,1.569465649,1968,884,106,43,43,0,28,0,0.11627907,0,empty,CD-0722-1
"H7,B10",6060,6674,4316,2358,3330,1699,0,1701,1071,630,1.7,1021,705,107,52,51,1,21,1,0.117647059,0,empty,CD-0722-1
"H7,B11",686393,825659,485369,340290,379960,243114,1,243357,174452,68905,2.531775633,147399,473,74,29,29,0,10,0,0.689655172,0,empty,CD-0722-1
"H7,B12",7200,7780,5519,2261,3740,1790,0,1791,1123,668,1.681137725,983,1187,246,99,96,3,35,2,0.083333333,0,empty,CD-0722-1
"H7,C1",14507,15847,11184,4663,7418,3485,0,3492,2199,1293,1.700696056,1915,773,197,76,76,0,23,0,0.092105263,0,empty,CD-0722-1
"H7,C2",12504,14311,9181,5130,6432,3306,0,3309,2090,1219,1.714520098,1972,1824,440,158,157,1,52,1,0.012738854,0,empty,CD-0722-1
"H7,C3",12727,13770,9595,4175,6496,3130,0,3130,1998,1132,1.765017668,1683,714,161,70,69,1,26,1,0.072463768,0,empty,CD-0722-1
"H7,C4",8097,8798,6369,2429,4165,1935,0,1939,1287,652,1.97392638,1010,1596,350,119,113,6,49,2,0.07079646,0,empty,CD-0722-1
"H7,C5",949735,1106428,708406,398022,508628,282367,2,282645,218441,64204,3.402295807,166528,87470,13510,4584,4496,88,927,5,0.054937722,0,hg38,CD-0722-1
"H7,C6",9716,10660,7163,3497,5224,2647,0,2651,1751,900,1.945555556,1486,1647,309,144,144,0,67,0,0.006944444,0,empty,CD-0722-1
"H7,C7",14569,16668,10619,6049,7787,4312,0,4314,2722,1592,1.709798995,2511,453,102,23,23,0,10,0,0.086956522,0,empty,CD-0722-1
"H7,C8",829067,945600,625805,319795,432587,224919,3,225165,170992,54173,3.156406328,130889,138149,23071,7818,7689,129,1355,5,0.060215893,0,hg38,CD-0722-1
"H7,C9",670773,786307,500868,285439,365586,197578,1,197777,147726,50051,2.95150946,119034,82431,8290,2929,2838,91,590,4,0.065891473,0,hg38,CD-0722-1
"H7,C10",631014,792240,430446,361794,373859,254341,0,254593,157276,97317,1.616120513,160417,2255,665,244,239,5,69,2,0.075313808,0,hg38,CD-0722-1
"H7,C11",10110,11279,7463,3816,5360,2668,0,2669,1751,918,1.907407407,1597,1650,402,179,178,1,70,1,0.06741573,0,empty,CD-0722-1
"H7,C12",14076,15624,10441,5183,7302,3594,0,3601,2362,1239,1.90637611,2041,2030,578,213,212,1,51,1,0.141509434,0,empty,CD-0722-1
"H7,D1",12961,14357,9431,4926,6715,3545,0,3552,2094,1458,1.436213992,2048,1006,148,58,57,1,20,1,0.070175439,0,empty,CD-0722-1
"H7,D2",11199,11968,8643,3325,5611,2586,0,2587,1707,880,1.939772727,1352,2284,633,187,186,1,62,1,0.069892473,0,empty,CD-0722-1
"H7,D3",9297,10458,6985,3473,5032,2563,0,2570,1662,908,1.830396476,1479,1355,277,109,104,5,42,1,0.144230769,0,empty,CD-0722-1
"H7,D4",7414,8547,5576,2971,4034,2021,0,2021,1335,686,1.94606414,1195,1795,438,108,103,5,39,2,0.13592233,0,empty,CD-0722-1
"H7,D5",8540,9678,6414,3264,4574,2280,5,2289,1569,720,2.179166667,1334,1466,206,86,81,5,46,3,0.061728395,0,empty,CD-0722-1
"H7,D6",12023,13341,8896,4445,6296,3305,0,3313,1976,1337,1.477935677,1918,1387,369,142,141,1,46,1,0.028368794,0,empty,CD-0722-1
"H7,D7",6895,7721,5160,2561,3545,1772,0,1774,1170,604,1.937086093,1029,1841,516,157,153,4,42,1,0.065359477,0,empty,CD-0722-1
"H7,D8",785430,894687,599124,295563,411897,208523,0,208721,156194,52527,2.973594532,120779,61061,7823,2652,2590,62,564,4,0.082239382,0,hg38,CD-0722-1
"H7,D9",5096,5638,3884,1754,2673,1270,0,1274,836,438,1.908675799,735,1303,266,75,74,1,37,1,0.054054054,0,empty,CD-0722-1
"H7,D10",8073,8930,5967,2963,4161,2079,0,2083,1302,781,1.66709347,1186,965,203,78,78,0,23,0,0.102564103,0,empty,CD-0722-1
"H7,D11",9552,10451,7225,3226,4946,2363,0,2367,1504,863,1.742757822,1329,2573,575,232,231,1,75,1,0.008658009,0,empty,CD-0722-1
"H7,D12",1198476,1385234,898560,486674,624038,335105,2,335472,261245,74227,3.519541407,196616,175325,25936,8486,8315,171,1496,5,0.038604931,0,hg38,CD-0722-1
"H7,E1",14911,16483,11056,5427,7725,3888,0,3894,2437,1457,1.672614962,2270,2018,279,140,138,2,71,1,0.101449275,0,empty,CD-0722-1
"H7,E2",10451,11481,7694,3787,5454,2724,0,2729,1732,997,1.737211635,1535,1700,249,105,101,4,49,2,0,0,empty,CD-0722-1
"H7,E3",7199,7925,5443,2482,3800,1841,0,1841,1261,580,2.174137931,995,2069,452,163,159,4,61,2,0.006289308,0,empty,CD-0722-1
"H7,E4",9788,10530,7317,3213,5010,2413,0,2414,1502,912,1.646929825,1373,1993,275,118,118,0,67,0,0.084745763,0,empty,CD-0722-1
"H7,E5",8458,9062,6609,2453,4309,1996,0,1998,1296,702,1.846153846,1058,1414,365,109,109,0,38,0,0.009174312,0,empty,CD-0722-1
"H7,E6",14753,16199,11067,5132,7699,3855,0,3856,2411,1445,1.668512111,2179,2550,615,229,227,2,70,2,0.044052863,0,empty,CD-0722-1
"H7,E7",14270,16196,10585,5611,7369,3641,0,3645,2339,1306,1.790964778,2118,2472,397,136,134,2,53,2,0.082089552,0,empty,CD-0722-1
"H7,E8",10828,11775,8157,3618,5560,2598,0,2598,1722,876,1.965753425,1435,2527,556,173,172,1,50,1,0.098837209,0,empty,CD-0722-1
"H7,E9",7486,8107,5587,2520,3892,1893,0,1894,1260,634,1.987381703,1070,2124,432,159,159,0,60,0,0.150943396,0,empty,CD-0722-1
"H7,E10",9085,9797,7046,2751,4542,2066,0,2069,1347,722,1.86565097,1099,1877,269,121,114,7,51,2,0.035087719,0,empty,CD-0722-1
"H7,E11",9744,10701,7345,3356,5037,2472,3,2481,1510,971,1.555097837,1379,1481,314,137,137,0,40,0,0,0,empty,CD-0722-1
"H7,E12",10429,11672,7806,3866,5503,2750,1,2757,1730,1027,1.684518014,1612,1728,474,168,166,2,56,2,0.024096386,0,empty,CD-0722-1
"H7,F1",12388,13293,9093,4200,6323,3119,0,3127,1941,1186,1.636593592,1753,1988,596,200,200,0,58,0,0.04,0,empty,CD-0722-1
"H7,F2",10090,10970,7617,3353,5240,2509,2,2517,1658,859,1.930151339,1399,2586,484,203,203,0,83,0,0.088669951,0,empty,CD-0722-1
"H7,F3",9814,10441,7356,3085,5027,2370,0,2370,1516,854,1.775175644,1324,2397,656,223,219,4,81,2,0.04109589,0,empty,CD-0722-1
"H7,F4",13971,14991,10394,4597,7210,3395,1,3402,2140,1262,1.695721078,1947,684,169,69,66,3,28,1,0.03030303,0,empty,CD-0722-1
"H7,F5",11752,12730,8794,3936,5845,2773,0,2775,1786,989,1.80586451,1515,1864,395,122,119,3,53,1,0.058823529,0,empty,CD-0722-1
"H7,F6",13815,15860,10351,5509,7308,3761,0,3766,2438,1328,1.835843373,2234,2926,716,247,247,0,84,0,0.056680162,0,empty,CD-0722-1
"H7,F7",13416,15077,10086,4991,7007,3476,1,3485,2211,1274,1.735478807,1966,1622,351,99,99,0,41,0,0.111111111,0,empty,CD-0722-1
"H7,F8",9251,10138,6903,3235,4711,2234,0,2235,1359,876,1.551369863,1255,282,63,27,27,0,13,0,0.185185185,0,empty,CD-0722-1
"H7,F9",10131,11283,7548,3735,5201,2473,0,2477,1677,800,2.09625,1417,2380,616,180,179,1,53,1,0.055865922,0,empty,CD-0722-1
"H7,F10",12315,13744,9384,4360,6395,3007,1,3010,1974,1036,1.905405405,1718,1453,305,93,86,7,36,2,0.011627907,0,empty,CD-0722-1
"H7,F11",10162,11342,7720,3622,5305,2542,0,2551,1700,851,1.997649824,1420,1397,273,121,117,4,41,1,0.162393162,0,empty,CD-0722-1
"H7,F12",11055,12254,8333,3921,5614,2734,0,2741,1805,936,1.928418803,1607,198,17,9,9,0,5,0,0.111111111,0,empty,CD-0722-1
"H7,G1",941097,1107368,693624,413744,506392,284731,1,285026,235609,49417,4.767772224,169863,294317,44068,14992,14706,286,2208,7,0.041479668,0,hg38,CD-0722-1
"H7,G2",7079,7782,4958,2824,3562,1854,0,1854,1153,701,1.644793153,1061,529,129,53,53,0,19,0,0.075471698,0,empty,CD-0722-1
"H7,G3",12907,13725,9583,4142,6571,3310,0,3313,1972,1341,1.47054437,1777,2304,322,157,156,1,59,1,0.08974359,0,empty,CD-0722-1
"H7,G4",3243376,3707620,2449904,1257716,1619316,884920,4,885937,711314,174623,4.073426754,512772,4152,638,221,220,1,58,1,0.118181818,0,hg38,CD-0722-1
"H7,G5",1584121,1864169,1162610,701559,854199,510970,2,511395,398453,112942,3.527943546,304150,27939,12022,3831,3813,18,716,2,0.027275111,0,hg38,CD-0722-1
"H7,G6",11434,12687,8625,4062,5851,2892,0,2897,1879,1018,1.845776031,1650,156,20,9,9,0,4,0,0.333333333,0,empty,CD-0722-1
"H7,G7",9712,10642,7363,3279,5115,2446,0,2448,1621,827,1.960096735,1378,2074,436,184,182,2,56,1,0.186813187,0,empty,CD-0722-1
"H7,G8",6756,7261,5146,2115,3415,1576,0,1581,1043,538,1.93866171,841,1646,464,174,172,2,47,2,0.087209302,0,empty,CD-0722-1
"H7,G9",8004,8998,5935,3063,4326,2178,0,2180,1393,787,1.770012706,1274,2132,521,188,187,1,60,1,0.085561497,0,empty,CD-0722-1
"H7,G10",451304,571163,296230,274933,271062,192888,1,193038,134169,58869,2.279111247,120777,2456,626,198,198,0,83,0,0.035353535,0,hg38,CD-0722-1
"H7,G11",10137,11109,7774,3335,5185,2465,0,2472,1656,816,2.029411765,1357,1072,380,118,116,2,44,2,0.120689655,0,empty,CD-0722-1
"H7,G12",8069,8769,5979,2790,4181,2062,0,2062,1328,734,1.809264305,1149,1980,463,193,190,3,53,2,0.073684211,0,empty,CD-0722-1
"H7,H1",8609,9070,6413,2657,4334,2090,0,2092,1377,715,1.925874126,1133,961,174,71,71,0,30,0,0,0,empty,CD-0722-1
"H7,H2",9828,11088,7223,3865,5116,2585,0,2588,1631,957,1.704284222,1513,2320,534,235,233,2,75,2,0.0472103,0,empty,CD-0722-1
"H7,H3",8243,8983,6000,2983,4246,2127,0,2128,1414,714,1.980392157,1222,1336,203,83,81,2,33,1,0.209876543,0,empty,CD-0722-1
"H7,H4",11930,13213,8894,4319,6043,2954,0,2959,1925,1034,1.861702128,1689,355,109,34,34,0,14,0,0.029411765,0,empty,CD-0722-1
"H7,H5",12372,13798,9101,4697,6440,3212,0,3214,2085,1129,1.84676705,1873,1795,471,188,187,1,46,1,0.032085561,0,empty,CD-0722-1
"H7,H6",8124,9061,6049,3012,4250,2174,2,2188,1413,775,1.823225806,1265,1599,288,133,132,1,50,1,0.25,0,empty,CD-0722-1
"H7,H7",9423,10219,7024,3195,4806,2330,0,2332,1530,802,1.907730673,1342,1489,372,131,128,3,50,2,0.0234375,0,empty,CD-0722-1
"H7,H8",1562195,1779029,1191329,587700,798292,413822,3,414298,324752,89546,3.62664999,238334,219865,21459,7265,7067,198,1475,9,0.053063535,0,hg38,CD-0722-1
"H7,H9",8015,8444,6060,2384,3934,1755,0,1760,1159,601,1.928452579,960,871,175,47,44,3,19,2,0,0,empty,CD-0722-1
"H7,H10",926973,1091571,683641,407930,496148,277799,2,278123,220471,57652,3.824169153,166311,94698,16813,5682,5537,145,1031,5,0.062849919,0,hg38,CD-0722-1
"H7,H11",9774,11836,6658,5178,5628,3510,0,3510,1920,1590,1.20754717,2223,17,2,2,2,0,2,0,0,0,empty,CD-0722-1
"H7,H12",696954,762477,540753,221724,354323,166387,3,166575,130848,35727,3.662440171,92510,102907,12808,4294,4195,99,853,6,0.039809297,0,hg38,CD-0722-1
"H8,A1",6911,7822,5010,2812,3734,1985,1,1990,1279,711,1.798874824,1165,796,142,79,77,2,29,1,0.181818182,0,empty,CD-0722-1
"H8,A2",9863,10997,7314,3683,5113,2608,0,2610,1630,980,1.663265306,1476,1505,358,129,127,2,40,2,0.102362205,0,empty,CD-0722-1
"H8,A3",6289,7155,4663,2492,3217,1597,0,1598,1091,507,2.151873767,903,705,196,56,55,1,18,1,0.127272727,0,empty,CD-0722-1
"H8,A4",11758,12613,9041,3572,5894,2835,0,2835,1858,977,1.90174002,1457,728,208,67,66,1,27,1,0.212121212,0,empty,CD-0722-1
"H8,A5",9110,9911,6986,2925,4695,2257,3,2261,1501,760,1.975,1194,1774,397,127,125,2,50,2,0.056,0,empty,CD-0722-1
"H8,A6",7542,9049,5576,3473,4242,2283,0,2285,1470,815,1.803680982,1392,1858,342,130,128,2,61,2,0.09375,0,empty,CD-0722-1
"H8,A7",6887,7814,5035,2779,3730,1971,0,1972,1303,669,1.947683109,1174,1148,269,87,87,0,40,0,0.034482759,0,empty,CD-0722-1
"H8,A8",4089,4384,3092,1292,2125,1022,0,1022,703,319,2.203761755,556,1196,184,82,82,0,24,0,0.170731707,0,empty,CD-0722-1
"H8,A9",2207679,2591543,1638229,953314,1170499,657830,6,658453,529473,128980,4.105078307,389722,241988,44605,14482,14219,263,2175,3,0.065686757,0,hg38,CD-0722-1
"H8,A10",7204,7686,5571,2115,3756,1826,0,1830,1218,612,1.990196078,960,292,45,21,21,0,10,0,0.380952381,0,empty,CD-0722-1
"H8,A11",6585,7221,4982,2239,3450,1630,0,1634,1094,540,2.025925926,947,960,187,81,81,0,35,0,0.12345679,0,empty,CD-0722-1
"H8,A12",7925,8574,6004,2570,4022,1889,0,1891,1181,710,1.663380282,1025,2336,626,254,246,8,63,2,0.093495935,0,empty,CD-0722-1
"H8,B1",7356,7985,5424,2561,3798,1895,0,1895,1266,629,2.012718601,1048,629,158,63,63,0,25,0,0.015873016,0,empty,CD-0722-1
"H8,B2",8447,9166,5869,3297,4400,2329,0,2329,1446,883,1.637599094,1390,503,56,24,24,0,13,0,0.083333333,0,empty,CD-0722-1
"H8,B3",5664,6124,4227,1897,2991,1503,0,1504,963,541,1.780036969,807,1082,364,80,80,0,25,0,0.175,0,empty,CD-0722-1
"H8,B4",6833,7859,4990,2869,3822,2023,0,2026,1296,730,1.775342466,1235,1134,267,108,107,1,38,1,0.121495327,0,empty,CD-0722-1
"H8,B5",7398,4030,2414,1616,2651,1444,0,1451,987,464,2.127155172,943,586,51,23,23,0,10,0,0,0,empty,CD-0722-1
"H8,B6",7888,8759,5822,2937,4271,2257,0,2262,1450,812,1.785714286,1318,1013,317,105,105,0,28,0,0.2,0,empty,CD-0722-1
"H8,B7",7755,8215,5901,2314,3970,1888,0,1888,1231,657,1.873668189,1012,1003,331,107,106,1,30,1,0,0,empty,CD-0722-1
"H8,B8",5303,5819,4094,1725,2748,1247,0,1248,785,463,1.695464363,668,669,162,72,70,2,20,1,0.242857143,0,empty,CD-0722-1
"H8,B9",10135,11365,7479,3886,5293,2765,4,2771,1735,1036,1.674710425,1597,1006,190,47,46,1,15,1,0.5,0,empty,CD-0722-1
"H8,B10",5182,5376,3688,1688,2777,1405,0,1412,913,499,1.829659319,799,330,24,14,14,0,10,0,0,0,empty,CD-0722-1
"H8,B11",13491,15032,10162,4870,7188,3767,0,3770,2334,1436,1.625348189,2150,120,28,18,18,0,5,0,0.444444444,0,empty,CD-0722-1
"H8,B12",6327,7100,4748,2352,3433,1718,0,1719,1096,623,1.759229535,986,929,174,53,51,2,21,1,0.156862745,0,empty,CD-0722-1
"H8,C1",13592,14493,10231,4262,6782,3235,0,3239,1983,1256,1.578821656,1761,853,196,66,66,0,24,0,0.015151515,0,empty,CD-0722-1
"H8,C2",10736,12196,7838,4358,5651,2911,0,2921,1913,1008,1.89781746,1731,1866,476,182,181,1,35,1,0.022099448,0,empty,CD-0722-1
"H8,C3",11571,12908,8585,4323,6195,3036,0,3041,1963,1078,1.82096475,1758,606,61,31,31,0,14,0,0.096774194,0,empty,CD-0722-1
"H8,C4",7239,7952,5444,2508,3754,1807,0,1808,1139,669,1.702541106,1025,1777,381,127,126,1,29,1,0.079365079,0,empty,CD-0722-1
"H8,C5",743269,922007,506633,415374,426637,287846,3,288085,206907,81178,2.548806327,178116,11779,863,304,290,14,85,3,0.520689655,0,hg38,CD-0722-1
"H8,C6",8720,9411,6443,2968,4636,2308,0,2309,1507,802,1.879052369,1353,1642,378,139,139,0,48,0,0.18705036,0,empty,CD-0722-1
"H8,C7",11298,13199,8165,5034,6305,3482,0,3483,2123,1360,1.561029412,2162,508,180,56,55,1,20,1,0.181818182,0,empty,CD-0722-1
"H8,C8",1803339,2083337,1356225,727112,938952,514959,7,515474,397969,117505,3.386826093,302842,135525,18214,5814,5677,137,1186,3,0.053373261,0,hg38,CD-0722-1
"H8,C9",8667,9824,6447,3377,4683,2382,0,2385,1513,872,1.735091743,1433,1079,201,84,84,0,28,0,0.023809524,0,empty,CD-0722-1
"H8,C10",10415,11224,7809,3415,5349,2564,0,2565,1679,886,1.89503386,1395,1585,400,110,109,1,36,1,0.19266055,0,empty,CD-0722-1
"H8,C11",8947,9652,6602,3050,4596,2231,0,2234,1461,773,1.89003881,1280,1818,438,197,193,4,44,2,0.025906736,0,empty,CD-0722-1
"H8,C12",12624,13727,9431,4296,6414,3088,0,3094,2001,1093,1.83074108,1742,1629,521,125,124,1,32,1,0.008064516,0,empty,CD-0722-1
"H8,D1",11212,12567,8370,4197,5773,2944,0,2949,1870,1079,1.733086191,1704,539,100,40,39,1,15,1,0,0,empty,CD-0722-1
"H8,D2",10166,11223,7817,3406,5120,2392,0,2394,1517,877,1.729760547,1335,1925,504,181,172,9,57,2,0.069767442,0,empty,CD-0722-1
"H8,D3",8232,8999,6068,2931,4347,2213,0,2218,1462,756,1.933862434,1268,1276,277,107,105,2,49,1,0.076190476,0,empty,CD-0722-1
"H8,D4",7506,8526,5595,2931,3993,2003,1,2008,1307,701,1.864479315,1161,1155,283,117,117,0,33,0,0.017094017,0,empty,CD-0722-1
"H8,D5",7669,8454,5688,2766,4002,1949,0,1953,1240,713,1.739130435,1116,1391,308,101,97,4,39,2,0.030927835,0,empty,CD-0722-1
"H8,D6",10892,12474,7857,4617,5859,3282,0,3287,1912,1375,1.390545455,1990,1141,202,73,73,0,28,0,0.109589041,0,empty,CD-0722-1
"H8,D7",6321,6820,4764,2056,3215,1514,0,1515,1008,507,1.98816568,846,1570,422,132,126,6,36,3,0.198412698,0,empty,CD-0722-1
"H8,D8",7670,8597,5832,2765,3947,1928,0,1930,1265,665,1.902255639,1087,926,191,82,80,2,31,2,0.1,0,empty,CD-0722-1
"H8,D9",4717,5122,3586,1536,2509,1217,0,1220,810,410,1.975609756,693,1172,257,85,85,0,41,0,0.058823529,0,empty,CD-0722-1
"H8,D10",7122,7929,5265,2664,3811,1958,0,1963,1251,712,1.757022472,1136,894,174,72,72,0,17,0,0.027777778,0,empty,CD-0722-1
"H8,D11",8663,9407,6593,2814,4639,2290,1,2295,1443,852,1.693661972,1292,2137,628,224,220,4,65,2,0.122727273,0,empty,CD-0722-1
"H8,D12",10760,12115,8133,3982,5607,2782,0,2783,1773,1010,1.755445545,1571,2946,743,257,256,1,81,1,0.05859375,0,empty,CD-0722-1
"H8,E1",13086,14446,9606,4840,6823,3563,0,3571,2221,1350,1.645185185,2059,1997,483,154,147,7,57,2,0.013605442,0,empty,CD-0722-1
"H8,E2",9657,10487,7118,3369,5042,2523,0,2529,1536,993,1.546827795,1469,1346,221,83,81,2,32,1,0.024691358,0,empty,CD-0722-1
"H8,E3",493001,597774,354071,243703,278847,166384,1,166558,130450,36108,3.612772793,101999,29642,11303,3374,3363,11,743,3,0.047279215,0,hg38,CD-0722-1
"H8,E4",8878,9611,6541,3070,4591,2213,0,2215,1484,731,2.030095759,1268,2014,457,170,169,1,62,1,0,0,empty,CD-0722-1
"H8,E5",8074,8796,6023,2773,4211,2011,0,2014,1292,722,1.789473684,1134,1291,449,174,173,1,39,1,0.028901734,0,empty,CD-0722-1
"H8,E6",903475,1049056,677689,371367,470038,253055,1,253318,206470,46848,4.407231899,147940,161953,23767,7686,7537,149,1376,5,0.064879926,0,hg38,CD-0722-1
"H8,E7",11868,12992,8815,4177,6176,2977,0,2980,1966,1014,1.938856016,1694,2140,403,151,148,3,53,1,0.074324324,0,empty,CD-0722-1
"H8,E8",102716,118562,77063,41499,53735,30221,0,30265,21626,8639,2.503298993,17086,3583,798,248,245,3,67,1,0.114285714,0,empty,CD-0722-1
"H8,E9",6206,6848,4748,2100,3157,1535,0,1536,1047,489,2.141104294,797,1773,433,128,121,7,49,1,0.024793388,0,empty,CD-0722-1
"H8,E10",7711,8210,5952,2258,3896,1791,0,1791,1175,616,1.907467532,972,1817,560,205,198,7,46,2,0.045454545,0,empty,CD-0722-1
"H8,E11",9069,9914,6772,3142,4764,2377,0,2377,1569,808,1.941831683,1328,1571,418,109,108,1,39,1,0.046296296,0,empty,CD-0722-1
"H8,E12",9095,10167,6654,3513,5003,2561,0,2565,1630,935,1.743315508,1551,1577,240,102,100,2,35,1,0.09,0,empty,CD-0722-1
"H8,F1",11736,12747,8751,3996,5933,2891,0,2899,1832,1067,1.716963449,1596,2094,636,220,220,0,57,0,0.1,0,empty,CD-0722-1
"H8,F2",9148,9995,6703,3292,4708,2322,0,2322,1527,795,1.920754717,1338,2006,436,164,163,1,56,1,0.030674847,0,empty,CD-0722-1
"H8,F3",8755,9619,6422,3197,4522,2217,0,2221,1463,758,1.930079156,1282,1861,343,118,116,2,43,2,0.068965517,0,empty,CD-0722-1
"H8,F4",13307,13944,10102,3842,6652,3100,1,3104,2018,1086,1.858195212,1646,411,64,36,35,1,18,1,0.028571429,0,empty,CD-0722-1
"H8,F5",10291,11017,7805,3212,5275,2470,0,2470,1586,884,1.794117647,1355,1496,451,170,170,0,42,0,0.1,0,empty,CD-0722-1
"H8,F6",751812,894743,549555,345188,411977,235027,1,235224,185345,49879,3.71589246,142903,98167,16542,5461,5349,112,1008,4,0.039820527,0,hg38,CD-0722-1
"H8,F7",12238,13530,9202,4328,6500,3226,0,3228,2144,1084,1.977859779,1862,964,291,79,79,0,34,0,0,0,empty,CD-0722-1
"H8,F8",8019,8898,5994,2904,4149,2036,1,2042,1323,719,1.840055633,1175,212,50,17,17,0,11,0,0.058823529,0,empty,CD-0722-1
"H8,F9",8747,9531,6695,2836,4519,2131,0,2132,1371,761,1.801576873,1199,1910,541,202,202,0,52,0,0.01980198,0,empty,CD-0722-1
"H8,F10",11482,12282,8806,3476,5770,2675,0,2677,1783,894,1.994407159,1437,1735,409,165,163,2,55,2,0.147239264,0,empty,CD-0722-1
"H8,F11",8479,9386,6549,2837,4399,2070,0,2072,1360,712,1.91011236,1129,1256,318,127,126,1,31,1,0.103174603,0,empty,CD-0722-1
"H8,F12",9991,10942,7291,3651,5085,2483,0,2486,1680,806,2.084367246,1463,183,65,30,30,0,5,0,0.1,0,empty,CD-0722-1
"H8,G1",11011,11952,8324,3628,5763,2701,1,2713,1741,972,1.791152263,1537,1972,378,132,126,6,55,2,0.071428571,0,empty,CD-0722-1
"H8,G2",7140,7973,4987,2986,3700,1950,0,1950,1231,719,1.712100139,1159,387,131,48,47,1,17,1,0.021276596,0,empty,CD-0722-1
"H8,G3",846451,1021769,614010,407759,467504,273535,3,273844,221413,52431,4.222940627,167258,143933,22593,7473,7336,137,1400,7,0.071428571,0,hg38,CD-0722-1
"H8,G4",20454,23237,14772,8465,11018,6075,0,6085,3686,2399,1.536473531,3664,103,9,9,9,0,6,0,0,0,empty,CD-0722-1
"H8,G5",7220,7949,5332,2617,3787,1849,0,1850,1245,605,2.05785124,1055,1094,245,96,95,1,34,1,0.305263158,0,empty,CD-0722-1
"H8,G6",10622,11359,8076,3283,5224,2452,0,2456,1612,844,1.909952607,1277,170,83,43,43,0,12,0,0.046511628,0,empty,CD-0722-1
"H8,G7",8776,9559,6662,2897,4542,2088,0,2090,1364,726,1.878787879,1174,1780,403,116,114,2,44,1,0.105263158,0,empty,CD-0722-1
"H8,G8",6402,7063,4729,2334,3280,1588,7,1595,1002,593,1.689713322,911,1441,326,118,116,2,45,2,0.034482759,0,empty,CD-0722-1
"H8,G9",7353,8127,5598,2529,3789,1809,0,1815,1141,674,1.692878338,1007,1812,483,168,167,1,70,1,0.035928144,0,empty,CD-0722-1
"H8,G10",8683,9596,6453,3143,4553,2275,0,2280,1459,821,1.777101096,1280,2027,584,247,228,19,64,2,0.048245614,0,empty,CD-0722-1
"H8,G11",9073,9908,6915,2993,4718,2228,0,2234,1451,783,1.853128991,1257,1169,279,119,119,0,36,0,0.016806723,0,empty,CD-0722-1
"H8,G12",7291,8112,5504,2608,3890,1955,0,1955,1290,665,1.939849624,1117,1842,376,108,107,1,43,1,0.028037383,0,empty,CD-0722-1
"H8,H1",6883,7509,5141,2368,3585,1722,0,1729,1173,556,2.10971223,977,1014,254,68,68,0,27,0,0.235294118,0,empty,CD-0722-1
"H8,H2",8515,9192,6394,2798,4373,2097,0,2102,1308,794,1.647355164,1183,1771,476,149,149,0,48,0,0.087248322,0,empty,CD-0722-1
"H8,H3",7205,8500,5354,3146,3947,2007,0,2007,1307,700,1.867142857,1236,991,117,68,68,0,33,0,0.205882353,0,empty,CD-0722-1
"H8,H4",779996,890988,591204,299784,407749,209147,3,209366,164683,44683,3.685585122,120801,8933,1458,489,484,5,118,2,0.024793388,0,hg38,CD-0722-1
"H8,H5",909225,1058298,676433,381865,479936,261688,2,261976,197175,64801,3.042777118,156184,94744,15567,4963,4850,113,916,6,0.044329897,0,hg38,CD-0722-1
"H8,H6",6485,7240,4719,2521,3389,1792,0,1796,1230,566,2.173144876,1066,1404,237,86,85,1,24,1,0.258823529,0,empty,CD-0722-1
"H8,H7",8280,8854,6244,2610,4167,1977,0,1980,1324,656,2.018292683,1037,1576,518,154,154,0,47,0,0.155844156,0,empty,CD-0722-1
"H8,H8",8328,8991,6027,2964,4247,2168,0,2168,1371,797,1.720200753,1237,1763,480,146,144,2,44,1,0.083333333,0,empty,CD-0722-1
"H8,H9",7057,7451,5372,2079,3385,1510,0,1512,1037,475,2.183157895,763,957,215,82,81,1,21,1,0,0,empty,CD-0722-1
"H8,H10",6169,6939,4571,2368,3209,1608,3,1612,1060,552,1.920289855,907,868,176,69,68,1,18,1,0.044117647,0,empty,CD-0722-1
"H8,H11",7637,8817,5319,3498,4245,2536,0,2542,1441,1101,1.308810173,1557,56,6,5,3,2,3,1,0.333333333,0,empty,CD-0722-1
"H8,H12",6611,7087,4872,2215,3397,1765,0,1767,1150,617,1.863857374,1003,1146,242,86,85,1,28,1,0.047058824,0,empty,CD-0722-1
"H9,A1",7011,7779,5083,2696,3774,2014,0,2017,1332,685,1.944525547,1174,1164,113,49,47,2,27,1,0.042553191,0,empty,CD-0722-1
"H9,A2",10522,11995,7690,4305,5555,2820,1,2827,1821,1006,1.810139165,1656,1482,398,161,158,3,49,2,0.082278481,0,empty,CD-0722-1
"H9,A3",6735,7405,4955,2450,3425,1727,0,1730,1117,613,1.822185971,975,912,184,67,67,0,24,0,0.014925373,0,empty,CD-0722-1
"H9,A4",11572,12629,8679,3950,6050,3047,0,3047,1940,1107,1.752484192,1701,790,129,37,36,1,14,1,0.166666667,0,empty,CD-0722-1
"H9,A5",9816,10737,7424,3313,5271,2571,1,2579,1667,912,1.827850877,1488,1815,408,169,166,3,56,2,0.120481928,0,empty,CD-0722-1
"H9,A6",12918,14966,9408,5558,7407,4190,0,4200,3084,1116,2.76344086,2482,2387,685,217,213,4,67,2,0.154929577,0,empty,CD-0722-1
"H9,A7",7030,7953,5220,2733,3712,1906,0,1909,1210,699,1.731044349,1093,1220,207,105,105,0,49,0,0.047619048,0,empty,CD-0722-1
"H9,A8",725383,866171,545087,321084,403938,225301,2,225510,186283,39227,4.748846458,134051,132798,19607,6376,6242,134,1306,5,0.028196091,0,hg38,CD-0722-1
"H9,A9",7609,8623,5637,2986,4141,2113,0,2114,1356,758,1.788918206,1236,1361,253,85,84,1,45,1,0.19047619,0,empty,CD-0722-1
"H9,A10",451044,530472,333310,197162,247941,136698,3,136851,113791,23060,4.934562012,81399,9434,1651,550,538,12,124,2,0.072490706,0,hg38,CD-0722-1
"H9,A11",6727,7321,5170,2151,3639,1691,0,1693,1103,590,1.869491525,947,1972,377,134,133,1,38,1,0.097744361,0,empty,CD-0722-1
"H9,A12",8953,10091,6745,3346,4610,2193,0,2200,1385,815,1.699386503,1235,3259,660,215,214,1,63,1,0.144859813,0,empty,CD-0722-1
"H9,B1",7802,8683,5746,2937,4113,2159,0,2163,1401,762,1.838582677,1251,1181,265,111,110,1,31,1,0.2,0,empty,CD-0722-1
"H9,B2",8223,8961,5649,3312,4359,2326,0,2331,1406,925,1.52,1368,588,58,35,35,0,18,0,0.2,0,empty,CD-0722-1
"H9,B3",6379,6749,4876,1873,3243,1534,0,1539,999,540,1.85,835,1242,319,93,90,3,32,2,0.011111111,0,empty,CD-0722-1
"H9,B4",7418,8582,5433,3149,4183,2224,0,2228,1409,819,1.72039072,1341,1615,493,131,129,2,40,1,0.046511628,0,empty,CD-0722-1
"H9,B5",14036,12175,7171,5004,6542,3743,2,3768,2726,1042,2.616122841,2446,744,123,27,27,0,16,0,0.074074074,0,empty,CD-0722-1
"H9,B6",8172,9124,6058,3066,4345,2288,0,2288,1462,826,1.769975787,1351,1684,548,224,223,1,68,1,0.031390135,0,empty,CD-0722-1
"H9,B7",7781,8929,5867,3062,4171,2108,0,2110,1338,772,1.733160622,1233,1069,157,66,60,6,23,1,0.033333333,0,empty,CD-0722-1
"H9,B8",6837,8894,4703,4191,4456,2663,0,2667,972,1695,0.573451327,1909,1214,264,123,122,1,49,1,0.040983607,0,empty,CD-0722-1
"H9,B9",10163,11130,7594,3536,5351,2791,0,2792,1724,1068,1.61423221,1545,1063,256,76,66,10,26,2,0.03030303,0,empty,CD-0722-1
"H9,B10",5643,6029,4004,2025,2984,1453,0,1458,937,521,1.798464491,873,525,130,34,33,1,14,1,0.212121212,0,empty,CD-0722-1
"H9,B11",11678,13152,8476,4676,6066,3324,0,3326,1944,1382,1.406657019,1931,190,10,4,4,0,4,0,0.25,0,empty,CD-0722-1
"H9,B12",6730,7346,5025,2321,3486,1763,1,1766,1109,657,1.687975647,967,1175,319,114,112,2,33,1,0.035714286,0,empty,CD-0722-1
"H9,C1",13530,14525,10308,4217,6849,3254,0,3256,2089,1167,1.790059983,1779,1447,587,188,188,0,36,0,0.031914894,0,empty,CD-0722-1
"H9,C2",11191,12431,8336,4095,5717,2853,0,2858,1814,1044,1.737547893,1639,1857,342,126,126,0,46,0,0.079365079,0,empty,CD-0722-1
"H9,C3",12335,13728,9236,4492,6663,3350,6,3364,2116,1248,1.695512821,1909,694,181,50,49,1,17,1,0.142857143,0,empty,CD-0722-1
"H9,C4",7485,7997,5666,2331,3915,1808,0,1810,1209,601,2.011647255,1006,1448,402,140,136,4,45,2,0.139705882,0,empty,CD-0722-1
"H9,C5",885776,1045215,650305,394910,480761,273625,3,273903,220902,53001,4.167883625,164357,130017,16635,5651,5502,149,1131,8,0.039440204,0,hg38,CD-0722-1
"H9,C6",9146,9816,6857,2959,4856,2364,2,2366,1555,811,1.917385943,1288,1900,358,133,133,0,51,0,0.037593985,0,empty,CD-0722-1
"H9,C7",12333,14095,8853,5242,6593,3602,0,3608,2159,1449,1.489993099,2179,426,78,37,34,3,14,1,0.117647059,0,empty,CD-0722-1
"H9,C8",13479,14695,10124,4571,6912,3444,0,3452,2309,1143,2.020122485,1922,3086,627,244,242,2,76,2,0.099173554,0,empty,CD-0722-1
"H9,C9",786991,945817,575793,370024,436659,255813,0,256025,201474,54551,3.693314513,153940,143743,16353,5820,5670,150,1082,7,0.096119929,0,hg38,CD-0722-1
"H9,C10",10637,11566,8168,3398,5430,2609,0,2616,1623,993,1.634441088,1373,1476,298,132,130,2,47,2,0.061538462,0,empty,CD-0722-1
"H9,C11",9534,10679,7014,3665,5060,2509,0,2509,1610,899,1.790878754,1475,2030,494,168,166,2,60,1,0.030120482,0,empty,CD-0722-1
"H9,C12",12869,13955,9518,4437,6675,3235,0,3238,2106,1132,1.860424028,1808,1640,445,175,175,0,54,0,0.114285714,0,empty,CD-0722-1
"H9,D1",11537,12987,8426,4561,6186,3255,0,3260,2020,1240,1.629032258,1924,661,103,37,35,2,16,2,0.285714286,0,empty,CD-0722-1
"H9,D2",9422,10252,7187,3065,4977,2347,0,2351,1493,858,1.74009324,1278,2140,515,212,209,3,73,2,0.09569378,0,empty,CD-0722-1
"H9,D3",609997,676720,465640,211080,315568,154414,1,154598,116907,37691,3.101721896,88453,75519,7818,2646,2539,107,574,7,0.047656558,0,hg38,CD-0722-1
"H9,D4",6347,6959,4749,2210,3324,1646,0,1648,1110,538,2.063197026,893,1753,527,145,143,2,43,2,0.244755245,0,empty,CD-0722-1
"H9,D5",989181,1185065,727886,457179,545890,315518,2,315818,259626,56192,4.620337415,189078,26912,5052,1506,1479,27,433,2,0.053414469,0,hg38,CD-0722-1
"H9,D6",11416,12666,8255,4411,5896,3131,1,3132,1898,1234,1.53808752,1786,1749,500,178,178,0,47,0,0.196629213,0,empty,CD-0722-1
"H9,D7",6521,6831,5017,1814,3252,1518,0,1521,977,544,1.795955882,799,1601,363,145,143,2,49,2,0.041958042,0,empty,CD-0722-1
"H9,D8",7557,8184,5673,2511,3959,1871,0,1871,1193,678,1.759587021,1066,1203,339,106,106,0,48,0,0,0,empty,CD-0722-1
"H9,D9",4179,4528,3205,1323,2216,1056,0,1057,712,345,2.063768116,573,1623,391,131,131,0,52,0,0.152671756,0,empty,CD-0722-1
"H9,D10",7204,8100,5286,2814,3818,1898,0,1903,1153,750,1.537333333,1084,715,102,39,38,1,16,1,0.026315789,0,empty,CD-0722-1
"H9,D11",582283,641015,451728,189287,298184,142988,3,143184,113165,30019,3.76977914,79524,44862,10201,3087,3055,32,609,3,0.042553191,0,hg38,CD-0722-1
"H9,D12",11037,12207,8152,4055,5677,2762,2,2766,1839,927,1.98381877,1521,3102,811,320,314,6,92,3,0.168789809,0,empty,CD-0722-1
"H9,E1",925581,1130700,648972,481728,516673,339340,1,339670,231375,108295,2.136525232,205989,9082,955,338,327,11,136,3,0.103975535,0,hg38,CD-0722-1
"H9,E2",9933,11099,7382,3717,5427,2777,0,2783,1818,965,1.883937824,1594,2194,458,151,148,3,40,2,0.060810811,0,empty,CD-0722-1
"H9,E3",6937,7851,5228,2623,3710,1789,0,1791,1171,620,1.888709677,1023,2120,613,175,173,2,61,1,0.069364162,0,empty,CD-0722-1
"H9,E4",9735,10571,7244,3327,5235,2588,0,2594,1682,912,1.844298246,1487,2424,470,170,170,0,63,0,0.1,0,empty,CD-0722-1
"H9,E5",8416,9123,6387,2736,4328,1989,0,1992,1286,706,1.821529745,1101,1144,335,124,124,0,39,0,0.008064516,0,empty,CD-0722-1
"H9,E6",14193,15541,10530,5011,7403,3720,0,3727,2368,1359,1.742457689,2116,2675,660,238,237,1,63,1,0.054852321,0,empty,CD-0722-1
"H9,E7",566032,697148,397491,299657,333693,216373,2,216586,182267,34319,5.310964772,132718,4773,1279,354,351,3,126,2,0.065527066,0,hg38,CD-0722-1
"H9,E8",10476,11596,7982,3614,5400,2535,0,2541,1653,888,1.861486486,1443,2910,939,274,273,1,58,1,0.201465201,0,empty,CD-0722-1
"H9,E9",6525,7500,4828,2672,3485,1740,0,1747,1161,586,1.981228669,1043,2405,680,270,269,1,78,1,0.040892193,0,empty,CD-0722-1
"H9,E10",7727,8621,5869,2752,4084,1870,0,1873,1238,635,1.949606299,1077,1822,498,145,143,2,46,1,0.132867133,0,empty,CD-0722-1
"H9,E11",9273,10391,6821,3570,4839,2461,0,2466,1597,869,1.837744534,1359,1708,388,158,157,1,42,1,0.082802548,0,empty,CD-0722-1
"H9,E12",9874,11134,7307,3827,5198,2640,0,2643,1724,919,1.875952122,1514,1324,200,104,103,1,45,1,0.048543689,0,empty,CD-0722-1
"H9,F1",11571,12637,8570,4067,5992,2990,0,2996,1879,1117,1.682184423,1684,2216,514,190,189,1,69,1,0.095238095,0,empty,CD-0722-1
"H9,F2",9463,10262,6999,3263,4824,2346,0,2356,1547,809,1.91223733,1324,2566,622,205,204,1,70,1,0.098039216,0,empty,CD-0722-1
"H9,F3",9095,9897,6533,3364,4776,2328,1,2333,1543,790,1.953164557,1355,2672,659,253,244,9,90,2,0.073770492,0,empty,CD-0722-1
"H9,F4",13577,14299,10053,4246,6797,3223,3,3234,2133,1101,1.9373297,1697,391,99,43,43,0,23,0,0.139534884,0,empty,CD-0722-1
"H9,F5",767463,845315,587058,258257,384639,187061,3,187317,146835,40482,3.62716763,105121,71409,8458,2741,2669,72,618,4,0.020981641,0,hg38,CD-0722-1
"H9,F6",709055,834590,524307,310283,386254,212555,1,212753,164426,48327,3.402363068,128181,142034,15221,5343,5233,110,1075,7,0.041276514,0,hg38,CD-0722-1
"H9,F7",13009,14544,9620,4924,6913,3500,4,3506,2296,1210,1.897520661,2030,1334,284,116,114,2,48,1,0.01754386,0,empty,CD-0722-1
"H9,F8",8107,8840,6152,2688,4074,1931,0,1937,1262,675,1.86962963,1028,350,144,40,40,0,12,0,0.05,0,empty,CD-0722-1
"H9,F9",9426,10139,7206,2933,4647,2167,1,2171,1397,774,1.804909561,1161,2214,462,169,166,3,58,2,0.078313253,0,empty,CD-0722-1
"H9,F10",12121,13007,9266,3741,6225,2953,0,2954,1932,1022,1.890410959,1640,1670,411,130,129,1,44,1,0.170542636,0,empty,CD-0722-1
"H9,F11",840388,991305,622555,368750,453704,259496,1,259713,183265,76448,2.397250419,153561,22767,5054,1624,1604,20,342,3,0.164588529,0,hg38,CD-0722-1
"H9,F12",10536,11599,7650,3949,5532,2688,0,2696,1801,895,2.012290503,1547,237,18,14,14,0,7,0,0,0,empty,CD-0722-1
"H9,G1",11403,12483,8591,3892,6110,2902,1,2910,1815,1095,1.657534247,1665,2874,650,250,248,2,74,1,0.072580645,0,empty,CD-0722-1
"H9,G2",6422,7112,4591,2521,3384,1744,0,1744,1111,633,1.755134281,1030,347,87,35,35,0,18,0,0.028571429,0,empty,CD-0722-1
"H9,G3",912605,1074181,674333,399848,492660,275591,3,275919,220724,55195,3.998985415,165053,168333,24019,8111,7913,198,1530,9,0.044989258,0,hg38,CD-0722-1
"H9,G4",21785,24924,15837,9087,11817,6620,0,6625,4096,2529,1.619612495,3929,127,19,16,16,0,13,0,0,0,empty,CD-0722-1
"H9,G5",7690,8582,5689,2893,4185,2101,0,2103,1319,784,1.682397959,1245,1649,418,125,121,4,45,2,0.049586777,0,empty,CD-0722-1
"H9,G6",1207961,1380787,925094,455693,621245,322396,4,322749,247660,75089,3.298219446,185567,1159,165,47,46,1,22,1,0.065217391,0,empty,CD-0722-1
"H9,G7",8993,9651,6716,2935,4630,2177,0,2179,1408,771,1.826199741,1198,2304,602,217,216,1,71,1,0,0,empty,CD-0722-1
"H9,G8",5859,6510,4339,2171,3139,1537,0,1544,1011,533,1.896810507,898,1712,408,126,126,0,51,0,0.055555556,0,empty,CD-0722-1
"H9,G9",7674,8772,5599,3173,4146,2118,0,2120,1412,708,1.994350282,1247,2161,472,161,160,1,60,1,0.05,0,empty,CD-0722-1
"H9,G10",9184,10500,6889,3611,4982,2484,0,2489,1568,921,1.702497286,1468,2021,220,85,84,1,51,1,0.011904762,0,empty,CD-0722-1
"H9,G11",9145,10078,6842,3236,4822,2291,0,2294,1451,843,1.721233689,1308,1481,325,113,110,3,41,2,0.027272727,0,empty,CD-0722-1
"H9,G12",7837,8719,5670,3049,4157,2147,0,2151,1345,806,1.668734491,1256,2195,465,175,174,1,48,1,0.166666667,0,empty,CD-0722-1
"H9,H1",7936,8301,6022,2279,4097,1916,1,1918,1295,623,2.078651685,1024,1080,282,111,111,0,32,0,0.081081081,0,empty,CD-0722-1
"H9,H2",14392,16003,10833,5170,7591,3656,0,3658,2551,1107,2.304426378,2079,2156,653,155,155,0,50,0,0.019354839,0,empty,CD-0722-1
"H9,H3",1263796,1369390,976234,393156,627733,297878,4,298255,244491,53764,4.547485306,166486,72553,11044,3491,3409,82,715,6,0.027574069,0,hg38,CD-0722-1
"H9,H4",11134,12331,8140,4191,5805,2872,0,2873,1876,997,1.881644935,1676,274,50,19,18,1,15,1,0.055555556,0,empty,CD-0722-1
"H9,H5",12698,14244,9220,5024,6583,3384,3,3391,2127,1264,1.682753165,1991,1422,401,98,98,0,43,0,0.030612245,0,empty,CD-0722-1
"H9,H6",6891,7708,5078,2630,3639,1900,0,1902,1284,618,2.077669903,1087,1858,595,201,200,1,54,1,0.045,0,empty,CD-0722-1
"H9,H7",8591,9401,6410,2991,4408,2092,3,2097,1371,726,1.888429752,1180,1901,342,122,119,3,40,2,0.100840336,0,empty,CD-0722-1
"H9,H8",9058,10211,6700,3511,4852,2522,0,2523,1633,890,1.834831461,1453,2037,267,111,111,0,47,0,0.054054054,0,empty,CD-0722-1
"H9,H9",1570607,1701243,1224699,476544,764477,360448,1,360862,276133,84729,3.259014033,197917,68923,10272,3279,3198,81,713,4,0.022514071,0,hg38,CD-0722-1
"H9,H10",586114,658126,449776,208350,304555,149360,2,149551,114653,34898,3.28537452,85741,107512,14595,5206,5051,155,977,6,0.042565829,0,hg38,CD-0722-1
"H9,H11",8569,9640,6005,3635,4569,2723,0,2723,1489,1234,1.206645057,1596,55,10,7,7,0,5,0,0,0,empty,CD-0722-1
"H9,H12",591813,747185,391355,355830,346509,240587,0,240787,175904,64883,2.711095356,152698,3745,721,206,200,6,75,2,0.13,0,hg38,CD-0722-1
"H10,A1",6867,7688,4963,2725,3781,1969,2,1977,1277,700,1.824285714,1135,1543,297,104,99,5,32,2,0.02020202,0,empty,CD-0722-1
"H10,A2",9941,10916,7370,3546,5254,2647,2,2652,1681,971,1.731204943,1510,1985,484,216,215,1,58,1,0.269767442,0,empty,CD-0722-1
"H10,A3",6292,6866,4596,2270,3238,1617,0,1617,1030,587,1.754684838,950,684,91,42,41,1,22,1,0.024390244,0,empty,CD-0722-1
"H10,A4",11410,12579,8507,4072,5789,2836,1,2838,1834,1004,1.826693227,1616,696,135,62,61,1,31,1,0.262295082,0,empty,CD-0722-1
"H10,A5",9493,10188,7046,3142,4778,2287,0,2289,1459,830,1.757831325,1300,2396,523,216,213,3,65,1,0.169014085,0,empty,CD-0722-1
"H10,A6",7968,9176,5768,3408,4372,2297,0,2301,1530,771,1.984435798,1371,2579,593,230,226,4,90,2,0.004424779,0,empty,CD-0722-1
"H10,A7",7474,8192,5575,2617,3941,1975,3,1978,1240,738,1.680216802,1096,1590,292,130,128,2,46,1,0.03125,0,empty,CD-0722-1
"H10,A8",4218,4687,3171,1516,2265,1137,0,1140,774,366,2.114754098,645,2045,473,201,198,3,64,1,0.131313131,0,empty,CD-0722-1
"H10,A9",9851,11381,7418,3963,5398,2776,0,2784,1943,841,2.310344828,1592,2160,328,145,139,6,47,2,0.079136691,0,empty,CD-0722-1
"H10,A10",7439,8106,5612,2494,3921,1978,0,1978,1242,736,1.6875,1092,375,149,55,55,0,17,0,0,0,empty,CD-0722-1
"H10,A11",6510,6889,5101,1788,3374,1513,2,1515,1010,505,2,773,2211,310,128,123,5,46,1,0.089430894,0,empty,CD-0722-1
"H10,A12",8262,9168,6246,2922,4159,2060,0,2071,1370,701,1.954350927,1124,5262,1376,401,394,7,95,2,0.093908629,0,empty,CD-0722-1
"H10,B1",7315,8012,5469,2543,3740,1824,0,1827,1158,669,1.730941704,1022,1280,236,97,95,2,34,2,0.010526316,0,empty,CD-0722-1
"H10,B2",2622139,2998200,1868994,1129206,1365187,781556,7,782287,620279,162008,3.828693645,469366,208649,24402,8361,8140,221,1452,6,0.074938575,0,hg38,CD-0722-1
"H10,B3",5892,6492,4275,2217,3124,1564,0,1567,992,575,1.725217391,911,1533,395,132,131,1,47,1,0.190839695,0,empty,CD-0722-1
"H10,B4",6815,7507,5018,2489,3573,1843,0,1847,1153,694,1.661383285,1052,1626,325,152,152,0,58,0,0.026315789,0,empty,CD-0722-1
"H10,B5",9007,5949,3489,2460,3553,2030,0,2042,1479,563,2.626998224,1320,1134,286,100,98,2,31,1,0.183673469,0,empty,CD-0722-1
"H10,B6",1756963,2068115,1313420,754695,936527,525819,9,526356,422451,103905,4.065742746,310707,203480,46838,15417,15225,192,2257,8,0.045254516,0,hg38,CD-0722-1
"H10,B7",7503,8205,5661,2544,3961,1877,0,1879,1220,659,1.851289833,1050,1322,314,97,96,1,35,1,0,0,empty,CD-0722-1
"H10,B8",5336,5845,4073,1772,2812,1291,0,1291,885,406,2.179802956,707,1192,200,82,79,3,44,1,0.025316456,0,empty,CD-0722-1
"H10,B9",10010,11374,7318,4056,5413,2825,0,2826,1787,1039,1.719923003,1716,1609,371,120,114,6,43,1,0.070175439,0,empty,CD-0722-1
"H10,B10",577587,645614,370603,275011,318906,192871,40,194181,148479,45702,3.248851254,122715,7057,2720,878,874,4,224,2,0.035469108,0,hg38,CD-0722-1
"H10,B11",10933,12276,7989,4287,5731,3068,0,3069,1739,1330,1.307518797,1765,274,61,36,34,2,19,2,0.029411765,0,empty,CD-0722-1
"H10,B12",619567,725227,459007,266220,340695,188904,3,189097,144490,44607,3.239177708,113045,80539,10978,3398,3295,103,777,3,0.039150228,0,hg38,CD-0722-1
"H10,C1",12936,13911,9911,4000,6595,3144,0,3149,2027,1122,1.806595365,1728,985,195,66,66,0,26,0,0,0,empty,CD-0722-1
"H10,C2",1252777,1544612,868792,675820,712613,456269,5,456670,372796,83874,4.444714691,286753,21795,9734,2809,2804,5,650,2,0.054921541,0,hg38,CD-0722-1
"H10,C3",14795,16662,11029,5633,7854,3965,0,3973,2673,1300,2.056153846,2274,1009,189,77,77,0,23,0,0,0,empty,CD-0722-1
"H10,C4",6855,7734,5167,2567,3672,1773,0,1777,1185,592,2.001689189,1042,1956,402,167,163,4,68,2,0.030674847,0,empty,CD-0722-1
"H10,C5",10076,11297,7529,3768,5456,2710,0,2714,1760,954,1.844863732,1621,1904,352,156,153,3,54,2,0.065359477,0,empty,CD-0722-1
"H10,C6",8522,9100,6409,2691,4591,2223,0,2227,1439,788,1.826142132,1242,1633,427,162,162,0,76,0,0.092592593,0,empty,CD-0722-1
"H10,C7",13099,15010,9616,5394,6954,3814,0,3825,2396,1429,1.676696991,2199,472,46,25,24,1,21,1,0.041666667,0,empty,CD-0722-1
"H10,C8",12348,13589,9132,4457,6567,3270,0,3272,2134,1138,1.875219684,1847,3290,635,236,234,2,90,2,0.106837607,0,empty,CD-0722-1
"H10,C9",27688,31647,21094,10553,14331,7132,1,7143,5070,2073,2.445730825,4019,5530,1259,410,401,9,108,2,0.019950125,0,empty,CD-0722-1
"H10,C10",1976428,2196321,1500911,695410,976767,506420,6,506911,391688,115223,3.399390747,285216,297380,39812,13424,13093,331,2182,9,0.056900634,0,hg38,CD-0722-1
"H10,C11",9407,10210,7031,3179,4945,2432,0,2435,1582,853,1.854630715,1336,2529,476,188,183,5,61,1,0.027322404,0,empty,CD-0722-1
"H10,C12",12362,13414,9106,4308,6378,3056,0,3069,2011,1058,1.900756144,1694,2751,691,171,164,7,55,2,0.091463415,0,empty,CD-0722-1
"H10,D1",11633,12625,8608,4017,6009,3087,0,3093,1923,1170,1.643589744,1718,1155,212,84,84,0,27,0,0.047619048,0,empty,CD-0722-1
"H10,D2",9959,10822,7670,3152,5172,2405,0,2405,1570,835,1.880239521,1294,2754,826,246,244,2,104,1,0.036885246,0,empty,CD-0722-1
"H10,D3",8135,8929,6031,2898,4271,2119,6,2129,1453,676,2.149408284,1198,1565,241,91,91,0,44,0,0.054945055,0,empty,CD-0722-1
"H10,D4",753058,895880,558455,337425,414680,230780,1,231034,182530,48504,3.763194788,138741,106536,17620,5784,5687,97,1105,4,0.058202919,0,hg38,CD-0722-1
"H10,D5",7631,8264,5705,2559,3839,1820,1,1824,1173,651,1.801843318,1008,2736,583,216,214,2,76,1,0.051401869,0,empty,CD-0722-1
"H10,D6",11090,12609,8032,4577,5804,3116,1,3126,1915,1211,1.581337737,1868,1534,372,138,133,5,40,1,0.082706767,0,empty,CD-0722-1
"H10,D7",6110,6695,4675,2020,3114,1454,0,1454,920,534,1.722846442,775,2365,524,200,197,3,62,1,0.086294416,0,empty,CD-0722-1
"H10,D8",7449,8159,5515,2644,3955,1983,0,1985,1294,691,1.872648336,1154,1291,365,170,168,2,56,2,0.041666667,0,empty,CD-0722-1
"H10,D9",4292,5087,3168,1919,2364,1187,0,1189,798,391,2.040920716,697,1893,304,115,112,3,51,2,0.035714286,0,empty,CD-0722-1
"H10,D10",7395,8244,5438,2806,3888,2036,0,2036,1302,734,1.773841962,1139,940,222,85,85,0,25,0,0.176470588,0,empty,CD-0722-1
"H10,D11",8332,9344,6309,3035,4444,2189,0,2193,1433,760,1.885526316,1194,3132,677,248,240,8,103,3,0.116666667,0,empty,CD-0722-1
"H10,D12",876827,1034736,648152,386584,472078,262342,3,262651,214179,48472,4.418612807,156740,188901,34330,11237,11038,199,1733,5,0.060789998,0,hg38,CD-0722-1
"H10,E1",12798,13849,9539,4310,6475,3205,0,3210,2003,1207,1.65948633,1738,3599,572,238,238,0,93,0,0.067226891,0,empty,CD-0722-1
"H10,E2",9586,10689,6949,3740,4979,2451,0,2459,1589,870,1.826436782,1427,2406,581,203,201,2,73,1,0.174129353,0,empty,CD-0722-1
"H10,E3",6412,7081,4899,2182,3470,1760,0,1760,1149,611,1.880523732,982,2502,586,218,214,4,77,2,0.046728972,0,empty,CD-0722-1
"H10,E4",8750,9913,6458,3455,4747,2405,1,2411,1566,845,1.853254438,1426,2990,567,242,232,10,105,3,0.047413793,0,empty,CD-0722-1
"H10,E5",7979,8507,6025,2482,4206,1976,0,1976,1290,686,1.880466472,1063,1443,415,157,149,8,41,1,0.100671141,0,empty,CD-0722-1
"H10,E6",634601,689572,496072,193500,316396,147265,2,147444,115198,32246,3.572474105,80231,86527,15103,4828,4734,94,877,4,0.031685678,0,hg38,CD-0722-1
"H10,E7",11658,12680,8768,3912,5934,2776,0,2783,1875,908,2.064977974,1442,3559,918,354,351,3,103,2,0.05982906,0,empty,CD-0722-1
"H10,E8",10333,11127,7830,3297,5248,2422,0,2427,1576,851,1.851938895,1338,2747,607,227,227,0,71,0,0.070484581,0,empty,CD-0722-1
"H10,E9",6121,6736,4526,2210,3252,1601,0,1603,1087,516,2.106589147,931,3758,844,286,286,0,82,0,0.052447552,0,empty,CD-0722-1
"H10,E10",7443,8253,5647,2606,3816,1804,0,1804,1149,655,1.754198473,1005,2227,497,149,145,4,63,2,0.020689655,0,empty,CD-0722-1
"H10,E11",9156,9980,6834,3146,4743,2338,0,2341,1496,845,1.770414201,1307,3099,764,244,241,3,71,3,0,0,empty,CD-0722-1
"H10,E12",9334,10067,6983,3084,4901,2394,0,2397,1502,895,1.678212291,1323,1709,389,157,155,2,56,2,0.090322581,0,empty,CD-0722-1
"H10,F1",11223,12115,8339,3776,5869,2804,0,2814,1849,965,1.916062176,1596,2363,700,250,250,0,74,0,0.076,0,empty,CD-0722-1
"H10,F2",1317797,1499952,991734,508218,687504,363775,5,364221,285143,79078,3.605844862,212517,170362,22694,7138,6947,191,1402,4,0.047646466,0,hg38,CD-0722-1
"H10,F3",8383,9168,6283,2885,4356,2094,0,2098,1386,712,1.946629213,1215,3387,715,233,224,9,92,2,0.017857143,0,empty,CD-0722-1
"H10,F4",13094,14105,9612,4493,6915,3369,0,3382,2214,1168,1.895547945,1912,679,128,60,60,0,22,0,0.183333333,0,empty,CD-0722-1
"H10,F5",10419,11321,7859,3462,5378,2534,0,2534,1621,913,1.775465498,1413,2176,510,164,164,0,63,0,0.042682927,0,empty,CD-0722-1
"H10,F6",10066,11225,7321,3904,5375,2709,0,2715,1771,944,1.876059322,1593,3059,700,277,271,6,94,3,0.114391144,0,empty,CD-0722-1
"H10,F7",11992,13033,8888,4145,6185,3038,0,3038,2005,1033,1.940948693,1707,1443,298,128,126,2,55,2,0.023809524,0,empty,CD-0722-1
"H10,F8",7943,8844,5932,2912,4130,1990,0,1992,1269,723,1.755186722,1145,247,26,15,15,0,9,0,0,0,empty,CD-0722-1
"H10,F9",8671,9215,6598,2617,4389,2064,0,2070,1332,738,1.804878049,1145,3110,648,176,172,4,65,2,0.023255814,0,empty,CD-0722-1
"H10,F10",11259,12258,8676,3582,5679,2638,0,2642,1722,920,1.87173913,1399,2347,521,181,181,0,47,0,0.121546961,0,empty,CD-0722-1
"H10,F11",8377,8967,6378,2589,4215,1928,0,1931,1295,636,2.036163522,997,2028,310,102,101,1,37,1,0.00990099,0,empty,CD-0722-1
"H10,F12",9743,10772,7146,3626,5258,2623,0,2627,1680,947,1.774023231,1539,137,37,25,25,0,16,0,0.04,0,empty,CD-0722-1
"H10,G1",11094,11712,8463,3249,5641,2632,0,2638,1719,919,1.870511425,1392,2569,466,225,216,9,105,3,0.027777778,0,empty,CD-0722-1
"H10,G2",6292,6916,4507,2409,3264,1661,1,1664,1078,586,1.839590444,969,510,89,38,38,0,18,0,0,0,empty,CD-0722-1
"H10,G3",11620,12906,8584,4322,6042,3093,0,3096,1860,1236,1.504854369,1726,3267,834,297,293,4,114,3,0.109215017,0,empty,CD-0722-1
"H10,G4",1834053,2111707,1363248,748459,951372,539004,3,539591,399905,139686,2.862885329,312181,1623,144,52,49,3,25,1,0.204081633,0,empty,CD-0722-1
"H10,G5",1372186,1624911,1035937,588974,738157,409247,5,409696,329235,80461,4.091858167,244153,200736,26591,8864,8643,221,1583,11,0.062709707,0,hg38,CD-0722-1
"H10,G6",10541,11238,7974,3264,5252,2480,0,2486,1652,834,1.980815348,1366,169,11,9,9,0,9,0,0.111111111,0,empty,CD-0722-1
"H10,G7",8656,9256,6657,2599,4413,1989,0,1992,1258,734,1.713896458,1077,2562,576,222,219,3,87,1,0.050228311,0,empty,CD-0722-1
"H10,G8",6229,6943,4624,2319,3304,1632,0,1634,1058,576,1.836805556,931,1643,273,119,117,2,47,1,0.025641026,0,empty,CD-0722-1
"H10,G9",7531,8497,5720,2777,4047,2059,0,2059,1308,751,1.741677763,1199,2794,484,189,180,9,81,2,0.044444444,0,empty,CD-0722-1
"H10,G10",1249997,1547382,878902,668480,736640,481709,4,482061,326953,155108,2.107905459,297388,94797,16143,5431,5332,99,1015,4,0.070705176,0,hg38,CD-0722-1
"H10,G11",9620,10356,7290,3066,4923,2250,0,2254,1487,767,1.938722295,1208,1491,321,116,116,0,52,0,0.043103448,0,empty,CD-0722-1
"H10,G12",585802,654014,448916,205098,311208,153369,0,153534,118525,35009,3.385557999,87293,70638,16313,4893,4827,66,880,6,0.020302465,0,hg38,CD-0722-1
"H10,H1",7681,8271,5659,2612,4023,1886,0,1888,1288,600,2.146666667,1077,1487,243,73,72,1,28,1,0.194444444,0,empty,CD-0722-1
"H10,H2",8176,9265,6080,3185,4366,2177,0,2178,1371,807,1.698884758,1274,2271,460,175,175,0,68,0,0.085714286,0,empty,CD-0722-1
"H10,H3",6927,7759,5156,2603,3690,1828,0,1828,1209,619,1.953150242,1048,1447,376,138,137,1,48,1,0.145985401,0,empty,CD-0722-1
"H10,H4",11192,12412,8250,4162,5775,2846,0,2847,1841,1006,1.830019881,1625,162,39,25,23,2,10,1,0.130434783,0,empty,CD-0722-1
"H10,H5",860704,960921,659256,301665,438896,217940,4,218191,172728,45463,3.799309328,123385,51877,11368,3390,3349,41,664,5,0.024186324,0,hg38,CD-0722-1
"H10,H6",6614,7394,4911,2483,3488,1772,0,1774,1116,658,1.696048632,1040,1704,308,133,131,2,37,2,0.13740458,0,empty,CD-0722-1
"H10,H7",256764,291642,188187,103455,134249,73400,7,73493,52548,20945,2.508856529,42518,4551,1118,461,452,9,215,2,0.066371681,0,hg38,CD-0722-1
"H10,H8",8585,9930,6267,3663,4577,2341,0,2347,1469,878,1.673120729,1397,2338,420,180,177,3,57,2,0.011299435,0,empty,CD-0722-1
"H10,H9",7052,7684,5347,2337,3582,1668,0,1669,1117,552,2.023550725,929,1258,334,86,86,0,29,0,0.197674419,0,empty,CD-0722-1
"H10,H10",7333,8345,5410,2935,3919,1953,0,1957,1314,643,2.043545879,1178,1491,240,113,111,2,39,1,0.153153153,0,empty,CD-0722-1
"H10,H11",7595,8662,5329,3333,4256,2524,0,2524,1403,1121,1.251561106,1504,60,16,9,8,1,5,1,0,0,empty,CD-0722-1
"H10,H12",6816,7553,4857,2696,3592,1855,0,1856,1228,628,1.955414013,1120,1910,304,111,104,7,47,2,0.153846154,0,empty,CD-0722-1
"H11,A1",6287,7204,4648,2556,3559,1902,0,1906,1250,656,1.905487805,1138,971,148,37,36,1,13,1,0.055555556,0,empty,CD-0722-1
"H11,A2",12427,13812,9479,4333,6488,3180,0,3181,2095,1086,1.929097606,1802,2283,245,113,112,1,35,1,0.026785714,0,empty,CD-0722-1
"H11,A3",5483,5992,4171,1821,2885,1419,0,1422,914,508,1.799212598,781,677,109,32,31,1,15,1,0.032258065,0,empty,CD-0722-1
"H11,A4",9512,10504,7120,3384,4962,2440,0,2440,1571,869,1.807825086,1363,625,211,72,72,0,18,0,0.013888889,0,empty,CD-0722-1
"H11,A5",8111,8849,6032,2817,4277,2030,4,2034,1274,760,1.676315789,1161,1738,450,139,138,1,33,1,0.072463768,0,empty,CD-0722-1
"H11,A6",11348,12731,8544,4187,6181,3186,0,3189,2283,906,2.51986755,1797,1724,539,173,169,4,42,2,0.130177515,0,empty,CD-0722-1
"H11,A7",510713,582738,388855,193883,273817,139608,0,139752,105175,34577,3.041761865,81205,64784,11133,3770,3698,72,740,4,0.040832883,0,hg38,CD-0722-1
"H11,A8",3586,4204,2684,1520,2035,1043,1,1048,668,380,1.757894737,639,1041,212,76,75,1,29,1,0.28,0,empty,CD-0722-1
"H11,A9",6721,7681,5049,2632,3556,1777,0,1783,1129,654,1.726299694,1028,753,110,46,46,0,20,0,0.086956522,0,empty,CD-0722-1
"H11,A10",7037,7742,5386,2356,3749,1819,0,1819,1134,685,1.655474453,997,259,60,29,29,0,7,0,0,0,empty,CD-0722-1
"H11,A11",5990,6286,4746,1540,3010,1332,0,1335,881,454,1.940528634,665,1169,306,87,86,1,25,1,0.011627907,0,empty,CD-0722-1
"H11,A12",7699,8516,5771,2745,4047,1947,0,1949,1304,645,2.021705426,1077,2703,602,201,199,2,44,1,0.075376884,0,empty,CD-0722-1
"H11,B1",6360,6984,4710,2274,3384,1738,0,1738,1065,673,1.582466568,988,690,294,100,99,1,28,1,0.050505051,0,empty,CD-0722-1
"H11,B2",1183356,1285522,884393,401129,596100,296391,2,296720,228736,67984,3.364556366,167950,29969,4241,1403,1369,34,310,3,0.032870709,0,hg38,CD-0722-1
"H11,B3",5048,5591,3745,1846,2748,1386,1,1388,941,447,2.105145414,808,1017,287,89,84,5,21,2,0.071428571,0,empty,CD-0722-1
"H11,B4",6747,7808,4843,2965,3797,2079,2,2083,1350,733,1.841746248,1256,885,265,97,96,1,25,1,0,0,empty,CD-0722-1
"H11,B5",6271,3211,1969,1242,2193,1165,0,1171,779,392,1.987244898,749,553,155,45,45,0,11,0,0.022222222,0,empty,CD-0722-1
"H11,B6",7385,8486,5321,3165,3998,2148,0,2157,1361,796,1.709798995,1286,1133,99,52,52,0,24,0,0.25,0,empty,CD-0722-1
"H11,B7",6653,7457,4995,2462,3514,1715,1,1719,1122,597,1.879396985,966,875,327,128,128,0,22,0,0.1171875,0,empty,CD-0722-1
"H11,B8",4922,5371,3735,1636,2633,1250,0,1255,774,481,1.609147609,714,836,168,59,59,0,21,0,0.033898305,0,empty,CD-0722-1
"H11,B9",9193,10501,6662,3839,4892,2592,1,2596,1594,1002,1.590818363,1581,467,80,32,32,0,13,0,0.0625,0,empty,CD-0722-1
"H11,B10",5025,5243,3553,1690,2620,1294,0,1298,816,482,1.692946058,736,280,44,17,17,0,8,0,0.117647059,0,empty,CD-0722-1
"H11,B11",10234,11663,7476,4187,5523,3052,0,3059,1742,1317,1.322703113,1841,123,12,5,5,0,3,0,0,0,empty,CD-0722-1
"H11,B12",5807,6382,4364,2018,3110,1571,0,1571,1003,568,1.76584507,896,994,360,135,135,0,32,0,0.051851852,0,empty,CD-0722-1
"H11,C1",1117667,1246002,856055,389947,567891,286917,4,287282,227972,59310,3.843736301,162485,44599,5737,2013,1972,41,484,3,0.020283976,0,hg38,CD-0722-1
"H11,C2",9024,10104,6737,3367,4802,2435,0,2435,1568,867,1.808535179,1346,1199,328,118,117,1,31,1,0.094017094,0,empty,CD-0722-1
"H11,C3",9600,10411,7240,3171,4971,2398,1,2401,1538,863,1.782155272,1279,694,187,68,68,0,17,0,0.514705882,0,empty,CD-0722-1
"H11,C4",6412,6842,4778,2064,3325,1553,0,1555,1004,551,1.822141561,847,929,268,64,64,0,22,0,0.359375,0,empty,CD-0722-1
"H11,C5",9306,10655,6947,3708,4946,2520,0,2521,1665,856,1.945093458,1467,1177,296,105,105,0,28,0,0,0,empty,CD-0722-1
"H11,C6",7708,8349,5721,2628,4144,2028,0,2037,1339,698,1.918338109,1151,1121,385,134,134,0,38,0,0.044776119,0,empty,CD-0722-1
"H11,C7",10563,12358,7691,4667,5896,3315,0,3322,2069,1253,1.651237031,2025,403,125,46,46,0,11,0,0,0,empty,CD-0722-1
"H11,C8",48720,56090,37233,18857,25352,12971,0,12986,9448,3538,2.670435274,7456,4770,1072,324,313,11,97,2,0.025559105,0,empty,CD-0722-1
"H11,C9",8039,9090,6026,3064,4296,2138,0,2140,1441,699,2.061516452,1220,785,168,48,48,0,23,0,0.104166667,0,empty,CD-0722-1
"H11,C10",8628,9394,6588,2806,4519,2171,0,2171,1404,767,1.830508475,1191,1504,366,122,121,1,31,1,0,0,empty,CD-0722-1
"H11,C11",7984,8970,5890,3080,4276,2164,0,2172,1355,817,1.658506732,1321,1312,354,98,94,4,28,2,0.191489362,0,empty,CD-0722-1
"H11,C12",10781,11713,8005,3708,5621,2656,0,2662,1693,969,1.747162023,1542,1633,350,94,94,0,27,0,0.095744681,0,empty,CD-0722-1
"H11,D1",10146,11513,7418,4095,5510,2963,0,2965,1805,1160,1.556034483,1754,459,90,36,36,0,11,0,0.166666667,0,empty,CD-0722-1
"H11,D2",465274,572708,327415,245293,273727,174972,6,175128,132057,43071,3.066030508,107824,12382,5667,1810,1806,4,410,2,0.030454042,0,hg38,CD-0722-1
"H11,D3",7496,8364,5532,2832,4007,2096,0,2096,1338,758,1.765171504,1220,1418,447,136,136,0,32,0,0.036764706,0,empty,CD-0722-1
"H11,D4",593517,714821,435098,279723,334771,192475,2,192648,144644,48004,3.01316557,117186,49946,9245,3043,2986,57,617,4,0.050234427,0,hg38,CD-0722-1
"H11,D5",6597,7063,5046,2017,3371,1563,0,1565,1025,540,1.898148148,835,1029,252,88,88,0,30,0,0.068181818,0,empty,CD-0722-1
"H11,D6",9348,10818,6887,3931,5057,2769,0,2774,1684,1090,1.544954128,1592,1006,273,95,95,0,29,0,0.042105263,0,empty,CD-0722-1
"H11,D7",5405,5816,4072,1744,2811,1349,0,1349,876,473,1.852008457,751,1139,370,108,108,0,29,0,0.018518519,0,empty,CD-0722-1
"H11,D8",583132,680757,427472,253285,318979,177436,0,177607,140548,37059,3.79254702,106212,40992,7050,2196,2155,41,472,5,0.026914153,0,hg38,CD-0722-1
"H11,D9",3641,4107,2717,1390,1954,943,0,944,658,286,2.300699301,557,963,258,66,66,0,25,0,0.196969697,0,empty,CD-0722-1
"H11,D10",6315,7162,4683,2479,3269,1660,0,1668,1066,602,1.77076412,947,598,78,37,35,2,8,1,0.057142857,0,empty,CD-0722-1
"H11,D11",7737,8389,5951,2438,4024,1918,0,1919,1259,660,1.907575758,1035,1900,459,141,138,3,42,2,0,0,empty,CD-0722-1
"H11,D12",9422,10539,6941,3598,4904,2405,0,2408,1595,813,1.961869619,1404,2733,720,219,218,1,69,1,0.114678899,0,empty,CD-0722-1
"H11,E1",11841,12913,8921,3992,6114,2991,1,2996,1866,1130,1.651327434,1655,1534,431,157,157,0,53,0,0.006369427,0,empty,CD-0722-1
"H11,E2",8224,9166,6012,3154,4490,2243,0,2245,1383,862,1.604408353,1353,1394,214,69,68,1,35,1,0.338235294,0,empty,CD-0722-1
"H11,E3",6013,6803,4643,2160,3105,1502,0,1504,977,527,1.853889943,833,1492,361,135,135,0,34,0,0.074074074,0,empty,CD-0722-1
"H11,E4",8259,9066,6363,2703,4328,2135,0,2141,1413,728,1.940934066,1143,1418,333,104,104,0,43,0,0.115384615,0,empty,CD-0722-1
"H11,E5",6574,7167,4978,2189,3458,1668,0,1670,1107,563,1.96625222,929,739,164,62,61,1,27,1,0.114754098,0,empty,CD-0722-1
"H11,E6",11951,13466,8836,4630,6306,3259,0,3264,2093,1171,1.78736123,1890,1982,416,157,155,2,48,1,0.058064516,0,empty,CD-0722-1
"H11,E7",554702,623944,415901,208043,289632,151219,1,151372,128003,23369,5.477470153,86000,69708,18073,5210,5147,63,1003,4,0.027006023,0,hg38,CD-0722-1
"H11,E8",8758,9639,6698,2941,4549,2119,0,2123,1390,733,1.896316508,1187,1402,258,89,84,5,33,1,0.035714286,0,empty,CD-0722-1
"H11,E9",6119,6818,4582,2236,3189,1536,2,1539,1067,472,2.26059322,858,1477,333,87,87,0,30,0,0.126436782,0,empty,CD-0722-1
"H11,E10",6825,7431,5135,2296,3431,1592,0,1593,1067,526,2.02851711,879,1289,286,113,112,1,33,1,0.116071429,0,empty,CD-0722-1
"H11,E11",7744,8592,5717,2875,4096,2045,0,2048,1357,691,1.96382055,1178,1188,363,126,126,0,29,0,0.015873016,0,empty,CD-0722-1
"H11,E12",8469,9510,6299,3211,4543,2318,0,2322,1498,824,1.817961165,1364,1308,321,116,116,0,35,0,0.051724138,0,empty,CD-0722-1
"H11,F1",10060,10624,7352,3272,5077,2519,0,2519,1639,880,1.8625,1397,1381,257,99,98,1,38,1,0.081632653,0,empty,CD-0722-1
"H11,F2",8024,8466,6129,2337,4173,1936,0,1937,1255,682,1.840175953,1034,1857,455,140,138,2,42,2,0.014492754,0,empty,CD-0722-1
"H11,F3",7499,8335,5559,2776,4070,1993,0,1995,1256,739,1.699594046,1146,1184,164,59,57,2,31,1,0.140350877,0,empty,CD-0722-1
"H11,F4",11458,12533,8632,3901,5939,2803,0,2803,1835,968,1.895661157,1569,308,83,31,29,2,6,1,0,0,empty,CD-0722-1
"H11,F5",8851,9879,6736,3143,4588,2170,0,2170,1391,779,1.785622593,1220,1211,249,72,69,3,28,2,0.15942029,0,empty,CD-0722-1
"H11,F6",9461,10632,6894,3738,5088,2635,0,2635,1639,996,1.645582329,1549,1682,268,98,97,1,33,1,0.020618557,0,empty,CD-0722-1
"H11,F7",10738,12046,8066,3980,5750,2828,0,2830,1799,1031,1.744907856,1650,775,163,62,62,0,16,0,0.032258065,0,empty,CD-0722-1
"H11,F8",6972,7497,5334,2163,3535,1672,0,1677,1085,592,1.83277027,892,73,35,17,17,0,5,0,0,0,empty,CD-0722-1
"H11,F9",7834,8416,5968,2448,4014,1884,0,1885,1175,710,1.654929577,1024,1554,400,120,120,0,35,0,0,0,empty,CD-0722-1
"H11,F10",25913,28352,19560,8792,13123,6470,0,6479,4773,1706,2.797772567,3605,2187,500,180,179,1,36,1,0,0,empty,CD-0722-1
"H11,F11",8080,8667,6181,2486,4157,1925,0,1927,1216,711,1.710267229,1065,1231,118,44,44,0,15,0,0,0,empty,CD-0722-1
"H11,F12",8326,9091,6221,2870,4306,2016,0,2021,1329,692,1.920520231,1137,73,2,1,1,0,1,0,1,0,empty,CD-0722-1
"H11,G1",9612,10486,7312,3174,4975,2345,2,2351,1459,892,1.635650224,1275,1607,433,143,142,1,42,1,0.070422535,0,empty,CD-0722-1
"H11,G2",5158,5799,3722,2077,2751,1409,5,1418,876,542,1.616236162,833,360,139,34,34,0,7,0,0,0,empty,CD-0722-1
"H11,G3",10579,11824,7757,4067,5451,2795,0,2797,1638,1159,1.413287317,1540,1769,557,135,132,3,37,2,0.121212121,0,empty,CD-0722-1
"H11,G4",1711172,2004754,1266033,738721,913673,520008,3,520501,428564,91937,4.66149646,309274,575,54,31,30,1,15,1,0.133333333,0,empty,CD-0722-1
"H11,G5",6306,7153,4723,2430,3376,1707,0,1709,1126,583,1.931389365,991,1111,250,103,103,0,28,0,0.087378641,0,empty,CD-0722-1
"H11,G6",9498,10456,7163,3293,4872,2475,0,2479,1671,808,2.068069307,1391,87,39,7,7,0,3,0,0,0,empty,CD-0722-1
"H11,G7",7436,8233,5725,2508,3839,1819,0,1821,1098,723,1.518672199,1008,1711,405,140,137,3,50,2,0.02189781,0,empty,CD-0722-1
"H11,G8",438967,554266,294414,259852,260817,179498,1,179641,128562,51079,2.516924764,113562,3589,578,151,140,11,51,2,0.128571429,0,hg38,CD-0722-1
"H11,G9",6373,7047,4769,2278,3366,1657,0,1657,1062,595,1.78487395,935,1366,423,127,127,0,45,0,0.031496063,0,empty,CD-0722-1
"H11,G10",7974,8977,6003,2974,4238,2115,1,2117,1340,777,1.724581725,1184,1269,363,136,135,1,44,1,0.066666667,0,empty,CD-0722-1
"H11,G11",8029,8922,5993,2929,4239,2067,1,2073,1350,723,1.867219917,1196,598,83,40,38,2,17,1,0,0,empty,CD-0722-1
"H11,G12",6777,7995,4941,3054,3710,1905,0,1910,1278,632,2.022151899,1143,1519,338,130,128,2,27,2,0.078125,0,empty,CD-0722-1
"H11,H1",7017,7851,5390,2461,3698,1770,2,1781,1118,663,1.68627451,996,736,190,88,88,0,27,0,0.034090909,0,empty,CD-0722-1
"H11,H2",7637,8514,5687,2827,3951,1956,0,1958,1312,646,2.030959752,1119,2092,505,171,170,1,43,1,0.152941176,0,empty,CD-0722-1
"H11,H3",693295,849698,494079,355619,397581,242854,0,243050,185587,57463,3.229678228,151284,12385,3434,1034,1031,3,267,1,0.064985451,0,hg38,CD-0722-1
"H11,H4",9709,10860,7212,3648,4993,2507,0,2510,1612,898,1.795100223,1435,163,61,8,8,0,5,0,0,0,empty,CD-0722-1
"H11,H5",9777,10619,7299,3320,4943,2432,0,2433,1556,877,1.774230331,1388,1397,270,85,83,2,31,1,0.096385542,0,empty,CD-0722-1
"H11,H6",6081,6922,4508,2414,3231,1668,0,1671,1074,597,1.798994975,941,1108,206,83,82,1,28,1,0.097560976,0,empty,CD-0722-1
"H11,H7",7267,7852,5543,2309,3719,1714,0,1720,1145,575,1.991304348,943,880,134,53,52,1,21,1,0,0,empty,CD-0722-1
"H11,H8",363593,408986,276231,132755,193170,97025,0,97126,74339,22787,3.262342564,55785,32243,5821,1975,1953,22,409,2,0.027137737,0,hg38,CD-0722-1
"H11,H9",6569,7098,5030,2068,3293,1526,0,1528,1023,505,2.025742574,793,830,241,61,61,0,16,0,0.081967213,0,empty,CD-0722-1
"H11,H10",6952,7912,5119,2793,3800,1976,0,1978,1404,574,2.445993031,1165,956,228,86,86,0,22,0,0,0,empty,CD-0722-1
"H11,H11",7364,8422,5169,3253,4108,2513,1,2516,1403,1113,1.260557053,1510,9,2,2,2,0,2,0,0,0,empty,CD-0722-1
"H11,H12",6700,7412,4911,2501,3461,1742,0,1743,1135,608,1.866776316,960,976,131,66,66,0,28,0,0.045454545,0,empty,CD-0722-1
"H12,A1",6694,7415,4994,2421,4282,2203,0,2206,1437,769,1.868660598,1274,1757,296,102,100,2,43,1,0.12,0,empty,CD-0722-1
"H12,A2",745023,843789,568551,275238,451658,229291,2,229495,181910,47585,3.822843333,130337,46793,9494,3288,3271,17,725,2,0.042800367,0,hg38,CD-0722-1
"H12,A3",7775,9229,5729,3500,5109,2839,0,2843,1947,896,2.172991071,1724,1102,244,69,68,1,25,1,0.044117647,0,empty,CD-0722-1
"H12,A4",9476,10695,7156,3539,5824,2966,0,2971,1904,1067,1.784442362,1678,1019,182,63,62,1,28,1,0.161290323,0,empty,CD-0722-1
"H12,A5",9341,10312,6912,3400,5675,2767,0,2775,1716,1059,1.620396601,1605,2219,678,229,228,1,66,1,0.074561404,0,empty,CD-0722-1
"H12,A6",398544,469662,299338,170324,261658,143539,0,143690,114081,29609,3.852916343,84667,86151,16491,5456,5368,88,966,6,0.034090909,0,hg38,CD-0722-1
"H12,A7",6580,7407,4877,2530,4140,2111,0,2113,1408,705,1.997163121,1219,1213,233,78,78,0,34,0,0.102564103,0,empty,CD-0722-1
"H12,A8",4027,4618,3032,1586,2563,1301,0,1301,895,406,2.204433498,777,2241,598,225,221,4,68,1,0.117647059,0,empty,CD-0722-1
"H12,A9",641523,755563,482615,272948,418633,225793,3,226000,179643,46357,3.875207628,133665,118766,17958,5960,5846,114,1060,4,0.094594595,0,hg38,CD-0722-1
"H12,A10",9178,9864,7055,2809,5590,2785,0,2787,1750,1037,1.68756027,1500,583,61,28,28,0,7,0,0,0,empty,CD-0722-1
"H12,A11",6617,7306,5061,2245,4162,2010,0,2010,1318,692,1.904624277,1120,1791,352,135,128,7,57,2,0.109375,0,empty,CD-0722-1
"H12,A12",12476,13589,9488,4101,7450,3621,1,3627,2321,1306,1.777182236,1994,4802,1366,499,494,5,114,1,0.093117409,0,empty,CD-0722-1
"H12,B1",7105,7992,5192,2800,4465,2296,3,2303,1489,814,1.829238329,1321,1531,353,131,130,1,39,1,0.061538462,0,empty,CD-0722-1
"H12,B2",608809,693512,420532,272980,385549,216795,0,216961,168693,48268,3.494924173,133024,32008,4305,1488,1443,45,339,2,0.113652114,0,hg38,CD-0722-1
"H12,B3",6981,7979,5147,2832,4501,2309,1,2310,1533,777,1.972972973,1416,1301,296,105,103,2,38,2,0.106796117,0,empty,CD-0722-1
"H12,B4",8111,8968,5928,3040,5095,2748,0,2754,1718,1036,1.658301158,1571,1559,331,107,104,3,40,1,0.076923077,0,empty,CD-0722-1
"H12,B5",6516,3556,2047,1509,2564,1387,1,1400,891,509,1.750491159,966,816,230,72,71,1,26,1,0.169014085,0,empty,CD-0722-1
"H12,B6",661356,756847,500046,256801,409985,213353,1,213560,165983,47577,3.488723543,123979,96157,14100,4607,4520,87,911,7,0.057743363,0,hg38,CD-0722-1
"H12,B7",7206,8305,5437,2868,4453,2179,0,2184,1435,749,1.91588785,1274,1218,291,97,96,1,28,1,0.041666667,0,empty,CD-0722-1
"H12,B8",574846,710447,417659,292788,393273,235415,1,235624,183641,51983,3.532712618,145798,11982,4114,1247,1241,6,311,3,0.085414988,0,hg38,CD-0722-1
"H12,B9",10398,11610,7736,3874,6540,3434,0,3436,2128,1308,1.626911315,2018,1205,395,120,120,0,30,0,0.133333333,0,empty,CD-0722-1
"H12,B10",5794,6070,3957,2113,3467,1793,0,1804,1163,641,1.814352574,1056,508,86,41,40,1,17,1,0.025,0,empty,CD-0722-1
"H12,B11",12044,13746,8713,5033,7684,4268,0,4269,2360,1909,1.236249345,2535,142,28,22,22,0,17,0,0.045454545,0,empty,CD-0722-1
"H12,B12",665485,803231,483007,320224,442674,255230,2,255459,209325,46134,4.53732605,157487,148614,21923,7259,7132,127,1248,6,0.056225463,0,hg38,CD-0722-1
"H12,C1",11523,12303,8705,3598,6831,3211,0,3217,2013,1204,1.67192691,1760,924,228,63,63,0,26,0,0.142857143,0,empty,CD-0722-1
"H12,C2",9967,11409,7228,4181,6216,3249,0,3254,2070,1184,1.748310811,1934,2349,622,166,166,0,46,0,0.018072289,0,empty,CD-0722-1
"H12,C3",11271,12366,8449,3917,7033,3596,0,3599,2310,1289,1.792086889,2014,829,193,96,95,1,29,1,0,0,empty,CD-0722-1
"H12,C4",7162,7851,5363,2488,4429,2131,0,2132,1336,796,1.67839196,1196,2300,713,233,228,5,67,2,0.039473684,0,empty,CD-0722-1
"H12,C5",12516,14153,9474,4679,7977,4036,0,4044,2768,1276,2.169278997,2373,1912,456,163,161,2,66,1,0.074534161,0,empty,CD-0722-1
"H12,C6",852893,998621,632142,366479,551486,304511,3,304785,244737,60048,4.075689448,182614,104303,17844,5971,5861,110,1035,6,0.066541546,0,hg38,CD-0722-1
"H12,C7",12154,14149,8769,5380,7653,4269,0,4273,2480,1793,1.383156721,2574,432,52,30,30,0,22,0,0.133333333,0,empty,CD-0722-1
"H12,C8",761654,883935,567382,316553,484388,272063,1,272301,202076,70225,2.87755073,159258,47706,19252,5760,5724,36,925,4,0.027428372,0,hg38,CD-0722-1
"H12,C9",8929,10056,6758,3298,5718,2852,0,2856,1810,1046,1.73040153,1645,1355,330,105,101,4,36,2,0.099009901,0,empty,CD-0722-1
"H12,C10",9215,9764,7116,2648,5482,2541,0,2548,1666,882,1.888888889,1321,1977,379,141,139,2,48,2,0.028776978,0,empty,CD-0722-1
"H12,C11",713646,824380,538823,285557,447623,231830,2,232048,180429,51619,3.495398981,137374,90683,10088,3395,3287,108,732,6,0.059628841,0,hg38,CD-0722-1
"H12,C12",12577,13815,9289,4526,7536,3645,0,3650,2431,1219,1.994257588,2108,1628,510,142,142,0,43,0,0.021126761,0,empty,CD-0722-1
"H12,D1",1164130,1429235,850309,578926,774024,464879,4,465314,375376,89938,4.173719674,287308,5221,765,222,218,4,78,2,0.096330275,0,hg38,CD-0722-1
"H12,D2",7880,8923,6012,2911,5150,2507,0,2509,1642,867,1.893886967,1464,2669,781,238,236,2,75,1,0.038135593,0,empty,CD-0722-1
"H12,D3",1453773,1685428,1084358,601070,907087,497534,2,497953,413428,84525,4.891191955,296633,101525,13727,4761,4657,104,973,6,0.062057118,0,hg38,CD-0722-1
"H12,D4",6759,7480,5098,2382,4133,2061,0,2061,1322,739,1.788903924,1175,2032,566,171,168,3,43,2,0.047619048,0,empty,CD-0722-1
"H12,D5",7344,8214,5518,2696,4634,2324,0,2326,1589,737,2.156037992,1344,1921,387,162,158,4,56,2,0.044303797,0,empty,CD-0722-1
"H12,D6",589600,676343,443170,233173,369326,192450,1,192611,144460,48151,3.000145376,113551,133760,18892,6234,6094,140,1149,6,0.064489662,0,hg38,CD-0722-1
"H12,D7",5862,6399,4372,2027,3648,1761,0,1761,1130,631,1.790808241,1002,1238,272,105,105,0,40,0,0.047619048,0,empty,CD-0722-1
"H12,D8",7655,8251,5722,2529,4611,2261,0,2263,1470,793,1.85372005,1240,1177,272,80,79,1,43,1,0.088607595,0,empty,CD-0722-1
"H12,D9",277202,349559,185553,164006,194467,133539,1,133612,88758,44854,1.978820172,84308,2697,644,211,209,2,87,2,0.076555024,0,hg38,CD-0722-1
"H12,D10",6716,7643,5023,2620,4279,2237,1,2245,1413,832,1.698317308,1318,622,80,31,30,1,12,1,0.033333333,0,empty,CD-0722-1
"H12,D11",8389,9103,6305,2798,5233,2510,0,2514,1640,874,1.876430206,1419,3254,815,290,287,3,106,1,0.090592334,0,empty,CD-0722-1
"H12,D12",9652,10732,7284,3448,5947,2984,0,2990,1981,1009,1.96333003,1668,3188,633,232,229,3,98,1,0.056768559,0,empty,CD-0722-1
"H12,E1",14835,16324,11073,5251,8501,4227,0,4232,2706,1526,1.773263434,2363,3200,607,232,223,9,84,2,0.121076233,0,empty,CD-0722-1
"H12,E2",798802,951802,588724,363078,517872,289730,2,289932,232042,57890,4.008326136,175942,90593,12773,4096,4007,89,821,6,0.056401298,0,hg38,CD-0722-1
"H12,E3",6071,6934,4617,2317,3870,1923,0,1934,1207,727,1.660247593,1135,2438,671,265,261,4,78,2,0.019157088,0,empty,CD-0722-1
"H12,E4",8753,9726,6465,3261,5502,2776,0,2781,1792,989,1.811931244,1642,2880,614,264,256,8,88,2,0.046875,0,empty,CD-0722-1
"H12,E5",7075,7776,5428,2348,4304,2048,0,2054,1352,702,1.925925926,1128,1362,352,123,123,0,41,0,0.048780488,0,empty,CD-0722-1
"H12,E6",13540,15043,10088,4955,8197,4156,0,4161,2592,1569,1.652007648,2321,2885,599,222,221,1,71,1,0.054298643,0,empty,CD-0722-1
"H12,E7",13459,14800,10125,4675,8284,4104,0,4107,2633,1474,1.786295794,2314,3046,668,231,229,2,71,1,0.043668122,0,empty,CD-0722-1
"H12,E8",9175,9720,7101,2619,5484,2509,0,2509,1587,922,1.721258134,1320,2238,512,149,147,2,50,2,0.047619048,0,empty,CD-0722-1
"H12,E9",7419,8337,5572,2765,4574,2328,0,2332,1496,836,1.789473684,1336,2494,573,223,220,3,79,2,0.077272727,0,empty,CD-0722-1
"H12,E10",6930,7880,5198,2682,4313,2173,0,2177,1362,815,1.671165644,1237,2177,569,164,164,0,53,0,0.024390244,0,empty,CD-0722-1
"H12,E11",9203,10296,6813,3483,5527,2837,0,2840,1822,1018,1.78978389,1641,2125,460,194,187,7,66,3,0.080213904,0,empty,CD-0722-1
"H12,E12",690502,806353,510449,295904,441228,234279,3,234487,187020,47467,3.940000421,140785,3708,916,338,335,3,168,2,0.020895522,0,hg38,CD-0722-1
"H12,F1",625150,703790,477328,226462,382177,189995,1,190187,148052,42135,3.513753412,108058,136253,19333,6516,6398,118,1110,6,0.050640825,0,hg38,CD-0722-1
"H12,F2",580259,711016,397746,313270,395693,258612,0,258808,206309,52499,3.929770091,159963,38643,22206,6580,6570,10,951,3,0.010958904,0,hg38,CD-0722-1
"H12,F3",1043177,1256696,760492,496204,665268,375448,3,375809,307167,68642,4.474913318,230435,6904,1924,648,642,6,298,2,0.060747664,0,hg38,CD-0722-1
"H12,F4",11879,12190,8493,3697,6925,3309,4,3324,2220,1104,2.010869565,1834,630,190,72,71,1,32,1,0.154929577,0,empty,CD-0722-1
"H12,F5",9016,9628,6752,2876,5293,2531,0,2535,1655,880,1.880681818,1431,1517,295,106,105,1,47,1,0.019047619,0,empty,CD-0722-1
"H12,F6",10811,12238,8054,4184,6862,3602,0,3607,2321,1286,1.804821151,2058,2720,589,196,194,2,71,2,0.108247423,0,empty,CD-0722-1
"H12,F7",11407,12785,8541,4244,7107,3663,0,3668,2396,1272,1.883647799,2087,1168,284,99,98,1,40,1,0.030612245,0,empty,CD-0722-1
"H12,F8",8255,9030,6289,2741,5011,2381,0,2381,1570,811,1.935881628,1306,245,53,26,26,0,8,0,0,0,empty,CD-0722-1
"H12,F9",8780,9541,6740,2801,5296,2461,1,2468,1590,878,1.810933941,1348,2551,648,223,221,2,61,2,0.131221719,0,empty,CD-0722-1
"H12,F10",9825,10798,7453,3345,6044,2892,0,2892,1870,1022,1.829745597,1641,2190,744,206,204,2,45,2,0.132352941,0,empty,CD-0722-1
"H12,F11",9423,9852,7297,2555,5578,2534,0,2536,1684,852,1.976525822,1323,1568,297,128,127,1,37,1,0.086614173,0,empty,CD-0722-1
"H12,F12",9578,10433,7045,3388,5727,2843,0,2849,1804,1045,1.726315789,1603,84,14,9,9,0,6,0,0,0,empty,CD-0722-1
"H12,G1",1563603,1835306,1164982,670324,992037,565095,7,565593,454414,111179,4.087228703,333287,173136,41167,13277,13142,135,2019,4,0.072287323,0,hg38,CD-0722-1
"H12,G2",5617,6203,4011,2192,3477,1807,0,1809,1158,651,1.778801843,1050,460,113,38,38,0,16,0,0.263157895,0,empty,CD-0722-1
"H12,G3",10923,11465,7960,3505,6516,3313,0,3322,2021,1301,1.553420446,1773,2544,630,270,267,3,102,2,0.08988764,0,empty,CD-0722-1
"H12,G4",19805,22564,14495,8069,12323,6804,1,6818,4134,2684,1.54023845,3913,239,34,20,20,0,10,0,0.05,0,empty,CD-0722-1
"H12,G5",6755,7609,5014,2595,4224,2163,1,2168,1392,776,1.793814433,1218,1919,512,193,186,7,57,2,0.016129032,0,empty,CD-0722-1
"H12,G6",9244,10186,6864,3322,5470,2723,1,2730,1776,954,1.86163522,1539,261,39,16,16,0,9,0,0,0,empty,CD-0722-1
"H12,G7",8955,9964,6810,3154,5437,2545,0,2550,1672,878,1.904328018,1422,2865,656,213,210,3,68,2,0.047619048,0,empty,CD-0722-1
"H12,G8",5814,6261,4303,1958,3508,1659,1,1663,1132,531,2.131826742,959,1725,374,141,141,0,49,0,0.09929078,0,empty,CD-0722-1
"H12,G9",6847,7650,5130,2520,4160,1996,0,1997,1304,693,1.881673882,1126,2162,563,211,211,0,71,0,0.061611374,0,empty,CD-0722-1
"H12,G10",9228,10133,6935,3198,5644,2839,0,2840,1815,1025,1.770731707,1615,1897,405,175,170,5,72,2,0.052941176,0,empty,CD-0722-1
"H12,G11",8975,9716,6806,2910,5443,2676,0,2676,1742,934,1.86509636,1467,1504,329,135,133,2,49,1,0.157894737,0,empty,CD-0722-1
"H12,G12",7022,7832,5216,2616,4426,2211,0,2218,1349,869,1.552359033,1272,2578,613,192,189,3,54,3,0.047619048,0,empty,CD-0722-1
"H12,H1",7856,8496,5906,2590,4751,2238,0,2241,1493,748,1.995989305,1232,1299,305,113,109,4,35,2,0.055045872,0,empty,CD-0722-1
"H12,H2",8014,8904,6114,2790,4918,2396,0,2399,1529,870,1.757471264,1337,2322,605,213,210,3,57,2,0.128571429,0,empty,CD-0722-1
"H12,H3",7240,8213,5278,2935,4440,2302,1,2305,1457,848,1.718160377,1359,1842,305,126,122,4,42,2,0.024590164,0,empty,CD-0722-1
"H12,H4",10578,11649,7898,3751,6306,3124,0,3125,2074,1051,1.973358706,1771,178,44,30,30,0,17,0,0.066666667,0,empty,CD-0722-1
"H12,H5",11322,12598,8366,4232,6873,3463,0,3469,2256,1213,1.859851608,2012,5969,977,358,346,12,83,2,0.034682081,0,empty,CD-0722-1
"H12,H6",6990,7844,5195,2649,4320,2233,0,2233,1470,763,1.926605505,1280,1754,424,143,142,1,49,1,0.056338028,0,empty,CD-0722-1
"H12,H7",8219,9135,6138,2997,5146,2557,4,2567,1656,911,1.817782656,1499,1913,491,197,195,2,62,1,0.123076923,0,empty,CD-0722-1
"H12,H8",8929,10095,6496,3599,5520,2896,0,2896,1774,1122,1.581105169,1711,2498,547,193,184,9,54,2,0.168478261,0,empty,CD-0722-1
"H12,H9",7135,7749,5334,2415,4267,2003,0,2005,1284,721,1.780859917,1146,1219,255,99,98,1,38,1,0.020408163,0,empty,CD-0722-1
"H12,H10",6060,6808,4490,2318,3800,1879,0,1881,1167,714,1.634453782,1110,1367,269,105,98,7,34,2,0.102040816,0,empty,CD-0722-1
"H12,H11",8817,10350,6081,4269,5901,3650,0,3653,1893,1760,1.075568182,2248,52,9,6,6,0,6,0,0,0,empty,CD-0722-1
"H12,H12",7517,8359,5449,2910,4709,2486,0,2488,1626,862,1.886310905,1467,1965,556,212,211,1,74,1,0.123222749,0,empty,CD-0722-1
"A1,A1",3634,4281,2642,1639,2528,1462,0,1465,922,543,1.697974217,833,1178,215,99,94,5,38,2,0.14893617,0,empty,CD-0722-2
"A1,A2",362425,399099,278257,120842,230087,110669,1,110780,80276,30504,2.631654865,60992,73098,13649,5317,5238,79,927,4,0.031882398,0,hg38,CD-0722-2
"A1,A3",3383,3788,2460,1328,2298,1268,0,1269,830,439,1.890660592,705,1192,244,73,73,0,29,0,0.02739726,0,empty,CD-0722-2
"A1,A4",403690,488631,284113,204518,284502,186145,0,186252,132803,53449,2.484667627,110245,901,120,60,60,0,28,0,0.016666667,0,empty,CD-0722-2
"A1,A5",4693,5209,3514,1695,3243,1752,0,1754,1180,574,2.055749129,970,2427,628,272,272,0,73,0,0.044117647,0,empty,CD-0722-2
"A1,A6",4224,4947,3036,1911,3075,1794,0,1794,1131,663,1.705882353,1079,2696,558,241,240,1,77,1,0.1125,0,empty,CD-0722-2
"A1,A7",3499,3988,2569,1419,2435,1371,1,1377,868,509,1.705304519,783,1131,272,127,125,2,44,2,0.152,0,empty,CD-0722-2
"A1,A8",2090,2422,1563,859,1460,793,0,793,534,259,2.061776062,446,1866,513,185,183,2,55,1,0.016393443,0,empty,CD-0722-2
"A1,A9",3880,4551,2888,1663,2783,1533,0,1533,1007,526,1.914448669,885,2070,484,166,166,0,44,0,0.072289157,0,empty,CD-0722-2
"A1,A10",4964,5803,3661,2142,3484,1948,0,1948,1240,708,1.751412429,1137,369,35,24,23,1,15,1,0,0,empty,CD-0722-2
"A1,A11",3369,3892,2526,1366,2337,1252,0,1253,840,413,2.033898305,731,1776,332,161,158,3,55,3,0.056962025,0,empty,CD-0722-2
"A1,A12",4927,5572,3718,1854,3298,1761,0,1761,1126,635,1.773228346,977,3415,794,329,326,3,95,2,0.088957055,0,empty,CD-0722-2
"A1,B1",4070,4883,2927,1956,2888,1695,0,1695,1036,659,1.572078907,1058,1290,281,146,143,3,39,2,0.027972028,0,empty,CD-0722-2
"A1,B2",4293,4777,2906,1871,2930,1745,0,1747,1078,669,1.611360239,1050,665,119,45,45,0,13,0,0,0,empty,CD-0722-2
"A1,B3",3524,3944,2608,1336,2368,1300,0,1305,869,436,1.993119266,725,1495,287,135,135,0,51,0,0.014814815,0,empty,CD-0722-2
"A1,B4",3906,4571,2785,1786,2799,1656,0,1658,1050,608,1.726973684,995,1647,305,146,146,0,41,0,0.04109589,0,empty,CD-0722-2
"A1,B5",7696,7219,3952,3267,4647,2817,0,2825,2059,766,2.687989556,1872,1165,358,111,110,1,38,1,0.172727273,0,empty,CD-0722-2
"A1,B6",4471,5274,3148,2126,3200,1911,0,1911,1204,707,1.702970297,1163,1291,232,110,107,3,35,1,0.009345794,0,empty,CD-0722-2
"A1,B7",3970,4542,2980,1562,2756,1491,0,1495,1019,476,2.140756303,846,1015,144,64,62,2,25,1,0.258064516,0,empty,CD-0722-2
"A1,B8",2963,3437,2243,1194,2098,1132,0,1134,745,389,1.915167095,622,963,208,97,96,1,39,1,0,0,empty,CD-0722-2
"A1,B9",5697,6518,4072,2446,3938,2326,0,2326,1467,859,1.707799767,1356,984,241,109,107,2,45,2,0.074766355,0,empty,CD-0722-2
"A1,B10",2814,3216,2033,1183,1887,1027,0,1027,668,359,1.860724234,578,362,50,25,25,0,9,0,0.04,0,empty,CD-0722-2
"A1,B11",7990,9049,5637,3412,5316,3069,0,3075,1840,1235,1.489878543,1793,216,38,27,27,0,18,0,0,0,empty,CD-0722-2
"A1,B12",3447,3849,2532,1317,2400,1348,0,1351,918,433,2.120092379,738,1626,384,157,153,4,50,2,0.163398693,0,empty,CD-0722-2
"A1,C1",7041,7932,5234,2698,4760,2573,0,2577,1627,950,1.712631579,1469,1010,311,138,138,0,35,0,0.094202899,0,empty,CD-0722-2
"A1,C2",5922,6664,4127,2537,3977,2208,0,2212,1430,782,1.828644501,1305,2131,500,191,190,1,65,1,0.1,0,empty,CD-0722-2
"A1,C3",1318650,1626631,956885,669746,922663,556722,7,557159,456299,100860,4.524082887,340838,93354,12265,4709,4626,83,921,5,0.060095115,0,hg38,CD-0722-2
"A1,C4",3814,4262,2847,1415,2590,1362,0,1362,915,447,2.046979866,755,1264,135,81,79,2,31,2,0.025316456,0,empty,CD-0722-2
"A1,C5",5842,6792,4299,2493,4090,2276,0,2278,1484,794,1.869017632,1341,1416,297,94,90,4,36,1,0,0,empty,CD-0722-2
"A1,C6",4795,5389,3494,1895,3314,1823,0,1830,1223,607,2.014827018,1043,1825,539,198,196,2,54,2,0.117346939,0,empty,CD-0722-2
"A1,C7",6554,7875,4474,3401,4700,2918,0,2919,1716,1203,1.426433915,1821,446,148,52,51,1,21,1,0.019607843,0,empty,CD-0722-2
"A1,C8",445978,514297,334925,179372,297168,158503,0,158644,123380,35264,3.498752269,91808,145611,21268,8442,8236,206,1414,8,0.072000971,0,hg38,CD-0722-2
"A1,C9",490809,625154,346485,278669,361983,228167,0,228304,178735,49569,3.605781839,144776,38474,7617,2804,2760,44,593,3,0.06884058,0,hg38,CD-0722-2
"A1,C10",5563,6094,4114,1980,3674,1972,0,1975,1288,687,1.874818049,1044,1776,360,157,157,0,51,0,0.159235669,0,empty,CD-0722-2
"A1,C11",4665,5582,3421,2161,3299,1823,0,1827,1193,634,1.88170347,1091,2161,457,211,210,1,52,1,0.142857143,0,empty,CD-0722-2
"A1,C12",442972,517686,326444,191242,302504,171679,1,171804,139010,32794,4.238885162,101521,32583,6257,2289,2244,45,477,4,0.027183601,0,hg38,CD-0722-2
"A1,D1",6327,7408,4482,2926,4492,2687,0,2690,1569,1121,1.399643176,1590,668,170,60,60,0,26,0,0.066666667,0,empty,CD-0722-2
"A1,D2",4766,5546,3556,1990,3366,1795,0,1797,1148,649,1.768875193,1060,2557,534,266,258,8,71,2,0.065891473,0,empty,CD-0722-2
"A1,D3",4454,5082,3189,1893,3044,1755,0,1755,1123,632,1.776898734,1005,1520,473,182,181,1,55,1,0.011049724,0,empty,CD-0722-2
"A1,D4",336641,376393,260817,115576,218811,107174,0,107260,85287,21973,3.88144541,59931,17891,2894,1078,1053,25,315,4,0.03988604,0,hg38,CD-0722-2
"A1,D5",3817,4434,2759,1675,2702,1509,0,1509,1009,500,2.018,909,1607,427,180,179,1,55,1,0.067039106,0,empty,CD-0722-2
"A1,D6",400886,498924,270503,228421,293818,200335,1,200475,145112,55363,2.621100735,124876,5458,570,236,232,4,77,1,0.232758621,0,hg38,CD-0722-2
"A1,D7",809596,920354,612402,307952,524516,277482,5,277742,227044,50698,4.478362066,159584,66746,11958,4469,4410,59,886,5,0.036961451,0,hg38,CD-0722-2
"A1,D8",3997,4652,2927,1725,2837,1562,0,1564,1007,557,1.807899461,930,1751,557,192,189,3,51,1,0.026455026,0,empty,CD-0722-2
"A1,D9",2177,2443,1586,857,1474,771,0,773,466,307,1.517915309,462,1446,437,156,154,2,42,2,0.11038961,0,empty,CD-0722-2
"A1,D10",4764,5641,3391,2250,3447,2011,0,2011,1285,726,1.769972452,1218,677,138,46,45,1,21,1,0.044444444,0,empty,CD-0722-2
"A1,D11",4183,4814,3122,1692,2946,1604,0,1607,1042,565,1.844247788,946,2235,765,266,261,5,75,2,0.218390805,0,empty,CD-0722-2
"A1,D12",5582,6294,4097,2197,3820,2092,0,2096,1390,706,1.968838527,1216,3738,856,363,360,3,102,2,0.063888889,0,empty,CD-0722-2
"A1,E1",6774,7676,4944,2732,4648,2607,0,2610,1649,961,1.715920916,1486,2330,525,223,216,7,64,2,0.171296296,0,empty,CD-0722-2
"A1,E2",4746,5402,3459,1943,3228,1812,0,1820,1165,655,1.778625954,1051,1899,426,153,145,8,45,2,0.055172414,0,empty,CD-0722-2
"A1,E3",3356,3989,2472,1517,2415,1326,0,1327,813,514,1.581712062,806,2143,544,231,229,2,71,1,0.034934498,0,empty,CD-0722-2
"A1,E4",4575,5453,3367,2086,3237,1793,0,1793,1165,628,1.855095541,1085,2047,515,180,178,2,66,2,0.078651685,0,empty,CD-0722-2
"A1,E5",4032,4567,3036,1531,2764,1436,0,1438,961,477,2.014675052,839,1520,410,133,129,4,39,2,0.023255814,0,empty,CD-0722-2
"A1,E6",390178,492180,266863,225317,286712,196807,1,196923,127537,69386,1.838079728,122636,3769,893,344,331,13,110,2,0.105740181,0,hg38,CD-0722-2
"A1,E7",6782,7762,5085,2677,4643,2503,0,2505,1634,871,1.876004592,1443,4033,928,303,299,4,97,2,0.150501672,0,empty,CD-0722-2
"A1,E8",512942,578598,396241,182357,332415,165913,3,166104,126589,39515,3.203568265,92604,187343,30561,11783,11565,218,1771,6,0.052313013,0,hg38,CD-0722-2
"A1,E9",3257,3643,2414,1229,2246,1241,0,1241,785,456,1.721491228,706,2693,784,298,295,3,99,3,0.057627119,0,empty,CD-0722-2
"A1,E10",3810,4387,2778,1609,2656,1448,0,1456,952,504,1.888888889,871,1876,373,163,160,3,60,1,0.08125,0,empty,CD-0722-2
"A1,E11",4710,5343,3451,1892,3244,1818,0,1820,1138,682,1.668621701,1061,2053,465,187,184,3,53,1,0.043478261,0,empty,CD-0722-2
"A1,E12",5076,5898,3660,2238,3539,1981,0,1985,1295,690,1.876811594,1175,1785,367,159,156,3,58,2,0.108974359,0,empty,CD-0722-2
"A1,F1",5968,6775,4378,2397,4047,2181,0,2187,1415,772,1.832901554,1268,1748,445,165,164,1,63,1,0.085365854,0,empty,CD-0722-2
"A1,F2",328204,353389,256370,97019,206600,91503,0,91599,67693,23906,2.831632226,49751,45047,8494,3122,3065,57,630,4,0.017944535,0,hg38,CD-0722-2
"A1,F3",14359,16926,10462,6464,9618,5539,0,5541,3671,1870,1.963101604,3245,2840,656,255,250,5,78,2,0.112,0,empty,CD-0722-2
"A1,F4",6644,7345,4950,2395,4552,2385,0,2386,1507,879,1.714448237,1355,821,150,76,75,1,36,1,0.013333333,0,empty,CD-0722-2
"A1,F5",5381,5862,3970,1892,3504,1839,0,1840,1224,616,1.987012987,1018,2459,646,230,228,2,63,2,0.118421053,0,empty,CD-0722-2
"A1,F6",5279,6030,3724,2306,3618,2065,0,2066,1306,760,1.718421053,1232,2765,673,271,270,1,63,1,0.051851852,0,empty,CD-0722-2
"A1,F7",5721,6447,4201,2246,3938,2172,0,2173,1362,811,1.679408138,1226,784,135,49,48,1,24,1,0,0,empty,CD-0722-2
"A1,F8",784082,942610,586581,356029,542271,310761,2,311019,255952,55067,4.648010605,183993,17284,2547,941,927,14,254,2,0.049622438,0,hg38,CD-0722-2
"A1,F9",5002,5687,3674,2013,3412,1756,0,1760,1096,664,1.65060241,1026,2609,645,262,260,2,92,2,0.05,0,empty,CD-0722-2
"A1,F10",517683,594210,388146,206064,343693,184249,3,184413,144589,39824,3.63070008,106154,139242,25372,9735,9582,153,1499,4,0.039970779,0,hg38,CD-0722-2
"A1,F11",139869,144525,109124,35401,84281,37919,0,37965,25764,12201,2.111630194,18958,3379,803,367,363,4,165,2,0.074380165,0,empty,CD-0722-2
"A1,F12",439309,506096,327797,178299,290315,154595,2,154715,116823,37892,3.083051832,91201,7573,948,396,388,8,82,3,0.020618557,0,hg38,CD-0722-2
"A1,G1",5595,6473,4172,2301,3810,2014,0,2014,1281,733,1.747612551,1148,2637,829,309,305,4,92,1,0.039344262,0,empty,CD-0722-2
"A1,G2",439414,529445,301591,227854,310290,191707,0,191848,151533,40315,3.75872504,118996,17098,3464,1358,1338,20,324,3,0.068759342,0,hg38,CD-0722-2
"A1,G3",6438,7267,4644,2623,4267,2408,0,2410,1435,975,1.471794872,1363,2066,487,171,169,2,64,2,0.041420118,0,empty,CD-0722-2
"A1,G4",11807,13723,8284,5439,8261,5010,0,5013,2973,2040,1.457352941,2989,151,37,20,20,0,7,0,0,0,empty,CD-0722-2
"A1,G5",3565,4062,2599,1463,2443,1319,0,1324,889,435,2.043678161,746,1585,278,138,138,0,51,0,0.02173913,0,empty,CD-0722-2
"A1,G6",5440,5997,4018,1979,3623,1961,1,1962,1324,638,2.07523511,1050,165,27,14,14,0,8,0,0,0,empty,CD-0722-2
"A1,G7",4158,4683,3090,1593,2815,1489,0,1491,972,519,1.87283237,822,2751,830,308,302,6,61,2,0.205298013,0,empty,CD-0722-2
"A1,G8",494709,582414,366019,216395,336454,192455,0,192588,146648,45940,3.192163692,113297,75008,12747,4966,4857,109,935,4,0.035001029,0,hg38,CD-0722-2
"A1,G9",3793,4259,2801,1458,2569,1387,0,1389,935,454,2.059471366,791,2513,600,221,216,5,73,2,0.027777778,0,empty,CD-0722-2
"A1,G10",4865,5515,3621,1894,3256,1768,0,1768,1107,661,1.67473525,969,2541,746,337,337,0,89,0,0.097922849,0,empty,CD-0722-2
"A1,G11",4721,5405,3538,1867,3182,1756,0,1756,1132,624,1.814102564,1002,1445,289,134,132,2,52,1,0.045454545,0,empty,CD-0722-2
"A1,G12",4387,5177,3118,2059,3139,1794,0,1794,1077,717,1.50209205,1117,4202,700,313,310,3,97,1,0.164516129,0,empty,CD-0722-2
"A1,H1",398630,446584,299201,147383,260950,141702,2,141813,110252,31561,3.493298691,79441,23625,7454,2676,2653,23,508,2,0.010931021,0,hg38,CD-0722-2
"A1,H2",526316,676184,363710,312474,395541,257672,0,257836,203021,54815,3.703748974,164972,27495,13683,4817,4804,13,932,3,0.026644463,0,hg38,CD-0722-2
"A1,H3",3870,4323,2844,1479,2603,1393,0,1395,919,476,1.930672269,764,1459,336,132,132,0,46,0,0.045454545,0,empty,CD-0722-2
"A1,H4",5821,6583,4286,2297,3873,2112,0,2116,1399,717,1.951185495,1176,264,50,33,33,0,13,0,0.060606061,0,empty,CD-0722-2
"A1,H5",621884,801747,426386,375361,462494,307974,2,308149,236937,71212,3.327206089,197344,25260,13600,5042,5031,11,898,2,0.028423773,0,hg38,CD-0722-2
"A1,H6",3641,4257,2594,1663,2575,1454,0,1454,981,473,2.073995772,873,1673,478,205,203,2,63,2,0.093596059,0,empty,CD-0722-2
"A1,H7",710189,852108,525184,326924,492150,283673,8,283967,229041,54926,4.169992353,168776,178002,38027,14673,14525,148,2039,6,0.08130809,0,hg38,CD-0722-2
"A1,H8",5141,5976,3741,2235,3512,1959,0,1961,1250,711,1.758087201,1182,2411,504,201,200,1,72,1,0.065,0,empty,CD-0722-2
"A1,H9",4139,4868,3091,1777,2889,1604,0,1608,1120,488,2.295081967,937,1056,207,113,111,2,38,1,0.054054054,0,empty,CD-0722-2
"A1,H10",1061783,1201230,810957,390273,677035,351650,5,351995,276666,75329,3.672768788,200605,156853,22740,8676,8482,194,1557,7,0.025112002,0,hg38,CD-0722-2
"A1,H11",6095,7283,3887,3396,4271,2899,0,2901,1449,1452,0.997933884,1789,103,7,2,2,0,2,0,0,0,empty,CD-0722-2
"A1,H12",3864,4369,2793,1576,2567,1418,0,1418,922,496,1.858870968,807,1284,367,159,158,1,44,1,0.056962025,0,empty,CD-0722-2
"A2,A1",4355,4899,3090,1809,2992,1710,0,1714,1063,651,1.632872504,1005,1505,387,142,141,1,51,1,0.014184397,0,empty,CD-0722-2
"A2,A2",6209,7009,4553,2456,4247,2391,0,2392,1495,897,1.666666667,1373,2026,510,188,185,3,57,2,0.064864865,0,empty,CD-0722-2
"A2,A3",3877,4268,2840,1428,2644,1443,0,1443,955,488,1.956967213,817,1184,249,94,92,2,42,1,0.010869565,0,empty,CD-0722-2
"A2,A4",6518,7551,4867,2684,4451,2523,0,2524,1660,864,1.921296296,1404,619,162,61,60,1,21,1,0.05,0,empty,CD-0722-2
"A2,A5",860435,992632,641597,351035,576046,317924,2,318193,241204,76989,3.132967047,185441,107427,13082,4791,4647,144,1015,8,0.023886378,0,hg38,CD-0722-2
"A2,A6",5125,6237,3777,2460,3769,2215,0,2219,1455,764,1.904450262,1315,3089,721,277,271,6,88,2,0.025830258,0,empty,CD-0722-2
"A2,A7",4349,5155,3048,2107,3051,1859,0,1859,1168,691,1.690303907,1121,1520,361,102,101,1,37,1,0.04950495,0,empty,CD-0722-2
"A2,A8",2437,2777,1786,991,1682,939,0,939,627,312,2.009615385,558,1874,513,188,187,1,48,1,0.064171123,0,empty,CD-0722-2
"A2,A9",4593,5223,3450,1773,3125,1701,0,1704,1140,564,2.021276596,943,2229,490,193,192,1,60,1,0.0625,0,empty,CD-0722-2
"A2,A10",5839,6474,4419,2055,3810,2007,0,2008,1271,737,1.724559023,1086,577,138,74,74,0,23,0,0.013513514,0,empty,CD-0722-2
"A2,A11",4025,4460,3052,1408,2692,1438,0,1438,954,484,1.97107438,769,2329,547,195,193,2,66,2,0.051813472,0,empty,CD-0722-2
"A2,A12",5804,6391,4395,1996,3780,1927,0,1930,1244,686,1.813411079,1044,4947,1072,404,401,3,100,2,0.06234414,0,empty,CD-0722-2
"A2,B1",4733,5456,3479,1977,3315,1895,0,1896,1277,619,2.063004847,1117,1277,305,78,76,2,30,2,0.078947368,0,empty,CD-0722-2
"A2,B2",4940,5641,3365,2276,3306,1962,0,1964,1222,742,1.64690027,1167,515,103,47,47,0,22,0,0.14893617,0,empty,CD-0722-2
"A2,B3",4292,4894,3101,1793,2912,1586,0,1589,1036,553,1.873417722,930,1793,398,164,160,4,51,2,0.09375,0,empty,CD-0722-2
"A2,B4",4909,5843,3468,2375,3536,2127,0,2132,1319,813,1.622386224,1305,1798,441,132,127,5,37,2,0.05511811,0,empty,CD-0722-2
"A2,B5",4662,2711,1692,1019,1994,1114,0,1121,733,388,1.889175258,701,963,212,90,90,0,29,0,0.322222222,0,empty,CD-0722-2
"A2,B6",5109,6051,3721,2330,3601,2149,0,2151,1345,806,1.668734491,1265,1909,382,145,141,4,47,2,0.028368794,0,empty,CD-0722-2
"A2,B7",4564,5046,3478,1568,3019,1563,0,1567,983,584,1.683219178,828,1342,324,121,120,1,38,1,0,0,empty,CD-0722-2
"A2,B8",3378,3793,2514,1279,2325,1265,0,1267,880,387,2.273901809,712,1270,328,134,134,0,45,0,0.059701493,0,empty,CD-0722-2
"A2,B9",6970,7926,5066,2860,4810,2728,0,2734,1668,1066,1.564727955,1610,1621,383,151,149,2,56,2,0.080536913,0,empty,CD-0722-2
"A2,B10",3327,3621,2400,1221,2211,1192,0,1192,746,446,1.67264574,659,874,154,54,53,1,21,1,0,0,empty,CD-0722-2
"A2,B11",681054,801426,505896,295530,453972,253409,0,253659,200532,53127,3.774577898,148782,28416,3341,1369,1330,39,316,3,0.05037594,0,hg38,CD-0722-2
"A2,B12",4490,5096,3290,1806,3015,1676,0,1687,1092,595,1.835294118,972,1950,363,168,167,1,52,1,0.119760479,0,empty,CD-0722-2
"A2,C1",960175,1153173,706833,446340,661429,393957,4,394292,315898,78394,4.029619614,234443,15927,6024,2026,2019,7,490,2,0.031698861,0,hg38,CD-0722-2
"A2,C2",6630,7233,4883,2350,4378,2319,0,2326,1545,781,1.978233035,1280,1780,467,179,177,2,49,1,0.124293785,0,empty,CD-0722-2
"A2,C3",7766,8821,5698,3123,5246,2864,0,2867,1895,972,1.949588477,1633,756,77,54,54,0,26,0,0.055555556,0,empty,CD-0722-2
"A2,C4",4239,4643,3128,1515,2791,1483,0,1483,1001,482,2.076763485,812,2099,562,208,208,0,50,0,0.057692308,0,empty,CD-0722-2
"A2,C5",674585,821689,488328,333361,473655,282882,3,283065,214223,68842,3.111806746,172691,82941,15150,5660,5564,96,1008,7,0.061466571,0,hg38,CD-0722-2
"A2,C6",5135,5873,3740,2133,3605,1960,0,1965,1260,705,1.787234043,1157,1998,524,187,186,1,50,1,0.043010753,0,empty,CD-0722-2
"A2,C7",7599,9101,5257,3844,5511,3450,0,3453,2054,1399,1.468191565,2137,545,157,55,55,0,18,0,0,0,empty,CD-0722-2
"A2,C8",8099,9339,5896,3443,5620,3133,0,3134,2048,1086,1.885819521,1822,3307,831,347,345,2,89,1,0.014492754,0,empty,CD-0722-2
"A2,C9",5726,6745,4189,2556,4129,2309,0,2318,1510,808,1.868811881,1386,2156,446,199,193,6,46,2,0.103626943,0,empty,CD-0722-2
"A2,C10",6260,7092,4579,2513,4252,2302,0,2305,1495,810,1.845679012,1326,2660,476,150,147,3,50,2,0.156462585,0,empty,CD-0722-2
"A2,C11",5342,6098,3885,2213,3669,2029,0,2029,1280,749,1.70894526,1235,1842,569,224,224,0,59,0,0.044642857,0,empty,CD-0722-2
"A2,C12",568801,669604,410546,259058,387031,224709,2,224908,179614,45294,3.965514196,134559,88581,17100,6228,6109,119,1064,5,0.033229661,0,hg38,CD-0722-2
"A2,D1",7167,8234,5154,3080,5008,2956,0,2958,1782,1176,1.515306122,1689,1030,160,63,56,7,22,1,0.017857143,0,empty,CD-0722-2
"A2,D2",5591,6090,4249,1841,3736,1944,0,1946,1279,667,1.917541229,1026,3844,1264,448,448,0,105,0,0.084821429,0,empty,CD-0722-2
"A2,D3",5032,5819,3559,2260,3532,2026,0,2030,1345,685,1.96350365,1201,1560,288,113,113,0,43,0,0.115044248,0,empty,CD-0722-2
"A2,D4",3982,4393,2965,1428,2620,1423,0,1425,923,502,1.838645418,798,1215,265,122,120,2,38,1,0.008333333,0,empty,CD-0722-2
"A2,D5",4694,5339,3444,1895,3200,1760,0,1760,1176,584,2.01369863,1025,2429,508,256,246,10,71,2,0.105691057,0,empty,CD-0722-2
"A2,D6",7502,8898,5320,3578,5262,3137,0,3137,1877,1260,1.48968254,1914,1788,401,188,186,2,55,2,0.075268817,0,empty,CD-0722-2
"A2,D7",3818,4393,2805,1588,2629,1442,0,1442,935,507,1.84418146,849,2067,479,190,189,1,66,1,0.042328042,0,empty,CD-0722-2
"A2,D8",4603,5294,3382,1912,3203,1747,0,1749,1118,631,1.771790808,989,1288,318,147,141,6,42,2,0.113475177,0,empty,CD-0722-2
"A2,D9",2789,3169,2062,1107,1909,1019,0,1019,678,341,1.988269795,593,1650,389,151,149,2,53,1,0.026845638,0,empty,CD-0722-2
"A2,D10",4345,5187,3111,2076,3082,1789,0,1792,1112,680,1.635294118,1084,842,104,62,61,1,26,1,0.016393443,0,empty,CD-0722-2
"A2,D11",5318,5907,3925,1982,3572,1881,0,1881,1215,666,1.824324324,1089,3537,902,302,297,5,94,2,0.057239057,0,empty,CD-0722-2
"A2,D12",548099,618775,417367,201408,356437,184430,0,184624,144250,40374,3.572843909,104592,108473,19776,7180,7022,158,1190,5,0.022927941,0,hg38,CD-0722-2
"A2,E1",8200,9148,5944,3204,5457,3066,0,3076,1940,1136,1.707746479,1696,3406,885,269,264,5,79,2,0.075757576,0,empty,CD-0722-2
"A2,E2",490802,553871,374629,179242,320395,161006,0,161138,119832,41306,2.901079746,92035,55178,8314,3134,3072,62,652,3,0.015299479,0,hg38,CD-0722-2
"A2,E3",3728,4266,2654,1612,2529,1341,0,1341,867,474,1.829113924,812,2281,633,271,270,1,74,1,0.048148148,0,empty,CD-0722-2
"A2,E4",5283,6056,3862,2194,3659,2013,0,2018,1354,664,2.039156627,1159,2610,641,252,249,3,72,1,0.076305221,0,empty,CD-0722-2
"A2,E5",1159142,1373476,857337,516139,786124,465025,4,465439,342597,122842,2.788923984,272767,57868,14891,5390,5322,68,988,4,0.012589252,0,hg38,CD-0722-2
"A2,E6",9071,10376,6613,3763,6047,3373,0,3373,2222,1151,1.930495222,1904,3529,789,322,320,2,93,2,0.04375,0,empty,CD-0722-2
"A2,E7",7785,8766,5822,2944,5231,2757,0,2757,1813,944,1.920550847,1523,4362,900,408,404,4,92,2,0.047029703,0,empty,CD-0722-2
"A2,E8",5963,6484,4430,2054,3937,2013,0,2014,1299,715,1.816783217,1105,2608,578,225,225,0,66,0,0.137777778,0,empty,CD-0722-2
"A2,E9",4221,4667,3172,1495,2869,1528,0,1529,1006,523,1.923518164,843,3005,607,218,216,2,72,2,0.083333333,0,empty,CD-0722-2
"A2,E10",4381,5008,3291,1717,2913,1500,0,1500,941,559,1.683363148,855,2259,562,247,246,1,57,1,0.06097561,0,empty,CD-0722-2
"A2,E11",5492,6375,4028,2347,3734,2099,0,2100,1296,804,1.611940299,1165,3138,669,232,230,2,57,1,0.004347826,0,empty,CD-0722-2
"A2,E12",664854,833268,465923,367345,478310,294588,1,294830,235727,59103,3.988410064,186060,163613,20775,8346,8086,260,1320,6,0.129112046,0,hg38,CD-0722-2
"A2,F1",7081,7744,5165,2579,4582,2399,0,2400,1539,861,1.787456446,1368,2853,665,277,269,8,75,2,0.085501859,0,empty,CD-0722-2
"A2,F2",431281,465244,334920,130324,270461,124281,1,124389,96923,27466,3.528835651,67680,61753,14252,5212,5145,67,920,4,0.0101069,0,hg38,CD-0722-2
"A2,F3",4919,5679,3536,2143,3470,1896,0,1899,1203,696,1.728448276,1124,3003,696,300,297,3,86,2,0.111111111,0,empty,CD-0722-2
"A2,F4",577070,627774,447050,180724,364855,172519,7,172698,133500,39198,3.405786009,94471,14031,2944,1109,1096,13,240,3,0.037408759,0,hg38,CD-0722-2
"A2,F5",6160,6887,4561,2326,4081,2157,0,2159,1342,817,1.642594859,1219,2355,482,218,215,3,57,2,0.013953488,0,empty,CD-0722-2
"A2,F6",6258,7125,4547,2578,4212,2425,0,2427,1515,912,1.661184211,1411,2885,883,331,322,9,77,2,0.096273292,0,empty,CD-0722-2
"A2,F7",7144,8182,5276,2906,4948,2712,0,2714,1824,890,2.049438202,1575,1393,437,151,151,0,37,0,0.066225166,0,empty,CD-0722-2
"A2,F8",610898,757879,429827,328052,441562,291257,0,291442,203929,87513,2.330270931,176984,4249,225,82,80,2,34,2,0.075,0,empty,CD-0722-2
"A2,F9",315430,377816,222954,154862,220839,139611,1,139713,109203,30510,3.579252704,82253,37310,17879,6645,6625,20,1103,3,0.041962264,0,hg38,CD-0722-2
"A2,F10",637958,723521,486690,236831,416064,213097,2,213291,161654,51637,3.130584658,120698,130031,18749,7057,6911,146,1177,4,0.027058313,0,hg38,CD-0722-2
"A2,F11",554296,654172,409787,244385,377285,214330,1,214481,169526,44955,3.77101546,126265,72756,15083,6005,5910,95,1108,4,0.074957699,0,hg38,CD-0722-2
"A2,F12",6060,6926,4384,2542,4119,2289,0,2292,1444,848,1.702830189,1358,252,39,19,19,0,13,0,0,0,empty,CD-0722-2
"A2,G1",6304,7044,4697,2347,4184,2215,0,2219,1435,784,1.830357143,1245,3602,873,337,334,3,88,1,0.077844311,0,empty,CD-0722-2
"A2,G2",627366,744258,430115,314143,434724,272178,2,272361,202652,69709,2.907113859,167088,13563,3057,1129,1110,19,236,2,0.024324324,0,hg38,CD-0722-2
"A2,G3",7428,8145,5464,2681,4903,2672,0,2675,1645,1030,1.597087379,1446,2978,948,304,300,4,80,1,0.073333333,0,empty,CD-0722-2
"A2,G4",13828,16111,9745,6366,9662,5897,0,5902,3490,2412,1.446932007,3511,108,28,17,17,0,12,0,0,0,empty,CD-0722-2
"A2,G5",4278,4946,3142,1804,2906,1605,0,1609,1047,562,1.862989324,943,1703,482,183,181,2,55,1,0.055248619,0,empty,CD-0722-2
"A2,G6",6377,7061,4780,2281,4187,2171,1,2172,1473,699,2.107296137,1193,120,1,1,1,0,1,0,0,0,empty,CD-0722-2
"A2,G7",5021,5575,3780,1795,3355,1708,0,1714,1124,590,1.905084746,964,2617,794,269,268,1,62,1,0.138059701,0,empty,CD-0722-2
"A2,G8",3871,4372,2909,1463,2593,1413,0,1413,947,466,2.032188841,787,2336,680,265,265,0,64,0,0.075471698,0,empty,CD-0722-2
"A2,G9",4306,4750,3208,1542,2926,1571,0,1571,989,582,1.699312715,873,2855,504,243,241,2,71,2,0.029045643,0,empty,CD-0722-2
"A2,G10",538675,591151,415527,175624,341844,166695,0,166875,131779,35096,3.754815364,91344,56957,5987,1757,1669,88,449,5,0.060515279,0,hg38,CD-0722-2
"A2,G11",5427,6071,4034,2037,3755,1979,0,1979,1348,631,2.136291601,1141,1865,391,143,136,7,48,2,0.102941176,0,empty,CD-0722-2
"A2,G12",4574,5375,3247,2128,3285,1909,0,1909,1228,681,1.803230543,1167,2951,543,230,225,5,76,1,0.048888889,0,empty,CD-0722-2
"A2,H1",5344,5779,3938,1841,3569,1859,0,1860,1168,692,1.687861272,1049,1574,381,146,145,1,40,1,0.075862069,0,empty,CD-0722-2
"A2,H2",5260,6088,3835,2253,3668,2024,0,2024,1327,697,1.903873745,1192,2978,897,355,351,4,79,2,0.065527066,0,empty,CD-0722-2
"A2,H3",4753,5573,3346,2227,3379,1968,0,1968,1297,671,1.932935917,1186,1994,395,156,154,2,49,1,0.032467532,0,empty,CD-0722-2
"A2,H4",6700,7354,4951,2403,4422,2409,0,2409,1586,823,1.92709599,1363,183,31,20,19,1,14,1,0,0,empty,CD-0722-2
"A2,H5",7486,8542,5538,3004,5000,2703,0,2708,1774,934,1.899357602,1542,4846,649,282,279,3,85,1,0.075268817,0,empty,CD-0722-2
"A2,H6",4632,5267,3339,1928,3108,1741,0,1741,1160,581,1.996557659,1000,2419,624,271,270,1,76,1,0.044444444,0,empty,CD-0722-2
"A2,H7",5400,6194,3962,2232,3779,2056,0,2056,1362,694,1.962536023,1184,2567,646,278,274,4,74,2,0.113138686,0,empty,CD-0722-2
"A2,H8",5994,6969,4310,2659,4149,2376,0,2377,1521,856,1.776869159,1402,2381,393,185,183,2,62,2,0.027322404,0,empty,CD-0722-2
"A2,H9",4416,4973,3295,1678,2951,1543,0,1543,1043,500,2.086,866,1529,353,124,122,2,42,1,0.032786885,0,empty,CD-0722-2
"A2,H10",4282,5002,3150,1852,3065,1688,0,1691,1082,609,1.776683087,1042,1887,420,160,157,3,46,1,0.089171975,0,empty,CD-0722-2
"A2,H11",6034,7259,4189,3070,4376,2904,0,2906,1534,1372,1.118075802,1726,80,10,9,9,0,6,0,0,0,empty,CD-0722-2
"A2,H12",4603,5123,3327,1796,3137,1752,0,1754,1169,585,1.998290598,1006,1376,185,90,90,0,39,0,0.1,0,empty,CD-0722-2
"A3,A1",4252,4970,3074,1896,2978,1719,0,1719,1105,614,1.799674267,998,1377,253,114,112,2,43,2,0.035714286,0,empty,CD-0722-2
"A3,A2",14908,16939,11229,5710,9820,5128,0,5132,3533,1599,2.209505941,2883,4955,1047,377,374,3,111,2,0.122994652,0,empty,CD-0722-2
"A3,A3",3804,4343,2786,1557,2616,1435,1,1441,963,478,2.014644351,827,1588,234,108,100,8,44,2,0.12,0,empty,CD-0722-2
"A3,A4",6738,7583,4965,2618,4563,2531,0,2534,1678,856,1.960280374,1421,754,217,91,88,3,31,1,0.113636364,0,empty,CD-0722-2
"A3,A5",5065,5673,3767,1906,3369,1796,0,1796,1214,582,2.085910653,976,2255,328,175,168,7,50,1,0,0,empty,CD-0722-2
"A3,A6",4970,6016,3684,2332,3592,2119,0,2127,1380,747,1.847389558,1249,3340,876,351,346,5,118,1,0.078034682,0,empty,CD-0722-2
"A3,A7",3917,4470,2898,1572,2786,1585,0,1587,1005,582,1.726804124,884,1851,302,113,112,1,47,1,0.125,0,empty,CD-0722-2
"A3,A8",2447,2756,1827,929,1733,963,0,963,627,336,1.866071429,542,2342,524,252,249,3,71,2,0.084337349,0,empty,CD-0722-2
"A3,A9",4359,4986,3247,1739,3004,1681,3,1686,1103,583,1.89193825,942,1461,358,165,163,2,58,2,0.122699387,0,empty,CD-0722-2
"A3,A10",5307,6163,4025,2138,3711,2028,0,2032,1281,751,1.705725699,1111,486,118,68,68,0,30,0,0.073529412,0,empty,CD-0722-2
"A3,A11",3760,4176,2841,1335,2483,1301,0,1301,883,418,2.112440191,697,1877,365,168,168,0,68,0,0.029761905,0,empty,CD-0722-2
"A3,A12",1128710,1321449,838704,482745,746851,420698,0,421062,337136,83926,4.01706265,245948,365411,50497,19967,19401,566,2627,10,0.072264316,0,hg38,CD-0722-2
"A3,B1",4314,5118,3083,2035,3004,1746,0,1746,1096,650,1.686153846,1049,1302,294,128,128,0,44,0,0.0546875,0,empty,CD-0722-2
"A3,B2",5231,6148,3473,2675,3692,2316,0,2319,1503,816,1.841911765,1419,646,127,56,55,1,23,1,0.072727273,0,empty,CD-0722-2
"A3,B3",605919,739448,439375,300073,427071,252717,1,252894,201694,51200,3.939335938,154195,202595,27634,10986,10784,202,1813,7,0.057399852,0,hg38,CD-0722-2
"A3,B4",419984,486670,312605,174065,284209,155690,0,155838,121878,33960,3.588869258,90686,37974,6861,2687,2631,56,500,3,0.023945268,0,hg38,CD-0722-2
"A3,B5",478064,262586,167030,95556,188727,97056,8,97727,74652,23075,3.235189599,60693,186055,17089,6716,6506,210,1185,4,0.068244697,0,hg38,CD-0722-2
"A3,B6",5082,5976,3558,2418,3667,2227,0,2227,1409,818,1.722493888,1345,1898,459,203,200,3,59,2,0.1,0,empty,CD-0722-2
"A3,B7",553213,648023,412277,235746,375429,209750,2,209940,165119,44821,3.683965106,122192,94988,15066,5704,5580,124,986,5,0.045878136,0,hg38,CD-0722-2
"A3,B8",3295,3669,2467,1202,2225,1195,0,1195,804,391,2.056265985,647,1719,284,138,136,2,50,2,0.198529412,0,empty,CD-0722-2
"A3,B9",575050,670384,428623,241761,385318,212449,1,212656,165880,46776,3.546263041,124517,55646,8730,3389,3320,69,721,3,0.06746988,0,hg38,CD-0722-2
"A3,B10",3102,3410,2226,1184,2081,1097,0,1103,720,383,1.879895561,616,385,83,42,42,0,21,0,0.047619048,0,empty,CD-0722-2
"A3,B11",531692,604693,402705,201988,344812,179574,2,179739,136750,42989,3.181046314,102623,17088,1410,605,580,25,151,3,0.022413793,0,hg38,CD-0722-2
"A3,B12",542129,645081,397379,247702,376156,214579,0,214744,167860,46884,3.580325911,128721,139672,18181,7013,6850,163,1201,7,0.06189781,0,hg38,CD-0722-2
"A3,C1",7652,8512,5686,2826,5105,2705,0,2705,1742,963,1.808930426,1514,1010,256,104,102,2,34,1,0,0,empty,CD-0722-2
"A3,C2",6717,7781,4788,2993,4760,2756,0,2756,1664,1092,1.523809524,1673,2015,492,225,224,1,68,1,0.089285714,0,empty,CD-0722-2
"A3,C3",7587,8575,5535,3040,5097,2752,0,2756,1779,977,1.820880246,1559,1026,183,97,96,1,32,1,0.010416667,0,empty,CD-0722-2
"A3,C4",4231,4661,3131,1530,2808,1475,0,1479,1000,479,2.087682672,834,1727,393,153,152,1,55,1,0.019736842,0,empty,CD-0722-2
"A3,C5",7845,8995,5891,3104,5393,2845,0,2846,1900,946,2.00845666,1628,2670,598,237,235,2,76,1,0.055319149,0,empty,CD-0722-2
"A3,C6",5240,5691,3822,1869,3472,1852,0,1852,1285,567,2.266313933,1011,1608,315,156,156,0,45,0,0.057692308,0,empty,CD-0722-2
"A3,C7",7147,8563,4959,3604,5070,3129,0,3134,1920,1214,1.5815486,1923,433,66,39,39,0,17,0,0.205128205,0,empty,CD-0722-2
"A3,C8",7677,8735,5524,3211,5337,3006,0,3008,1978,1030,1.92038835,1677,3871,790,325,322,3,125,2,0.01552795,0,empty,CD-0722-2
"A3,C9",501988,591089,374928,216161,342260,186943,1,187095,139832,47263,2.958593403,110954,40713,5452,2145,2090,55,431,3,0.064114833,0,hg38,CD-0722-2
"A3,C10",819914,943197,628501,314696,537381,285693,2,285963,229913,56050,4.101926851,162697,29156,3942,1554,1525,29,448,2,0.03147541,0,hg38,CD-0722-2
"A3,C11",5066,5737,3671,2066,3502,1887,0,1890,1233,657,1.876712329,1134,2084,565,218,214,4,67,1,0.102803738,0,empty,CD-0722-2
"A3,C12",7643,8518,5515,3003,5098,2766,0,2774,1859,915,2.031693989,1592,1859,482,206,204,2,76,1,0.053921569,0,empty,CD-0722-2
"A3,D1",6688,7707,4788,2919,4704,2759,0,2762,1730,1032,1.676356589,1613,735,215,85,85,0,35,0,0.070588235,0,empty,CD-0722-2
"A3,D2",646352,734997,499224,235773,422625,216989,0,217187,163927,53260,3.077863312,122054,61911,6666,2591,2525,66,664,5,0.053069307,0,hg38,CD-0722-2
"A3,D3",5038,5766,3627,2139,3459,2031,0,2035,1379,656,2.102134146,1211,1854,470,187,184,3,80,2,0.027173913,0,empty,CD-0722-2
"A3,D4",581407,671414,441920,229494,387124,204347,2,204528,155800,48728,3.197340338,117942,103103,14532,5519,5386,133,1047,5,0.053286298,0,hg38,CD-0722-2
"A3,D5",4296,4689,3146,1543,2997,1594,0,1594,1075,519,2.071290944,888,1627,244,102,96,6,53,2,0.0625,0,empty,CD-0722-2
"A3,D6",851275,962204,642452,319752,552324,289230,1,289487,231951,57536,4.031406424,165651,81651,15062,5737,5626,111,1017,8,0.030394597,0,hg38,CD-0722-2
"A3,D7",3673,4063,2658,1405,2533,1371,0,1371,908,463,1.96112311,805,3258,550,224,216,8,81,2,0.013888889,0,empty,CD-0722-2
"A3,D8",4920,5497,3551,1946,3342,1815,0,1815,1210,605,2,1034,1898,376,182,181,1,69,1,0.055248619,0,empty,CD-0722-2
"A3,D9",2340,2729,1681,1048,1685,930,0,932,601,331,1.81570997,563,1475,351,172,171,1,53,1,0.18128655,0,empty,CD-0722-2
"A3,D10",6370,7453,4511,2942,4408,2495,0,2496,1642,854,1.922716628,1483,945,164,94,90,4,42,1,0.066666667,0,empty,CD-0722-2
"A3,D11",5010,5627,3713,1914,3496,1853,0,1856,1206,650,1.855384615,1092,2687,681,331,328,3,91,2,0.021341463,0,empty,CD-0722-2
"A3,D12",6121,6969,4474,2495,4189,2291,0,2291,1463,828,1.766908213,1327,3199,831,325,314,11,116,2,0.035031847,0,empty,CD-0722-2
"A3,E1",7978,9190,5786,3404,5472,3098,0,3100,1962,1138,1.724077329,1826,2405,434,222,220,2,71,1,0.113636364,0,empty,CD-0722-2
"A3,E2",5225,5937,3837,2100,3512,1949,0,1952,1271,681,1.866372981,1097,1747,466,156,154,2,54,2,0.019480519,0,empty,CD-0722-2
"A3,E3",3690,4151,2794,1357,2433,1259,0,1259,777,482,1.612033195,685,2151,322,142,140,2,62,1,0.2,0,empty,CD-0722-2
"A3,E4",1148672,1357248,851201,506047,772433,435397,3,435756,351099,84657,4.147312095,258274,168558,24836,9836,9658,178,1747,8,0.038827915,0,hg38,CD-0722-2
"A3,E5",672203,816417,494414,322003,469958,276596,1,276794,216800,59994,3.613694703,166104,34320,12596,4822,4810,12,928,2,0.06964657,0,hg38,CD-0722-2
"A3,E6",8454,9784,6168,3616,5834,3264,0,3267,2100,1167,1.799485861,1915,3955,934,349,345,4,118,3,0.043478261,0,empty,CD-0722-2
"A3,E7",7331,8314,5410,2904,4904,2606,0,2610,1773,837,2.11827957,1454,3434,806,354,347,7,108,2,0.054755043,0,empty,CD-0722-2
"A3,E8",6035,6917,4627,2290,4109,2134,0,2134,1394,740,1.883783784,1175,2930,584,284,278,6,87,2,0.064748201,0,empty,CD-0722-2
"A3,E9",3909,4619,2873,1746,2771,1546,0,1546,1049,497,2.110663984,916,2500,534,246,244,2,95,2,0.118852459,0,empty,CD-0722-2
"A3,E10",4177,4809,3092,1717,2886,1576,0,1578,1023,555,1.843243243,896,1612,411,190,189,1,61,1,0.026455026,0,empty,CD-0722-2
"A3,E11",4917,5340,3672,1668,3342,1798,0,1801,1169,632,1.849683544,985,2076,680,240,240,0,62,0,0.129166667,0,empty,CD-0722-2
"A3,E12",5804,6913,4235,2678,4173,2376,0,2378,1565,813,1.92496925,1404,2078,485,204,204,0,72,0,0.06372549,0,empty,CD-0722-2
"A3,F1",489592,593380,347750,245630,345866,211040,0,211202,164331,46871,3.506027181,129610,20529,8587,3195,3180,15,732,2,0.017924528,0,hg38,CD-0722-2
"A3,F2",471083,547028,344589,202439,319197,179626,3,179775,139823,39952,3.49977473,106420,78056,13520,5196,5091,105,987,5,0.028285209,0,hg38,CD-0722-2
"A3,F3",4790,5218,3460,1758,3175,1661,0,1666,1113,553,2.012658228,943,2921,689,278,278,0,81,0,0.057553957,0,empty,CD-0722-2
"A3,F4",7596,8492,5616,2876,5098,2628,0,2630,1749,881,1.985244041,1497,1186,317,142,141,1,56,1,0,0,empty,CD-0722-2
"A3,F5",502847,570878,375125,195753,328102,172402,3,172559,146415,26144,5.600328947,98986,115990,16351,6312,6173,139,1242,7,0.034019116,0,hg38,CD-0722-2
"A3,F6",5876,6756,4329,2427,3935,2220,0,2227,1409,818,1.722493888,1243,2881,650,273,264,9,78,2,0.041666667,0,empty,CD-0722-2
"A3,F7",6478,7303,4741,2562,4396,2368,0,2368,1552,816,1.901960784,1335,1269,275,121,119,2,39,1,0.008403361,0,empty,CD-0722-2
"A3,F8",4892,5562,3574,1988,3384,1826,0,1828,1189,639,1.860719875,1035,512,91,56,55,1,27,1,0.018181818,0,empty,CD-0722-2
"A3,F9",5341,6047,4010,2037,3698,1931,0,1931,1291,640,2.0171875,1078,2549,620,256,251,5,98,1,0.027888446,0,empty,CD-0722-2
"A3,F10",6562,7469,4858,2611,4429,2390,0,2390,1556,834,1.865707434,1347,1804,386,148,147,1,57,1,0.074829932,0,empty,CD-0722-2
"A3,F11",5647,6262,4181,2081,3650,1887,0,1887,1301,586,2.220136519,1026,1639,319,125,114,11,34,3,0.201754386,0,empty,CD-0722-2
"A3,F12",5915,6711,4260,2451,4019,2189,0,2195,1390,805,1.726708075,1297,424,85,43,43,0,24,0,0.069767442,0,empty,CD-0722-2
"A3,G1",5861,6489,4352,2137,3968,2128,0,2131,1426,705,2.022695035,1207,2563,576,243,240,3,90,2,0.045833333,0,empty,CD-0722-2
"A3,G2",1003619,1160943,720643,440300,672527,386385,4,386738,313776,72962,4.300540007,230745,78151,10462,3980,3901,79,808,4,0.056908485,0,hg38,CD-0722-2
"A3,G3",690895,856059,493679,362380,491406,301220,5,301514,230144,71370,3.224660221,186245,62659,14353,5435,5374,61,1119,4,0.030703387,0,hg38,CD-0722-2
"A3,G4",12506,14585,8730,5855,8840,5411,0,5423,3291,2132,1.543621013,3164,192,40,28,27,1,18,1,0,0,empty,CD-0722-2
"A3,G5",4130,4672,3009,1663,2822,1587,0,1587,1037,550,1.885454545,901,2091,552,248,246,2,77,2,0.203252033,0,empty,CD-0722-2
"A3,G6",5987,6941,4450,2491,4152,2323,0,2325,1544,781,1.976952625,1352,330,103,43,42,1,11,1,0.023809524,0,empty,CD-0722-2
"A3,G7",4655,5320,3432,1888,3228,1735,0,1739,1128,611,1.846153846,1033,2638,600,255,252,3,60,2,0.103174603,0,empty,CD-0722-2
"A3,G8",536464,630789,397030,233759,363798,203125,0,203253,159619,43634,3.658133566,120788,138535,19747,7794,7640,154,1315,6,0.062303665,0,hg38,CD-0722-2
"A3,G9",4256,4808,3135,1673,2931,1580,0,1588,1037,551,1.882032668,911,2660,431,183,177,6,71,3,0.033898305,0,empty,CD-0722-2
"A3,G10",5262,6165,3850,2315,3727,2108,2,2114,1359,755,1.8,1250,2554,707,311,308,3,94,2,0.035714286,0,empty,CD-0722-2
"A3,G11",5135,5787,3756,2031,3459,1830,0,1833,1209,624,1.9375,1055,1797,434,212,208,4,65,2,0.048076923,0,empty,CD-0722-2
"A3,G12",588574,730269,417731,312538,431597,264302,3,264506,214985,49521,4.341289554,164337,186407,41862,16298,16120,178,2257,7,0.051364764,0,hg38,CD-0722-2
"A3,H1",461063,529625,346580,183045,307930,159946,2,160094,121309,38785,3.127729792,93306,64698,8337,3233,3148,85,656,4,0.044155019,0,hg38,CD-0722-2
"A3,H2",5142,6010,3781,2229,3625,2028,0,2030,1272,758,1.678100264,1196,2666,642,283,280,3,77,1,0.1,0,empty,CD-0722-2
"A3,H3",917046,1074403,686572,387831,614486,343571,5,343866,280461,63405,4.423326236,202301,87043,11689,4478,4377,101,968,5,0.02878684,0,hg38,CD-0722-2
"A3,H4",6551,7395,4854,2541,4350,2347,0,2350,1582,768,2.059895833,1311,252,20,13,12,1,12,1,0.083333333,0,empty,CD-0722-2
"A3,H5",6931,7868,5063,2805,4696,2586,0,2587,1733,854,2.029274005,1508,2433,676,278,277,1,99,1,0.176895307,0,empty,CD-0722-2
"A3,H6",4213,4795,3063,1732,2910,1623,0,1623,1062,561,1.893048128,910,2477,424,191,187,4,84,2,0.14973262,0,empty,CD-0722-2
"A3,H7",4969,5490,3676,1814,3362,1810,0,1810,1266,544,2.327205882,1042,2622,421,200,197,3,94,2,0.040609137,0,empty,CD-0722-2
"A3,H8",5640,6428,4033,2395,3853,2164,0,2165,1398,767,1.822685789,1298,2348,436,197,196,1,65,1,0.040816327,0,empty,CD-0722-2
"A3,H9",4194,4946,3084,1862,2858,1527,0,1527,1004,523,1.919694073,909,1097,218,97,94,3,40,2,0.074468085,0,empty,CD-0722-2
"A3,H10",4302,4930,3165,1765,3035,1656,0,1658,1134,524,2.164122137,995,1684,277,143,142,1,56,1,0.154929577,0,empty,CD-0722-2
"A3,H11",5808,6896,3973,2923,4160,2731,0,2736,1492,1244,1.199356913,1643,121,45,6,6,0,6,0,0,0,empty,CD-0722-2
"A3,H12",4436,4947,3184,1763,3006,1733,0,1736,1197,539,2.220779221,997,1432,365,169,169,0,65,0,0.017751479,0,empty,CD-0722-2
"A4,A1",3541,4266,2436,1830,2533,1446,0,1446,917,529,1.733459357,919,1320,212,109,108,1,35,1,0.027777778,0,empty,CD-0722-2
"A4,A2",5033,5688,3709,1979,3428,1888,0,1891,1203,688,1.748546512,1052,1772,488,187,185,2,50,1,0.032432432,0,empty,CD-0722-2
"A4,A3",3342,3659,2413,1246,2174,1187,0,1187,790,397,1.989924433,662,1401,395,132,129,3,31,2,0.271317829,0,empty,CD-0722-2
"A4,A4",1147960,1409425,798084,611341,802879,541155,4,541574,428884,112690,3.805874523,324729,15183,612,277,254,23,91,3,0.027559055,0,hg38,CD-0722-2
"A4,A5",4896,5642,3594,2048,3321,1803,0,1803,1115,688,1.620639535,1072,2949,1034,343,342,1,73,1,0.029239766,0,empty,CD-0722-2
"A4,A6",4110,4718,3010,1708,2791,1557,0,1557,982,575,1.707826087,882,3210,704,264,264,0,81,0,0.09469697,0,empty,CD-0722-2
"A4,A7",3695,4351,2710,1641,2561,1489,0,1496,908,588,1.544217687,858,1480,346,112,112,0,38,0,0.017857143,0,empty,CD-0722-2
"A4,A8",2048,2340,1520,820,1412,751,0,751,512,239,2.142259414,436,2069,598,198,195,3,38,2,0.015384615,0,empty,CD-0722-2
"A4,A9",3616,4253,2693,1560,2468,1340,0,1341,847,494,1.714574899,781,1700,330,181,180,1,54,1,0.011111111,0,empty,CD-0722-2
"A4,A10",4419,4891,3351,1540,2889,1551,0,1551,988,563,1.754884547,841,533,69,34,33,1,10,1,0.151515152,0,empty,CD-0722-2
"A4,A11",3163,3612,2338,1274,2187,1159,0,1159,729,430,1.695348837,683,1878,474,199,199,0,46,0,0.090452261,0,empty,CD-0722-2
"A4,A12",4517,5040,3385,1655,3001,1596,0,1596,1027,569,1.804920914,910,3250,900,330,328,2,70,1,0.091463415,0,empty,CD-0722-2
"A4,B1",570995,699170,414166,285004,398664,238820,2,238995,189595,49400,3.837955466,145443,19770,4585,1547,1526,21,389,4,0.081258191,0,hg38,CD-0722-2
"A4,B2",4303,4887,2948,1939,2912,1733,0,1735,1147,588,1.950680272,994,575,79,32,31,1,18,1,0.290322581,0,empty,CD-0722-2
"A4,B3",3500,3944,2548,1396,2343,1280,0,1282,857,425,2.016470588,754,1343,330,133,126,7,39,2,0.023809524,0,empty,CD-0722-2
"A4,B4",481309,566120,357144,208976,325629,181709,1,181843,138302,43541,3.176362509,107157,89183,11938,4690,4576,114,834,6,0.055506993,0,hg38,CD-0722-2
"A4,B5",4064,2448,1492,956,1735,1004,0,1012,671,341,1.967741935,626,1137,348,125,125,0,28,0,0.008,0,empty,CD-0722-2
"A4,B6",4179,4966,2870,2096,2922,1743,0,1743,1040,703,1.479374111,1066,1602,481,183,180,3,45,2,0.1,0,empty,CD-0722-2
"A4,B7",3876,4330,2859,1471,2573,1337,0,1339,860,479,1.795407098,750,1142,404,146,141,5,32,2,0.042553191,0,empty,CD-0722-2
"A4,B8",2671,2959,2038,921,1791,928,0,929,610,319,1.912225705,513,1382,250,114,113,1,29,1,0.283185841,0,empty,CD-0722-2
"A4,B9",5383,6164,3882,2282,3690,2055,0,2055,1259,796,1.581658291,1208,1026,263,103,96,7,31,1,0.145833333,0,empty,CD-0722-2
"A4,B10",2687,2909,1942,967,1783,987,0,991,632,359,1.760445682,545,452,157,62,61,1,15,1,0,0,empty,CD-0722-2
"A4,B11",6955,8412,4920,3492,4809,2960,0,2961,1631,1330,1.226315789,1774,217,17,15,15,0,9,0,0,0,empty,CD-0722-2
"A4,B12",3493,3984,2540,1444,2430,1360,0,1362,850,512,1.66015625,793,1611,388,164,162,2,43,1,0.024691358,0,empty,CD-0722-2
"A4,C1",7155,7788,5413,2375,4553,2314,1,2318,1446,872,1.658256881,1276,1164,290,101,101,0,21,0,0.148514851,0,empty,CD-0722-2
"A4,C2",5672,6295,4055,2240,3766,2093,0,2095,1338,757,1.767503303,1210,1845,550,200,200,0,58,0,0.02,0,empty,CD-0722-2
"A4,C3",5867,6739,4312,2427,4076,2217,0,2218,1439,779,1.847240051,1294,864,172,97,97,0,27,0,0.216494845,0,empty,CD-0722-2
"A4,C4",3411,3737,2526,1211,2243,1150,0,1150,781,369,2.116531165,649,1990,267,92,91,1,43,1,0.054945055,0,empty,CD-0722-2
"A4,C5",6593,7641,4784,2857,4453,2533,0,2538,1744,794,2.196473552,1488,1825,361,139,135,4,46,1,0.022222222,0,empty,CD-0722-2
"A4,C6",4430,5010,3203,1807,3023,1721,0,1722,1084,638,1.699059561,984,1522,358,151,151,0,41,0,0.225165563,0,empty,CD-0722-2
"A4,C7",6294,7554,4410,3144,4419,2710,0,2711,1658,1053,1.574548908,1657,215,40,25,25,0,11,0,0,0,empty,CD-0722-2
"A4,C8",6761,7703,4891,2812,4477,2511,0,2511,1682,829,2.028950543,1443,3064,643,235,233,2,73,1,0.137339056,0,empty,CD-0722-2
"A4,C9",15656,18364,11885,6479,10380,5345,0,5348,3652,1696,2.153301887,3130,4359,825,289,283,6,69,1,0.102473498,0,empty,CD-0722-2
"A4,C10",5477,6257,3965,2292,3648,1993,1,1997,1275,722,1.765927978,1137,1901,411,191,190,1,51,1,0.068421053,0,empty,CD-0722-2
"A4,C11",4588,5171,3403,1768,3089,1667,0,1669,1023,646,1.583591331,955,1590,494,195,193,2,51,2,0.113989637,0,empty,CD-0722-2
"A4,C12",6014,6787,4470,2317,4129,2205,1,2210,1441,769,1.873862159,1242,1523,482,216,215,1,55,1,0.037209302,0,empty,CD-0722-2
"A4,D1",592385,725369,426956,298413,415843,247550,2,247731,199888,47843,4.177998871,151952,69278,11221,4227,4140,87,832,3,0.063285024,0,hg38,CD-0722-2
"A4,D2",4730,5237,3535,1702,3120,1570,0,1570,1060,510,2.078431373,863,2773,562,212,211,1,70,1,0.033175355,0,empty,CD-0722-2
"A4,D3",4220,4855,2968,1887,2836,1574,0,1574,976,598,1.632107023,941,1255,325,125,124,1,38,1,0.088709677,0,empty,CD-0722-2
"A4,D4",3223,3828,2357,1471,2210,1215,0,1215,745,470,1.585106383,736,1476,359,138,138,0,39,0,0.036231884,0,empty,CD-0722-2
"A4,D5",3666,4180,2637,1543,2556,1396,0,1401,873,528,1.653409091,849,1643,518,195,190,5,53,1,0,0,empty,CD-0722-2
"A4,D6",571294,684865,413202,271663,391865,229454,1,229655,181951,47704,3.814166527,139123,201473,36500,14014,13786,228,1974,8,0.055055854,0,hg38,CD-0722-2
"A4,D7",356164,442180,242483,199697,256168,174642,1,174757,120220,54537,2.204375011,107241,4873,706,262,250,12,83,2,0.12,0,hg38,CD-0722-2
"A4,D8",4281,4823,3075,1748,2853,1567,0,1574,1006,568,1.771126761,884,1382,288,116,112,4,35,1,0.0625,0,empty,CD-0722-2
"A4,D9",2032,2303,1475,828,1362,720,0,721,486,235,2.068085106,427,1821,583,228,228,0,42,0,0,0,empty,CD-0722-2
"A4,D10",4558,5401,3195,2206,3197,1839,0,1843,1248,595,2.097478992,1132,886,216,65,65,0,21,0,0,0,empty,CD-0722-2
"A4,D11",356253,444299,243073,201226,256967,174755,1,174860,126650,48210,2.62704833,107387,8449,1520,559,543,16,168,2,0.038674033,0,hg38,CD-0722-2
"A4,D12",5386,6315,3915,2400,3710,2062,0,2064,1392,672,2.071428571,1219,3105,794,317,309,8,89,2,0.038834951,0,empty,CD-0722-2
"A4,E1",948120,1094558,682516,412042,621880,367878,1,368182,283257,84925,3.335378275,214919,49320,11674,3906,3848,58,753,3,0.01975052,0,hg38,CD-0722-2
"A4,E2",4805,5505,3439,2066,3338,1855,0,1856,1206,650,1.855384615,1109,2070,349,141,141,0,54,0,0.007092199,0,empty,CD-0722-2
"A4,E3",3236,3538,2395,1143,2196,1200,0,1201,789,412,1.915048544,670,2294,596,185,184,1,62,1,0.032608696,0,empty,CD-0722-2
"A4,E4",503279,604180,369196,234984,345921,197321,0,197482,156125,41357,3.775056218,119603,91704,15146,5714,5623,91,1108,6,0.058865374,0,hg38,CD-0722-2
"A4,E5",5529,6307,4114,2193,3681,2031,0,2031,1290,741,1.740890688,1118,1591,253,116,111,5,36,2,0.027027027,0,empty,CD-0722-2
"A4,E6",7458,8427,5512,2915,5027,2748,0,2748,1708,1040,1.642307692,1591,3375,748,325,322,3,88,1,0.052795031,0,empty,CD-0722-2
"A4,E7",6251,7126,4637,2489,4241,2221,0,2223,1484,739,2.00811908,1279,3105,594,255,253,2,91,2,0.079051383,0,empty,CD-0722-2
"A4,E8",5482,6166,4122,2044,3655,1927,0,1931,1307,624,2.094551282,1063,2955,604,241,238,3,62,2,0.025210084,0,empty,CD-0722-2
"A4,E9",3237,3666,2363,1303,2180,1178,0,1179,784,395,1.984810127,680,2961,700,274,263,11,64,2,0.064638783,0,empty,CD-0722-2
"A4,E10",3778,4211,2815,1396,2495,1264,0,1273,795,478,1.663179916,706,1878,402,190,188,2,53,2,0.021276596,0,empty,CD-0722-2
"A4,E11",4642,5317,3390,1927,3207,1790,0,1792,1202,590,2.037288136,1048,1766,392,146,144,2,45,2,0.104166667,0,empty,CD-0722-2
"A4,E12",4856,5524,3509,2015,3250,1739,0,1741,1078,663,1.625942685,1006,1671,410,150,142,8,49,2,0.042253521,0,empty,CD-0722-2
"A4,F1",5785,6331,4248,2083,3769,2059,0,2059,1294,765,1.691503268,1118,2219,560,217,216,1,57,1,0.037037037,0,empty,CD-0722-2
"A4,F2",4904,5408,3511,1897,3234,1748,0,1748,1120,628,1.78343949,1015,2987,634,239,238,1,61,1,0.058823529,0,empty,CD-0722-2
"A4,F3",4308,4886,3120,1766,2950,1627,0,1627,1001,626,1.599041534,972,2946,741,300,295,5,73,2,0.108474576,0,empty,CD-0722-2
"A4,F4",782876,918814,576849,341965,525465,295691,3,295968,234597,61371,3.82260351,173972,78477,12050,4542,4469,73,849,4,0.078317297,0,hg38,CD-0722-2
"A4,F5",5439,6330,3989,2341,3608,1930,0,1937,1238,699,1.771101574,1145,1786,420,149,148,1,44,1,0.067567568,0,empty,CD-0722-2
"A4,F6",4939,5677,3548,2129,3254,1843,0,1847,1224,623,1.964686998,1062,3064,802,322,318,4,76,2,0.106918239,0,empty,CD-0722-2
"A4,F7",6153,6890,4437,2453,3959,2181,0,2183,1418,765,1.853594771,1230,786,165,57,56,1,24,1,0.160714286,0,empty,CD-0722-2
"A4,F8",4082,4841,3001,1840,2867,1594,0,1598,1005,593,1.694772344,933,171,5,5,5,0,4,0,0,0,empty,CD-0722-2
"A4,F9",4540,5043,3343,1700,3139,1703,0,1703,1135,568,1.998239437,946,2439,590,218,213,5,61,2,0.061032864,0,empty,CD-0722-2
"A4,F10",6093,6981,4469,2512,4157,2252,0,2255,1502,753,1.994687915,1308,1609,378,142,141,1,51,1,0.021276596,0,empty,CD-0722-2
"A4,F11",4640,5186,3486,1700,2981,1533,0,1533,1037,496,2.090725806,836,1182,166,68,67,1,21,1,0,0,empty,CD-0722-2
"A4,F12",5223,5852,3874,1978,3439,1823,0,1825,1174,651,1.803379416,1059,314,42,23,21,2,6,2,0.095238095,0,empty,CD-0722-2
"A4,G1",5325,6068,3979,2089,3628,1892,0,1897,1220,677,1.802067947,1094,2823,765,279,277,2,76,2,0.086642599,0,empty,CD-0722-2
"A4,G2",3441,4085,2404,1681,2381,1380,0,1380,863,517,1.669245648,804,548,77,49,47,2,25,1,0,0,empty,CD-0722-2
"A4,G3",6395,7006,4684,2322,4162,2288,0,2294,1375,919,1.496191513,1263,2277,608,255,253,2,62,2,0.114624506,0,empty,CD-0722-2
"A4,G4",11506,13298,8039,5259,8042,4905,0,4909,2924,1985,1.473047859,2920,69,6,5,5,0,4,0,0.2,0,empty,CD-0722-2
"A4,G5",3659,4194,2651,1543,2468,1365,0,1365,847,518,1.635135135,797,2171,606,247,241,6,57,2,0.149377593,0,empty,CD-0722-2
"A4,G6",5553,6209,4095,2114,3679,2034,0,2034,1341,693,1.935064935,1096,92,36,24,24,0,7,0,0,0,empty,CD-0722-2
"A4,G7",4396,4834,3316,1518,2842,1419,0,1421,936,485,1.929896907,736,13690,2398,864,846,18,221,3,0.073286052,0,empty,CD-0722-2
"A4,G8",2944,3505,2181,1324,2108,1155,0,1165,750,415,1.807228916,707,1655,312,144,140,4,48,2,0.042857143,0,empty,CD-0722-2
"A4,G9",3744,4350,2773,1577,2625,1471,0,1471,964,507,1.901380671,862,1901,353,151,145,6,52,2,0.186206897,0,empty,CD-0722-2
"A4,G10",727413,889293,523091,366202,513925,331054,2,331287,244223,87064,2.8050974,198396,33790,1759,681,613,68,181,3,0.251223491,0,hg38,CD-0722-2
"A4,G11",4575,5252,3484,1768,3036,1610,0,1611,1078,533,2.022514071,900,1459,351,142,142,0,37,0,0.007042254,0,empty,CD-0722-2
"A4,G12",3947,4643,2878,1765,2755,1598,0,1598,1020,578,1.764705882,950,2676,517,185,183,2,61,1,0.087431694,0,empty,CD-0722-2
"A4,H1",3988,4399,2945,1454,2571,1359,0,1359,910,449,2.026726058,731,1270,300,116,116,0,43,0,0.129310345,0,empty,CD-0722-2
"A4,H2",4621,5253,3302,1951,3105,1678,0,1678,1070,608,1.759868421,1007,2064,464,171,168,3,53,2,0.035714286,0,empty,CD-0722-2
"A4,H3",3674,4050,2734,1316,2467,1313,0,1313,838,475,1.764210526,733,1587,410,167,160,7,43,2,0.20625,0,empty,CD-0722-2
"A4,H4",5707,6453,4264,2189,3770,2049,0,2049,1292,757,1.70673712,1174,120,7,6,6,0,5,0,0.166666667,0,empty,CD-0722-2
"A4,H5",6266,6885,4570,2315,4008,2201,0,2201,1393,808,1.724009901,1223,2270,750,290,290,0,76,0,0.027586207,0,empty,CD-0722-2
"A4,H6",3570,4237,2580,1657,2429,1384,0,1384,941,443,2.124153499,796,1892,572,195,193,2,59,1,0.025906736,0,empty,CD-0722-2
"A4,H7",4185,4675,3081,1594,2839,1511,0,1511,1013,498,2.034136546,880,2101,403,153,152,1,55,1,0.046052632,0,empty,CD-0722-2
"A4,H8",4663,5414,3357,2057,3150,1760,0,1762,1135,627,1.810207337,1026,2166,550,184,182,2,62,1,0.021978022,0,empty,CD-0722-2
"A4,H9",3932,4418,2955,1463,2635,1398,0,1400,955,445,2.146067416,805,1108,234,103,100,3,31,2,0.13,0,empty,CD-0722-2
"A4,H10",3351,3788,2450,1338,2228,1160,1,1165,742,423,1.754137116,655,1464,226,108,103,5,46,2,0.067961165,0,empty,CD-0722-2
"A4,H11",4686,5398,3229,2169,3238,2134,0,2135,1177,958,1.228601253,1258,35,7,5,5,0,4,0,0.4,0,empty,CD-0722-2
"A4,H12",3649,4131,2557,1574,2326,1329,0,1331,871,460,1.893478261,762,1915,483,145,142,3,46,2,0.169014085,0,empty,CD-0722-2
"A5,A1",3940,4829,2781,2048,2863,1693,0,1693,1065,628,1.695859873,1059,1287,173,57,56,1,29,1,0.017857143,0,empty,CD-0722-2
"A5,A2",6009,7063,4283,2780,4312,2501,0,2503,1529,974,1.569815195,1533,1720,389,121,116,5,43,1,0.077586207,0,empty,CD-0722-2
"A5,A3",3576,3929,2617,1312,2428,1318,0,1322,878,444,1.977477477,734,1190,270,103,103,0,41,0,0.048543689,0,empty,CD-0722-2
"A5,A4",6042,6830,4525,2305,4105,2228,0,2233,1376,857,1.605600933,1260,776,189,76,76,0,30,0,0.105263158,0,empty,CD-0722-2
"A5,A5",5287,5698,3825,1873,3473,1874,0,1877,1246,631,1.974643423,1048,1968,531,201,195,6,45,1,0.087179487,0,empty,CD-0722-2
"A5,A6",9126,10435,6712,3723,6323,3556,0,3557,2543,1014,2.507889546,2019,3109,859,351,338,13,89,2,0.153846154,0,empty,CD-0722-2
"A5,A7",3975,4699,2935,1764,2731,1598,0,1599,1045,554,1.886281588,931,1139,285,138,136,2,37,2,0.051470588,0,empty,CD-0722-2
"A5,A8",2239,2560,1609,951,1579,870,0,870,604,266,2.270676692,507,1954,565,193,188,5,61,3,0,0,empty,CD-0722-2
"A5,A9",4252,4854,3183,1671,2914,1550,0,1557,1040,517,2.011605416,868,1517,292,107,107,0,36,0,0.037383178,0,empty,CD-0722-2
"A5,A10",7335,7986,5578,2408,4823,2553,0,2553,1619,934,1.733404711,1326,470,181,58,58,0,19,0,0.051724138,0,empty,CD-0722-2
"A5,A11",3731,4241,2753,1488,2545,1337,0,1337,856,481,1.77962578,775,1830,442,209,206,3,53,2,0.09223301,0,empty,CD-0722-2
"A5,A12",5473,6150,4117,2033,3643,1973,0,1973,1310,663,1.97586727,1124,3014,810,296,290,6,77,2,0.075862069,0,empty,CD-0722-2
"A5,B1",4247,4871,3028,1843,2924,1643,0,1643,1057,586,1.803754266,964,1399,239,96,93,3,32,1,0.010752688,0,empty,CD-0722-2
"A5,B2",522196,597735,360221,237514,353086,202422,0,202561,154666,47895,3.229272367,123792,51824,5367,2110,2023,87,418,3,0.081067721,0,hg38,CD-0722-2
"A5,B3",387215,487739,265024,222715,288383,198310,1,198410,141120,57290,2.463257113,122148,5697,656,264,254,10,88,2,0.07480315,0,hg38,CD-0722-2
"A5,B4",4470,5186,3172,2014,3227,1894,0,1900,1117,783,1.426564496,1111,1343,228,87,85,2,37,1,0.082352941,0,empty,CD-0722-2
"A5,B5",4426,2609,1593,1016,1871,1034,0,1044,640,404,1.584158416,676,904,190,89,88,1,32,1,0.034090909,0,empty,CD-0722-2
"A5,B6",4968,5889,3538,2351,3539,2115,0,2116,1288,828,1.555555556,1283,1685,425,203,199,4,57,2,0.095477387,0,empty,CD-0722-2
"A5,B7",4367,4922,3277,1645,2943,1590,0,1590,1021,569,1.794376098,863,1059,177,94,92,2,29,1,0.010869565,0,empty,CD-0722-2
"A5,B8",1234205,1438633,913717,524916,825640,464699,2,465065,372773,92292,4.039060807,271470,172264,31819,12458,12244,214,1953,4,0.07963084,0,hg38,CD-0722-2
"A5,B9",6748,7877,4902,2975,4726,2697,0,2697,1740,957,1.818181818,1599,1121,417,165,163,2,44,2,0.012269939,0,empty,CD-0722-2
"A5,B10",3103,3454,2268,1186,2071,1085,0,1088,698,390,1.78974359,631,430,105,54,54,0,17,0,0,0,empty,CD-0722-2
"A5,B11",7415,8659,5359,3300,5205,3163,0,3166,1735,1431,1.212438854,1877,283,71,19,19,0,13,0,0.052631579,0,empty,CD-0722-2
"A5,B12",4038,4551,2947,1604,2733,1513,0,1514,998,516,1.934108527,837,1524,378,179,179,0,53,0,0.05027933,0,empty,CD-0722-2
"A5,C1",7249,7991,5352,2639,4866,2578,0,2586,1564,1022,1.530332681,1447,1156,300,143,142,1,41,1,0.021126761,0,empty,CD-0722-2
"A5,C2",6238,7209,4417,2792,4330,2506,0,2511,1563,948,1.648734177,1508,1778,435,177,173,4,58,2,0.040462428,0,empty,CD-0722-2
"A5,C3",6601,7484,4896,2588,4517,2451,0,2454,1583,871,1.817451206,1376,965,121,71,63,8,25,2,0,0,empty,CD-0722-2
"A5,C4",977835,1136149,727742,408407,658257,368679,0,368919,261292,107627,2.427755117,215593,42771,6109,2299,2252,47,578,4,0.019538188,0,hg38,CD-0722-2
"A5,C5",7370,8217,5403,2814,5097,2775,0,2778,1897,881,2.15323496,1569,1463,363,172,171,1,49,1,0.210526316,0,empty,CD-0722-2
"A5,C6",5013,5823,3579,2244,3494,1975,0,1975,1316,659,1.996965099,1126,1684,349,139,133,6,43,2,0.015037594,0,empty,CD-0722-2
"A5,C7",469005,601534,317214,284320,356785,238716,0,238857,182361,56496,3.227856839,153441,3688,1885,766,765,1,210,1,0.011764706,0,hg38,CD-0722-2
"A5,C8",7680,8661,5660,3001,5281,2888,0,2892,1914,978,1.957055215,1690,3277,923,401,396,5,102,2,0.123737374,0,empty,CD-0722-2
"A5,C9",5294,6157,3880,2277,3731,2065,0,2067,1342,725,1.851034483,1213,1501,375,128,126,2,34,2,0.119047619,0,empty,CD-0722-2
"A5,C10",5956,6680,4418,2262,4021,2177,0,2177,1417,760,1.864473684,1210,1709,436,223,221,2,58,1,0.122171946,0,empty,CD-0722-2
"A5,C11",583538,704919,421236,283683,410412,242702,1,242899,189420,53479,3.541951046,148074,88185,10238,3971,3883,88,895,5,0.049188772,0,hg38,CD-0722-2
"A5,C12",7096,8250,5132,3118,4839,2577,0,2579,1691,888,1.904279279,1495,1592,307,128,128,0,43,0,0.09375,0,empty,CD-0722-2
"A5,D1",6614,7654,4770,2884,4570,2623,0,2631,1609,1022,1.574363992,1550,770,179,64,64,0,27,0,0.015625,0,empty,CD-0722-2
"A5,D2",5204,5749,3785,1964,3521,1860,1,1863,1172,691,1.696092619,1075,2808,528,199,198,1,65,1,0.075757576,0,empty,CD-0722-2
"A5,D3",547922,665846,394607,271239,388816,231054,1,231235,180480,50755,3.555905822,141104,127883,20260,7975,7833,142,1315,3,0.091918805,0,hg38,CD-0722-2
"A5,D4",3800,4308,2848,1460,2613,1453,0,1454,961,493,1.949290061,774,1154,203,87,86,1,31,1,0.081395349,0,empty,CD-0722-2
"A5,D5",4336,4890,3179,1711,2988,1581,0,1582,1049,533,1.968105066,915,1986,460,205,198,7,51,2,0.101010101,0,empty,CD-0722-2
"A5,D6",566329,648657,423693,224964,373635,198204,1,198377,145337,53040,2.740139517,115924,140991,16353,6660,6521,139,1159,5,0.067934366,0,hg38,CD-0722-2
"A5,D7",3712,4026,2756,1270,2406,1265,0,1270,847,423,2.002364066,690,2055,576,245,242,3,64,1,0.033057851,0,empty,CD-0722-2
"A5,D8",4577,5227,3331,1896,3155,1723,0,1725,1132,593,1.908937605,1015,1221,325,149,149,0,56,0,0.10738255,0,empty,CD-0722-2
"A5,D9",2323,2824,1704,1120,1689,919,0,919,612,307,1.993485342,552,1864,573,224,222,2,41,2,0.166666667,0,empty,CD-0722-2
"A5,D10",4851,5733,3434,2299,3462,2006,0,2006,1244,762,1.632545932,1202,958,230,105,103,2,33,1,0.058252427,0,empty,CD-0722-2
"A5,D11",4932,5335,3634,1701,3215,1696,0,1699,1090,609,1.789819376,913,4281,1000,345,340,5,106,3,0.091176471,0,empty,CD-0722-2
"A5,D12",6008,6767,4475,2292,4141,2223,0,2225,1452,773,1.87839586,1293,2920,776,284,281,3,96,1,0.099644128,0,empty,CD-0722-2
"A5,E1",7975,8943,5789,3154,5326,2941,0,2941,1761,1180,1.492372881,1671,2768,612,199,193,6,64,2,0.124352332,0,empty,CD-0722-2
"A5,E2",5234,6032,3712,2320,3609,2014,0,2015,1289,726,1.775482094,1189,1812,387,153,151,2,45,1,0.046357616,0,empty,CD-0722-2
"A5,E3",195093,255152,131354,123798,158124,110644,0,110698,63827,46871,1.36175887,71734,3187,715,290,289,1,80,1,0.131487889,0,hg38,CD-0722-2
"A5,E4",4814,5470,3510,1960,3257,1748,0,1749,1119,630,1.776190476,1037,2500,418,187,180,7,65,2,0.022222222,0,empty,CD-0722-2
"A5,E5",4421,4948,3298,1650,3054,1606,0,1608,1080,528,2.045454545,915,1241,211,111,111,0,43,0,0,0,empty,CD-0722-2
"A5,E6",527666,657177,364372,292805,381381,257812,0,257968,153763,104205,1.475581786,157654,4036,1303,446,442,4,113,2,0.126696833,0,hg38,CD-0722-2
"A5,E7",7051,7998,5261,2737,4777,2548,0,2554,1590,964,1.649377593,1432,2549,524,219,214,5,74,2,0.03271028,0,empty,CD-0722-2
"A5,E8",5521,6104,4101,2003,3709,1904,0,1906,1206,700,1.722857143,1063,2563,566,229,224,5,63,2,0.129464286,0,empty,CD-0722-2
"A5,E9",3915,4513,2848,1665,2710,1514,0,1514,1000,514,1.945525292,905,2766,820,355,354,1,108,1,0.050847458,0,empty,CD-0722-2
"A5,E10",596210,706876,440029,266847,409752,231061,2,231260,182811,48449,3.773266734,137252,130029,26363,10475,10344,131,1569,6,0.095224285,0,hg38,CD-0722-2
"A5,E11",4926,5665,3613,2052,3364,1846,0,1847,1189,658,1.806990881,1036,2022,588,214,210,4,66,2,0.076190476,0,empty,CD-0722-2
"A5,E12",5991,6946,4385,2561,4191,2377,0,2379,1584,795,1.99245283,1413,2216,538,222,220,2,73,2,0.05,0,empty,CD-0722-2
"A5,F1",503121,575188,371863,203325,335639,183050,1,183234,145401,37833,3.843232099,105955,109734,19120,7709,7591,118,1294,6,0.032670267,0,hg38,CD-0722-2
"A5,F2",5066,5741,3602,2139,3513,1965,0,1965,1253,712,1.759831461,1186,2493,729,249,249,0,74,0,0.112449799,0,empty,CD-0722-2
"A5,F3",4799,5281,3437,1844,3173,1709,0,1714,1109,605,1.833057851,996,2448,493,211,207,4,65,2,0.106280193,0,empty,CD-0722-2
"A5,F4",7176,7863,5292,2571,4678,2460,0,2462,1624,838,1.937947494,1345,779,268,123,121,2,34,1,0.024793388,0,empty,CD-0722-2
"A5,F5",5781,6279,4346,1933,3833,1971,0,1973,1267,706,1.794617564,1068,2205,468,198,197,1,61,1,0.010152284,0,empty,CD-0722-2
"A5,F6",5766,6852,4083,2769,3969,2308,0,2311,1405,906,1.550772627,1387,2691,644,243,242,1,70,1,0.140495868,0,empty,CD-0722-2
"A5,F7",6422,7115,4774,2341,4234,2267,0,2267,1473,794,1.855163728,1232,979,362,125,125,0,33,0,0.072,0,empty,CD-0722-2
"A5,F8",4742,5457,3428,2029,3302,1788,0,1790,1196,594,2.013468013,1055,278,62,31,30,1,13,1,0.066666667,0,empty,CD-0722-2
"A5,F9",5592,6347,4121,2226,3841,2077,0,2077,1404,673,2.086181278,1152,3435,761,326,324,2,91,1,0.108024691,0,empty,CD-0722-2
"A5,F10",527326,644631,372791,271840,377018,246981,1,247141,181444,65697,2.761830829,147281,4578,705,212,210,2,73,2,0.076190476,0,hg38,CD-0722-2
"A5,F11",5271,6086,3884,2202,3560,1890,0,1892,1294,598,2.163879599,1070,1448,303,168,167,1,45,1,0.089820359,0,empty,CD-0722-2
"A5,F12",6003,6490,4348,2142,3942,2097,0,2097,1426,671,2.125186289,1179,197,49,20,19,1,10,1,0,0,empty,CD-0722-2
"A5,G1",5852,6337,4338,1999,3810,1941,0,1941,1229,712,1.726123596,1056,2873,714,266,259,7,80,2,0.092664093,0,empty,CD-0722-2
"A5,G2",3740,4026,2619,1407,2502,1422,0,1422,962,460,2.091304348,812,634,150,55,54,1,29,1,0.185185185,0,empty,CD-0722-2
"A5,G3",6918,7653,5081,2572,4602,2558,0,2562,1484,1078,1.376623377,1410,2583,640,248,243,5,84,1,0.111111111,0,empty,CD-0722-2
"A5,G4",12580,15000,8786,6214,9066,5603,0,5607,3298,2309,1.42832395,3430,164,54,31,30,1,11,1,0,0,empty,CD-0722-2
"A5,G5",3974,4584,2907,1677,2767,1559,0,1561,1065,496,2.147177419,897,1826,473,189,188,1,65,1,0.095744681,0,empty,CD-0722-2
"A5,G6",5861,6576,4355,2221,3988,2202,0,2203,1489,714,2.085434174,1211,85,7,6,6,0,5,0,0.166666667,0,empty,CD-0722-2
"A5,G7",112850,128432,81891,46541,75121,41643,0,41675,33834,7841,4.31501084,24199,15587,2585,1016,1006,10,213,2,0.166003976,0,empty,CD-0722-2
"A5,G8",3444,3911,2454,1457,2356,1264,0,1266,852,414,2.057971014,753,1987,435,171,169,2,55,1,0.106508876,0,empty,CD-0722-2
"A5,G9",4098,4683,3026,1657,2884,1554,1,1562,977,585,1.67008547,896,2269,631,266,263,3,71,1,0.072243346,0,empty,CD-0722-2
"A5,G10",5136,5908,3630,2278,3559,2048,0,2048,1312,736,1.782608696,1205,2533,594,235,235,0,69,0,0.038297872,0,empty,CD-0722-2
"A5,G11",548069,644498,403306,241192,373184,210686,2,210876,167571,43305,3.869553169,123975,156027,26086,9975,9794,181,1551,7,0.054727384,0,hg38,CD-0722-2
"A5,G12",4377,5058,3153,1905,3081,1693,0,1693,1102,591,1.86463621,999,1947,523,227,227,0,66,0,0.04845815,0,empty,CD-0722-2
"A5,H1",4887,5539,3616,1923,3390,1873,1,1878,1263,615,2.053658537,1101,1854,484,167,166,1,49,1,0.012048193,0,empty,CD-0722-2
"A5,H2",5124,6012,3717,2295,3613,2084,1,2090,1297,793,1.63556116,1225,2214,567,230,227,3,69,2,0.140969163,0,empty,CD-0722-2
"A5,H3",4431,5121,3238,1883,3033,1663,0,1667,1118,549,2.036429872,966,1886,256,108,107,1,49,1,0.056074766,0,empty,CD-0722-2
"A5,H4",6153,6909,4553,2356,4134,2173,0,2175,1472,703,2.093883357,1254,180,32,19,19,0,15,0,0.157894737,0,empty,CD-0722-2
"A5,H5",6674,7785,4697,3088,4595,2616,0,2620,1697,923,1.838569881,1569,2158,536,200,199,1,62,1,0.155778894,0,empty,CD-0722-2
"A5,H6",4782,5675,3443,2232,3359,1878,0,1883,1270,613,2.07177814,1144,2497,526,213,211,2,65,2,0.037914692,0,empty,CD-0722-2
"A5,H7",4985,5491,3721,1770,3240,1702,0,1706,1138,568,2.003521127,916,1992,399,170,166,4,66,2,0.084337349,0,empty,CD-0722-2
"A5,H8",5398,6370,3880,2490,3782,2182,0,2184,1516,668,2.269461078,1300,2447,450,192,185,7,60,2,0.135135135,0,empty,CD-0722-2
"A5,H9",4006,4417,3019,1398,2665,1384,0,1386,894,492,1.817073171,748,1263,229,118,117,1,33,1,0.008547009,0,empty,CD-0722-2
"A5,H10",4061,4515,3004,1511,2710,1485,0,1485,1030,455,2.263736264,822,1688,349,124,124,0,36,0,0.120967742,0,empty,CD-0722-2
"A5,H11",5428,6459,3728,2731,3862,2520,0,2522,1343,1179,1.139100933,1507,91,0,0,0,0,0,0,0,0,empty,CD-0722-2
"A5,H12",4199,4715,3006,1709,2902,1611,0,1611,1062,549,1.93442623,933,1545,291,127,127,0,28,0,0.283464567,0,empty,CD-0722-2
"A6,A1",4047,4791,2952,1839,2893,1671,0,1673,1067,606,1.760726073,1024,980,167,82,81,1,31,1,0,0,empty,CD-0722-2
"A6,A2",6210,6914,4515,2399,4092,2309,0,2311,1432,879,1.629124005,1287,1769,538,220,219,1,59,1,0.086757991,0,empty,CD-0722-2
"A6,A3",3932,4601,2895,1706,2741,1534,0,1537,988,549,1.799635701,907,1168,318,125,124,1,32,1,0.064516129,0,empty,CD-0722-2
"A6,A4",6538,7372,4859,2513,4308,2394,0,2394,1591,803,1.98132005,1344,674,108,55,53,2,26,2,0.094339623,0,empty,CD-0722-2
"A6,A5",5442,6231,3870,2361,3665,2000,0,2006,1228,778,1.57840617,1191,2075,474,174,172,2,55,1,0.052325581,0,empty,CD-0722-2
"A6,A6",289185,369800,198961,170839,213789,147074,1,147184,109144,38040,2.869190326,90859,10742,1064,386,375,11,113,3,0.069333333,0,hg38,CD-0722-2
"A6,A7",3884,4462,2829,1633,2643,1500,0,1502,939,563,1.667850799,868,1199,229,97,96,1,35,1,0.020833333,0,empty,CD-0722-2
"A6,A8",2291,2529,1726,803,1589,850,0,851,579,272,2.128676471,473,1604,477,193,191,2,50,1,0.073298429,0,empty,CD-0722-2
"A6,A9",4117,4648,3086,1562,2760,1478,0,1479,1011,468,2.16025641,814,1668,409,141,140,1,43,1,0.085714286,0,empty,CD-0722-2
"A6,A10",5223,5763,3963,1800,3393,1807,0,1809,1121,688,1.629360465,984,272,40,22,22,0,12,0,0,0,empty,CD-0722-2
"A6,A11",3597,3903,2717,1186,2359,1209,0,1210,776,434,1.788018433,630,1490,383,126,125,1,51,1,0.032,0,empty,CD-0722-2
"A6,A12",1120049,1297619,836421,461198,724681,398156,1,398494,331262,67232,4.927147787,230675,374832,54544,21154,20694,460,2892,7,0.057021359,0,hg38,CD-0722-2
"A6,B1",4540,5292,3283,2009,3110,1806,0,1806,1104,702,1.572649573,1053,1119,174,78,78,0,36,0,0.269230769,0,empty,CD-0722-2
"A6,B2",4636,5213,3036,2177,3131,1886,0,1886,1150,736,1.5625,1158,553,89,39,38,1,13,1,0,0,empty,CD-0722-2
"A6,B3",3728,4248,2702,1546,2539,1383,0,1387,900,487,1.848049281,830,1660,352,142,142,0,51,0,0.014084507,0,empty,CD-0722-2
"A6,B4",4405,5187,3123,2064,3144,1847,0,1847,1194,653,1.82848392,1123,1211,334,130,130,0,30,0,0.253846154,0,empty,CD-0722-2
"A6,B5",4535,2814,1657,1157,1991,1153,0,1163,732,431,1.69837587,746,1036,284,109,109,0,32,0,0.036697248,0,empty,CD-0722-2
"A6,B6",4805,5651,3398,2253,3383,2028,0,2030,1289,741,1.739541161,1186,1637,555,217,216,1,54,1,0.041666667,0,empty,CD-0722-2
"A6,B7",4694,5447,3492,1955,3254,1804,0,1804,1209,595,2.031932773,1053,1236,329,161,159,2,31,1,0.06918239,0,empty,CD-0722-2
"A6,B8",3471,4018,2508,1510,2321,1240,0,1242,812,430,1.888372093,747,786,91,56,56,0,29,0,0,0,empty,CD-0722-2
"A6,B9",6478,7303,4636,2667,4369,2493,0,2498,1522,976,1.55942623,1449,1299,362,132,132,0,43,0,0.090909091,0,empty,CD-0722-2
"A6,B10",2929,3067,2085,982,1897,1007,0,1012,667,345,1.933333333,539,569,149,58,58,0,16,0,0.206896552,0,empty,CD-0722-2
"A6,B11",10140,11553,7464,4089,6891,3887,0,3887,2365,1522,1.553876478,2192,208,32,15,15,0,10,0,0,0,empty,CD-0722-2
"A6,B12",3733,4309,2748,1561,2634,1455,0,1458,944,514,1.836575875,879,1625,411,177,177,0,46,0,0.039548023,0,empty,CD-0722-2
"A6,C1",721165,823830,538661,285169,463877,251014,1,251247,200525,50722,3.95341272,143551,61910,10444,4075,4005,70,816,3,0.052684145,0,hg38,CD-0722-2
"A6,C2",6422,7210,4546,2664,4264,2426,0,2430,1531,899,1.703003337,1371,2108,594,239,235,4,54,2,0.178723404,0,empty,CD-0722-2
"A6,C3",6350,7048,4601,2447,4217,2301,0,2301,1464,837,1.749103943,1284,775,110,58,58,0,23,0,0.051724138,0,empty,CD-0722-2
"A6,C4",4253,4666,3195,1471,2745,1427,0,1427,914,513,1.781676413,797,1936,326,154,152,2,47,2,0.243421053,0,empty,CD-0722-2
"A6,C5",5906,6819,4312,2507,3961,2132,0,2133,1364,769,1.77373212,1264,1803,395,149,144,5,47,2,0.097222222,0,empty,CD-0722-2
"A6,C6",5148,5791,3725,2066,3440,1877,0,1877,1207,670,1.801492537,1071,1667,352,99,99,0,44,0,0.121212121,0,empty,CD-0722-2
"A6,C7",7030,8467,4990,3477,4979,3055,0,3058,1835,1223,1.500408831,1890,282,40,24,24,0,13,0,0,0,empty,CD-0722-2
"A6,C8",9310,10930,6669,4261,6304,3651,0,3653,2505,1148,2.182055749,2210,2378,567,242,237,5,85,1,0.092827004,0,empty,CD-0722-2
"A6,C9",5160,5962,3733,2229,3559,1937,0,1937,1261,676,1.865384615,1166,1427,415,180,179,1,49,1,0.100558659,0,empty,CD-0722-2
"A6,C10",6123,6874,4494,2380,4032,2107,0,2109,1279,830,1.540963855,1213,1758,414,213,213,0,53,0,0.17370892,0,empty,CD-0722-2
"A6,C11",5137,5810,3688,2122,3472,1912,0,1916,1229,687,1.788937409,1143,1558,404,158,158,0,52,0,0.075949367,0,empty,CD-0722-2
"A6,C12",7326,8354,5396,2958,4929,2676,1,2680,1781,899,1.9810901,1553,1726,574,221,221,0,49,0,0.167420814,0,empty,CD-0722-2
"A6,D1",6831,8019,4824,3195,4714,2782,0,2782,1659,1123,1.477292965,1665,737,102,63,58,5,26,2,0,0,empty,CD-0722-2
"A6,D2",5227,5652,3946,1706,3458,1782,0,1782,1174,608,1.930921053,966,2660,1049,335,335,0,79,0,0.035820896,0,empty,CD-0722-2
"A6,D3",5004,6058,3593,2465,3504,2074,0,2074,1376,698,1.971346705,1230,926,191,108,108,0,38,0,0.12962963,0,empty,CD-0722-2
"A6,D4",3703,4251,2729,1522,2571,1403,0,1407,906,501,1.808383234,814,1076,318,139,138,1,41,1,0.036231884,0,empty,CD-0722-2
"A6,D5",4025,4826,2899,1927,2931,1658,0,1659,1106,553,2,1035,1517,260,105,103,2,40,1,0.106796117,0,empty,CD-0722-2
"A6,D6",6825,7987,4746,3241,4700,2789,0,2796,1632,1164,1.402061856,1667,3326,618,246,241,5,69,2,0.070539419,0,empty,CD-0722-2
"A6,D7",3735,4168,2769,1399,2444,1281,0,1282,843,439,1.920273349,746,2207,667,220,218,2,67,1,0.027522936,0,empty,CD-0722-2
"A6,D8",4765,5332,3511,1821,3040,1642,0,1644,1057,587,1.800681431,900,1333,268,98,97,1,35,1,0.144329897,0,empty,CD-0722-2
"A6,D9",328277,394659,237230,157429,227036,133852,1,133951,104979,28972,3.623464034,81053,89581,17268,6509,6407,102,1239,4,0.057905416,0,hg38,CD-0722-2
"A6,D10",4359,5075,3162,1913,3054,1696,0,1698,1052,646,1.628482972,980,1042,259,105,102,3,30,2,0.058823529,0,empty,CD-0722-2
"A6,D11",4924,5534,3702,1832,3265,1740,0,1740,1089,651,1.67281106,973,2366,534,201,200,1,63,1,0.095,0,empty,CD-0722-2
"A6,D12",6052,7241,4397,2844,4238,2330,0,2333,1509,824,1.83131068,1396,2933,595,277,272,5,87,2,0.029411765,0,empty,CD-0722-2
"A6,E1",7772,8919,5588,3331,5145,2892,0,2895,1781,1114,1.598743268,1701,2401,487,203,202,1,64,1,0.128712871,0,empty,CD-0722-2
"A6,E2",537381,642033,394112,247921,370682,211587,1,211766,164912,46854,3.519699492,127509,119141,17334,6871,6728,143,1147,6,0.043549346,0,hg38,CD-0722-2
"A6,E3",3730,4314,2806,1508,2435,1270,0,1271,850,421,2.019002375,683,1829,476,191,190,1,61,1,0.052631579,0,empty,CD-0722-2
"A6,E4",5171,6186,3762,2424,3617,1996,0,1999,1283,716,1.791899441,1203,2528,490,221,218,3,67,1,0.059633028,0,empty,CD-0722-2
"A6,E5",4543,5029,3395,1634,3032,1571,0,1574,1012,562,1.800711744,892,1248,343,120,120,0,38,0,0.016666667,0,empty,CD-0722-2
"A6,E6",8491,9614,6281,3333,5650,3096,0,3101,1985,1116,1.778673835,1798,3210,875,333,330,3,83,2,0.036363636,0,empty,CD-0722-2
"A6,E7",8847,10615,6313,4302,6183,3655,0,3655,2246,1409,1.594038325,2174,2553,412,190,190,0,65,0,0.136842105,0,empty,CD-0722-2
"A6,E8",556507,625432,429806,195626,356475,177066,1,177265,131634,45631,2.884749403,99515,140361,15916,6107,5915,192,1088,6,0.046999155,0,hg38,CD-0722-2
"A6,E9",3797,4341,2730,1611,2591,1410,0,1412,930,482,1.929460581,823,2463,495,200,195,5,67,3,0.128205128,0,empty,CD-0722-2
"A6,E10",4252,4827,3198,1629,2829,1466,0,1469,926,543,1.7053407,823,1948,603,247,245,2,55,1,0.102040816,0,empty,CD-0722-2
"A6,E11",5260,5865,3837,2028,3477,1888,0,1888,1199,689,1.740203193,1071,1787,375,176,174,2,52,1,0.057471264,0,empty,CD-0722-2
"A6,E12",6271,7123,4559,2564,4240,2389,0,2389,1575,814,1.934889435,1368,1548,295,91,89,2,34,1,0.02247191,0,empty,CD-0722-2
"A6,F1",575312,652703,434425,218278,372855,196313,1,196453,148186,48267,3.070130731,113136,86511,10154,3796,3672,124,776,5,0.056372549,0,hg38,CD-0722-2
"A6,F2",5011,5675,3649,2026,3437,1834,0,1837,1199,638,1.879310345,1037,2273,591,264,263,1,74,1,0.064638783,0,empty,CD-0722-2
"A6,F3",5029,5857,3728,2129,3431,1869,0,1869,1237,632,1.957278481,1083,2456,612,198,196,2,62,2,0.045918367,0,empty,CD-0722-2
"A6,F4",7236,7948,5304,2644,4721,2470,0,2479,1582,897,1.763656633,1355,698,169,72,72,0,29,0,0.236111111,0,empty,CD-0722-2
"A6,F5",6068,6776,4502,2274,3971,2049,0,2049,1264,785,1.610191083,1158,2050,587,229,224,5,71,1,0.147321429,0,empty,CD-0722-2
"A6,F6",5808,6707,4110,2597,3952,2287,0,2287,1483,804,1.844527363,1350,2449,674,297,294,3,75,2,0.074829932,0,empty,CD-0722-2
"A6,F7",598561,765506,407441,358065,444509,308042,0,308210,206983,101227,2.044741028,193766,1296,412,115,115,0,33,0,0.043478261,0,hg38,CD-0722-2
"A6,F8",4791,5357,3528,1829,3177,1757,0,1760,1166,594,1.962962963,1012,258,53,19,19,0,11,0,0,0,empty,CD-0722-2
"A6,F9",5273,5961,3885,2076,3470,1817,0,1820,1219,601,2.02828619,1032,2938,745,308,304,4,80,2,0.042763158,0,empty,CD-0722-2
"A6,F10",6583,7605,4948,2657,4477,2368,0,2368,1497,871,1.718714122,1328,1725,506,202,200,2,46,2,0.095,0,empty,CD-0722-2
"A6,F11",5316,5632,3944,1688,3321,1606,0,1609,1040,569,1.827768014,880,1442,252,114,113,1,38,1,0.008849558,0,empty,CD-0722-2
"A6,F12",5875,6626,4225,2401,3851,2082,0,2087,1357,730,1.85890411,1174,178,19,11,11,0,6,0,0,0,empty,CD-0722-2
"A6,G1",613405,737378,444556,292822,423421,251940,0,252098,200199,51899,3.857473169,151297,159466,25630,9610,9461,149,1660,9,0.033294578,0,hg38,CD-0722-2
"A6,G2",3682,4331,2564,1767,2560,1519,0,1522,931,591,1.575296108,939,417,105,58,57,1,30,1,0.122807018,0,empty,CD-0722-2
"A6,G3",7294,7913,5442,2471,4610,2495,0,2499,1488,1011,1.471810089,1321,2754,744,280,274,6,68,1,0.105839416,0,empty,CD-0722-2
"A6,G4",12968,15239,9144,6095,8959,5447,0,5447,3298,2149,1.534667287,3190,94,12,10,10,0,9,0,0,0,empty,CD-0722-2
"A6,G5",4039,4585,2889,1696,2736,1518,0,1518,985,533,1.848030019,875,1611,377,171,168,3,55,2,0.041666667,0,empty,CD-0722-2
"A6,G6",6249,6982,4646,2336,4075,2213,0,2213,1445,768,1.881510417,1230,266,58,27,27,0,6,0,0,0,empty,CD-0722-2
"A6,G7",4954,5592,3668,1924,3274,1709,0,1711,1161,550,2.110909091,946,2335,634,207,205,2,59,1,0.073170732,0,empty,CD-0722-2
"A6,G8",3593,4132,2595,1537,2419,1328,0,1328,862,466,1.849785408,774,1517,375,148,142,6,48,2,0.063380282,0,empty,CD-0722-2
"A6,G9",4156,4880,3071,1809,2869,1569,0,1570,1030,540,1.907407407,929,1946,471,202,202,0,66,0,0.004950495,0,empty,CD-0722-2
"A6,G10",5432,5924,4039,1885,3492,1888,0,1889,1262,627,2.012759171,1037,2093,594,228,227,1,66,1,0.017621145,0,empty,CD-0722-2
"A6,G11",5244,5785,3936,1849,3442,1808,0,1809,1173,636,1.844339623,981,1505,301,110,110,0,38,0,0.1,0,empty,CD-0722-2
"A6,G12",4685,5606,3253,2353,3221,1842,0,1847,1168,679,1.72017673,1159,2304,480,190,188,2,74,2,0.127659574,0,empty,CD-0722-2
"A6,H1",4510,4999,3376,1623,3018,1588,0,1588,1084,504,2.150793651,852,967,128,59,59,0,29,0,0.016949153,0,empty,CD-0722-2
"A6,H2",5220,5919,3732,2187,3475,1918,0,1918,1237,681,1.816446402,1132,2357,585,251,249,2,80,1,0.020080321,0,empty,CD-0722-2
"A6,H3",4296,4860,3138,1722,2957,1619,0,1619,1074,545,1.970642202,909,1656,267,93,93,0,36,0,0.086021505,0,empty,CD-0722-2
"A6,H4",650140,692396,506573,185823,384821,176365,1,176519,138971,37548,3.701155854,92204,331,128,49,49,0,16,0,0.020408163,0,empty,CD-0722-2
"A6,H5",6871,7858,4915,2943,4592,2578,0,2587,1643,944,1.740466102,1546,1985,541,189,188,1,45,1,0.10106383,0,empty,CD-0722-2
"A6,H6",3890,4387,2888,1499,2640,1478,0,1478,987,491,2.010183299,829,2071,417,200,198,2,58,1,0.070707071,0,empty,CD-0722-2
"A6,H7",4907,5534,3606,1928,3367,1801,0,1805,1188,617,1.925445705,1050,2082,519,216,215,1,69,1,0.074418605,0,empty,CD-0722-2
"A6,H8",5507,6390,3820,2570,3685,2141,0,2141,1354,787,1.720457433,1308,1913,386,164,164,0,58,0,0.054878049,0,empty,CD-0722-2
"A6,H9",4011,4474,2972,1502,2675,1413,0,1413,946,467,2.025695931,782,1066,197,94,91,3,29,1,0,0,empty,CD-0722-2
"A6,H10",243651,315881,155051,160830,184538,138420,0,138515,67746,70769,0.957283556,87069,2114,580,234,231,3,105,1,0.142857143,0,empty,CD-0722-2
"A6,H11",5579,6800,3788,3012,4021,2672,0,2672,1441,1231,1.170593014,1640,82,4,4,4,0,3,0,0,0,empty,CD-0722-2
"A6,H12",4072,4628,2891,1737,2752,1538,0,1540,1064,476,2.235294118,901,1322,233,87,87,0,37,0,0.091954023,0,empty,CD-0722-2
"A7,A1",4189,4999,2975,2024,3067,1819,0,1819,1206,613,1.967373573,1117,1196,180,73,71,2,25,2,0.14084507,0,empty,CD-0722-2
"A7,A2",5898,6730,4247,2483,4013,2295,0,2298,1435,863,1.662804171,1332,2223,437,172,169,3,60,2,0.01183432,0,empty,CD-0722-2
"A7,A3",3737,4260,2704,1556,2601,1439,0,1440,956,484,1.975206612,847,1437,231,105,103,2,43,2,0.077669903,0,empty,CD-0722-2
"A7,A4",6537,7544,4791,2753,4490,2476,0,2476,1604,872,1.839449541,1408,795,176,69,68,1,27,1,0.029411765,0,empty,CD-0722-2
"A7,A5",5274,5726,3847,1879,3453,1813,0,1816,1126,690,1.631884058,982,2008,521,214,210,4,45,2,0.095238095,0,empty,CD-0722-2
"A7,A6",6264,7365,4566,2799,4455,2540,0,2544,1734,810,2.140740741,1508,3114,779,293,290,3,78,2,0.103448276,0,empty,CD-0722-2
"A7,A7",4062,4685,2957,1728,2775,1613,0,1613,1059,554,1.911552347,910,1280,286,124,123,1,52,1,0,0,empty,CD-0722-2
"A7,A8",2346,2804,1694,1110,1672,912,0,917,606,311,1.948553055,545,1865,438,161,160,1,60,1,0.1,0,empty,CD-0722-2
"A7,A9",4043,4786,2964,1822,2984,1699,0,1706,1090,616,1.769480519,1042,1745,585,199,196,3,49,3,0.137755102,0,empty,CD-0722-2
"A7,A10",370269,433629,275721,157908,251940,137267,0,137374,105555,31819,3.317357554,81154,46773,5938,2268,2194,74,453,5,0.091157703,0,hg38,CD-0722-2
"A7,A11",3653,4116,2724,1392,2498,1328,0,1332,910,422,2.156398104,739,1690,410,154,152,2,40,1,0.138157895,0,empty,CD-0722-2
"A7,A12",5392,5991,4023,1968,3472,1814,0,1816,1174,642,1.828660436,974,3338,706,318,314,4,94,2,0.079617834,0,empty,CD-0722-2
"A7,B1",4622,5494,3324,2170,3346,1873,0,1873,1171,702,1.668091168,1184,1608,475,174,174,0,46,0,0.051724138,0,empty,CD-0722-2
"A7,B2",4869,5501,3330,2171,3274,1935,0,1936,1209,727,1.662998624,1155,680,168,81,81,0,27,0,0.061728395,0,empty,CD-0722-2
"A7,B3",4079,4615,3006,1609,2815,1538,0,1538,1030,508,2.027559055,882,1522,213,103,102,1,51,1,0.107843137,0,empty,CD-0722-2
"A7,B4",4397,5007,3169,1838,3004,1738,0,1738,1145,593,1.930860034,990,1270,234,103,102,1,35,1,0.12745098,0,empty,CD-0722-2
"A7,B5",4461,2792,1641,1151,2038,1157,0,1169,772,397,1.944584383,758,1070,219,80,78,2,23,2,0.141025641,0,empty,CD-0722-2
"A7,B6",4920,5664,3606,2058,3380,1974,0,1975,1276,699,1.82546495,1124,1934,374,140,139,1,48,1,0.129496403,0,empty,CD-0722-2
"A7,B7",4510,5181,3395,1786,3126,1664,0,1666,1071,595,1.8,925,1375,225,109,109,0,39,0,0,0,empty,CD-0722-2
"A7,B8",419953,492241,310743,181498,285299,158907,1,159031,129725,29306,4.426567938,92890,130812,18682,7524,7359,165,1319,5,0.079902161,0,hg38,CD-0722-2
"A7,B9",6785,7919,4848,3071,4739,2756,0,2760,1770,990,1.787878788,1631,1392,335,119,116,3,59,2,0.043103448,0,empty,CD-0722-2
"A7,B10",2943,3224,2130,1094,1995,1079,0,1082,679,403,1.684863524,604,297,66,33,33,0,13,0,0.03030303,0,empty,CD-0722-2
"A7,B11",7403,8711,5254,3457,5143,3140,0,3140,1766,1374,1.285298399,1871,428,40,18,18,0,8,0,0,0,empty,CD-0722-2
"A7,B12",3863,4422,2818,1604,2720,1528,0,1531,1049,482,2.176348548,900,1470,323,145,143,2,44,2,0.006993007,0,empty,CD-0722-2
"A7,C1",7827,8454,5930,2524,5072,2624,0,2634,1682,952,1.766806723,1418,988,181,101,100,1,33,1,0.1,0,empty,CD-0722-2
"A7,C2",6486,7392,4789,2603,4428,2517,0,2522,1653,869,1.902186421,1424,2258,691,331,328,3,88,3,0.042682927,0,empty,CD-0722-2
"A7,C3",7062,7982,5124,2858,4847,2729,0,2731,1807,924,1.955627706,1561,1024,336,124,124,0,36,0,0.064516129,0,empty,CD-0722-2
"A7,C4",4085,4732,2963,1769,2857,1519,0,1519,1020,499,2.044088176,877,1989,591,252,245,7,52,2,0.057142857,0,empty,CD-0722-2
"A7,C5",1662031,2023324,1187764,835560,1157625,723045,2,723524,551713,171811,3.211162266,441441,171386,22863,8899,8709,190,1591,9,0.056378459,0,hg38,CD-0722-2
"A7,C6",600848,678500,456894,221606,398643,206626,1,206806,172103,34703,4.959311875,116584,16425,2450,1018,999,19,273,3,0.038038038,0,hg38,CD-0722-2
"A7,C7",7024,8385,4827,3558,5002,3097,0,3098,1828,1270,1.439370079,1893,461,95,48,48,0,19,0,0.041666667,0,empty,CD-0722-2
"A7,C8",7869,8873,5680,3193,5280,2945,0,2949,1969,980,2.009183673,1704,4027,869,354,347,7,127,2,0.13832853,0,empty,CD-0722-2
"A7,C9",5483,6151,3937,2214,3691,2050,0,2052,1317,735,1.791836735,1185,1628,423,149,148,1,51,1,0.067567568,0,empty,CD-0722-2
"A7,C10",618517,705165,464982,240183,403864,214332,1,214495,161971,52524,3.083752189,123047,148768,19385,7616,7440,176,1285,7,0.048790323,0,hg38,CD-0722-2
"A7,C11",5294,5946,3918,2028,3550,1937,0,1938,1253,685,1.82919708,1084,2093,604,242,239,3,57,2,0.033472803,0,empty,CD-0722-2
"A7,C12",569816,667202,418138,249064,384644,216085,3,216263,169683,46580,3.642829541,128454,69432,9129,3533,3448,85,777,5,0.040313225,0,hg38,CD-0722-2
"A7,D1",6697,7771,4748,3023,4659,2736,0,2741,1739,1002,1.735528942,1625,871,113,50,47,3,21,2,0.063829787,0,empty,CD-0722-2
"A7,D2",422762,462026,331329,130697,268500,126366,1,126511,100938,25573,3.947053533,68058,68872,12678,4642,4548,94,883,3,0.022207564,0,hg38,CD-0722-2
"A7,D3",391965,454076,291057,163019,269206,148245,1,148362,122049,26313,4.638353665,86676,10881,2991,1066,1059,7,256,2,0.012275732,0,hg38,CD-0722-2
"A7,D4",504320,614039,366251,247788,356575,209770,1,209935,170124,39811,4.273291301,127680,86234,15899,6079,5987,92,1147,7,0.05812594,0,hg38,CD-0722-2
"A7,D5",4271,4905,3129,1776,2951,1620,0,1621,1048,573,1.828970332,931,1772,410,170,165,5,51,3,0.048484848,0,empty,CD-0722-2
"A7,D6",6613,7635,4591,3044,4567,2720,0,2721,1692,1029,1.644314869,1608,2244,527,237,236,1,62,1,0.038135593,0,empty,CD-0722-2
"A7,D7",3846,4442,2853,1589,2635,1421,0,1421,953,468,2.036324786,795,1942,438,187,183,4,65,2,0.010928962,0,empty,CD-0722-2
"A7,D8",4509,5011,3296,1715,3076,1635,0,1635,1132,503,2.250497018,948,1468,337,137,132,5,64,1,0.037878788,0,empty,CD-0722-2
"A7,D9",2355,2759,1715,1044,1615,864,0,866,554,312,1.775641026,499,1563,443,163,161,2,36,1,0.037267081,0,empty,CD-0722-2
"A7,D10",4427,5186,3162,2024,3098,1795,0,1797,1090,707,1.541725601,1084,980,214,80,79,1,27,1,0.050632911,0,empty,CD-0722-2
"A7,D11",5055,5972,3716,2256,3552,1953,0,1955,1273,682,1.866568915,1168,2752,671,270,269,1,84,1,0.078066914,0,empty,CD-0722-2
"A7,D12",714697,844653,529819,314834,484951,278118,0,278317,218774,59543,3.674218632,163473,96041,18631,6976,6886,90,1287,5,0.031513215,0,hg38,CD-0722-2
"A7,E1",7668,8403,5507,2896,5194,2858,0,2862,1820,1042,1.746641075,1643,2035,459,225,219,6,79,2,0.150684932,0,empty,CD-0722-2
"A7,E2",5467,6285,3925,2360,3767,2101,0,2101,1392,709,1.963328632,1225,2014,473,194,190,4,66,2,0.073684211,0,empty,CD-0722-2
"A7,E3",3757,4201,2851,1350,2532,1357,0,1358,863,495,1.743434343,727,2547,583,247,240,7,75,2,0.025,0,empty,CD-0722-2
"A7,E4",4901,5453,3624,1829,3312,1795,0,1798,1196,602,1.986710963,996,2120,423,203,201,2,78,2,0.119402985,0,empty,CD-0722-2
"A7,E5",4497,5087,3440,1647,3006,1546,0,1551,999,552,1.809782609,832,1349,277,107,102,5,36,2,0.009803922,0,empty,CD-0722-2
"A7,E6",8109,9279,5895,3384,5445,2964,0,2970,1881,1089,1.727272727,1693,3477,954,377,373,4,118,2,0.029490617,0,empty,CD-0722-2
"A7,E7",7152,7792,5347,2445,4720,2494,0,2495,1615,880,1.835227273,1353,2744,688,294,292,2,106,2,0.113013699,0,empty,CD-0722-2
"A7,E8",5939,6680,4474,2206,4033,2148,0,2150,1445,705,2.04964539,1192,2789,668,225,216,9,66,2,0.064814815,0,empty,CD-0722-2
"A7,E9",4146,4756,3015,1741,2809,1531,0,1534,1030,504,2.043650794,886,2896,736,306,304,2,89,2,0.052631579,0,empty,CD-0722-2
"A7,E10",1249114,1565199,879183,686016,904183,590020,4,590447,457519,132928,3.441855741,365514,38713,13449,4988,4958,30,1099,3,0.047398144,0,hg38,CD-0722-2
"A7,E11",196134,224238,147685,76553,131762,72969,0,73034,49899,23135,2.156861898,41940,8792,1865,612,608,4,163,2,0.041118421,0,hg38,CD-0722-2
"A7,E12",5628,6768,3985,2783,4064,2316,0,2316,1526,790,1.93164557,1423,1782,441,213,211,2,66,2,0.028436019,0,empty,CD-0722-2
"A7,F1",6926,7667,5090,2577,4697,2553,0,2559,1569,990,1.584848485,1432,2666,746,273,268,5,82,1,0.074626866,0,empty,CD-0722-2
"A7,F2",268942,352607,172647,179960,210099,154595,1,154708,106214,48494,2.19025034,99429,3615,1161,356,354,2,110,1,0.138418079,0,hg38,CD-0722-2
"A7,F3",4929,5763,3563,2200,3433,1866,0,1866,1227,639,1.920187793,1136,2786,691,284,281,3,77,1,0.078291815,0,empty,CD-0722-2
"A7,F4",496852,633308,325042,308266,376832,272349,1,272535,189811,82724,2.294509453,170355,2234,333,139,136,3,74,2,0.169117647,0,hg38,CD-0722-2
"A7,F5",6678,7307,4963,2344,4342,2267,0,2269,1531,738,2.074525745,1241,2425,491,244,242,2,87,2,0.033057851,0,empty,CD-0722-2
"A7,F6",5836,6634,4154,2480,4053,2313,0,2315,1471,844,1.742890995,1389,2993,795,286,282,4,82,1,0.141843972,0,empty,CD-0722-2
"A7,F7",6837,7774,5008,2766,4619,2536,0,2536,1683,853,1.973036342,1482,1300,415,196,196,0,43,0,0.071428571,0,empty,CD-0722-2
"A7,F8",4863,5182,3599,1583,3240,1636,0,1636,1125,511,2.201565558,877,360,49,22,22,0,17,0,0,0,empty,CD-0722-2
"A7,F9",5275,5828,4028,1800,3519,1774,0,1777,1143,634,1.802839117,985,2520,691,260,260,0,77,0,0.011538462,0,empty,CD-0722-2
"A7,F10",6473,7346,4846,2500,4370,2328,0,2328,1512,816,1.852941176,1291,1687,430,172,171,1,55,1,0.081871345,0,empty,CD-0722-2
"A7,F11",567701,636697,430692,206005,366775,187829,3,188012,147523,40489,3.643532811,105317,94880,13158,5341,5208,133,938,5,0.085061444,0,hg38,CD-0722-2
"A7,F12",542712,653720,387561,266159,378719,235332,0,235497,157857,77640,2.033191654,144470,1356,64,43,43,0,22,0,0.162790698,0,empty,CD-0722-2
"A7,G1",6175,6917,4569,2348,4242,2196,0,2198,1466,732,2.00273224,1297,3038,760,310,306,4,88,2,0.104575163,0,empty,CD-0722-2
"A7,G2",3904,4483,2765,1718,2751,1600,0,1600,1051,549,1.9143898,967,510,93,47,46,1,28,1,0.065217391,0,empty,CD-0722-2
"A7,G3",6978,7670,5052,2618,4610,2572,0,2573,1546,1027,1.505355404,1404,2340,682,269,268,1,79,1,0.134328358,0,empty,CD-0722-2
"A7,G4",13087,15267,9215,6052,9097,5613,0,5621,3361,2260,1.487168142,3327,118,18,14,14,0,10,0,0,0,empty,CD-0722-2
"A7,G5",4112,4628,3081,1547,2882,1586,0,1586,1040,546,1.904761905,921,1652,431,165,163,2,46,2,0.049079755,0,empty,CD-0722-2
"A7,G6",6032,6746,4562,2184,4102,2184,0,2187,1400,787,1.778907243,1228,229,65,37,37,0,14,0,0.351351351,0,empty,CD-0722-2
"A7,G7",4774,5379,3586,1793,3265,1680,0,1680,1125,555,2.027027027,939,2062,494,197,195,2,57,2,0.056410256,0,empty,CD-0722-2
"A7,G8",3549,3943,2581,1362,2406,1299,0,1299,850,449,1.893095768,739,1667,423,173,173,0,48,0,0.046242775,0,empty,CD-0722-2
"A7,G9",4436,5140,3189,1951,3041,1678,0,1678,1109,569,1.949033392,982,2326,580,252,250,2,74,1,0.128,0,empty,CD-0722-2
"A7,G10",5249,5911,3840,2071,3528,1947,0,1951,1308,643,2.034214619,1067,2724,812,270,268,2,74,1,0.02238806,0,empty,CD-0722-2
"A7,G11",5059,5806,3773,2033,3435,1784,0,1784,1156,628,1.840764331,1023,1774,469,184,184,0,48,0,0.010869565,0,empty,CD-0722-2
"A7,G12",4528,5353,3200,2153,3276,1888,0,1888,1250,638,1.959247649,1193,2406,432,219,216,3,86,2,0.166666667,0,empty,CD-0722-2
"A7,H1",4864,5382,3592,1790,3303,1743,0,1743,1113,630,1.766666667,982,1437,390,157,155,2,49,1,0.180645161,0,empty,CD-0722-2
"A7,H2",5251,5942,3884,2058,3564,1880,0,1882,1242,640,1.940625,1059,2457,620,234,233,1,71,1,0.081545064,0,empty,CD-0722-2
"A7,H3",4320,4941,3138,1803,2965,1667,0,1667,1074,593,1.811129848,970,1479,228,124,123,1,49,1,0,0,empty,CD-0722-2
"A7,H4",6467,7283,4737,2546,4405,2366,0,2366,1521,845,1.8,1363,297,100,43,43,0,14,0,0.069767442,0,empty,CD-0722-2
"A7,H5",6915,7873,5040,2833,4721,2568,0,2571,1723,848,2.031839623,1441,1969,606,227,225,2,67,2,0.084444444,0,empty,CD-0722-2
"A7,H6",4565,5238,3205,2033,3111,1778,0,1782,1137,645,1.762790698,1061,1939,416,200,199,1,67,1,0.030150754,0,empty,CD-0722-2
"A7,H7",4912,5559,3629,1930,3390,1833,1,1836,1258,578,2.176470588,1024,2113,513,220,215,5,78,3,0.046511628,0,empty,CD-0722-2
"A7,H8",1669368,2012812,1212034,800778,1135798,682442,4,682994,548583,134411,4.081384708,412301,386930,64096,25850,25417,433,3298,9,0.044222371,0,hg38,CD-0722-2
"A7,H9",4075,4537,3037,1500,2689,1417,0,1417,912,505,1.805940594,757,1047,215,91,90,1,29,1,0.155555556,0,empty,CD-0722-2
"A7,H10",4903,5776,3508,2268,3432,2031,0,2033,1432,601,2.382695507,1224,1711,260,139,135,4,60,2,0.059259259,0,empty,CD-0722-2
"A7,H11",5311,6567,3548,3019,3964,2646,0,2646,1463,1183,1.236686391,1707,86,22,12,12,0,6,0,0,0,empty,CD-0722-2
"A7,H12",4266,4854,3098,1756,2783,1534,1,1535,992,543,1.826887661,829,1997,349,132,131,1,49,1,0.022900763,0,empty,CD-0722-2
"A8,A1",3143,3518,2299,1219,2208,1252,0,1252,832,420,1.980952381,709,1061,209,99,97,2,34,2,0.020618557,0,empty,CD-0722-2
"A8,A2",4618,5270,3329,1941,3209,1796,0,1797,1160,637,1.821036107,1031,1580,356,160,158,2,56,2,0.126582278,0,empty,CD-0722-2
"A8,A3",2845,3242,2077,1165,1934,1062,0,1062,706,356,1.983146067,593,1171,151,72,69,3,32,1,0.072463768,0,empty,CD-0722-2
"A8,A4",5304,5829,3900,1929,3606,1977,0,1981,1246,735,1.695238095,1102,806,134,70,68,2,25,2,0,0,empty,CD-0722-2
"A8,A5",4025,4598,2964,1634,2752,1500,0,1502,993,509,1.950884086,862,1626,467,178,176,2,41,1,0,0,empty,CD-0722-2
"A8,A6",3441,3969,2514,1455,2474,1448,0,1448,938,510,1.839215686,842,2836,549,239,232,7,86,2,0.081896552,0,empty,CD-0722-2
"A8,A7",2953,3526,2110,1416,2169,1251,0,1251,807,444,1.817567568,765,1514,332,127,124,3,43,2,0.120967742,0,empty,CD-0722-2
"A8,A8",1910,2110,1429,681,1258,662,0,663,415,248,1.673387097,343,1840,427,160,159,1,58,1,0.012578616,0,empty,CD-0722-2
"A8,A9",3027,3424,2197,1227,2195,1183,0,1185,741,444,1.668918919,686,2175,359,149,147,2,47,1,0.020408163,0,empty,CD-0722-2
"A8,A10",3713,4020,2741,1279,2516,1393,0,1393,846,547,1.546617916,767,440,58,39,39,0,16,0,0,0,empty,CD-0722-2
"A8,A11",2735,3061,2100,961,1853,935,0,935,600,335,1.791044776,490,1718,364,147,144,3,46,1,0.048611111,0,empty,CD-0722-2
"A8,A12",3856,4219,2931,1288,2544,1303,0,1305,850,455,1.868131868,682,3376,776,313,313,0,91,0,0.092651757,0,empty,CD-0722-2
"A8,B1",3512,3899,2500,1399,2388,1310,0,1310,822,488,1.68442623,753,1069,143,64,61,3,30,2,0.016393443,0,empty,CD-0722-2
"A8,B2",3801,4288,2673,1615,2653,1572,0,1576,914,662,1.380664653,910,590,111,52,49,3,22,2,0.183673469,0,empty,CD-0722-2
"A8,B3",467888,582386,330108,252278,340946,212140,2,212268,171975,40293,4.268111086,131755,87613,21363,8341,8234,107,1324,6,0.041899441,0,hg38,CD-0722-2
"A8,B4",3188,3667,2272,1395,2273,1323,0,1323,812,511,1.589041096,777,1039,251,131,131,0,42,0,0.015267176,0,empty,CD-0722-2
"A8,B5",6707,5910,3587,2323,3840,2116,0,2130,1550,580,2.672413793,1313,1096,248,85,83,2,34,1,0.072289157,0,empty,CD-0722-2
"A8,B6",3606,4000,2641,1359,2493,1396,0,1396,875,521,1.679462572,776,1329,291,112,107,5,43,1,0.046728972,0,empty,CD-0722-2
"A8,B7",3487,4124,2627,1497,2522,1380,0,1382,883,499,1.769539078,792,1442,351,113,113,0,29,0,0.283185841,0,empty,CD-0722-2
"A8,B8",2499,2775,1836,939,1730,942,0,944,612,332,1.843373494,540,968,187,65,65,0,37,0,0.092307692,0,empty,CD-0722-2
"A8,B9",431894,498548,321568,176980,289660,157893,1,158013,119929,38084,3.149065224,92324,155209,15947,6335,6153,182,1161,9,0.064033805,0,hg38,CD-0722-2
"A8,B10",2371,2606,1716,890,1623,863,0,864,540,324,1.666666667,501,374,47,19,19,0,10,0,0,0,empty,CD-0722-2
"A8,B11",5657,6821,4041,2780,4084,2452,0,2454,1361,1093,1.245196706,1485,288,55,35,35,0,14,0,0.285714286,0,empty,CD-0722-2
"A8,B12",3285,3841,2329,1512,2319,1329,0,1329,866,463,1.870410367,804,1381,444,188,187,1,46,1,0.117647059,0,empty,CD-0722-2
"A8,C1",6519,7452,4827,2625,4456,2442,0,2444,1561,883,1.76783692,1414,962,190,85,84,1,31,1,0.095238095,0,empty,CD-0722-2
"A8,C2",5145,5805,3661,2144,3492,2000,0,2002,1330,672,1.979166667,1147,2374,675,242,240,2,73,1,0.020833333,0,empty,CD-0722-2
"A8,C3",8388,9719,6146,3573,5940,3267,1,3268,2291,977,2.34493347,1881,888,175,87,87,0,29,0,0.08045977,0,empty,CD-0722-2
"A8,C4",3221,3783,2376,1407,2227,1169,0,1176,733,443,1.65462754,674,1570,290,99,98,1,38,1,0.153061224,0,empty,CD-0722-2
"A8,C5",383064,424334,295989,128345,250209,119239,1,119362,92669,26693,3.471659237,67375,32656,5944,2254,2225,29,465,3,0.029662921,0,hg38,CD-0722-2
"A8,C6",4311,4800,3178,1622,2996,1595,0,1599,1049,550,1.907272727,895,1281,364,129,126,3,39,1,0.047619048,0,empty,CD-0722-2
"A8,C7",5604,6729,3897,2832,4035,2517,0,2519,1510,1009,1.496531219,1544,477,46,25,24,1,13,1,0.125,0,empty,CD-0722-2
"A8,C8",5910,6929,4227,2702,4157,2378,0,2380,1491,889,1.677165354,1410,3024,895,327,326,1,93,1,0.04601227,0,empty,CD-0722-2
"A8,C9",397857,470233,297027,173206,277967,151125,0,151247,115865,35382,3.274687694,90503,91964,9487,3813,3673,140,711,5,0.053634631,0,hg38,CD-0722-2
"A8,C10",4809,5283,3555,1728,3234,1760,0,1760,1104,656,1.682926829,959,1674,317,149,146,3,50,1,0.123287671,0,empty,CD-0722-2
"A8,C11",4118,4618,3007,1611,2802,1508,0,1508,992,516,1.92248062,855,1604,401,157,154,3,43,1,0.207792208,0,empty,CD-0722-2
"A8,C12",5698,6200,4189,2011,3901,2140,0,2141,1377,764,1.802356021,1182,2212,510,213,209,4,54,2,0.119617225,0,empty,CD-0722-2
"A8,D1",5241,5969,3752,2217,3647,2134,0,2134,1323,811,1.631319359,1254,931,142,51,50,1,26,1,0.08,0,empty,CD-0722-2
"A8,D2",4367,4905,3256,1649,2927,1488,0,1498,949,549,1.72859745,832,2547,753,287,285,2,77,2,0.126315789,0,empty,CD-0722-2
"A8,D3",3751,4234,2638,1596,2588,1477,0,1477,992,485,2.045360825,845,1232,263,109,108,1,41,1,0.083333333,0,empty,CD-0722-2
"A8,D4",2884,3364,2133,1231,1989,1091,0,1091,742,349,2.126074499,656,1140,218,84,84,0,34,0,0.05952381,0,empty,CD-0722-2
"A8,D5",3255,3874,2379,1495,2381,1342,0,1342,843,499,1.689378758,794,1810,527,141,140,1,46,1,0.007142857,0,empty,CD-0722-2
"A8,D6",5358,6127,3695,2432,3773,2264,0,2266,1391,875,1.589714286,1388,2119,580,225,222,3,61,1,0.018018018,0,empty,CD-0722-2
"A8,D7",2968,3354,2149,1205,2029,1078,0,1078,704,374,1.882352941,608,2528,700,247,243,4,62,2,0.086419753,0,empty,CD-0722-2
"A8,D8",3258,3707,2407,1300,2309,1265,0,1265,800,465,1.720430108,747,1227,348,162,159,3,50,1,0.163522013,0,empty,CD-0722-2
"A8,D9",1773,1960,1288,672,1183,622,0,622,385,237,1.624472574,319,1509,392,184,183,1,38,1,0.136612022,0,empty,CD-0722-2
"A8,D10",4187,4891,2979,1912,3023,1725,0,1727,1190,537,2.216014898,1017,917,197,88,88,0,28,0,0.034090909,0,empty,CD-0722-2
"A8,D11",3863,4292,2807,1485,2603,1410,0,1414,883,531,1.662900188,787,2669,699,287,285,2,95,2,0.014035088,0,empty,CD-0722-2
"A8,D12",5261,6071,3774,2297,3626,2018,0,2023,1288,735,1.752380952,1180,3587,1118,449,445,4,119,1,0.031460674,0,empty,CD-0722-2
"A8,E1",5994,6659,4331,2328,4075,2215,0,2215,1360,855,1.590643275,1283,2280,518,224,223,1,66,1,0.121076233,0,empty,CD-0722-2
"A8,E2",456424,545278,330779,214499,320708,187402,1,187605,147207,40398,3.643918016,113103,168822,20912,8431,8233,198,1406,5,0.052714685,0,hg38,CD-0722-2
"A8,E3",2860,3291,2071,1220,2019,1140,0,1140,739,401,1.842892768,648,2132,466,181,180,1,56,1,0.088888889,0,empty,CD-0722-2
"A8,E4",3769,4019,2787,1232,2526,1342,0,1342,843,499,1.689378758,738,2083,653,270,267,3,80,2,0.112359551,0,empty,CD-0722-2
"A8,E5",3495,3920,2660,1260,2406,1214,0,1214,756,458,1.650655022,648,1251,346,121,119,2,37,1,0.025210084,0,empty,CD-0722-2
"A8,E6",53642,61719,38242,23477,36350,20772,0,20787,17766,3021,5.880834161,12220,8494,3026,806,802,4,196,2,0.044887781,0,empty,CD-0722-2
"A8,E7",5607,6250,4086,2164,3765,2017,0,2022,1239,783,1.582375479,1155,2448,535,235,235,0,66,0,0.136170213,0,empty,CD-0722-2
"A8,E8",38532,43232,27181,16051,25879,15456,0,15471,11194,4277,2.617255085,8727,2719,519,255,252,3,86,2,0.099206349,0,empty,CD-0722-2
"A8,E9",2812,3325,2030,1295,1923,1024,1,1025,704,321,2.193146417,609,2784,533,215,213,2,72,1,0.009389671,0,empty,CD-0722-2
"A8,E10",541067,657180,390837,266343,385132,231146,4,231331,185486,45845,4.045937398,140264,181218,33174,13249,13019,230,1956,6,0.0433213,0,hg38,CD-0722-2
"A8,E11",4030,4640,3003,1637,2894,1565,0,1569,1012,557,1.816876122,904,2054,416,159,152,7,48,2,0.125,0,empty,CD-0722-2
"A8,E12",4081,4554,2987,1567,2835,1533,0,1533,965,568,1.698943662,876,1577,297,125,123,2,39,2,0.105691057,0,empty,CD-0722-2
"A8,F1",5171,5751,3713,2038,3568,1926,0,1928,1179,749,1.574098798,1131,1967,407,175,173,2,61,1,0.069364162,0,empty,CD-0722-2
"A8,F2",1518895,1758180,1130888,627292,1017867,569759,0,570186,462425,107761,4.29120925,333242,396805,69395,26861,26430,431,3221,12,0.044078698,0,hg38,CD-0722-2
"A8,F3",357185,390929,275716,115213,230588,108700,2,108794,84366,24428,3.453659735,60823,58910,11439,4416,4347,69,805,4,0.011732229,0,hg38,CD-0722-2
"A8,F4",6147,6854,4468,2386,4245,2263,1,2271,1454,817,1.779681763,1308,700,143,76,73,3,31,2,0.01369863,0,empty,CD-0722-2
"A8,F5",4729,5028,3515,1513,3048,1605,3,1610,1028,582,1.766323024,848,2252,577,265,259,6,76,2,0.038610039,0,empty,CD-0722-2
"A8,F6",4404,5193,3096,2097,3154,1841,0,1841,1148,693,1.656565657,1135,2552,566,234,234,0,52,0,0.209401709,0,empty,CD-0722-2
"A8,F7",5492,6270,4079,2191,3841,2116,0,2119,1366,753,1.814077025,1251,1198,234,94,93,1,34,1,0.021505376,0,empty,CD-0722-2
"A8,F8",3615,4249,2625,1624,2614,1393,0,1395,969,426,2.274647887,824,411,67,35,35,0,22,0,0.028571429,0,empty,CD-0722-2
"A8,F9",4130,4543,3101,1442,2819,1455,0,1455,943,512,1.841796875,796,2399,518,230,226,4,75,2,0.150442478,0,empty,CD-0722-2
"A8,F10",5328,6179,4026,2153,3718,1976,0,1976,1340,636,2.106918239,1130,1364,206,124,123,1,44,1,0.097560976,0,empty,CD-0722-2
"A8,F11",3989,4334,2988,1346,2587,1318,0,1322,847,475,1.783157895,715,1329,313,129,129,0,37,0,0.162790698,0,empty,CD-0722-2
"A8,F12",4439,4963,3257,1706,3017,1647,0,1647,1081,566,1.909893993,915,276,36,23,23,0,12,0,0,0,empty,CD-0722-2
"A8,G1",4887,5613,3576,2037,3440,1833,1,1837,1194,643,1.856920684,1035,2833,696,293,287,6,94,3,0.048780488,0,empty,CD-0722-2
"A8,G2",3711,4282,2629,1653,2569,1499,0,1500,893,607,1.471169687,907,741,225,108,107,1,33,1,0.009345794,0,empty,CD-0722-2
"A8,G3",5298,5787,3925,1862,3554,1921,0,1922,1149,773,1.486416559,1036,1976,541,200,196,4,56,2,0.102040816,0,empty,CD-0722-2
"A8,G4",9836,11328,6903,4425,7047,4373,0,4378,2577,1801,1.430871738,2617,118,9,7,7,0,5,0,0,0,empty,CD-0722-2
"A8,G5",3201,3676,2305,1371,2304,1306,0,1310,883,427,2.067915691,765,1425,375,153,151,2,52,2,0.026490066,0,empty,CD-0722-2
"A8,G6",5029,5534,3757,1777,3361,1758,0,1758,1139,619,1.84006462,957,194,36,27,27,0,16,0,0.074074074,0,empty,CD-0722-2
"A8,G7",3948,4449,2934,1515,2676,1380,0,1383,887,496,1.788306452,791,2677,669,216,215,1,52,1,0.134883721,0,empty,CD-0722-2
"A8,G8",2750,3117,2007,1110,1914,1037,0,1042,684,358,1.910614525,599,1533,230,125,125,0,45,0,0.024,0,empty,CD-0722-2
"A8,G9",3445,3915,2598,1317,2366,1275,0,1275,788,487,1.618069815,728,2142,571,216,212,4,63,3,0.04245283,0,empty,CD-0722-2
"A8,G10",4013,4432,2998,1434,2776,1504,0,1504,945,559,1.690518784,801,1772,490,215,212,3,73,2,0.04245283,0,empty,CD-0722-2
"A8,G11",508365,621296,360916,260380,368180,236186,2,236377,174230,62147,2.803514248,141789,31730,10876,3814,3791,23,849,5,0.034819309,0,hg38,CD-0722-2
"A8,G12",3542,4086,2600,1486,2491,1361,0,1368,857,511,1.677103718,812,2301,433,194,190,4,71,2,0.015789474,0,empty,CD-0722-2
"A8,H1",510432,605424,377855,227569,358272,199594,4,199767,165297,34470,4.795387293,119214,114062,20775,8155,8027,128,1325,6,0.065404261,0,hg38,CD-0722-2
"A8,H2",4131,4688,3002,1686,2763,1512,0,1513,984,529,1.860113422,880,2200,671,246,243,3,68,1,0.024691358,0,empty,CD-0722-2
"A8,H3",3242,3638,2314,1324,2200,1214,0,1214,762,452,1.685840708,708,1682,492,181,181,0,47,0,0.187845304,0,empty,CD-0722-2
"A8,H4",5020,5595,3530,2065,3304,1757,0,1757,1105,652,1.694785276,1027,180,23,12,12,0,7,0,0,0,empty,CD-0722-2
"A8,H5",489099,619576,329117,290459,369503,258058,2,258205,164498,93707,1.7554505,161726,2070,643,267,267,0,96,0,0.056179775,0,hg38,CD-0722-2
"A8,H6",3072,3535,2197,1338,2119,1175,0,1175,779,396,1.967171717,701,1798,449,159,150,9,51,1,0.12,0,empty,CD-0722-2
"A8,H7",630447,776095,432899,343196,467269,313634,6,313907,240769,73138,3.29198228,193437,16714,1025,440,413,27,112,6,0.099273608,0,hg38,CD-0722-2
"A8,H8",3947,4484,2840,1644,2779,1570,0,1574,996,578,1.723183391,909,2501,591,222,220,2,61,2,0.104545455,0,empty,CD-0722-2
"A8,H9",3228,3504,2382,1122,2114,1121,0,1121,762,359,2.122562674,593,1266,292,119,117,2,34,2,0.094017094,0,empty,CD-0722-2
"A8,H10",168041,203429,116388,87041,123522,81489,1,81546,59882,21664,2.764124815,48678,4481,1179,421,417,4,125,2,0.023980815,0,hg38,CD-0722-2
"A8,H11",4318,5161,2934,2227,3140,2066,0,2072,1092,980,1.114285714,1280,66,10,5,5,0,3,0,0,0,empty,CD-0722-2
"A8,H12",3106,3637,2239,1398,2245,1304,0,1307,897,410,2.187804878,793,1423,250,84,78,6,40,2,0.038461538,0,empty,CD-0722-2
"A9,A1",3554,3971,2637,1334,2376,1299,0,1300,841,459,1.832244009,723,997,295,111,108,3,45,2,0.148148148,0,empty,CD-0722-2
"A9,A2",5116,5829,3709,2120,3533,1997,0,2000,1266,734,1.72479564,1136,1612,333,138,138,0,48,0,0.108695652,0,empty,CD-0722-2
"A9,A3",3457,4085,2508,1577,2417,1344,0,1344,852,492,1.731707317,794,1066,316,123,123,0,41,0,0.008130081,0,empty,CD-0722-2
"A9,A4",5790,6621,4239,2382,3820,2031,0,2037,1333,704,1.893465909,1173,920,247,116,116,0,28,0,0.017241379,0,empty,CD-0722-2
"A9,A5",4580,5150,3317,1833,3025,1661,0,1661,1074,587,1.829642249,940,2149,544,214,212,2,51,1,0.080188679,0,empty,CD-0722-2
"A9,A6",4081,4765,3012,1753,2782,1655,0,1655,1002,653,1.534456355,889,2765,597,259,254,5,102,2,0.07480315,0,empty,CD-0722-2
"A9,A7",3582,3945,2641,1304,2353,1315,0,1317,833,484,1.72107438,707,1335,330,119,117,2,42,2,0.042735043,0,empty,CD-0722-2
"A9,A8",2364,2701,1701,1000,1634,910,0,910,614,296,2.074324324,520,2263,633,263,262,1,61,1,0.099236641,0,empty,CD-0722-2
"A9,A9",4994,5524,3807,1717,3245,1658,0,1658,1146,512,2.23828125,885,1497,247,82,81,1,41,1,0.049382716,0,empty,CD-0722-2
"A9,A10",4292,4799,3247,1552,2802,1471,0,1474,934,540,1.72962963,798,468,87,36,36,0,17,0,0.138888889,0,empty,CD-0722-2
"A9,A11",435317,519675,319734,199941,299698,172700,2,172861,137781,35080,3.927622577,102526,87976,12689,5044,4955,89,1051,6,0.071442987,0,hg38,CD-0722-2
"A9,A12",4674,5189,3555,1634,3096,1582,0,1582,1034,548,1.886861314,870,3138,865,345,340,5,92,2,0.073529412,0,empty,CD-0722-2
"A9,B1",3928,4542,2830,1712,2704,1525,0,1526,954,572,1.667832168,904,1348,440,144,143,1,43,1,0.097902098,0,empty,CD-0722-2
"A9,B2",4283,4721,2911,1810,2914,1712,0,1714,1029,685,1.502189781,1002,710,116,50,49,1,24,1,0.020408163,0,empty,CD-0722-2
"A9,B3",3306,3788,2306,1482,2269,1273,0,1273,815,458,1.779475983,766,1340,279,130,128,2,57,2,0.0625,0,empty,CD-0722-2
"A9,B4",3851,4524,2790,1734,2687,1608,0,1610,1032,578,1.785467128,956,1346,268,121,114,7,39,1,0.105263158,0,empty,CD-0722-2
"A9,B5",3972,2480,1517,963,1797,990,0,998,637,361,1.764542936,607,1044,231,103,101,2,27,1,0.099009901,0,empty,CD-0722-2
"A9,B6",4396,5211,3074,2137,3116,1828,0,1828,1134,694,1.634005764,1116,1712,445,196,195,1,55,1,0.020512821,0,empty,CD-0722-2
"A9,B7",4126,4578,3064,1514,2769,1511,0,1513,996,517,1.926499033,833,1457,411,164,164,0,37,0,0.024390244,0,empty,CD-0722-2
"A9,B8",2862,3342,2150,1192,2021,1102,0,1102,727,375,1.938666667,620,937,193,93,93,0,39,0,0,0,empty,CD-0722-2
"A9,B9",5707,6720,4076,2644,3952,2249,0,2251,1406,845,1.663905325,1356,1195,287,116,114,2,47,2,0.096491228,0,empty,CD-0722-2
"A9,B10",2635,2850,1854,996,1769,908,0,910,547,363,1.506887052,536,483,43,25,24,1,15,1,0.166666667,0,empty,CD-0722-2
"A9,B11",6426,7481,4561,2920,4424,2693,0,2696,1472,1224,1.202614379,1604,386,145,62,61,1,17,1,0.213114754,0,empty,CD-0722-2
"A9,B12",3203,3850,2319,1531,2339,1329,0,1329,852,477,1.786163522,802,1588,339,158,154,4,54,2,0.116883117,0,empty,CD-0722-2
"A9,C1",6905,7464,5150,2314,4490,2356,0,2360,1492,868,1.718894009,1315,785,180,77,77,0,30,0,0,0,empty,CD-0722-2
"A9,C2",6014,6786,4323,2463,4059,2257,0,2261,1499,762,1.967191601,1319,2028,487,217,214,3,67,1,0.107476636,0,empty,CD-0722-2
"A9,C3",6119,6871,4529,2342,3968,2116,0,2123,1330,793,1.677175284,1167,895,146,70,65,5,26,2,0.169230769,0,empty,CD-0722-2
"A9,C4",3577,3893,2616,1277,2332,1186,0,1186,768,418,1.837320574,667,1627,259,121,118,3,39,1,0.076271186,0,empty,CD-0722-2
"A9,C5",5254,5955,3819,2136,3443,1911,1,1916,1301,615,2.115447154,1088,1892,440,203,202,1,61,1,0.044554455,0,empty,CD-0722-2
"A9,C6",1228983,1474084,892496,581588,850288,502467,10,502851,405323,97528,4.155965466,303112,189810,28368,11046,10855,191,1826,9,0.055550438,0,hg38,CD-0722-2
"A9,C7",6657,7924,4617,3307,4760,2852,0,2855,1731,1124,1.540035587,1784,364,89,39,39,0,15,0,0.076923077,0,empty,CD-0722-2
"A9,C8",468238,538406,349190,189216,310100,166184,1,166308,128666,37642,3.418149939,97219,143066,17329,6877,6705,172,1304,7,0.055033557,0,hg38,CD-0722-2
"A9,C9",4635,5457,3350,2107,3263,1788,0,1788,1154,634,1.820189274,1110,1398,158,53,53,0,21,0,0,0,empty,CD-0722-2
"A9,C10",5626,6247,4274,1973,3677,1938,0,1938,1259,679,1.854197349,1043,2336,646,202,198,4,53,2,0.01010101,0,empty,CD-0722-2
"A9,C11",4536,5039,3288,1751,3044,1611,0,1614,1047,567,1.846560847,917,2173,531,200,197,3,63,2,0.025380711,0,empty,CD-0722-2
"A9,C12",6474,7128,4755,2373,4276,2228,0,2229,1419,810,1.751851852,1255,1863,495,182,180,2,60,2,0.044444444,0,empty,CD-0722-2
"A9,D1",5865,6813,4104,2709,4064,2353,0,2356,1384,972,1.423868313,1437,834,101,57,55,2,26,1,0.036363636,0,empty,CD-0722-2
"A9,D2",4997,5679,3747,1932,3390,1798,0,1800,1203,597,2.015075377,1022,2815,686,269,269,0,70,0,0.063197026,0,empty,CD-0722-2
"A9,D3",4347,4936,3097,1839,2893,1640,0,1640,1105,535,2.065420561,940,1347,198,117,117,0,50,0,0.170940171,0,empty,CD-0722-2
"A9,D4",3498,4008,2548,1460,2373,1277,0,1278,851,427,1.992974239,749,1150,207,91,90,1,34,1,0.144444444,0,empty,CD-0722-2
"A9,D5",3682,4065,2723,1342,2511,1372,0,1372,885,487,1.81724846,794,1577,372,153,152,1,51,1,0.052631579,0,empty,CD-0722-2
"A9,D6",5982,6977,4252,2725,4058,2391,0,2391,1486,905,1.64198895,1440,1572,464,150,147,3,60,2,0.102040816,0,empty,CD-0722-2
"A9,D7",3139,3498,2353,1145,2135,1142,0,1142,766,376,2.037234043,637,2096,438,195,186,9,70,2,0.037634409,0,empty,CD-0722-2
"A9,D8",4179,4731,3056,1675,2861,1549,0,1550,1004,546,1.838827839,901,1408,318,123,121,2,36,1,0.082644628,0,empty,CD-0722-2
"A9,D9",1979,2179,1465,714,1265,659,0,659,436,223,1.955156951,363,1029,184,76,76,0,32,0,0.052631579,0,empty,CD-0722-2
"A9,D10",3751,4347,2707,1640,2534,1415,0,1418,918,500,1.836,817,810,151,67,66,1,32,1,0.075757576,0,empty,CD-0722-2
"A9,D11",4260,4801,3111,1690,2930,1564,0,1566,1010,556,1.816546763,920,2982,651,257,255,2,79,1,0.050980392,0,empty,CD-0722-2
"A9,D12",5834,6426,4367,2059,3909,2131,0,2131,1359,772,1.760362694,1194,3173,749,296,292,4,105,2,0.113013699,0,empty,CD-0722-2
"A9,E1",514820,601525,373975,227550,344530,196492,2,196630,161345,35285,4.572622928,116275,122383,21261,8084,7950,134,1447,6,0.055597484,0,hg38,CD-0722-2
"A9,E2",195878,232515,137615,94900,142392,89694,1,89747,50004,39743,1.258183831,54753,2060,400,173,171,2,53,1,0.035087719,0,hg38,CD-0722-2
"A9,E3",3399,3903,2551,1352,2310,1245,0,1246,814,432,1.884259259,695,1816,456,192,186,6,55,1,0.096774194,0,empty,CD-0722-2
"A9,E4",4201,4891,3034,1857,2889,1543,0,1544,983,561,1.752228164,914,2521,417,198,195,3,82,1,0.076923077,0,empty,CD-0722-2
"A9,E5",3969,4370,3070,1300,2607,1295,1,1299,865,434,1.993087558,674,1002,180,87,85,2,31,2,0.105882353,0,empty,CD-0722-2
"A9,E6",474556,541939,360599,181340,306241,158033,1,158165,127428,30737,4.145752676,90176,181001,22350,9120,8883,237,1473,6,0.063604638,0,hg38,CD-0722-2
"A9,E7",6253,6993,4667,2326,4186,2268,1,2272,1497,775,1.931612903,1258,2556,616,272,272,0,95,0,0.084558824,0,empty,CD-0722-2
"A9,E8",5414,6022,4049,1973,3565,1852,0,1857,1185,672,1.763392857,1030,2532,532,238,236,2,76,1,0.093220339,0,empty,CD-0722-2
"A9,E9",3091,3494,2216,1278,2016,1091,1,1092,741,351,2.111111111,621,2318,739,268,263,5,76,3,0.015209125,0,empty,CD-0722-2
"A9,E10",3975,4576,2907,1669,2731,1431,0,1432,941,491,1.916496945,836,1564,517,211,210,1,56,1,0.128571429,0,empty,CD-0722-2
"A9,E11",4596,5116,3361,1755,3071,1658,0,1660,1064,596,1.785234899,951,1799,427,184,181,3,53,2,0.038674033,0,empty,CD-0722-2
"A9,E12",4941,5755,3508,2247,3319,1843,0,1843,1166,677,1.722304284,1124,1537,381,146,146,0,59,0,0.075342466,0,empty,CD-0722-2
"A9,F1",5801,6672,4225,2447,4017,2192,0,2201,1333,868,1.535714286,1276,2062,649,228,222,6,69,1,0.067567568,0,empty,CD-0722-2
"A9,F2",4435,4934,3266,1668,2973,1564,0,1566,1019,547,1.862888483,867,2126,467,178,177,1,70,1,0.163841808,0,empty,CD-0722-2
"A9,F3",4470,5003,3300,1703,2909,1532,0,1532,950,582,1.632302405,866,2445,605,215,214,1,62,1,0.112149533,0,empty,CD-0722-2
"A9,F4",6876,7440,5062,2378,4507,2412,0,2414,1584,830,1.908433735,1303,769,244,93,93,0,31,0,0.010752688,0,empty,CD-0722-2
"A9,F5",5467,6060,4030,2030,3559,1849,0,1850,1200,650,1.846153846,1045,2147,466,209,207,2,69,1,0.082125604,0,empty,CD-0722-2
"A9,F6",5118,5802,3611,2191,3452,1985,0,1987,1304,683,1.909224012,1160,2567,519,189,189,0,71,0,0.084656085,0,empty,CD-0722-2
"A9,F7",5996,6871,4429,2442,4166,2306,0,2306,1500,806,1.861042184,1352,1004,312,96,96,0,33,0,0.010416667,0,empty,CD-0722-2
"A9,F8",425226,544064,292309,251755,318911,209922,1,210074,166298,43776,3.798839547,133660,2368,1317,443,442,1,140,1,0.031674208,0,hg38,CD-0722-2
"A9,F9",4687,5286,3491,1795,3137,1661,0,1663,1093,570,1.91754386,936,2636,433,185,183,2,70,1,0.021857923,0,empty,CD-0722-2
"A9,F10",6120,7064,4575,2489,4036,2140,0,2142,1369,773,1.771021992,1178,1610,324,154,152,2,56,1,0.098684211,0,empty,CD-0722-2
"A9,F11",4640,5143,3533,1610,3066,1586,0,1588,1026,562,1.825622776,870,1525,437,184,182,2,53,1,0.159340659,0,empty,CD-0722-2
"A9,F12",487199,548974,367320,181654,313351,162106,1,162278,126452,35826,3.529615363,93197,8651,973,436,430,6,114,2,0.037209302,0,hg38,CD-0722-2
"A9,G1",5742,6461,4292,2169,3929,2082,0,2088,1364,724,1.883977901,1174,3248,759,287,284,3,91,2,0.091549296,0,empty,CD-0722-2
"A9,G2",3463,3826,2401,1425,2334,1334,0,1334,821,513,1.600389864,796,499,91,54,54,0,29,0,0.018518519,0,empty,CD-0722-2
"A9,G3",6464,7029,4772,2257,4141,2231,0,2231,1386,845,1.640236686,1180,2092,414,180,177,3,64,1,0.073446328,0,empty,CD-0722-2
"A9,G4",11536,13519,8148,5371,8056,4957,0,4966,2961,2005,1.47680798,2985,104,12,7,7,0,6,0,0,0,empty,CD-0722-2
"A9,G5",472062,526379,361901,164478,300961,147249,0,147365,111137,36228,3.067710059,82580,50585,4180,1547,1477,70,361,5,0.126607989,0,hg38,CD-0722-2
"A9,G6",5595,6192,4146,2046,3696,1940,0,1942,1286,656,1.960365854,1079,157,59,36,36,0,13,0,0,0,empty,CD-0722-2
"A9,G7",4145,4642,3028,1614,2802,1464,0,1466,984,482,2.041493776,840,2165,320,155,153,2,47,1,0.176470588,0,empty,CD-0722-2
"A9,G8",3087,3418,2332,1086,2116,1134,0,1134,728,406,1.793103448,608,2075,513,262,258,4,76,2,0.011627907,0,empty,CD-0722-2
"A9,G9",442355,507115,331649,175466,291835,156114,0,156256,122013,34243,3.563151593,91059,48088,9517,3588,3518,70,690,4,0.028425242,0,hg38,CD-0722-2
"A9,G10",4710,5244,3499,1745,3141,1717,0,1717,1124,593,1.89544688,960,2338,828,292,289,3,75,2,0.07266436,0,empty,CD-0722-2
"A9,G11",4465,5149,3265,1884,3149,1724,0,1727,1174,553,2.122965642,1067,1315,236,100,95,5,46,1,0.042105263,0,empty,CD-0722-2
"A9,G12",1040497,1228593,760831,467762,711511,403223,2,403534,327345,76189,4.296486369,242914,343989,49620,19888,19503,385,2615,8,0.043634313,0,hg38,CD-0722-2
"A9,H1",3933,4432,2846,1586,2684,1471,0,1472,936,536,1.746268657,857,1380,273,121,121,0,44,0,0.107438017,0,empty,CD-0722-2
"A9,H2",4736,5243,3429,1814,3119,1683,0,1683,1071,612,1.75,942,2262,622,250,250,0,81,0,0.1,0,empty,CD-0722-2
"A9,H3",3793,4419,2771,1648,2645,1465,0,1467,982,485,2.024742268,882,1663,235,154,151,3,74,3,0.006622517,0,empty,CD-0722-2
"A9,H4",5781,6478,4252,2226,3829,2076,0,2079,1361,718,1.895543175,1163,286,63,34,33,1,22,1,0.212121212,0,empty,CD-0722-2
"A9,H5",6194,7094,4546,2548,4097,2295,0,2300,1470,830,1.771084337,1271,2151,546,204,203,1,77,1,0.039408867,0,empty,CD-0722-2
"A9,H6",3532,3958,2460,1498,2372,1312,0,1312,833,479,1.739039666,771,1885,442,189,188,1,51,1,0.042553191,0,empty,CD-0722-2
"A9,H7",4190,4607,3099,1508,2809,1452,0,1452,931,521,1.786948177,826,2240,499,201,197,4,73,1,0.065989848,0,empty,CD-0722-2
"A9,H8",4680,5263,3405,1858,3100,1750,0,1752,1169,583,2.005145798,989,2075,479,217,217,0,67,0,0.069124424,0,empty,CD-0722-2
"A9,H9",3750,4136,2877,1259,2428,1212,0,1212,801,411,1.948905109,650,1223,336,168,166,2,51,1,0.162650602,0,empty,CD-0722-2
"A9,H10",453399,533381,337341,196040,304868,165947,0,166078,127478,38600,3.30253886,98557,93554,9449,3692,3547,145,821,5,0.029320553,0,hg38,CD-0722-2
"A9,H11",4554,5470,3083,2387,3347,2205,0,2206,1208,998,1.210420842,1379,66,4,2,2,0,2,0,0,0,empty,CD-0722-2
"A9,H12",1128039,1373386,808060,565326,783349,473954,2,474332,387924,86408,4.489445422,290707,291812,45709,18157,17850,307,2649,5,0.046946779,0,hg38,CD-0722-2
"A10,A1",464423,552239,344257,207982,322384,180804,1,180958,136248,44710,3.047371953,107560,83249,11739,4535,4439,96,856,5,0.043478261,0,hg38,CD-0722-2
"A10,A2",4099,4626,2989,1637,2815,1571,0,1576,995,581,1.712564544,906,1916,445,175,174,1,62,1,0.022988506,0,empty,CD-0722-2
"A10,A3",2943,3213,2128,1085,1943,1067,0,1067,705,362,1.947513812,612,1143,242,95,93,2,39,2,0.172043011,0,empty,CD-0722-2
"A10,A4",5305,5893,3927,1966,3514,1873,0,1877,1160,717,1.617852162,1034,797,123,46,44,2,25,2,0.204545455,0,empty,CD-0722-2
"A10,A5",3958,4316,2935,1381,2579,1341,0,1341,857,484,1.770661157,729,2112,548,221,214,7,52,2,0.037383178,0,empty,CD-0722-2
"A10,A6",3447,4168,2541,1627,2510,1461,0,1461,941,520,1.809615385,865,2625,726,282,277,5,98,3,0.108303249,0,empty,CD-0722-2
"A10,A7",3189,3712,2294,1418,2192,1264,0,1264,786,478,1.644351464,747,1386,401,185,184,1,52,1,0.016304348,0,empty,CD-0722-2
"A10,A8",1589,1767,1182,585,1106,601,0,601,400,201,1.990049751,334,1742,427,152,152,0,46,0,0.032894737,0,empty,CD-0722-2
"A10,A9",3362,3900,2519,1381,2341,1283,1,1284,849,435,1.951724138,733,1702,378,173,173,0,50,0,0.052023121,0,empty,CD-0722-2
"A10,A10",3617,4029,2764,1265,2351,1212,0,1212,773,439,1.760820046,660,428,20,14,14,0,10,0,0.071428571,0,empty,CD-0722-2
"A10,A11",2777,3031,2064,967,1731,913,0,918,618,300,2.06,457,1506,328,121,118,3,46,1,0.008474576,0,empty,CD-0722-2
"A10,A12",3601,4054,2684,1370,2439,1303,0,1304,845,459,1.840958606,735,3579,974,377,374,3,90,2,0.016042781,0,empty,CD-0722-2
"A10,B1",3534,3951,2540,1411,2354,1363,0,1366,835,531,1.572504708,797,1158,261,102,102,0,39,0,0.049019608,0,empty,CD-0722-2
"A10,B2",635024,748929,434642,314287,439375,266323,0,266492,222237,44255,5.021737657,163874,91331,11132,4436,4344,92,854,4,0.055248619,0,hg38,CD-0722-2
"A10,B3",2758,3171,2028,1143,1921,1089,0,1092,704,388,1.81443299,627,1388,307,139,139,0,58,0,0.028776978,0,empty,CD-0722-2
"A10,B4",2948,3550,2080,1470,2152,1296,0,1296,838,458,1.829694323,789,1347,323,124,122,2,26,2,0.090163934,0,empty,CD-0722-2
"A10,B5",3327,2035,1245,790,1471,805,0,812,523,289,1.809688581,530,1080,156,74,70,4,30,1,0,0,empty,CD-0722-2
"A10,B6",3662,4236,2534,1702,2515,1487,0,1487,900,587,1.533219761,863,1502,338,167,166,1,49,1,0.030120482,0,empty,CD-0722-2
"A10,B7",3662,4107,2667,1440,2447,1309,0,1309,856,453,1.889624724,716,1337,349,119,118,1,35,1,0.13559322,0,empty,CD-0722-2
"A10,B8",2362,2690,1762,928,1575,886,0,886,606,280,2.164285714,477,1148,131,72,72,0,40,0,0,0,empty,CD-0722-2
"A10,B9",4798,5572,3433,2139,3388,1988,0,1994,1275,719,1.773296245,1173,1579,359,143,143,0,52,0,0.020979021,0,empty,CD-0722-2
"A10,B10",2227,2413,1579,834,1518,808,0,809,520,289,1.799307958,472,549,96,40,40,0,16,0,0,0,empty,CD-0722-2
"A10,B11",5262,5842,3724,2118,3572,2089,0,2089,1180,909,1.298129813,1237,226,28,20,20,0,9,0,0,0,empty,CD-0722-2
"A10,B12",2773,3126,1990,1136,1905,1060,0,1060,714,346,2.063583815,609,1641,517,204,204,0,45,0,0.088235294,0,empty,CD-0722-2
"A10,C1",6083,6689,4602,2087,3926,2050,0,2052,1285,767,1.67535854,1087,1017,268,88,88,0,31,0,0.170454545,0,empty,CD-0722-2
"A10,C2",4976,5763,3590,2173,3474,1966,0,1968,1228,740,1.659459459,1180,1885,599,285,284,1,80,1,0.095070423,0,empty,CD-0722-2
"A10,C3",672401,812523,492479,320044,466830,271480,0,271661,219109,52552,4.169375095,163676,71235,9056,3674,3584,90,690,4,0.039341518,0,hg38,CD-0722-2
"A10,C4",2842,3234,2062,1172,2030,1042,1,1043,696,347,2.005763689,651,1748,333,132,132,0,45,0,0.022727273,0,empty,CD-0722-2
"A10,C5",4510,5313,3218,2095,3165,1779,0,1781,1181,600,1.968333333,1082,1812,409,155,155,0,45,0,0.006451613,0,empty,CD-0722-2
"A10,C6",4162,4810,2986,1824,2876,1611,0,1613,1051,562,1.870106762,946,1559,322,120,120,0,37,0,0.041666667,0,empty,CD-0722-2
"A10,C7",702145,855243,510386,344857,488876,289999,3,290233,231519,58714,3.943165174,176045,69979,10817,4117,4024,93,766,7,0.048459245,0,hg38,CD-0722-2
"A10,C8",5360,6049,3948,2101,3700,2044,0,2046,1326,720,1.841666667,1168,3554,962,384,383,1,111,1,0.08616188,0,empty,CD-0722-2
"A10,C9",4975,6047,3662,2385,3523,2027,0,2029,1311,718,1.825905292,1183,1964,376,159,154,5,44,2,0.097402597,0,empty,CD-0722-2
"A10,C10",4764,5468,3502,1966,3291,1809,0,1815,1141,674,1.692878338,1043,2085,482,180,177,3,53,2,0.107344633,0,empty,CD-0722-2
"A10,C11",423561,483977,316188,167789,283644,150737,3,150867,114497,36370,3.14811658,87955,126335,12251,4789,4619,170,922,6,0.051742801,0,hg38,CD-0722-2
"A10,C12",5580,6281,4063,2218,3781,2041,0,2043,1375,668,2.058383234,1156,1721,398,172,171,1,59,1,0.070175439,0,empty,CD-0722-2
"A10,D1",4881,5858,3487,2371,3537,2102,0,2102,1281,821,1.560292326,1255,937,241,109,108,1,30,1,0.268518519,0,empty,CD-0722-2
"A10,D2",4286,4766,3189,1577,2843,1443,1,1446,943,503,1.874751491,787,2609,555,220,217,3,88,2,0.032258065,0,empty,CD-0722-2
"A10,D3",3587,3935,2513,1422,2367,1313,0,1313,897,416,2.15625,748,1333,337,168,166,2,60,1,0.108433735,0,empty,CD-0722-2
"A10,D4",2751,3169,2005,1164,1949,1101,0,1102,669,433,1.545034642,632,1357,239,110,110,0,29,0,0.227272727,0,empty,CD-0722-2
"A10,D5",3278,3674,2418,1256,2231,1221,0,1221,801,420,1.907142857,692,1868,587,216,214,2,65,2,0.042056075,0,empty,CD-0722-2
"A10,D6",5262,6136,3670,2466,3604,2196,0,2197,1314,883,1.48810872,1305,1891,616,218,216,2,64,2,0.069444444,0,empty,CD-0722-2
"A10,D7",2927,3249,2177,1072,1898,1005,0,1005,665,340,1.955882353,547,2202,424,188,188,0,67,0,0.010638298,0,empty,CD-0722-2
"A10,D8",3283,3636,2429,1207,2211,1208,0,1208,765,443,1.726862302,672,1741,370,147,145,2,51,2,0.006896552,0,empty,CD-0722-2
"A10,D9",1735,1849,1225,624,1125,588,0,588,389,199,1.954773869,348,1638,338,123,112,11,39,2,0.008928571,0,empty,CD-0722-2
"A10,D10",4273,5074,3112,1962,2968,1673,0,1673,1149,524,2.192748092,968,1018,214,89,87,2,29,1,0.24137931,0,empty,CD-0722-2
"A10,D11",3857,4317,2875,1442,2627,1383,0,1387,901,486,1.853909465,803,3047,890,317,315,2,84,1,0.098412698,0,empty,CD-0722-2
"A10,D12",4983,5718,3678,2040,3401,1865,0,1867,1241,626,1.982428115,1099,3284,892,340,339,1,91,1,0.088495575,0,empty,CD-0722-2
"A10,E1",9728,11101,7166,3935,6530,3510,0,3510,2270,1240,1.830645161,2043,2635,609,256,255,1,68,1,0.031372549,0,empty,CD-0722-2
"A10,E2",4185,4956,2997,1959,2920,1649,0,1654,1027,627,1.637958533,967,1858,386,175,168,7,48,1,0.023809524,0,empty,CD-0722-2
"A10,E3",2865,3271,2109,1162,2015,1071,0,1071,672,399,1.684210526,635,2061,714,294,293,1,73,1,0.064846416,0,empty,CD-0722-2
"A10,E4",392660,453639,294487,159152,262210,140612,1,140710,111253,29457,3.776793292,82100,129788,18813,7184,7036,148,1284,7,0.038800455,0,hg38,CD-0722-2
"A10,E5",426871,476666,330166,146500,274920,136430,1,136561,112342,24219,4.638589537,75148,34241,7290,2641,2596,45,529,5,0.018875193,0,hg38,CD-0722-2
"A10,E6",6287,7313,4440,2873,4341,2475,0,2475,1557,918,1.696078431,1500,3400,914,361,360,1,90,1,0.102777778,0,empty,CD-0722-2
"A10,E7",5092,5692,3754,1938,3330,1750,0,1754,1151,603,1.908789386,979,3256,673,273,269,4,65,2,0.204460967,0,empty,CD-0722-2
"A10,E8",4710,5307,3581,1726,3159,1634,0,1637,1079,558,1.933691756,894,2522,590,214,214,0,65,0,0.08411215,0,empty,CD-0722-2
"A10,E9",811905,1011148,584189,426959,585190,361736,1,361978,293337,68641,4.273495433,222963,336300,57958,22241,21945,296,3008,7,0.075643655,0,hg38,CD-0722-2
"A10,E10",3496,4087,2549,1538,2407,1357,0,1358,883,475,1.858947368,809,1442,416,181,181,0,45,0,0.027624309,0,empty,CD-0722-2
"A10,E11",3955,4457,2805,1652,2733,1507,0,1507,945,562,1.681494662,882,2180,498,181,178,3,57,2,0.050561798,0,empty,CD-0722-2
"A10,E12",4001,4534,2894,1640,2765,1539,0,1539,988,551,1.793103448,904,2223,600,209,204,5,55,2,0.176470588,0,empty,CD-0722-2
"A10,F1",477705,539664,358341,181323,311729,164653,3,164777,126500,38277,3.304856702,94377,45474,7650,2881,2832,49,600,3,0.012711864,0,hg38,CD-0722-2
"A10,F2",4412,4983,3162,1821,3059,1678,0,1678,1072,606,1.768976898,997,3149,463,201,197,4,63,3,0.025380711,0,empty,CD-0722-2
"A10,F3",3808,4174,2819,1355,2496,1337,0,1337,897,440,2.038636364,722,2999,903,328,326,2,76,2,0.122699387,0,empty,CD-0722-2
"A10,F4",6025,6560,4487,2073,3942,2032,2,2035,1322,713,1.854137447,1125,813,222,91,89,2,35,2,0.04494382,0,empty,CD-0722-2
"A10,F5",4762,5329,3483,1846,3182,1697,0,1697,1065,632,1.685126582,950,2132,559,237,235,2,64,1,0.2,0,empty,CD-0722-2
"A10,F6",4311,4895,3130,1765,2882,1605,0,1605,991,614,1.614006515,910,2977,722,263,259,4,71,1,0.166023166,0,empty,CD-0722-2
"A10,F7",5497,6251,4012,2239,3670,2007,0,2010,1317,693,1.9004329,1170,1016,228,79,78,1,30,1,0.166666667,0,empty,CD-0722-2
"A10,F8",3469,3957,2488,1469,2491,1406,0,1406,954,452,2.110619469,835,455,81,52,49,3,23,1,0.183673469,0,empty,CD-0722-2
"A10,F9",4081,4475,3032,1443,2718,1439,0,1439,954,485,1.967010309,799,2829,520,231,225,6,90,2,0.044444444,0,empty,CD-0722-2
"A10,F10",5237,5836,3849,1987,3506,1781,0,1783,1152,631,1.825673534,1004,1583,389,165,161,4,54,2,0.049689441,0,empty,CD-0722-2
"A10,F11",3789,4200,2855,1345,2470,1288,0,1288,866,422,2.052132701,691,1236,228,105,103,2,41,1,0.13592233,0,empty,CD-0722-2
"A10,F12",4378,5030,3168,1862,2984,1669,0,1671,1095,576,1.901041667,970,194,31,15,15,0,10,0,0.066666667,0,empty,CD-0722-2
"A10,G1",4700,5279,3490,1789,3105,1634,0,1634,1070,564,1.897163121,912,2583,541,178,176,2,62,2,0.102272727,0,empty,CD-0722-2
"A10,G2",2958,3200,2047,1153,1977,1105,0,1109,706,403,1.751861042,651,389,68,38,38,0,29,0,0,0,empty,CD-0722-2
"A10,G3",5521,6385,3933,2452,3660,2068,0,2070,1288,782,1.647058824,1157,2551,620,220,217,3,84,1,0.078341014,0,empty,CD-0722-2
"A10,G4",10293,12108,7217,4891,7177,4394,0,4394,2534,1860,1.362365591,2623,181,43,28,28,0,15,0,0,0,empty,CD-0722-2
"A10,G5",3492,4083,2538,1545,2485,1405,0,1405,939,466,2.015021459,869,1974,316,135,132,3,45,2,0.022727273,0,empty,CD-0722-2
"A10,G6",4971,5695,3767,1928,3371,1815,0,1817,1206,611,1.973813421,1057,145,9,6,5,1,4,1,0,0,empty,CD-0722-2
"A10,G7",3685,4070,2701,1369,2463,1264,0,1268,828,440,1.881818182,730,2513,639,188,188,0,52,0,0.127659574,0,empty,CD-0722-2
"A10,G8",2644,2879,1939,940,1780,919,0,920,583,337,1.729970326,510,1885,338,133,132,1,41,1,0.060606061,0,empty,CD-0722-2
"A10,G9",3191,3686,2339,1347,2211,1191,0,1194,776,418,1.85645933,704,2554,563,242,240,2,76,2,0.041666667,0,empty,CD-0722-2
"A10,G10",4030,4723,2931,1792,2830,1629,0,1632,1019,613,1.662316476,949,1987,522,235,233,2,88,1,0.077253219,0,empty,CD-0722-2
"A10,G11",414331,465449,315033,150416,269146,136050,2,136169,102611,33558,3.057720961,77252,121994,13691,5084,4943,141,922,8,0.03762897,0,hg38,CD-0722-2
"A10,G12",3507,4012,2530,1482,2390,1309,0,1309,865,444,1.948198198,766,2404,467,232,228,4,80,1,0.057017544,0,empty,CD-0722-2
"A10,H1",430995,518448,308936,209512,301731,179827,1,179981,142997,36984,3.866455765,109146,66846,10129,3877,3777,100,826,5,0.037331215,0,hg38,CD-0722-2
"A10,H2",3927,4239,2777,1462,2622,1412,0,1414,944,470,2.008510638,811,2088,595,268,260,8,64,2,0.023076923,0,empty,CD-0722-2
"A10,H3",3189,3604,2388,1216,2101,1131,0,1131,764,367,2.081743869,628,1471,327,115,112,3,48,2,0.035714286,0,empty,CD-0722-2
"A10,H4",4937,5495,3627,1868,3226,1782,0,1783,1102,681,1.618208517,965,267,16,12,12,0,6,0,0.583333333,0,empty,CD-0722-2
"A10,H5",5151,5748,3720,2028,3474,1934,0,1934,1269,665,1.908270677,1100,2001,581,271,265,6,77,1,0.116981132,0,empty,CD-0722-2
"A10,H6",3012,3735,2092,1643,2198,1292,0,1294,854,440,1.940909091,799,1706,495,187,186,1,54,1,0.021505376,0,empty,CD-0722-2
"A10,H7",3661,4143,2689,1454,2469,1333,0,1333,910,423,2.151300236,740,2148,565,250,248,2,66,1,0.036290323,0,empty,CD-0722-2
"A10,H8",14784,17968,10651,7317,10623,6127,0,6133,4639,1494,3.105087015,3739,1974,319,164,164,0,63,0,0.018292683,0,empty,CD-0722-2
"A10,H9",2994,3343,2249,1094,1975,1015,0,1015,662,353,1.875354108,557,1482,346,130,124,6,39,2,0.040322581,0,empty,CD-0722-2
"A10,H10",412501,486633,304494,182139,279490,157002,1,157120,124147,32973,3.765110848,93203,134844,15533,6218,6036,182,1178,8,0.050695825,0,hg38,CD-0722-2
"A10,H11",4019,4963,2657,2306,2930,1947,0,1949,1053,896,1.175223214,1268,78,10,5,5,0,3,0,0,0,empty,CD-0722-2
"A10,H12",2934,3241,2082,1159,1965,1124,0,1127,761,366,2.079234973,652,1688,273,128,127,1,43,1,0.251968504,0,empty,CD-0722-2
"A11,A1",3305,3842,2427,1415,2386,1344,0,1346,846,500,1.692,793,1185,233,107,106,1,33,1,0.066037736,0,empty,CD-0722-2
"A11,A2",6214,6997,4626,2371,4168,2269,0,2272,1449,823,1.760631835,1270,2576,453,190,186,4,62,2,0.220430108,0,empty,CD-0722-2
"A11,A3",3321,3737,2435,1302,2238,1245,0,1245,799,446,1.791479821,721,1417,227,92,91,1,45,1,0.054945055,0,empty,CD-0722-2
"A11,A4",5800,6503,4246,2257,3930,2161,0,2163,1348,815,1.65398773,1225,1046,176,71,71,0,30,0,0.028169014,0,empty,CD-0722-2
"A11,A5",4365,4756,3222,1534,2886,1515,0,1520,973,547,1.778793419,857,2044,334,163,160,3,70,2,0.04375,0,empty,CD-0722-2
"A11,A6",3739,4235,2730,1505,2608,1484,0,1486,960,526,1.825095057,848,2714,719,323,317,6,102,2,0.059936909,0,empty,CD-0722-2
"A11,A7",3481,3938,2524,1414,2412,1349,0,1351,868,483,1.797101449,774,1582,404,173,170,3,57,2,0.005882353,0,empty,CD-0722-2
"A11,A8",2225,2465,1644,821,1507,836,0,836,579,257,2.252918288,463,2123,525,221,219,2,67,2,0.109589041,0,empty,CD-0722-2
"A11,A9",3440,3897,2526,1371,2329,1220,0,1220,813,407,1.997542998,688,1699,297,142,142,0,48,0,0.211267606,0,empty,CD-0722-2
"A11,A10",277235,338579,200668,137911,199343,118971,0,119072,90098,28974,3.109615517,72587,7030,1294,499,497,2,109,2,0.056338028,0,hg38,CD-0722-2
"A11,A11",2979,3402,2198,1204,2109,1106,0,1108,741,367,2.019073569,642,1947,502,193,192,1,69,1,0.0625,0,empty,CD-0722-2
"A11,A12",1591014,1879877,1152586,727291,1063361,647342,2,647830,457759,190071,2.408357929,380942,499232,100574,38108,37624,484,3874,10,0.052865192,0,hg38,CD-0722-2
"A11,B1",3914,4355,2886,1469,2672,1498,0,1498,988,510,1.937254902,844,1203,256,106,105,1,44,1,0,0,empty,CD-0722-2
"A11,B2",4422,5144,3025,2119,2995,1782,0,1784,1146,638,1.796238245,1080,838,136,58,56,2,16,1,0,0,empty,CD-0722-2
"A11,B3",3432,3939,2447,1492,2403,1322,0,1322,867,455,1.905494505,792,1392,320,153,153,0,63,0,0.019607843,0,empty,CD-0722-2
"A11,B4",341028,396157,256311,139846,230612,123951,1,124052,92551,31501,2.938033713,72399,112220,10863,4247,4096,151,847,5,0.070556641,0,hg38,CD-0722-2
"A11,B5",3852,2293,1387,906,1623,902,0,914,573,341,1.680351906,577,1430,199,89,86,3,39,2,0.058139535,0,empty,CD-0722-2
"A11,B6",4333,5137,3051,2086,3043,1782,0,1785,1124,661,1.700453858,1112,1536,316,138,134,4,41,2,0.082089552,0,empty,CD-0722-2
"A11,B7",4054,4597,3050,1547,2825,1510,0,1514,1008,506,1.992094862,828,1397,332,116,116,0,46,0,0.034482759,0,empty,CD-0722-2
"A11,B8",2774,3262,2045,1217,1967,1102,0,1104,707,397,1.780856423,662,1320,214,94,92,2,41,1,0.032608696,0,empty,CD-0722-2
"A11,B9",5482,6267,3995,2272,3824,2127,0,2128,1307,821,1.591961023,1272,1215,341,142,140,2,50,2,0.042857143,0,empty,CD-0722-2
"A11,B10",2725,3080,1920,1160,1878,1065,0,1068,656,412,1.59223301,629,622,97,38,37,1,19,1,0,0,empty,CD-0722-2
"A11,B11",6701,7722,4837,2885,4685,2849,0,2849,1529,1320,1.158333333,1673,360,19,13,12,1,9,1,0,0,empty,CD-0722-2
"A11,B12",3331,3721,2437,1284,2258,1206,0,1206,776,430,1.804651163,664,1613,425,179,178,1,55,1,0.061797753,0,empty,CD-0722-2
"A11,C1",29692,33766,22515,11251,19309,10113,0,10124,7406,2718,2.724797645,5672,4549,938,351,347,4,82,2,0.144092219,0,empty,CD-0722-2
"A11,C2",5526,6267,4022,2245,3712,2080,0,2082,1366,716,1.907821229,1157,2243,475,207,205,2,60,2,0.034146341,0,empty,CD-0722-2
"A11,C3",582396,686097,438092,248005,394404,213869,3,214040,165231,48809,3.385256817,125760,35020,4967,2080,2035,45,449,4,0.03980344,0,hg38,CD-0722-2
"A11,C4",480674,555986,359107,196879,322218,174738,0,174868,140037,34831,4.020470271,101115,155086,28665,11302,11120,182,1764,6,0.067715827,0,hg38,CD-0722-2
"A11,C5",5086,5768,3715,2053,3531,1963,0,1964,1287,677,1.901033973,1128,1759,469,215,213,2,68,1,0.037558685,0,empty,CD-0722-2
"A11,C6",505710,582382,378812,203570,343198,184184,0,184327,142079,42248,3.362975762,107796,32512,4551,1784,1744,40,432,3,0.032683486,0,hg38,CD-0722-2
"A11,C7",6113,7447,4250,3197,4432,2725,0,2725,1647,1078,1.527829314,1691,464,120,64,63,1,24,1,0.015873016,0,empty,CD-0722-2
"A11,C8",1127282,1303122,840687,462435,742275,413019,2,413330,327586,85744,3.820512222,238167,386328,69041,27608,27215,393,3224,11,0.03986772,0,hg38,CD-0722-2
"A11,C9",4420,5333,3239,2094,3063,1744,0,1744,1114,630,1.768253968,1056,2065,517,183,183,0,45,0,0.06557377,0,empty,CD-0722-2
"A11,C10",5368,6026,4014,2012,3546,1885,0,1885,1229,656,1.87347561,1082,1875,357,156,154,2,54,2,0.045454545,0,empty,CD-0722-2
"A11,C11",4381,5106,3112,1994,3081,1758,0,1760,1162,598,1.943143813,1039,2057,487,191,189,2,67,2,0.08994709,0,empty,CD-0722-2
"A11,C12",6264,7056,4606,2450,4208,2284,0,2286,1483,803,1.846824408,1279,2254,683,250,247,3,74,1,0.024291498,0,empty,CD-0722-2
"A11,D1",5393,6303,3726,2577,3822,2229,0,2231,1298,933,1.391211147,1325,863,113,60,59,1,28,1,0.050847458,0,empty,CD-0722-2
"A11,D2",18004,20304,13874,6430,11656,5803,0,5806,4084,1722,2.371660859,3214,4372,1631,615,605,10,160,2,0.092561983,0,empty,CD-0722-2
"A11,D3",4101,4981,2915,2066,2963,1657,0,1658,1129,529,2.134215501,1073,1418,265,121,120,1,41,1,0.083333333,0,empty,CD-0722-2
"A11,D4",3842,4567,2797,1770,2772,1559,0,1559,1010,549,1.839708561,942,1412,253,104,104,0,41,0,0.038461538,0,empty,CD-0722-2
"A11,D5",3561,4158,2647,1511,2541,1404,0,1406,881,525,1.678095238,818,1528,381,174,173,1,70,1,0.098265896,0,empty,CD-0722-2
"A11,D6",5848,6562,4167,2395,3970,2290,0,2293,1413,880,1.605681818,1323,2144,542,217,209,8,55,2,0.052631579,0,empty,CD-0722-2
"A11,D7",3210,3373,2350,1023,2096,1065,0,1067,734,333,2.204204204,578,2312,480,198,196,2,66,2,0.107142857,0,empty,CD-0722-2
"A11,D8",4050,4501,2983,1518,2685,1438,0,1442,984,458,2.148471616,806,1468,354,161,159,2,60,2,0.012578616,0,empty,CD-0722-2
"A11,D9",1889,2087,1377,710,1262,647,0,652,425,227,1.872246696,362,1469,493,215,212,3,52,3,0.056603774,0,empty,CD-0722-2
"A11,D10",4263,4717,3046,1671,2902,1661,1,1664,1054,610,1.727868852,940,772,135,81,80,1,41,1,0.075,0,empty,CD-0722-2
"A11,D11",4210,4656,3098,1558,2817,1499,0,1500,973,527,1.84629981,820,2736,667,271,268,3,93,1,0.123134328,0,empty,CD-0722-2
"A11,D12",5633,6357,4173,2184,3820,2055,0,2056,1303,753,1.730411687,1182,3958,933,377,366,11,129,2,0.131147541,0,empty,CD-0722-2
"A11,E1",6520,7489,4713,2776,4372,2491,0,2491,1584,907,1.746416759,1427,2764,823,281,280,1,77,1,0.089285714,0,empty,CD-0722-2
"A11,E2",636721,811945,448665,363280,473672,305255,2,305440,246776,58664,4.2066003,192645,40393,12681,4652,4628,24,911,2,0.079083838,0,hg38,CD-0722-2
"A11,E3",3025,3399,2216,1183,2126,1159,0,1161,744,417,1.784172662,666,1952,504,213,208,5,66,1,0.100961538,0,empty,CD-0722-2
"A11,E4",4399,5010,3137,1873,3020,1697,0,1697,1109,588,1.886054422,1022,1927,421,220,217,3,82,3,0.124423963,0.333333333,empty,CD-0722-2
"A11,E5",4109,4428,3024,1404,2660,1344,0,1344,867,477,1.817610063,746,1275,339,145,144,1,43,1,0.125,0,empty,CD-0722-2
"A11,E6",7151,8074,5301,2773,4849,2619,0,2619,1662,957,1.736677116,1524,3787,953,380,378,2,110,1,0.052910053,0,empty,CD-0722-2
"A11,E7",6057,6699,4413,2286,4009,2147,0,2150,1419,731,1.941176471,1218,2929,717,254,253,1,96,1,0.067193676,0,empty,CD-0722-2
"A11,E8",5009,5242,3740,1502,3251,1672,0,1672,1127,545,2.067889908,897,2546,612,251,246,5,75,2,0.073170732,0,empty,CD-0722-2
"A11,E9",3085,3524,2278,1246,2143,1166,0,1167,778,389,2,677,2257,327,161,159,2,77,2,0.044025157,0,empty,CD-0722-2
"A11,E10",3770,4223,2751,1472,2501,1335,0,1335,874,461,1.895878525,742,1860,543,241,237,4,58,2,0.227848101,0,empty,CD-0722-2
"A11,E11",4434,4990,3234,1756,2888,1572,0,1574,995,579,1.718480138,863,2032,442,217,216,1,64,1,0.217592593,0,empty,CD-0722-2
"A11,E12",4820,5388,3493,1895,3293,1820,0,1822,1187,635,1.869291339,1021,1926,385,154,147,7,61,2,0.013605442,0,empty,CD-0722-2
"A11,F1",5843,6520,4200,2320,3857,2100,0,2106,1381,725,1.904827586,1176,2255,647,276,272,4,87,2,0.040441176,0,empty,CD-0722-2
"A11,F2",4750,5464,3415,2049,3262,1835,1,1838,1220,618,1.974110032,1058,3182,892,354,345,9,85,3,0.2,0,empty,CD-0722-2
"A11,F3",4185,4515,3097,1418,2737,1438,0,1439,956,483,1.979296066,759,2802,650,284,281,3,69,3,0.113879004,0,empty,CD-0722-2
"A11,F4",6594,7429,4929,2500,4548,2397,1,2403,1614,789,2.045627376,1377,894,213,86,84,2,37,1,0.011904762,0,empty,CD-0722-2
"A11,F5",5304,5828,3843,1985,3507,1855,0,1861,1212,649,1.867488444,1069,2117,568,252,249,3,73,2,0.032128514,0,empty,CD-0722-2
"A11,F6",4744,5605,3389,2216,3310,1868,0,1871,1191,680,1.751470588,1136,2579,603,244,242,2,63,1,0.119834711,0,empty,CD-0722-2
"A11,F7",5737,6472,4252,2220,3858,2108,0,2113,1384,729,1.898491084,1191,1115,275,106,105,1,48,1,0.00952381,0,empty,CD-0722-2
"A11,F8",4120,4791,3027,1764,2939,1635,0,1635,1069,566,1.88869258,937,374,53,34,33,1,17,1,0.03030303,0,empty,CD-0722-2
"A11,F9",4622,5130,3495,1635,3047,1621,0,1623,1107,516,2.145348837,875,3475,994,377,371,6,107,2,0.04851752,0,empty,CD-0722-2
"A11,F10",6066,6744,4506,2238,4045,2136,0,2136,1388,748,1.855614973,1172,1851,513,214,214,0,62,0,0.014018692,0,empty,CD-0722-2
"A11,F11",799409,932787,585783,347004,535895,302925,0,303168,259420,43748,5.92987108,178590,274026,40189,16789,16419,370,2424,11,0.083257202,0,hg38,CD-0722-2
"A11,F12",5405,5947,3888,2059,3506,1916,0,1919,1222,697,1.753228121,1073,263,60,27,26,1,19,1,0,0,empty,CD-0722-2
"A11,G1",5461,5997,4133,1864,3677,1889,0,1893,1230,663,1.85520362,1036,2568,642,277,275,2,91,1,0.021818182,0,empty,CD-0722-2
"A11,G2",3396,3937,2373,1564,2392,1400,0,1400,874,526,1.661596958,846,797,132,85,82,3,42,2,0.097560976,0,empty,CD-0722-2
"A11,G3",6038,6435,4420,2015,3930,2161,0,2163,1325,838,1.581145585,1149,2542,661,252,252,0,80,0,0.119047619,0,empty,CD-0722-2
"A11,G4",11449,13130,8127,5003,7770,4687,0,4697,2886,1811,1.593594699,2710,245,29,19,19,0,14,0,0.052631579,0,empty,CD-0722-2
"A11,G5",3516,4037,2572,1465,2386,1297,0,1297,824,473,1.742071882,740,1746,421,170,167,3,66,2,0.113772455,0,empty,CD-0722-2
"A11,G6",5697,6360,4140,2220,3835,2089,0,2092,1399,693,2.018759019,1218,299,53,37,37,0,15,0,0,0,empty,CD-0722-2
"A11,G7",4180,4680,3134,1546,2871,1483,0,1484,956,528,1.810606061,819,2602,843,307,306,1,79,1,0.04248366,0,empty,CD-0722-2
"A11,G8",3013,3357,2232,1125,2045,1090,0,1090,685,405,1.691358025,595,1734,331,153,150,3,57,2,0.06,0,empty,CD-0722-2
"A11,G9",3862,4287,2803,1484,2524,1314,0,1314,885,429,2.062937063,747,2542,581,234,232,2,74,1,0.051724138,0,empty,CD-0722-2
"A11,G10",4358,4931,3236,1695,3031,1656,0,1663,1033,630,1.63968254,979,2366,642,297,297,0,98,0,0.164983165,0,empty,CD-0722-2
"A11,G11",4293,4849,3088,1761,2929,1580,0,1583,1002,581,1.724612737,906,1753,371,141,138,3,57,1,0.02173913,0,empty,CD-0722-2
"A11,G12",939376,1181509,674569,506940,690627,429335,1,429654,363709,65945,5.51533854,267472,346829,63771,24996,24652,344,3011,8,0.061658283,0,hg38,CD-0722-2
"A11,H1",303718,378281,205583,172698,222870,152133,3,152214,101302,50912,1.989747014,94475,1493,264,96,95,1,48,1,0.021052632,0,empty,CD-0722-2
"A11,H2",4655,5272,3379,1893,3178,1765,0,1768,1174,594,1.976430976,988,2525,582,239,237,2,79,1,0.067510549,0,empty,CD-0722-2
"A11,H3",506385,620341,360093,260248,359759,216619,1,216762,174237,42525,4.097283951,134308,104817,18318,7097,6977,120,1194,7,0.06564426,0,hg38,CD-0722-2
"A11,H4",5583,6485,4092,2393,3753,2046,0,2046,1347,699,1.927038627,1214,243,109,31,30,1,16,1,0.2,0,empty,CD-0722-2
"A11,H5",6171,7019,4463,2556,4167,2314,0,2315,1509,806,1.872208437,1337,2096,601,199,195,4,83,2,0.066666667,0,empty,CD-0722-2
"A11,H6",3720,4265,2708,1557,2567,1430,0,1430,939,491,1.912423625,838,1920,469,220,219,1,69,1,0.02283105,0,empty,CD-0722-2
"A11,H7",4131,4546,3075,1471,2765,1451,0,1451,980,471,2.080679406,794,2256,471,214,213,1,82,1,0.042253521,0,empty,CD-0722-2
"A11,H8",4649,5358,3321,2037,3188,1808,0,1813,1160,653,1.776416539,1098,2067,534,218,213,5,66,2,0.154929577,0,empty,CD-0722-2
"A11,H9",3677,4096,2696,1400,2481,1310,0,1312,857,455,1.883516484,748,1406,279,126,125,1,39,1,0.016,0,empty,CD-0722-2
"A11,H10",3399,3826,2461,1365,2348,1287,0,1287,874,413,2.11622276,767,1915,352,185,183,2,69,2,0.038251366,0,empty,CD-0722-2
"A11,H11",4368,5189,3028,2161,3095,1989,0,1992,1087,905,1.201104972,1179,134,13,5,5,0,4,0,0,0,empty,CD-0722-2
"A11,H12",382339,466490,265103,201387,274454,180686,1,180789,128872,51917,2.482269777,110603,2553,698,222,218,4,83,1,0.096330275,0,hg38,CD-0722-2
"A12,A1",3752,4307,2658,1649,2639,1478,0,1478,995,483,2.060041408,836,1011,218,104,103,1,39,1,0.009708738,0,empty,CD-0722-2
"A12,A2",5133,5767,3813,1954,3548,1953,0,1953,1231,722,1.70498615,1081,1823,416,167,165,2,56,2,0.006060606,0,empty,CD-0722-2
"A12,A3",3483,3918,2506,1412,2401,1361,0,1361,842,519,1.622350674,795,1117,294,130,125,5,47,1,0.056,0,empty,CD-0722-2
"A12,A4",6129,7184,4415,2769,4274,2410,0,2415,1598,817,1.955936353,1422,802,139,57,56,1,20,1,0.232142857,0,empty,CD-0722-2
"A12,A5",4630,5253,3351,1902,3086,1690,0,1690,1065,625,1.704,969,2087,417,230,228,2,68,1,0.057017544,0,empty,CD-0722-2
"A12,A6",309551,363361,234766,128595,210074,113047,0,113136,87774,25362,3.460846936,65680,143028,17626,7015,6863,152,1161,7,0.067171791,0,hg38,CD-0722-2
"A12,A7",3622,4209,2666,1543,2560,1477,0,1477,902,575,1.568695652,854,1661,328,137,137,0,50,0,0.167883212,0,empty,CD-0722-2
"A12,A8",2043,2490,1488,1002,1520,859,0,859,576,283,2.035335689,546,1890,473,221,219,2,77,1,0.03652968,0,empty,CD-0722-2
"A12,A9",3844,4342,2842,1500,2593,1393,0,1393,910,483,1.884057971,752,2186,662,241,236,5,59,3,0.093220339,0,empty,CD-0722-2
"A12,A10",257740,333466,175519,157947,195843,136487,0,136592,91700,44892,2.04268021,85703,2719,398,148,144,4,45,1,0.173611111,0,hg38,CD-0722-2
"A12,A11",3142,3364,2347,1017,2045,1045,0,1045,683,362,1.886740331,541,1454,306,128,126,2,42,1,0.126984127,0,empty,CD-0722-2
"A12,A12",486412,557490,364062,193428,317359,170227,1,170377,133321,37056,3.597824914,98139,217125,31101,11972,11773,199,1814,8,0.046377304,0,hg38,CD-0722-2
"A12,B1",3958,4613,2798,1815,2854,1629,0,1629,1015,614,1.653094463,992,1697,463,163,162,1,41,1,0.092592593,0,empty,CD-0722-2
"A12,B2",4287,4889,2892,1997,3028,1816,0,1818,1132,686,1.650145773,1103,485,75,31,31,0,14,0,0.032258065,0,empty,CD-0722-2
"A12,B3",3693,4345,2683,1662,2674,1520,0,1520,987,533,1.851782364,918,1693,333,152,152,0,60,0,0.059210526,0,empty,CD-0722-2
"A12,B4",3901,4505,2789,1716,2687,1550,0,1554,1023,531,1.926553672,935,1195,296,130,127,3,48,1,0.031496063,0,empty,CD-0722-2
"A12,B5",5147,3668,2290,1378,2502,1423,0,1431,995,436,2.282110092,866,1383,310,117,116,1,37,1,0.086206897,0,empty,CD-0722-2
"A12,B6",4239,4798,3000,1798,2888,1678,0,1680,1026,654,1.568807339,956,2066,442,145,144,1,51,1,0.027777778,0,empty,CD-0722-2
"A12,B7",4073,4600,2959,1641,2793,1503,0,1503,1004,499,2.012024048,882,1144,272,114,111,3,42,2,0.054054054,0,empty,CD-0722-2
"A12,B8",3137,3700,2344,1356,2223,1191,0,1193,763,430,1.774418605,722,1298,291,131,130,1,50,1,0.015384615,0,empty,CD-0722-2
"A12,B9",5594,6598,4048,2550,3892,2252,0,2253,1449,804,1.802238806,1348,1471,415,175,174,1,55,1,0.097701149,0,empty,CD-0722-2
"A12,B10",374853,415414,265792,149622,250071,134960,6,135253,104143,31110,3.347573128,79568,45090,6207,2395,2345,50,485,4,0.058422175,0,hg38,CD-0722-2
"A12,B11",6487,7482,4547,2935,4484,2696,0,2699,1533,1166,1.314751286,1613,461,71,27,26,1,22,1,0.038461538,0,empty,CD-0722-2
"A12,B12",3517,4165,2565,1600,2454,1355,0,1358,915,443,2.065462754,789,2266,507,168,165,3,59,1,0.072727273,0,empty,CD-0722-2
"A12,C1",7180,7988,5351,2637,4812,2527,0,2527,1543,984,1.568089431,1422,1192,144,69,68,1,31,1,0.014705882,0,empty,CD-0722-2
"A12,C2",6048,6878,4404,2474,3983,2214,0,2214,1413,801,1.764044944,1259,2739,747,314,311,3,95,1,0.006430868,0,empty,CD-0722-2
"A12,C3",6259,7154,4563,2591,4348,2427,0,2435,1503,932,1.612660944,1404,1220,322,142,142,0,43,0,0.112676056,0,empty,CD-0722-2
"A12,C4",3573,3867,2665,1202,2365,1193,0,1195,738,457,1.61487965,643,2156,645,235,230,5,60,2,0.12173913,0,empty,CD-0722-2
"A12,C5",5239,5918,3879,2039,3514,1910,0,1912,1278,634,2.015772871,1095,1835,296,146,146,0,67,0,0.01369863,0,empty,CD-0722-2
"A12,C6",4691,5424,3372,2052,3234,1783,0,1783,1184,599,1.976627713,1045,1853,468,176,171,5,57,1,0.052631579,0,empty,CD-0722-2
"A12,C7",1157096,1440040,824974,615066,823610,521003,4,521368,426283,95085,4.483178209,322684,8265,1366,611,611,0,159,0,0.093289689,0,hg38,CD-0722-2
"A12,C8",6950,8137,5034,3103,4806,2679,0,2683,1750,933,1.875669882,1575,3126,540,241,236,5,95,2,0.029661017,0,empty,CD-0722-2
"A12,C9",4630,5271,3282,1989,3163,1719,0,1721,1087,634,1.714511041,995,1544,404,156,156,0,50,0,0.096153846,0,empty,CD-0722-2
"A12,C10",5601,6411,4140,2271,3831,2092,0,2094,1409,685,2.056934307,1192,2091,411,168,166,2,47,2,0,0,empty,CD-0722-2
"A12,C11",4847,5417,3524,1893,3286,1796,0,1796,1218,578,2.107266436,1019,2279,533,215,212,3,61,2,0.089622642,0,empty,CD-0722-2
"A12,C12",6445,7128,4645,2483,4367,2325,0,2332,1509,823,1.833535844,1377,2358,882,303,302,1,73,1,0.013245033,0,empty,CD-0722-2
"A12,D1",5973,6976,4249,2727,4093,2421,0,2422,1497,925,1.618378378,1426,862,97,52,51,1,25,1,0.039215686,0,empty,CD-0722-2
"A12,D2",506247,579287,377287,202000,333380,181092,2,181262,144510,36752,3.93203091,103531,246581,52769,19779,19488,291,2564,8,0.040024631,0,hg38,CD-0722-2
"A12,D3",4349,4796,3164,1632,2839,1596,0,1596,1062,534,1.988764045,836,1841,313,137,135,2,49,1,0.037037037,0,empty,CD-0722-2
"A12,D4",3079,3432,2268,1164,2102,1133,0,1136,724,412,1.757281553,627,1512,381,145,142,3,48,2,0.281690141,0,empty,CD-0722-2
"A12,D5",3921,4585,2880,1705,2732,1519,0,1522,1004,518,1.938223938,876,2041,541,206,201,5,54,2,0.089552239,0,empty,CD-0722-2
"A12,D6",5947,6983,4174,2809,4159,2501,0,2503,1512,991,1.525731584,1491,2226,469,199,196,3,71,1,0.096938776,0,empty,CD-0722-2
"A12,D7",3325,3779,2478,1301,2344,1267,0,1267,893,374,2.387700535,742,2137,414,198,196,2,60,1,0.081632653,0,empty,CD-0722-2
"A12,D8",3949,4549,2902,1647,2788,1518,0,1518,1034,484,2.136363636,909,1392,292,136,134,2,55,1,0.074626866,0,empty,CD-0722-2
"A12,D9",2191,2508,1501,1007,1455,781,0,781,547,234,2.337606838,478,1360,318,108,105,3,40,3,0.057142857,0,empty,CD-0722-2
"A12,D10",4569,5444,3227,2217,3285,1904,0,1908,1263,645,1.958139535,1168,1367,394,156,152,4,41,2,0.092105263,0,empty,CD-0722-2
"A12,D11",4285,4899,3201,1698,2907,1562,0,1562,987,575,1.716521739,848,3041,714,282,281,1,90,1,0.067615658,0,empty,CD-0722-2
"A12,D12",5841,6707,4237,2470,3963,2194,1,2203,1434,769,1.864759428,1266,3825,875,356,356,0,118,0,0.064606742,0,empty,CD-0722-2
"A12,E1",6748,7719,4798,2921,4446,2453,0,2453,1487,966,1.539337474,1416,2210,507,204,198,6,59,3,0.03030303,0,empty,CD-0722-2
"A12,E2",4953,5802,3507,2295,3494,2003,0,2009,1291,718,1.798050139,1199,2122,363,180,177,3,60,2,0.02259887,0,empty,CD-0722-2
"A12,E3",3234,3668,2389,1279,2275,1239,0,1239,819,420,1.95,709,2570,644,293,285,8,83,2,0.049122807,0,empty,CD-0722-2
"A12,E4",4565,5099,3383,1716,3121,1727,1,1729,1126,603,1.867330017,960,2853,616,244,241,3,81,1,0.128630705,0,empty,CD-0722-2
"A12,E5",4165,4962,3111,1851,2933,1569,0,1571,1049,522,2.009578544,951,1641,410,163,163,0,48,0,0.024539877,0,empty,CD-0722-2
"A12,E6",7574,8975,5498,3477,5204,2916,0,2919,1872,1047,1.787965616,1702,3438,681,328,322,6,101,2,0.027950311,0,empty,CD-0722-2
"A12,E7",6923,7723,5146,2577,4683,2487,0,2489,1678,811,2.069050555,1381,3277,630,271,261,10,97,2,0.042145594,0,empty,CD-0722-2
"A12,E8",5572,6248,4155,2093,3724,1959,0,1960,1303,657,1.98325723,1099,3099,791,333,331,2,91,1,0.039274924,0,empty,CD-0722-2
"A12,E9",3640,4251,2668,1583,2515,1392,0,1396,911,485,1.878350515,797,3132,643,249,246,3,95,1,0.036585366,0,empty,CD-0722-2
"A12,E10",3956,4408,2896,1512,2650,1442,0,1444,943,501,1.882235529,793,2057,553,195,193,2,54,1,0.191709845,0,empty,CD-0722-2
"A12,E11",4962,5812,3588,2224,3472,1916,0,1917,1283,634,2.023659306,1157,2087,394,138,137,1,64,1,0.03649635,0,empty,CD-0722-2
"A12,E12",1724435,2115163,1235766,879397,1201635,734799,3,735309,595861,139448,4.27299782,454148,214925,36169,13598,13406,192,2133,6,0.054826197,0,hg38,CD-0722-2
"A12,F1",5967,6703,4373,2330,4089,2194,0,2195,1436,759,1.891963109,1234,2299,379,174,171,3,75,2,0.052631579,0,empty,CD-0722-2
"A12,F2",4779,5555,3443,2112,3261,1805,0,1805,1199,606,1.978547855,1077,2969,934,343,337,6,96,2,0.115727003,0,empty,CD-0722-2
"A12,F3",4463,5044,3198,1846,3021,1677,0,1681,1105,576,1.918402778,995,2895,688,337,334,3,92,2,0.128742515,0,empty,CD-0722-2
"A12,F4",6896,7523,5207,2316,4621,2353,0,2359,1584,775,2.043870968,1267,892,177,81,80,1,42,1,0.05,0,empty,CD-0722-2
"A12,F5",5696,6389,4247,2142,3731,1901,0,1913,1241,672,1.84672619,1072,2366,771,262,262,0,81,0,0.106870229,0,empty,CD-0722-2
"A12,F6",5168,5833,3715,2118,3528,1990,0,1991,1300,691,1.881331404,1150,3255,661,272,270,2,72,1,0.066666667,0,empty,CD-0722-2
"A12,F7",6118,7066,4431,2635,4155,2304,0,2308,1502,806,1.863523573,1328,1211,280,116,116,0,40,0,0.129310345,0,empty,CD-0722-2
"A12,F8",4609,5206,3437,1769,3185,1681,0,1688,1131,557,2.030520646,969,516,60,43,41,2,25,2,0,0,empty,CD-0722-2
"A12,F9",4823,5381,3609,1772,3287,1752,0,1752,1179,573,2.057591623,948,3213,649,248,243,5,91,2,0.057613169,0,empty,CD-0722-2
"A12,F10",6128,6848,4560,2288,4079,2106,0,2108,1390,718,1.935933148,1176,2068,596,241,238,3,56,2,0.197478992,0,empty,CD-0722-2
"A12,F11",873117,991955,663511,328444,566477,296120,2,296350,233061,63289,3.682488268,168332,242299,25867,10144,9841,303,1688,9,0.08108932,0,hg38,CD-0722-2
"A12,F12",5180,6040,3753,2287,3629,1998,0,1999,1249,750,1.665333333,1172,238,51,25,25,0,14,0,0.08,0,empty,CD-0722-2
"A12,G1",5593,6281,4142,2139,3758,2001,0,2004,1311,693,1.891774892,1134,3315,727,289,286,3,99,1,0.062937063,0,empty,CD-0722-2
"A12,G2",3372,3869,2335,1534,2388,1380,0,1380,909,471,1.929936306,835,624,147,55,54,1,33,1,0.055555556,0,empty,CD-0722-2
"A12,G3",6152,6667,4526,2141,4036,2210,0,2212,1307,905,1.444198895,1187,3053,720,244,240,4,83,2,0.066666667,0,empty,CD-0722-2
"A12,G4",607274,702438,452893,249545,402712,219142,3,219319,172666,46653,3.701069599,127504,1784,209,93,88,5,33,2,0.011363636,0,empty,CD-0722-2
"A12,G5",3891,4394,2825,1569,2691,1482,0,1484,930,554,1.678700361,857,2015,342,167,165,2,65,2,0.006060606,0,empty,CD-0722-2
"A12,G6",5834,6653,4289,2364,3973,2188,0,2188,1427,761,1.875164258,1247,204,65,31,29,2,14,1,0.068965517,0,empty,CD-0722-2
"A12,G7",4353,4966,3291,1675,2992,1564,0,1566,1086,480,2.2625,860,3046,781,283,280,3,79,1,0.028571429,0,empty,CD-0722-2
"A12,G8",507304,582314,380398,201916,334245,177744,2,177867,134185,43682,3.071860263,103732,188050,21904,8348,8112,236,1432,7,0.051158777,0,hg38,CD-0722-2
"A12,G9",3987,4716,2901,1815,2766,1510,0,1512,954,558,1.709677419,908,2592,477,201,201,0,74,0,0.069651741,0,empty,CD-0722-2
"A12,G10",4631,5298,3412,1886,3189,1769,0,1774,1134,640,1.771875,1024,2702,716,319,312,7,83,2,0.073717949,0,empty,CD-0722-2
"A12,G11",4568,5185,3349,1836,3144,1697,0,1700,1095,605,1.809917355,998,1739,431,173,173,0,57,0,0.132947977,0,empty,CD-0722-2
"A12,G12",4001,4487,2888,1599,2775,1514,0,1514,947,567,1.670194004,910,2399,536,214,213,1,92,1,0.037558685,0,empty,CD-0722-2
"A12,H1",4320,4699,3122,1577,2938,1540,0,1544,1053,491,2.144602851,902,1616,338,123,121,2,50,1,0.049586777,0,empty,CD-0722-2
"A12,H2",4843,5487,3587,1900,3350,1821,0,1825,1175,650,1.807692308,1061,2059,375,152,151,1,61,1,0.165562914,0,empty,CD-0722-2
"A12,H3",4109,4748,2869,1879,2802,1590,0,1594,1073,521,2.05950096,946,1800,276,125,124,1,53,1,0.112903226,0,empty,CD-0722-2
"A12,H4",5790,6602,4261,2341,3994,2175,0,2175,1423,752,1.892287234,1270,282,90,53,53,0,23,0,0.056603774,0,empty,CD-0722-2
"A12,H5",687431,840147,492145,348002,479821,289540,0,289729,231659,58070,3.98930601,177401,169063,28352,10750,10571,179,1809,7,0.03433923,0,hg38,CD-0722-2
"A12,H6",3874,4422,2790,1632,2644,1482,0,1482,986,496,1.987903226,860,2088,458,216,215,1,71,1,0.023255814,0,empty,CD-0722-2
"A12,H7",4548,4995,3296,1699,3018,1596,1,1599,1070,529,2.02268431,905,2107,480,224,223,1,87,1,0.076233184,0,empty,CD-0722-2
"A12,H8",466785,555520,342623,212897,318634,181134,1,181265,141927,39338,3.607885505,108998,143083,25665,10040,9887,153,1597,8,0.054414888,0,hg38,CD-0722-2
"A12,H9",3686,4016,2739,1277,2489,1277,0,1279,879,400,2.1975,720,1455,475,162,158,4,49,2,0.03164557,0,empty,CD-0722-2
"A12,H10",443271,527532,326313,201219,303190,171090,2,171220,131162,40058,3.274302262,102956,119955,17124,6547,6373,174,1158,4,0.034363722,0,hg38,CD-0722-2
"A12,H11",4593,5417,3154,2263,3277,2137,0,2137,1153,984,1.171747967,1295,142,11,9,8,1,5,1,0,0,empty,CD-0722-2
"A12,H12",3647,4226,2515,1711,2505,1513,0,1513,1021,492,2.075203252,910,1538,340,122,121,1,40,1,0.074380165,0,empty,CD-0722-2
"B1,A1",3699,4264,2619,1645,2515,1424,0,1428,881,547,1.610603291,811,1105,280,138,136,2,38,1,0.161764706,0,empty,CD-0722-2
"B1,A2",5443,6151,3991,2160,3771,2183,0,2183,1345,838,1.605011933,1254,2032,490,206,200,6,55,3,0.065,0,empty,CD-0722-2
"B1,A3",435743,509508,323325,186183,293608,160760,0,160914,130066,30848,4.216351141,95479,88792,15372,5837,5735,102,1023,6,0.044986922,0,hg38,CD-0722-2
"B1,A4",5829,6609,4285,2324,3977,2234,0,2236,1425,811,1.757090012,1297,844,255,80,80,0,23,0,0.025,0,empty,CD-0722-2
"B1,A5",4816,5256,3587,1669,3164,1662,0,1666,1066,600,1.776666667,893,2203,483,183,183,0,50,0,0.016393443,0,empty,CD-0722-2
"B1,A6",5058,5990,3681,2309,3541,2090,0,2090,1342,748,1.794117647,1221,2640,630,239,234,5,81,1,0.11965812,0,empty,CD-0722-2
"B1,A7",3665,4191,2682,1509,2560,1495,0,1500,966,534,1.808988764,845,1595,435,166,166,0,53,0,0.024096386,0,empty,CD-0722-2
"B1,A8",2069,2349,1556,793,1414,767,0,767,498,269,1.851301115,428,1854,446,163,162,1,51,1,0.00617284,0,empty,CD-0722-2
"B1,A9",4032,4633,3018,1615,2669,1435,0,1435,928,507,1.830374753,800,1747,468,206,204,2,49,2,0.06372549,0,empty,CD-0722-2
"B1,A10",4629,5132,3542,1590,3065,1587,0,1587,966,621,1.555555556,872,439,61,41,39,2,18,2,0.025641026,0,empty,CD-0722-2
"B1,A11",3200,3652,2438,1214,2145,1101,0,1103,736,367,2.005449591,603,1877,531,217,213,4,56,1,0.046948357,0,empty,CD-0722-2
"B1,A12",4919,5585,3689,1896,3227,1637,0,1637,1093,544,2.009191176,920,3112,905,321,318,3,87,2,0.078616352,0,empty,CD-0722-2
"B1,B1",3944,4269,2764,1505,2605,1436,0,1436,892,544,1.639705882,835,1532,255,112,111,1,41,1,0.126126126,0,empty,CD-0722-2
"B1,B2",4445,5154,3025,2129,3110,1876,0,1877,1174,703,1.669985775,1166,501,51,30,29,1,9,1,0,0,empty,CD-0722-2
"B1,B3",3473,3977,2500,1477,2423,1369,0,1370,864,506,1.707509881,787,1595,350,118,116,2,43,2,0.094827586,0,empty,CD-0722-2
"B1,B4",3992,4728,2870,1858,2834,1693,0,1693,1073,620,1.730645161,991,1288,297,133,132,1,43,1,0.128787879,0,empty,CD-0722-2
"B1,B5",3911,2395,1467,928,1704,972,0,982,650,332,1.957831325,600,1057,222,85,83,2,35,2,0,0,empty,CD-0722-2
"B1,B6",4284,5111,3056,2055,3094,1830,0,1830,1111,719,1.545201669,1085,1177,306,122,121,1,38,1,0,0,empty,CD-0722-2
"B1,B7",621461,742807,461511,281296,425124,241075,1,241239,194617,46622,4.174359744,142457,117716,16427,6187,6045,142,1190,6,0.044665012,0,hg38,CD-0722-2
"B1,B8",267670,333208,181525,151683,195786,134927,1,135036,100089,34947,2.864022663,82166,2567,396,166,164,2,54,2,0.030487805,0,hg38,CD-0722-2
"B1,B9",5710,6675,4099,2576,3953,2311,0,2313,1422,891,1.595959596,1338,1350,337,144,144,0,63,0,0.027777778,0,empty,CD-0722-2
"B1,B10",2613,2688,1799,889,1683,904,0,909,601,308,1.951298701,499,340,28,22,22,0,13,0,0,0,empty,CD-0722-2
"B1,B11",6688,7778,4684,3094,4618,2757,0,2757,1528,1229,1.243287225,1657,237,10,6,6,0,6,0,0,0,empty,CD-0722-2
"B1,B12",3593,4114,2672,1442,2435,1317,0,1317,876,441,1.986394558,739,1675,526,178,177,1,56,1,0.073446328,0,empty,CD-0722-2
"B1,C1",6958,7639,5180,2459,4538,2390,0,2392,1512,880,1.718181818,1306,1064,259,107,106,1,29,1,0.169811321,0,empty,CD-0722-2
"B1,C2",5665,6512,3884,2628,3864,2215,0,2215,1388,827,1.678355502,1313,2061,522,181,176,5,66,2,0.085227273,0,empty,CD-0722-2
"B1,C3",5863,6731,4264,2467,4077,2269,0,2269,1495,774,1.931524548,1290,1245,375,147,146,1,44,1,0.095890411,0,empty,CD-0722-2
"B1,C4",3528,3982,2645,1337,2427,1281,0,1283,818,465,1.759139785,729,2013,397,161,158,3,51,1,0.056962025,0,empty,CD-0722-2
"B1,C5",6093,7108,4477,2631,4099,2220,0,2223,1510,713,2.117812062,1271,1401,372,155,153,2,50,1,0.130718954,0,empty,CD-0722-2
"B1,C6",573648,632051,444897,187154,364344,175756,1,175924,141741,34183,4.146534827,95885,26046,2315,798,779,19,232,4,0.03465982,0,hg38,CD-0722-2
"B1,C7",1214942,1498221,875804,622417,848562,514002,1,514378,420747,93631,4.493671968,316666,47127,7395,2872,2822,50,579,4,0.063075833,0,hg38,CD-0722-2
"B1,C8",480427,558058,351548,206510,322192,182573,0,182703,145709,36994,3.938719792,106572,69957,13340,5220,5154,66,1000,3,0.048117967,0,hg38,CD-0722-2
"B1,C9",4755,5540,3523,2017,3251,1822,0,1825,1155,670,1.723880597,1066,1698,355,156,153,3,37,2,0.189542484,0,empty,CD-0722-2
"B1,C10",5373,6103,3908,2195,3613,1942,0,1945,1200,745,1.610738255,1137,2318,515,205,201,4,52,2,0.034825871,0,empty,CD-0722-2
"B1,C11",4500,5150,3309,1841,3129,1680,0,1682,1117,565,1.97699115,994,1735,307,140,139,1,45,1,0.115107914,0,empty,CD-0722-2
"B1,C12",1416626,1714614,1029914,684700,968330,584257,4,584773,467523,117250,3.987402985,357562,168290,30494,11320,11093,227,1811,7,0.055620662,0,hg38,CD-0722-2
"B1,D1",5856,6815,4249,2566,4060,2346,0,2348,1436,912,1.574561404,1390,831,177,84,84,0,32,0,0.023809524,0,empty,CD-0722-2
"B1,D2",395258,441293,302836,138457,254704,128686,0,128823,100861,27962,3.607073886,71251,79979,12108,4580,4514,66,936,4,0.010855117,0,hg38,CD-0722-2
"B1,D3",904411,1049092,677638,371454,599890,321578,2,321850,251478,70372,3.573551981,188176,288639,36789,14755,14439,316,2154,6,0.058245031,0,hg38,CD-0722-2
"B1,D4",3501,4058,2632,1426,2419,1333,0,1337,887,450,1.971111111,756,1309,246,104,99,5,35,2,0.080808081,0,empty,CD-0722-2
"B1,D5",3667,4209,2778,1431,2581,1320,0,1320,825,495,1.666666667,779,1366,257,124,123,1,58,1,0.073170732,0,empty,CD-0722-2
"B1,D6",6048,7160,4204,2956,4261,2552,0,2552,1511,1041,1.451488953,1568,1959,488,216,214,2,68,1,0.046728972,0,empty,CD-0722-2
"B1,D7",3477,3893,2582,1311,2351,1251,0,1253,839,414,2.026570048,709,2272,663,266,262,4,75,1,0.08778626,0,empty,CD-0722-2
"B1,D8",4255,4744,3104,1640,2900,1557,0,1562,1048,514,2.038910506,880,1817,545,227,227,0,71,0,0.083700441,0,empty,CD-0722-2
"B1,D9",2119,2387,1563,824,1413,718,0,718,487,231,2.108225108,426,1461,172,63,62,1,25,1,0.096774194,0,empty,CD-0722-2
"B1,D10",4166,4779,3055,1724,2887,1641,0,1643,1053,590,1.784745763,940,921,254,114,114,0,28,0,0.00877193,0,empty,CD-0722-2
"B1,D11",4472,5012,3350,1662,2984,1554,0,1554,967,587,1.647359455,844,2510,555,235,230,5,67,2,0.117391304,0,empty,CD-0722-2
"B1,D12",542718,618710,414035,204675,355682,184364,0,184509,139804,44705,3.127256459,105812,171828,22597,8560,8351,209,1396,8,0.050053886,0,hg38,CD-0722-2
"B1,E1",7162,8187,5063,3124,4767,2658,0,2660,1671,989,1.68958544,1565,2394,520,236,234,2,70,2,0.106837607,0,empty,CD-0722-2
"B1,E2",376108,477369,252618,224751,281069,190302,2,190412,147234,43178,3.409930983,121372,14852,7888,2998,2996,2,628,2,0.012016021,0,hg38,CD-0722-2
"B1,E3",3276,3752,2425,1327,2290,1235,0,1235,816,419,1.947494033,730,2211,393,145,143,2,53,2,0.111888112,0,empty,CD-0722-2
"B1,E4",4290,4885,3051,1834,2937,1657,0,1657,1057,600,1.761666667,948,2396,563,244,240,4,69,1,0.125,0,empty,CD-0722-2
"B1,E5",3995,4472,3048,1424,2701,1383,0,1383,912,471,1.936305732,779,1582,399,196,194,2,57,2,0.025773196,0,empty,CD-0722-2
"B1,E6",7447,8536,5454,3082,5052,2811,0,2811,1850,961,1.925078044,1602,3444,642,308,305,3,103,2,0.144262295,0,empty,CD-0722-2
"B1,E7",6810,7558,5048,2510,4471,2333,0,2333,1521,812,1.873152709,1298,4177,769,281,272,9,95,2,0.036764706,0,empty,CD-0722-2
"B1,E8",5209,5663,3834,1829,3354,1742,0,1742,1115,627,1.77830941,950,3299,613,272,266,6,84,2,0.033834586,0,empty,CD-0722-2
"B1,E9",3412,3924,2543,1381,2330,1288,0,1288,867,421,2.059382423,730,2787,738,289,288,1,80,1,0.052083333,0,empty,CD-0722-2
"B1,E10",3789,4330,2843,1487,2634,1428,0,1428,902,526,1.714828897,832,1676,284,121,121,0,43,0,0.223140496,0,empty,CD-0722-2
"B1,E11",4734,5492,3489,2003,3284,1774,0,1774,1138,636,1.789308176,1020,1617,416,164,163,1,42,1,0.006134969,0,empty,CD-0722-2
"B1,E12",5048,5866,3634,2232,3461,1920,0,1920,1252,668,1.874251497,1161,2107,478,204,200,4,64,2,0.11,0,empty,CD-0722-2
"B1,F1",5920,6657,4329,2328,3924,2135,0,2135,1354,781,1.733674776,1208,2284,490,154,152,2,66,2,0.085526316,0,empty,CD-0722-2
"B1,F2",6020,6758,4417,2341,4010,2098,0,2102,1375,727,1.89133425,1193,3298,762,273,268,5,75,2,0.111940299,0,empty,CD-0722-2
"B1,F3",6149,6894,4546,2348,4029,2172,0,2178,1408,770,1.828571429,1257,2157,404,210,206,4,68,2,0.019417476,0,empty,CD-0722-2
"B1,F4",6772,7389,4957,2432,4459,2322,2,2328,1524,804,1.895522388,1318,788,143,79,78,1,36,1,0.076923077,0,empty,CD-0722-2
"B1,F5",4915,5341,3670,1671,3250,1645,0,1647,1086,561,1.935828877,917,2348,491,183,182,1,53,1,0.098901099,0,empty,CD-0722-2
"B1,F6",5302,6028,3822,2206,3503,1962,0,1965,1238,727,1.702888583,1158,2498,702,260,258,2,65,2,0.124031008,0,empty,CD-0722-2
"B1,F7",5975,6681,4406,2275,3934,2096,0,2096,1316,780,1.687179487,1187,1067,290,123,123,0,40,0,0.138211382,0,empty,CD-0722-2
"B1,F8",536200,608118,412089,196029,349997,177836,2,177997,133808,44189,3.028083912,100475,15113,2008,767,752,15,185,3,0.04787234,0,hg38,CD-0722-2
"B1,F9",4658,5214,3418,1796,3043,1631,0,1631,1062,569,1.866432337,934,2405,566,248,244,4,73,2,0.110655738,0,empty,CD-0722-2
"B1,F10",5935,6635,4417,2218,3954,2056,0,2061,1319,742,1.777628032,1160,1990,610,203,202,1,52,1,0.00990099,0,empty,CD-0722-2
"B1,F11",4642,5466,3512,1954,3288,1791,0,1792,1194,598,1.996655518,1042,1664,340,184,183,1,51,1,0,0,empty,CD-0722-2
"B1,F12",5229,5977,3857,2120,3568,1973,0,1976,1271,705,1.802836879,1160,240,29,23,22,1,12,1,0,0,empty,CD-0722-2
"B1,G1",5309,5840,3965,1875,3516,1833,0,1834,1191,643,1.852255054,1015,3048,651,263,261,2,88,2,0.045977011,0,empty,CD-0722-2
"B1,G2",3368,3788,2368,1420,2193,1266,0,1266,820,446,1.838565022,731,779,256,109,109,0,46,0,0.018348624,0,empty,CD-0722-2
"B1,G3",6364,7129,4643,2486,4188,2286,0,2286,1389,897,1.548494983,1248,2088,481,213,210,3,70,2,0.133333333,0,empty,CD-0722-2
"B1,G4",603750,683073,458749,224324,389823,200473,1,200658,157868,42790,3.689366674,114103,1444,308,129,128,1,36,1,0.0234375,0,hg38,CD-0722-2
"B1,G5",4004,4551,2920,1631,2702,1479,0,1479,993,486,2.043209877,852,1740,336,150,147,3,51,2,0.027210884,0,empty,CD-0722-2
"B1,G6",5380,5933,4057,1876,3541,1899,0,1900,1257,643,1.954898911,1015,161,34,12,12,0,8,0,0.25,0,empty,CD-0722-2
"B1,G7",4211,4811,3205,1606,2830,1439,0,1443,910,533,1.707317073,804,2541,856,284,284,0,67,0,0.059859155,0,empty,CD-0722-2
"B1,G8",3220,3556,2297,1259,2192,1156,0,1158,733,425,1.724705882,692,1454,360,138,135,3,49,2,0.214814815,0,empty,CD-0722-2
"B1,G9",829748,990247,624636,365611,563001,315788,2,316039,257259,58780,4.376641715,186886,226365,32012,12570,12318,252,1983,10,0.038074363,0,hg38,CD-0722-2
"B1,G10",6687,7318,4889,2429,4362,2320,0,2320,1489,831,1.791817088,1295,3127,667,258,257,1,73,1,0.073929961,0,empty,CD-0722-2
"B1,G11",4613,5108,3466,1642,3078,1614,0,1618,1059,559,1.894454383,888,1298,285,107,101,6,40,2,0.089108911,0,empty,CD-0722-2
"B1,G12",3888,4377,2672,1705,2693,1551,0,1551,996,555,1.794594595,901,2754,592,246,244,2,71,2,0.090163934,0,empty,CD-0722-2
"B1,H1",4210,4716,3060,1656,2772,1494,0,1495,944,551,1.713248639,863,1295,316,133,127,6,48,2,0,0,empty,CD-0722-2
"B1,H2",4581,5213,3313,1900,3176,1782,0,1788,1160,628,1.847133758,1049,2448,802,310,305,5,87,1,0.059016393,0,empty,CD-0722-2
"B1,H3",3940,4403,2761,1642,2650,1457,1,1460,992,468,2.11965812,866,1386,283,122,122,0,43,0,0.016393443,0,empty,CD-0722-2
"B1,H4",7507,7974,5573,2401,4633,2152,0,2154,1375,779,1.76508344,1242,174,37,25,24,1,16,1,0.041666667,0,empty,CD-0722-2
"B1,H5",990879,1185990,738744,447246,666553,379272,1,379556,312266,67290,4.640600386,226527,256089,39348,15860,15518,342,2111,5,0.081904885,0,hg38,CD-0722-2
"B1,H6",3929,4442,2975,1467,2640,1482,0,1482,977,505,1.934653465,820,1824,330,172,172,0,44,0,0.23255814,0,empty,CD-0722-2
"B1,H7",4405,4955,3233,1722,3054,1618,0,1622,1109,513,2.161793372,967,2610,626,251,242,9,78,2,0.053719008,0,empty,CD-0722-2
"B1,H8",5092,5941,3702,2239,3556,2048,0,2048,1333,715,1.864335664,1218,1945,423,189,178,11,67,3,0.050561798,0,empty,CD-0722-2
"B1,H9",3724,4093,2835,1258,2414,1253,0,1253,845,408,2.071078431,664,1073,267,95,92,3,36,1,0.010869565,0,empty,CD-0722-2
"B1,H10",3956,4425,2990,1435,2660,1368,1,1373,978,395,2.475949367,797,1795,308,114,111,3,54,2,0.153153153,0,empty,CD-0722-2
"B1,H11",5256,6208,3563,2645,3719,2364,0,2365,1256,1109,1.132551849,1442,79,8,8,8,0,7,0,0,0,empty,CD-0722-2
"B1,H12",3756,4264,2703,1561,2543,1471,0,1475,958,517,1.852998066,848,1634,346,125,123,2,47,2,0.097560976,0,empty,CD-0722-2
"B2,A1",4181,4814,3013,1801,2921,1685,0,1685,1068,617,1.73095624,973,1346,328,131,131,0,35,0,0.030534351,0,empty,CD-0722-2
"B2,A2",6392,7372,4673,2699,4306,2445,0,2451,1517,934,1.624197002,1434,1551,305,133,132,1,40,1,0.007575758,0,empty,CD-0722-2
"B2,A3",3655,4218,2605,1613,2554,1411,1,1414,963,451,2.135254989,877,1058,203,101,101,0,38,0,0.089108911,0,empty,CD-0722-2
"B2,A4",6546,7687,4782,2905,4513,2519,0,2522,1623,899,1.805339266,1483,575,82,40,40,0,19,0,0.1,0,empty,CD-0722-2
"B2,A5",5548,6327,4073,2254,3670,1994,0,1996,1261,735,1.715646259,1172,2550,740,241,233,8,51,2,0.08583691,0,empty,CD-0722-2
"B2,A6",10257,11700,7788,3912,7029,3650,0,3653,2592,1061,2.442978322,2115,2638,599,226,224,2,72,2,0.0625,0,empty,CD-0722-2
"B2,A7",4279,5062,3047,2015,3035,1758,0,1759,1087,672,1.617559524,1096,1103,241,99,97,2,39,2,0.072164948,0,empty,CD-0722-2
"B2,A8",2563,2907,1930,977,1742,935,0,935,611,324,1.885802469,510,1496,283,128,125,3,41,2,0.264,0,empty,CD-0722-2
"B2,A9",5976,7095,4384,2711,4150,2321,0,2321,1583,738,2.14498645,1383,1681,435,176,175,1,51,1,0.24,0,empty,CD-0722-2
"B2,A10",6444,7312,4740,2572,4277,2392,0,2393,1499,894,1.676733781,1341,286,39,28,28,0,15,0,0,0,empty,CD-0722-2
"B2,A11",3830,4234,2884,1350,2578,1306,0,1309,862,447,1.928411633,724,1887,544,198,198,0,52,0,0.121212121,0,empty,CD-0722-2
"B2,A12",5659,6463,4177,2286,3784,2010,0,2012,1293,719,1.798331015,1168,3266,932,388,383,5,88,2,0.122715405,0,empty,CD-0722-2
"B2,B1",4973,5766,3553,2213,3407,1941,0,1941,1201,740,1.622972973,1187,997,225,96,96,0,21,0,0.010416667,0,empty,CD-0722-2
"B2,B2",4753,5491,3158,2333,3368,2059,0,2063,1279,784,1.631377551,1268,442,60,42,41,1,18,1,0.024390244,0,empty,CD-0722-2
"B2,B3",4139,4798,3038,1760,2888,1594,0,1594,1080,514,2.101167315,926,1616,333,147,145,2,42,2,0.055172414,0,empty,CD-0722-2
"B2,B4",4840,5788,3478,2310,3489,2055,0,2056,1248,808,1.544554455,1269,1266,250,98,98,0,31,0,0.010204082,0,empty,CD-0722-2
"B2,B5",4645,2791,1655,1136,2000,1152,0,1158,758,400,1.895,734,1048,340,142,141,1,32,1,0,0,empty,CD-0722-2
"B2,B6",5179,5980,3657,2323,3590,2143,0,2143,1353,790,1.712658228,1267,1385,358,148,147,1,37,1,0.163265306,0,empty,CD-0722-2
"B2,B7",4478,5068,3347,1721,3075,1654,0,1656,1082,574,1.885017422,949,1198,252,90,89,1,30,1,0.02247191,0,empty,CD-0722-2
"B2,B8",3486,3957,2549,1408,2372,1244,0,1250,796,454,1.753303965,733,1132,260,115,113,2,35,2,0.026548673,0,empty,CD-0722-2
"B2,B9",852522,955167,647834,307333,543648,279345,1,279574,219505,60069,3.65421432,158386,23542,4845,1789,1765,24,372,3,0.009631728,0,hg38,CD-0722-2
"B2,B10",3156,3605,2281,1324,2187,1187,0,1189,753,436,1.72706422,677,600,165,84,83,1,20,1,0,0,empty,CD-0722-2
"B2,B11",7737,9267,5390,3877,5485,3316,0,3322,1832,1490,1.229530201,2031,139,18,11,11,0,10,0,0,0,empty,CD-0722-2
"B2,B12",4312,4863,3067,1796,2945,1587,0,1587,1048,539,1.944341373,938,1548,391,161,161,0,48,0,0.149068323,0,empty,CD-0722-2
"B2,C1",8068,9199,5964,3235,5439,2993,0,2997,1875,1122,1.671122995,1703,877,258,125,125,0,35,0,0.152,0,empty,CD-0722-2
"B2,C2",6709,7695,4854,2841,4598,2602,0,2602,1684,918,1.834422658,1516,2051,506,216,215,1,59,1,0.013953488,0,empty,CD-0722-2
"B2,C3",665662,828487,475037,353450,476864,291557,2,291770,231864,59906,3.870463727,181069,58417,9052,3392,3321,71,610,4,0.080698585,0,hg38,CD-0722-2
"B2,C4",527181,611196,395209,215987,353579,191833,1,192016,150670,41346,3.644125187,110826,69029,13083,5015,4921,94,939,3,0.056289372,0,hg38,CD-0722-2
"B2,C5",6105,7115,4473,2642,4321,2443,0,2445,1580,865,1.826589595,1422,1426,259,94,92,2,33,2,0.119565217,0,empty,CD-0722-2
"B2,C6",5153,5585,3758,1827,3420,1825,0,1826,1151,675,1.705185185,1016,1530,306,130,130,0,33,0,0.069230769,0,empty,CD-0722-2
"B2,C7",637404,746830,479808,267022,427170,231294,0,231477,172619,58858,2.932804377,136206,30407,3385,1318,1282,36,280,2,0.053822153,0,hg38,CD-0722-2
"B2,C8",7934,9161,5804,3357,5442,2986,0,2987,1968,1019,1.931305201,1728,2826,587,240,236,4,79,2,0.072033898,0,empty,CD-0722-2
"B2,C9",5523,6392,4037,2355,3871,2149,0,2151,1365,786,1.736641221,1253,1581,362,134,131,3,36,2,0.13740458,0,empty,CD-0722-2
"B2,C10",6047,6760,4411,2349,4054,2198,0,2200,1417,783,1.809706258,1288,1981,625,218,216,2,54,2,0,0,empty,CD-0722-2
"B2,C11",5226,6074,3909,2165,3606,1974,0,1981,1282,699,1.834048641,1119,1834,469,195,194,1,48,1,0.118556701,0,empty,CD-0722-2
"B2,C12",7835,8641,5651,2990,5257,2832,0,2833,1845,988,1.867408907,1629,1792,547,208,203,5,44,1,0.054187192,0,empty,CD-0722-2
"B2,D1",7031,8050,5021,3029,4841,2902,0,2904,1768,1136,1.556338028,1680,805,190,87,86,1,27,1,0.023255814,0,empty,CD-0722-2
"B2,D2",5782,6668,4256,2412,3981,2171,0,2179,1365,814,1.676904177,1265,2948,685,241,234,7,68,1,0.141025641,0,empty,CD-0722-2
"B2,D3",5094,5772,3785,1987,3516,1950,0,1950,1296,654,1.981651376,1090,1557,334,116,114,2,39,2,0,0,empty,CD-0722-2
"B2,D4",3910,4674,2893,1781,2810,1588,0,1588,1050,538,1.951672862,940,1143,356,105,105,0,41,0,0.047619048,0,empty,CD-0722-2
"B2,D5",4450,5110,3300,1810,3011,1589,1,1593,1036,557,1.859964093,920,1912,305,142,142,0,38,0,0,0,empty,CD-0722-2
"B2,D6",7178,8230,5143,3087,4890,2905,1,2907,1766,1141,1.547765118,1691,1802,424,166,166,0,48,0,0.006024096,0,empty,CD-0722-2
"B2,D7",3803,4249,2822,1427,2533,1351,0,1351,929,422,2.201421801,770,1545,283,138,137,1,44,1,0.102189781,0,empty,CD-0722-2
"B2,D8",4973,5717,3628,2089,3353,1871,0,1878,1164,714,1.630252101,1092,1524,367,135,130,5,47,1,0.092307692,0,empty,CD-0722-2
"B2,D9",2509,2954,1857,1097,1750,955,0,956,623,333,1.870870871,557,1560,251,99,96,3,29,2,0.083333333,0,empty,CD-0722-2
"B2,D10",4646,5384,3388,1996,3239,1795,0,1803,1129,674,1.675074184,1045,742,169,65,65,0,23,0,0.015384615,0,empty,CD-0722-2
"B2,D11",790920,931019,560600,370419,538211,327768,3,327998,289779,38219,7.582066511,196372,211071,71012,26562,26363,199,2805,8,0.010962334,0,hg38,CD-0722-2
"B2,D12",6692,7608,4897,2711,4464,2423,0,2423,1541,882,1.747165533,1376,3521,909,322,319,3,98,1,0.122257053,0,empty,CD-0722-2
"B2,E1",632553,739830,467372,272458,421927,236822,2,237051,186236,50815,3.664980813,139277,60617,9073,3236,3175,61,735,3,0.065826772,0,hg38,CD-0722-2
"B2,E2",5735,6580,4300,2280,3926,2160,0,2162,1345,817,1.64626683,1231,2252,424,155,152,3,44,2,0.039473684,0,empty,CD-0722-2
"B2,E3",3704,4245,2703,1542,2540,1382,0,1382,889,493,1.803245436,812,2184,487,206,201,5,66,2,0.004975124,0,empty,CD-0722-2
"B2,E4",4988,5626,3653,1973,3472,1864,0,1864,1203,661,1.819969743,1087,2847,780,261,253,8,68,2,0.031620553,0,empty,CD-0722-2
"B2,E5",4739,5296,3488,1808,3165,1624,0,1626,1065,561,1.898395722,924,1569,351,137,137,0,44,0,0.087591241,0,empty,CD-0722-2
"B2,E6",8698,9708,6456,3252,5825,3253,1,3256,2059,1197,1.720133668,1850,3722,1167,446,445,1,105,1,0.101123596,0,empty,CD-0722-2
"B2,E7",424202,477078,323960,153118,273186,138187,0,138299,108830,29469,3.693033357,78325,38514,10376,3786,3750,36,638,3,0.036266667,0,hg38,CD-0722-2
"B2,E8",6238,6969,4692,2277,4062,2091,0,2092,1385,707,1.958981612,1144,2572,718,269,257,12,61,3,0.124513619,0,empty,CD-0722-2
"B2,E9",4009,4628,2891,1737,2768,1516,0,1516,1002,514,1.949416342,896,2331,340,169,166,3,60,1,0.078313253,0,empty,CD-0722-2
"B2,E10",4293,4868,3174,1694,2960,1562,0,1565,1035,530,1.952830189,929,1849,413,167,166,1,37,1,0.048192771,0,empty,CD-0722-2
"B2,E11",5382,6197,3931,2266,3683,2049,0,2052,1273,779,1.634146341,1140,2253,664,261,260,1,56,1,0.023076923,0,empty,CD-0722-2
"B2,E12",6002,6760,4423,2337,4125,2263,0,2264,1469,795,1.847798742,1365,2309,529,205,205,0,61,0,0.009756098,0,empty,CD-0722-2
"B2,F1",7141,7856,5134,2722,4719,2507,1,2509,1591,918,1.733115468,1435,2141,579,231,227,4,56,2,0.246696035,0,empty,CD-0722-2
"B2,F2",5835,6622,4252,2370,3964,2178,0,2178,1428,750,1.904,1252,3163,953,365,360,5,72,2,0.127777778,0,empty,CD-0722-2
"B2,F3",5088,5789,3721,2068,3474,1866,0,1870,1254,616,2.035714286,1089,3017,618,210,201,9,63,2,0.139303483,0,empty,CD-0722-2
"B2,F4",7702,8368,5683,2685,5035,2591,0,2595,1632,963,1.69470405,1400,662,106,45,44,1,20,1,0.159090909,0,empty,CD-0722-2
"B2,F5",6066,6726,4448,2278,3980,2104,0,2114,1390,724,1.919889503,1200,2128,730,287,287,0,58,0,0.041811847,0,empty,CD-0722-2
"B2,F6",6187,6857,4483,2374,4101,2285,0,2287,1481,806,1.837468983,1284,2943,824,258,257,1,59,1,0.13618677,0,empty,CD-0722-2
"B2,F7",433814,535554,298472,237082,316481,205023,1,205188,157556,47632,3.307776285,128565,7003,3440,1234,1230,4,286,2,0.032520325,0,hg38,CD-0722-2
"B2,F8",670642,815597,486779,328818,468115,278238,1,278451,226082,52369,4.317095992,167560,8152,1461,493,475,18,118,3,0.065263158,0,hg38,CD-0722-2
"B2,F9",5893,6607,4452,2155,3975,2035,0,2039,1375,664,2.070783133,1128,3011,903,309,306,3,73,2,0.111111111,0,empty,CD-0722-2
"B2,F10",6795,7556,5095,2461,4451,2336,0,2341,1505,836,1.800239234,1281,1445,411,167,166,1,52,1,0.012048193,0,empty,CD-0722-2
"B2,F11",5632,6331,4210,2121,3746,1984,0,1984,1329,655,2.029007634,1121,1413,311,119,117,2,42,2,0.153846154,0,empty,CD-0722-2
"B2,F12",6048,6827,4327,2500,4013,2176,0,2179,1413,766,1.84464752,1270,236,29,18,18,0,11,0,0.277777778,0,empty,CD-0722-2
"B2,G1",6348,7235,4690,2545,4283,2266,0,2267,1433,834,1.71822542,1308,2916,723,289,288,1,75,1,0.055555556,0,empty,CD-0722-2
"B2,G2",3918,4317,2695,1622,2620,1499,0,1500,994,506,1.964426877,879,766,150,79,79,0,34,0,0.012658228,0,empty,CD-0722-2
"B2,G3",7163,7867,5279,2588,4702,2569,0,2573,1536,1037,1.481195757,1396,2314,550,170,165,5,54,2,0.066666667,0,empty,CD-0722-2
"B2,G4",13426,15650,9591,6059,9360,5622,0,5628,3329,2299,1.448020879,3317,66,7,6,6,0,6,0,0,0,empty,CD-0722-2
"B2,G5",663431,826165,474986,351179,470490,286940,2,287095,224927,62168,3.618051087,178101,192665,27185,10542,10298,244,1676,7,0.067974364,0,hg38,CD-0722-2
"B2,G6",6191,7113,4734,2379,4240,2312,0,2315,1537,778,1.975578406,1263,148,8,6,6,0,3,0,0,0,empty,CD-0722-2
"B2,G7",4919,5459,3647,1812,3354,1783,0,1785,1155,630,1.833333333,989,2368,644,182,180,2,52,2,0.044444444,0,empty,CD-0722-2
"B2,G8",3575,3951,2592,1359,2445,1299,0,1301,842,459,1.834422658,764,1827,343,182,182,0,62,0,0.093406593,0,empty,CD-0722-2
"B2,G9",4558,5324,3367,1957,3143,1718,0,1718,1109,609,1.821018062,1002,2186,539,196,194,2,59,2,0.164948454,0,empty,CD-0722-2
"B2,G10",5539,6271,4018,2253,3748,2071,1,2074,1262,812,1.554187192,1237,2111,380,168,165,3,67,1,0.048484848,0,empty,CD-0722-2
"B2,G11",5337,6047,3955,2092,3558,1874,1,1877,1259,618,2.037216828,1066,1461,354,134,134,0,38,0,0.037313433,0,empty,CD-0722-2
"B2,G12",4645,5491,3356,2135,3338,1863,0,1863,1179,684,1.723684211,1136,2289,625,225,223,2,57,2,0.147982063,0,empty,CD-0722-2
"B2,H1",4956,5464,3606,1858,3332,1779,0,1782,1183,599,1.974958264,1016,1082,197,87,87,0,38,0,0.022988506,0,empty,CD-0722-2
"B2,H2",6392,7253,4642,2611,4424,2450,0,2455,1706,749,2.277703605,1411,2193,641,212,208,4,61,2,0.004807692,0,empty,CD-0722-2
"B2,H3",638828,813431,442635,370796,467735,302167,2,302397,242689,59708,4.064597709,191825,44619,15726,5690,5643,47,1043,3,0.025695552,0,hg38,CD-0722-2
"B2,H4",6708,7621,4927,2694,4556,2477,0,2480,1637,843,1.941874259,1406,275,60,28,28,0,11,0,0,0,empty,CD-0722-2
"B2,H5",7369,8324,5326,2998,4935,2709,0,2709,1729,980,1.764285714,1578,3429,767,297,294,3,80,2,0.06462585,0,empty,CD-0722-2
"B2,H6",486348,570365,361928,208437,329008,179475,0,179598,138790,40808,3.401048814,107132,191890,22758,8563,8310,253,1380,10,0.070998797,0,hg38,CD-0722-2
"B2,H7",4873,5415,3582,1833,3298,1773,0,1773,1194,579,2.062176166,967,2095,363,157,156,1,61,1,0.076923077,0,empty,CD-0722-2
"B2,H8",5592,6581,4001,2580,3898,2241,0,2241,1437,804,1.787313433,1301,1912,511,173,168,5,60,1,0.053571429,0,empty,CD-0722-2
"B2,H9",5294,6009,3914,2095,3543,1892,0,1894,1323,571,2.316987741,1079,1854,517,164,164,0,43,0,0.109756098,0,empty,CD-0722-2
"B2,H10",541858,675504,375551,299953,387790,256941,2,257129,182184,74945,2.430902662,159025,18968,923,412,391,21,115,3,0.314578005,0,hg38,CD-0722-2
"B2,H11",5826,6773,3989,2784,4076,2634,0,2635,1403,1232,1.138798701,1581,35,7,6,6,0,6,0,0,0,empty,CD-0722-2
"B2,H12",4409,4834,3181,1653,2869,1591,0,1592,1069,523,2.043977055,864,1477,258,105,105,0,39,0,0.219047619,0,empty,CD-0722-2
"B3,A1",3985,4534,2872,1662,2720,1523,0,1525,978,547,1.787934186,896,1269,283,101,99,2,38,1,0.454545455,0,empty,CD-0722-2
"B3,A2",6931,7951,5131,2820,4662,2596,0,2596,1606,990,1.622222222,1478,3093,752,296,295,1,78,1,0.166101695,0,empty,CD-0722-2
"B3,A3",3671,4029,2587,1442,2527,1380,0,1387,918,469,1.957356077,824,1604,310,144,143,1,51,1,0.013986014,0,empty,CD-0722-2
"B3,A4",6341,7273,4656,2617,4381,2442,0,2444,1550,894,1.733780761,1427,951,166,84,83,1,29,1,0.060240964,0,empty,CD-0722-2
"B3,A5",5075,5559,3778,1781,3422,1860,0,1860,1203,657,1.831050228,1022,2794,530,208,206,2,52,1,0.082524272,0,empty,CD-0722-2
"B3,A6",4622,5251,3386,1865,3278,1931,0,1935,1230,705,1.744680851,1103,3076,633,297,294,3,116,2,0.010204082,0,empty,CD-0722-2
"B3,A7",3974,4628,2828,1800,2803,1639,0,1639,1041,598,1.740802676,989,1524,317,144,142,2,44,1,0.14084507,0,empty,CD-0722-2
"B3,A8",2241,2635,1551,1084,1597,915,0,917,600,317,1.892744479,577,1913,478,205,204,1,64,1,0.044117647,0,empty,CD-0722-2
"B3,A9",5443,6438,4010,2428,3800,2145,0,2145,1475,670,2.201492537,1286,2244,546,204,199,5,62,2,0.015075377,0,empty,CD-0722-2
"B3,A10",257080,334422,173725,160697,198938,139328,0,139392,88240,51152,1.725054739,88837,2054,674,264,262,2,55,2,0.015267176,0,hg38,CD-0722-2
"B3,A11",3726,4202,2742,1460,2538,1348,0,1348,916,432,2.12037037,768,1740,439,172,169,3,50,2,0.130177515,0,empty,CD-0722-2
"B3,A12",5353,5796,3999,1797,3470,1840,0,1842,1254,588,2.132653061,971,4373,1213,405,400,5,106,2,0.1,0,empty,CD-0722-2
"B3,B1",4443,5090,3190,1900,3030,1696,0,1698,1051,647,1.624420402,997,1314,330,148,146,2,43,2,0.068493151,0,empty,CD-0722-2
"B3,B2",5540,6290,3701,2589,3809,2340,0,2341,1497,844,1.773696682,1390,652,141,63,61,2,20,1,0.098360656,0,empty,CD-0722-2
"B3,B3",457425,520839,346308,174531,302301,157370,0,157485,122324,35161,3.478968175,90501,78851,6274,2541,2450,91,569,7,0.050204082,0,hg38,CD-0722-2
"B3,B4",365932,458058,252557,205501,267031,179161,0,179262,134337,44925,2.990250417,109666,14454,1013,374,350,24,76,4,0.291428571,0,hg38,CD-0722-2
"B3,B5",4976,3428,1981,1447,2382,1396,0,1403,881,522,1.687739464,896,1435,254,108,108,0,35,0,0.046296296,0,empty,CD-0722-2
"B3,B6",15875,19612,11236,8376,11457,7052,0,7061,5414,1647,3.287188828,4376,2693,864,307,303,4,75,2,0.02310231,0,empty,CD-0722-2
"B3,B7",563541,658279,416363,241916,380199,211284,0,211439,185343,26096,7.102352851,123529,135933,25862,9486,9330,156,1467,7,0.043622722,0,hg38,CD-0722-2
"B3,B8",3477,3804,2530,1274,2365,1228,0,1228,810,418,1.937799043,687,1463,327,150,148,2,58,2,0.060810811,0,empty,CD-0722-2
"B3,B9",6274,7341,4481,2860,4407,2479,0,2482,1523,959,1.588112617,1500,1269,279,144,143,1,71,1,0.055944056,0,empty,CD-0722-2
"B3,B10",2859,3068,2000,1068,1957,1053,0,1057,664,393,1.68956743,611,576,125,69,67,2,27,2,0.074626866,0,empty,CD-0722-2
"B3,B11",9229,10951,6490,4461,6504,4014,0,4020,2295,1725,1.330434783,2445,334,49,29,28,1,12,1,0,0,empty,CD-0722-2
"B3,B12",325661,421128,215785,205343,249916,178258,1,178370,127884,50486,2.53305867,113239,2496,705,230,229,1,70,1,0.069868996,0,hg38,CD-0722-2
"B3,C1",398071,497364,272695,224669,290883,191411,1,191539,153290,38249,4.007686475,120000,4945,1653,567,566,1,138,1,0.038869258,0,hg38,CD-0722-2
"B3,C2",6138,6846,4477,2369,4115,2318,0,2320,1491,829,1.798552473,1304,2138,613,238,237,1,74,1,0.054852321,0,empty,CD-0722-2
"B3,C3",6525,7425,4773,2652,4495,2500,0,2503,1625,878,1.850797267,1478,1170,190,86,84,2,35,1,0.011904762,0,empty,CD-0722-2
"B3,C4",4078,4512,3041,1471,2766,1417,0,1420,897,523,1.715105163,802,2024,559,178,174,4,50,2,0.109195402,0,empty,CD-0722-2
"B3,C5",731316,852562,548175,304387,486545,271741,1,271950,213092,58858,3.620442421,157883,204365,30518,11843,11615,228,1792,7,0.034696513,0,hg38,CD-0722-2
"B3,C6",7222,8350,5205,3145,5051,2842,0,2844,1947,897,2.170568562,1710,1427,371,142,140,2,49,1,0.171428571,0,empty,CD-0722-2
"B3,C7",7603,9159,5369,3790,5583,3456,0,3458,2171,1287,1.686868687,2114,408,58,27,27,0,10,0,0.222222222,0,empty,CD-0722-2
"B3,C8",560347,654631,415328,239303,376227,208989,1,209138,169880,39258,4.327270875,122607,229936,39663,15670,15371,299,2114,10,0.079695531,0,hg38,CD-0722-2
"B3,C9",5302,5994,3864,2130,3563,1936,1,1939,1295,644,2.010869565,1128,1548,378,128,126,2,43,1,0.015873016,0,empty,CD-0722-2
"B3,C10",5708,6513,4180,2333,3890,2101,0,2107,1349,758,1.779683377,1204,2216,488,189,184,5,54,1,0.135869565,0,empty,CD-0722-2
"B3,C11",5034,5772,3718,2054,3508,1918,0,1919,1257,662,1.898791541,1139,2022,378,176,175,1,61,1,0.034285714,0,empty,CD-0722-2
"B3,C12",7905,8790,5753,3037,5289,2874,0,2880,1860,1020,1.823529412,1659,1974,606,233,233,0,76,0,0.081545064,0,empty,CD-0722-2
"B3,D1",6675,7948,4697,3251,4760,2878,0,2880,1671,1209,1.382133995,1738,1132,190,77,75,2,27,1,0.053333333,0,empty,CD-0722-2
"B3,D2",5186,5693,3800,1893,3543,1882,0,1882,1262,620,2.035483871,1062,3193,932,375,373,2,112,1,0.032171582,0,empty,CD-0722-2
"B3,D3",4638,5294,3287,2007,3238,1820,0,1820,1196,624,1.916666667,1071,1862,449,172,171,1,50,1,0.046783626,0,empty,CD-0722-2
"B3,D4",554456,671905,406728,265177,386487,225435,0,225593,180854,44739,4.042423836,136027,76815,12567,4890,4787,103,964,4,0.062669731,0,hg38,CD-0722-2
"B3,D5",433230,490814,329565,161249,285403,147400,0,147528,111655,35873,3.112508014,83661,87810,11756,4646,4560,86,891,7,0.025877193,0,hg38,CD-0722-2
"B3,D6",6679,7732,4652,3080,4496,2626,0,2626,1607,1019,1.57703631,1561,2319,585,226,224,2,66,1,0.044642857,0,empty,CD-0722-2
"B3,D7",3846,4161,2831,1330,2527,1374,0,1375,891,484,1.840909091,767,2639,685,283,279,4,79,2,0.05734767,0,empty,CD-0722-2
"B3,D8",4559,5157,3235,1922,3152,1774,0,1780,1165,615,1.894308943,1070,1808,529,213,211,2,55,1,0.023696682,0,empty,CD-0722-2
"B3,D9",2368,2550,1778,772,1554,790,0,790,520,270,1.925925926,425,1818,471,166,165,1,49,1,0.084848485,0,empty,CD-0722-2
"B3,D10",944091,1115696,691568,424128,639834,364557,3,364888,290549,74339,3.908432989,220434,98707,15559,6096,5993,103,1163,3,0.040881028,0,hg38,CD-0722-2
"B3,D11",4978,5540,3618,1922,3381,1800,0,1804,1185,619,1.914378029,1024,2576,642,271,270,1,75,1,0.025925926,0,empty,CD-0722-2
"B3,D12",5999,6734,4324,2410,4125,2251,0,2253,1492,761,1.960578187,1322,3809,1049,435,431,4,118,2,0.099767981,0,empty,CD-0722-2
"B3,E1",7644,8594,5518,3076,5136,2839,0,2843,1759,1084,1.622693727,1614,3013,784,313,312,1,63,1,0.121794872,0,empty,CD-0722-2
"B3,E2",472640,578680,335877,242803,337876,205640,0,205802,171032,34770,4.918953121,126607,76807,13335,5115,5007,108,985,5,0.043738766,0,hg38,CD-0722-2
"B3,E3",3883,4278,2799,1479,2617,1418,0,1418,936,482,1.941908714,777,2695,653,247,236,11,79,2,0.080508475,0,empty,CD-0722-2
"B3,E4",4889,5802,3573,2229,3455,1929,0,1930,1238,692,1.789017341,1139,2823,600,256,256,0,88,0,0.07421875,0,empty,CD-0722-2
"B3,E5",4248,4647,3249,1398,2854,1455,0,1457,967,490,1.973469388,795,1965,334,137,136,1,48,1,0.029411765,0,empty,CD-0722-2
"B3,E6",8220,9175,6060,3115,5521,3051,0,3053,1996,1057,1.888363292,1712,4018,1044,436,432,4,125,1,0.048611111,0,empty,CD-0722-2
"B3,E7",8566,9895,6275,3620,5867,3294,0,3296,2156,1140,1.89122807,1910,4018,1005,384,382,2,115,2,0.146596859,0,empty,CD-0722-2
"B3,E8",5680,6142,4247,1895,3657,1840,0,1841,1201,640,1.8765625,970,3317,803,293,289,4,80,1,0.041522491,0,empty,CD-0722-2
"B3,E9",3715,3943,2731,1212,2393,1269,0,1269,834,435,1.917241379,666,2850,845,303,296,7,88,2,0.040540541,0,empty,CD-0722-2
"B3,E10",4143,4527,2984,1543,2701,1409,0,1412,924,488,1.893442623,787,1722,524,205,204,1,54,1,0.147058824,0,empty,CD-0722-2
"B3,E11",4971,5785,3618,2167,3576,2034,0,2034,1284,750,1.712,1228,2307,628,233,233,0,72,0,0.012875536,0,empty,CD-0722-2
"B3,E12",5580,6519,4038,2481,4010,2278,0,2280,1441,839,1.717520858,1350,2203,502,186,186,0,62,0,0.037634409,0,empty,CD-0722-2
"B3,F1",6465,7072,4630,2442,4267,2272,0,2272,1555,717,2.168758717,1308,2140,514,225,222,3,72,2,0.09009009,0,empty,CD-0722-2
"B3,F2",5143,5385,3824,1561,3248,1708,0,1708,1141,567,2.012345679,894,3542,674,267,265,2,78,1,0.01509434,0,empty,CD-0722-2
"B3,F3",4613,5223,3413,1810,3095,1612,0,1618,1067,551,1.936479129,938,2819,557,185,183,2,73,1,0.038251366,0,empty,CD-0722-2
"B3,F4",7332,7903,5434,2469,4754,2449,0,2457,1685,772,2.182642487,1342,948,240,110,106,4,44,2,0,0,empty,CD-0722-2
"B3,F5",5786,6346,4270,2076,3795,1988,0,1990,1232,758,1.625329815,1083,2568,680,300,299,1,73,1,0.056856187,0,empty,CD-0722-2
"B3,F6",5622,6372,4046,2326,3804,2106,0,2108,1329,779,1.706033376,1213,3763,656,293,285,8,86,3,0.112280702,0,empty,CD-0722-2
"B3,F7",6582,7422,4770,2652,4472,2430,0,2433,1552,881,1.761634506,1404,1217,427,165,165,0,42,0,0.018181818,0,empty,CD-0722-2
"B3,F8",5274,5784,3976,1808,3547,1851,0,1851,1246,605,2.059504132,1027,443,78,49,49,0,26,0,0.183673469,0,empty,CD-0722-2
"B3,F9",671774,805505,489679,315826,463608,270168,0,270357,220158,50199,4.385704895,161330,292266,48935,18996,18665,331,2517,7,0.068148942,0,hg38,CD-0722-2
"B3,F10",6533,7204,4812,2392,4240,2162,0,2162,1405,757,1.856010568,1192,1778,356,167,162,5,46,2,0.037037037,0,empty,CD-0722-2
"B3,F11",5464,6085,4086,1999,3610,1823,0,1828,1206,622,1.938906752,1069,2171,448,171,169,2,44,2,0.076923077,0,empty,CD-0722-2
"B3,F12",5737,6575,4129,2446,3886,2120,0,2122,1340,782,1.713554987,1252,349,33,24,24,0,15,0,0.125,0,empty,CD-0722-2
"B3,G1",5840,6529,4376,2153,3842,1947,0,1953,1274,679,1.87628866,1093,3620,1158,378,376,2,108,2,0.061170213,0,empty,CD-0722-2
"B3,G2",3647,4012,2509,1503,2420,1381,0,1381,899,482,1.865145228,812,755,165,70,68,2,44,2,0.029411765,0,empty,CD-0722-2
"B3,G3",7116,7829,5162,2667,4707,2617,0,2618,1501,1117,1.343777977,1436,2563,689,212,208,4,70,1,0.024038462,0,empty,CD-0722-2
"B3,G4",12412,14344,8808,5536,8507,5092,0,5099,3042,2057,1.478852698,2996,213,74,22,22,0,13,0,0,0,empty,CD-0722-2
"B3,G5",625134,762991,453806,309185,435683,257677,1,257872,207333,50539,4.102435743,157339,80788,13690,5534,5442,92,1008,7,0.063212054,0,hg38,CD-0722-2
"B3,G6",5880,6629,4330,2299,3950,2106,0,2108,1378,730,1.887671233,1194,223,43,21,21,0,10,0,0,0,empty,CD-0722-2
"B3,G7",445578,542949,313460,229489,321640,208326,0,208457,142379,66078,2.154711099,126743,6093,1052,340,336,4,83,1,0.145833333,0,hg38,CD-0722-2
"B3,G8",3571,4087,2648,1439,2421,1310,0,1311,868,443,1.959367946,754,2322,425,202,201,1,63,1,0.064676617,0,empty,CD-0722-2
"B3,G9",4273,4862,3093,1769,2873,1577,0,1577,995,582,1.709621993,918,2791,703,267,266,1,77,1,0.214285714,0,empty,CD-0722-2
"B3,G10",5202,6190,3667,2523,3661,2081,0,2084,1318,766,1.720626632,1261,3617,1164,422,421,1,105,1,0.040380048,0,empty,CD-0722-2
"B3,G11",5087,5802,3795,2007,3438,1835,0,1837,1260,577,2.183708839,1067,1983,559,193,193,0,58,0,0.093264249,0,empty,CD-0722-2
"B3,G12",4339,5086,3002,2084,2985,1684,0,1688,1125,563,1.998223801,1008,2613,602,240,240,0,85,0,0.108333333,0,empty,CD-0722-2
"B3,H1",529021,638861,381222,257639,369939,218913,3,219060,171277,47783,3.58447565,133603,26001,3900,1412,1378,34,425,3,0.021770682,0,hg38,CD-0722-2
"B3,H2",692313,886982,470764,416218,517575,355655,2,355863,203831,152032,1.340711166,226255,37534,16953,6189,6161,28,1057,3,0.010550235,0,hg38,CD-0722-2
"B3,H3",4382,4860,3184,1676,2909,1611,0,1614,1084,530,2.045283019,914,2070,331,137,134,3,57,1,0.156716418,0,empty,CD-0722-2
"B3,H4",568764,714236,389673,324563,411240,280838,0,280987,183031,97956,1.868502185,173811,348,54,28,28,0,14,0,0.285714286,0,empty,CD-0722-2
"B3,H5",611082,739195,439199,299996,424753,252927,2,253118,197420,55698,3.544471974,154817,124976,20056,7874,7718,156,1403,6,0.028375227,0,hg38,CD-0722-2
"B3,H6",4165,4792,2890,1902,2881,1699,0,1700,1143,557,2.052064632,1019,2514,597,240,238,2,76,2,0.092436975,0,empty,CD-0722-2
"B3,H7",5099,5529,3757,1772,3372,1810,0,1810,1191,619,1.924071082,989,2812,633,290,286,4,92,2,0.059440559,0,empty,CD-0722-2
"B3,H8",5355,6226,3747,2479,3735,2122,0,2126,1393,733,1.900409277,1254,2123,418,211,208,3,68,1,0.076923077,0,empty,CD-0722-2
"B3,H9",4455,4994,3325,1669,3047,1621,0,1621,1029,592,1.738175676,885,1316,254,108,108,0,38,0,0.009259259,0,empty,CD-0722-2
"B3,H10",4100,4724,2981,1743,2808,1573,0,1578,1031,547,1.884826325,908,1500,383,189,184,5,67,1,0.043478261,0,empty,CD-0722-2
"B3,H11",5433,6307,3706,2601,3821,2497,0,2497,1352,1145,1.180786026,1489,101,7,7,7,0,5,0,0,0,empty,CD-0722-2
"B3,H12",4259,4873,3034,1839,2891,1641,0,1641,1093,548,1.994525547,965,1498,177,85,85,0,39,0,0.011764706,0,empty,CD-0722-2
"B4,A1",4805,5553,3430,2123,3366,1952,0,1952,1266,686,1.84548105,1179,1428,210,96,95,1,31,1,0.052631579,0,empty,CD-0722-2
"B4,A2",7473,8749,5531,3218,5203,2944,0,2945,1826,1119,1.63181412,1737,2580,706,289,286,3,83,1,0.038461538,0,empty,CD-0722-2
"B4,A3",4497,5030,3198,1832,2962,1630,0,1632,1111,521,2.13243762,933,1438,435,166,163,3,57,2,0.165644172,0,empty,CD-0722-2
"B4,A4",6845,7721,4994,2727,4747,2643,0,2644,1737,907,1.915104741,1527,985,204,87,87,0,31,0,0.103448276,0,empty,CD-0722-2
"B4,A5",6125,7010,4402,2608,4184,2237,1,2244,1445,799,1.808510638,1334,2673,722,265,265,0,56,0,0.101886792,0,empty,CD-0722-2
"B4,A6",13359,15286,10087,5199,9015,4757,0,4764,3375,1389,2.429805616,2659,3414,751,309,307,2,99,2,0.087947883,0,empty,CD-0722-2
"B4,A7",4493,5234,3255,1979,3147,1810,0,1810,1135,675,1.681481481,1065,1373,302,113,112,1,41,1,0.116071429,0,empty,CD-0722-2
"B4,A8",2875,3407,2110,1297,1980,1101,0,1101,743,358,2.075418994,642,2430,640,226,222,4,63,2,0.126126126,0,empty,CD-0722-2
"B4,A9",862459,1025077,655337,369740,578602,319152,1,319429,258214,61215,4.218149146,186725,247532,29058,11243,10955,288,1866,7,0.064171611,0,hg38,CD-0722-2
"B4,A10",6423,7168,4871,2297,4256,2213,0,2217,1437,780,1.842307692,1219,484,131,55,55,0,23,0,0.090909091,0,empty,CD-0722-2
"B4,A11",4443,4927,3364,1563,2920,1468,0,1471,960,511,1.878669276,779,1669,269,122,118,4,54,1,0.144067797,0,empty,CD-0722-2
"B4,A12",6645,7216,5010,2206,4292,2224,0,2226,1488,738,2.016260163,1199,3667,875,362,356,6,91,3,0.070224719,0,empty,CD-0722-2
"B4,B1",5698,6617,4158,2459,3832,2190,0,2195,1414,781,1.81049936,1281,2016,651,236,229,7,57,2,0.056768559,0,empty,CD-0722-2
"B4,B2",528914,611560,360680,250880,356084,208530,0,208677,163383,45294,3.607166512,128548,48585,6609,2514,2449,65,561,6,0.0600245,0,hg38,CD-0722-2
"B4,B3",4908,5566,3575,1991,3367,1934,0,1939,1268,671,1.889716841,1108,1812,432,161,159,2,55,2,0.144654088,0,empty,CD-0722-2
"B4,B4",5747,6952,4008,2944,4143,2538,0,2541,1543,998,1.546092184,1562,1574,433,156,155,1,56,1,0.006451613,0,empty,CD-0722-2
"B4,B5",5133,3211,1968,1243,2240,1268,0,1275,857,418,2.050239234,783,1234,200,88,88,0,39,0,0.034090909,0,empty,CD-0722-2
"B4,B6",532476,634427,386956,247471,362540,208243,0,208375,167644,40731,4.115882252,125027,125653,22928,8959,8837,122,1529,5,0.03734299,0,hg38,CD-0722-2
"B4,B7",5273,6193,3898,2295,3606,1996,0,1996,1315,681,1.930983847,1141,1538,405,166,166,0,42,0,0.006024096,0,empty,CD-0722-2
"B4,B8",383157,491408,265454,225954,286203,186868,2,187029,147862,39167,3.775167871,119001,3255,1015,317,316,1,96,1,0.050632911,0,hg38,CD-0722-2
"B4,B9",7853,8987,5698,3289,5256,3021,0,3026,1895,1131,1.6755084,1711,1314,333,142,141,1,51,1,0.234042553,0,empty,CD-0722-2
"B4,B10",3754,4160,2742,1418,2497,1347,0,1349,852,497,1.714285714,740,533,98,28,25,3,13,1,0.16,0,empty,CD-0722-2
"B4,B11",13026,15231,9343,5888,8842,5244,0,5256,3304,1952,1.692622951,3080,255,40,29,29,0,22,0,0.034482759,0,empty,CD-0722-2
"B4,B12",4776,5429,3466,1963,3332,1861,0,1866,1268,598,2.120401338,1110,1897,359,147,142,5,39,2,0,0,empty,CD-0722-2
"B4,C1",726266,810127,558848,251279,456678,227465,2,227691,172675,55016,3.138632398,127558,84533,10369,3846,3741,105,713,4,0.04918471,0,hg38,CD-0722-2
"B4,C2",657994,750106,500593,249513,423914,219412,1,219618,169475,50143,3.379833676,125636,58802,5904,2248,2196,52,516,3,0.029143898,0,hg38,CD-0722-2
"B4,C3",7608,8660,5518,3142,5150,2866,0,2866,1800,1066,1.688555347,1630,1411,272,117,115,2,46,2,0.147826087,0,empty,CD-0722-2
"B4,C4",4963,5690,3687,2003,3423,1770,0,1771,1208,563,2.145648313,1036,1902,469,195,191,4,67,2,0.19895288,0,empty,CD-0722-2
"B4,C5",6704,7919,4858,3061,4605,2534,0,2537,1679,858,1.956876457,1518,2239,658,224,221,3,69,1,0.049773756,0,empty,CD-0722-2
"B4,C6",5848,6476,4202,2274,4010,2238,0,2238,1431,807,1.773234201,1326,1919,489,192,192,0,49,0,0.005208333,0,empty,CD-0722-2
"B4,C7",8556,10347,5969,4378,5926,3575,0,3579,2114,1465,1.443003413,2187,420,89,38,36,2,16,1,0,0,empty,CD-0722-2
"B4,C8",9605,11195,7020,4175,6477,3559,1,3565,2364,1201,1.9683597,2088,3065,657,365,362,3,119,2,0.055248619,0,empty,CD-0722-2
"B4,C9",12695,14896,9510,5386,8648,4614,1,4621,3102,1519,2.042132982,2750,5151,656,272,268,4,81,2,0.197761194,0,empty,CD-0722-2
"B4,C10",7073,8021,5278,2743,4726,2549,0,2549,1678,871,1.92652124,1462,2089,445,193,192,1,58,1,0.015625,0,empty,CD-0722-2
"B4,C11",6063,7046,4360,2686,4187,2309,0,2311,1517,794,1.910579345,1377,2405,582,231,227,4,70,2,0.035242291,0,empty,CD-0722-2
"B4,C12",8713,9838,6363,3475,5779,3073,0,3075,2034,1041,1.95389049,1805,1876,704,256,253,3,77,2,0.019762846,0,empty,CD-0722-2
"B4,D1",8584,9890,6032,3858,5837,3450,0,3450,2058,1392,1.478448276,2016,1200,305,114,112,2,45,1,0.071428571,0,empty,CD-0722-2
"B4,D2",5756,6166,4334,1832,3675,1870,0,1870,1196,674,1.774480712,976,3076,783,312,308,4,111,1,0.032467532,0,empty,CD-0722-2
"B4,D3",5790,6601,4178,2423,3923,2240,0,2242,1454,788,1.845177665,1303,1555,416,183,179,4,62,2,0.033519553,0,empty,CD-0722-2
"B4,D4",369408,335878,320986,14892,187329,27982,0,28066,21919,6147,3.565804457,7822,27279,7421,2805,2786,19,510,3,0.02045944,0,empty,CD-0722-2
"B4,D5",5474,6506,4033,2473,3806,2131,0,2131,1416,715,1.98041958,1249,2328,743,280,280,0,76,0,0.146428571,0,empty,CD-0722-2
"B4,D6",7998,9587,5631,3956,5557,3360,0,3360,2009,1351,1.487046632,2024,2456,686,233,233,0,60,0,0.107296137,0,empty,CD-0722-2
"B4,D7",507629,571465,389542,181923,324705,162583,1,162746,127211,35535,3.579878993,91626,394848,46133,18374,17890,484,2509,12,0.046785914,0,hg38,CD-0722-2
"B4,D8",5333,6120,4010,2110,3674,1996,0,1996,1317,679,1.939617084,1122,1576,385,155,152,3,59,2,0.026315789,0,empty,CD-0722-2
"B4,D9",3792,4199,2803,1396,2549,1299,0,1299,900,399,2.255639098,761,2036,469,163,161,2,45,1,0.080745342,0,empty,CD-0722-2
"B4,D10",4919,5483,3604,1879,3231,1802,0,1803,1158,645,1.795348837,983,847,243,100,100,0,26,0,0.08,0,empty,CD-0722-2
"B4,D11",5670,6459,4164,2295,3938,2151,0,2151,1456,695,2.094964029,1282,3092,814,299,299,0,95,0,0.036789298,0,empty,CD-0722-2
"B4,D12",7033,7920,5160,2760,4770,2560,0,2563,1717,846,2.029550827,1491,3464,826,327,319,8,126,3,0.034482759,0,empty,CD-0722-2
"B4,E1",9319,10471,6740,3731,6104,3348,0,3348,2102,1246,1.686998395,1916,3123,697,287,286,1,84,1,0.006993007,0,empty,CD-0722-2
"B4,E2",6322,7513,4521,2992,4456,2555,0,2555,1605,950,1.689473684,1575,1847,397,148,145,3,57,2,0.062068966,0,empty,CD-0722-2
"B4,E3",4255,4890,3151,1739,2887,1560,0,1561,1028,533,1.928705441,900,2386,515,186,181,5,65,2,0.016574586,0,empty,CD-0722-2
"B4,E4",6010,6916,4403,2513,4147,2316,0,2316,1478,838,1.76372315,1346,3123,802,279,268,11,93,3,0.074626866,0,empty,CD-0722-2
"B4,E5",6955,7957,5111,2846,4640,2557,0,2557,1664,893,1.863381859,1456,1716,422,187,186,1,53,1,0.091397849,0,empty,CD-0722-2
"B4,E6",1434681,1706895,1060699,646196,945610,550722,5,551206,472413,78793,5.995621438,324742,409817,74804,28657,28240,417,3287,11,0.071954674,0,hg38,CD-0722-2
"B4,E7",601244,676648,462272,214376,379760,189916,0,190058,141527,48531,2.9162185,106472,88970,13961,5178,5092,86,963,5,0.040455617,0,hg38,CD-0722-2
"B4,E8",6796,7479,5115,2364,4432,2278,0,2279,1571,708,2.218926554,1232,3201,649,256,253,3,89,1,0.015810277,0,empty,CD-0722-2
"B4,E9",1141642,1335331,860809,474522,751029,414566,1,414901,341208,73693,4.630127692,242526,344735,55069,21193,20762,431,2743,9,0.048405741,0,hg38,CD-0722-2
"B4,E10",4672,5292,3540,1752,3172,1652,0,1654,1092,562,1.943060498,906,2040,425,173,169,4,55,1,0.088757396,0,empty,CD-0722-2
"B4,E11",5995,6883,4369,2514,4052,2243,0,2244,1441,803,1.794520548,1290,1796,388,157,152,5,45,2,0.111842105,0,empty,CD-0722-2
"B4,E12",657284,811364,466181,345183,466530,287478,2,287663,231552,56111,4.126677479,178039,39216,6102,2299,2266,33,632,2,0.020741395,0,hg38,CD-0722-2
"B4,F1",7652,8506,5563,2943,5115,2765,0,2766,1754,1012,1.733201581,1580,2832,721,255,252,3,92,2,0.142857143,0,empty,CD-0722-2
"B4,F2",5995,6667,4397,2270,3977,2115,0,2117,1319,798,1.652882206,1176,3801,1057,362,357,5,81,2,0.089635854,0,empty,CD-0722-2
"B4,F3",5896,6609,4336,2273,3965,2083,1,2086,1382,704,1.963068182,1202,3406,609,258,253,5,82,4,0.086956522,0,empty,CD-0722-2
"B4,F4",9517,10655,7084,3571,6343,3260,0,3264,2139,1125,1.901333333,1866,1563,185,81,78,3,36,2,0.166666667,0,empty,CD-0722-2
"B4,F5",6585,7116,4720,2396,4245,2272,1,2274,1535,739,2.077131258,1279,2571,503,239,236,3,78,2,0.025423729,0,empty,CD-0722-2
"B4,F6",6973,7956,5055,2901,4706,2685,0,2687,1630,1057,1.542100284,1575,3344,601,237,234,3,65,3,0.064102564,0,empty,CD-0722-2
"B4,F7",7213,8327,5299,3028,4997,2825,0,2825,1812,1013,1.788746298,1621,1141,338,100,100,0,34,0,0,0,empty,CD-0722-2
"B4,F8",5716,6265,4336,1929,3833,1981,0,1981,1326,655,2.024427481,1071,459,87,45,43,2,25,1,0.023255814,0,empty,CD-0722-2
"B4,F9",6364,7263,4750,2513,4224,2195,0,2198,1478,720,2.052777778,1235,2909,779,296,287,9,96,2,0.069686411,0,empty,CD-0722-2
"B4,F10",7342,8310,5460,2850,4887,2587,0,2587,1711,876,1.953196347,1453,1754,444,183,178,5,53,2,0.117977528,0,empty,CD-0722-2
"B4,F11",6765,7326,5062,2264,4351,2219,0,2223,1503,720,2.0875,1196,1918,394,172,164,8,48,2,0.115853659,0,empty,CD-0722-2
"B4,F12",6817,7760,4819,2941,4518,2472,0,2472,1650,822,2.00729927,1493,239,40,28,28,0,13,0,0.321428571,0,empty,CD-0722-2
"B4,G1",6830,7851,5012,2839,4668,2537,0,2542,1690,852,1.983568075,1491,2775,608,276,273,3,106,2,0.04029304,0,empty,CD-0722-2
"B4,G2",4378,4979,3016,1963,2897,1601,0,1601,1030,571,1.80385289,948,657,94,49,49,0,32,0,0.040816327,0,empty,CD-0722-2
"B4,G3",8255,9065,6083,2982,5286,2934,0,2935,1771,1164,1.521477663,1527,2748,563,235,226,9,80,2,0.053097345,0,empty,CD-0722-2
"B4,G4",14761,17109,10331,6778,9956,6048,0,6053,3629,2424,1.497112211,3476,153,31,19,19,0,12,0,0.052631579,0,empty,CD-0722-2
"B4,G5",4836,5472,3416,2056,3206,1808,0,1809,1208,601,2.009983361,1057,2083,429,172,172,0,59,0,0.075581395,0,empty,CD-0722-2
"B4,G6",6991,8058,5215,2843,4656,2547,1,2548,1736,812,2.137931034,1423,248,22,14,13,1,9,1,0,0,empty,CD-0722-2
"B4,G7",5851,6466,4425,2041,3841,1935,0,1940,1215,725,1.675862069,1070,7141,1476,570,565,5,151,2,0.099115044,0,empty,CD-0722-2
"B4,G8",4198,4602,3066,1536,2717,1446,0,1446,999,447,2.234899329,798,1653,365,177,172,5,64,2,0.104651163,0,empty,CD-0722-2
"B4,G9",4958,5742,3650,2092,3445,1885,0,1886,1183,703,1.682788051,1083,3085,1041,340,334,6,95,2,0.107784431,0,empty,CD-0722-2
"B4,G10",6390,7456,4683,2773,4328,2484,0,2488,1631,857,1.903150525,1440,2414,567,235,234,1,105,1,0.072649573,0,empty,CD-0722-2
"B4,G11",5989,6798,4475,2323,3988,2117,0,2118,1418,700,2.025714286,1186,1862,317,125,122,3,57,1,0.073770492,0,empty,CD-0722-2
"B4,G12",5215,6265,3749,2516,3726,2137,0,2138,1383,755,1.831788079,1308,2753,681,265,264,1,75,1,0.056818182,0,empty,CD-0722-2
"B4,H1",6023,6790,4418,2372,4087,2195,0,2197,1501,696,2.156609195,1267,1564,325,155,154,1,48,1,0.123376623,0,empty,CD-0722-2
"B4,H2",5946,6615,4342,2273,3918,2123,0,2125,1347,778,1.731362468,1225,2877,700,286,282,4,86,1,0.166666667,0,empty,CD-0722-2
"B4,H3",676530,847144,472425,374719,482057,306635,2,306869,240397,66472,3.616515224,192867,7295,2710,780,776,4,262,2,0.018041237,0,hg38,CD-0722-2
"B4,H4",752042,872006,565121,306885,488566,261209,1,261429,208120,53309,3.904031214,152211,13419,1728,667,652,15,158,2,0.035276074,0,hg38,CD-0722-2
"B4,H5",8081,9206,5809,3397,5400,2984,0,2984,1930,1054,1.831119545,1707,2511,607,258,249,9,86,2,0.052208835,0,empty,CD-0722-2
"B4,H6",5324,6326,3790,2536,3667,2118,0,2120,1454,666,2.183183183,1259,2228,489,203,201,2,75,2,0.134328358,0,empty,CD-0722-2
"B4,H7",5695,6574,4189,2385,4001,2127,0,2127,1443,684,2.109649123,1257,2533,520,241,234,7,100,2,0.068376068,0,empty,CD-0722-2
"B4,H8",23718,27664,17745,9919,16337,8808,0,8819,6709,2110,3.179620853,5162,2114,422,192,188,4,65,1,0.111702128,0,empty,CD-0722-2
"B4,H9",5116,5824,3841,1983,3393,1764,0,1766,1229,537,2.288640596,1002,1559,378,169,169,0,46,0,0.059171598,0,empty,CD-0722-2
"B4,H10",5008,5640,3742,1898,3283,1710,0,1712,1175,537,2.188081937,940,2041,401,171,166,5,60,2,0.138554217,0,empty,CD-0722-2
"B4,H11",6783,7903,4613,3290,4758,3107,0,3116,1670,1446,1.154910097,1865,82,3,3,3,0,3,0,0.333333333,0,empty,CD-0722-2
"B4,H12",5531,6342,3988,2354,3789,2155,1,2158,1457,701,2.078459344,1303,2027,342,140,136,4,48,2,0.007352941,0,empty,CD-0722-2
"B5,A1",4343,5076,3083,1993,2970,1741,0,1745,1123,622,1.805466238,1026,1430,271,119,117,2,58,1,0.017094017,0,empty,CD-0722-2
"B5,A2",6351,7293,4656,2637,4306,2413,0,2415,1465,950,1.542105263,1375,2119,555,262,261,1,84,1,0.057471264,0,empty,CD-0722-2
"B5,A3",3856,4356,2831,1525,2661,1434,0,1436,933,503,1.854870775,814,1295,210,110,108,2,49,2,0.037037037,0,empty,CD-0722-2
"B5,A4",6882,7926,4992,2934,4718,2624,0,2627,1743,884,1.971719457,1525,828,111,50,50,0,27,0,0.06,0,empty,CD-0722-2
"B5,A5",5629,6231,4123,2108,3731,2052,0,2052,1271,781,1.627400768,1140,2285,660,209,207,2,76,1,0.086956522,0,empty,CD-0722-2
"B5,A6",4840,5695,3521,2174,3390,1898,0,1898,1219,679,1.795287187,1117,3095,805,347,346,1,128,1,0.083815029,0,empty,CD-0722-2
"B5,A7",4323,4985,3028,1957,2952,1701,0,1703,1095,608,1.800986842,1016,1466,340,123,123,0,54,0,0.048780488,0,empty,CD-0722-2
"B5,A8",2427,2790,1821,969,1682,921,0,923,641,282,2.273049645,537,1814,350,186,183,3,72,2,0.136612022,0,empty,CD-0722-2
"B5,A9",4422,5038,3238,1800,3013,1622,0,1627,1047,580,1.805172414,919,1889,450,183,182,1,59,1,0.115384615,0,empty,CD-0722-2
"B5,A10",169024,164719,137278,27441,100231,42414,0,42459,24135,18324,1.317125082,16357,761,139,81,79,2,42,2,0.088607595,0,empty,CD-0722-2
"B5,A11",3931,4343,3021,1322,2611,1338,0,1341,830,511,1.624266145,736,1843,482,178,175,3,79,2,0.057142857,0,empty,CD-0722-2
"B5,A12",5730,6465,4257,2208,3782,2032,0,2032,1300,732,1.775956284,1131,3346,794,311,309,2,110,2,0.093851133,0,empty,CD-0722-2
"B5,B1",4666,5344,3322,2022,3304,1931,0,1935,1190,745,1.597315436,1136,1487,385,181,180,1,64,1,0.1,0,empty,CD-0722-2
"B5,B2",4892,5588,3268,2320,3441,2092,0,2092,1333,759,1.756258235,1275,763,135,69,68,1,25,1,0.161764706,0,empty,CD-0722-2
"B5,B3",3990,4698,2830,1868,2832,1613,0,1614,990,624,1.586538462,972,1760,304,161,156,5,80,1,0.038461538,0,empty,CD-0722-2
"B5,B4",4774,5575,3401,2174,3473,2059,0,2059,1275,784,1.62627551,1272,1524,504,183,183,0,49,0,0.027322404,0,empty,CD-0722-2
"B5,B5",9767,9178,5425,3753,5856,3468,0,3478,2639,839,3.145411204,2157,1091,283,140,140,0,52,0,0.064285714,0,empty,CD-0722-2
"B5,B6",5388,6006,3912,2094,3626,2021,0,2023,1234,789,1.56400507,1143,1949,439,188,185,3,57,1,0.075675676,0,empty,CD-0722-2
"B5,B7",5441,6330,4086,2244,3785,2019,0,2024,1358,666,2.039039039,1207,2082,502,186,185,1,52,1,0.021621622,0,empty,CD-0722-2
"B5,B8",3434,3723,2542,1181,2217,1156,0,1156,827,329,2.513677812,591,1588,322,155,153,2,70,2,0.150326797,0,empty,CD-0722-2
"B5,B9",6820,7765,4925,2840,4639,2669,0,2672,1658,1014,1.635108481,1543,1576,350,154,153,1,68,1,0.052287582,0,empty,CD-0722-2
"B5,B10",3240,3571,2262,1309,2180,1181,0,1183,764,419,1.823389021,670,676,143,50,50,0,20,0,0.06,0,empty,CD-0722-2
"B5,B11",7654,9058,5344,3714,5296,3249,0,3250,1832,1418,1.291960508,1962,378,42,34,31,3,20,2,0.096774194,0,empty,CD-0722-2
"B5,B12",530980,629378,392236,237142,365752,204929,1,205065,153410,51655,2.969896428,122838,59035,11036,4074,4018,56,794,5,0.037829766,0,hg38,CD-0722-2
"B5,C1",8125,8923,6064,2859,5265,2734,1,2744,1714,1030,1.66407767,1472,1335,278,105,101,4,33,2,0.04950495,0,empty,CD-0722-2
"B5,C2",7048,8138,4956,3182,4800,2776,0,2780,1736,1044,1.662835249,1637,2505,807,277,275,2,82,1,0.029090909,0,empty,CD-0722-2
"B5,C3",6974,8130,5142,2988,4786,2644,1,2646,1706,940,1.814893617,1511,1233,186,89,89,0,44,0,0.011235955,0,empty,CD-0722-2
"B5,C4",549104,646591,404721,241870,373324,209259,1,209440,165937,43503,3.814380617,123693,165535,31030,11994,11828,166,1777,9,0.051657085,0,hg38,CD-0722-2
"B5,C5",10436,11232,6881,4351,6592,3936,0,3936,2697,1239,2.176755448,2327,2245,526,245,244,1,82,1,0.098360656,0,empty,CD-0722-2
"B5,C6",6429,7183,4720,2463,4385,2379,0,2380,1650,730,2.260273973,1364,2151,525,200,198,2,74,2,0.005050505,0,empty,CD-0722-2
"B5,C7",7780,9107,5582,3525,5473,3299,0,3299,1992,1307,1.524100995,1964,406,63,38,37,1,28,1,0.027027027,0,empty,CD-0722-2
"B5,C8",9609,11013,6931,4082,6402,3579,0,3583,2329,1254,1.857256778,2084,3808,913,342,336,6,121,3,0.035714286,0,empty,CD-0722-2
"B5,C9",660647,810148,480672,329476,464784,275416,2,275649,221060,54589,4.049533789,168583,101797,8791,3467,3332,135,807,6,0.034813926,0,hg38,CD-0722-2
"B5,C10",6519,7332,4866,2466,4365,2342,0,2342,1481,861,1.720092915,1307,2109,428,194,192,2,72,1,0.083333333,0,empty,CD-0722-2
"B5,C11",5417,6128,3850,2278,3740,2039,0,2042,1290,752,1.715425532,1215,2042,341,160,156,4,72,2,0.115384615,0,empty,CD-0722-2
"B5,C12",7230,8083,5306,2777,4863,2600,0,2605,1677,928,1.807112069,1479,2152,660,278,278,0,88,0,0.075539568,0,empty,CD-0722-2
"B5,D1",21600,27509,12971,14538,16718,12490,0,12498,8157,4341,1.879060124,8236,970,182,61,61,0,31,0,0.016393443,0,empty,CD-0722-2
"B5,D2",5712,6514,4237,2277,3856,2028,0,2030,1342,688,1.950581395,1111,3359,803,319,316,3,122,2,0.03164557,0,empty,CD-0722-2
"B5,D3",5061,5647,3672,1975,3402,1881,0,1881,1221,660,1.85,1066,1709,361,193,193,0,77,0,0.020725389,0,empty,CD-0722-2
"B5,D4",3980,4615,2877,1738,2740,1557,0,1557,979,578,1.693771626,915,1370,273,124,123,1,52,1,0.032520325,0,empty,CD-0722-2
"B5,D5",1394422,1552024,1075789,476235,876582,440689,0,441021,348908,92113,3.787825823,245866,107462,21475,7862,7768,94,1361,4,0.025102987,0,hg38,CD-0722-2
"B5,D6",7399,8515,5216,3299,5021,2957,0,2968,1746,1222,1.428805237,1719,2537,608,255,252,3,81,2,0.095238095,0,empty,CD-0722-2
"B5,D7",3928,4472,2865,1607,2636,1444,0,1448,924,524,1.763358779,822,2706,701,260,260,0,92,0,0.153846154,0,empty,CD-0722-2
"B5,D8",1096716,1248589,819418,429171,708507,383390,2,383774,320058,63716,5.023196685,223419,86743,15517,5828,5737,91,1068,4,0.014990413,0,hg38,CD-0722-2
"B5,D9",678402,798191,512477,285714,456502,253029,0,253238,200843,52395,3.833247447,147234,105390,17301,6358,6253,105,1221,3,0.033743803,0,hg38,CD-0722-2
"B5,D10",557724,671070,406634,264436,386695,224800,0,224962,176077,48885,3.601861512,136901,84219,14861,5831,5729,102,990,5,0.078198639,0,hg38,CD-0722-2
"B5,D11",5317,5725,3977,1748,3386,1735,0,1736,1125,611,1.841243863,949,4219,931,383,377,6,113,2,0.108753316,0,empty,CD-0722-2
"B5,D12",6708,7729,4877,2852,4539,2507,0,2509,1649,860,1.91744186,1478,4149,1228,526,520,6,168,2,0.092307692,0,empty,CD-0722-2
"B5,E1",8301,9273,5997,3276,5467,3079,0,3090,1898,1192,1.592281879,1737,3213,908,404,400,4,113,3,0.0375,0,empty,CD-0722-2
"B5,E2",1032945,1233554,752715,480839,709956,412313,2,412640,320025,92615,3.455433785,249502,172825,20621,8089,7928,161,1516,5,0.043642785,0,hg38,CD-0722-2
"B5,E3",3748,4140,2764,1376,2518,1319,2,1321,866,455,1.903296703,742,2298,586,254,249,5,83,2,0.136546185,0,empty,CD-0722-2
"B5,E4",305748,354222,234865,119357,203409,105700,1,105771,79583,26188,3.038910952,60786,62401,8522,3501,3427,74,702,4,0.073825503,0,hg38,CD-0722-2
"B5,E5",4839,5277,3638,1639,3100,1581,0,1581,1032,549,1.879781421,818,1403,276,146,141,5,60,3,0.014184397,0,empty,CD-0722-2
"B5,E6",8787,10012,6330,3682,5883,3344,0,3345,2115,1230,1.719512195,1900,3908,949,436,436,0,133,0,0.03440367,0,empty,CD-0722-2
"B5,E7",7805,8616,5772,2844,5067,2696,0,2696,1816,880,2.063636364,1485,3325,652,290,287,3,97,2,0.12195122,0,empty,CD-0722-2
"B5,E8",6170,6798,4668,2130,3975,2019,0,2020,1364,656,2.079268293,1108,3132,642,286,281,5,102,1,0.06405694,0,empty,CD-0722-2
"B5,E9",508435,616847,369466,247381,353202,205145,2,205296,163553,41743,3.918094052,123951,332380,34646,14118,13633,485,2207,11,0.062862173,0,hg38,CD-0722-2
"B5,E10",4635,5302,3430,1872,3096,1707,0,1707,1103,604,1.82615894,981,1886,559,211,205,6,66,3,0.034146341,0,empty,CD-0722-2
"B5,E11",5407,5925,4016,1909,3692,1996,0,1996,1259,737,1.708276798,1114,2255,433,178,176,2,69,1,0.096590909,0,empty,CD-0722-2
"B5,E12",596215,670957,455930,215027,386199,194738,0,194914,147282,47632,3.092080954,111157,44370,3971,1557,1474,83,435,6,0.059023066,0,hg38,CD-0722-2
"B5,F1",7348,8093,5345,2748,4943,2768,0,2769,1777,992,1.791330645,1554,2668,626,258,255,3,91,2,0.015686275,0,empty,CD-0722-2
"B5,F2",5456,6121,4027,2094,3689,1983,0,1983,1291,692,1.865606936,1138,3233,720,281,278,3,90,1,0.075539568,0,empty,CD-0722-2
"B5,F3",5100,5645,3732,1913,3384,1802,0,1802,1200,602,1.993355482,995,2837,696,318,317,1,92,1,0.157728707,0,empty,CD-0722-2
"B5,F4",8037,8902,5870,3032,5411,2847,0,2847,1879,968,1.941115702,1620,1068,161,76,74,2,43,2,0.243243243,0,empty,CD-0722-2
"B5,F5",5934,6720,4387,2333,3964,2104,0,2104,1375,729,1.886145405,1184,2143,471,179,179,0,77,0,0.106145251,0,empty,CD-0722-2
"B5,F6",6302,7260,4473,2787,4239,2443,0,2445,1507,938,1.606609808,1433,2985,632,256,253,3,80,2,0.04743083,0,empty,CD-0722-2
"B5,F7",7166,7921,5383,2538,4892,2643,0,2644,1713,931,1.839957035,1443,1089,130,65,63,2,32,2,0.111111111,0,empty,CD-0722-2
"B5,F8",4934,5513,3529,1984,3334,1866,0,1868,1213,655,1.851908397,1066,481,99,61,59,2,38,2,0.118644068,0,empty,CD-0722-2
"B5,F9",647119,755673,484411,271262,433447,241695,1,241874,185157,56717,3.264576758,140175,129001,21447,7849,7706,143,1463,5,0.03802232,0,hg38,CD-0722-2
"B5,F10",780155,911004,581321,329683,517644,285797,2,286039,231869,54170,4.280395053,166583,116886,17692,6636,6509,127,1266,7,0.0519281,0,hg38,CD-0722-2
"B5,F11",5905,6565,4457,2108,3904,2021,0,2025,1332,693,1.922077922,1141,2185,378,180,180,0,60,0,0.127777778,0,empty,CD-0722-2
"B5,F12",621258,735184,454517,280667,418624,237152,2,237354,188327,49027,3.841291533,142012,12838,1788,657,643,14,154,4,0.080870918,0,hg38,CD-0722-2
"B5,G1",1063350,1248434,808014,440420,707250,390610,4,390996,323580,67416,4.799750801,224838,336844,56732,20994,20613,381,2658,5,0.053606947,0,hg38,CD-0722-2
"B5,G2",4177,4698,2913,1785,2901,1676,0,1677,1092,585,1.866666667,995,788,132,79,77,2,42,2,0.077922078,0,empty,CD-0722-2
"B5,G3",563012,644464,416616,227848,369862,200930,0,201105,159094,42011,3.786960558,116877,282575,41512,16127,15726,401,2208,10,0.059455678,0,hg38,CD-0722-2
"B5,G4",13366,15549,9489,6060,9314,5650,1,5652,3439,2213,1.553999096,3307,214,39,27,26,1,17,1,0.153846154,0,empty,CD-0722-2
"B5,G5",4591,5187,3263,1924,3195,1814,0,1819,1208,611,1.977086743,1072,2055,359,195,188,7,85,1,0.074468085,0,empty,CD-0722-2
"B5,G6",6689,7642,4978,2664,4582,2554,0,2554,1725,829,2.080820265,1472,265,73,13,13,0,11,0,0.153846154,0,empty,CD-0722-2
"B5,G7",11282,13066,8635,4431,7606,3930,0,3933,2829,1104,2.5625,2191,4878,932,364,358,6,103,2,0.094972067,0,empty,CD-0722-2
"B5,G8",3937,4438,2793,1645,2630,1420,0,1421,890,531,1.676082863,805,2267,683,258,257,1,71,1,0.186770428,0,empty,CD-0722-2
"B5,G9",4588,5325,3341,1984,3088,1728,0,1728,1105,623,1.773675762,999,2816,780,324,323,1,103,1,0.105263158,0,empty,CD-0722-2
"B5,G10",1130557,1341487,842120,499367,764219,436902,4,437209,371617,65592,5.665584218,257278,342275,48249,19065,18629,436,2671,8,0.061570669,0,hg38,CD-0722-2
"B5,G11",5410,5843,4017,1826,3584,1833,0,1833,1190,643,1.850699844,1009,1547,409,173,172,1,62,1,0.046511628,0,empty,CD-0722-2
"B5,G12",4829,5690,3458,2232,3326,1869,0,1876,1185,691,1.714905933,1122,2606,717,290,285,5,109,2,0.021052632,0,empty,CD-0722-2
"B5,H1",5097,5920,3642,2278,3511,1901,0,1901,1245,656,1.897865854,1158,1858,375,184,183,1,75,1,0.054644809,0,empty,CD-0722-2
"B5,H2",5523,6304,4023,2281,3816,2063,0,2064,1358,706,1.923512748,1220,2835,591,264,258,6,101,2,0.015503876,0,empty,CD-0722-2
"B5,H3",4787,5393,3476,1917,3179,1737,0,1743,1145,598,1.914715719,1002,1822,446,199,195,4,79,1,0.117948718,0,empty,CD-0722-2
"B5,H4",6859,7793,4969,2824,4582,2492,0,2496,1655,841,1.967895363,1457,226,45,32,32,0,20,0,0.03125,0,empty,CD-0722-2
"B5,H5",1376072,1700380,961897,738483,965187,623786,3,624208,470141,154067,3.05153602,385048,177190,29852,11901,11708,193,1860,6,0.060556884,0,hg38,CD-0722-2
"B5,H6",4751,5342,3499,1843,3164,1747,0,1750,1183,567,2.086419753,968,2362,473,222,222,0,83,0,0.09009009,0,empty,CD-0722-2
"B5,H7",5083,5578,3737,1841,3357,1754,0,1755,1154,601,1.920133111,965,3103,835,355,355,0,109,0,0.143661972,0,empty,CD-0722-2
"B5,H8",12472,14645,9145,5500,8627,4822,0,4825,3496,1329,2.630549285,2795,2939,581,249,242,7,93,2,0.016528926,0,empty,CD-0722-2
"B5,H9",4400,4819,3289,1530,2870,1453,1,1459,1019,440,2.315909091,809,1196,220,117,114,3,48,1,0.01754386,0,empty,CD-0722-2
"B5,H10",4311,4908,3131,1777,2921,1627,0,1627,1054,573,1.839441536,953,1857,458,202,197,5,81,2,0.035532995,0,empty,CD-0722-2
"B5,H11",6040,7019,4196,2823,4229,2738,0,2739,1459,1280,1.13984375,1634,132,34,22,22,0,9,0,0.090909091,0,empty,CD-0722-2
"B5,H12",4454,5185,3220,1965,3025,1699,0,1701,1089,612,1.779411765,1017,1607,330,148,144,4,39,1,0.069444444,0,empty,CD-0722-2
"B6,A1",4073,4587,2953,1634,2715,1525,0,1527,985,542,1.817343173,880,1059,224,104,104,0,45,0,0.307692308,0,empty,CD-0722-2
"B6,A2",5900,6749,4307,2442,4089,2352,0,2352,1502,850,1.767058824,1346,1316,296,121,117,4,56,3,0.05982906,0,empty,CD-0722-2
"B6,A3",3797,4272,2771,1501,2521,1364,0,1366,899,467,1.925053533,785,1219,346,143,143,0,46,0,0.041958042,0,empty,CD-0722-2
"B6,A4",536589,598183,414331,183852,343510,170953,2,171116,128678,42438,3.032141006,95674,10218,1882,713,707,6,191,2,0.033946252,0,hg38,CD-0722-2
"B6,A5",5133,5693,3709,1984,3480,1865,0,1872,1186,686,1.728862974,1086,2356,529,183,181,2,44,2,0.182320442,0,empty,CD-0722-2
"B6,A6",6044,7131,4338,2793,4262,2501,0,2503,1659,844,1.96563981,1477,2820,567,259,257,2,85,1,0.140077821,0,empty,CD-0722-2
"B6,A7",4118,4981,2962,2019,3000,1805,0,1808,1192,616,1.935064935,1097,1545,416,134,133,1,38,1,0.022556391,0,empty,CD-0722-2
"B6,A8",2778,3137,2004,1133,1915,1049,0,1049,742,307,2.416938111,606,1619,248,120,118,2,59,1,0.016949153,0,empty,CD-0722-2
"B6,A9",4095,4610,3015,1595,2791,1480,0,1481,954,527,1.810246679,834,1452,295,143,143,0,50,0,0.272727273,0,empty,CD-0722-2
"B6,A10",4841,5235,3697,1538,3219,1700,0,1700,1061,639,1.660406886,851,422,103,45,44,1,26,1,0.159090909,0,empty,CD-0722-2
"B6,A11",3522,3804,2634,1170,2354,1235,0,1241,833,408,2.041666667,671,1606,380,170,169,1,55,1,0.124260355,0,empty,CD-0722-2
"B6,A12",5134,5795,3777,2018,3431,1781,0,1781,1111,670,1.658208955,1020,3483,885,308,304,4,97,2,0.016447368,0,empty,CD-0722-2
"B6,B1",4339,4870,3149,1721,2913,1638,0,1639,1058,581,1.820998279,951,1068,173,81,81,0,37,0,0.012345679,0,empty,CD-0722-2
"B6,B2",4828,5413,3239,2174,3314,1965,0,1965,1248,717,1.740585774,1179,620,144,64,64,0,19,0,0.015625,0,empty,CD-0722-2
"B6,B3",3776,4361,2683,1678,2746,1547,0,1549,1035,514,2.013618677,930,1488,358,153,151,2,64,1,0.046357616,0,empty,CD-0722-2
"B6,B4",373411,479957,246643,233314,282351,197554,0,197675,150119,47556,3.156678442,124951,2540,697,231,229,2,96,2,0.091703057,0,hg38,CD-0722-2
"B6,B5",4477,2910,1764,1146,2126,1235,0,1240,811,429,1.89044289,787,811,154,61,58,3,38,1,0.24137931,0,empty,CD-0722-2
"B6,B6",468532,561770,339162,222608,324923,189720,2,189861,146640,43221,3.392795169,114922,86864,15071,5923,5796,127,1047,6,0.053485162,0,hg38,CD-0722-2
"B6,B7",4234,4916,3080,1836,2931,1589,0,1591,1010,581,1.7383821,942,1056,166,71,71,0,33,0,0.042253521,0,empty,CD-0722-2
"B6,B8",319962,403750,220690,183060,239146,158190,1,158310,120130,38180,3.146411734,99318,2516,770,168,167,1,66,1,0.041916168,0,hg38,CD-0722-2
"B6,B9",2825364,3315304,2098726,1216578,1815179,1059267,5,1060059,890767,169292,5.261719396,621521,241923,33316,12842,12619,223,2182,8,0.059037959,0,hg38,CD-0722-2
"B6,B10",2912,3234,2069,1165,2018,1096,0,1097,708,389,1.820051414,662,491,118,48,47,1,23,1,0.042553191,0,empty,CD-0722-2
"B6,B11",7323,8514,5152,3362,5030,3017,0,3019,1701,1318,1.290591806,1837,383,49,37,37,0,21,0,0.027027027,0,empty,CD-0722-2
"B6,B12",3762,4050,2712,1338,2500,1334,1,1338,931,407,2.287469287,730,1560,325,145,143,2,45,1,0.188811189,0,empty,CD-0722-2
"B6,C1",7765,8735,5776,2959,5241,2787,0,2795,1787,1008,1.77281746,1637,988,218,97,95,2,28,1,0.042105263,0,empty,CD-0722-2
"B6,C2",6418,7462,4523,2939,4596,2655,0,2657,1659,998,1.662324649,1584,1873,713,288,286,2,75,1,0.062937063,0,empty,CD-0722-2
"B6,C3",6431,7314,4752,2562,4437,2384,0,2384,1555,829,1.87575392,1319,920,186,88,85,3,31,2,0.129411765,0,empty,CD-0722-2
"B6,C4",545231,624086,410481,213605,362863,192972,2,193146,151327,41819,3.618618331,110627,46549,7494,2938,2888,50,616,3,0.064750693,0,hg38,CD-0722-2
"B6,C5",5836,6794,4290,2504,4102,2252,0,2255,1460,795,1.836477987,1345,1758,278,102,98,4,42,1,0.071428571,0,empty,CD-0722-2
"B6,C6",6077,6735,4554,2181,4106,2240,0,2242,1474,768,1.919270833,1196,1332,334,121,116,5,47,3,0.103448276,0,empty,CD-0722-2
"B6,C7",6970,8268,4911,3357,5002,3048,0,3048,1811,1237,1.464025869,1865,442,111,60,60,0,24,0,0.016666667,0,empty,CD-0722-2
"B6,C8",622034,748288,450566,297722,432628,256203,4,256419,203501,52918,3.845591292,154144,49132,8969,3477,3433,44,772,6,0.09059132,0,hg38,CD-0722-2
"B6,C9",5274,6392,3821,2571,3748,2123,0,2123,1373,750,1.830666667,1293,1461,172,86,85,1,33,1,0.141176471,0,empty,CD-0722-2
"B6,C10",517574,584258,393099,191159,337763,174934,0,175090,132098,42992,3.072618162,99614,33674,6009,2237,2186,51,439,5,0.040256176,0,hg38,CD-0722-2
"B6,C11",5369,6248,3981,2267,3738,2045,0,2048,1291,757,1.705416116,1172,1878,574,209,209,0,59,0,0.04784689,0,empty,CD-0722-2
"B6,C12",7040,7963,5202,2761,4837,2606,0,2611,1631,980,1.664285714,1484,1590,472,202,198,4,63,1,0.101010101,0,empty,CD-0722-2
"B6,D1",6863,8083,4944,3139,4808,2768,0,2771,1597,1174,1.360306644,1673,737,156,51,50,1,24,1,0,0,empty,CD-0722-2
"B6,D2",5422,6085,4024,2061,3654,1918,0,1918,1284,634,2.025236593,1089,2523,597,268,264,4,84,3,0.083333333,0,empty,CD-0722-2
"B6,D3",4673,5462,3377,2085,3314,1872,0,1873,1228,645,1.903875969,1076,1309,224,96,91,5,44,2,0,0,empty,CD-0722-2
"B6,D4",3737,4315,2785,1530,2628,1445,0,1445,949,496,1.913306452,851,997,212,89,88,1,38,1,0,0,empty,CD-0722-2
"B6,D5",3998,4633,2939,1694,2862,1582,0,1582,1049,533,1.968105066,918,1754,355,153,152,1,52,1,0.078947368,0,empty,CD-0722-2
"B6,D6",6935,8257,4891,3366,4934,2957,0,2960,1785,1175,1.519148936,1824,3039,803,307,301,6,80,3,0.013289037,0,empty,CD-0722-2
"B6,D7",3539,4093,2599,1494,2479,1349,0,1353,889,464,1.915948276,792,2005,433,204,202,2,65,2,0.128712871,0,empty,CD-0722-2
"B6,D8",1269866,1536601,924274,612327,874866,514133,1,514516,409010,105506,3.876651565,312668,181767,30299,11411,11223,188,1811,6,0.072707832,0,hg38,CD-0722-2
"B6,D9",780353,871702,590561,281141,499849,256490,2,256711,216980,39731,5.46122675,145223,93969,16252,6032,5948,84,1055,4,0.035137861,0,hg38,CD-0722-2
"B6,D10",552600,651899,409528,242371,377011,209915,1,210133,163557,46576,3.511615424,124782,76291,11633,4443,4364,79,877,5,0.05659945,0,hg38,CD-0722-2
"B6,D11",441759,549315,308082,241233,320340,212287,1,212435,144612,67823,2.132197042,130151,25356,1711,680,640,40,179,3,0.3109375,0,hg38,CD-0722-2
"B6,D12",6231,6983,4585,2398,4153,2249,0,2249,1471,778,1.890745501,1225,2753,841,367,362,5,119,2,0.027624309,0,empty,CD-0722-2
"B6,E1",7441,8722,5262,3460,5224,3041,0,3042,1930,1112,1.735611511,1874,1754,334,148,148,0,59,0,0.114864865,0,empty,CD-0722-2
"B6,E2",5434,6244,3940,2304,3716,2076,0,2079,1395,684,2.039473684,1178,1419,300,127,123,4,47,2,0.040650407,0,empty,CD-0722-2
"B6,E3",3571,4051,2633,1418,2535,1332,0,1335,860,475,1.810526316,776,1790,389,202,202,0,72,0,0.173267327,0,empty,CD-0722-2
"B6,E4",5140,5709,3774,1935,3410,1869,0,1871,1191,680,1.751470588,1069,2585,512,228,226,2,75,1,0.044247788,0,empty,CD-0722-2
"B6,E5",4714,5250,3498,1752,3134,1645,0,1647,1063,584,1.820205479,923,1520,440,159,159,0,48,0,0.081761006,0,empty,CD-0722-2
"B6,E6",8184,9393,6020,3373,5492,3071,0,3075,1964,1111,1.767776778,1751,2816,573,244,240,4,85,2,0.008333333,0,empty,CD-0722-2
"B6,E7",7406,8418,5456,2962,5019,2708,0,2710,1758,952,1.846638655,1569,2566,487,178,177,1,62,1,0.096045198,0,empty,CD-0722-2
"B6,E8",5904,6478,4430,2048,3923,2049,0,2053,1332,721,1.847434119,1128,2948,633,301,296,5,76,2,0.10472973,0,empty,CD-0722-2
"B6,E9",3701,4168,2732,1436,2533,1370,0,1374,906,468,1.935897436,805,1981,387,144,143,1,60,1,0.090909091,0,empty,CD-0722-2
"B6,E10",4364,4751,3235,1516,2948,1594,0,1594,1016,578,1.757785467,894,1240,449,184,182,2,63,1,0.032967033,0,empty,CD-0722-2
"B6,E11",5061,5808,3701,2107,3443,1920,0,1920,1184,736,1.608695652,1103,1657,246,99,98,1,46,1,0.040816327,0,empty,CD-0722-2
"B6,E12",6859,7834,4995,2839,4731,2564,0,2564,1754,810,2.165432099,1477,1815,377,178,175,3,59,2,0.131428571,0,empty,CD-0722-2
"B6,F1",6712,7540,4745,2795,4471,2477,0,2479,1550,929,1.66846071,1462,2380,631,212,212,0,77,0,0.033018868,0,empty,CD-0722-2
"B6,F2",4909,5471,3631,1840,3309,1772,0,1773,1158,615,1.882926829,985,2598,741,310,305,5,69,2,0.281967213,0,empty,CD-0722-2
"B6,F3",4854,5409,3636,1773,3294,1706,0,1710,1114,596,1.869127517,1002,2040,458,185,184,1,76,1,0.076086957,0,empty,CD-0722-2
"B6,F4",7660,8331,5672,2659,4973,2569,0,2573,1680,893,1.881298992,1412,784,127,67,66,1,33,1,0.03030303,0,empty,CD-0722-2
"B6,F5",1216822,1389539,897186,492353,785392,434786,6,435192,350396,84796,4.132223218,251713,147818,26642,10149,9974,175,1716,4,0.046520954,0,hg38,CD-0722-2
"B6,F6",5757,6594,4082,2512,3931,2258,0,2258,1454,804,1.808457711,1343,2216,360,152,149,3,68,1,0.026845638,0,empty,CD-0722-2
"B6,F7",6837,7585,4969,2616,4626,2536,0,2540,1602,938,1.707889126,1447,1074,328,125,125,0,39,0,0.024,0,empty,CD-0722-2
"B6,F8",4806,5502,3646,1856,3256,1731,0,1733,1168,565,2.067256637,945,322,81,50,50,0,30,0,0,0,empty,CD-0722-2
"B6,F9",5149,5701,3869,1832,3439,1738,0,1746,1179,567,2.079365079,996,2692,693,302,297,5,95,2,0.127946128,0,empty,CD-0722-2
"B6,F10",805637,921815,613841,307974,525556,276504,1,276744,220829,55915,3.949369579,156891,171552,18569,7481,7261,220,1351,6,0.059633659,0,hg38,CD-0722-2
"B6,F11",4936,5588,3712,1876,3366,1719,0,1721,1100,621,1.771336554,975,1131,212,101,100,1,39,1,0.09,0,empty,CD-0722-2
"B6,F12",5709,6174,4160,2014,3692,2018,0,2019,1302,717,1.815899582,1125,166,21,13,12,1,12,1,0.166666667,0,empty,CD-0722-2
"B6,G1",6364,7200,4692,2508,4345,2305,0,2312,1494,818,1.826405868,1323,2280,423,182,176,6,76,1,0.056818182,0,empty,CD-0722-2
"B6,G2",3818,4417,2667,1750,2654,1541,2,1550,1002,548,1.828467153,949,779,180,84,83,1,42,1,0.036144578,0,empty,CD-0722-2
"B6,G3",2122267,2544976,1575061,969915,1417253,840309,1,841025,696857,144168,4.833645469,502352,377176,74331,28693,28312,381,3462,10,0.056124611,0,hg38,CD-0722-2
"B6,G4",12651,14780,8927,5853,8804,5325,0,5328,3247,2081,1.560307544,3131,114,22,12,12,0,9,0,0,0,empty,CD-0722-2
"B6,G5",4162,4828,3061,1767,2888,1608,0,1609,1063,546,1.946886447,949,1659,389,179,175,4,61,1,0.045714286,0,empty,CD-0722-2
"B6,G6",6064,6754,4510,2244,4040,2153,0,2155,1392,763,1.824377457,1194,287,78,21,21,0,14,0,0.095238095,0,empty,CD-0722-2
"B6,G7",4779,5139,3595,1544,3173,1604,0,1609,1060,549,1.930783242,878,2279,549,239,234,5,62,2,0.064102564,0,empty,CD-0722-2
"B6,G8",3435,3780,2513,1267,2273,1213,0,1217,744,473,1.572938689,678,1697,293,122,122,0,45,0,0.081967213,0,empty,CD-0722-2
"B6,G9",4582,5160,3314,1846,3115,1699,0,1699,1118,581,1.924268503,1002,1816,477,201,198,3,51,1,0.050505051,0,empty,CD-0722-2
"B6,G10",5177,5914,3742,2172,3565,2019,0,2019,1269,750,1.692,1200,1888,303,145,144,1,66,1,0.104166667,0,empty,CD-0722-2
"B6,G11",895680,1062558,667405,395153,610766,351615,3,351902,287885,64017,4.497008607,204600,51402,16036,5944,5909,35,1036,3,0.11440176,0,hg38,CD-0722-2
"B6,G12",4452,5176,3257,1919,3076,1755,0,1761,1133,628,1.804140127,998,2173,578,234,232,2,84,1,0.068965517,0,empty,CD-0722-2
"B6,H1",4518,5126,3349,1777,3125,1674,0,1674,1113,561,1.983957219,968,1100,249,78,78,0,43,0,0,0,empty,CD-0722-2
"B6,H2",5488,6511,3981,2530,3907,2248,0,2252,1470,782,1.879795396,1355,2219,628,216,213,3,76,2,0.042253521,0,empty,CD-0722-2
"B6,H3",617053,743250,443772,299478,427353,252644,0,252805,207008,45797,4.520121405,154456,92250,14106,5571,5498,73,1054,6,0.043652237,0,hg38,CD-0722-2
"B6,H4",6424,7511,4607,2904,4480,2458,0,2458,1646,812,2.027093596,1499,303,83,37,37,0,14,0,0.081081081,0,empty,CD-0722-2
"B6,H5",7200,8003,5094,2909,4772,2716,0,2719,1789,930,1.923655914,1586,2112,441,212,209,3,81,2,0.162679426,0,empty,CD-0722-2
"B6,H6",516243,618026,377326,240700,358709,205702,1,205852,166804,39048,4.27176808,124028,188344,33839,12959,12772,187,1900,5,0.052693392,0,hg38,CD-0722-2
"B6,H7",467700,549526,339066,210460,321823,185424,6,185588,147602,37986,3.88569473,111033,159255,22363,8543,8336,207,1485,9,0.038507678,0,hg38,CD-0722-2
"B6,H8",5446,6453,3936,2517,3814,2137,0,2143,1362,781,1.743918054,1286,1783,337,133,130,3,59,2,0.069230769,0,empty,CD-0722-2
"B6,H9",4496,4897,3362,1535,2996,1559,0,1560,1033,527,1.960151803,894,1018,267,102,102,0,33,0,0.029411765,0,empty,CD-0722-2
"B6,H10",431658,552077,288599,263478,320831,226538,4,226689,144991,81698,1.774719087,142424,1740,425,145,142,3,65,1,0.105633803,0,hg38,CD-0722-2
"B6,H11",5233,6370,3616,2754,3891,2537,0,2540,1433,1107,1.294489612,1557,124,18,14,14,0,11,0,0,0,empty,CD-0722-2
"B6,H12",4034,4511,2908,1603,2720,1558,0,1560,974,586,1.662116041,873,1333,263,98,96,2,35,2,0.010416667,0,empty,CD-0722-2
"B7,A1",715255,840807,535681,305126,471988,256730,2,256975,197512,59463,3.321594941,151387,115381,15452,5719,5587,132,1037,6,0.063003401,0,hg38,CD-0722-2
"B7,A2",7044,8226,5159,3067,4783,2752,0,2754,1730,1024,1.689453125,1623,1408,312,124,123,1,34,1,0.073170732,0,empty,CD-0722-2
"B7,A3",4443,4842,3273,1569,2888,1552,0,1555,1052,503,2.091451292,862,1206,396,137,134,3,39,2,0.052238806,0,empty,CD-0722-2
"B7,A4",7421,8390,5391,2999,4798,2636,0,2638,1735,903,1.9213732,1480,891,209,106,105,1,28,1,0.066666667,0,empty,CD-0722-2
"B7,A5",6033,6808,4417,2391,4049,2199,0,2199,1467,732,2.004098361,1255,2087,310,140,140,0,47,0,0.035714286,0,empty,CD-0722-2
"B7,A6",5676,6697,4185,2512,4011,2297,0,2299,1499,800,1.87375,1346,2326,479,214,205,9,75,2,0.014634146,0,empty,CD-0722-2
"B7,A7",555861,642233,421940,220293,360140,190653,1,190846,147664,43182,3.41957297,109770,66017,9602,3590,3529,61,652,7,0.055539813,0,hg38,CD-0722-2
"B7,A8",2781,3270,2096,1174,1924,1039,0,1039,703,336,2.092261905,608,1872,436,177,176,1,57,1,0.130681818,0,empty,CD-0722-2
"B7,A9",5560,6290,4213,2077,3630,1958,0,1959,1295,664,1.950301205,1074,1519,360,167,166,1,43,1,0.295180723,0,empty,CD-0722-2
"B7,A10",6103,6869,4587,2282,3963,2097,0,2099,1369,730,1.875342466,1158,419,119,37,37,0,7,0,0.513513514,0,empty,CD-0722-2
"B7,A11",4391,4770,3303,1467,2838,1437,0,1438,981,457,2.146608315,775,1578,311,127,125,2,48,1,0,0,empty,CD-0722-2
"B7,A12",6461,7314,4748,2566,4216,2230,0,2230,1383,847,1.632821724,1307,3008,747,279,278,1,85,1,0.021582734,0,empty,CD-0722-2
"B7,B1",5194,5989,3740,2249,3515,1994,0,2000,1233,767,1.60756193,1145,1089,226,75,75,0,36,0,0,0,empty,CD-0722-2
"B7,B2",5480,6208,3814,2394,3673,2146,0,2146,1338,808,1.655940594,1252,964,262,72,69,3,16,1,0.434782609,0,empty,CD-0722-2
"B7,B3",543836,630355,408859,221496,355908,188489,2,188642,145631,43011,3.385901281,110602,63532,9326,3611,3545,66,702,4,0.05528914,0,hg38,CD-0722-2
"B7,B4",5263,6120,3784,2336,3610,2110,0,2112,1272,840,1.514285714,1216,1356,342,138,138,0,47,0,0.072463768,0,empty,CD-0722-2
"B7,B5",5870,3850,2307,1543,2682,1524,0,1531,986,545,1.809174312,976,993,146,68,67,1,33,1,0.119402985,0,empty,CD-0722-2
"B7,B6",5951,7043,4129,2914,4139,2493,0,2499,1546,953,1.62224554,1504,1681,356,151,150,1,52,1,0.073333333,0,empty,CD-0722-2
"B7,B7",830418,1029474,582681,446793,579770,379011,2,379298,291759,87539,3.332903049,229581,2929,745,294,292,2,143,2,0.037671233,0,hg38,CD-0722-2
"B7,B8",3892,4387,2848,1539,2613,1390,0,1392,909,483,1.881987578,793,1315,281,120,119,1,31,1,0.008403361,0,empty,CD-0722-2
"B7,B9",7753,8958,5575,3383,5244,2962,0,2966,1900,1066,1.782363977,1778,1241,337,99,99,0,35,0,0.060606061,0,empty,CD-0722-2
"B7,B10",3547,3964,2544,1420,2331,1234,0,1239,817,422,1.936018957,729,506,56,30,30,0,15,0,0.066666667,0,empty,CD-0722-2
"B7,B11",8686,10093,6103,3990,5883,3595,0,3597,2028,1569,1.292543021,2115,235,30,21,21,0,14,0,0,0,empty,CD-0722-2
"B7,B12",4867,5564,3552,2012,3309,1835,0,1838,1248,590,2.115254237,1067,1508,285,112,111,1,40,1,0.117117117,0,empty,CD-0722-2
"B7,C1",8822,9757,6520,3237,5604,2897,0,2905,1852,1053,1.758784425,1628,994,237,92,92,0,28,0,0,0,empty,CD-0722-2
"B7,C2",7401,8477,5331,3146,4959,2848,0,2850,1823,1027,1.775073028,1639,1652,470,191,190,1,55,1,0.078947368,0,empty,CD-0722-2
"B7,C3",780421,965836,561941,403895,540277,328231,3,328459,266672,61787,4.3159888,202562,19000,2820,1042,1023,19,280,2,0.022482893,0,hg38,CD-0722-2
"B7,C4",5046,5602,3804,1798,3288,1685,0,1687,1148,539,2.12987013,955,1305,241,103,103,0,51,0,0,0,empty,CD-0722-2
"B7,C5",7187,8080,5195,2885,4737,2587,0,2589,1678,911,1.841931943,1492,1611,399,175,174,1,51,1,0.051724138,0,empty,CD-0722-2
"B7,C6",7349,8488,5372,3116,4998,2783,0,2790,1871,919,2.035908596,1654,1415,371,146,145,1,40,1,0.020689655,0,empty,CD-0722-2
"B7,C7",8182,9662,5770,3892,5738,3585,0,3588,2096,1492,1.404825737,2198,512,79,34,34,0,16,0,0,0,empty,CD-0722-2
"B7,C8",554208,618998,426834,192164,347500,174684,1,174865,133000,41865,3.17687806,97836,37580,8326,2987,2933,54,567,3,0.017729287,0,hg38,CD-0722-2
"B7,C9",6221,7194,4540,2654,4181,2276,0,2284,1537,747,2.057563588,1318,1328,270,107,105,2,41,1,0.038095238,0,empty,CD-0722-2
"B7,C10",1140745,1349787,862648,487139,739235,417144,3,417540,334918,82622,4.053617681,242647,17554,1989,733,720,13,280,3,0.038888889,0,hg38,CD-0722-2
"B7,C11",5979,6891,4306,2585,4031,2206,0,2206,1410,796,1.771356784,1280,1378,238,110,110,0,41,0,0.045454545,0,empty,CD-0722-2
"B7,C12",519627,646058,360831,285227,367880,233680,2,233899,184313,49586,3.717037067,146660,12818,5649,2001,1997,4,460,1,0.024536805,0,hg38,CD-0722-2
"B7,D1",7639,9059,5524,3535,5333,3126,0,3126,1863,1263,1.475059382,1867,908,122,65,64,1,26,1,0.0625,0,empty,CD-0722-2
"B7,D2",6190,7027,4632,2395,4132,2182,0,2185,1420,765,1.85620915,1247,2836,717,281,280,1,81,1,0.067857143,0,empty,CD-0722-2
"B7,D3",5562,6403,4155,2248,3735,2068,0,2071,1418,653,2.17151608,1179,1280,211,93,93,0,40,0,0.032258065,0,empty,CD-0722-2
"B7,D4",5187,5929,3828,2101,3474,1907,0,1910,1262,648,1.947530864,1134,1460,428,152,152,0,49,0,0.039473684,0,empty,CD-0722-2
"B7,D5",5023,5725,3737,1988,3398,1847,0,1850,1262,588,2.146258503,1074,1432,359,157,157,0,51,0,0.108280255,0,empty,CD-0722-2
"B7,D6",8056,9212,5699,3513,5465,3170,0,3171,1936,1235,1.567611336,1881,1371,345,152,149,3,48,1,0.073825503,0,empty,CD-0722-2
"B7,D7",4334,4747,3155,1592,2834,1494,0,1494,993,501,1.982035928,840,1703,270,135,133,2,63,1,0.135338346,0,empty,CD-0722-2
"B7,D8",5367,6191,3962,2229,3567,1942,0,1942,1260,682,1.847507331,1120,1252,259,112,111,1,43,1,0.036036036,0,empty,CD-0722-2
"B7,D9",2635,3121,1921,1200,1836,992,0,996,645,351,1.837606838,591,1762,375,156,154,2,41,2,0.149350649,0,empty,CD-0722-2
"B7,D10",634537,817746,434515,383231,461739,303212,2,303428,229721,73707,3.116678199,195647,6667,2474,870,868,2,243,1,0.016129032,0,hg38,CD-0722-2
"B7,D11",528606,596382,406876,189506,335064,168084,1,168264,127937,40327,3.172489895,94856,135031,18800,7288,7128,160,1256,6,0.060886644,0,hg38,CD-0722-2
"B7,D12",683714,787234,517934,269300,438555,232298,2,232541,176961,55580,3.183897085,134344,127836,14909,5782,5615,167,1051,6,0.046482636,0,hg38,CD-0722-2
"B7,E1",9085,10348,6606,3742,5991,3386,0,3391,2174,1217,1.786359901,1971,2405,511,217,215,2,65,2,0.069767442,0,empty,CD-0722-2
"B7,E2",6541,7478,4725,2753,4272,2434,0,2438,1537,901,1.705882353,1393,1558,368,155,153,2,44,2,0.019607843,0,empty,CD-0722-2
"B7,E3",4264,5006,3053,1953,2915,1567,0,1570,1015,555,1.828828829,941,2426,499,216,216,0,72,0,0.064814815,0,empty,CD-0722-2
"B7,E4",5681,6436,4139,2297,3811,2085,1,2090,1369,721,1.898751734,1194,2607,537,212,204,8,63,1,0.019607843,0,empty,CD-0722-2
"B7,E5",5046,5633,3831,1802,3330,1733,0,1738,1131,607,1.863261944,927,1293,264,135,134,1,38,1,0.074626866,0,empty,CD-0722-2
"B7,E6",10011,11620,7231,4389,6701,3856,0,3865,2424,1441,1.682165163,2261,3715,959,353,350,3,97,1,0.051428571,0,empty,CD-0722-2
"B7,E7",8501,9429,6282,3147,5509,2901,0,2902,1874,1028,1.822957198,1668,2699,741,283,280,3,78,2,0.039285714,0,empty,CD-0722-2
"B7,E8",634955,725993,482883,243110,406748,213242,0,213420,163477,49943,3.27327153,121287,115111,16805,6594,6447,147,1141,7,0.04110439,0,hg38,CD-0722-2
"B7,E9",4690,5359,3451,1908,3172,1722,0,1727,1180,547,2.157221207,999,2065,374,162,152,10,57,2,0.019736842,0,empty,CD-0722-2
"B7,E10",4931,5589,3606,1983,3328,1762,0,1762,1153,609,1.893267652,1021,1368,403,170,170,0,44,0,0.058823529,0,empty,CD-0722-2
"B7,E11",6087,6993,4503,2490,4027,2219,0,2221,1431,790,1.811392405,1272,1936,357,148,142,6,47,1,0.014084507,0,empty,CD-0722-2
"B7,E12",6747,7939,4854,3085,4791,2722,0,2722,1816,906,2.004415011,1646,1808,456,155,155,0,56,0,0.135483871,0,empty,CD-0722-2
"B7,F1",7871,8950,5766,3184,5207,2862,0,2864,1821,1043,1.745925216,1654,1844,387,169,168,1,54,1,0.017857143,0,empty,CD-0722-2
"B7,F2",6524,7676,4749,2927,4416,2437,0,2437,1688,749,2.253671562,1460,2910,692,282,281,1,82,1,0.085409253,0,empty,CD-0722-2
"B7,F3",5635,6354,4130,2224,3773,2022,0,2022,1405,617,2.277147488,1163,3032,561,214,211,3,77,1,0.085308057,0,empty,CD-0722-2
"B7,F4",2227726,2600419,1670537,929882,1420114,805600,23,806339,665952,140387,4.743687094,469787,129576,19252,7676,7498,178,1296,6,0.046412377,0,hg38,CD-0722-2
"B7,F5",3302738,4102257,2215355,1886902,2254900,1600402,10,1601556,1109907,491649,2.257519084,991458,26092,9586,1606,1587,19,616,2,0.031505986,0,hg38,CD-0722-2
"B7,F6",7311,8466,5314,3152,4907,2823,0,2825,1810,1015,1.783251232,1667,2653,596,226,221,5,68,2,0.040723982,0,empty,CD-0722-2
"B7,F7",843852,1009760,621766,387994,564454,323433,4,323712,255020,68692,3.71251383,193487,61279,11256,4411,4340,71,852,5,0.057834101,0,hg38,CD-0722-2
"B7,F8",583128,678821,438639,240182,382139,204801,0,204970,174891,30079,5.814388776,118945,36017,4823,1952,1917,35,409,3,0.03599374,0,hg38,CD-0722-2
"B7,F9",6466,7112,4720,2392,4212,2155,0,2155,1442,713,2.022440393,1226,2620,435,178,176,2,67,2,0.130681818,0,empty,CD-0722-2
"B7,F10",7131,7872,5298,2574,4691,2427,0,2427,1595,832,1.917067308,1347,1366,393,139,136,3,40,1,0,0,empty,CD-0722-2
"B7,F11",6534,7202,4940,2262,4133,2082,0,2082,1367,715,1.911888112,1124,1616,516,161,160,1,46,1,0.04375,0,empty,CD-0722-2
"B7,F12",6816,7738,4924,2814,4400,2385,0,2387,1536,851,1.80493537,1381,241,20,16,16,0,12,0,0,0,empty,CD-0722-2
"B7,G1",6976,7691,5360,2331,4522,2319,0,2324,1518,806,1.88337469,1255,2363,388,164,164,0,64,0,0.085365854,0,empty,CD-0722-2
"B7,G2",524763,630863,361294,269569,359035,218065,8,218219,174256,43963,3.963696745,135522,50982,10531,3954,3881,73,756,3,0.043030147,0,hg38,CD-0722-2
"B7,G3",12909,15175,9242,5933,8853,5448,1,5451,3548,1903,1.864424593,3146,1921,440,228,227,1,67,1,0.0969163,0,empty,CD-0722-2
"B7,G4",660899,816486,458996,357490,460997,306376,0,306618,214707,91911,2.336031596,187886,176,12,10,9,1,6,1,0,0,empty,CD-0722-2
"B7,G5",4739,5569,3408,2161,3327,1870,0,1870,1207,663,1.820512821,1113,1580,469,192,188,4,52,1,0.005319149,0,empty,CD-0722-2
"B7,G6",6877,7915,5145,2770,4696,2565,0,2565,1716,849,2.021201413,1452,159,56,19,19,0,11,0,0,0,empty,CD-0722-2
"B7,G7",5423,6092,4078,2014,3527,1765,0,1767,1157,610,1.896721311,985,2098,329,133,130,3,42,1,0.030769231,0,empty,CD-0722-2
"B7,G8",4166,4779,3075,1704,2763,1465,0,1467,945,522,1.810344828,862,1632,432,136,136,0,44,0,0.014705882,0,empty,CD-0722-2
"B7,G9",5182,5856,3712,2144,3466,1875,0,1875,1254,621,2.019323671,1118,2030,519,226,224,2,65,1,0.053571429,0,empty,CD-0722-2
"B7,G10",6310,7451,4565,2886,4378,2522,0,2527,1589,938,1.694029851,1492,1416,388,143,140,3,58,2,0.042857143,0,empty,CD-0722-2
"B7,G11",5997,6879,4460,2419,4034,2140,1,2143,1418,725,1.955862069,1234,1373,399,121,118,3,43,2,0.042372881,0,empty,CD-0722-2
"B7,G12",5152,6082,3761,2321,3553,1996,0,2004,1276,728,1.752747253,1165,2317,569,264,255,9,92,2,0.043137255,0,empty,CD-0722-2
"B7,H1",586187,705233,420276,284957,397367,236539,1,236704,194106,42598,4.556692802,144321,50915,10954,3981,3927,54,766,2,0.037178508,0,hg38,CD-0722-2
"B7,H2",756885,884521,567128,317393,495573,268328,2,268563,210029,58534,3.588153893,158189,118731,18961,7190,7058,132,1242,6,0.046897138,0,hg38,CD-0722-2
"B7,H3",5116,5724,3772,1952,3373,1818,0,1820,1206,614,1.964169381,1032,1446,281,116,114,2,41,1,0.070175439,0,empty,CD-0722-2
"B7,H4",7222,8302,5374,2928,4861,2620,0,2629,1712,917,1.86695747,1497,196,24,13,12,1,7,1,0,0,empty,CD-0722-2
"B7,H5",8000,8982,5803,3179,5128,2800,0,2803,1828,975,1.874871795,1557,1943,593,249,249,0,73,0,0.024096386,0,empty,CD-0722-2
"B7,H6",5267,6146,3792,2354,3509,2003,0,2006,1348,658,2.048632219,1150,2058,667,268,265,3,69,2,0.116981132,0,empty,CD-0722-2
"B7,H7",6192,6837,4446,2391,4130,2256,1,2264,1548,716,2.162011173,1313,2086,439,157,155,2,65,1,0.025806452,0,empty,CD-0722-2
"B7,H8",6490,7400,4702,2698,4248,2343,3,2349,1527,822,1.857664234,1316,1823,333,160,159,1,52,1,0.050314465,0,empty,CD-0722-2
"B7,H9",5985,6833,4453,2380,3922,2044,0,2046,1412,634,2.227129338,1157,1158,216,110,109,1,36,1,0.04587156,0,empty,CD-0722-2
"B7,H10",656213,816023,466590,349433,455800,282719,3,282907,228131,54776,4.164798452,175664,34067,11920,4326,4309,17,907,3,0.049895567,0,hg38,CD-0722-2
"B7,H11",6487,7563,4478,3085,4452,2853,0,2853,1556,1297,1.199691596,1684,89,28,13,13,0,9,0,0.076923077,0,empty,CD-0722-2
"B7,H12",5192,5797,3706,2091,3519,1932,0,1933,1309,624,2.09775641,1118,1667,332,150,149,1,50,1,0.073825503,0,empty,CD-0722-2
"B8,A1",3657,4288,2655,1633,2542,1456,0,1458,892,566,1.575971731,826,1331,230,94,94,0,32,0,0,0,empty,CD-0722-2
"B8,A2",5510,6243,3955,2288,3713,2112,0,2114,1343,771,1.741893645,1225,1706,334,119,117,2,42,1,0.094017094,0,empty,CD-0722-2
"B8,A3",3555,3894,2590,1304,2370,1308,0,1310,859,451,1.904656319,723,1391,285,129,129,0,42,0,0.023255814,0,empty,CD-0722-2
"B8,A4",5954,6881,4340,2541,4040,2240,0,2243,1465,778,1.883033419,1270,676,108,47,47,0,22,0,0.042553191,0,empty,CD-0722-2
"B8,A5",4832,5533,3539,1994,3290,1818,0,1818,1221,597,2.045226131,1042,2058,321,97,94,3,41,2,0.212765957,0,empty,CD-0722-2
"B8,A6",297139,376377,212268,164109,220336,138195,1,138312,106897,31415,3.402737546,86049,76904,16512,6612,6559,53,1211,7,0.053666717,0,hg38,CD-0722-2
"B8,A7",3696,4187,2682,1505,2556,1465,0,1465,880,585,1.504273504,841,1042,235,118,118,0,41,0,0.008474576,0,empty,CD-0722-2
"B8,A8",2214,2530,1585,945,1523,846,0,846,571,275,2.076363636,504,2144,418,213,209,4,55,1,0.100478469,0,empty,CD-0722-2
"B8,A9",3856,4606,2831,1775,2676,1468,0,1468,904,564,1.602836879,876,1747,528,176,176,0,52,0,0.153409091,0,empty,CD-0722-2
"B8,A10",317076,370262,238747,131515,215777,114546,1,114636,88786,25850,3.434661509,66913,13499,1781,654,643,11,139,3,0.055987558,0,hg38,CD-0722-2
"B8,A11",3237,3757,2420,1337,2270,1223,0,1223,818,405,2.019753086,715,1637,440,139,138,1,36,1,0.231884058,0,empty,CD-0722-2
"B8,A12",4830,5271,3597,1674,3203,1679,0,1679,1130,549,2.058287796,913,3021,584,291,283,8,76,2,0.098939929,0,empty,CD-0722-2
"B8,B1",4010,4670,2883,1787,2794,1588,0,1588,984,604,1.629139073,931,1252,329,120,120,0,46,0,0.016666667,0,empty,CD-0722-2
"B8,B2",4266,4916,2884,2032,2999,1793,0,1793,1107,686,1.613702624,1093,565,157,54,50,4,13,3,0,0,empty,CD-0722-2
"B8,B3",551453,684366,395055,289311,397238,238103,2,238281,196530,41751,4.707192642,148022,135748,22782,8909,8756,153,1470,8,0.063156693,0,hg38,CD-0722-2
"B8,B4",4002,4605,2866,1739,2698,1584,0,1584,1012,572,1.769230769,924,780,101,54,53,1,29,1,0.075471698,0,empty,CD-0722-2
"B8,B5",6476,5568,3122,2446,3588,2163,0,2175,1555,620,2.508064516,1380,823,197,92,91,1,27,1,0.021978022,0,empty,CD-0722-2
"B8,B6",4619,5481,3323,2158,3250,1927,0,1931,1192,739,1.612990528,1163,1640,383,186,184,2,45,1,0.233695652,0,empty,CD-0722-2
"B8,B7",4111,4672,3076,1596,2793,1442,0,1448,968,480,2.016666667,815,1006,274,111,111,0,39,0,0,0,empty,CD-0722-2
"B8,B8",3177,3443,2345,1098,2107,1150,0,1153,802,351,2.284900285,609,1261,297,106,101,5,42,2,0.168316832,0,empty,CD-0722-2
"B8,B9",5991,7084,4265,2819,4235,2501,0,2501,1611,890,1.81011236,1502,1069,209,86,86,0,42,0,0.058139535,0,empty,CD-0722-2
"B8,B10",3329,3332,2040,1292,2117,1180,1,1189,741,448,1.654017857,709,620,210,77,76,1,17,1,0.171052632,0,empty,CD-0722-2
"B8,B11",10594,12900,7586,5314,7570,4542,0,4544,2855,1689,1.690349319,2787,256,30,23,23,0,16,0,0,0,empty,CD-0722-2
"B8,B12",3659,4306,2711,1595,2536,1432,0,1433,970,463,2.095032397,800,1395,430,170,166,4,59,1,0.012048193,0,empty,CD-0722-2
"B8,C1",7168,7562,5461,2101,4513,2313,0,2317,1456,861,1.691056911,1169,1027,203,91,91,0,34,0,0.010989011,0,empty,CD-0722-2
"B8,C2",5753,6635,4150,2485,4049,2301,0,2303,1509,794,1.900503778,1380,1810,546,199,199,0,50,0,0.070351759,0,empty,CD-0722-2
"B8,C3",6361,7291,4542,2749,4423,2507,0,2510,1588,922,1.722342733,1473,855,227,88,88,0,31,0,0.022727273,0,empty,CD-0722-2
"B8,C4",3802,4165,2865,1300,2484,1257,0,1259,803,456,1.760964912,694,2029,428,192,190,2,51,2,0.015789474,0,empty,CD-0722-2
"B8,C5",5202,5996,3758,2238,3546,1906,0,1906,1291,615,2.099186992,1102,1314,266,127,124,3,46,1,0.153225806,0,empty,CD-0722-2
"B8,C6",4604,5140,3336,1804,3053,1692,0,1693,1115,578,1.929065744,929,1412,223,105,104,1,35,1,0.192307692,0,empty,CD-0722-2
"B8,C7",6597,7856,4638,3218,4732,2926,0,2928,1682,1246,1.349919743,1820,436,25,16,15,1,7,1,0,0,empty,CD-0722-2
"B8,C8",7058,8092,5118,2974,4912,2724,0,2726,1792,934,1.91862955,1601,2600,578,217,215,2,76,1,0.027906977,0,empty,CD-0722-2
"B8,C9",379369,488541,258172,230369,285051,189291,0,189385,145813,43572,3.346483981,121563,7784,3349,1266,1265,1,339,1,0.028458498,0,hg38,CD-0722-2
"B8,C10",5617,6484,4153,2331,3813,2093,0,2096,1328,768,1.729166667,1222,1688,148,79,79,0,33,0,0.101265823,0,empty,CD-0722-2
"B8,C11",503325,607522,363899,243623,352867,204387,0,204544,162616,41928,3.878458309,125267,89280,14620,5884,5772,112,1052,3,0.054227304,0,hg38,CD-0722-2
"B8,C12",6830,7757,4990,2767,4652,2521,0,2525,1649,876,1.882420091,1455,1829,498,216,213,3,55,1,0.103286385,0,empty,CD-0722-2
"B8,D1",3334902,3954634,2482132,1472502,2146731,1284356,7,1285458,1049480,235978,4.447363737,759065,400232,41166,16599,16078,521,2433,8,0.062818759,0,hg38,CD-0722-2
"B8,D2",4622,5121,3493,1628,3212,1682,0,1684,1060,624,1.698717949,936,2257,464,250,248,2,78,2,0.092741935,0,empty,CD-0722-2
"B8,D3",4347,5042,3147,1895,3054,1745,0,1746,1167,579,2.015544041,1048,1363,263,129,129,0,44,0,0.031007752,0,empty,CD-0722-2
"B8,D4",3243,3794,2398,1396,2329,1297,0,1301,858,443,1.936794582,770,1094,175,78,77,1,38,1,0.25974026,0,empty,CD-0722-2
"B8,D5",3806,4405,2869,1536,2634,1418,0,1421,962,459,2.095860566,805,1138,263,114,114,0,45,0,0.131578947,0,empty,CD-0722-2
"B8,D6",5987,7061,4132,2929,4177,2545,0,2546,1565,981,1.595310907,1547,1670,289,138,136,2,47,1,0.102941176,0,empty,CD-0722-2
"B8,D7",384559,483537,265082,218455,282693,189711,1,189860,141331,48529,2.912299862,117631,44826,25858,9296,9283,13,1378,2,0.010880103,0,hg38,CD-0722-2
"B8,D8",3868,4327,2807,1520,2614,1406,0,1406,927,479,1.935281837,779,1354,416,179,177,2,48,1,0.033898305,0,empty,CD-0722-2
"B8,D9",3089,3557,2263,1294,2157,1179,0,1179,763,416,1.834134615,687,1221,257,101,99,2,32,1,0.02020202,0,empty,CD-0722-2
"B8,D10",3980,4527,2908,1619,2747,1547,0,1549,944,605,1.560330579,902,888,186,95,95,0,29,0,0.115789474,0,empty,CD-0722-2
"B8,D11",4777,5581,3450,2131,3313,1832,0,1834,1164,670,1.737313433,1116,2814,815,276,272,4,89,1,0,0,empty,CD-0722-2
"B8,D12",5707,6556,4299,2257,3952,2148,0,2154,1365,789,1.730038023,1240,2827,570,260,258,2,109,1,0.003875969,0,empty,CD-0722-2
"B8,E1",7246,8031,5354,2677,4858,2672,0,2679,1653,1026,1.611111111,1462,2046,333,146,146,0,66,0,0.089041096,0,empty,CD-0722-2
"B8,E2",4866,5673,3496,2177,3388,1917,0,1917,1228,689,1.782293179,1134,1606,429,163,161,2,37,1,0.093167702,0,empty,CD-0722-2
"B8,E3",3489,3937,2545,1392,2354,1312,0,1312,846,466,1.815450644,743,2326,824,265,261,4,65,2,0.034482759,0,empty,CD-0722-2
"B8,E4",389332,435690,297717,137973,252094,126392,0,126531,101256,25275,4.006172107,71352,67770,12392,4712,4616,96,877,3,0.02729636,0,hg38,CD-0722-2
"B8,E5",4198,4711,3173,1538,2752,1392,0,1393,915,478,1.914225941,796,1084,318,142,141,1,44,1,0.007092199,0,empty,CD-0722-2
"B8,E6",58780,66012,41756,24256,38039,21698,0,21723,18546,3177,5.837582625,12523,7742,3118,921,916,5,223,2,0.015283843,0,empty,CD-0722-2
"B8,E7",6633,7377,4905,2472,4475,2369,0,2373,1522,851,1.788484136,1319,2577,754,253,250,3,73,1,0.248,0,empty,CD-0722-2
"B8,E8",41366,48417,30198,18219,28476,17144,0,17176,12230,4946,2.472705216,9824,2734,741,290,290,0,64,0,0.110344828,0,empty,CD-0722-2
"B8,E9",3482,3927,2536,1391,2356,1247,0,1252,819,433,1.891454965,720,2385,619,209,206,3,55,2,0.111650485,0,empty,CD-0722-2
"B8,E10",3732,4278,2756,1522,2528,1311,0,1313,818,495,1.652525253,783,1764,263,96,96,0,32,0,0.03125,0,empty,CD-0722-2
"B8,E11",4739,5317,3537,1780,3196,1699,0,1699,1065,634,1.679810726,938,1927,370,129,127,2,42,1,0.125984252,0,empty,CD-0722-2
"B8,E12",1450547,1759650,1046636,713014,1008685,605080,2,605526,476410,129116,3.689782831,370954,128897,20441,8037,7929,108,1453,4,0.066086518,0,hg38,CD-0722-2
"B8,F1",6125,6915,4477,2438,4178,2325,0,2326,1482,844,1.755924171,1316,2029,514,194,193,1,56,1,0.124352332,0,empty,CD-0722-2
"B8,F2",4603,5209,3392,1817,3164,1741,0,1741,1162,579,2.006908463,972,2497,579,222,216,6,72,1,0.152777778,0,empty,CD-0722-2
"B8,F3",9426,12622,5940,6682,7737,5537,0,5539,3461,2078,1.665543792,3717,2302,584,225,220,5,81,2,0.036363636,0,empty,CD-0722-2
"B8,F4",6674,7360,4942,2418,4462,2348,1,2356,1529,827,1.84885127,1315,737,117,34,34,0,20,0,0.088235294,0,empty,CD-0722-2
"B8,F5",5280,5932,3929,2003,3630,1867,0,1868,1222,646,1.891640867,1069,1885,518,201,198,3,58,2,0.075757576,0,empty,CD-0722-2
"B8,F6",5404,6383,3845,2538,3715,2151,0,2151,1282,869,1.475258918,1282,2822,666,220,216,4,66,2,0.092592593,0,empty,CD-0722-2
"B8,F7",6062,6935,4507,2428,4192,2314,1,2321,1477,844,1.75,1333,922,167,86,84,2,29,1,0.202380952,0,empty,CD-0722-2
"B8,F8",4507,5204,3276,1928,3221,1811,0,1811,1197,614,1.949511401,1063,479,78,42,42,0,24,0,0.047619048,0,empty,CD-0722-2
"B8,F9",656595,705093,527293,177800,404838,169396,2,169580,131965,37615,3.508307856,88765,300524,45494,17519,17129,390,2352,9,0.057504816,0,hg38,CD-0722-2
"B8,F10",5911,6753,4492,2261,4060,2097,0,2100,1398,702,1.991452991,1192,1355,280,107,105,2,37,1,0.019047619,0,empty,CD-0722-2
"B8,F11",5195,5743,3902,1841,3304,1678,0,1680,1117,563,1.98401421,890,1401,364,141,139,2,47,2,0.086330935,0,empty,CD-0722-2
"B8,F12",5296,5887,3856,2031,3587,1912,1,1920,1293,627,2.062200957,1096,254,24,13,13,0,9,0,0,0,empty,CD-0722-2
"B8,G1",5357,6149,3952,2197,3745,2009,0,2012,1300,712,1.825842697,1203,2943,601,269,268,1,87,1,0.048507463,0,empty,CD-0722-2
"B8,G2",3957,4503,2746,1757,2706,1565,0,1568,990,578,1.712802768,943,751,134,77,77,0,36,0,0.090909091,0,empty,CD-0722-2
"B8,G3",6662,7236,4900,2336,4215,2307,0,2308,1363,945,1.442328042,1207,2382,515,224,222,2,52,2,0.009009009,0,empty,CD-0722-2
"B8,G4",11808,13754,8364,5390,8296,5052,0,5053,3123,1930,1.618134715,2990,161,44,25,25,0,12,0,0.24,0,empty,CD-0722-2
"B8,G5",3800,4370,2763,1607,2604,1447,0,1450,953,497,1.91750503,831,1481,404,125,122,3,47,1,0.049180328,0,empty,CD-0722-2
"B8,G6",5871,6682,4372,2310,4014,2141,0,2145,1363,782,1.742966752,1200,199,50,9,9,0,6,0,0,0,empty,CD-0722-2
"B8,G7",4358,4782,3232,1550,2908,1496,0,1498,951,547,1.73857404,860,2096,555,204,204,0,57,0,0.044117647,0,empty,CD-0722-2
"B8,G8",3378,3776,2414,1362,2243,1198,0,1198,783,415,1.886746988,679,1547,310,119,117,2,47,1,0.068376068,0,empty,CD-0722-2
"B8,G9",416089,480171,313224,166947,279021,147357,5,147497,110651,36846,3.003066819,86707,113071,13376,5300,5153,147,1042,4,0.055695711,0,hg38,CD-0722-2
"B8,G10",4882,5530,3451,2079,3262,1862,0,1866,1194,672,1.776785714,1087,1821,368,155,154,1,63,1,0.11038961,0,empty,CD-0722-2
"B8,G11",4664,5186,3464,1722,3108,1649,0,1649,1082,567,1.908289242,905,1244,335,143,142,1,57,1,0.105633803,0,empty,CD-0722-2
"B8,G12",4185,4856,2988,1868,2919,1636,0,1637,1060,577,1.837088388,968,2195,427,176,176,0,68,0,0.034090909,0,empty,CD-0722-2
"B8,H1",4301,4765,3142,1623,2924,1561,0,1561,1081,480,2.252083333,882,1260,255,84,84,0,31,0,0,0,empty,CD-0722-2
"B8,H2",6306,7495,4574,2921,4414,2578,0,2581,1756,825,2.128484848,1540,2095,641,252,244,8,64,2,0.069672131,0,empty,CD-0722-2
"B8,H3",4041,4664,2957,1707,2707,1487,0,1489,927,562,1.649466192,858,1577,329,114,114,0,46,0,0.210526316,0,empty,CD-0722-2
"B8,H4",744398,893566,553320,340246,507388,293153,0,293382,228778,64604,3.541235837,175325,6886,1282,468,461,7,101,2,0.056399132,0,hg38,CD-0722-2
"B8,H5",6366,7403,4732,2671,4305,2352,1,2353,1506,847,1.778040142,1304,1544,382,193,192,1,75,1,0.020833333,0,empty,CD-0722-2
"B8,H6",3794,4369,2719,1650,2545,1419,0,1420,960,460,2.086956522,819,2010,620,231,229,2,68,1,0,0,empty,CD-0722-2
"B8,H7",4559,4887,3286,1601,3009,1583,1,1586,1059,527,2.009487666,901,1987,558,275,274,1,91,1,0.062043796,0,empty,CD-0722-2
"B8,H8",5277,6014,3738,2276,3549,1982,0,1982,1321,661,1.998487141,1196,2836,694,276,274,2,82,1,0.124087591,0,empty,CD-0722-2
"B8,H9",488725,604124,335877,268247,351339,235857,1,235997,167870,68127,2.464074449,145085,3841,660,220,215,5,57,1,0.162790698,0,hg38,CD-0722-2
"B8,H10",4643,5440,3444,1996,3167,1687,1,1690,1176,514,2.287937743,984,2706,476,224,216,8,64,2,0.097222222,0,empty,CD-0722-2
"B8,H11",4906,5926,3364,2562,3608,2341,0,2342,1240,1102,1.12522686,1454,71,1,1,1,0,1,0,0,0,empty,CD-0722-2
"B8,H12",3744,4198,2665,1533,2540,1455,0,1455,951,504,1.886904762,823,1177,270,104,104,0,46,0,0.019230769,0,empty,CD-0722-2
"B9,A1",4031,4624,2921,1703,2793,1582,0,1585,1008,577,1.746967071,900,1120,216,95,92,3,24,2,0.130434783,0,empty,CD-0722-2
"B9,A2",6034,7170,4382,2788,4173,2353,0,2358,1443,915,1.57704918,1364,1272,258,96,96,0,28,0,0.125,0,empty,CD-0722-2
"B9,A3",3706,4158,2727,1431,2483,1340,0,1340,923,417,2.213429257,733,891,142,62,58,4,21,2,0,0,empty,CD-0722-2
"B9,A4",6406,7411,4610,2801,4406,2470,0,2471,1611,860,1.873255814,1434,429,134,63,62,1,11,1,0.35483871,0,empty,CD-0722-2
"B9,A5",5286,6097,3910,2187,3606,2011,0,2013,1263,750,1.684,1190,1558,356,150,146,4,41,2,0.075342466,0,empty,CD-0722-2
"B9,A6",4937,5763,3671,2092,3514,1988,0,1990,1354,636,2.128930818,1138,2330,484,222,218,4,60,1,0.100917431,0,empty,CD-0722-2
"B9,A7",3868,4570,2859,1711,2736,1539,0,1539,1047,492,2.12804878,874,1054,294,122,122,0,32,0,0.262295082,0,empty,CD-0722-2
"B9,A8",491480,607671,357658,250013,350703,208978,3,209141,173514,35627,4.870295001,127580,163715,36206,13993,13833,160,2012,8,0.068314899,0,hg38,CD-0722-2
"B9,A9",4242,4824,3168,1656,2902,1552,0,1554,996,558,1.784946237,873,1078,252,102,96,6,33,1,0.208333333,0,empty,CD-0722-2
"B9,A10",5122,5701,3855,1846,3544,1905,0,1909,1160,749,1.548731642,1079,309,109,39,39,0,8,0,0,0,empty,CD-0722-2
"B9,A11",3753,4188,2823,1365,2574,1302,0,1304,886,418,2.119617225,742,1337,257,88,86,2,31,1,0.011627907,0,empty,CD-0722-2
"B9,A12",5312,5842,4010,1832,3564,1884,0,1884,1235,649,1.902927581,1052,2679,891,369,367,2,72,2,0.125340599,0.5,empty,CD-0722-2
"B9,B1",4238,4899,3035,1864,3007,1677,0,1681,1059,622,1.702572347,1006,792,213,84,83,1,22,1,0,0,empty,CD-0722-2
"B9,B2",4575,5140,3157,1983,3245,1957,0,1957,1251,706,1.771954674,1170,467,119,49,46,3,13,1,0.195652174,0,empty,CD-0722-2
"B9,B3",3934,4581,2900,1681,2809,1567,0,1567,1020,547,1.864716636,885,1186,183,88,88,0,35,0,0.022727273,0,empty,CD-0722-2
"B9,B4",4431,5381,3107,2274,3194,1903,0,1903,1193,710,1.68028169,1175,963,285,116,116,0,27,0,0.00862069,0,empty,CD-0722-2
"B9,B5",4471,2587,1508,1079,1824,1066,0,1074,697,377,1.848806366,697,774,155,70,70,0,24,0,0.085714286,0,empty,CD-0722-2
"B9,B6",4587,5403,3268,2135,3221,1861,0,1861,1149,712,1.613764045,1061,1311,281,101,99,2,31,2,0.03030303,0,empty,CD-0722-2
"B9,B7",4324,4999,3191,1808,3021,1638,0,1640,1108,532,2.082706767,965,928,272,108,108,0,25,0,0.175925926,0,empty,CD-0722-2
"B9,B8",3229,3564,2389,1175,2214,1180,0,1180,798,382,2.089005236,671,839,228,100,99,1,28,1,0,0,empty,CD-0722-2
"B9,B9",6464,7367,4711,2656,4409,2517,0,2520,1593,927,1.718446602,1453,971,264,103,102,1,35,1,0.009803922,0,empty,CD-0722-2
"B9,B10",3371,3714,2348,1366,2262,1245,0,1248,797,451,1.767184035,735,491,224,56,56,0,11,0,0.107142857,0,empty,CD-0722-2
"B9,B11",11939,14427,8631,5796,8571,5106,0,5111,3261,1850,1.762702703,3121,288,141,42,42,0,6,0,0.119047619,0,empty,CD-0722-2
"B9,B12",3985,4603,2893,1710,2872,1597,0,1603,1028,575,1.787826087,934,1472,212,93,93,0,27,0,0,0,empty,CD-0722-2
"B9,C1",8010,9037,6050,2987,5303,2794,0,2797,1760,1037,1.697203472,1549,972,366,156,152,4,27,2,0.164473684,0,empty,CD-0722-2
"B9,C2",6531,7292,4707,2585,4328,2444,0,2444,1528,916,1.668122271,1390,1713,355,144,140,4,46,2,0.028571429,0,empty,CD-0722-2
"B9,C3",6500,7213,4712,2501,4474,2478,0,2482,1628,854,1.906323185,1390,752,90,48,48,0,16,0,0.0625,0,empty,CD-0722-2
"B9,C4",3946,4383,2948,1435,2654,1412,0,1412,933,479,1.947807933,756,1328,271,118,118,0,31,0,0.008474576,0,empty,CD-0722-2
"B9,C5",5741,6563,4238,2325,3969,2185,0,2186,1451,735,1.97414966,1267,1352,318,127,126,1,44,1,0.015873016,0,empty,CD-0722-2
"B9,C6",5125,5877,3676,2201,3548,1970,0,1972,1236,736,1.679347826,1174,1587,368,132,131,1,36,1,0,0,empty,CD-0722-2
"B9,C7",7095,8319,4933,3386,5023,3039,0,3041,1803,1238,1.45638126,1870,438,120,49,48,1,10,1,0.020833333,0,empty,CD-0722-2
"B9,C8",7589,8688,5550,3138,5269,2930,0,2930,1876,1054,1.779886148,1667,2302,504,208,207,1,64,1,0.106280193,0,empty,CD-0722-2
"B9,C9",5361,6132,3919,2213,3667,2007,0,2009,1347,662,2.034743202,1165,1462,224,101,100,1,26,1,0.09,0,empty,CD-0722-2
"B9,C10",5886,6728,4326,2402,4097,2263,0,2265,1498,767,1.953063885,1306,1407,178,83,83,0,30,0,0.21686747,0,empty,CD-0722-2
"B9,C11",5014,5681,3652,2029,3517,1928,0,1928,1256,672,1.869047619,1113,1939,458,165,164,1,47,1,0.036585366,0,empty,CD-0722-2
"B9,C12",606401,716673,446613,270060,408885,229858,1,230054,180524,49530,3.644740561,137369,88009,14457,5559,5462,97,1023,5,0.043390699,0,hg38,CD-0722-2
"B9,D1",1212916,1455543,884759,570784,835703,502317,4,502695,375473,127222,2.951321312,303531,40050,5034,2001,1974,27,438,4,0.03343465,0,hg38,CD-0722-2
"B9,D2",4989,5465,3668,1797,3306,1741,0,1742,1150,592,1.942567568,943,2027,595,242,241,1,58,1,0.008298755,0,empty,CD-0722-2
"B9,D3",4954,5596,3645,1951,3346,1865,0,1867,1235,632,1.954113924,1062,1303,344,126,126,0,37,0,0.182539683,0,empty,CD-0722-2
"B9,D4",563346,677838,416126,261712,390109,223149,0,223316,176010,47306,3.720669682,133419,47008,5066,1899,1849,50,460,5,0.056787453,0,hg38,CD-0722-2
"B9,D5",4266,5036,3018,2018,3028,1760,0,1760,1113,647,1.720247295,1084,1416,331,141,138,3,38,1,0.152173913,0,empty,CD-0722-2
"B9,D6",6793,7728,4757,2971,4699,2763,0,2765,1656,1109,1.493237151,1651,1421,489,174,174,0,42,0,0.126436782,0,empty,CD-0722-2
"B9,D7",3820,4207,2797,1410,2599,1368,0,1371,922,449,2.053452116,774,1892,359,141,138,3,42,2,0.014492754,0,empty,CD-0722-2
"B9,D8",4369,5131,3080,2051,3003,1705,0,1705,1108,597,1.855946399,1020,1034,238,100,100,0,29,0,0,0,empty,CD-0722-2
"B9,D9",3633,4113,2711,1402,2462,1295,0,1299,917,382,2.40052356,752,1270,257,105,100,5,28,2,0,0,empty,CD-0722-2
"B9,D10",4407,5011,3103,1908,3113,1768,0,1769,1100,669,1.644245142,1078,1047,373,150,147,3,30,1,0.006802721,0,empty,CD-0722-2
"B9,D11",4840,5434,3584,1850,3320,1759,0,1762,1171,591,1.981387479,1016,2446,625,247,245,2,70,1,0.081632653,0,empty,CD-0722-2
"B9,D12",6348,7061,4685,2376,4154,2196,0,2196,1462,734,1.991825613,1251,3008,712,299,294,5,73,2,0.098639456,0,empty,CD-0722-2
"B9,E1",7767,8805,5642,3163,5207,2870,0,2874,1841,1033,1.782187803,1615,1984,410,176,174,2,54,1,0.074712644,0,empty,CD-0722-2
"B9,E2",5543,6564,4004,2560,3858,2254,0,2254,1378,876,1.573059361,1364,1536,418,146,143,3,33,1,0.286713287,0,empty,CD-0722-2
"B9,E3",3505,3928,2600,1328,2443,1337,0,1340,824,516,1.596899225,745,2074,604,217,215,2,58,1,0.074418605,0,empty,CD-0722-2
"B9,E4",4865,5899,3429,2470,3435,1903,0,1904,1246,658,1.893617021,1161,1875,466,193,192,1,62,1,0.140625,0,empty,CD-0722-2
"B9,E5",4318,4772,3242,1530,2828,1481,0,1484,974,510,1.909803922,806,1203,281,104,104,0,28,0,0.019230769,0,empty,CD-0722-2
"B9,E6",8335,9381,6107,3274,5602,3129,0,3130,2028,1102,1.840290381,1724,2188,440,179,178,1,70,1,0.095505618,0,empty,CD-0722-2
"B9,E7",7329,8439,5467,2972,5040,2696,1,2701,1813,888,2.041666667,1577,2657,736,278,274,4,63,2,0.127737226,0,empty,CD-0722-2
"B9,E8",5796,6441,4332,2109,3811,2014,0,2014,1341,673,1.992570579,1092,2137,354,146,143,3,43,2,0.048951049,0,empty,CD-0722-2
"B9,E9",3843,4154,2867,1287,2530,1340,0,1341,878,463,1.896328294,718,1644,273,134,132,2,43,2,0.022727273,0,empty,CD-0722-2
"B9,E10",4077,4528,3095,1433,2831,1482,0,1484,1013,471,2.1507431,823,1909,661,188,188,0,38,0,0.106382979,0,empty,CD-0722-2
"B9,E11",5114,5534,3788,1746,3338,1767,0,1767,1198,569,2.105448155,944,1344,411,133,133,0,33,0,0.082706767,0,empty,CD-0722-2
"B9,E12",5468,6286,3987,2299,3854,2144,0,2145,1393,752,1.852393617,1253,1396,352,142,142,0,42,0,0.063380282,0,empty,CD-0722-2
"B9,F1",6718,7573,4852,2721,4470,2439,0,2445,1546,899,1.719688543,1375,1605,486,132,131,1,50,1,0.06870229,0,empty,CD-0722-2
"B9,F2",4938,5485,3634,1851,3376,1781,0,1785,1167,618,1.888349515,1020,2264,587,270,267,3,68,1,0.052434457,0,empty,CD-0722-2
"B9,F3",4787,5549,3454,2095,3338,1814,0,1816,1196,620,1.929032258,1104,2274,541,211,211,0,56,0,0.123222749,0,empty,CD-0722-2
"B9,F4",7717,8535,5748,2787,5154,2703,0,2703,1793,910,1.97032967,1515,860,206,86,86,0,32,0,0.093023256,0,empty,CD-0722-2
"B9,F5",6220,6943,4513,2430,4106,2206,0,2209,1459,750,1.945333333,1241,1997,413,190,190,0,51,0,0.042105263,0,empty,CD-0722-2
"B9,F6",5791,6530,4140,2390,3897,2210,0,2214,1352,862,1.568445476,1285,2129,518,236,233,3,52,1,0.008583691,0,empty,CD-0722-2
"B9,F7",6583,7423,4809,2614,4468,2429,0,2436,1559,877,1.777651083,1386,987,231,89,89,0,27,0,0.011235955,0,empty,CD-0722-2
"B9,F8",1410827,1708753,1037640,671113,968975,572847,3,573284,458952,114332,4.014204247,343428,23430,3741,1357,1340,17,310,2,0.042537313,0,hg38,CD-0722-2
"B9,F9",5505,6249,4107,2142,3745,2009,0,2009,1340,669,2.002989537,1138,2637,541,222,220,2,58,2,0.186363636,0,empty,CD-0722-2
"B9,F10",646191,736458,492648,243810,421618,218519,0,218724,169790,48934,3.469775616,125081,86402,9490,3628,3520,108,718,4,0.051988636,0,hg38,CD-0722-2
"B9,F11",5394,5780,4098,1682,3512,1741,0,1743,1175,568,2.068661972,923,1506,256,111,111,0,41,0,0.162162162,0,empty,CD-0722-2
"B9,F12",496529,527169,389971,137198,300444,133072,1,133202,102525,30677,3.342080386,71095,1209,167,65,61,4,23,2,0,0,empty,CD-0722-2
"B9,G1",6015,6725,4545,2180,4086,2111,0,2111,1344,767,1.752281617,1195,2844,623,260,257,3,80,2,0.015564202,0,empty,CD-0722-2
"B9,G2",3845,4373,2648,1725,2576,1462,0,1462,986,476,2.071428571,860,501,145,56,56,0,18,0,0.357142857,0,empty,CD-0722-2
"B9,G3",6734,7442,4905,2537,4454,2523,0,2526,1525,1001,1.523476523,1366,2076,573,257,255,2,57,1,0.02745098,0,empty,CD-0722-2
"B9,G4",13167,15416,9332,6084,9080,5602,0,5602,3402,2200,1.546363636,3287,35,3,2,2,0,2,0,0.5,0,empty,CD-0722-2
"B9,G5",3928,4525,2927,1598,2850,1504,0,1504,1008,496,2.032258065,907,1201,160,82,81,1,22,1,0.283950617,0,empty,CD-0722-2
"B9,G6",1864287,2056165,1438850,617315,1134643,568159,4,568676,469889,98787,4.756587405,315084,21116,2495,1029,1003,26,252,3,0.030907278,0,hg38,CD-0722-2
"B9,G7",4795,5500,3576,1924,3332,1773,0,1775,1165,610,1.909836066,1047,2092,526,212,210,2,52,1,0.071428571,0,empty,CD-0722-2
"B9,G8",3639,4062,2650,1412,2420,1301,0,1301,843,458,1.840611354,750,1350,313,136,136,0,33,0,0.007352941,0,empty,CD-0722-2
"B9,G9",4263,5024,3074,1950,3052,1737,0,1739,1134,605,1.874380165,1066,1785,458,206,206,0,51,0,0.155339806,0,empty,CD-0722-2
"B9,G10",5345,6139,3866,2273,3594,2028,0,2028,1334,694,1.922190202,1144,1729,551,199,195,4,51,2,0.046153846,0,empty,CD-0722-2
"B9,G11",5127,5864,3851,2013,3555,1901,0,1901,1163,738,1.575880759,1108,1423,318,102,100,2,32,2,0.01,0,empty,CD-0722-2
"B9,G12",4500,5230,3299,1931,3174,1787,0,1788,1205,583,2.066895369,1040,2077,701,293,289,4,65,1,0.186851211,0,empty,CD-0722-2
"B9,H1",4911,5502,3532,1970,3384,1861,0,1862,1234,628,1.964968153,1079,1086,219,76,76,0,33,0,0.092105263,0,empty,CD-0722-2
"B9,H2",5196,5802,3822,1980,3603,1926,0,1926,1258,668,1.883233533,1134,1802,456,192,187,5,67,2,0.005347594,0,empty,CD-0722-2
"B9,H3",4665,5204,3398,1806,3176,1734,0,1739,1102,637,1.729984301,1009,1137,279,106,105,1,37,1,0.066666667,0,empty,CD-0722-2
"B9,H4",1340617,1609979,983962,626017,904995,524647,4,525040,414694,110346,3.758124445,316221,7859,1249,460,457,3,110,1,0.026258206,0,hg38,CD-0722-2
"B9,H5",6839,8098,5025,3073,4775,2622,0,2624,1719,905,1.899447514,1557,1611,353,165,164,1,46,1,0.140243902,0,empty,CD-0722-2
"B9,H6",4130,4878,2930,1948,2973,1736,0,1739,1174,565,2.077876106,1045,1789,370,144,138,6,38,2,0.028985507,0,empty,CD-0722-2
"B9,H7",510044,613899,367550,246349,358410,211603,7,211794,170245,41549,4.097451202,128563,92939,16408,6345,6260,85,1239,3,0.047444089,0,hg38,CD-0722-2
"B9,H8",5453,6354,3916,2438,3761,2145,0,2149,1381,768,1.798177083,1288,1507,326,163,162,1,54,1,0.030864198,0,empty,CD-0722-2
"B9,H9",4295,4938,3218,1720,2894,1513,0,1513,1024,489,2.09406953,866,937,313,144,141,3,30,1,0,0,empty,CD-0722-2
"B9,H10",4178,4870,3070,1800,2955,1660,0,1662,1141,521,2.190019194,1003,1243,213,88,81,7,31,2,0.024691358,0,empty,CD-0722-2
"B9,H11",5324,6406,3645,2761,3888,2532,0,2536,1343,1193,1.125733445,1558,18,1,1,1,0,1,0,0,0,empty,CD-0722-2
"B9,H12",4308,4903,3105,1798,2960,1679,1,1681,1097,584,1.878424658,977,1279,327,134,132,2,33,1,0.007575758,0,empty,CD-0722-2
"B10,A1",3463,3917,2476,1441,2361,1341,0,1341,879,462,1.902597403,782,1138,248,114,111,3,34,1,0.261261261,0,empty,CD-0722-2
"B10,A2",5148,5952,3789,2163,3482,1915,0,1916,1209,707,1.710042433,1078,1989,475,183,182,1,52,1,0,0,empty,CD-0722-2
"B10,A3",3211,3647,2262,1385,2243,1255,0,1255,830,425,1.952941176,762,1348,375,194,193,1,67,1,0.207253886,0,empty,CD-0722-2
"B10,A4",5651,6413,4138,2275,3891,2145,0,2148,1397,751,1.860186418,1246,981,174,71,69,2,32,2,0.014492754,0,empty,CD-0722-2
"B10,A5",429496,470144,330374,139770,271897,132806,1,132978,105525,27453,3.843842203,73292,83096,11863,4848,4727,121,875,3,0.034271208,0,hg38,CD-0722-2
"B10,A6",5165,6067,3784,2283,3645,2029,0,2030,1371,659,2.080424886,1183,3054,719,342,333,9,98,2,0.093093093,0,empty,CD-0722-2
"B10,A7",3491,4113,2482,1631,2524,1466,0,1466,965,501,1.926147705,895,1456,355,155,154,1,53,1,0.006493506,0,empty,CD-0722-2
"B10,A8",2016,2383,1532,851,1457,811,0,811,545,266,2.04887218,451,1912,379,187,187,0,66,0,0.058823529,0,empty,CD-0722-2
"B10,A9",3539,4099,2602,1497,2421,1325,0,1327,823,504,1.632936508,750,1843,381,195,193,2,54,2,0.129533679,0,empty,CD-0722-2
"B10,A10",4285,4816,3289,1527,2886,1531,0,1531,962,569,1.690685413,832,453,47,35,35,0,25,0,0.028571429,0,empty,CD-0722-2
"B10,A11",3282,3657,2490,1167,2096,1075,0,1075,728,347,2.097982709,558,1700,422,170,168,2,64,1,0.083333333,0,empty,CD-0722-2
"B10,A12",4415,4927,3278,1649,2953,1514,0,1520,993,527,1.884250474,855,3747,999,369,368,1,127,1,0.027173913,0,empty,CD-0722-2
"B10,B1",4027,4495,2901,1594,2710,1535,0,1536,963,573,1.680628272,880,1620,469,165,164,1,53,1,0.140243902,0,empty,CD-0722-2
"B10,B2",4129,4719,2761,1958,2826,1695,0,1698,1036,662,1.564954683,1035,837,170,78,73,5,27,2,0.136986301,0,empty,CD-0722-2
"B10,B3",3290,3718,2404,1314,2270,1211,0,1216,837,379,2.208443272,696,1556,247,122,121,1,70,1,0.082644628,0,empty,CD-0722-2
"B10,B4",3846,4673,2725,1948,2718,1628,0,1630,991,639,1.55086072,987,1920,356,121,121,0,39,0,0.140495868,0,empty,CD-0722-2
"B10,B5",4057,2562,1543,1019,1852,1079,0,1090,692,398,1.738693467,692,1281,262,102,102,0,48,0,0.12745098,0,empty,CD-0722-2
"B10,B6",4178,4787,3018,1769,2931,1709,0,1711,1071,640,1.6734375,986,1849,602,221,220,1,62,1,0.045454545,0,empty,CD-0722-2
"B10,B7",3782,4319,2821,1498,2646,1428,0,1428,933,495,1.884848485,816,1086,189,87,83,4,42,2,0.108433735,0,empty,CD-0722-2
"B10,B8",341972,398155,258549,139606,230850,122302,0,122401,96523,25878,3.729925033,71098,63980,9425,3709,3642,67,727,3,0.051619989,0,hg38,CD-0722-2
"B10,B9",453770,525829,340783,185046,302881,161878,0,162008,126228,35780,3.527892677,94222,112435,14829,6064,5947,117,1127,4,0.089456869,0,hg38,CD-0722-2
"B10,B10",2609,3062,1819,1243,1908,1108,0,1109,735,374,1.965240642,693,411,84,39,34,5,16,1,0,0,empty,CD-0722-2
"B10,B11",7331,8378,5251,3127,5007,2956,0,2956,1751,1205,1.453112033,1723,266,33,27,24,3,16,2,0.041666667,0,empty,CD-0722-2
"B10,B12",3439,3975,2494,1481,2377,1333,0,1335,899,436,2.061926606,791,1799,449,168,168,0,57,0,0.035714286,0,empty,CD-0722-2
"B10,C1",6819,7546,5030,2516,4490,2365,1,2370,1498,872,1.717889908,1336,1018,244,98,97,1,29,1,0.010309278,0,empty,CD-0722-2
"B10,C2",5571,6162,3977,2185,3679,2067,0,2069,1371,698,1.964183381,1152,2110,732,269,267,2,78,1,0.116104869,0,empty,CD-0722-2
"B10,C3",5768,6442,4292,2150,3897,2101,0,2101,1370,731,1.874145007,1142,944,141,66,65,1,34,1,0.123076923,0,empty,CD-0722-2
"B10,C4",3753,4234,2777,1457,2483,1339,0,1344,902,442,2.040723982,741,1924,456,176,176,0,45,0,0.079545455,0,empty,CD-0722-2
"B10,C5",5083,5780,3764,2016,3495,1950,0,1954,1278,676,1.890532544,1106,2280,487,231,230,1,77,1,0.056521739,0,empty,CD-0722-2
"B10,C6",5299,6287,3792,2495,3785,2162,0,2168,1460,708,2.062146893,1332,1467,315,136,135,1,48,1,0.02962963,0,empty,CD-0722-2
"B10,C7",6533,7916,4640,3276,4713,2884,0,2886,1741,1145,1.520524017,1764,877,151,74,74,0,27,0,0,0,empty,CD-0722-2
"B10,C8",6730,7841,4872,2969,4759,2726,0,2730,1811,919,1.970620239,1642,3452,641,325,324,1,125,1,0.12037037,0,empty,CD-0722-2
"B10,C9",31797,35964,24218,11746,20556,10113,0,10122,7422,2700,2.748888889,5780,21254,4283,1730,1699,31,354,3,0.055915244,0,empty,CD-0722-2
"B10,C10",5338,5961,3924,2037,3592,1861,0,1861,1209,652,1.854294479,1058,2051,474,192,189,3,53,2,0.142857143,0,empty,CD-0722-2
"B10,C11",4550,5263,3278,1985,3147,1752,0,1752,1116,636,1.754716981,1040,1825,370,200,199,1,64,1,0.045226131,0,empty,CD-0722-2
"B10,C12",6065,6809,4425,2384,4229,2316,0,2318,1542,776,1.987113402,1332,2353,641,236,234,2,71,2,0.021367521,0,empty,CD-0722-2
"B10,D1",5873,7066,4170,2896,4146,2461,0,2463,1498,965,1.552331606,1492,599,101,59,59,0,32,0,0.084745763,0,empty,CD-0722-2
"B10,D2",4712,5074,3587,1487,3128,1599,0,1601,1058,543,1.948434622,838,2715,703,304,297,7,99,1,0.114478114,0,empty,CD-0722-2
"B10,D3",3888,4429,2843,1586,2754,1511,0,1511,961,550,1.747272727,877,2032,584,231,230,1,68,1,0.165217391,0,empty,CD-0722-2
"B10,D4",3202,3678,2366,1312,2201,1191,0,1191,768,423,1.815602837,676,1545,247,131,130,1,48,1,0.053846154,0,empty,CD-0722-2
"B10,D5",1714336,2137527,1224712,912815,1216057,764874,5,765390,635150,130240,4.876765971,472599,322814,53743,20995,20628,367,3105,10,0.057979445,0,hg38,CD-0722-2
"B10,D6",5905,6839,4064,2775,4069,2487,0,2487,1512,975,1.550769231,1482,1815,409,168,165,3,61,2,0.078787879,0,empty,CD-0722-2
"B10,D7",716369,834502,538247,296255,478390,265147,0,265384,215134,50250,4.281273632,153676,263298,38657,15979,15643,336,2234,8,0.05229176,0,hg38,CD-0722-2
"B10,D8",3807,4321,2842,1479,2574,1398,0,1399,945,454,2.081497797,800,1608,460,190,188,2,57,1,0.106382979,0,empty,CD-0722-2
"B10,D9",2209,2527,1604,923,1490,788,0,788,542,246,2.203252033,476,1363,313,134,133,1,38,1,0,0,empty,CD-0722-2
"B10,D10",513136,636045,364426,271619,368559,225916,0,226080,177261,48819,3.630983838,140975,82199,14425,5994,5881,113,1031,6,0.077877912,0,hg38,CD-0722-2
"B10,D11",4374,4793,3193,1600,2916,1535,0,1535,975,560,1.741071429,872,3951,1040,391,383,8,112,1,0.15926893,0,empty,CD-0722-2
"B10,D12",5543,6455,4028,2427,3835,2169,0,2170,1387,783,1.771392082,1288,3575,882,404,399,5,143,2,0.067669173,0,empty,CD-0722-2
"B10,E1",6818,7857,4886,2971,4548,2553,0,2558,1557,1001,1.555444555,1500,3048,793,293,288,5,81,1,0.086805556,0,empty,CD-0722-2
"B10,E2",4730,5529,3421,2108,3233,1741,0,1744,1111,633,1.755134281,1052,2252,580,249,245,4,75,2,0.085714286,0,empty,CD-0722-2
"B10,E3",3185,3577,2409,1168,2129,1125,0,1125,737,388,1.899484536,589,2283,449,190,189,1,64,1,0.010582011,0,empty,CD-0722-2
"B10,E4",4386,4983,3185,1798,2949,1589,0,1591,1039,552,1.882246377,927,2605,597,245,241,4,87,1,0.112033195,0,empty,CD-0722-2
"B10,E5",3822,4404,2870,1534,2667,1408,0,1408,914,494,1.850202429,785,1658,464,186,185,1,51,1,0,0,empty,CD-0722-2
"B10,E6",1615437,1904304,1180072,724232,1065252,633805,5,634339,520722,113617,4.583134566,370527,550525,80269,31627,30956,671,3679,9,0.066319938,0,hg38,CD-0722-2
"B10,E7",6256,7240,4548,2692,4234,2334,0,2334,1524,810,1.881481481,1342,3168,724,306,304,2,104,1,0.052631579,0,empty,CD-0722-2
"B10,E8",5293,5887,4059,1828,3518,1776,0,1776,1168,608,1.921052632,979,2892,581,265,262,3,79,2,0.076335878,0,empty,CD-0722-2
"B10,E9",269701,296327,210004,86323,171655,79999,2,80061,62345,17716,3.519135245,44093,71454,11043,4197,4118,79,835,4,0.020155415,0,hg38,CD-0722-2
"B10,E10",3697,4116,2731,1385,2458,1300,0,1302,875,427,2.049180328,722,1582,302,99,99,0,53,0,0.070707071,0,empty,CD-0722-2
"B10,E11",4501,4921,3340,1581,2962,1580,0,1580,1007,573,1.757417103,851,2210,376,158,154,4,58,2,0.11038961,0,empty,CD-0722-2
"B10,E12",4846,5635,3518,2117,3467,1919,0,1923,1236,687,1.799126638,1168,2071,560,265,263,2,90,2,0.02661597,0,empty,CD-0722-2
"B10,F1",5838,6505,4271,2234,3981,2122,0,2129,1359,770,1.764935065,1232,2194,513,210,206,4,78,2,0.019417476,0,empty,CD-0722-2
"B10,F2",4525,4994,3245,1749,2946,1610,0,1610,1004,606,1.656765677,902,2911,662,279,278,1,98,1,0.028776978,0,empty,CD-0722-2
"B10,F3",4370,4773,3199,1574,2989,1545,0,1548,1042,506,2.059288538,868,2569,544,242,240,2,93,1,0.008333333,0,empty,CD-0722-2
"B10,F4",6389,6985,4769,2216,4297,2192,1,2193,1475,718,2.054317549,1206,888,129,71,63,8,38,2,0.206349206,0,empty,CD-0722-2
"B10,F5",5370,5784,3902,1882,3514,1815,0,1816,1214,602,2.016611296,1003,1918,440,207,206,1,86,1,0.203883495,0,empty,CD-0722-2
"B10,F6",5025,5679,3626,2053,3403,1873,0,1873,1159,714,1.6232493,1069,3064,765,310,310,0,95,0,0.077419355,0,empty,CD-0722-2
"B10,F7",6264,7069,4412,2657,4231,2415,0,2419,1600,819,1.953601954,1410,1282,414,166,165,1,41,1,0.266666667,0,empty,CD-0722-2
"B10,F8",655468,798258,482676,315582,460783,270917,0,271103,219755,51348,4.279718782,163102,15664,2463,978,964,14,234,3,0.079875519,0,hg38,CD-0722-2
"B10,F9",4609,4969,3492,1477,3051,1542,0,1545,1033,512,2.017578125,837,2880,523,232,225,7,90,2,0.075555556,0,empty,CD-0722-2
"B10,F10",5897,6537,4353,2184,3770,1918,0,1918,1270,648,1.959876543,1071,1953,441,181,178,3,54,1,0.028089888,0,empty,CD-0722-2
"B10,F11",4561,4951,3466,1485,2933,1438,0,1444,994,450,2.208888889,783,1895,315,152,148,4,54,2,0.047297297,0,empty,CD-0722-2
"B10,F12",5050,5884,3729,2155,3492,1965,0,1965,1238,727,1.702888583,1138,257,51,25,25,0,19,0,0,0,empty,CD-0722-2
"B10,G1",5416,6044,3978,2066,3591,1926,0,1926,1242,684,1.815789474,1058,2955,590,272,267,5,103,2,0.037453184,0,empty,CD-0722-2
"B10,G2",3603,4062,2488,1574,2413,1403,0,1403,883,520,1.698076923,831,691,75,35,35,0,20,0,0.057142857,0,empty,CD-0722-2
"B10,G3",957107,1066398,725569,340829,605079,310705,4,311005,253113,57892,4.372158502,176654,110375,18960,7479,7332,147,1255,5,0.02523186,0,hg38,CD-0722-2
"B10,G4",11361,13377,7912,5465,8062,4959,0,4964,3030,1934,1.566701138,3015,159,17,13,13,0,9,0,0.076923077,0,empty,CD-0722-2
"B10,G5",3634,4255,2614,1641,2519,1389,0,1390,832,558,1.491039427,843,2159,595,248,248,0,77,0,0.153225806,0,empty,CD-0722-2
"B10,G6",5458,6214,4086,2128,3704,2000,0,2000,1362,638,2.134796238,1120,296,63,33,32,1,8,1,0,0,empty,CD-0722-2
"B10,G7",4300,4854,3179,1675,2950,1550,0,1552,997,555,1.796396396,875,3004,536,241,241,0,79,0,0.041493776,0,empty,CD-0722-2
"B10,G8",3092,3457,2209,1248,2068,1106,0,1107,717,390,1.838461538,642,2181,532,237,228,9,81,1,0.065789474,0,empty,CD-0722-2
"B10,G9",500114,614316,361040,253276,354787,210782,0,210938,174977,35961,4.865743444,129057,152621,29058,11609,11449,160,1849,6,0.059568521,0,hg38,CD-0722-2
"B10,G10",4490,5128,3318,1810,3106,1695,0,1696,1126,570,1.975438596,976,2653,789,302,300,2,92,1,0.03,0,empty,CD-0722-2
"B10,G11",4571,5013,3372,1641,3098,1615,0,1617,1050,567,1.851851852,899,1480,501,217,217,0,66,0,0.087557604,0,empty,CD-0722-2
"B10,G12",3809,4520,2742,1778,2769,1617,0,1617,1017,600,1.695,948,2231,421,210,207,3,88,2,0.082125604,0,empty,CD-0722-2
"B10,H1",3821,4264,2756,1508,2592,1384,0,1384,903,481,1.877338877,814,1410,361,151,149,2,59,2,0.181208054,0,empty,CD-0722-2
"B10,H2",4488,5122,3273,1849,3052,1680,0,1682,1052,630,1.66984127,988,2568,747,300,298,2,89,1,0.083892617,0,empty,CD-0722-2
"B10,H3",3886,4396,2815,1581,2655,1494,0,1498,993,505,1.966336634,903,1459,371,173,168,5,68,3,0.011904762,0,empty,CD-0722-2
"B10,H4",5724,6635,4213,2422,3841,2078,0,2078,1337,741,1.804318489,1226,244,73,29,29,0,12,0,0.068965517,0,empty,CD-0722-2
"B10,H5",6087,6955,4387,2568,4099,2244,0,2248,1466,782,1.874680307,1317,2407,613,257,254,3,95,2,0.098425197,0,empty,CD-0722-2
"B10,H6",546014,649167,404537,244630,372984,210791,0,210955,167372,43583,3.840304706,125533,140186,22791,9130,8965,165,1577,5,0.04350251,0,hg38,CD-0722-2
"B10,H7",4416,4789,3312,1477,2890,1524,0,1524,1032,492,2.097560976,845,2374,478,226,226,0,96,0,0.026548673,0,empty,CD-0722-2
"B10,H8",788992,993094,548483,444611,575575,386944,1,387189,281268,105921,2.65545076,239007,20376,2017,753,726,27,209,3,0.319559229,0,hg38,CD-0722-2
"B10,H9",3547,3940,2689,1251,2386,1225,0,1225,824,401,2.054862843,679,1581,342,147,146,1,47,1,0.095890411,0,empty,CD-0722-2
"B10,H10",450211,506041,345681,160360,289313,145588,1,145720,116554,29166,3.996228485,82012,32743,6512,2352,2318,34,538,2,0.019844694,0,hg38,CD-0722-2
"B10,H11",4785,5668,3291,2377,3329,2161,0,2162,1201,961,1.249739854,1298,130,12,7,7,0,4,0,0,0,empty,CD-0722-2
"B10,H12",3641,4026,2632,1394,2397,1337,0,1339,923,416,2.21875,756,1769,290,138,130,8,53,2,0.084615385,0,empty,CD-0722-2
"B11,A1",3806,4253,2754,1499,2585,1485,0,1487,927,560,1.655357143,814,1511,151,66,65,1,31,1,0.276923077,0,empty,CD-0722-2
"B11,A2",419660,475081,320284,154797,272880,139372,0,139512,105308,34204,3.078821191,78872,126722,15803,6564,6419,145,1096,4,0.069792803,0,hg38,CD-0722-2
"B11,A3",508525,619263,367460,251803,357666,211985,0,212135,168676,43459,3.881267401,129639,129366,18731,7497,7347,150,1259,3,0.073771607,0,hg38,CD-0722-2
"B11,A4",587755,667680,448692,218988,381321,196345,1,196529,146878,49651,2.958208294,111300,53954,6277,2471,2390,81,526,4,0.055230126,0,hg38,CD-0722-2
"B11,A5",4913,5551,3582,1969,3436,1935,0,1936,1208,728,1.659340659,1125,2207,426,157,149,8,50,2,0.020134228,0,empty,CD-0722-2
"B11,A6",4534,5361,3339,2022,3238,1865,0,1869,1224,645,1.897674419,1108,2699,602,252,252,0,92,0,0.031746032,0,empty,CD-0722-2
"B11,A7",3638,4373,2607,1766,2600,1489,0,1489,982,507,1.936883629,906,1205,213,89,87,2,39,1,0.011494253,0,empty,CD-0722-2
"B11,A8",273774,323726,204039,119687,190392,105655,0,105732,82135,23597,3.480739077,61894,113948,10032,3950,3813,137,936,8,0.068450039,0,hg38,CD-0722-2
"B11,A9",4152,4805,3130,1675,2870,1576,0,1578,1068,510,2.094117647,889,2021,388,160,154,6,58,2,0.025974026,0,empty,CD-0722-2
"B11,A10",4892,5325,3690,1635,3278,1784,0,1785,1151,634,1.815457413,969,701,130,64,64,0,25,0,0,0,empty,CD-0722-2
"B11,A11",3558,3975,2650,1325,2450,1299,2,1305,853,452,1.887168142,728,1634,381,167,166,1,57,1,0.084337349,0,empty,CD-0722-2
"B11,A12",5115,5737,3810,1927,3408,1765,0,1771,1177,594,1.981481481,1003,3708,967,341,339,2,102,1,0.09439528,0,empty,CD-0722-2
"B11,B1",435708,483621,335234,148387,278805,139096,0,139214,103002,36212,2.844416216,76789,39762,6065,2340,2297,43,510,2,0.01915542,0,hg38,CD-0722-2
"B11,B2",4955,5788,3254,2534,3466,2166,0,2167,1418,749,1.893190921,1321,899,115,46,46,0,19,0,0.065217391,0,empty,CD-0722-2
"B11,B3",3877,4552,2817,1735,2685,1531,0,1531,1026,505,2.031683168,884,1371,310,156,156,0,57,0,0.096153846,0,empty,CD-0722-2
"B11,B4",4221,5010,3036,1974,3005,1782,0,1787,1134,653,1.736600306,1055,1572,292,106,100,6,33,2,0.05,0,empty,CD-0722-2
"B11,B5",5352,3903,2430,1473,2638,1419,0,1422,1008,414,2.434782609,902,911,125,73,70,3,28,2,0.028571429,0,empty,CD-0722-2
"B11,B6",460646,581001,319566,261435,338950,231049,0,231209,168346,62863,2.677982279,141141,7827,954,279,263,16,82,3,0.163498099,0,hg38,CD-0722-2
"B11,B7",442926,559234,305010,254224,327693,223740,1,223901,164097,59804,2.743913451,137738,2345,488,182,181,1,78,1,0.005524862,0,hg38,CD-0722-2
"B11,B8",3031,3602,2238,1364,2217,1218,0,1218,876,342,2.561403509,739,1243,290,117,116,1,36,1,0.034482759,0,empty,CD-0722-2
"B11,B9",7470,8614,5330,3284,5135,3105,0,3105,2010,1095,1.835616438,1769,1899,656,167,165,2,76,1,0.018181818,0,empty,CD-0722-2
"B11,B10",449561,467587,332753,134834,277336,128777,4,129068,104470,24598,4.24709326,70735,11268,1891,672,657,15,172,2,0.02435312,0,hg38,CD-0722-2
"B11,B11",6756,7944,4757,3187,4735,2876,0,2880,1591,1289,1.234290147,1712,285,26,20,19,1,13,1,0,0,empty,CD-0722-2
"B11,B12",3760,4250,2724,1526,2582,1409,0,1409,975,434,2.246543779,810,1752,493,197,196,1,53,1,0.193877551,0,empty,CD-0722-2
"B11,C1",28022,31651,21759,9892,17904,8876,0,8879,6182,2697,2.292176492,4872,4127,677,280,272,8,68,3,0.084558824,0,empty,CD-0722-2
"B11,C2",6266,7402,4472,2930,4354,2513,0,2513,1628,885,1.839548023,1495,2344,544,210,207,3,79,2,0.048309179,0,empty,CD-0722-2
"B11,C3",497908,624215,347434,276781,362825,241878,0,242021,178257,63764,2.795574305,148264,7106,4198,1447,1444,3,316,1,0.003462604,0,hg38,CD-0722-2
"B11,C4",4227,4694,3113,1581,2814,1499,0,1505,969,536,1.807835821,851,2174,419,200,194,6,61,2,0.067010309,0,empty,CD-0722-2
"B11,C5",5477,6334,3963,2371,3807,2117,0,2117,1438,679,2.117820324,1219,1585,472,182,181,1,49,1,0.17679558,0,empty,CD-0722-2
"B11,C6",4612,5309,3281,2028,3265,1875,0,1879,1261,618,2.040453074,1131,1339,421,167,166,1,52,1,0.15060241,0,empty,CD-0722-2
"B11,C7",6893,8211,4760,3451,4977,3051,0,3055,1878,1177,1.595581988,1882,527,111,48,45,3,24,1,0.133333333,0,empty,CD-0722-2
"B11,C8",581845,667198,434796,232402,383318,204801,2,204985,165690,39295,4.216566993,117919,172368,26951,10824,10634,190,1685,8,0.06883581,0,hg38,CD-0722-2
"B11,C9",4925,5730,3623,2107,3464,1962,0,1964,1226,738,1.661246612,1141,1445,247,105,104,1,34,1,0.115384615,0,empty,CD-0722-2
"B11,C10",5774,6693,4311,2382,3965,2177,0,2180,1462,718,2.036211699,1249,2337,522,212,209,3,59,3,0.258373206,0,empty,CD-0722-2
"B11,C11",1422190,1677566,1061202,616364,950741,541185,2,541600,442314,99286,4.454948331,320378,192878,26512,10624,10356,268,1808,7,0.044322132,0,hg38,CD-0722-2
"B11,C12",6961,7851,5128,2723,4677,2506,1,2514,1631,883,1.847112118,1436,1710,358,164,163,1,67,1,0.079754601,0,empty,CD-0722-2
"B11,D1",1194409,1408953,875229,533724,804000,469396,1,469709,399903,69806,5.728776896,280014,96900,12735,5083,4971,112,944,3,0.041239187,0,hg38,CD-0722-2
"B11,D2",480797,543234,366182,177052,313806,161535,0,161696,126213,35483,3.556999126,91510,125205,15632,5953,5801,152,1163,7,0.046026547,0,hg38,CD-0722-2
"B11,D3",4588,5178,3284,1894,3091,1726,0,1726,1112,614,1.811074919,999,1820,552,243,242,1,76,1,0.078512397,0,empty,CD-0722-2
"B11,D4",3739,4205,2826,1379,2467,1290,0,1290,859,431,1.993039443,689,1254,347,153,153,0,49,0,0.006535948,0,empty,CD-0722-2
"B11,D5",4198,4751,3118,1633,2899,1560,0,1561,1023,538,1.901486989,884,1713,362,144,143,1,63,1,0.111888112,0,empty,CD-0722-2
"B11,D6",6418,7504,4543,2961,4434,2631,0,2636,1608,1028,1.564202335,1587,1561,262,108,106,2,49,1,0.037735849,0,empty,CD-0722-2
"B11,D7",3681,4235,2666,1569,2477,1326,0,1327,925,402,2.300995025,786,1981,461,194,192,2,71,2,0.005208333,0,empty,CD-0722-2
"B11,D8",4242,4802,3117,1685,2871,1543,0,1544,984,560,1.757142857,861,1055,249,120,120,0,53,0,0.008333333,0,empty,CD-0722-2
"B11,D9",2221,2590,1687,903,1522,777,0,779,536,243,2.205761317,450,1300,242,109,108,1,33,1,0.027777778,0,empty,CD-0722-2
"B11,D10",4336,5083,3155,1928,3010,1686,0,1692,1125,567,1.984126984,1011,1159,278,128,127,1,35,1,0.11023622,0,empty,CD-0722-2
"B11,D11",561950,661137,421193,239944,379825,209282,0,209457,166094,43363,3.830316168,122777,225141,42682,16356,16148,208,2342,10,0.053876641,0,hg38,CD-0722-2
"B11,D12",884893,1034477,671961,362516,586924,320804,5,321066,265548,55518,4.783097374,185680,167352,30637,12042,11864,178,1997,5,0.039362778,0,hg38,CD-0722-2
"B11,E1",7128,7916,5194,2722,4729,2548,0,2552,1607,945,1.700529101,1440,2890,649,274,267,7,85,1,0.104868914,0,empty,CD-0722-2
"B11,E2",5135,5858,3695,2163,3536,1962,0,1962,1222,740,1.651351351,1162,2255,376,157,157,0,57,0,0.012738854,0,empty,CD-0722-2
"B11,E3",3805,4353,2839,1514,2663,1406,0,1410,884,526,1.680608365,825,2860,398,191,184,7,78,2,0.038043478,0,empty,CD-0722-2
"B11,E4",4911,5516,3625,1891,3385,1807,0,1809,1190,619,1.922455574,1054,2377,562,230,228,2,72,2,0.083333333,0,empty,CD-0722-2
"B11,E5",4432,4926,3365,1561,2938,1550,0,1554,986,568,1.735915493,841,1336,326,129,128,1,47,1,0.0859375,0,empty,CD-0722-2
"B11,E6",7946,9024,5837,3187,5408,3007,0,3009,1928,1081,1.783533765,1727,3813,1004,410,406,4,133,2,0.054187192,0,empty,CD-0722-2
"B11,E7",6861,7610,5086,2524,4598,2380,0,2386,1545,841,1.837098692,1360,3145,788,294,292,2,85,1,0.023972603,0,empty,CD-0722-2
"B11,E8",5489,6249,4150,2099,3780,1996,0,1998,1305,693,1.883116883,1109,2455,595,253,249,4,82,2,0.024096386,0,empty,CD-0722-2
"B11,E9",3732,4308,2769,1539,2615,1494,0,1494,1002,492,2.036585366,864,2256,577,248,245,3,83,1,0.110204082,0,empty,CD-0722-2
"B11,E10",3915,4488,2908,1580,2647,1446,0,1446,963,483,1.99378882,812,1738,469,178,177,1,56,1,0.02259887,0,empty,CD-0722-2
"B11,E11",4963,5750,3584,2166,3425,1969,0,1969,1278,691,1.849493488,1148,1741,338,121,121,0,50,0,0.107438017,0,empty,CD-0722-2
"B11,E12",5587,6505,3954,2551,3976,2193,0,2194,1426,768,1.856770833,1345,1876,378,179,173,6,72,2,0.132947977,0,empty,CD-0722-2
"B11,F1",6588,7439,4857,2582,4416,2410,0,2417,1551,866,1.790993072,1359,2678,573,248,248,0,78,0,0.02016129,0,empty,CD-0722-2
"B11,F2",5259,6048,3816,2232,3621,1989,0,1990,1333,657,2.02891933,1133,2773,513,237,233,4,68,1,0.167381974,0,empty,CD-0722-2
"B11,F3",4680,5245,3409,1836,3158,1739,0,1739,1175,564,2.083333333,991,2333,447,181,179,2,69,1,0.011173184,0,empty,CD-0722-2
"B11,F4",6917,7699,5243,2456,4655,2430,0,2434,1561,873,1.788087056,1325,1182,144,85,84,1,43,1,0.05952381,0,empty,CD-0722-2
"B11,F5",5729,6382,4243,2139,3847,2008,0,2011,1320,691,1.910274964,1150,2198,486,221,220,1,64,1,0.227272727,0,empty,CD-0722-2
"B11,F6",5501,6451,4043,2408,3802,2166,1,2172,1346,826,1.629539952,1253,2504,794,273,271,2,79,1,0.084870849,0,empty,CD-0722-2
"B11,F7",6235,7186,4595,2591,4322,2430,0,2432,1613,819,1.969474969,1429,990,218,108,107,1,30,1,0.009345794,0,empty,CD-0722-2
"B11,F8",90340,127957,59408,68549,75643,55986,0,56027,30326,25701,1.179954087,37011,853,291,84,82,2,34,2,0.036585366,0,empty,CD-0722-2
"B11,F9",5401,5661,4163,1498,3467,1705,0,1709,1199,510,2.350980392,848,3248,739,314,308,6,99,2,0.048701299,0,empty,CD-0722-2
"B11,F10",6304,6961,4722,2239,4316,2261,0,2261,1501,760,1.975,1267,1731,395,165,162,3,55,2,0.086419753,0,empty,CD-0722-2
"B11,F11",5025,5410,3757,1653,3358,1721,0,1723,1168,555,2.104504505,922,1643,422,174,173,1,54,1,0.150289017,0,empty,CD-0722-2
"B11,F12",5833,6432,4273,2159,3822,2084,0,2086,1401,685,2.045255474,1172,362,30,24,24,0,15,0,0,0,empty,CD-0722-2
"B11,G1",5800,6448,4317,2131,3827,1999,0,1999,1323,676,1.957100592,1110,2921,700,318,314,4,96,2,0.02866242,0,empty,CD-0722-2
"B11,G2",3824,4545,2614,1931,2703,1621,0,1621,1041,580,1.794827586,975,714,98,64,63,1,36,1,0.142857143,0,empty,CD-0722-2
"B11,G3",11881,12932,8818,4114,7720,4406,0,4407,2348,2059,1.140359398,2213,2577,558,238,229,9,81,3,0.109170306,0,empty,CD-0722-2
"B11,G4",12146,14250,8513,5737,8491,5151,0,5169,3146,2023,1.555116164,3099,200,31,22,22,0,18,0,0,0,empty,CD-0722-2
"B11,G5",4179,4848,2967,1881,2879,1608,0,1609,1008,601,1.677204659,959,2001,372,154,146,8,52,2,0.054794521,0,empty,CD-0722-2
"B11,G6",6094,6909,4436,2473,4203,2272,0,2272,1484,788,1.883248731,1294,186,52,15,15,0,9,0,0.2,0,empty,CD-0722-2
"B11,G7",4550,4926,3402,1524,2998,1552,0,1555,1002,553,1.811934901,836,2340,564,208,208,0,51,0,0.076923077,0,empty,CD-0722-2
"B11,G8",3610,4063,2618,1445,2468,1326,0,1327,876,451,1.942350333,750,1574,407,171,170,1,66,1,0.182352941,0,empty,CD-0722-2
"B11,G9",3985,4452,2928,1524,2728,1479,0,1487,980,507,1.932938856,873,2144,553,188,186,2,67,2,0.11827957,0,empty,CD-0722-2
"B11,G10",5127,5979,3735,2244,3585,2038,0,2041,1346,695,1.936690647,1189,1978,417,152,152,0,58,0,0.092105263,0,empty,CD-0722-2
"B11,G11",497177,555323,382927,172396,319549,158668,4,158788,123098,35690,3.449089381,87792,169586,24156,9058,8846,212,1476,4,0.043409451,0,hg38,CD-0722-2
"B11,G12",4484,5363,3241,2122,3374,1947,0,1949,1225,724,1.69198895,1226,2813,612,254,253,1,88,1,0.102766798,0,empty,CD-0722-2
"B11,H1",4587,5260,3379,1881,3193,1734,0,1734,1181,553,2.13562387,1031,1317,298,140,140,0,45,0,0.042857143,0,empty,CD-0722-2
"B11,H2",7332,8300,5429,2871,5010,2609,0,2610,1870,740,2.527027027,1509,2340,466,200,199,1,76,1,0.070351759,0,empty,CD-0722-2
"B11,H3",4535,5351,3254,2097,3160,1792,0,1792,1194,598,1.996655518,1085,2062,408,167,165,2,77,1,0.060606061,0,empty,CD-0722-2
"B11,H4",6402,7344,4615,2729,4258,2379,0,2379,1612,767,2.101694915,1363,292,49,24,24,0,16,0,0.041666667,0,empty,CD-0722-2
"B11,H5",609841,705998,458177,247821,402721,214253,1,214429,161752,52677,3.070638039,125372,102671,18639,7338,7228,110,1216,5,0.02905368,0,hg38,CD-0722-2
"B11,H6",4314,4953,3106,1847,2951,1660,0,1660,1085,575,1.886956522,965,1998,586,258,255,3,74,2,0.039215686,0,empty,CD-0722-2
"B11,H7",4825,5374,3547,1827,3255,1787,0,1787,1191,596,1.998322148,1012,2317,654,271,267,4,92,2,0.014981273,0,empty,CD-0722-2
"B11,H8",5303,6001,3818,2183,3582,2057,0,2057,1366,691,1.976845152,1177,2095,423,212,207,5,87,1,0.053140097,0,empty,CD-0722-2
"B11,H9",560630,642449,423913,218536,368736,194123,0,194291,152270,42021,3.623664358,112382,77793,12362,4645,4533,112,841,5,0.049415398,0,hg38,CD-0722-2
"B11,H10",4081,4726,2971,1755,2823,1563,0,1564,1061,503,2.109343936,908,1726,301,138,137,1,46,1,0.04379562,0,empty,CD-0722-2
"B11,H11",4863,5811,3331,2480,3564,2363,0,2364,1340,1024,1.30859375,1464,108,17,7,7,0,6,0,0,0,empty,CD-0722-2
"B11,H12",4050,4368,2960,1408,2703,1478,0,1479,1017,462,2.201298701,810,1441,240,108,105,3,48,2,0.028571429,0,empty,CD-0722-2
"B12,A1",3657,4158,2656,1502,2489,1436,0,1437,886,551,1.607985481,827,1114,247,110,110,0,35,0,0.009090909,0,empty,CD-0722-2
"B12,A2",5235,5877,3785,2092,3557,2007,0,2007,1273,734,1.734332425,1129,1800,302,98,94,4,47,2,0.010638298,0,empty,CD-0722-2
"B12,A3",3321,3795,2382,1413,2309,1247,0,1249,819,430,1.904651163,737,1067,229,102,98,4,37,2,0.010204082,0,empty,CD-0722-2
"B12,A4",6105,7090,4465,2625,4291,2411,0,2412,1521,891,1.707070707,1390,1046,217,79,79,0,19,0,0.063291139,0,empty,CD-0722-2
"B12,A5",4709,5061,3475,1586,3142,1610,0,1614,994,620,1.603225806,919,1809,272,129,125,4,30,3,0.24,0,empty,CD-0722-2
"B12,A6",4004,4817,2887,1930,2853,1699,0,1699,1133,566,2.001766784,997,2688,660,282,281,1,91,1,0.103202847,0,empty,CD-0722-2
"B12,A7",3633,4204,2629,1575,2571,1437,0,1438,901,537,1.677839851,867,1243,258,109,107,2,32,2,0.093457944,0,empty,CD-0722-2
"B12,A8",207549,227889,162902,64987,134841,62799,1,62843,47207,15636,3.019122538,34419,33888,5904,2263,2226,37,492,3,0.021563342,0,hg38,CD-0722-2
"B12,A9",4924,5836,3710,2126,3479,1893,0,1893,1244,649,1.916795069,1098,1609,409,163,161,2,43,1,0.093167702,0,empty,CD-0722-2
"B12,A10",4547,5041,3484,1557,3014,1608,0,1609,1012,597,1.695142379,895,377,40,28,28,0,18,0,0.035714286,0,empty,CD-0722-2
"B12,A11",3216,3531,2424,1107,2186,1127,0,1129,768,361,2.127423823,619,1496,288,120,117,3,47,2,0,0,empty,CD-0722-2
"B12,A12",4675,5189,3592,1597,3152,1633,0,1633,1016,617,1.646677472,908,2850,836,327,325,2,87,1,0.095384615,0,empty,CD-0722-2
"B12,B1",4188,4678,3066,1612,2812,1579,0,1581,993,588,1.68877551,882,1001,125,65,65,0,27,0,0.046153846,0,empty,CD-0722-2
"B12,B2",4415,4904,3026,1878,3034,1792,0,1795,1112,683,1.628111274,1067,650,79,42,42,0,16,0,0.071428571,0,empty,CD-0722-2
"B12,B3",3852,4392,2761,1631,2769,1602,1,1607,1051,556,1.89028777,955,1140,210,96,94,2,39,1,0.095744681,0,empty,CD-0722-2
"B12,B4",3926,4634,2816,1818,2815,1665,0,1667,1014,653,1.552833078,985,1030,264,125,123,2,44,1,0.056910569,0,empty,CD-0722-2
"B12,B5",4117,2528,1547,981,1850,1040,0,1051,658,393,1.674300254,673,944,201,99,96,3,39,2,0.020833333,0,empty,CD-0722-2
"B12,B6",4386,4979,3083,1896,2992,1751,0,1751,1086,665,1.633082707,1027,1601,363,148,145,3,45,2,0.027586207,0,empty,CD-0722-2
"B12,B7",4005,4584,2944,1640,2771,1470,0,1470,973,497,1.957746479,825,1604,480,154,150,4,34,1,0.126666667,0,empty,CD-0722-2
"B12,B8",2761,3239,2032,1207,1931,1062,0,1066,698,368,1.89673913,602,1112,242,100,100,0,35,0,0.04,0,empty,CD-0722-2
"B12,B9",5774,6711,4192,2519,4029,2314,1,2318,1426,892,1.598654709,1325,1172,206,126,125,1,50,1,0.048,0,empty,CD-0722-2
"B12,B10",2851,3048,1939,1109,1916,1052,0,1057,693,364,1.903846154,608,600,42,25,23,2,11,1,0,0,empty,CD-0722-2
"B12,B11",10773,13004,7864,5140,7696,4532,0,4535,3030,1505,2.013289037,2741,242,53,29,28,1,16,1,0,0,empty,CD-0722-2
"B12,B12",3460,4001,2501,1500,2424,1339,0,1339,878,461,1.904555315,795,1459,421,175,170,5,53,1,0.023529412,0,empty,CD-0722-2
"B12,C1",7020,7977,5150,2827,4720,2577,0,2583,1624,959,1.693430657,1463,812,180,78,78,0,26,0,0.166666667,0,empty,CD-0722-2
"B12,C2",5922,6604,4259,2345,3955,2218,0,2220,1420,800,1.775,1233,1866,394,142,141,1,47,1,0.014184397,0,empty,CD-0722-2
"B12,C3",6074,6972,4507,2465,4102,2241,0,2246,1418,828,1.712560386,1283,927,223,92,88,4,30,1,0.090909091,0,empty,CD-0722-2
"B12,C4",3808,4227,2771,1456,2521,1309,0,1313,848,465,1.823655914,734,1961,574,226,223,3,48,1,0.143497758,0,empty,CD-0722-2
"B12,C5",507395,575069,386020,189049,332969,170493,0,170637,134326,36311,3.699319765,97311,31325,6009,2269,2242,27,512,2,0.04058876,0,hg38,CD-0722-2
"B12,C6",592995,701233,435721,265512,409925,231752,2,231931,187710,44221,4.244815811,137867,55723,8600,3279,3217,62,682,3,0.053776811,0,hg38,CD-0722-2
"B12,C7",6860,8090,4873,3217,4822,2859,0,2864,1749,1115,1.568609865,1714,450,51,23,23,0,12,0,0,0,empty,CD-0722-2
"B12,C8",6787,7861,5034,2827,4724,2618,0,2622,1703,919,1.853101197,1502,2548,759,333,330,3,90,1,0.084848485,0,empty,CD-0722-2
"B12,C9",4630,5432,3377,2055,3157,1769,0,1769,1188,581,2.04475043,1011,1597,395,151,150,1,48,1,0.073333333,0,empty,CD-0722-2
"B12,C10",606963,695610,458445,237165,399930,212591,0,212776,155941,56835,2.74374945,122703,167878,16318,6581,6353,228,1155,8,0.060129073,0,hg38,CD-0722-2
"B12,C11",614893,725803,449983,275820,419059,231598,1,231746,192976,38770,4.977456796,139693,3542,1170,402,395,7,160,2,0.035443038,0,hg38,CD-0722-2
"B12,C12",6309,7086,4533,2553,4386,2410,0,2412,1590,822,1.934306569,1412,1805,370,160,159,1,44,1,0.062893082,0,empty,CD-0722-2
"B12,D1",5990,6937,4326,2611,4157,2417,0,2424,1478,946,1.562367865,1374,765,104,48,46,2,21,2,0.217391304,0,empty,CD-0722-2
"B12,D2",4988,5544,3776,1768,3401,1729,0,1735,1083,652,1.661042945,979,2949,969,347,344,3,97,2,0.061046512,0,empty,CD-0722-2
"B12,D3",4306,4946,3063,1883,2948,1638,0,1640,1076,564,1.907801418,952,1253,304,117,116,1,42,1,0.025862069,0,empty,CD-0722-2
"B12,D4",3529,4122,2619,1503,2460,1321,0,1321,831,490,1.695918367,785,1356,247,106,102,4,35,1,0.12745098,0,empty,CD-0722-2
"B12,D5",3900,4479,2872,1607,2736,1516,0,1516,1016,500,2.032,873,1691,396,165,162,3,55,2,0.018518519,0,empty,CD-0722-2
"B12,D6",6026,6831,4254,2577,4116,2472,0,2474,1513,961,1.574401665,1405,1483,298,147,147,0,58,0,0.013605442,0,empty,CD-0722-2
"B12,D7",3128,3426,2213,1213,2123,1169,0,1172,757,415,1.824096386,653,1684,370,161,159,2,64,2,0.119496855,0,empty,CD-0722-2
"B12,D8",4363,4931,3150,1781,2937,1578,0,1578,1020,558,1.827956989,901,992,118,67,65,2,40,2,0.015384615,0,empty,CD-0722-2
"B12,D9",3023,3346,2170,1176,2037,1075,0,1078,731,347,2.106628242,636,1273,196,83,78,5,34,1,0.128205128,0,empty,CD-0722-2
"B12,D10",3608,4118,2632,1486,2529,1429,3,1432,917,515,1.780582524,834,781,126,51,50,1,21,1,0,0,empty,CD-0722-2
"B12,D11",4315,4840,3213,1627,2948,1574,0,1575,1032,543,1.900552486,877,2640,661,318,314,4,96,2,0.041401274,0,empty,CD-0722-2
"B12,D12",734271,865085,553830,311255,494320,274298,2,274528,205774,68754,2.992902231,159708,32165,8907,3237,3207,30,725,2,0.027128157,0,hg38,CD-0722-2
"B12,E1",482486,523292,377510,145782,302468,138769,0,138902,105854,33048,3.203038005,74788,37330,7617,2814,2769,45,594,3,0.018418202,0,hg38,CD-0722-2
"B12,E2",4902,5683,3427,2256,3454,1930,0,1930,1171,759,1.542819499,1181,1722,365,140,139,1,49,1,0.014388489,0,empty,CD-0722-2
"B12,E3",3329,3841,2462,1379,2303,1246,0,1246,865,381,2.270341207,738,1889,629,269,267,2,69,1,0.06741573,0,empty,CD-0722-2
"B12,E4",4464,4982,3320,1662,3025,1593,0,1594,993,601,1.652246256,891,2368,629,260,258,2,81,2,0.050387597,0,empty,CD-0722-2
"B12,E5",4142,4534,3110,1424,2733,1431,0,1434,947,487,1.944558522,774,1258,264,122,118,4,48,2,0.042372881,0,empty,CD-0722-2
"B12,E6",906325,1051521,690627,360894,595384,321190,1,321459,262320,59139,4.4356516,183840,265726,51656,19763,19490,273,2461,10,0.048691637,0,hg38,CD-0722-2
"B12,E7",6328,7185,4603,2582,4229,2276,0,2280,1477,803,1.839352428,1295,2542,730,266,265,1,68,1,0.052830189,0,empty,CD-0722-2
"B12,E8",5583,6330,4137,2193,3798,2010,0,2012,1343,669,2.007473842,1134,2721,827,292,281,11,76,3,0.003558719,0,empty,CD-0722-2
"B12,E9",3401,3860,2518,1342,2316,1254,0,1254,814,440,1.85,715,1909,453,163,163,0,58,0,0.049079755,0,empty,CD-0722-2
"B12,E10",3865,4465,2818,1647,2705,1476,0,1476,1000,476,2.100840336,845,1795,366,102,98,4,36,2,0,0,empty,CD-0722-2
"B12,E11",4749,5160,3442,1718,3111,1656,0,1656,1052,604,1.741721854,899,1908,429,164,160,4,62,2,0.0625,0,empty,CD-0722-2
"B12,E12",4977,5573,3596,1977,3349,1841,0,1841,1195,646,1.849845201,1053,2306,459,167,165,2,46,1,0.127272727,0,empty,CD-0722-2
"B12,F1",5875,6530,4251,2279,3954,2167,0,2167,1347,820,1.642682927,1227,1946,495,216,213,3,76,2,0.023474178,0,empty,CD-0722-2
"B12,F2",4678,5179,3473,1706,3054,1635,0,1635,1075,560,1.919642857,842,2324,624,258,257,1,88,1,0.070038911,0,empty,CD-0722-2
"B12,F3",440038,558742,293054,265688,329710,230390,1,230562,159429,71133,2.241280418,145713,4397,722,273,266,7,82,2,0.07518797,0,hg38,CD-0722-2
"B12,F4",639292,720425,483089,237336,419795,219094,5,219263,182390,36873,4.946437773,124585,16978,3087,1103,1082,21,232,4,0.044362292,0,hg38,CD-0722-2
"B12,F5",5489,6056,3936,2120,3566,1892,0,1894,1173,721,1.626907074,1058,2167,625,219,218,1,57,1,0.041284404,0,empty,CD-0722-2
"B12,F6",5143,5766,3658,2108,3480,1981,0,1983,1267,716,1.769553073,1127,2513,634,223,221,2,57,1,0.054298643,0,empty,CD-0722-2
"B12,F7",6104,6959,4382,2577,4205,2388,0,2392,1500,892,1.68161435,1378,815,173,86,85,1,28,1,0.011764706,0,empty,CD-0722-2
"B12,F8",4189,4934,3137,1797,2947,1609,0,1609,1029,580,1.774137931,911,446,37,32,29,3,19,2,0.103448276,0,empty,CD-0722-2
"B12,F9",4698,5098,3559,1539,3056,1545,0,1547,997,550,1.812727273,826,2999,559,237,234,3,72,2,0.123931624,0,empty,CD-0722-2
"B12,F10",6040,6862,4517,2345,4178,2242,0,2246,1436,810,1.772839506,1284,1972,496,178,172,6,55,2,0.063953488,0,empty,CD-0722-2
"B12,F11",652020,810468,450460,360008,473677,322533,4,322745,235211,87534,2.687081591,194839,16003,1022,355,329,26,97,3,0.273556231,0,hg38,CD-0722-2
"B12,F12",5100,5572,3686,1886,3405,1817,0,1820,1204,616,1.954545455,1012,215,31,20,20,0,17,0,0,0,empty,CD-0722-2
"B12,G1",5928,6685,4482,2203,4073,2203,0,2207,1438,769,1.869960988,1203,2410,559,201,201,0,75,0,0.039800995,0,empty,CD-0722-2
"B12,G2",3526,3933,2460,1473,2360,1326,0,1326,854,472,1.809322034,754,432,71,50,50,0,22,0,0.04,0,empty,CD-0722-2
"B12,G3",6385,7126,4785,2341,4253,2301,0,2301,1337,964,1.386929461,1255,2257,582,210,208,2,67,1,0.076923077,0,empty,CD-0722-2
"B12,G4",11497,13289,8139,5150,8125,4928,0,4940,3087,1853,1.665947113,2941,83,7,6,6,0,6,0,0,0,empty,CD-0722-2
"B12,G5",522800,594114,399193,194921,341353,175156,1,175290,131465,43825,2.99977182,100586,82949,11157,4471,4384,87,899,4,0.056341241,0,hg38,CD-0722-2
"B12,G6",5599,6250,4107,2143,3767,2039,0,2045,1370,675,2.02962963,1172,234,51,28,28,0,16,0,0,0,empty,CD-0722-2
"B12,G7",4367,4744,3314,1430,2894,1421,0,1423,918,505,1.817821782,791,2553,499,190,185,5,54,2,0.102702703,0,empty,CD-0722-2
"B12,G8",3061,3484,2263,1221,2134,1162,0,1164,740,424,1.745283019,681,1495,361,134,134,0,52,0,0.052238806,0,empty,CD-0722-2
"B12,G9",3823,4380,2761,1619,2632,1437,0,1437,926,511,1.812133072,837,2123,514,230,227,3,75,2,0.026431718,0,empty,CD-0722-2
"B12,G10",4667,5238,3391,1847,3194,1806,0,1808,1134,674,1.682492582,1057,1877,639,248,245,3,71,2,0.012244898,0,empty,CD-0722-2
"B12,G11",4660,5318,3326,1992,3157,1741,0,1741,1118,623,1.794542536,994,1231,209,83,83,0,36,0,0.168674699,0,empty,CD-0722-2
"B12,G12",4112,4767,3021,1746,2929,1667,0,1670,1102,568,1.940140845,958,2133,620,202,201,1,63,1,0.114427861,0,empty,CD-0722-2
"B12,H1",4140,4700,3066,1634,2767,1469,0,1471,961,510,1.884313725,864,1374,436,151,149,2,45,1,0.187919463,0,empty,CD-0722-2
"B12,H2",4593,5237,3401,1836,3093,1685,0,1685,1052,633,1.66192733,974,2420,643,261,261,0,74,0,0.164750958,0,empty,CD-0722-2
"B12,H3",4018,4490,2887,1603,2656,1488,0,1488,975,513,1.900584795,842,1552,275,133,131,2,45,2,0.053435115,0,empty,CD-0722-2
"B12,H4",1412106,1725808,1020180,705628,973651,586918,5,587347,478356,108991,4.388949546,357972,16769,2378,939,927,12,213,2,0.11218986,0,hg38,CD-0722-2
"B12,H5",1391380,1626625,1039098,587527,914627,506419,1,506843,385703,121140,3.183944197,299434,225269,28644,11161,10873,288,1969,9,0.044789846,0.003472222,hg38,CD-0722-2
"B12,H6",2099151,2512167,1543656,968511,1416378,830702,3,831349,667609,163740,4.077250519,499286,364683,54772,21151,20651,500,2895,13,0.064500508,0,hg38,CD-0722-2
"B12,H7",4396,5093,3235,1858,3118,1686,3,1692,1144,548,2.087591241,997,1664,476,178,175,3,63,1,0.022857143,0,empty,CD-0722-2
"B12,H8",4927,5588,3572,2016,3322,1854,0,1856,1204,652,1.846625767,1044,2482,646,277,277,0,70,0,0.108303249,0,empty,CD-0722-2
"B12,H9",3663,3936,2819,1117,2348,1149,0,1151,765,386,1.981865285,600,1221,359,147,146,1,48,1,0.075342466,0,empty,CD-0722-2
"B12,H10",3493,3958,2581,1377,2461,1320,0,1320,858,462,1.857142857,763,1677,257,126,123,3,52,3,0.032520325,0,empty,CD-0722-2
"B12,H11",4930,5791,3338,2453,3439,2247,0,2254,1206,1048,1.150763359,1349,46,2,1,1,0,1,0,0,0,empty,CD-0722-2
"B12,H12",3556,4256,2552,1704,2530,1482,0,1482,988,494,2,897,1278,249,103,101,2,43,2,0,0,empty,CD-0722-2
"C1,A1",3529,4051,2549,1502,2451,1428,0,1430,890,540,1.648148148,785,809,177,72,71,1,28,1,0.169014085,0,empty,CD-0722-2
"C1,A2",5304,6102,3913,2189,3585,2065,0,2065,1214,851,1.426556992,1174,1331,219,112,110,2,42,1,0.054545455,0,empty,CD-0722-2
"C1,A3",3362,3788,2429,1359,2299,1260,0,1264,782,482,1.622406639,743,1233,252,98,97,1,31,1,0.134020619,0,empty,CD-0722-2
"C1,A4",5530,6291,4029,2262,3782,2051,0,2051,1321,730,1.809589041,1203,928,346,123,122,1,29,1,0.032786885,0,empty,CD-0722-2
"C1,A5",4624,4944,3331,1613,3011,1597,0,1597,1089,508,2.143700787,873,1820,381,154,152,2,48,1,0.085526316,0,empty,CD-0722-2
"C1,A6",4037,4737,2952,1785,2872,1613,0,1617,1061,556,1.908273381,933,2592,779,316,314,2,86,2,0.063694268,0,empty,CD-0722-2
"C1,A7",3691,4134,2706,1428,2499,1396,0,1397,929,468,1.985042735,744,1357,308,146,139,7,37,2,0.014388489,0,empty,CD-0722-2
"C1,A8",2088,2366,1591,775,1433,758,0,758,484,274,1.766423358,425,1417,338,170,170,0,44,0,0.017647059,0,empty,CD-0722-2
"C1,A9",4008,4539,2962,1577,2671,1421,0,1423,881,542,1.625461255,818,1695,391,143,140,3,43,2,0.028571429,0,empty,CD-0722-2
"C1,A10",4839,5456,3611,1845,3280,1742,0,1742,1058,684,1.546783626,1029,265,42,16,16,0,7,0,0,0,empty,CD-0722-2
"C1,A11",380574,464145,268776,195369,270987,171950,1,172071,125118,46953,2.664749856,104589,37615,4040,1575,1535,40,406,3,0.051465798,0,hg38,CD-0722-2
"C1,A12",4798,5484,3541,1943,3251,1747,0,1749,1184,565,2.095575221,1004,2784,799,276,273,3,84,1,0.098901099,0,empty,CD-0722-2
"C1,B1",530459,615552,397451,218101,350449,191394,2,191564,144807,46757,3.097012212,112144,130840,21467,8077,7930,147,1384,7,0.04779319,0,hg38,CD-0722-2
"C1,B2",4255,4892,2826,2066,3014,1825,0,1825,1111,714,1.556022409,1146,434,76,41,41,0,12,0,0,0,empty,CD-0722-2
"C1,B3",3470,3892,2528,1364,2406,1326,0,1329,878,451,1.946784922,741,1309,228,121,121,0,46,0,0,0,empty,CD-0722-2
"C1,B4",324638,368274,245245,123029,214212,111710,1,111804,90139,21665,4.160581583,64018,32051,5644,2133,2102,31,421,3,0.027592769,0,hg38,CD-0722-2
"C1,B5",5598,4232,2610,1622,2830,1556,0,1560,1134,426,2.661971831,947,853,129,50,50,0,21,0,0,0,empty,CD-0722-2
"C1,B6",4417,5140,3114,2026,2985,1724,0,1724,1086,638,1.702194357,1028,1597,584,198,196,2,43,1,0.112244898,0,empty,CD-0722-2
"C1,B7",3773,4262,2831,1431,2534,1336,0,1338,888,450,1.973333333,743,1017,251,91,91,0,29,0,0.32967033,0,empty,CD-0722-2
"C1,B8",2918,3487,2185,1302,2088,1162,0,1162,750,412,1.82038835,686,1156,226,84,84,0,25,0,0.202380952,0,empty,CD-0722-2
"C1,B9",5870,6700,4212,2488,4176,2400,0,2401,1505,896,1.6796875,1400,864,211,96,93,3,28,2,0,0,empty,CD-0722-2
"C1,B10",368967,399591,266874,132717,239113,120555,8,120867,89333,31534,2.832910509,69624,36058,3826,1581,1541,40,315,4,0.071382219,0,hg38,CD-0722-2
"C1,B11",6724,7902,4655,3247,4668,2815,0,2817,1594,1223,1.303352412,1713,173,5,4,3,1,2,1,0.333333333,0,empty,CD-0722-2
"C1,B12",3346,3768,2446,1322,2276,1239,0,1243,828,415,1.995180723,694,1372,364,149,149,0,41,0,0.067114094,0,empty,CD-0722-2
"C1,C1",6795,7590,5042,2548,4394,2321,0,2321,1446,875,1.652571429,1273,886,212,77,76,1,25,1,0.013157895,0,empty,CD-0722-2
"C1,C2",5366,6048,3884,2164,3645,2046,0,2048,1315,733,1.793997271,1155,1602,476,222,218,4,62,1,0.050458716,0,empty,CD-0722-2
"C1,C3",7100,8171,5180,2991,4900,2688,0,2691,1769,922,1.918655098,1587,905,156,52,52,0,19,0,0.096153846,0,empty,CD-0722-2
"C1,C4",3706,4142,2786,1356,2484,1270,0,1270,784,486,1.613168724,719,1568,406,165,163,2,47,1,0.141104294,0,empty,CD-0722-2
"C1,C5",5064,5788,3654,2134,3438,1888,0,1888,1251,637,1.96389325,1124,1580,321,102,99,3,35,2,0.050505051,0,empty,CD-0722-2
"C1,C6",4526,5188,3267,1921,3130,1722,0,1722,1156,566,2.042402827,992,1574,434,163,162,1,45,1,0.12345679,0,empty,CD-0722-2
"C1,C7",6314,7326,4420,2906,4405,2692,0,2692,1594,1098,1.451730419,1626,749,279,110,108,2,21,1,0,0,empty,CD-0722-2
"C1,C8",7047,8313,5081,3232,4910,2824,0,2827,1796,1031,1.74199806,1667,2646,709,298,297,1,94,1,0.063973064,0,empty,CD-0722-2
"C1,C9",4673,5315,3400,1915,3253,1820,0,1820,1205,615,1.959349593,1062,1487,281,93,89,4,30,1,0.04494382,0,empty,CD-0722-2
"C1,C10",5355,6164,3997,2167,3618,1937,0,1939,1251,688,1.818313953,1082,1752,442,168,168,0,41,0,0.220238095,0,empty,CD-0722-2
"C1,C11",407790,474818,298278,176540,275448,149667,2,149796,124838,24958,5.001923231,89840,5205,1876,639,636,3,234,3,0.009433962,0,hg38,CD-0722-2
"C1,C12",6355,7219,4633,2586,4346,2334,0,2335,1512,823,1.837181045,1339,2216,678,260,254,6,55,1,0.153543307,0,empty,CD-0722-2
"C1,D1",6068,7018,4274,2744,4159,2470,0,2470,1486,984,1.510162602,1440,681,113,78,78,0,24,0,0.179487179,0,empty,CD-0722-2
"C1,D2",4892,5389,3780,1609,3263,1628,0,1630,1068,562,1.900355872,867,2398,684,289,288,1,72,1,0.166666667,0,empty,CD-0722-2
"C1,D3",4359,5041,3214,1827,3036,1683,0,1683,1108,575,1.926956522,982,1253,376,142,142,0,47,0,0.021126761,0,empty,CD-0722-2
"C1,D4",3116,3456,2285,1171,2149,1193,0,1193,767,426,1.800469484,697,1243,325,138,137,1,47,1,0,0,empty,CD-0722-2
"C1,D5",3774,4155,2762,1393,2591,1420,0,1423,935,488,1.915983607,817,1161,279,126,126,0,51,0,0.031746032,0,empty,CD-0722-2
"C1,D6",6101,6830,4273,2557,4078,2424,0,2424,1501,923,1.626218852,1408,1310,361,170,170,0,49,0,0.123529412,0,empty,CD-0722-2
"C1,D7",3241,3694,2400,1294,2228,1214,0,1214,773,441,1.752834467,679,1667,296,131,130,1,51,1,0.030769231,0,empty,CD-0722-2
"C1,D8",4076,4466,2987,1479,2727,1432,0,1435,910,525,1.733333333,795,1146,245,108,107,1,39,1,0,0,empty,CD-0722-2
"C1,D9",2047,2247,1541,706,1415,729,0,731,485,246,1.971544715,397,1329,330,128,126,2,25,2,0.182539683,0,empty,CD-0722-2
"C1,D10",3883,4515,2822,1693,2625,1470,0,1472,916,556,1.647482014,847,943,193,73,71,2,26,2,0.056338028,0,empty,CD-0722-2
"C1,D11",4360,4653,3285,1368,2916,1505,0,1506,1016,490,2.073469388,795,2119,444,167,163,4,58,2,0.098159509,0,empty,CD-0722-2
"C1,D12",5783,6556,4270,2286,4003,2114,0,2119,1392,727,1.914718019,1247,3167,681,286,276,10,75,2,0.061594203,0,empty,CD-0722-2
"C1,E1",6923,8001,4988,3013,4702,2629,0,2631,1651,980,1.684693878,1567,2300,522,210,208,2,51,1,0.024038462,0,empty,CD-0722-2
"C1,E2",4708,5312,3408,1904,3251,1778,0,1778,1108,670,1.653731343,1044,1770,331,135,134,1,45,1,0.067164179,0,empty,CD-0722-2
"C1,E3",3497,3992,2557,1435,2364,1308,0,1309,845,464,1.82112069,778,1976,648,274,270,4,57,2,0.07037037,0,empty,CD-0722-2
"C1,E4",4545,5189,3268,1921,3124,1799,0,1808,1123,685,1.639416058,1028,1852,434,156,154,2,60,1,0.084415584,0,empty,CD-0722-2
"C1,E5",616551,730135,458866,271269,418277,234862,1,235047,189033,46014,4.108162733,138800,71532,7285,2935,2838,97,657,5,0.041226216,0,hg38,CD-0722-2
"C1,E6",7365,8561,5324,3237,5033,2828,0,2830,1801,1029,1.750242954,1653,2643,587,277,270,7,85,2,0.085185185,0,empty,CD-0722-2
"C1,E7",8225,9230,6201,3029,5415,2775,0,2775,1880,895,2.100558659,1509,13291,2049,905,881,24,192,2,0.056753689,0,empty,CD-0722-2
"C1,E8",5317,5855,3860,1995,3462,1779,0,1779,1154,625,1.8464,996,2310,415,160,159,1,51,1,0.031446541,0,empty,CD-0722-2
"C1,E9",3553,3958,2549,1409,2383,1295,1,1299,874,425,2.056470588,736,1921,469,180,174,6,53,2,0.005747126,0,empty,CD-0722-2
"C1,E10",3960,4279,2920,1359,2602,1362,0,1362,886,476,1.861344538,724,1339,256,108,107,1,41,1,0.018691589,0,empty,CD-0722-2
"C1,E11",4628,5247,3337,1910,3107,1737,0,1739,1057,682,1.549853372,999,1725,436,177,177,0,54,0,0.011299435,0,empty,CD-0722-2
"C1,E12",441464,488618,339115,149503,283291,137809,0,137935,107519,30416,3.534948711,77537,17043,4746,1823,1809,14,427,2,0.030956329,0,hg38,CD-0722-2
"C1,F1",6251,6981,4440,2541,4305,2378,0,2382,1523,859,1.772991851,1407,1539,267,122,121,1,47,1,0.05785124,0,empty,CD-0722-2
"C1,F2",535829,631704,392286,239418,364446,207239,3,207433,166166,41267,4.026607216,123818,107858,15138,5896,5785,111,1147,8,0.057735523,0,hg38,CD-0722-2
"C1,F3",8507,9596,6147,3449,5764,3164,0,3164,2108,1056,1.996212121,1812,2440,671,269,262,7,67,2,0.064885496,0,empty,CD-0722-2
"C1,F4",6494,7199,4866,2333,4299,2284,0,2286,1495,791,1.890012642,1251,783,138,51,51,0,25,0,0,0,empty,CD-0722-2
"C1,F5",5768,6566,4180,2386,4090,2232,0,2233,1516,717,2.114365411,1278,1887,629,234,232,2,61,1,0.077586207,0,empty,CD-0722-2
"C1,F6",5475,6312,3917,2395,3661,2096,0,2096,1327,769,1.725617685,1204,2539,572,253,251,2,62,1,0.091633466,0,empty,CD-0722-2
"C1,F7",5722,6398,4234,2164,3857,2068,0,2074,1280,794,1.61209068,1167,813,100,41,39,2,20,1,0.179487179,0,empty,CD-0722-2
"C1,F8",568197,693739,411693,282046,400328,240273,3,240442,191283,49159,3.891108444,145531,5559,1086,438,430,8,110,2,0.027906977,0,hg38,CD-0722-2
"C1,F9",4668,5240,3507,1733,3201,1662,0,1662,1161,501,2.317365269,926,2786,728,317,312,5,73,2,0.173076923,0,empty,CD-0722-2
"C1,F10",549323,626296,414867,211429,359394,189711,0,189872,147694,42178,3.501683342,108499,108469,15539,5940,5815,125,1007,5,0.048323302,0,hg38,CD-0722-2
"C1,F11",4590,4954,3485,1469,3010,1554,0,1554,1035,519,1.994219653,833,1229,352,134,134,0,39,0,0.194029851,0,empty,CD-0722-2
"C1,F12",5233,5964,3805,2159,3506,1882,0,1886,1299,587,2.212947189,1104,225,45,25,25,0,12,0,0.04,0,empty,CD-0722-2
"C1,G1",521099,620068,382032,238036,358247,206768,1,206927,163027,43900,3.713599089,122800,143156,19900,7118,6951,167,1283,7,0.02675874,0,hg38,CD-0722-2
"C1,G2",3665,4107,2577,1530,2504,1404,0,1407,883,524,1.685114504,834,675,212,82,80,2,26,1,0.025,0,empty,CD-0722-2
"C1,G3",6188,6953,4516,2437,4145,2317,0,2317,1359,958,1.418580376,1304,2255,624,201,197,4,53,2,0.005076142,0,empty,CD-0722-2
"C1,G4",11306,13187,7971,5216,7962,4828,0,4832,2959,1873,1.579818473,2856,108,12,8,8,0,7,0,0.125,0,empty,CD-0722-2
"C1,G5",3878,4236,2808,1428,2528,1362,0,1368,925,443,2.088036117,738,1360,248,135,133,2,50,1,0.067669173,0,empty,CD-0722-2
"C1,G6",5396,5980,4029,1951,3595,1958,0,1960,1274,686,1.857142857,1065,151,39,16,16,0,3,0,0,0,empty,CD-0722-2
"C1,G7",4097,4459,3042,1417,2732,1417,0,1420,914,506,1.806324111,799,2671,881,292,292,0,65,0,0.123287671,0,empty,CD-0722-2
"C1,G8",3297,3637,2361,1276,2304,1242,0,1248,847,401,2.112219451,719,1319,378,161,160,1,44,1,0.14375,0,empty,CD-0722-2
"C1,G9",3677,4134,2688,1446,2474,1319,0,1323,850,473,1.797040169,757,1945,340,159,155,4,46,2,0.04516129,0,empty,CD-0722-2
"C1,G10",4480,5154,3340,1814,3108,1709,0,1713,1072,641,1.672386895,978,2100,566,234,232,2,71,1,0.172413793,0,empty,CD-0722-2
"C1,G11",373093,460676,258428,202248,269475,173506,2,173624,134041,39583,3.386327464,107877,2713,916,271,269,2,91,2,0.126394052,0,hg38,CD-0722-2
"C1,G12",3921,4698,2829,1869,2850,1625,0,1625,1094,531,2.060263653,997,1896,376,153,153,0,59,0,0.124183007,0,empty,CD-0722-2
"C1,H1",4181,4712,3012,1700,2840,1535,0,1537,1016,521,1.950095969,898,1023,184,99,98,1,44,1,0.020408163,0,empty,CD-0722-2
"C1,H2",767223,900877,581319,319558,515777,280748,2,280992,229359,51633,4.442100982,164012,243926,26048,10429,10132,297,1880,7,0.03661666,0,hg38,CD-0722-2
"C1,H3",3941,4592,2726,1866,2775,1575,3,1580,1043,537,1.942271881,950,1153,253,119,119,0,43,0,0.18487395,0,empty,CD-0722-2
"C1,H4",5787,6619,4341,2278,3864,2022,0,2022,1342,680,1.973529412,1126,198,64,28,28,0,16,0,0.321428571,0,empty,CD-0722-2
"C1,H5",6300,7108,4533,2575,4300,2457,0,2457,1554,903,1.720930233,1439,1633,457,196,195,1,62,1,0.025641026,0,empty,CD-0722-2
"C1,H6",4015,4575,2805,1770,2724,1521,1,1526,1031,495,2.082828283,910,1531,320,151,150,1,47,1,0.046666667,0,empty,CD-0722-2
"C1,H7",4379,4926,3296,1630,3042,1611,0,1618,1069,549,1.947176685,888,2019,449,170,168,2,60,1,0.119047619,0,empty,CD-0722-2
"C1,H8",4843,5658,3534,2124,3370,1934,0,1934,1257,677,1.856720827,1119,1799,351,180,177,3,56,2,0.09039548,0,empty,CD-0722-2
"C1,H9",554397,610439,430637,179802,347836,169243,1,169412,133642,35770,3.73614761,93022,31634,5292,2042,2014,28,426,4,0.032770606,0,hg38,CD-0722-2
"C1,H10",5164,5676,3541,2135,3770,2145,0,2148,1511,637,2.372056515,1227,1036,153,87,86,1,35,1,0.151162791,0,empty,CD-0722-2
"C1,H11",5188,6160,3597,2563,3666,2391,0,2393,1257,1136,1.106514085,1478,73,20,10,10,0,8,0,0.2,0,empty,CD-0722-2
"C1,H12",3853,4545,2777,1768,2667,1489,0,1492,1009,483,2.089026915,893,961,151,65,64,1,26,1,0.078125,0,empty,CD-0722-2
"C2,A1",3932,4549,2768,1781,2789,1616,0,1618,1039,579,1.79447323,967,1233,191,102,99,3,33,2,0.050505051,0,empty,CD-0722-2
"C2,A2",6148,7267,4509,2758,4285,2435,0,2437,1474,963,1.530633437,1446,1824,362,159,156,3,52,1,0.153846154,0,empty,CD-0722-2
"C2,A3",3578,3945,2615,1330,2413,1334,0,1334,867,467,1.856531049,737,1427,205,80,77,3,34,2,0,0,empty,CD-0722-2
"C2,A4",5941,6521,4335,2186,3901,2145,0,2148,1363,785,1.736305732,1159,949,251,71,71,0,28,0,0.056338028,0,empty,CD-0722-2
"C2,A5",5129,5850,3710,2140,3525,1899,0,1901,1191,710,1.677464789,1102,2407,660,282,281,1,89,1,0.053380783,0,empty,CD-0722-2
"C2,A6",15386,17433,11445,5988,10400,5565,0,5568,4047,1521,2.660749507,3162,2956,688,281,280,1,101,1,0.085714286,0,empty,CD-0722-2
"C2,A7",638200,758359,471295,287064,437115,252340,1,252538,195247,57291,3.407987293,148458,122019,19158,7078,6943,135,1250,6,0.037591819,0,hg38,CD-0722-2
"C2,A8",2427,2692,1799,893,1676,920,0,922,624,298,2.093959732,491,1918,418,185,185,0,48,0,0.189189189,0,empty,CD-0722-2
"C2,A9",850019,1049511,596799,452712,605045,388858,2,389117,294708,94409,3.121609169,237474,84974,14956,5851,5752,99,1057,5,0.05945758,0,hg38,CD-0722-2
"C2,A10",5357,5806,4092,1714,3500,1787,0,1789,1122,667,1.682158921,959,589,75,35,35,0,13,0,0,0,empty,CD-0722-2
"C2,A11",3655,4121,2723,1398,2500,1331,0,1334,844,490,1.72244898,745,1987,430,153,153,0,60,0,0.124183007,0,empty,CD-0722-2
"C2,A12",5407,5978,4030,1948,3516,1830,0,1833,1191,642,1.855140187,1016,3390,604,263,259,4,89,2,0.115830116,0,empty,CD-0722-2
"C2,B1",4319,5058,3161,1897,2964,1708,0,1708,1021,687,1.486171761,1010,1472,244,88,88,0,40,0,0,0,empty,CD-0722-2
"C2,B2",145015,179422,93731,85691,108172,72377,1,72427,58554,13873,4.2207165,46719,3925,1075,374,372,2,110,2,0.086021505,0,hg38,CD-0722-2
"C2,B3",863725,981329,660436,320893,560837,292700,1,292947,236547,56400,4.194095745,166411,128808,18197,7071,6930,141,1233,4,0.038816739,0,hg38,CD-0722-2
"C2,B4",4363,5042,3069,1973,3138,1893,0,1894,1185,709,1.671368124,1139,1357,357,138,137,1,34,1,0.102189781,0,empty,CD-0722-2
"C2,B5",4479,2566,1592,974,1861,1007,0,1010,676,334,2.023952096,645,1019,209,108,108,0,43,0,0.037037037,0,empty,CD-0722-2
"C2,B6",4846,5717,3312,2405,3412,2052,0,2052,1325,727,1.822558459,1288,2147,577,200,198,2,54,1,0.156565657,0,empty,CD-0722-2
"C2,B7",4277,4725,3106,1619,2829,1552,0,1552,1042,510,2.043137255,848,1070,248,92,92,0,35,0,0.02173913,0,empty,CD-0722-2
"C2,B8",3155,3679,2377,1302,2187,1172,0,1172,783,389,2.01285347,668,1109,310,146,145,1,59,1,0.006896552,0,empty,CD-0722-2
"C2,B9",6395,7320,4657,2663,4414,2566,0,2574,1610,964,1.670124481,1470,1702,535,224,219,5,62,3,0.127853881,0,empty,CD-0722-2
"C2,B10",2833,3107,2002,1105,1925,1037,0,1037,652,385,1.693506494,637,784,230,58,58,0,14,0,0,0,empty,CD-0722-2
"C2,B11",7653,8918,5390,3528,5237,3124,0,3126,1727,1399,1.234453181,1837,327,17,12,12,0,9,0,0.083333333,0,empty,CD-0722-2
"C2,B12",3961,4570,2870,1700,2638,1442,0,1442,926,516,1.794573643,818,1815,355,137,137,0,39,0,0,0,empty,CD-0722-2
"C2,C1",7894,8639,5830,2809,5003,2662,0,2664,1708,956,1.786610879,1458,1374,387,158,155,3,31,3,0.070967742,0,empty,CD-0722-2
"C2,C2",6238,7170,4403,2767,4262,2430,0,2436,1523,913,1.668127054,1424,2206,490,207,205,2,63,2,0.063414634,0,empty,CD-0722-2
"C2,C3",6425,7145,4687,2458,4317,2390,0,2391,1551,840,1.846428571,1308,942,140,81,81,0,42,0,0.012345679,0,empty,CD-0722-2
"C2,C4",3940,4361,2957,1404,2686,1391,0,1391,976,415,2.351807229,773,1942,487,218,215,3,59,2,0.037209302,0,empty,CD-0722-2
"C2,C5",5667,6333,4135,2198,3863,2080,0,2080,1387,693,2.001443001,1186,2010,484,183,180,3,70,2,0.022222222,0,empty,CD-0722-2
"C2,C6",5323,5962,3838,2124,3624,1998,0,2004,1347,657,2.050228311,1147,1822,474,208,205,3,52,1,0.014634146,0,empty,CD-0722-2
"C2,C7",7132,8343,4941,3402,4934,2990,0,2991,1738,1253,1.38707103,1795,452,98,43,41,2,17,2,0,0,empty,CD-0722-2
"C2,C8",504568,569144,383198,185946,329018,168485,1,168648,120098,48550,2.473697219,96801,83471,13031,5032,4929,103,913,4,0.030837898,0,hg38,CD-0722-2
"C2,C9",5313,6100,3897,2203,3560,1942,0,1942,1248,694,1.798270893,1081,1689,401,142,139,3,42,2,0.050359712,0,empty,CD-0722-2
"C2,C10",5978,6662,4377,2285,3962,2138,0,2140,1369,771,1.775616083,1217,2274,551,205,204,1,56,1,0.019607843,0,empty,CD-0722-2
"C2,C11",5397,6134,3870,2264,3675,2081,0,2082,1348,734,1.836512262,1180,2249,453,174,173,1,57,1,0.086705202,0,empty,CD-0722-2
"C2,C12",7157,8072,5247,2825,4793,2535,0,2538,1640,898,1.826280624,1452,2198,516,171,169,2,57,2,0.00591716,0,empty,CD-0722-2
"C2,D1",6493,7734,4643,3091,4535,2711,0,2711,1603,1108,1.446750903,1572,980,156,66,62,4,27,2,0.080645161,0,empty,CD-0722-2
"C2,D2",5131,5766,3877,1889,3485,1829,0,1832,1173,659,1.779969651,1040,3585,874,354,347,7,104,2,0.054755043,0,empty,CD-0722-2
"C2,D3",4943,5639,3555,2084,3270,1852,0,1854,1222,632,1.933544304,1040,1752,247,100,96,4,43,2,0.041666667,0,empty,CD-0722-2
"C2,D4",3901,4346,2894,1452,2533,1346,0,1346,893,453,1.971302428,760,1513,240,108,108,0,41,0,0.046296296,0,empty,CD-0722-2
"C2,D5",4156,4659,3040,1619,2801,1490,0,1490,1008,482,2.091286307,832,1558,186,116,115,1,60,1,0.060869565,0,empty,CD-0722-2
"C2,D6",6698,7531,4618,2913,4628,2772,0,2775,1651,1124,1.46886121,1678,2251,524,195,190,5,71,2,0.042105263,0,empty,CD-0722-2
"C2,D7",3467,3868,2563,1305,2334,1238,0,1238,844,394,2.14213198,681,2259,556,202,195,7,72,2,0.051282051,0,empty,CD-0722-2
"C2,D8",4420,4969,3212,1757,3000,1581,0,1581,1076,505,2.130693069,933,1449,274,120,119,1,52,1,0.033613445,0,empty,CD-0722-2
"C2,D9",2282,2515,1688,827,1543,785,0,785,524,261,2.007662835,447,1816,386,148,148,0,45,0,0.013513514,0,empty,CD-0722-2
"C2,D10",4694,5367,3426,1941,3215,1852,0,1857,1200,657,1.826484018,1036,1173,359,135,134,1,34,1,0.074626866,0,empty,CD-0722-2
"C2,D11",4836,5287,3563,1724,3199,1669,0,1669,1127,542,2.079335793,941,2962,741,335,329,6,114,2,0.124620061,0,empty,CD-0722-2
"C2,D12",5996,6621,4355,2266,4018,2156,0,2168,1377,791,1.740834387,1209,4423,1386,436,433,3,122,2,0.096997691,0,empty,CD-0722-2
"C2,E1",617035,699305,466998,232307,398965,207266,2,207480,166785,40695,4.098415039,117221,174760,28859,11098,10894,204,1743,4,0.066458601,0,hg38,CD-0722-2
"C2,E2",5151,5723,3748,1975,3442,1892,0,1892,1205,687,1.754002911,1059,1832,406,173,170,3,53,2,0.052941176,0,empty,CD-0722-2
"C2,E3",3571,3963,2696,1267,2409,1283,0,1283,811,472,1.718220339,701,2447,788,271,267,4,73,2,0.183520599,0,empty,CD-0722-2
"C2,E4",4714,5430,3413,2017,3168,1761,0,1761,1126,635,1.773228346,1035,2910,581,269,266,3,85,2,0.082706767,0,empty,CD-0722-2
"C2,E5",4368,4903,3231,1672,2917,1555,0,1555,1041,514,2.025291829,864,1659,411,178,175,3,57,1,0.034285714,0,empty,CD-0722-2
"C2,E6",977335,1070968,758793,312175,603362,290289,4,290563,232283,58280,3.985638298,158597,285290,48990,18986,18653,333,2487,10,0.056880931,0,hg38,CD-0722-2
"C2,E7",979250,1139107,726166,412941,646191,360543,2,360841,282146,78695,3.585310376,211371,128978,23757,8942,8795,147,1609,5,0.058101194,0,hg38,CD-0722-2
"C2,E8",5681,6485,4273,2212,3774,1993,0,1995,1259,736,1.710597826,1081,2609,609,269,265,4,75,2,0.147169811,0,empty,CD-0722-2
"C2,E9",3989,4516,3013,1503,2633,1437,0,1438,1015,423,2.399527187,798,2494,562,228,219,9,72,2,0.068493151,0,empty,CD-0722-2
"C2,E10",4185,4639,3120,1519,2677,1401,0,1402,905,497,1.820925553,773,1886,502,188,187,1,53,1,0.165775401,0,empty,CD-0722-2
"C2,E11",5041,5848,3736,2112,3432,1872,0,1873,1116,757,1.474240423,1049,2298,636,227,226,1,63,1,0.044247788,0,empty,CD-0722-2
"C2,E12",453810,570062,305767,264295,335202,230816,0,230954,163890,67064,2.443785041,145031,4069,753,255,242,13,82,2,0.061983471,0,hg38,CD-0722-2
"C2,F1",6582,7623,4744,2879,4574,2578,0,2582,1644,938,1.752665245,1541,2835,611,231,228,3,77,2,0.078947368,0,empty,CD-0722-2
"C2,F2",4779,5447,3415,2032,3333,1848,0,1852,1262,590,2.138983051,1100,2870,557,246,239,7,84,2,0.133891213,0,empty,CD-0722-2
"C2,F3",484998,549493,368274,181219,318651,164278,0,164429,120612,43817,2.752630258,94510,130054,13706,5376,5214,162,1030,4,0.047372459,0,hg38,CD-0722-2
"C2,F4",6847,7573,4987,2586,4577,2457,0,2457,1635,822,1.989051095,1372,937,189,83,74,9,31,2,0,0,empty,CD-0722-2
"C2,F5",5821,6629,4264,2365,3836,2019,0,2021,1327,694,1.912103746,1169,2778,639,242,238,4,93,2,0.029411765,0,empty,CD-0722-2
"C2,F6",6063,7002,4296,2706,4245,2359,1,2363,1453,910,1.596703297,1433,2278,564,214,213,1,64,1,0.084507042,0,empty,CD-0722-2
"C2,F7",6340,7067,4679,2388,4285,2306,0,2308,1479,829,1.784077201,1327,1245,351,148,148,0,40,0,0.013513514,0,empty,CD-0722-2
"C2,F8",4714,5285,3517,1768,3231,1716,0,1716,1160,556,2.086330935,967,483,87,39,39,0,23,0,0.076923077,0,empty,CD-0722-2
"C2,F9",5316,6191,3938,2253,3643,1939,0,1939,1295,644,2.010869565,1128,3091,631,241,235,6,73,2,0.080851064,0,empty,CD-0722-2
"C2,F10",6191,6897,4638,2259,4211,2243,0,2243,1462,781,1.871959027,1217,1969,551,212,210,2,63,1,0.052380952,0,empty,CD-0722-2
"C2,F11",5414,6050,4039,2011,3598,1803,0,1803,1159,644,1.799689441,1040,1874,440,163,160,3,43,2,0.18125,0,empty,CD-0722-2
"C2,F12",5741,6466,4181,2285,3818,2092,0,2092,1317,775,1.699354839,1192,242,42,27,27,0,19,0,0,0,empty,CD-0722-2
"C2,G1",5896,6692,4347,2345,4005,2138,0,2140,1390,750,1.853333333,1200,3791,946,390,386,4,105,3,0.095854922,0,empty,CD-0722-2
"C2,G2",3623,4106,2531,1575,2534,1475,0,1475,995,480,2.072916667,891,671,134,33,33,0,21,0,0,0,empty,CD-0722-2
"C2,G3",6650,7218,4882,2336,4383,2446,0,2453,1496,957,1.563218391,1309,2446,771,298,295,3,77,2,0.084745763,0,empty,CD-0722-2
"C2,G4",686393,775219,526744,248475,443835,224224,2,224437,174842,49595,3.525395705,126491,1830,242,115,112,3,30,2,0.196428571,0,hg38,CD-0722-2
"C2,G5",4148,4589,3061,1528,2677,1419,0,1421,941,480,1.960416667,767,1604,296,132,131,1,55,1,0.053435115,0,empty,CD-0722-2
"C2,G6",5874,6597,4363,2234,3848,2036,0,2039,1370,669,2.047832586,1138,230,19,18,17,1,14,1,0.117647059,0,empty,CD-0722-2
"C2,G7",4688,5113,3453,1660,3110,1650,0,1653,1078,575,1.874782609,911,2708,809,298,288,10,64,2,0.111111111,0,empty,CD-0722-2
"C2,G8",3411,3817,2481,1336,2262,1254,0,1256,798,458,1.742358079,693,1882,426,169,166,3,61,2,0.030120482,0,empty,CD-0722-2
"C2,G9",4086,4605,2981,1624,2756,1507,0,1507,1006,501,2.007984032,851,2476,593,217,216,1,71,1,0.046296296,0,empty,CD-0722-2
"C2,G10",5080,5744,3642,2102,3545,2012,0,2014,1274,740,1.721621622,1181,2358,717,276,276,0,97,0,0.079710145,0,empty,CD-0722-2
"C2,G11",4929,5578,3603,1975,3293,1769,0,1772,1080,692,1.560693642,1001,1419,363,148,148,0,48,0,0.094594595,0,empty,CD-0722-2
"C2,G12",509624,587258,384025,203233,344844,182167,0,182273,137685,44588,3.087938459,106612,151231,27643,10664,10488,176,1586,7,0.048245614,0,hg38,CD-0722-2
"C2,H1",479052,562595,351300,211295,326147,182333,4,182491,140371,42120,3.332644824,108823,77655,11512,4246,4181,65,859,4,0.028701268,0,hg38,CD-0722-2
"C2,H2",7507,8783,5409,3374,5395,3056,0,3058,2193,865,2.535260116,1859,3034,632,249,245,4,82,2,0.06122449,0,empty,CD-0722-2
"C2,H3",4304,4852,3183,1669,2921,1603,0,1604,1042,562,1.854092527,888,1727,403,178,175,3,64,2,0.074285714,0,empty,CD-0722-2
"C2,H4",6180,7014,4442,2572,4144,2307,0,2308,1487,821,1.811205847,1386,212,23,15,15,0,11,0,0,0,empty,CD-0722-2
"C2,H5",647538,765752,474160,291592,439480,249305,2,249485,214425,35060,6.115944096,149535,100772,19784,7708,7610,98,1324,6,0.044678055,0,hg38,CD-0722-2
"C2,H6",4275,4823,3113,1710,2842,1557,0,1558,1010,548,1.843065693,862,2666,699,223,218,5,67,2,0.059633028,0,empty,CD-0722-2
"C2,H7",4893,5470,3610,1860,3280,1699,0,1702,1104,598,1.846153846,967,2229,524,193,190,3,72,1,0.031578947,0,empty,CD-0722-2
"C2,H8",5358,6256,3898,2358,3640,2038,0,2040,1254,786,1.595419847,1203,2512,413,188,186,2,76,2,0.037634409,0,empty,CD-0722-2
"C2,H9",620211,739992,451508,288484,425089,249160,0,249329,194234,55095,3.52543788,149602,90284,16785,6248,6150,98,1171,5,0.040162602,0,hg38,CD-0722-2
"C2,H10",4722,5247,3425,1822,3232,1722,0,1725,1061,664,1.597891566,979,2408,497,184,182,2,75,1,0.06043956,0,empty,CD-0722-2
"C2,H11",5422,6548,3656,2892,4012,2609,0,2610,1441,1169,1.232677502,1658,88,7,5,4,1,3,1,0.25,0,empty,CD-0722-2
"C2,H12",4316,5022,3062,1960,2967,1721,0,1723,1160,563,2.060390764,1014,1234,165,74,73,1,32,1,0.178082192,0,empty,CD-0722-2
"C3,A1",3435,3885,2519,1366,2388,1377,0,1378,854,524,1.629770992,778,1374,316,140,139,1,40,1,0.086330935,0,empty,CD-0722-2
"C3,A2",5395,6059,3965,2094,3611,1991,0,1993,1250,743,1.682368775,1100,2206,578,229,227,2,78,1,0.207048458,0,empty,CD-0722-2
"C3,A3",391432,445781,295809,149972,256543,132874,0,132981,103539,29442,3.516710821,76733,89285,14025,5414,5289,125,993,6,0.036112687,0,hg38,CD-0722-2
"C3,A4",5675,6390,4214,2176,3850,2082,0,2085,1304,781,1.669654289,1206,1050,230,109,106,3,36,1,0.122641509,0,empty,CD-0722-2
"C3,A5",4520,5205,3302,1903,3098,1680,0,1680,1057,623,1.696629213,1005,2377,451,188,187,1,67,1,0.171122995,0,empty,CD-0722-2
"C3,A6",3878,4530,2815,1715,2701,1527,0,1527,980,547,1.791590494,910,2683,612,253,250,3,99,2,0.136,0,empty,CD-0722-2
"C3,A7",460599,543456,343589,199867,312506,172947,1,173098,139757,33341,4.191745898,101810,121839,13960,5655,5521,134,1083,9,0.043289259,0,hg38,CD-0722-2
"C3,A8",2002,2390,1456,934,1437,772,0,772,507,265,1.913207547,455,2424,628,257,254,3,74,3,0,0,empty,CD-0722-2
"C3,A9",3440,3928,2548,1380,2350,1305,0,1305,811,494,1.641700405,747,1787,253,122,116,6,52,1,0.094827586,0,empty,CD-0722-2
"C3,A10",4409,5042,3275,1767,2992,1641,0,1644,1014,630,1.60952381,916,458,98,50,49,1,27,1,0,0,empty,CD-0722-2
"C3,A11",2963,3468,2206,1262,2045,1080,0,1082,717,365,1.964383562,602,1545,389,189,186,3,64,2,0.037634409,0,empty,CD-0722-2
"C3,A12",4430,4889,3377,1512,2909,1492,0,1492,983,509,1.931237721,814,3514,832,378,367,11,118,2,0.073569482,0,empty,CD-0722-2
"C3,B1",3759,4213,2668,1545,2609,1510,0,1510,903,607,1.487644152,887,1265,284,136,134,2,61,2,0.014925373,0,empty,CD-0722-2
"C3,B2",3011751,3910094,1910966,1999128,2300465,1732051,5,1733030,1255466,477564,2.628895813,1125644,19650,2957,994,970,24,322,4,0.029896907,0,hg38,CD-0722-2
"C3,B3",3138,3693,2241,1452,2161,1236,0,1238,805,433,1.859122402,745,1711,346,167,163,4,71,2,0.165644172,0,empty,CD-0722-2
"C3,B4",3745,4306,2643,1663,2572,1519,0,1524,991,533,1.859287054,883,1437,331,149,148,1,54,1,0.135135135,0,empty,CD-0722-2
"C3,B5",448578,264910,163622,101288,188774,102799,4,103352,81035,22317,3.631088408,64615,61479,9782,3522,3458,64,651,3,0.037593985,0,hg38,CD-0722-2
"C3,B6",3918,4578,2823,1755,2844,1718,0,1721,1035,686,1.508746356,1007,1534,430,206,199,7,60,1,0.055276382,0,empty,CD-0722-2
"C3,B7",3588,4257,2612,1645,2473,1380,1,1381,865,516,1.676356589,782,1500,342,139,138,1,36,1,0.268115942,0,empty,CD-0722-2
"C3,B8",2701,3055,2003,1052,1837,1036,0,1037,670,367,1.825613079,569,1334,308,125,122,3,58,2,0.147540984,0,empty,CD-0722-2
"C3,B9",401131,456561,303686,152875,261712,135134,0,135249,104043,31206,3.334070371,77411,41433,4380,1758,1722,36,398,3,0.029616725,0,hg38,CD-0722-2
"C3,B10",2390,2652,1650,1002,1682,930,0,933,604,329,1.835866261,563,672,94,44,44,0,17,0,0,0,empty,CD-0722-2
"C3,B11",6203,7446,4310,3136,4379,2619,0,2621,1446,1175,1.230638298,1601,441,75,29,29,0,21,0,0.103448276,0,empty,CD-0722-2
"C3,B12",3277,3807,2343,1464,2276,1261,0,1262,849,413,2.055690073,744,2031,574,184,180,4,58,2,0.011111111,0,empty,CD-0722-2
"C3,C1",6649,7459,5008,2451,4372,2323,1,2324,1415,909,1.556655666,1293,1174,248,127,125,2,38,2,0.032,0,empty,CD-0722-2
"C3,C2",622719,748281,455866,292415,425288,248425,1,248637,194403,54234,3.584522624,148572,87210,10951,4199,4098,101,928,3,0.06124939,0,hg38,CD-0722-2
"C3,C3",5723,6385,4300,2085,3886,2077,0,2077,1285,792,1.622474747,1179,827,141,70,69,1,27,1,0.101449275,0,empty,CD-0722-2
"C3,C4",3425,4018,2499,1519,2361,1307,0,1309,887,422,2.101895735,792,1934,360,124,123,1,52,1,0.024390244,0,empty,CD-0722-2
"C3,C5",4992,5671,3637,2034,3339,1837,0,1837,1223,614,1.991856678,1034,2191,562,238,237,1,82,1,0.025316456,0,empty,CD-0722-2
"C3,C6",4614,5186,3397,1789,3128,1668,0,1669,1088,581,1.872633391,925,1344,376,149,146,3,53,2,0.02739726,0,empty,CD-0722-2
"C3,C7",6712,8087,4670,3417,4868,3056,0,3058,1915,1143,1.675415573,1899,485,88,35,34,1,22,1,0,0,empty,CD-0722-2
"C3,C8",505295,605734,367277,238457,349822,203647,1,203807,167986,35821,4.689595489,122144,231044,38781,14983,14667,316,2149,9,0.072202904,0,hg38,CD-0722-2
"C3,C9",4979,5952,3702,2250,3541,2031,0,2031,1361,670,2.031343284,1185,1938,412,157,154,3,52,1,0.097402597,0,empty,CD-0722-2
"C3,C10",4984,5439,3742,1697,3257,1714,0,1716,1101,615,1.790243902,930,2351,603,294,288,6,68,2,0.076388889,0,empty,CD-0722-2
"C3,C11",4456,4904,3244,1660,2927,1591,0,1596,1004,592,1.695945946,859,1825,473,205,204,1,67,1,0.098039216,0,empty,CD-0722-2
"C3,C12",6694,7299,4959,2340,4418,2299,0,2301,1557,744,2.092741935,1241,1909,426,166,164,2,70,2,0.048780488,0,empty,CD-0722-2
"C3,D1",5440,6363,3927,2436,3902,2252,0,2252,1411,841,1.677764566,1308,884,239,83,83,0,35,0,0.012048193,0,empty,CD-0722-2
"C3,D2",548873,617154,415261,201893,352108,180945,1,181100,143539,37561,3.821490376,101664,216162,35318,13646,13407,239,2117,7,0.036175132,0,hg38,CD-0722-2
"C3,D3",3927,4293,2882,1411,2596,1434,0,1434,918,516,1.779069767,790,1893,371,186,186,0,68,0,0.016129032,0,empty,CD-0722-2
"C3,D4",4393,5046,3225,1821,3006,1632,0,1633,1128,505,2.233663366,936,1310,190,110,108,2,55,2,0.064814815,0,empty,CD-0722-2
"C3,D5",3605,4045,2611,1434,2434,1339,0,1339,861,478,1.80125523,745,1789,279,130,129,1,67,1,0.085271318,0,empty,CD-0722-2
"C3,D6",6009,6820,4164,2656,4099,2484,0,2488,1481,1007,1.470705065,1444,2166,333,162,161,1,66,1,0.00621118,0,empty,CD-0722-2
"C3,D7",3142,3559,2325,1234,2121,1150,0,1150,706,444,1.59009009,677,2666,452,209,203,6,92,2,0.039408867,0,empty,CD-0722-2
"C3,D8",3794,4299,2802,1497,2600,1384,0,1384,904,480,1.883333333,807,1626,419,178,176,2,63,2,0.068181818,0,empty,CD-0722-2
"C3,D9",261519,304466,190218,114248,176556,99234,0,99328,78861,20467,3.853080569,58836,116767,24881,9209,9094,115,1402,5,0.046844073,0,hg38,CD-0722-2
"C3,D10",210004,196954,187005,9949,113194,16702,2,16728,11956,4772,2.505448449,4425,1356,242,119,115,4,35,2,0.034782609,0,empty,CD-0722-2
"C3,D11",4174,4709,3060,1649,2836,1529,0,1537,982,555,1.769369369,908,2781,675,294,292,2,110,1,0.051369863,0,empty,CD-0722-2
"C3,D12",5340,6059,3968,2091,3646,2008,0,2008,1342,666,2.015015015,1135,3136,631,310,307,3,144,2,0.039087948,0,empty,CD-0722-2
"C3,E1",429984,471477,331523,139954,270229,129311,1,129437,90919,38518,2.36042889,71888,65996,9766,3777,3690,87,768,3,0.041192412,0,hg38,CD-0722-2
"C3,E2",4691,5502,3345,2157,3215,1820,0,1828,1117,711,1.571026723,1099,1727,419,172,171,1,64,1,0.14619883,0,empty,CD-0722-2
"C3,E3",3180,3588,2366,1222,2140,1176,0,1177,777,400,1.9425,659,1990,315,162,160,2,64,2,0.09375,0,empty,CD-0722-2
"C3,E4",4328,5146,3057,2089,2994,1687,0,1687,1081,606,1.783828383,1074,2645,556,276,273,3,105,2,0.043956044,0,empty,CD-0722-2
"C3,E5",543443,617092,412343,204749,353932,185570,2,185730,148551,37179,3.995562011,104753,101240,12095,4488,4361,127,951,4,0.023618436,0,hg38,CD-0722-2
"C3,E6",416891,453629,325701,127928,257887,121934,0,122065,93919,28146,3.336850707,65825,49950,9697,3511,3455,56,662,5,0.026049204,0,hg38,CD-0722-2
"C3,E7",5695,6604,4223,2381,3926,2072,0,2075,1355,720,1.881944444,1175,2861,865,299,295,4,121,2,0.027118644,0,empty,CD-0722-2
"C3,E8",5027,5732,3754,1978,3409,1822,0,1830,1198,632,1.89556962,1014,2991,749,323,320,3,86,2,0.1,0,empty,CD-0722-2
"C3,E9",3184,3674,2361,1313,2191,1184,0,1187,781,406,1.92364532,662,2410,543,253,251,2,91,2,0.099601594,0,empty,CD-0722-2
"C3,E10",3621,4145,2660,1485,2502,1314,0,1316,816,500,1.632,772,1710,305,131,131,0,57,0,0.038167939,0,empty,CD-0722-2
"C3,E11",4500,4798,3325,1473,2877,1561,0,1561,947,614,1.542345277,829,2112,405,161,159,2,64,2,0.106918239,0,empty,CD-0722-2
"C3,E12",5021,5904,3600,2304,3479,1959,0,1959,1250,709,1.763046544,1196,1962,358,167,166,1,81,1,0.06626506,0,empty,CD-0722-2
"C3,F1",5678,6409,4070,2339,3927,2194,0,2194,1353,841,1.608799049,1308,2313,448,219,217,2,93,2,0.059907834,0,empty,CD-0722-2
"C3,F2",4522,5140,3251,1889,3056,1667,0,1670,1123,547,2.053016453,966,2780,857,321,318,3,94,2,0.141509434,0,empty,CD-0722-2
"C3,F3",4109,4704,2961,1743,2785,1495,0,1500,956,544,1.757352941,871,2738,600,273,272,1,94,1,0.0625,0,empty,CD-0722-2
"C3,F4",7067,7914,5230,2684,4704,2478,1,2479,1663,816,2.037990196,1384,915,163,87,85,2,54,2,0.023529412,0,empty,CD-0722-2
"C3,F5",623657,705538,472366,233172,398916,208930,0,209145,171278,37867,4.523146803,118680,192525,24808,10138,9915,223,1644,6,0.075441251,0,hg38,CD-0722-2
"C3,F6",5031,5498,3687,1811,3275,1767,0,1772,1133,639,1.773082942,981,3013,939,341,339,2,93,1,0.056047198,0,empty,CD-0722-2
"C3,F7",486061,539615,376954,162661,310457,148947,5,149120,118745,30375,3.909300412,81716,58596,7625,2614,2522,92,565,5,0.139571768,0,hg38,CD-0722-2
"C3,F8",3964,4614,2913,1701,2752,1495,0,1499,965,534,1.807116105,853,516,84,52,52,0,33,0,0,0,empty,CD-0722-2
"C3,F9",583284,692092,425984,266108,397771,229740,1,229906,179587,50319,3.568969972,137159,168409,25109,9696,9514,182,1601,8,0.064221148,0,hg38,CD-0722-2
"C3,F10",5853,6456,4343,2113,3851,2016,0,2021,1304,717,1.818688982,1145,1863,460,180,175,5,59,2,0.011428571,0,empty,CD-0722-2
"C3,F11",4273,4828,3212,1616,2832,1440,0,1440,942,498,1.891566265,810,1474,236,118,116,2,53,1,0.112068966,0,empty,CD-0722-2
"C3,F12",4843,5491,3478,2013,3260,1746,0,1751,1141,610,1.870491803,1042,341,52,36,36,0,18,0,0,0,empty,CD-0722-2
"C3,G1",494356,558221,380969,177252,321401,159842,1,160012,126284,33728,3.744188805,89847,112005,24041,8656,8530,126,1377,6,0.021922626,0,hg38,CD-0722-2
"C3,G2",3652,4341,2451,1890,2635,1643,0,1643,1125,518,2.171814672,1053,837,189,94,93,1,46,1,0.010752688,0,empty,CD-0722-2
"C3,G3",7203,7956,5359,2597,4735,2547,0,2547,1632,915,1.783606557,1370,2150,507,245,240,5,92,1,0.0375,0,empty,CD-0722-2
"C3,G4",11048,13017,7645,5372,7788,4762,0,4768,2910,1858,1.566200215,2879,216,36,24,24,0,18,0,0,0,empty,CD-0722-2
"C3,G5",3654,4165,2636,1529,2435,1348,0,1348,852,496,1.717741935,788,1944,435,211,210,1,74,1,0.204761905,0,empty,CD-0722-2
"C3,G6",5237,5952,3837,2115,3525,1878,0,1882,1184,698,1.696275072,1088,254,56,35,34,1,17,1,0,0,empty,CD-0722-2
"C3,G7",542985,658361,393748,264613,382585,229244,1,229386,182217,47169,3.863066845,138836,33597,5924,2178,2153,25,604,5,0.033441709,0,hg38,CD-0722-2
"C3,G8",387069,429281,297607,131674,247199,120877,0,120992,97491,23501,4.148376665,67277,50376,10648,4031,3955,76,725,6,0.029582807,0,hg38,CD-0722-2
"C3,G9",3596,4108,2669,1439,2473,1368,0,1368,903,465,1.941935484,786,2413,492,225,221,4,89,2,0.07239819,0,empty,CD-0722-2
"C3,G10",4237,4779,3116,1663,2936,1651,0,1651,1099,552,1.990942029,939,2814,593,269,267,2,94,1,0.056179775,0,empty,CD-0722-2
"C3,G11",4434,4893,3344,1549,2919,1541,1,1545,976,569,1.715289982,846,1546,408,162,158,4,61,1,0.063291139,0,empty,CD-0722-2
"C3,G12",3851,4464,2818,1646,2656,1498,0,1498,931,567,1.641975309,859,2825,845,337,334,3,114,1,0.032934132,0,empty,CD-0722-2
"C3,H1",4423,4827,3286,1541,2913,1508,0,1511,1053,458,2.299126638,832,1727,409,185,180,5,75,1,0.038888889,0,empty,CD-0722-2
"C3,H2",4824,5611,3436,2175,3377,1906,0,1908,1118,790,1.415189873,1160,2486,532,214,212,2,82,1,0.113207547,0,empty,CD-0722-2
"C3,H3",1480330,1728931,1095337,633594,970639,544765,1,545218,436364,108854,4.008708913,323057,406434,53674,20627,20132,495,2866,8,0.047585933,0,hg38,CD-0722-2
"C3,H4",5571,6490,4094,2396,3759,2104,0,2104,1408,696,2.022988506,1196,274,51,35,35,0,23,0,0.114285714,0,empty,CD-0722-2
"C3,H5",6611,7801,4780,3021,4652,2718,0,2718,1827,891,2.050505051,1613,2545,454,223,219,4,87,2,0.03652968,0,empty,CD-0722-2
"C3,H6",3439,4109,2487,1622,2487,1424,0,1424,935,489,1.91206544,878,2060,437,209,205,4,84,2,0.082926829,0,empty,CD-0722-2
"C3,H7",1898394,2286033,1364648,921385,1297586,784600,27,785235,644158,141077,4.566002963,476235,622523,103848,40549,39829,720,4297,11,0.068994953,0,hg38,CD-0722-2
"C3,H8",4492,4870,3256,1614,2935,1636,0,1636,1098,538,2.040892193,917,2221,416,171,167,4,76,2,0.02994012,0,empty,CD-0722-2
"C3,H9",3638,4019,2705,1314,2422,1282,0,1282,875,407,2.14987715,722,1186,288,148,146,2,58,2,0.061643836,0,empty,CD-0722-2
"C3,H10",3427,3857,2495,1362,2297,1172,0,1174,788,386,2.041450777,674,1483,268,158,156,2,61,2,0.115384615,0,empty,CD-0722-2
"C3,H11",4901,5775,3312,2463,3368,2214,0,2216,1249,967,1.291623578,1344,85,14,9,9,0,7,0,0,0,empty,CD-0722-2
"C3,H12",3424,3787,2502,1285,2206,1195,0,1195,828,367,2.25613079,616,1757,375,177,176,1,61,1,0.176136364,0,empty,CD-0722-2
"C4,A1",4458,5136,3129,2007,3103,1801,0,1805,1222,583,2.096054889,1072,1359,199,113,112,1,30,1,0.276785714,0,empty,CD-0722-2
"C4,A2",6410,7073,4575,2498,4281,2337,0,2344,1466,878,1.669703872,1321,2408,470,172,170,2,50,1,0.035294118,0,empty,CD-0722-2
"C4,A3",449206,524132,330348,193784,303225,169837,0,169955,132659,37296,3.556922994,100174,133634,19435,7625,7490,135,1249,8,0.033244326,0,hg38,CD-0722-2
"C4,A4",6842,7866,5139,2727,4691,2548,0,2550,1649,901,1.830188679,1441,842,179,85,85,0,35,0,0,0,empty,CD-0722-2
"C4,A5",5510,6364,4068,2296,3789,2033,0,2039,1291,748,1.725935829,1174,2404,595,219,218,1,64,1,0.041284404,0,empty,CD-0722-2
"C4,A6",1279685,1565919,956548,609371,887301,519061,1,519445,427680,91765,4.660600447,309492,399306,62742,24614,24145,469,3091,8,0.053137296,0,hg38,CD-0722-2
"C4,A7",4186,4813,3074,1739,2921,1645,0,1645,1076,569,1.891036907,943,1422,336,178,178,0,52,0,0.123595506,0,empty,CD-0722-2
"C4,A8",2542,2967,1863,1104,1762,947,0,947,646,301,2.146179402,541,1642,380,183,181,2,58,2,0.116022099,0,empty,CD-0722-2
"C4,A9",4648,5368,3434,1934,3132,1712,0,1714,1157,557,2.077199282,1015,1971,323,143,141,2,51,1,0.056737589,0,empty,CD-0722-2
"C4,A10",5780,6326,4350,1976,3797,1963,0,1970,1218,752,1.619680851,1038,513,152,75,75,0,19,0,0.013333333,0,empty,CD-0722-2
"C4,A11",4028,4479,3039,1440,2659,1334,0,1336,885,451,1.962305987,726,2217,531,210,209,1,68,1,0.019138756,0,empty,CD-0722-2
"C4,A12",5960,6732,4411,2321,3922,2107,0,2110,1382,728,1.898351648,1212,3358,726,299,291,8,91,2,0.065292096,0,empty,CD-0722-2
"C4,B1",4908,5508,3589,1919,3301,1862,0,1864,1161,703,1.651493599,1019,1354,339,119,109,10,37,3,0.091743119,0,empty,CD-0722-2
"C4,B2",5162,5767,3514,2253,3386,1998,0,1998,1276,722,1.767313019,1164,601,117,45,41,4,19,2,0.024390244,0,empty,CD-0722-2
"C4,B3",444231,523354,326783,196571,304855,173455,1,173571,136624,36947,3.697837443,102968,67840,10563,4094,4019,75,786,3,0.029360537,0,hg38,CD-0722-2
"C4,B4",5255,6120,3641,2479,3784,2316,0,2318,1444,874,1.652173913,1384,1241,367,154,152,2,45,2,0.217105263,0,empty,CD-0722-2
"C4,B5",10073,9351,5197,4154,5930,3705,0,3712,2719,993,2.73816717,2352,1126,267,127,127,0,40,0,0.204724409,0,empty,CD-0722-2
"C4,B6",5511,6513,3902,2611,3920,2348,0,2352,1497,855,1.750877193,1418,1711,316,123,121,2,46,2,0.107438017,0,empty,CD-0722-2
"C4,B7",4642,5265,3502,1763,3098,1675,0,1677,1085,592,1.83277027,903,1360,428,182,180,2,52,1,0.05,0,empty,CD-0722-2
"C4,B8",463606,588938,314217,274721,349945,243622,1,243755,181069,62686,2.888507801,152229,2502,532,151,145,6,51,2,0.117241379,0,hg38,CD-0722-2
"C4,B9",7123,8160,5109,3051,4844,2754,0,2757,1734,1023,1.695014663,1619,1228,330,159,158,1,55,1,0.037974684,0,empty,CD-0722-2
"C4,B10",953481,1118706,651091,467615,663447,415021,4,415514,327588,87926,3.725723904,251027,51104,11464,4116,4048,68,775,4,0.017786561,0,hg38,CD-0722-2
"C4,B11",8122,9732,5833,3899,5806,3497,0,3503,1913,1590,1.203144654,2116,336,92,54,54,0,26,0,0,0,empty,CD-0722-2
"C4,B12",552061,683856,395238,288618,398323,241285,0,241473,197646,43827,4.50968581,149680,91568,17288,6550,6464,86,1263,4,0.058013614,0,hg38,CD-0722-2
"C4,C1",503441,553554,387277,166277,316863,154017,0,154195,126065,28130,4.481514397,84701,8995,1884,706,694,12,191,2,0.007204611,0,hg38,CD-0722-2
"C4,C2",7077,8275,5063,3212,4806,2768,0,2772,1794,978,1.834355828,1608,2081,470,207,206,1,65,1,0.101941748,0,empty,CD-0722-2
"C4,C3",6971,7980,5138,2842,4875,2689,0,2690,1763,927,1.901833873,1564,1235,283,135,135,0,39,0,0.222222222,0,empty,CD-0722-2
"C4,C4",4500,5170,3312,1858,3083,1643,0,1644,1107,537,2.061452514,926,2160,453,172,172,0,47,0,0.011627907,0,empty,CD-0722-2
"C4,C5",678055,820339,488414,331925,471995,280496,2,280727,226294,54433,4.157294288,170674,132227,23741,8948,8803,145,1554,6,0.044075883,0,hg38,CD-0722-2
"C4,C6",5480,6291,3928,2363,3841,2147,0,2147,1319,828,1.592995169,1305,1693,389,123,122,1,43,1,0.163934426,0,empty,CD-0722-2
"C4,C7",7738,9214,5475,3739,5512,3363,0,3366,2089,1277,1.635865309,2044,322,84,37,35,2,14,1,0.371428571,0,empty,CD-0722-2
"C4,C8",8430,9538,6213,3325,5701,3162,1,3168,2021,1147,1.761987794,1763,3080,518,226,220,6,109,2,0.013636364,0,empty,CD-0722-2
"C4,C9",403469,519372,271976,247396,302749,210917,0,211035,151674,59361,2.555111942,133114,25384,2253,946,915,31,221,2,0.132240437,0,hg38,CD-0722-2
"C4,C10",6466,7550,4717,2833,4424,2387,0,2389,1533,856,1.79088785,1398,1811,408,165,164,1,54,1,0.036585366,0,empty,CD-0722-2
"C4,C11",5333,6193,3960,2233,3697,1964,0,1968,1291,677,1.906942393,1119,2216,603,250,250,0,59,0,0.088,0,empty,CD-0722-2
"C4,C12",7997,9135,5915,3220,5367,2922,1,2928,1899,1029,1.84548105,1669,2317,620,243,241,2,67,1,0.033195021,0,empty,CD-0722-2
"C4,D1",670537,805854,491277,314577,463725,270735,1,270920,204822,66098,3.098762444,163221,60987,8137,3318,3253,65,604,6,0.044266831,0,hg38,CD-0722-2
"C4,D2",5594,6141,4128,2013,3717,1924,0,1927,1208,719,1.680111266,1031,2737,648,257,251,6,86,2,0.067729084,0,empty,CD-0722-2
"C4,D3",5112,5911,3641,2270,3589,2036,0,2038,1347,691,1.94934877,1171,1760,433,146,146,0,47,0,0.020547945,0,empty,CD-0722-2
"C4,D4",4123,4809,3010,1799,2757,1541,0,1541,1029,512,2.009765625,895,1215,314,109,108,1,34,1,0.027777778,0,empty,CD-0722-2
"C4,D5",686858,826299,504571,321728,473885,275137,2,275386,217765,57621,3.779264504,165484,33368,7466,2773,2754,19,694,4,0.04248366,0,hg38,CD-0722-2
"C4,D6",7200,8280,5101,3179,4892,2908,0,2912,1676,1236,1.355987055,1741,2094,485,207,205,2,70,1,0.043902439,0,empty,CD-0722-2
"C4,D7",4223,4691,3179,1512,2808,1494,0,1494,1013,481,2.106029106,804,2460,384,181,180,1,67,1,0.111111111,0,empty,CD-0722-2
"C4,D8",4821,5586,3476,2110,3322,1861,0,1861,1187,674,1.761127596,1108,1446,420,172,171,1,62,1,0.134502924,0,empty,CD-0722-2
"C4,D9",2582,2879,1945,934,1759,949,0,949,599,350,1.711428571,527,1443,302,117,113,4,35,2,0.017699115,0,empty,CD-0722-2
"C4,D10",4642,5534,3294,2240,3283,1920,0,1920,1206,714,1.68907563,1185,1415,408,159,158,1,32,1,0.037974684,0,empty,CD-0722-2
"C4,D11",5387,6183,3982,2201,3626,1912,0,1916,1269,647,1.961360124,1122,2853,640,284,283,1,105,1,0.024734982,0,empty,CD-0722-2
"C4,D12",6466,7538,4645,2893,4556,2529,0,2535,1654,881,1.877412032,1496,3632,870,410,409,1,139,1,0.036674817,0,empty,CD-0722-2
"C4,E1",8309,9418,6056,3362,5510,3055,0,3058,1824,1234,1.478119935,1712,2524,505,204,202,2,72,2,0.074257426,0,empty,CD-0722-2
"C4,E2",5726,6530,4123,2407,3952,2202,0,2206,1377,829,1.661037394,1329,2044,482,190,189,1,59,1,0.058201058,0,empty,CD-0722-2
"C4,E3",711265,866417,514527,351890,505001,317388,0,317613,232778,84835,2.743891083,190226,37415,8478,3090,3045,45,682,2,0.040722496,0,hg38,CD-0722-2
"C4,E4",484826,555508,368698,186810,319491,165895,3,166059,134511,31548,4.26369342,95489,59155,12217,4528,4460,68,853,6,0.032959641,0,hg38,CD-0722-2
"C4,E5",5971,6783,4409,2374,4034,2250,0,2255,1450,805,1.801242236,1229,1329,386,164,164,0,51,0,0.030487805,0,empty,CD-0722-2
"C4,E6",584771,658072,451180,206892,371864,185072,1,185247,146761,38486,3.813360703,103977,189800,25550,9701,9477,224,1609,7,0.044212303,0,hg38,CD-0722-2
"C4,E7",9121,10334,6667,3667,6169,3287,0,3289,2188,1101,1.987284287,1948,3444,875,339,337,2,99,2,0.077151335,0,empty,CD-0722-2
"C4,E8",1289407,1483505,977437,506068,837528,453548,1,453959,360214,93745,3.842487599,258252,217666,36751,14146,13895,251,2087,6,0.054120187,0,hg38,CD-0722-2
"C4,E9",407921,476463,304862,171601,274658,150432,0,150558,116654,33904,3.44071496,88494,167970,21096,8220,8011,209,1376,7,0.065410061,0,hg38,CD-0722-2
"C4,E10",4447,5051,3311,1740,2995,1563,0,1564,1002,562,1.782918149,886,1345,330,138,134,4,59,3,0.007462687,0,empty,CD-0722-2
"C4,E11",5558,6248,4047,2201,3805,2088,0,2095,1356,739,1.834912043,1230,2201,439,192,192,0,57,0,0.020833333,0,empty,CD-0722-2
"C4,E12",6484,7238,4675,2563,4311,2347,0,2347,1572,775,2.028387097,1344,2503,678,297,296,1,82,1,0.084459459,0,empty,CD-0722-2
"C4,F1",7065,8060,5144,2916,4881,2665,1,2673,1702,971,1.752832132,1557,2633,689,271,269,2,95,1,0.037174721,0,empty,CD-0722-2
"C4,F2",5545,6164,4019,2145,3751,2000,0,2000,1366,634,2.154574132,1140,3559,985,349,346,3,76,2,0.150289017,0,empty,CD-0722-2
"C4,F3",5119,5767,3753,2014,3459,1824,0,1826,1219,607,2.008237232,1033,3162,664,265,258,7,81,2,0.062015504,0,empty,CD-0722-2
"C4,F4",9070,9988,6678,3310,6027,3158,0,3166,2098,1068,1.964419476,1764,1297,317,118,116,2,40,1,0.043103448,0,empty,CD-0722-2
"C4,F5",6128,6983,4599,2384,4123,2188,0,2191,1436,755,1.901986755,1240,1997,395,201,198,3,68,2,0.116161616,0,empty,CD-0722-2
"C4,F6",6157,7082,4422,2660,4223,2377,0,2380,1499,881,1.701475596,1375,2403,660,250,248,2,63,1,0.052419355,0,empty,CD-0722-2
"C4,F7",6720,7541,4967,2574,4504,2457,0,2459,1659,800,2.07375,1394,850,127,60,60,0,34,0,0.033333333,0,empty,CD-0722-2
"C4,F8",668526,786083,501488,284595,452107,247010,1,247210,194087,53123,3.653539898,146138,13405,2026,830,818,12,212,2,0.061124694,0,hg38,CD-0722-2
"C4,F9",5754,6630,4280,2350,3952,2099,0,2099,1386,713,1.943899018,1187,2648,686,298,294,4,94,1,0.010204082,0,empty,CD-0722-2
"C4,F10",6726,7212,5133,2079,4381,2244,1,2253,1435,818,1.754278729,1175,1778,372,167,165,2,49,1,0.290909091,0,empty,CD-0722-2
"C4,F11",5922,6602,4482,2120,3905,2022,0,2024,1320,704,1.875,1110,1668,330,176,176,0,44,0,0.034090909,0,empty,CD-0722-2
"C4,F12",6224,6912,4545,2367,4178,2178,0,2182,1378,804,1.713930348,1281,229,35,30,30,0,17,0,0.1,0,empty,CD-0722-2
"C4,G1",526250,626614,382158,244456,366917,218250,1,218427,173585,44842,3.871036082,130424,10874,2654,879,870,9,234,3,0.027586207,0,hg38,CD-0722-2
"C4,G2",4026,4445,2818,1627,2711,1520,0,1524,963,561,1.71657754,870,563,91,46,46,0,35,0,0.086956522,0,empty,CD-0722-2
"C4,G3",7541,8229,5492,2737,4911,2708,0,2709,1679,1030,1.630097087,1476,2587,680,299,299,0,88,0,0.043478261,0,empty,CD-0722-2
"C4,G4",14208,16685,9859,6826,9929,6143,0,6145,3750,2395,1.565762004,3727,196,23,13,11,2,9,1,0,0,empty,CD-0722-2
"C4,G5",4299,4875,3150,1725,3002,1669,0,1669,1070,599,1.786310518,945,1982,442,198,193,5,57,3,0.056994819,0,empty,CD-0722-2
"C4,G6",6401,7045,4708,2337,4260,2308,0,2309,1586,723,2.193637621,1280,149,17,13,13,0,9,0,0.076923077,0,empty,CD-0722-2
"C4,G7",5242,5976,3957,2019,3570,1882,0,1885,1286,599,2.146911519,1089,8625,1402,491,482,9,156,2,0.074688797,0,empty,CD-0722-2
"C4,G8",3760,4182,2792,1390,2571,1353,0,1353,872,481,1.812889813,762,1857,466,220,218,2,67,2,0.055045872,0,empty,CD-0722-2
"C4,G9",4497,5192,3309,1883,3033,1623,0,1623,1071,552,1.940217391,946,2533,838,308,301,7,78,2,0.096345515,0,empty,CD-0722-2
"C4,G10",5661,6674,4118,2556,3887,2228,0,2230,1374,856,1.605140187,1301,2425,604,250,248,2,80,2,0.052419355,0,empty,CD-0722-2
"C4,G11",5552,6296,4198,2098,3770,1972,0,1973,1313,660,1.989393939,1110,1654,374,185,180,5,58,2,0.005555556,0,empty,CD-0722-2
"C4,G12",4956,5749,3560,2189,3365,1878,0,1878,1246,632,1.971518987,1061,2475,651,314,314,0,101,0,0.149681529,0,empty,CD-0722-2
"C4,H1",5055,5755,3723,2032,3411,1815,0,1815,1189,626,1.899361022,1066,1589,361,170,166,4,58,2,0.042168675,0,empty,CD-0722-2
"C4,H2",5679,6524,4253,2271,3845,2090,0,2097,1372,725,1.892413793,1172,2374,465,185,181,4,73,2,0.022099448,0,empty,CD-0722-2
"C4,H3",4999,5742,3563,2179,3408,1885,0,1887,1213,674,1.799703264,1113,1674,361,184,178,6,69,2,0.056179775,0,empty,CD-0722-2
"C4,H4",6988,7732,5094,2638,4643,2528,0,2528,1672,856,1.953271028,1433,201,54,26,26,0,16,0,0.038461538,0,empty,CD-0722-2
"C4,H5",847191,1039515,605825,433690,591179,361481,3,361787,287391,74396,3.862989946,222240,28971,11459,4385,4366,19,847,2,0.024278516,0,hg38,CD-0722-2
"C4,H6",4680,5426,3427,1999,3290,1882,0,1882,1321,561,2.354723708,1083,2043,429,208,203,5,79,1,0.098522167,0,empty,CD-0722-2
"C4,H7",5492,6070,4048,2022,3671,2002,1,2005,1345,660,2.037878788,1074,3160,715,255,250,5,88,1,0.124,0,empty,CD-0722-2
"C4,H8",12579,14864,9181,5683,8888,5019,0,5022,3628,1394,2.602582496,2970,2049,584,239,238,1,75,1,0.109243697,0,empty,CD-0722-2
"C4,H9",4488,5014,3295,1719,3041,1548,0,1548,1028,520,1.976923077,912,1311,175,72,71,1,34,1,0.098591549,0,empty,CD-0722-2
"C4,H10",4528,5207,3336,1871,3167,1742,0,1745,1149,596,1.927852349,1010,1506,251,126,124,2,52,2,0.040322581,0,empty,CD-0722-2
"C4,H11",6151,7241,4229,3012,4422,2874,0,2882,1493,1389,1.07487401,1757,148,87,5,4,1,4,1,0,0,empty,CD-0722-2
"C4,H12",4747,5524,3394,2130,3241,1860,1,1864,1263,601,2.101497504,1094,1761,367,158,158,0,53,0,0.056962025,0,empty,CD-0722-2
"C5,A1",4038,4561,2884,1677,2795,1595,0,1598,1037,561,1.848484848,931,1304,264,99,98,1,38,1,0.234693878,0,empty,CD-0722-2
"C5,A2",544052,631380,401691,229689,359169,200306,4,200481,160906,39575,4.065849653,115872,138432,21653,8834,8666,168,1575,6,0.026540503,0,hg38,CD-0722-2
"C5,A3",3670,4252,2720,1532,2581,1410,0,1412,958,454,2.110132159,830,1229,215,112,107,5,44,1,0.14953271,0,empty,CD-0722-2
"C5,A4",6460,7076,4702,2374,4250,2305,0,2310,1479,831,1.779783394,1291,855,179,91,91,0,32,0,0.087912088,0,empty,CD-0722-2
"C5,A5",5081,5721,3725,1996,3382,1839,0,1844,1216,628,1.936305732,1059,2592,527,255,252,3,58,2,0.023809524,0,empty,CD-0722-2
"C5,A6",4449,5206,3174,2032,3128,1817,0,1819,1179,640,1.8421875,1076,3252,920,331,326,5,100,1,0.150306748,0,empty,CD-0722-2
"C5,A7",4398,4875,3073,1802,2912,1679,0,1682,1004,678,1.480825959,984,1822,362,121,121,0,53,0,0.107438017,0,empty,CD-0722-2
"C5,A8",2272,2615,1647,968,1582,881,0,884,605,279,2.168458781,528,1838,435,166,164,2,54,1,0,0,empty,CD-0722-2
"C5,A9",4344,4863,3295,1568,2905,1585,0,1587,1023,564,1.813829787,870,1948,420,149,147,2,54,2,0.081632653,0,empty,CD-0722-2
"C5,A10",5962,6524,4557,1967,3861,1979,0,1984,1180,804,1.467661692,1083,461,39,31,30,1,16,1,0.033333333,0,empty,CD-0722-2
"C5,A11",3565,4012,2673,1339,2369,1227,0,1229,838,391,2.143222506,699,1749,370,137,137,0,56,0,0.02189781,0,empty,CD-0722-2
"C5,A12",5371,5906,3961,1945,3522,1816,0,1821,1211,610,1.985245902,995,3638,775,313,308,5,92,1,0.016233766,0,empty,CD-0722-2
"C5,B1",4519,5094,3291,1803,3006,1671,0,1676,1075,601,1.788685524,929,1417,402,180,178,2,43,2,0.123595506,0,empty,CD-0722-2
"C5,B2",5013,5775,3401,2374,3440,2106,0,2108,1356,752,1.803191489,1261,727,233,93,93,0,28,0,0.107526882,0,empty,CD-0722-2
"C5,B3",4506,5127,3338,1789,3095,1686,0,1690,1158,532,2.176691729,953,1479,261,93,91,2,46,2,0.175824176,0,empty,CD-0722-2
"C5,B4",3908,4420,2796,1624,2760,1601,0,1601,1003,598,1.677257525,926,1247,368,140,139,1,41,1,0.26618705,0,empty,CD-0722-2
"C5,B5",8878,7811,4871,2940,4962,2801,0,2807,2083,724,2.877071823,1697,1087,265,112,110,2,41,1,0.045454545,0,empty,CD-0722-2
"C5,B6",5312,6336,3723,2613,3828,2356,0,2356,1424,932,1.527896996,1400,2182,589,228,219,9,63,1,0.050228311,0,empty,CD-0722-2
"C5,B7",491135,609113,349236,259877,354603,221553,1,221704,175054,46650,3.75249732,137024,20740,8113,2869,2854,15,611,3,0.033637001,0,hg38,CD-0722-2
"C5,B8",3105,3533,2331,1202,2137,1170,0,1170,797,373,2.136729223,645,1374,256,125,123,2,50,2,0.048780488,0,empty,CD-0722-2
"C5,B9",6407,7358,4684,2674,4335,2413,0,2417,1544,873,1.768613975,1366,1524,461,166,165,1,53,1,0.096969697,0,empty,CD-0722-2
"C5,B10",3037,3391,2158,1233,2006,1108,0,1108,694,414,1.676328502,631,529,82,45,45,0,22,0,0,0,empty,CD-0722-2
"C5,B11",7072,7869,5027,2842,4659,2717,0,2719,1563,1156,1.352076125,1543,390,69,36,35,1,15,1,0,0,empty,CD-0722-2
"C5,B12",3746,4347,2753,1594,2517,1370,0,1376,969,407,2.380835381,763,1942,497,183,182,1,50,1,0.098901099,0,empty,CD-0722-2
"C5,C1",7569,8343,5617,2726,4999,2664,0,2664,1700,964,1.763485477,1493,1357,392,147,147,0,39,0,0.034013605,0,empty,CD-0722-2
"C5,C2",6450,7386,4648,2738,4348,2423,0,2423,1601,822,1.947688564,1407,2276,675,248,247,1,78,1,0.028340081,0,empty,CD-0722-2
"C5,C3",6671,7568,4879,2689,4448,2450,0,2455,1600,855,1.871345029,1357,940,167,95,92,3,39,1,0.043478261,0,empty,CD-0722-2
"C5,C4",3935,4416,2951,1465,2600,1324,0,1326,837,489,1.711656442,737,2050,529,229,229,0,68,0,0.008733624,0,empty,CD-0722-2
"C5,C5",421366,440321,344228,96093,251653,92133,1,92295,68925,23370,2.949293967,46327,104149,25267,9621,9510,111,1427,6,0.046477392,0,hg38,CD-0722-2
"C5,C6",7644,8363,5574,2789,5058,2774,0,2776,1967,809,2.431396786,1522,2177,637,221,217,4,49,1,0.078341014,0,empty,CD-0722-2
"C5,C7",7122,8271,5145,3126,4878,2869,0,2870,1714,1156,1.482698962,1658,395,58,25,24,1,15,1,0,0,empty,CD-0722-2
"C5,C8",571802,714912,391608,323304,414712,283607,1,283796,218471,65325,3.344370455,171923,63098,36582,12975,12957,18,1859,3,0.017056417,0,hg38,CD-0722-2
"C5,C9",549871,658412,406395,252017,377282,215895,2,216053,166148,49905,3.329285643,129016,104996,10304,4046,3880,166,878,4,0.061340206,0,hg38,CD-0722-2
"C5,C10",6084,6763,4389,2374,3991,2157,0,2159,1359,800,1.69875,1226,2282,438,182,178,4,61,2,0.028089888,0,empty,CD-0722-2
"C5,C11",5044,5791,3696,2095,3525,1940,0,1943,1207,736,1.639945652,1145,1956,372,162,162,0,53,0,0.166666667,0,empty,CD-0722-2
"C5,C12",6910,7890,5014,2876,4691,2551,0,2561,1696,865,1.960693642,1508,2281,534,204,196,8,59,2,0.147959184,0,empty,CD-0722-2
"C5,D1",6598,7758,4653,3105,4597,2710,0,2710,1618,1092,1.481684982,1640,1029,97,52,52,0,24,0,0.096153846,0,empty,CD-0722-2
"C5,D2",5295,5763,3955,1808,3496,1824,0,1828,1186,642,1.847352025,975,3357,691,303,296,7,98,2,0.206081081,0,empty,CD-0722-2
"C5,D3",4732,5404,3429,1975,3175,1760,0,1764,1178,586,2.010238908,1018,1475,294,129,128,1,55,1,0.0703125,0,empty,CD-0722-2
"C5,D4",4045,4659,2915,1744,2839,1647,0,1647,1130,517,2.185686654,947,1471,308,130,126,4,31,2,0.111111111,0,empty,CD-0722-2
"C5,D5",4323,4934,3206,1728,2964,1596,0,1596,1087,509,2.135559921,894,1903,332,141,138,3,54,1,0.101449275,0,empty,CD-0722-2
"C5,D6",14282,16469,10012,6457,9468,5683,0,5684,4249,1435,2.96097561,3337,2893,665,285,277,8,77,2,0.046931408,0,empty,CD-0722-2
"C5,D7",3731,4232,2802,1430,2464,1306,0,1312,884,428,2.065420561,718,2471,608,238,231,7,79,3,0.038961039,0,empty,CD-0722-2
"C5,D8",4463,5074,3218,1856,3052,1669,0,1672,1056,616,1.714285714,1010,1398,374,141,140,1,57,1,0.085714286,0,empty,CD-0722-2
"C5,D9",2348,2593,1706,887,1535,818,0,818,532,286,1.86013986,440,1940,413,185,184,1,56,1,0.10326087,0,empty,CD-0722-2
"C5,D10",1124131,1305106,832158,472948,737612,412587,2,412911,347354,65557,5.298503592,243512,152857,16542,6927,6732,195,1259,8,0.093285799,0,hg38,CD-0722-2
"C5,D11",4835,5362,3575,1787,3236,1748,0,1748,1114,634,1.757097792,994,4476,1045,407,404,3,127,1,0.017326733,0,empty,CD-0722-2
"C5,D12",6524,7224,4806,2418,4173,2227,0,2229,1443,786,1.835877863,1226,3681,1035,374,370,4,111,1,0.048648649,0,empty,CD-0722-2
"C5,E1",7514,8263,5554,2709,5014,2707,0,2711,1744,967,1.803516029,1497,3391,894,319,314,5,86,2,0.079617834,0,empty,CD-0722-2
"C5,E2",5297,6058,3795,2263,3581,1993,0,1998,1253,745,1.681879195,1165,2157,568,193,189,4,55,1,0.068783069,0,empty,CD-0722-2
"C5,E3",3450,3911,2555,1356,2362,1233,1,1236,823,413,1.992736077,705,2436,777,307,304,3,90,2,0.049342105,0,empty,CD-0722-2
"C5,E4",4883,5403,3645,1758,3280,1672,0,1672,1113,559,1.991055456,924,3016,709,319,308,11,121,2,0.055194805,0,empty,CD-0722-2
"C5,E5",506692,609656,361259,248397,353592,216321,1,216517,173009,43508,3.976487083,130061,23692,6562,2252,2230,22,567,4,0.037668161,0,hg38,CD-0722-2
"C5,E6",8090,9358,5845,3513,5493,3059,0,3059,1876,1183,1.585798817,1836,3461,972,369,367,2,110,1,0.04359673,0,empty,CD-0722-2
"C5,E7",7045,7790,5363,2427,4611,2381,0,2385,1606,779,2.061617458,1286,2901,727,321,314,7,108,2,0.031847134,0,empty,CD-0722-2
"C5,E8",5791,6554,4358,2196,3932,2068,0,2068,1331,737,1.805970149,1161,3080,626,240,233,7,72,2,0.163090129,0,empty,CD-0722-2
"C5,E9",357769,449824,244444,205380,262208,176505,1,176619,136076,40543,3.356337716,108875,146501,84166,30072,30011,61,2608,2,0.00746393,0,hg38,CD-0722-2
"C5,E10",4437,4910,3311,1599,2784,1394,0,1397,932,465,2.004301075,717,1721,463,173,173,0,52,0,0.12716763,0,empty,CD-0722-2
"C5,E11",5138,5821,3696,2125,3404,1898,1,1901,1165,736,1.582880435,1105,2117,513,225,222,3,56,2,0.094594595,0,empty,CD-0722-2
"C5,E12",984384,1178080,717881,460199,677627,393628,0,393921,319631,74290,4.30247678,238933,101066,20450,7854,7763,91,1404,4,0.065180987,0,hg38,CD-0722-2
"C5,F1",631921,731401,467191,264210,416933,233128,1,233312,183080,50232,3.644688645,136503,92066,11720,4401,4312,89,904,3,0.016465677,0,hg38,CD-0722-2
"C5,F2",5027,5697,3643,2054,3472,1929,0,1929,1266,663,1.909502262,1106,2937,717,282,277,5,81,1,0.039711191,0,empty,CD-0722-2
"C5,F3",513709,586189,385525,200664,336349,178439,0,178586,130926,47660,2.747083508,103879,47068,9392,3542,3473,69,683,4,0.02562626,0,hg38,CD-0722-2
"C5,F4",7433,8114,5473,2641,4881,2532,1,2537,1665,872,1.90940367,1355,1124,185,87,86,1,44,1,0.058139535,0,empty,CD-0722-2
"C5,F5",5909,6497,4458,2039,3895,1972,0,1973,1263,710,1.778873239,1073,2001,468,207,207,0,60,0,0.125603865,0,empty,CD-0722-2
"C5,F6",5688,6521,4124,2397,3835,2173,0,2179,1423,756,1.882275132,1243,2743,533,224,220,4,61,2,0.036363636,0,empty,CD-0722-2
"C5,F7",6694,7596,4796,2800,4456,2377,0,2379,1569,810,1.937037037,1382,1360,324,134,130,4,42,1,0.146153846,0,empty,CD-0722-2
"C5,F8",5361,6164,3923,2241,3714,2049,0,2049,1404,645,2.176744186,1201,464,168,57,56,1,29,1,0,0,empty,CD-0722-2
"C5,F9",5452,6124,4150,1974,3742,1955,0,1957,1303,654,1.99235474,1101,3850,1157,473,469,4,123,2,0.093816631,0,empty,CD-0722-2
"C5,F10",6818,7414,5137,2277,4413,2230,0,2236,1509,727,2.07565337,1168,2124,567,233,232,1,73,1,0.034482759,0,empty,CD-0722-2
"C5,F11",5126,5826,3933,1893,3357,1774,0,1774,1188,586,2.027303754,958,1729,350,162,162,0,50,0,0.055555556,0,empty,CD-0722-2
"C5,F12",597374,708814,433264,275550,401357,230102,0,230285,185859,44426,4.183563679,138640,15417,1923,762,743,19,184,2,0.048452221,0,hg38,CD-0722-2
"C5,G1",6062,6852,4545,2307,4101,2134,0,2134,1416,718,1.972144847,1215,3964,1065,388,387,1,106,1,0.015503876,0,empty,CD-0722-2
"C5,G2",3758,4240,2528,1712,2485,1394,0,1396,832,564,1.475177305,864,581,112,67,67,0,46,0,0.014925373,0,empty,CD-0722-2
"C5,G3",6736,7464,4819,2645,4389,2477,0,2479,1468,1011,1.452027695,1383,2628,621,232,228,4,86,2,0.087719298,0,empty,CD-0722-2
"C5,G4",12944,15213,9205,6008,8925,5468,0,5470,3239,2231,1.451815329,3221,137,28,18,18,0,9,0,0.333333333,0,empty,CD-0722-2
"C5,G5",4065,4519,3028,1491,2697,1485,0,1485,996,489,2.036809816,814,2212,511,169,169,0,65,0,0.047337278,0,empty,CD-0722-2
"C5,G6",6168,6911,4586,2325,4104,2175,0,2177,1433,744,1.926075269,1183,190,45,30,30,0,13,0,0,0,empty,CD-0722-2
"C5,G7",32317,36958,24107,12851,21330,11376,1,11387,9041,2346,3.853793691,6557,5195,769,315,307,8,97,2,0.068403909,0,empty,CD-0722-2
"C5,G8",3678,4114,2640,1474,2472,1313,0,1324,843,481,1.752598753,755,2466,703,259,258,1,74,1,0.058139535,0,empty,CD-0722-2
"C5,G9",626123,720723,476502,244221,411220,218339,0,218513,170692,47821,3.569394199,125904,89627,17548,6588,6510,78,1199,2,0.023963134,0,hg38,CD-0722-2
"C5,G10",510129,594770,381692,213078,341702,186254,3,186420,138510,47910,2.891045711,109438,107169,23869,9100,9000,100,1455,5,0.024222222,0,hg38,CD-0722-2
"C5,G11",5164,5783,3835,1948,3458,1852,0,1852,1240,612,2.026143791,1053,1594,454,202,200,2,61,1,0.04,0,empty,CD-0722-2
"C5,G12",4242,4869,3036,1833,2920,1678,0,1682,1048,634,1.652996845,1008,2380,478,185,182,3,73,1,0.06043956,0,empty,CD-0722-2
"C5,H1",901850,1019833,681356,338477,581708,304848,3,305140,248387,56753,4.376632072,175722,60288,10370,3812,3743,69,797,4,0.022976222,0,hg38,CD-0722-2
"C5,H2",5190,5962,3790,2172,3569,1981,0,1985,1289,696,1.852011494,1153,2757,653,248,243,5,69,2,0.061728395,0,empty,CD-0722-2
"C5,H3",4427,5029,3097,1932,2926,1569,0,1571,1045,526,1.986692015,930,1859,398,150,145,5,50,2,0.248275862,0,empty,CD-0722-2
"C5,H4",6269,6819,4631,2188,4157,2177,0,2177,1397,780,1.791025641,1191,356,117,40,40,0,19,0,0.15,0,empty,CD-0722-2
"C5,H5",6948,7854,5078,2776,4642,2528,0,2531,1666,865,1.926011561,1455,2137,591,245,245,0,90,0,0.093877551,0,empty,CD-0722-2
"C5,H6",4068,4745,2894,1851,2701,1524,0,1524,956,568,1.683098592,913,2307,547,223,220,3,77,2,0.077272727,0,empty,CD-0722-2
"C5,H7",4909,5560,3471,2089,3260,1775,0,1776,1213,563,2.154529307,1029,3063,635,254,249,5,97,2,0.016064257,0,empty,CD-0722-2
"C5,H8",585394,714144,423315,290829,406717,238599,1,238793,191999,46794,4.10306877,146142,178311,29266,11663,11421,242,1840,7,0.085894405,0.004132231,hg38,CD-0722-2
"C5,H9",4143,4618,3048,1570,2680,1389,0,1389,965,424,2.275943396,761,1647,517,199,194,5,56,3,0.06185567,0,empty,CD-0722-2
"C5,H10",534407,636225,390275,245950,362694,207940,0,208086,167167,40919,4.08531489,125135,136359,20453,8179,8010,169,1405,7,0.048439451,0,hg38,CD-0722-2
"C5,H11",5040,5908,3386,2522,3584,2332,0,2334,1245,1089,1.143250689,1414,63,7,5,5,0,3,0,0,0,empty,CD-0722-2
"C5,H12",3855,4290,2751,1539,2515,1397,0,1397,920,477,1.928721174,787,1440,210,92,90,2,45,1,0.033333333,0,empty,CD-0722-2
"C6,A1",4874,5517,3573,1944,3385,1903,0,1905,1212,693,1.748917749,1086,1354,259,127,126,1,51,1,0.111111111,0,empty,CD-0722-2
"C6,A2",7510,8645,5507,3138,5176,2950,0,2951,1816,1135,1.6,1724,2245,624,206,204,2,54,1,0.107843137,0,empty,CD-0722-2
"C6,A3",4660,5263,3349,1914,3119,1747,0,1749,1065,684,1.557017544,1006,1875,488,161,161,0,52,0,0.00621118,0,empty,CD-0722-2
"C6,A4",6987,7923,5050,2873,4715,2632,0,2638,1676,962,1.742203742,1477,832,236,113,109,4,45,2,0.009174312,0,empty,CD-0722-2
"C6,A5",6402,7111,4652,2459,4291,2329,0,2330,1467,863,1.699884125,1319,2506,574,218,217,1,70,1,0.082949309,0,empty,CD-0722-2
"C6,A6",723777,858835,548017,310818,494041,273281,2,273521,217749,55772,3.90427096,160553,199619,27566,11021,10783,238,1835,7,0.068812019,0,hg38,CD-0722-2
"C6,A7",5012,5928,3577,2351,3514,2010,0,2015,1317,698,1.886819484,1215,1276,210,96,96,0,43,0,0.135416667,0,empty,CD-0722-2
"C6,A8",2749,3202,2016,1186,1894,1069,0,1071,707,364,1.942307692,598,1901,479,193,192,1,63,1,0.114583333,0,empty,CD-0722-2
"C6,A9",5189,5924,3887,2037,3604,1972,0,1972,1252,720,1.738888889,1114,1800,377,155,152,3,48,2,0.052631579,0,empty,CD-0722-2
"C6,A10",6630,7374,5040,2334,4425,2326,0,2331,1459,872,1.673165138,1274,532,129,57,57,0,23,0,0,0,empty,CD-0722-2
"C6,A11",4594,5254,3499,1755,3156,1645,0,1645,1076,569,1.891036907,903,1843,417,140,140,0,52,0,0.078571429,0,empty,CD-0722-2
"C6,A12",7031,8111,5222,2889,4796,2555,0,2559,1659,900,1.843333333,1489,4315,998,391,390,1,111,1,0.082051282,0,empty,CD-0722-2
"C6,B1",5690,6470,4134,2336,3832,2173,0,2174,1378,796,1.731155779,1237,1573,414,158,156,2,51,2,0.121794872,0,empty,CD-0722-2
"C6,B2",5412,6130,3653,2477,3684,2155,0,2157,1322,835,1.583233533,1282,1122,287,95,95,0,27,0,0,0,empty,CD-0722-2
"C6,B3",5194,5878,3722,2156,3647,2055,0,2065,1384,681,2.032305433,1197,1756,256,120,120,0,60,0,0.141666667,0,empty,CD-0722-2
"C6,B4",5859,7022,4232,2790,4298,2539,0,2547,1588,959,1.655891554,1548,1575,233,99,95,4,41,2,0.031578947,0,empty,CD-0722-2
"C6,B5",5621,3407,1998,1409,2464,1426,0,1436,933,503,1.854870775,910,1484,273,79,78,1,39,1,0,0,empty,CD-0722-2
"C6,B6",6431,7784,4573,3211,4677,2735,0,2739,1770,969,1.826625387,1656,2469,567,184,180,4,55,3,0.116666667,0,empty,CD-0722-2
"C6,B7",5761,6587,4167,2420,3930,2155,0,2155,1437,718,2.001392758,1252,1451,334,126,125,1,45,1,0.112,0,empty,CD-0722-2
"C6,B8",4630,5231,3503,1728,3159,1666,0,1666,1164,502,2.3187251,934,1297,305,134,133,1,48,1,0.082706767,0,empty,CD-0722-2
"C6,B9",8390,9927,6064,3863,5939,3525,0,3529,2227,1302,1.710445469,2102,1802,387,146,145,1,62,1,0.027586207,0,empty,CD-0722-2
"C6,B10",3788,4140,2725,1415,2581,1424,0,1426,882,544,1.621323529,797,616,75,38,38,0,18,0,0.105263158,0,empty,CD-0722-2
"C6,B11",9455,11110,6625,4485,6627,4019,0,4023,2263,1760,1.285795455,2432,285,65,43,41,2,19,2,0,0,empty,CD-0722-2
"C6,B12",5087,5933,3657,2276,3575,2023,0,2023,1307,716,1.825418994,1192,1898,324,143,142,1,53,1,0.14084507,0,empty,CD-0722-2
"C6,C1",9255,10360,6863,3497,6088,3264,0,3264,2104,1160,1.813793103,1799,1263,242,111,109,2,32,2,0.009174312,0,empty,CD-0722-2
"C6,C2",7696,8749,5532,3217,5123,2931,0,2931,1973,958,2.059498956,1689,2445,575,228,227,1,74,1,0.123348018,0,empty,CD-0722-2
"C6,C3",7970,8943,5801,3142,5348,2876,0,2879,1843,1036,1.778957529,1630,1105,217,103,100,3,38,2,0.1,0,empty,CD-0722-2
"C6,C4",5277,5940,3902,2038,3573,1860,0,1860,1233,627,1.966507177,1081,2384,489,206,206,0,60,0,0.165048544,0,empty,CD-0722-2
"C6,C5",7327,8379,5467,2912,4954,2726,0,2729,1815,914,1.985776805,1519,2520,460,169,164,5,53,3,0.054878049,0,empty,CD-0722-2
"C6,C6",7362,8558,5332,3226,5174,2904,0,2911,1982,929,2.133476857,1718,2347,527,221,221,0,55,0,0.099547511,0,empty,CD-0722-2
"C6,C7",786533,919069,595195,323874,523479,281938,2,282229,216073,66156,3.266113429,164839,24302,2267,912,871,41,250,2,0.024110218,0,hg38,CD-0722-2
"C6,C8",683509,799608,505228,294380,459198,253611,2,253835,211689,42146,5.022754235,148653,310425,70867,27633,27278,355,3085,7,0.076178605,0,hg38,CD-0722-2
"C6,C9",6816,7794,5060,2734,4768,2657,0,2661,1777,884,2.010180995,1535,1865,309,127,126,1,38,1,0.063492063,0,empty,CD-0722-2
"C6,C10",7128,8109,5194,2915,4706,2521,0,2526,1643,883,1.860702152,1450,2076,405,179,175,4,52,1,0.034285714,0,empty,CD-0722-2
"C6,C11",547001,616649,415863,200786,357350,181891,1,182025,143290,38735,3.699238415,105006,31985,6438,2306,2284,22,479,5,0.03765324,0,hg38,CD-0722-2
"C6,C12",9138,10222,6769,3453,6080,3246,0,3249,2111,1138,1.855008787,1854,2188,587,233,232,1,68,1,0.064655172,0,empty,CD-0722-2
"C6,D1",8528,9747,6091,3656,5794,3380,0,3383,1993,1390,1.43381295,1967,1210,267,115,106,9,29,2,0.018867925,0,empty,CD-0722-2
"C6,D2",5913,6666,4449,2217,4018,2132,0,2136,1395,741,1.882591093,1190,3010,711,319,316,3,109,1,0.050632911,0,empty,CD-0722-2
"C6,D3",5985,6675,4321,2354,4021,2279,0,2279,1531,748,2.046791444,1285,1823,345,135,129,6,44,2,0.03875969,0,empty,CD-0722-2
"C6,D4",4917,5444,3695,1749,3233,1714,0,1716,1116,600,1.86,950,1600,491,174,169,5,61,2,0.076923077,0,empty,CD-0722-2
"C6,D5",1206217,1449572,894485,555087,829750,492620,3,493001,408425,84576,4.82908863,291029,190788,29640,11473,11243,230,1815,7,0.053722316,0,hg38,CD-0722-2
"C6,D6",8541,10059,5948,4111,5987,3676,0,3676,2197,1479,1.485463151,2252,3175,897,333,331,2,81,2,0.066465257,0,empty,CD-0722-2
"C6,D7",4477,5062,3276,1786,3102,1656,0,1656,1138,518,2.196911197,971,2539,436,191,190,1,77,1,0.157894737,0,empty,CD-0722-2
"C6,D8",5545,6361,4004,2357,3731,2071,0,2073,1349,724,1.863259669,1189,2078,466,207,205,2,64,2,0.097560976,0,empty,CD-0722-2
"C6,D9",2962,3478,2146,1332,2059,1173,0,1173,769,404,1.903465347,698,2113,592,211,210,1,54,1,0.047619048,0,empty,CD-0722-2
"C6,D10",596665,707099,441684,265415,408857,229358,2,229560,176968,52592,3.364922422,136974,63270,6656,2624,2548,76,576,7,0.050235479,0,hg38,CD-0722-2
"C6,D11",459680,513236,351851,161385,297536,149299,0,149444,113380,36064,3.143855368,83138,196477,30422,11852,11599,253,1726,7,0.050866454,0,hg38,CD-0722-2
"C6,D12",638237,738810,477000,261810,426272,232275,2,232465,178555,53910,3.312094231,135408,234427,40341,15055,14752,303,2062,7,0.045553145,0,hg38,CD-0722-2
"C6,E1",9943,11335,7164,4171,6656,3764,0,3764,2389,1375,1.737454545,2177,3256,749,264,263,1,75,1,0.148288973,0,empty,CD-0722-2
"C6,E2",6607,7683,4741,2942,4625,2650,0,2652,1674,978,1.711656442,1557,2468,637,224,222,2,59,1,0.022522523,0,empty,CD-0722-2
"C6,E3",4432,5089,3343,1746,3030,1603,0,1605,1052,553,1.902350814,891,2664,691,303,302,1,83,1,0.056291391,0,empty,CD-0722-2
"C6,E4",5983,6869,4439,2430,4092,2321,0,2321,1508,813,1.854858549,1320,2584,559,238,232,6,90,2,0.051724138,0,empty,CD-0722-2
"C6,E5",5203,5892,3883,2009,3588,1950,0,1953,1284,669,1.919282511,1122,1497,434,152,151,1,44,1,0.145695364,0,empty,CD-0722-2
"C6,E6",10311,11727,7516,4211,6848,3788,0,3789,2431,1358,1.790132548,2154,4301,922,414,410,4,112,2,0.097560976,0,empty,CD-0722-2
"C6,E7",9952,11248,7395,3853,6738,3531,0,3531,2421,1110,2.181081081,2007,3219,810,333,330,3,119,1,0.027272727,0,empty,CD-0722-2
"C6,E8",7183,8323,5302,3021,4906,2611,0,2611,1713,898,1.907572383,1515,3126,855,360,359,1,98,1,0.033426184,0,empty,CD-0722-2
"C6,E9",5136,5662,3756,1906,3371,1802,0,1804,1200,604,1.986754967,992,2597,646,288,287,1,73,1,0.045296167,0,empty,CD-0722-2
"C6,E10",4986,5667,3709,1958,3353,1791,0,1793,1174,619,1.896607431,1000,2102,627,220,219,1,65,1,0.059360731,0,empty,CD-0722-2
"C6,E11",6254,6933,4604,2329,4228,2341,0,2343,1446,897,1.612040134,1306,2662,712,278,276,2,80,2,0,0,empty,CD-0722-2
"C6,E12",7257,8321,5195,3126,5028,2846,0,2850,1793,1057,1.696310312,1672,2138,665,263,262,1,84,1,0.019083969,0,empty,CD-0722-2
"C6,F1",8080,9045,5852,3193,5389,2996,0,3000,1912,1088,1.757352941,1690,2709,774,313,303,10,87,2,0.085808581,0,empty,CD-0722-2
"C6,F2",6293,7128,4677,2451,4339,2315,0,2317,1506,811,1.856966708,1311,3221,862,339,333,6,90,2,0.054054054,0,empty,CD-0722-2
"C6,F3",5883,6670,4444,2226,3976,2072,0,2072,1369,703,1.947368421,1144,2861,614,253,250,3,97,1,0.056,0,empty,CD-0722-2
"C6,F4",8845,9911,6521,3390,5981,3188,0,3192,2045,1147,1.782911944,1810,801,220,93,88,5,40,1,0.022727273,0,empty,CD-0722-2
"C6,F5",6711,7224,4902,2322,4384,2291,0,2295,1513,782,1.934782609,1261,3021,626,241,233,8,77,1,0.017167382,0,empty,CD-0722-2
"C6,F6",1101504,1277045,821504,455541,728458,399986,0,400313,327847,72466,4.524149256,235270,126870,23968,9184,9025,159,1493,7,0.034903047,0,hg38,CD-0722-2
"C6,F7",8053,9236,5954,3282,5511,3072,0,3074,1999,1075,1.859534884,1763,1310,204,90,89,1,33,1,0.157303371,0,empty,CD-0722-2
"C6,F8",5937,6951,4374,2577,4105,2229,0,2231,1514,717,2.111576011,1298,449,70,34,34,0,22,0,0.029411765,0,empty,CD-0722-2
"C6,F9",6761,7583,5140,2443,4563,2359,0,2365,1585,780,2.032051282,1306,3390,900,325,320,5,94,1,0.053125,0,empty,CD-0722-2
"C6,F10",8306,9606,6012,3594,5710,3162,1,3170,1964,1206,1.628524046,1850,2449,631,300,298,2,66,2,0.110738255,0,empty,CD-0722-2
"C6,F11",6876,7783,5229,2554,4574,2366,0,2366,1632,734,2.223433243,1292,2094,361,173,171,2,55,1,0.052631579,0,empty,CD-0722-2
"C6,F12",7038,7940,5142,2798,4719,2571,0,2574,1720,854,2.014051522,1448,398,30,16,15,1,9,1,0.066666667,0,empty,CD-0722-2
"C6,G1",7236,8247,5385,2862,4896,2592,0,2597,1701,896,1.8984375,1455,3731,1126,389,387,2,106,2,0.087855297,0,empty,CD-0722-2
"C6,G2",4562,5328,3180,2148,3231,1845,0,1847,1216,631,1.927099842,1147,724,150,67,67,0,33,0,0.149253731,0,empty,CD-0722-2
"C6,G3",8191,8951,5935,3016,5318,2916,1,2920,1794,1126,1.593250444,1583,2881,490,161,156,5,67,2,0.006410256,0,empty,CD-0722-2
"C6,G4",15377,17830,10892,6938,10587,6434,0,6441,3910,2531,1.544843935,3780,279,54,25,25,0,13,0,0,0,empty,CD-0722-2
"C6,G5",5195,5770,3763,2007,3529,1906,0,1906,1179,727,1.62173315,1093,1918,324,157,155,2,60,2,0.04516129,0,empty,CD-0722-2
"C6,G6",7207,8075,5513,2562,4779,2521,0,2521,1725,796,2.167085427,1327,233,29,19,19,0,13,0,0.052631579,0,empty,CD-0722-2
"C6,G7",5932,6608,4422,2186,3947,2033,0,2033,1294,739,1.751014885,1114,3254,695,274,266,8,77,2,0.12406015,0,empty,CD-0722-2
"C6,G8",590576,727046,421811,305235,421691,256974,3,257136,202074,55062,3.669935709,159119,139968,21644,8599,8462,137,1508,4,0.046561097,0,hg38,CD-0722-2
"C6,G9",5049,5711,3653,2058,3496,1933,0,1936,1232,704,1.75,1107,2727,697,249,244,5,89,2,0.06147541,0,empty,CD-0722-2
"C6,G10",6653,7383,4982,2401,4548,2478,0,2486,1634,852,1.917840376,1393,3174,900,308,306,2,96,2,0.058823529,0,empty,CD-0722-2
"C6,G11",6320,7153,4684,2469,4276,2263,0,2266,1503,763,1.969855832,1310,1679,307,148,148,0,46,0,0.216216216,0,empty,CD-0722-2
"C6,G12",5421,6467,3880,2587,3984,2283,0,2287,1487,800,1.85875,1432,2210,516,227,225,2,80,1,0.053333333,0,empty,CD-0722-2
"C6,H1",6397,7086,4772,2314,4239,2233,1,2238,1500,738,2.032520325,1232,1367,317,137,137,0,55,0,0.00729927,0,empty,CD-0722-2
"C6,H2",6840,7596,5031,2565,4591,2487,0,2489,1625,864,1.880787037,1412,3440,928,367,356,11,93,2,0.053370787,0,empty,CD-0722-2
"C6,H3",5608,6584,4085,2499,3888,2139,0,2139,1448,691,2.095513748,1236,1983,412,220,218,2,65,2,0.082568807,0,empty,CD-0722-2
"C6,H4",7677,8863,5643,3220,5143,2846,0,2848,1913,935,2.045989305,1658,298,31,24,24,0,19,0,0,0,empty,CD-0722-2
"C6,H5",1776525,2130970,1305083,825887,1186959,695993,4,696594,546462,150132,3.639876908,419996,364031,54088,21015,20618,397,2805,10,0.058056068,0,hg38,CD-0722-2
"C6,H6",6165,7426,4412,3014,4474,2757,0,2757,1761,996,1.768072289,1659,2458,651,266,257,9,78,1,0.101167315,0,empty,CD-0722-2
"C6,H7",6135,6659,4573,2086,4054,2112,0,2113,1489,624,2.386217949,1129,2536,507,252,249,3,82,2,0.036144578,0,empty,CD-0722-2
"C6,H8",6743,8135,4938,3197,4835,2803,0,2804,1810,994,1.820925553,1691,2209,417,211,209,2,82,1,0.009569378,0,empty,CD-0722-2
"C6,H9",5707,6383,4352,2031,3770,1888,0,1888,1246,642,1.940809969,1037,1517,345,145,142,3,53,1,0.056338028,0,empty,CD-0722-2
"C6,H10",5390,6270,3917,2353,3749,2020,0,2025,1327,698,1.901146132,1226,1720,400,179,178,1,61,1,0.02247191,0,empty,CD-0722-2
"C6,H11",7147,8417,4748,3669,4967,3251,0,3253,1679,1574,1.066709022,1966,89,21,6,6,0,4,0,0.166666667,0,empty,CD-0722-2
"C6,H12",5573,6436,3978,2458,3874,2243,0,2248,1495,753,1.985391766,1316,1635,323,143,142,1,42,1,0.077464789,0,empty,CD-0722-2
"C7,A1",691869,798562,526788,271774,461944,248108,0,248304,202688,45616,4.443353209,142717,65493,8628,3301,3225,76,789,6,0.019534884,0,hg38,CD-0722-2
"C7,A2",6277,7110,4571,2539,4194,2397,0,2397,1474,923,1.596966414,1313,2247,408,197,194,3,62,1,0.103092784,0,empty,CD-0722-2
"C7,A3",3951,4576,2866,1710,2638,1422,0,1426,926,500,1.852,824,1399,307,140,138,2,60,1,0.043478261,0,empty,CD-0722-2
"C7,A4",632794,785508,445762,339746,454626,291000,1,291188,225753,65435,3.450034385,179870,11592,6335,2351,2339,12,508,2,0.025224455,0,hg38,CD-0722-2
"C7,A5",5443,6122,3980,2142,3673,2002,0,2005,1256,749,1.676902537,1122,2382,514,185,179,6,58,2,0.156424581,0,empty,CD-0722-2
"C7,A6",10789,12287,8094,4193,7484,4021,0,4027,3015,1012,2.979249012,2267,3384,705,323,323,0,111,0,0.021671827,0,empty,CD-0722-2
"C7,A7",4160,4844,3001,1843,2938,1723,3,1726,1071,655,1.635114504,1042,1522,287,123,122,1,50,1,0.032786885,0,empty,CD-0722-2
"C7,A8",2419,2898,1798,1100,1730,963,0,965,633,332,1.906626506,571,2209,473,196,194,2,73,2,0.010309278,0,empty,CD-0722-2
"C7,A9",4784,5677,3524,2153,3395,1847,0,1847,1231,616,1.998376623,1103,1619,346,136,135,1,47,1,0,0,empty,CD-0722-2
"C7,A10",5448,6047,4172,1875,3736,1997,0,2002,1275,727,1.753782669,1105,655,211,75,75,0,27,0,0.186666667,0,empty,CD-0722-2
"C7,A11",3918,4450,2893,1557,2671,1414,0,1415,921,494,1.86437247,798,1925,376,178,177,1,56,1,0.073446328,0,empty,CD-0722-2
"C7,A12",5541,6055,4204,1851,3620,1889,0,1890,1268,622,2.038585209,1006,4174,1285,545,543,2,135,2,0.08839779,0,empty,CD-0722-2
"C7,B1",669387,781660,502305,279355,445462,244520,2,244745,188604,56141,3.359469906,142886,33063,6071,2061,2034,27,530,3,0.029006883,0,hg38,CD-0722-2
"C7,B2",5047,5707,3352,2355,3521,2080,0,2082,1255,827,1.517533253,1281,597,111,62,58,4,30,2,0.086206897,0,empty,CD-0722-2
"C7,B3",4081,4830,2900,1930,2839,1640,0,1640,1062,578,1.837370242,971,1892,339,155,154,1,73,1,0.090909091,0,empty,CD-0722-2
"C7,B4",4488,5256,3206,2050,3241,1941,1,1945,1221,724,1.686464088,1138,1523,343,157,155,2,53,2,0.04516129,0,empty,CD-0722-2
"C7,B5",5009,2943,1861,1082,2105,1197,0,1210,761,449,1.694877506,727,1585,250,109,105,4,43,1,0.00952381,0,empty,CD-0722-2
"C7,B6",1658281,1988601,1229862,758739,1112700,654842,1,655411,536290,119121,4.50206093,387492,284838,34047,13826,13551,275,2323,9,0.076747104,0,hg38,CD-0722-2
"C7,B7",4944,5913,3668,2245,3541,1949,0,1950,1246,704,1.769886364,1176,1620,463,210,208,2,51,2,0.019230769,0,empty,CD-0722-2
"C7,B8",3360,3751,2523,1228,2316,1218,0,1219,812,407,1.995085995,706,1451,353,149,144,5,56,2,0.034722222,0,empty,CD-0722-2
"C7,B9",6778,7704,4889,2815,4634,2581,0,2583,1659,924,1.795454545,1494,1606,476,200,199,1,82,1,0.251256281,0,empty,CD-0722-2
"C7,B10",3086,3470,2235,1235,2095,1087,0,1087,732,355,2.061971831,624,838,231,78,78,0,30,0,0,0,empty,CD-0722-2
"C7,B11",569296,669444,419505,249939,382745,222640,0,222827,167964,54863,3.061516869,130947,3943,1022,366,365,1,95,1,0.04109589,0,hg38,CD-0722-2
"C7,B12",4143,4649,3043,1606,2802,1489,0,1489,957,532,1.79887218,826,1992,511,204,203,1,63,1,0.15270936,0,empty,CD-0722-2
"C7,C1",8349,9138,6187,2951,5433,2862,0,2866,1811,1055,1.716587678,1583,1358,460,183,183,0,50,0,0.054644809,0,empty,CD-0722-2
"C7,C2",6753,7600,4870,2730,4630,2625,0,2632,1670,962,1.735966736,1503,2608,638,260,258,2,91,1,0.027131783,0,empty,CD-0722-2
"C7,C3",8620,9992,6336,3656,5947,3271,1,3276,2127,1149,1.851174935,1840,1046,194,101,101,0,40,0,0.108910891,0,empty,CD-0722-2
"C7,C4",4430,4915,3299,1616,3002,1587,0,1591,1012,579,1.747841105,897,2220,461,209,206,3,58,1,0.101941748,0,empty,CD-0722-2
"C7,C5",6471,7166,4645,2521,4384,2414,0,2418,1590,828,1.920289855,1389,2405,480,243,240,3,89,2,0.045833333,0,empty,CD-0722-2
"C7,C6",710812,862184,509489,352695,504589,301198,3,301420,243672,57748,4.219574704,185088,112453,16725,6337,6193,144,1137,9,0.04666559,0,hg38,CD-0722-2
"C7,C7",7813,9283,5484,3799,5631,3431,0,3431,2054,1377,1.491648511,2127,474,78,35,34,1,14,1,0.029411765,0,empty,CD-0722-2
"C7,C8",8614,9960,6270,3690,6096,3351,0,3353,2202,1151,1.913119027,2038,4943,996,445,439,6,144,2,0.034168565,0,empty,CD-0722-2
"C7,C9",5732,6515,4162,2353,3913,2159,0,2165,1399,766,1.826370757,1238,2015,464,194,191,3,47,1,0.146596859,0,empty,CD-0722-2
"C7,C10",6453,7248,4897,2351,4342,2365,0,2365,1527,838,1.822195704,1265,2691,481,181,179,2,60,2,0.055865922,0,empty,CD-0722-2
"C7,C11",5618,6304,4136,2168,3817,2084,0,2086,1348,738,1.826558266,1199,1991,454,198,198,0,70,0,0.131313131,0,empty,CD-0722-2
"C7,C12",7403,8249,5434,2815,5056,2711,0,2718,1732,986,1.756592292,1532,2562,601,242,239,3,72,2,0.09623431,0,empty,CD-0722-2
"C7,D1",7227,8461,5094,3367,5168,3118,0,3118,1883,1235,1.524696356,1922,1148,295,120,118,2,40,2,0.118644068,0,empty,CD-0722-2
"C7,D2",5877,6642,4406,2236,4017,2040,0,2040,1377,663,2.076923077,1135,3574,1108,464,462,2,140,1,0.012987013,0,empty,CD-0722-2
"C7,D3",5124,5841,3624,2217,3473,2018,0,2019,1342,677,1.982274742,1181,1612,358,137,133,4,49,2,0.015037594,0,empty,CD-0722-2
"C7,D4",4018,4528,3069,1459,2805,1472,0,1474,936,538,1.739776952,832,1466,289,141,140,1,59,1,0.25,0,empty,CD-0722-2
"C7,D5",4549,5087,3413,1674,3113,1637,0,1637,1055,582,1.812714777,936,2056,490,196,191,5,83,1,0.020942408,0,empty,CD-0722-2
"C7,D6",7940,8971,5539,3432,5477,3190,0,3194,2051,1143,1.7944007,1922,2206,583,252,247,5,70,2,0.028340081,0,empty,CD-0722-2
"C7,D7",4132,4548,2972,1576,2748,1494,0,1498,959,539,1.779220779,843,2708,641,228,227,1,80,1,0.193832599,0,empty,CD-0722-2
"C7,D8",4774,5651,3495,2156,3308,1800,0,1805,1201,604,1.988410596,1096,1559,373,157,157,0,56,0,0.057324841,0,empty,CD-0722-2
"C7,D9",723196,829122,540104,289018,477942,259993,2,260194,208368,51826,4.020530236,150755,162290,17938,6844,6666,178,1323,6,0.04080408,0,hg38,CD-0722-2
"C7,D10",588771,694296,436260,258036,400083,221513,1,221735,175453,46282,3.790955447,132804,79193,10533,4232,4121,111,834,6,0.052414463,0,hg38,CD-0722-2
"C7,D11",5107,5696,3806,1890,3467,1834,0,1836,1196,640,1.86875,1047,4474,1173,467,461,6,116,2,0.206073753,0,empty,CD-0722-2
"C7,D12",6909,7794,5029,2765,4665,2530,0,2535,1669,866,1.927251732,1479,4819,1113,435,432,3,152,2,0.009259259,0,empty,CD-0722-2
"C7,E1",8343,9557,6050,3507,5652,3145,0,3146,1960,1186,1.652613828,1826,2956,521,223,222,1,79,1,0.117117117,0,empty,CD-0722-2
"C7,E2",5688,6500,4049,2451,3887,2173,0,2178,1360,818,1.662591687,1277,2058,567,206,204,2,51,1,0.102941176,0,empty,CD-0722-2
"C7,E3",1306728,1589904,941995,647909,909410,552934,7,553297,410887,142410,2.885239801,338303,256523,52481,20171,19891,280,2626,7,0.021768639,0,hg38,CD-0722-2
"C7,E4",5272,6148,3914,2234,3680,2026,0,2031,1325,706,1.876770538,1229,2701,633,279,276,3,91,2,0.083333333,0,empty,CD-0722-2
"C7,E5",4904,5470,3729,1741,3297,1723,0,1723,1124,599,1.876460768,939,1869,404,187,187,0,63,0,0.053475936,0,empty,CD-0722-2
"C7,E6",1462012,1755130,1036384,718746,996235,632931,6,633413,413250,220163,1.877018391,381029,150648,32205,12271,12166,105,1787,5,0.037481506,0,hg38,CD-0722-2
"C7,E7",645997,754475,483674,270801,429146,237598,2,237809,195875,41934,4.671030667,137525,257803,47915,18528,18263,265,2457,7,0.064392488,0,hg38,CD-0722-2
"C7,E8",6285,6700,4754,1946,4050,2021,0,2023,1328,695,1.910791367,1099,3129,795,260,258,2,90,2,0.069767442,0,empty,CD-0722-2
"C7,E9",4038,4554,2962,1592,2757,1512,0,1512,1007,505,1.994059406,857,2923,635,262,259,3,82,1,0.084942085,0,empty,CD-0722-2
"C7,E10",6110,6966,4554,2412,4043,2217,0,2223,1440,783,1.83908046,1224,2336,541,216,215,1,62,1,0.060465116,0,empty,CD-0722-2
"C7,E11",518059,560830,406348,154482,329231,152362,0,152496,117731,34765,3.386480656,81422,40062,6263,2360,2303,57,549,4,0.018671298,0,hg38,CD-0722-2
"C7,E12",521617,593632,394581,199051,345199,178643,1,178812,137271,41541,3.304470282,103355,115708,14298,5698,5547,151,1104,5,0.041463854,0,hg38,CD-0722-2
"C7,F1",7106,8117,5216,2901,4778,2560,0,2561,1576,985,1.6,1448,2439,503,187,186,1,81,1,0.043010753,0,empty,CD-0722-2
"C7,F2",650660,749361,483426,265935,430468,232510,0,232716,180693,52023,3.473329104,136130,203371,28089,11065,10813,252,1775,8,0.040876722,0,hg38,CD-0722-2
"C7,F3",5094,5710,3728,1982,3402,1835,0,1838,1184,654,1.810397554,1032,3209,568,250,247,3,90,2,0.076923077,0,empty,CD-0722-2
"C7,F4",8220,9225,6072,3153,5525,2925,0,2930,1828,1102,1.658802178,1670,1320,376,143,141,2,46,1,0.063829787,0,empty,CD-0722-2
"C7,F5",6297,6853,4593,2260,4237,2245,0,2250,1447,803,1.801992528,1253,2968,756,278,275,3,84,2,0.116363636,0,empty,CD-0722-2
"C7,F6",476298,530455,366691,163764,305144,147952,1,148079,115069,33010,3.485883066,83565,56183,12385,4527,4486,41,796,3,0.021622827,0,hg38,CD-0722-2
"C7,F7",7277,8252,5274,2978,4953,2773,0,2775,1862,913,2.039430449,1589,2058,513,201,197,4,49,2,0.106598985,0,empty,CD-0722-2
"C7,F8",674859,789303,508146,281157,454106,245100,1,245288,189345,55943,3.384605759,143703,11357,1210,498,481,17,151,3,0.03950104,0,hg38,CD-0722-2
"C7,F9",5610,6449,4178,2271,3841,1991,0,1991,1344,647,2.077279753,1114,3140,610,295,289,6,102,2,0.141868512,0,empty,CD-0722-2
"C7,F10",6986,7696,5306,2390,4622,2346,0,2351,1514,837,1.808841099,1275,2182,443,208,208,0,58,0,0.125,0,empty,CD-0722-2
"C7,F11",576992,674281,422080,252201,388985,225624,2,225812,181446,44366,4.089753415,131237,125365,21488,8533,8383,150,1391,9,0.060360253,0,hg38,CD-0722-2
"C7,F12",6110,6824,4437,2387,4086,2199,0,2201,1402,799,1.754693367,1267,372,91,47,46,1,24,1,0.065217391,0,empty,CD-0722-2
"C7,G1",6577,7322,4911,2411,4387,2264,0,2264,1426,838,1.701670644,1267,3599,841,340,337,3,114,2,0.115727003,0,empty,CD-0722-2
"C7,G2",1649534,1993580,1122274,871306,1143284,719717,2,720164,594385,125779,4.725629875,448177,124378,23133,8903,8786,117,1525,6,0.052242204,0,hg38,CD-0722-2
"C7,G3",7401,8198,5410,2788,4922,2769,0,2774,1698,1076,1.578066914,1526,2360,587,228,217,11,93,3,0.110599078,0,empty,CD-0722-2
"C7,G4",630925,704003,485690,218313,405065,199838,4,200000,158694,41306,3.841911587,110024,499,75,44,44,0,24,0,0.090909091,0,empty,CD-0722-2
"C7,G5",5057,5765,3644,2121,3311,1813,0,1820,1165,655,1.778625954,1035,2252,649,281,279,2,77,1,0.114695341,0,empty,CD-0722-2
"C7,G6",6790,7727,4918,2809,4517,2392,1,2395,1591,804,1.978855721,1390,319,22,19,18,1,10,1,0.166666667,0,empty,CD-0722-2
"C7,G7",5065,5632,3804,1828,3459,1772,0,1779,1175,604,1.945364238,1018,3105,880,319,315,4,81,2,0.142857143,0,empty,CD-0722-2
"C7,G8",3820,4249,2764,1485,2523,1339,0,1339,873,466,1.873390558,759,2732,721,245,242,3,78,2,0.05785124,0,empty,CD-0722-2
"C7,G9",4291,4750,3154,1596,2929,1569,0,1569,1044,525,1.988571429,902,2907,532,234,231,3,75,1,0.017316017,0,empty,CD-0722-2
"C7,G10",5568,6428,4090,2338,3822,2164,0,2167,1375,792,1.736111111,1240,3079,736,337,335,2,106,1,0.110447761,0,empty,CD-0722-2
"C7,G11",682371,814060,495820,318240,468937,286233,1,286426,221922,64504,3.440437802,167744,62004,28023,9983,9958,25,1554,2,0.017774654,0,hg38,CD-0722-2
"C7,G12",4775,5737,3396,2341,3395,1963,0,1963,1239,724,1.711325967,1196,2751,789,349,344,5,116,2,0.061046512,0,empty,CD-0722-2
"C7,H1",4932,5474,3626,1848,3311,1778,0,1779,1170,609,1.921182266,1014,1723,373,190,188,2,70,2,0.138297872,0,empty,CD-0722-2
"C7,H2",5645,6395,4116,2279,3819,2095,0,2097,1346,751,1.792276964,1217,3242,884,364,363,1,116,1,0.063360882,0,empty,CD-0722-2
"C7,H3",4912,5817,3502,2315,3376,1943,0,1943,1240,703,1.763869132,1170,1835,240,126,122,4,63,3,0.032786885,0,empty,CD-0722-2
"C7,H4",6991,8066,5080,2986,4763,2563,0,2565,1731,834,2.075539568,1522,259,41,26,25,1,19,1,0.08,0,empty,CD-0722-2
"C7,H5",7413,8655,5280,3375,5109,2887,0,2888,1809,1079,1.676552363,1753,2295,563,275,273,2,105,2,0.06959707,0,empty,CD-0722-2
"C7,H6",4562,5352,3225,2127,3094,1787,1,1788,1201,587,2.045996593,1070,2657,616,252,249,3,70,1,0.100401606,0,empty,CD-0722-2
"C7,H7",5045,5573,3703,1870,3428,1824,0,1825,1193,632,1.887658228,1036,2987,680,294,292,2,115,1,0.034246575,0,empty,CD-0722-2
"C7,H8",5704,6675,4129,2546,3968,2266,0,2269,1450,819,1.77045177,1364,2930,611,280,278,2,102,1,0.068345324,0,empty,CD-0722-2
"C7,H9",4381,4829,3287,1542,2898,1535,0,1535,1003,532,1.885338346,839,1557,377,149,146,3,49,2,0.061643836,0,empty,CD-0722-2
"C7,H10",4608,5257,3476,1781,3140,1681,0,1683,1141,542,2.105166052,973,2219,541,253,251,2,84,2,0.03187251,0,empty,CD-0722-2
"C7,H11",5989,7213,4068,3145,4315,2836,0,2840,1550,1290,1.201550388,1733,98,20,14,14,0,8,0,0,0,empty,CD-0722-2
"C7,H12",4471,5132,3213,1919,3043,1759,0,1759,1172,587,1.996592845,1021,1767,312,163,163,0,50,0,0.09202454,0,empty,CD-0722-2
"C8,A1",3929,4540,2780,1760,2752,1578,0,1583,1027,556,1.847122302,917,1386,391,122,122,0,35,0,0.098360656,0,empty,CD-0722-2
"C8,A2",5748,6606,4072,2534,3979,2290,0,2295,1374,921,1.491856678,1327,2009,547,224,222,2,43,2,0.045045045,0,empty,CD-0722-2
"C8,A3",465096,559370,334105,225265,324045,192256,0,192404,155318,37086,4.188049399,116845,116842,15770,6234,6064,170,1165,6,0.047823219,0,hg38,CD-0722-2
"C8,A4",5702,6318,4183,2135,3810,2044,0,2045,1284,761,1.687253614,1167,911,322,126,126,0,34,0,0.111111111,0,empty,CD-0722-2
"C8,A5",4837,5261,3598,1663,3240,1678,0,1680,1060,620,1.709677419,947,2125,507,193,189,4,57,2,0.201058201,0,empty,CD-0722-2
"C8,A6",4512,5536,3215,2321,3293,1953,0,1954,1227,727,1.687757909,1208,3019,688,276,270,6,84,2,0.066666667,0,empty,CD-0722-2
"C8,A7",3878,4481,2824,1657,2700,1596,0,1597,1053,544,1.935661765,920,1229,367,134,131,3,41,2,0.106870229,0,empty,CD-0722-2
"C8,A8",202965,225800,159331,66469,133497,63740,1,63789,48369,15420,3.136770428,35102,23078,4874,1945,1909,36,440,3,0.052383447,0,hg38,CD-0722-2
"C8,A9",4177,4729,3127,1602,2798,1506,0,1508,1007,501,2.00998004,829,1486,303,134,131,3,42,2,0.129770992,0,empty,CD-0722-2
"C8,A10",4909,5610,3635,1975,3295,1730,0,1734,1123,611,1.83797054,1011,457,66,30,29,1,17,1,0.103448276,0,empty,CD-0722-2
"C8,A11",3426,3947,2528,1419,2398,1324,0,1325,860,465,1.849462366,771,1928,388,142,142,0,43,0,0.154929577,0,empty,CD-0722-2
"C8,A12",5170,5848,3826,2022,3515,1875,0,1878,1263,615,2.053658537,1097,3057,659,276,275,1,81,1,0.047272727,0,empty,CD-0722-2
"C8,B1",4203,4994,2944,2050,3042,1823,0,1823,1098,725,1.514482759,1136,1094,308,111,111,0,40,0,0.018018018,0,empty,CD-0722-2
"C8,B2",4749,5430,3213,2217,3267,1973,0,1975,1289,686,1.879008746,1172,577,104,53,52,1,23,1,0.134615385,0,empty,CD-0722-2
"C8,B3",4054,4534,2956,1578,2740,1510,1,1513,971,542,1.791512915,877,1466,280,133,131,2,49,1,0.022900763,0,empty,CD-0722-2
"C8,B4",6215,6970,4089,2881,4140,2551,0,2554,1659,895,1.853631285,1561,3266,531,232,224,8,70,4,0.053571429,0,empty,CD-0722-2
"C8,B5",409929,217717,142282,75435,156514,78815,9,79472,60303,19169,3.145860504,48830,49171,8354,3037,2997,40,562,3,0.037704371,0,hg38,CD-0722-2
"C8,B6",4612,5337,3306,2031,3283,1930,0,1932,1184,748,1.582887701,1163,1644,406,153,151,2,46,2,0.033112583,0,empty,CD-0722-2
"C8,B7",1043779,1172783,805668,367115,667805,339997,1,340269,277983,62286,4.463009344,190161,60351,9641,3507,3456,51,696,2,0.027777778,0,hg38,CD-0722-2
"C8,B8",11643,12791,8709,4082,7653,3827,0,3833,2838,995,2.852261307,2129,2598,461,193,191,2,70,1,0.141361257,0,empty,CD-0722-2
"C8,B9",412601,468776,308864,159912,269781,143148,0,143293,111933,31360,3.569292092,82376,30745,5031,1896,1861,35,396,3,0.013970983,0,hg38,CD-0722-2
"C8,B10",2920,3050,2063,987,1890,1032,0,1034,683,351,1.945868946,539,508,87,44,44,0,16,0,0.045454545,0,empty,CD-0722-2
"C8,B11",11687,13783,8459,5324,8051,4660,0,4661,3074,1587,1.936988028,2821,334,137,50,49,1,11,1,0.244897959,0,empty,CD-0722-2
"C8,B12",969884,1125966,722499,403467,649110,358047,2,358345,289426,68919,4.199509569,209852,127376,20199,7495,7324,171,1214,6,0.049972693,0,hg38,CD-0722-2
"C8,C1",1803243,2052079,1363432,688647,1141821,621204,1,621738,503851,117887,4.274016643,353359,168616,21043,8252,8080,172,1438,7,0.056930693,0,hg38,CD-0722-2
"C8,C2",5983,6778,4291,2487,4054,2240,0,2240,1455,785,1.853503185,1306,2181,522,214,212,2,65,2,0.20754717,0,empty,CD-0722-2
"C8,C3",5986,6801,4446,2355,4136,2240,0,2249,1452,797,1.82183187,1226,1188,282,102,102,0,34,0,0,0,empty,CD-0722-2
"C8,C4",313843,387183,215858,171325,229175,149644,0,149751,113803,35948,3.165767219,93104,19401,10597,3698,3693,5,745,2,0.019225562,0,hg38,CD-0722-2
"C8,C5",7008,8030,5096,2934,4713,2631,0,2633,1795,838,2.142004773,1479,1711,503,195,195,0,50,0,0.128205128,0,empty,CD-0722-2
"C8,C6",4670,5338,3396,1942,3238,1807,0,1808,1168,640,1.825,1031,1720,492,170,170,0,47,0,0.141176471,0,empty,CD-0722-2
"C8,C7",6713,8021,4730,3291,4843,2985,0,2987,1772,1215,1.458436214,1808,396,30,19,19,0,11,0,0.210526316,0,empty,CD-0722-2
"C8,C8",7409,8308,5487,2821,4900,2612,0,2614,1774,840,2.111904762,1439,3480,671,259,256,3,89,2,0.03125,0,empty,CD-0722-2
"C8,C9",5380,6201,3885,2316,3713,2070,0,2072,1366,706,1.934844193,1259,1476,304,139,137,2,38,1,0.065693431,0,empty,CD-0722-2
"C8,C10",5576,6394,4130,2264,3783,2030,0,2032,1294,738,1.753387534,1128,2120,404,139,137,2,42,1,0.058394161,0,empty,CD-0722-2
"C8,C11",4628,5451,3376,2075,3290,1863,0,1863,1189,674,1.764094955,1097,1705,418,173,169,4,48,1,0.26035503,0,empty,CD-0722-2
"C8,C12",6984,7903,5065,2838,4723,2509,0,2514,1645,869,1.892980437,1490,1652,369,182,182,0,57,0,0.027472527,0,empty,CD-0722-2
"C8,D1",233875,280341,162182,118159,166801,107610,3,107694,78104,29590,2.639540385,64446,15042,4084,1359,1352,7,323,2,0.013313609,0,hg38,CD-0722-2
"C8,D2",5026,5749,3718,2031,3532,1854,0,1858,1215,643,1.889580093,1080,2147,387,188,187,1,69,1,0.048128342,0,empty,CD-0722-2
"C8,D3",469729,542741,345906,196835,315099,176302,1,176441,144201,32240,4.472735732,103340,70514,5157,1881,1794,87,398,4,0.14548495,0,hg38,CD-0722-2
"C8,D4",3442,3978,2525,1453,2428,1385,0,1385,903,482,1.873443983,817,1252,291,114,109,5,40,2,0.100917431,0,empty,CD-0722-2
"C8,D5",4073,4847,2976,1871,2881,1634,0,1634,1087,547,1.987202925,982,1700,329,147,147,0,47,0,0.074829932,0,empty,CD-0722-2
"C8,D6",479745,565045,350909,214136,325251,183335,0,183515,138950,44565,3.117917648,110001,136490,19208,7364,7213,151,1262,6,0.053791765,0,hg38,CD-0722-2
"C8,D7",3502,3990,2448,1542,2348,1267,0,1267,835,432,1.93287037,728,1919,389,169,166,3,70,1,0.030120482,0,empty,CD-0722-2
"C8,D8",4492,5108,3314,1794,3013,1639,0,1639,1085,554,1.958483755,958,1632,619,200,200,0,66,0,0.035,0,empty,CD-0722-2
"C8,D9",3069,3200,2334,866,2006,997,0,999,718,281,2.555160142,509,1269,268,93,93,0,22,0,0,0,empty,CD-0722-2
"C8,D10",4435,5039,3283,1756,3079,1727,0,1728,1076,652,1.650306748,979,875,173,69,64,5,18,2,0.015625,0,empty,CD-0722-2
"C8,D11",4851,5557,3604,1953,3298,1764,0,1766,1108,658,1.683890578,1016,3519,1098,381,376,5,109,2,0.074468085,0,empty,CD-0722-2
"C8,D12",639687,768217,468577,299640,439668,256359,3,256565,200246,56319,3.555567393,153551,150919,22109,8432,8235,197,1495,8,0.026836673,0,hg38,CD-0722-2
"C8,E1",7498,8574,5365,3209,5136,2902,0,2911,1865,1046,1.782982792,1693,2424,626,253,248,5,70,2,0.161290323,0,empty,CD-0722-2
"C8,E2",4863,5642,3485,2157,3463,1922,0,1927,1210,717,1.687587169,1185,1870,486,175,172,3,44,2,0.029069767,0,empty,CD-0722-2
"C8,E3",3369,3879,2484,1395,2380,1266,0,1266,834,432,1.930555556,742,2437,532,204,204,0,59,0,0.102941176,0,empty,CD-0722-2
"C8,E4",4972,5735,3593,2142,3472,1944,0,1946,1248,698,1.787965616,1142,2392,582,248,239,9,79,2,0.037656904,0,empty,CD-0722-2
"C8,E5",4030,4472,3031,1441,2733,1402,0,1406,865,541,1.598890943,787,1138,260,102,102,0,34,0,0.058823529,0,empty,CD-0722-2
"C8,E6",35475,39816,25724,14092,23251,13060,0,13067,10697,2370,4.51350211,7343,5370,1803,682,674,8,165,2,0.081602374,0,empty,CD-0722-2
"C8,E7",6877,7606,5126,2480,4565,2416,0,2420,1615,805,2.00621118,1325,2696,567,240,236,4,78,2,0.038135593,0,empty,CD-0722-2
"C8,E8",30986,36386,22511,13875,21406,12839,0,12858,9248,3610,2.561772853,7473,3027,525,228,227,1,73,1,0.026431718,0,empty,CD-0722-2
"C8,E9",3699,4306,2736,1570,2544,1376,0,1376,933,443,2.106094808,799,2357,584,227,224,3,64,1,0.026785714,0,empty,CD-0722-2
"C8,E10",3782,4401,2710,1691,2656,1401,0,1401,980,421,2.327790974,855,1643,445,148,145,3,47,1,0.124137931,0,empty,CD-0722-2
"C8,E11",4626,5115,3386,1729,3142,1750,0,1752,1107,645,1.71627907,944,2742,475,163,162,1,52,1,0.043209877,0,empty,CD-0722-2
"C8,E12",5555,6260,3988,2272,3792,2082,0,2082,1407,675,2.084444444,1214,1755,296,141,137,4,54,3,0.094890511,0,empty,CD-0722-2
"C8,F1",533282,483651,466137,17514,265225,36909,0,37043,28325,8718,3.249025006,9319,99764,12887,5072,4936,136,973,8,0.05328201,0,empty,CD-0722-2
"C8,F2",4795,5284,3542,1742,3197,1682,0,1686,1087,599,1.814691152,920,3003,658,267,267,0,82,0,0.007490637,0,empty,CD-0722-2
"C8,F3",4646,5108,3409,1699,3121,1638,0,1639,1010,629,1.60572337,936,2338,495,223,219,4,66,2,0.077625571,0,empty,CD-0722-2
"C8,F4",1008775,1099548,779015,320533,627494,301053,8,301346,234406,66940,3.501732895,167871,23869,3100,1151,1121,30,279,5,0.011596789,0,hg38,CD-0722-2
"C8,F5",5388,5850,3954,1896,3448,1767,0,1767,1178,589,2,986,2381,511,191,191,0,59,0,0.031413613,0,empty,CD-0722-2
"C8,F6",5574,6559,4002,2557,3789,2126,0,2128,1363,765,1.781699346,1244,2675,653,245,244,1,69,1,0.077868852,0,empty,CD-0722-2
"C8,F7",6153,7032,4479,2553,4143,2270,0,2275,1496,779,1.920410783,1321,1075,333,151,149,2,34,2,0.006711409,0,empty,CD-0722-2
"C8,F8",4475,5002,3331,1671,3016,1599,0,1599,1045,554,1.886281588,901,354,88,43,42,1,24,1,0.166666667,0,empty,CD-0722-2
"C8,F9",5297,5887,3890,1997,3602,1890,1,1891,1311,580,2.260344828,1064,2664,609,259,255,4,93,2,0.043137255,0,empty,CD-0722-2
"C8,F10",5998,6798,4558,2240,4045,2104,0,2105,1379,726,1.899449036,1167,1780,308,123,117,6,47,1,0.025641026,0,empty,CD-0722-2
"C8,F11",5108,5785,3798,1987,3456,1813,0,1818,1241,577,2.150779896,1020,1658,352,142,141,1,44,1,0.120567376,0,empty,CD-0722-2
"C8,F12",5764,6317,4181,2136,3730,1997,0,1998,1359,639,2.126760563,1129,225,35,19,18,1,14,1,0.055555556,0,empty,CD-0722-2
"C8,G1",5467,6182,4026,2156,3778,1980,0,1984,1313,671,1.956780924,1172,2756,696,264,261,3,85,1,0.08045977,0,empty,CD-0722-2
"C8,G2",4304,4752,2960,1792,2901,1642,0,1644,1078,566,1.90459364,942,771,216,77,73,4,32,1,0.054794521,0,empty,CD-0722-2
"C8,G3",6652,7385,4957,2428,4477,2423,0,2427,1441,986,1.461460446,1291,2104,489,197,193,4,65,1,0.041450777,0,empty,CD-0722-2
"C8,G4",633693,740227,462452,277775,425611,243589,2,243778,201741,42037,4.799129338,143600,2191,429,198,198,0,44,0,0.101010101,0,hg38,CD-0722-2
"C8,G5",3744,4303,2804,1499,2646,1471,0,1472,971,501,1.938123752,860,1694,395,168,168,0,57,0,0.041666667,0,empty,CD-0722-2
"C8,G6",608780,736132,428280,307852,426605,280664,0,280854,211903,68951,3.073240417,164853,2001,386,132,123,9,44,2,0.016260163,0,hg38,CD-0722-2
"C8,G7",4188,4749,3226,1523,2908,1453,1,1461,957,504,1.898809524,794,2715,698,263,262,1,53,1,0.049618321,0,empty,CD-0722-2
"C8,G8",3504,3964,2571,1393,2402,1306,1,1308,837,471,1.777070064,782,1625,430,188,188,0,62,0,0.042553191,0,empty,CD-0722-2
"C8,G9",4055,4716,2981,1735,2841,1517,0,1519,967,552,1.751811594,900,2216,511,224,221,3,71,2,0.045248869,0,empty,CD-0722-2
"C8,G10",4938,5629,3587,2042,3351,1888,0,1894,1246,648,1.922839506,1078,1945,507,184,184,0,49,0,0.070652174,0,empty,CD-0722-2
"C8,G11",497819,554576,386377,168199,317556,153063,1,153225,112217,41008,2.736466055,85016,103077,10300,3772,3634,138,729,5,0.037974684,0,hg38,CD-0722-2
"C8,G12",807535,962259,602659,359600,559259,319216,1,319439,263125,56314,4.672461555,189253,351074,52788,20334,19843,491,2610,9,0.053116968,0,hg38,CD-0722-2
"C8,H1",4648,5337,3322,2015,3290,1827,0,1833,1209,624,1.9375,1119,1455,451,197,197,0,54,0,0.355329949,0,empty,CD-0722-2
"C8,H2",4919,5711,3609,2102,3367,1822,1,1826,1194,632,1.889240506,1063,3102,979,353,347,6,82,2,0.109510086,0,empty,CD-0722-2
"C8,H3",4199,4937,3060,1877,2831,1568,0,1569,1037,532,1.94924812,896,1528,389,171,169,2,65,1,0.059171598,0,empty,CD-0722-2
"C8,H4",1033830,1177482,767740,409742,664818,364025,2,364336,313334,51002,6.143562998,212244,4990,756,295,292,3,94,2,0.065068493,0,hg38,CD-0722-2
"C8,H5",6318,6899,4608,2291,4108,2207,0,2211,1455,756,1.924603175,1191,2053,555,261,257,4,83,1,0.031128405,0,empty,CD-0722-2
"C8,H6",4259,4970,3051,1919,2980,1701,0,1702,1198,504,2.376984127,998,2192,517,215,212,3,87,1,0.16509434,0,empty,CD-0722-2
"C8,H7",4889,5358,3541,1817,3246,1710,0,1710,1128,582,1.93814433,957,2231,424,182,182,0,69,0,0.071428571,0,empty,CD-0722-2
"C8,H8",5176,6116,3709,2407,3629,2058,0,2062,1353,709,1.90832158,1263,2359,509,178,170,8,61,2,0.029411765,0,empty,CD-0722-2
"C8,H9",4014,4463,2977,1486,2711,1381,0,1381,918,463,1.982721382,807,894,141,64,63,1,22,1,0.079365079,0,empty,CD-0722-2
"C8,H10",12403,14251,9295,4956,8133,4342,0,4344,3115,1229,2.53458096,2493,7532,1506,568,558,10,134,4,0.032258065,0,empty,CD-0722-2
"C8,H11",5384,6463,3626,2837,3826,2510,0,2510,1293,1217,1.062448644,1497,76,11,8,8,0,6,0,0,0,empty,CD-0722-2
"C8,H12",4219,4874,2992,1882,2876,1625,0,1626,1116,510,2.188235294,1000,1368,195,69,65,4,35,1,0.030769231,0,empty,CD-0722-2
"C9,A1",3613,4232,2523,1709,2525,1503,0,1503,945,558,1.693548387,921,1398,252,127,126,1,53,1,0.198412698,0,empty,CD-0722-2
"C9,A2",5219,5855,3731,2124,3485,1946,0,1946,1182,764,1.547120419,1142,1595,300,135,133,2,66,2,0.052631579,0,empty,CD-0722-2
"C9,A3",3177,3535,2325,1210,2211,1234,0,1234,804,430,1.869767442,717,1511,278,140,137,3,66,2,0.04379562,0,empty,CD-0722-2
"C9,A4",5606,6293,4106,2187,3817,2096,0,2100,1363,737,1.849389417,1157,1086,222,93,89,4,43,2,0.213483146,0,empty,CD-0722-2
"C9,A5",4619,5232,3260,1972,3210,1771,0,1773,1066,707,1.507779349,1049,2659,662,272,271,1,74,1,0.136531365,0,empty,CD-0722-2
"C9,A6",6835,7755,5056,2699,4783,2676,0,2676,1921,755,2.544370861,1523,3326,753,326,319,7,131,2,0.034482759,0,empty,CD-0722-2
"C9,A7",3497,4123,2516,1607,2430,1366,0,1369,806,563,1.431616341,813,1529,250,120,120,0,59,0,0.008333333,0,empty,CD-0722-2
"C9,A8",2224,2585,1655,930,1559,837,0,837,561,276,2.032608696,490,2717,791,349,346,3,100,2,0.028901734,0,empty,CD-0722-2
"C9,A9",730289,859970,551842,308128,491350,270408,1,270680,223593,47087,4.748508081,156522,188253,26296,10150,9942,208,1721,5,0.057433112,0,hg38,CD-0722-2
"C9,A10",4425,4701,3300,1401,2861,1495,0,1496,882,614,1.436482085,806,620,148,75,75,0,28,0,0.026666667,0,empty,CD-0722-2
"C9,A11",799308,902326,610142,292184,515573,269153,0,269402,226244,43158,5.242226238,151738,121626,16784,6224,6058,166,1125,8,0.032188841,0,hg38,CD-0722-2
"C9,A12",4500,4979,3232,1747,2923,1530,0,1535,974,561,1.736185383,894,3894,830,369,366,3,127,1,0.131147541,0,empty,CD-0722-2
"C9,B1",3929,4529,2871,1658,2695,1510,0,1511,934,577,1.618717504,886,1575,389,179,175,4,71,1,0.102857143,0,empty,CD-0722-2
"C9,B2",4210,4894,2862,2032,2951,1796,0,1796,1118,678,1.648967552,1094,745,124,69,67,2,38,1,0.044776119,0,empty,CD-0722-2
"C9,B3",3346,3976,2400,1576,2405,1345,0,1345,877,468,1.873931624,822,1961,428,186,186,0,77,0,0.086021505,0,empty,CD-0722-2
"C9,B4",308659,331952,242249,89703,194527,87703,0,87790,70324,17466,4.026336883,46824,25830,4342,1642,1606,36,358,3,0.03113325,0,hg38,CD-0722-2
"C9,B5",824009,346811,192902,153909,263093,151098,14,152622,110540,42082,2.626776294,103829,28918,3265,1125,1092,33,347,3,0.017399267,0,hg38,CD-0722-2
"C9,B6",458397,540099,335368,204731,312521,178088,1,178226,139888,38338,3.648807971,106126,148092,20029,7760,7569,191,1362,6,0.074118113,0,hg38,CD-0722-2
"C9,B7",3943,4478,2894,1584,2696,1495,1,1496,1013,483,2.097308489,845,1266,289,118,117,1,52,1,0.034188034,0,empty,CD-0722-2
"C9,B8",722032,838936,531826,307110,483648,272170,2,272409,227007,45402,4.999933924,159100,158947,25177,9644,9484,160,1610,7,0.090995361,0,hg38,CD-0722-2
"C9,B9",5419,6141,3940,2201,3708,2071,0,2074,1239,835,1.483832335,1180,1632,298,158,157,1,71,1,0.031847134,0,empty,CD-0722-2
"C9,B10",2584,2869,1858,1011,1795,990,0,992,609,383,1.590078329,566,746,39,28,24,4,17,2,0.166666667,0,empty,CD-0722-2
"C9,B11",517740,627702,359984,267718,362413,239886,3,240070,179876,60194,2.988271256,143276,537,112,75,75,0,42,0,0.08,0,empty,CD-0722-2
"C9,B12",3438,4009,2540,1469,2430,1353,0,1354,875,479,1.826722338,793,1882,338,158,156,2,72,2,0.083333333,0,empty,CD-0722-2
"C9,C1",6820,7543,5048,2495,4561,2443,0,2446,1514,932,1.624463519,1343,962,186,90,86,4,38,2,0.046511628,0,empty,CD-0722-2
"C9,C2",5819,6570,4184,2386,3920,2208,0,2210,1439,771,1.866407263,1242,2688,693,247,242,5,81,2,0.095041322,0,empty,CD-0722-2
"C9,C3",699938,868236,501346,366890,499105,305273,1,305490,243444,62046,3.923605067,188813,29154,6043,2329,2307,22,489,2,0.066753359,0,hg38,CD-0722-2
"C9,C4",3488,4070,2642,1428,2445,1285,0,1286,835,451,1.851441242,755,1602,451,200,197,3,69,2,0.050761421,0,empty,CD-0722-2
"C9,C5",5112,5780,3680,2100,3398,1873,0,1878,1236,642,1.925233645,1047,2440,456,173,170,3,78,2,0.029411765,0,empty,CD-0722-2
"C9,C6",4586,5254,3305,1949,3159,1759,0,1762,1173,589,1.991511036,1024,1597,362,177,176,1,62,1,0.107954545,0,empty,CD-0722-2
"C9,C7",6246,7565,4301,3264,4499,2722,0,2722,1656,1066,1.553470919,1677,590,35,24,24,0,18,0,0.041666667,0,empty,CD-0722-2
"C9,C8",6550,7363,4780,2583,4435,2356,0,2357,1545,812,1.90270936,1345,3413,693,340,334,6,160,2,0.047904192,0,empty,CD-0722-2
"C9,C9",4804,5522,3535,1987,3324,1828,0,1830,1164,666,1.747747748,1071,1652,245,120,119,1,55,1,0.016806723,0,empty,CD-0722-2
"C9,C10",5426,6096,4000,2096,3658,2003,0,2011,1286,725,1.773793103,1134,2211,512,179,176,3,71,2,0.102272727,0,empty,CD-0722-2
"C9,C11",4602,5278,3245,2033,3191,1781,0,1781,1137,644,1.76552795,1060,1951,477,203,201,2,74,2,0.07960199,0,empty,CD-0722-2
"C9,C12",6289,7081,4553,2528,4248,2254,0,2256,1517,739,2.052774019,1287,2319,415,211,208,3,74,2,0.120192308,0,empty,CD-0722-2
"C9,D1",6113,7034,4399,2635,4265,2537,0,2543,1530,1013,1.510365252,1483,1181,157,50,49,1,24,1,0.06122449,0,empty,CD-0722-2
"C9,D2",4805,5261,3619,1642,3223,1622,0,1622,1060,562,1.886120996,922,2725,677,279,279,0,99,0,0.035842294,0,empty,CD-0722-2
"C9,D3",4245,4802,3025,1777,2867,1603,0,1603,1044,559,1.867620751,916,1884,429,183,182,1,78,1,0.082417582,0,empty,CD-0722-2
"C9,D4",3354,4010,2460,1550,2377,1370,0,1370,906,464,1.952586207,808,1832,488,186,182,4,53,2,0.104395604,0,empty,CD-0722-2
"C9,D5",3786,4202,2809,1393,2512,1344,0,1344,869,475,1.829473684,722,2110,407,166,165,1,50,1,0.024242424,0,empty,CD-0722-2
"C9,D6",5874,6989,4048,2941,4084,2413,0,2417,1451,966,1.502070393,1494,2457,537,241,236,5,88,3,0.042372881,0,empty,CD-0722-2
"C9,D7",789476,887703,597604,290099,508648,263010,1,263229,201906,61323,3.292500367,149790,151939,24495,9012,8846,166,1538,5,0.03300927,0,hg38,CD-0722-2
"C9,D8",4113,4517,3047,1470,2712,1447,0,1450,959,491,1.953156823,825,1845,465,208,203,5,68,2,0.039408867,0,empty,CD-0722-2
"C9,D9",1884,2139,1418,721,1295,670,0,671,432,239,1.807531381,383,1432,245,123,120,3,48,3,0.033333333,0,empty,CD-0722-2
"C9,D10",4392,5181,3235,1946,3167,1775,0,1776,1133,643,1.762052877,1037,1255,391,144,142,2,46,1,0.098591549,0,empty,CD-0722-2
"C9,D11",500629,579319,371863,207456,332792,179348,3,179543,150469,29074,5.175380065,103858,328018,51254,20141,19820,321,2671,9,0.080776993,0,hg38,CD-0722-2
"C9,D12",5534,6431,3979,2452,3830,2131,0,2131,1382,749,1.845126836,1284,4307,950,440,438,2,155,2,0.043378995,0,empty,CD-0722-2
"C9,E1",6726,7568,4815,2753,4531,2569,0,2575,1612,963,1.673935618,1508,2613,464,221,219,2,87,2,0.132420091,0,empty,CD-0722-2
"C9,E2",4682,5458,3315,2143,3270,1855,0,1856,1139,717,1.588563459,1144,2384,407,170,167,3,72,2,0.077844311,0,empty,CD-0722-2
"C9,E3",3179,3514,2326,1188,2092,1091,0,1093,696,397,1.753148615,611,2546,759,281,280,1,110,1,0.017857143,0,empty,CD-0722-2
"C9,E4",587142,691661,436520,255141,395760,218122,0,218285,167523,50762,3.300165478,128997,125460,16237,6202,6052,150,1101,7,0.061797753,0,hg38,CD-0722-2
"C9,E5",3899,4624,2838,1786,2765,1532,0,1534,1005,529,1.899810964,910,1516,368,168,167,1,63,1,0.149700599,0,empty,CD-0722-2
"C9,E6",7160,8274,5214,3060,4872,2687,0,2690,1768,922,1.917570499,1569,4576,1027,437,432,5,137,2,0.094907407,0,empty,CD-0722-2
"C9,E7",6138,6770,4593,2177,4001,2063,0,2065,1329,736,1.805706522,1136,4037,1036,372,363,9,133,2,0.085399449,0,empty,CD-0722-2
"C9,E8",5263,5797,3864,1933,3458,1799,0,1800,1206,594,2.03030303,1001,3018,735,275,275,0,84,0,0.04,0,empty,CD-0722-2
"C9,E9",3532,3858,2675,1183,2388,1242,0,1242,783,459,1.705882353,664,2878,588,278,276,2,115,2,0.15942029,0,empty,CD-0722-2
"C9,E10",523233,605233,384925,220308,352497,197922,0,198085,154851,43234,3.581694962,115336,38522,6519,2423,2397,26,614,6,0.046725073,0,hg38,CD-0722-2
"C9,E11",530142,598857,404514,194343,347739,181659,2,181859,140169,41690,3.362173183,102503,45334,6560,2466,2419,47,565,3,0.014055395,0,hg38,CD-0722-2
"C9,E12",440397,512512,326982,185530,299141,162343,0,162484,123615,38869,3.180297924,96363,101464,11273,4462,4304,158,837,7,0.030669145,0,hg38,CD-0722-2
"C9,F1",5827,6428,4210,2218,3992,2179,0,2179,1383,796,1.737437186,1260,2470,567,231,228,3,90,2,0.052631579,0,empty,CD-0722-2
"C9,F2",5034,5770,3666,2104,3411,1876,0,1880,1178,702,1.678062678,1067,3339,781,329,324,5,110,2,0.043209877,0,empty,CD-0722-2
"C9,F3",4164,4774,3123,1651,2850,1526,0,1532,975,557,1.750448833,849,2776,458,199,197,2,75,2,0.060913706,0,empty,CD-0722-2
"C9,F4",6650,7313,4898,2415,4308,2226,0,2236,1470,766,1.919060052,1217,1135,294,134,129,5,58,2,0.007751938,0,empty,CD-0722-2
"C9,F5",5244,5849,3854,1995,3532,1836,0,1836,1205,631,1.909667195,1077,2565,668,325,319,6,121,2,0.034482759,0,empty,CD-0722-2
"C9,F6",5137,5900,3705,2195,3505,1972,0,1972,1269,703,1.80512091,1151,3423,707,247,240,7,78,2,0.183333333,0,empty,CD-0722-2
"C9,F7",1443657,1711266,1074380,636886,972223,556758,2,557257,487171,70086,6.951045858,327179,51137,8934,3488,3429,59,746,4,0.030912803,0,hg38,CD-0722-2
"C9,F8",4243,4756,3201,1555,2934,1636,0,1640,1089,551,1.976406534,903,652,59,43,43,0,35,0,0.069767442,0,empty,CD-0722-2
"C9,F9",4972,5488,3571,1917,3370,1853,0,1853,1285,568,2.262323944,1006,3476,894,366,360,6,119,2,0.127777778,0,empty,CD-0722-2
"C9,F10",5827,6733,4374,2359,4006,2075,0,2079,1317,762,1.728346457,1171,2531,716,234,229,5,63,2,0.126637555,0,empty,CD-0722-2
"C9,F11",4473,4898,3354,1544,2970,1533,0,1535,1000,535,1.869158879,876,2275,368,157,157,0,55,0,0.210191083,0,empty,CD-0722-2
"C9,F12",4890,5468,3480,1988,3394,1890,0,1894,1189,705,1.686524823,1123,425,60,39,37,2,27,1,0.054054054,0,empty,CD-0722-2
"C9,G1",3018280,3098628,2457832,640796,1588106,640252,4,641114,507100,134014,3.783933022,332260,816529,125497,45848,45004,844,4486,10,0.054350724,0,hg38,CD-0722-2
"C9,G2",3297,3733,2295,1438,2258,1340,0,1342,863,479,1.801670146,776,922,155,98,96,2,47,1,0.052083333,0,empty,CD-0722-2
"C9,G3",6247,6904,4502,2402,4113,2237,0,2243,1334,909,1.467546755,1229,3089,817,296,283,13,116,2,0.024734982,0,empty,CD-0722-2
"C9,G4",11640,13546,8187,5359,8164,5039,0,5042,2997,2045,1.465525672,2996,249,39,27,26,1,15,1,0.115384615,0,empty,CD-0722-2
"C9,G5",3823,4333,2816,1517,2572,1460,0,1460,914,546,1.673992674,826,2209,453,203,198,5,78,2,0.045454545,0,empty,CD-0722-2
"C9,G6",5997,6957,4318,2639,4154,2387,0,2389,1484,905,1.639779006,1385,305,28,20,17,3,15,2,0.176470588,0,empty,CD-0722-2
"C9,G7",4155,4619,3074,1545,2806,1442,0,1449,945,504,1.875,815,2708,667,281,276,5,74,2,0.057971014,0,empty,CD-0722-2
"C9,G8",2968,3227,2145,1082,1980,1070,0,1070,719,351,2.048433048,593,2060,522,231,231,0,87,0,0.03030303,0,empty,CD-0722-2
"C9,G9",3788,4178,2747,1431,2532,1356,0,1359,849,510,1.664705882,767,3032,604,248,245,3,87,1,0.06122449,0,empty,CD-0722-2
"C9,G10",3073024,3629536,2265902,1363634,2007990,1192579,8,1193525,968044,225481,4.293239785,702261,425709,98918,37172,36782,390,4032,9,0.04844761,0,hg38,CD-0722-2
"C9,G11",1080633,1254608,798545,456063,717662,406260,3,406566,360896,45670,7.90225531,237015,219204,42642,15984,15786,198,2152,7,0.042189282,0,hg38,CD-0722-2
"C9,G12",4015,4615,2896,1719,2724,1492,0,1497,961,536,1.792910448,850,3246,684,310,307,3,123,2,0.055374593,0,empty,CD-0722-2
"C9,H1",467182,558926,337449,221477,324732,187950,0,188097,148864,39233,3.794356791,114490,113366,15111,5539,5398,141,1053,7,0.049833272,0,hg38,CD-0722-2
"C9,H2",4956,5699,3542,2157,3478,1904,0,1905,1222,683,1.789165447,1128,2856,554,248,239,9,92,2,0.075313808,0,empty,CD-0722-2
"C9,H3",3926,4412,2806,1606,2717,1536,0,1538,999,539,1.853432282,894,1888,264,141,138,3,71,1,0.028985507,0,empty,CD-0722-2
"C9,H4",5561,6355,3938,2417,3860,2109,0,2109,1361,748,1.819518717,1250,268,37,29,28,1,22,1,0,0,empty,CD-0722-2
"C9,H5",654293,771812,484100,287712,440881,245097,1,245318,195506,49812,3.92487754,146087,165443,29124,11466,11218,248,1786,9,0.046175789,0,hg38,CD-0722-2
"C9,H6",3871,4260,2724,1536,2549,1446,0,1448,907,541,1.676524954,833,2196,489,233,226,7,87,1,0.154867257,0,empty,CD-0722-2
"C9,H7",4118,4566,3050,1516,2798,1445,0,1445,963,482,1.997925311,812,2610,516,238,225,13,114,2,0.022222222,0,empty,CD-0722-2
"C9,H8",490130,559537,369479,190058,320943,167885,0,168041,128511,39530,3.250973944,96868,158382,19582,7768,7563,205,1344,8,0.043633479,0,hg38,CD-0722-2
"C9,H9",3999,4464,2981,1483,2665,1397,0,1399,929,470,1.976595745,781,1529,317,110,107,3,45,2,0.177570093,0,empty,CD-0722-2
"C9,H10",3292,3535,2386,1149,2202,1168,0,1170,765,405,1.888888889,647,2081,427,195,193,2,97,1,0.046632124,0,empty,CD-0722-2
"C9,H11",4707,5491,3167,2324,3337,2184,0,2188,1180,1008,1.170634921,1360,164,22,14,13,1,8,1,0.076923077,0,empty,CD-0722-2
"C9,H12",3546,3930,2562,1368,2402,1368,0,1369,883,486,1.816872428,775,2130,412,192,191,1,80,1,0.083769634,0,empty,CD-0722-2
"C10,A1",4202,4892,3008,1884,2873,1700,0,1702,1148,554,2.072202166,979,1139,236,88,88,0,29,0,0.068181818,0,empty,CD-0722-2
"C10,A2",6441,7279,4672,2607,4341,2398,0,2402,1491,911,1.636663008,1379,1690,455,195,193,2,51,2,0.062176166,0,empty,CD-0722-2
"C10,A3",476531,570916,346942,223974,327310,189398,1,189557,145214,44343,3.274789708,114966,91508,13419,5167,5048,119,899,5,0.12163233,0,hg38,CD-0722-2
"C10,A4",5868,6654,4273,2381,3979,2171,0,2171,1412,759,1.860342556,1277,648,112,55,55,0,22,0,0.163636364,0,empty,CD-0722-2
"C10,A5",5267,5938,3799,2139,3518,1924,1,1927,1214,713,1.702664797,1095,2114,480,198,195,3,50,1,0.133333333,0,empty,CD-0722-2
"C10,A6",435047,536436,316873,219563,308074,184427,3,184560,150495,34065,4.417877587,111873,110431,14057,5871,5724,147,1077,5,0.056079665,0,hg38,CD-0722-2
"C10,A7",1075978,1274331,806862,467469,723857,406946,5,407319,314737,92582,3.399548508,239947,85344,11942,4637,4540,97,974,4,0.031057269,0,hg38,CD-0722-2
"C10,A8",2297,2617,1614,1003,1566,879,0,879,562,317,1.772870662,494,1810,397,167,165,2,58,2,0.048484848,0,empty,CD-0722-2
"C10,A9",4730,5233,3525,1708,3136,1687,0,1689,1108,581,1.907056799,916,1384,369,156,153,3,51,1,0.215686275,0,empty,CD-0722-2
"C10,A10",5561,6308,4252,2056,3736,2021,0,2021,1269,752,1.6875,1083,379,49,29,29,0,15,0,0.034482759,0,empty,CD-0722-2
"C10,A11",3971,4309,3014,1295,2656,1314,0,1316,899,417,2.1558753,725,1630,481,186,186,0,45,0,0.064516129,0,empty,CD-0722-2
"C10,A12",5775,6515,4299,2216,3892,2080,0,2085,1403,682,2.057184751,1185,3114,781,277,272,5,84,2,0.044117647,0,empty,CD-0722-2
"C10,B1",4564,5339,3368,1971,3145,1733,0,1739,1105,634,1.742902208,1018,1035,346,120,119,1,34,1,0.084033613,0,empty,CD-0722-2
"C10,B2",4753,5289,3250,2039,3213,1877,0,1877,1215,662,1.835347432,1090,639,152,75,75,0,22,0,0.013333333,0,empty,CD-0722-2
"C10,B3",4523,5515,3219,2296,3357,1971,0,1973,1305,668,1.953592814,1230,1562,359,165,165,0,51,0,0.006060606,0,empty,CD-0722-2
"C10,B4",308744,390992,209603,181389,228551,156816,0,156908,111375,45533,2.446028155,97470,8625,555,209,197,12,58,2,0.269035533,0,hg38,CD-0722-2
"C10,B5",4637,2654,1663,991,1891,1075,0,1078,722,356,2.028089888,662,874,137,71,71,0,26,0,0.281690141,0,empty,CD-0722-2
"C10,B6",5155,5962,3687,2275,3589,2101,0,2101,1374,727,1.889958735,1259,1830,375,134,133,1,50,1,0.060150376,0,empty,CD-0722-2
"C10,B7",4243,4808,3159,1649,2952,1585,0,1585,1030,555,1.855855856,888,1026,236,84,84,0,26,0,0.19047619,0,empty,CD-0722-2
"C10,B8",3527,4044,2642,1402,2450,1284,0,1286,858,428,2.004672897,715,1160,250,99,98,1,38,1,0.030612245,0,empty,CD-0722-2
"C10,B9",6996,8332,4998,3334,4989,2936,0,2940,1919,1021,1.879529873,1782,1155,385,159,158,1,60,1,0.018987342,0,empty,CD-0722-2
"C10,B10",3076,3450,2222,1228,2176,1225,0,1225,831,394,2.109137056,716,308,54,35,35,0,16,0,0.228571429,0,empty,CD-0722-2
"C10,B11",10127,11840,7160,4680,6963,4312,0,4313,2532,1781,1.421673217,2582,292,48,20,20,0,11,0,0,0,empty,CD-0722-2
"C10,B12",4256,5012,3105,1907,3030,1725,0,1731,1152,579,1.989637306,1028,1271,352,105,105,0,35,0,0.00952381,0,empty,CD-0722-2
"C10,C1",7391,8165,5483,2682,4829,2593,0,2593,1637,956,1.712343096,1432,664,122,47,46,1,26,1,0.043478261,0,empty,CD-0722-2
"C10,C2",6447,7377,4659,2718,4424,2541,0,2542,1631,911,1.790340285,1478,1904,580,268,267,1,69,1,0.056179775,0,empty,CD-0722-2
"C10,C3",6720,7582,4981,2601,4547,2471,1,2481,1596,885,1.803389831,1355,1111,196,64,63,1,25,1,0.349206349,0,empty,CD-0722-2
"C10,C4",4188,4604,3155,1449,2803,1464,0,1464,957,507,1.887573964,789,1251,260,122,118,4,47,1,0.177966102,0,empty,CD-0722-2
"C10,C5",6013,7111,4350,2761,4247,2400,0,2402,1618,784,2.06377551,1442,1611,364,144,143,1,40,1,0.132867133,0,empty,CD-0722-2
"C10,C6",5242,5901,3708,2193,3598,2033,0,2037,1287,750,1.716,1227,1165,157,80,80,0,34,0,0.05,0,empty,CD-0722-2
"C10,C7",602786,708592,444640,263952,405035,233845,2,234044,177481,56563,3.137757898,138046,18871,3137,1188,1161,27,301,2,0.01464255,0,hg38,CD-0722-2
"C10,C8",8130,9552,5856,3696,5748,3266,0,3268,2129,1139,1.869183494,1956,2675,571,217,214,3,80,2,0.065420561,0,empty,CD-0722-2
"C10,C9",10942,12775,8055,4720,7410,3952,0,3956,2735,1221,2.23996724,2298,6624,1372,547,545,2,127,1,0.062385321,0,empty,CD-0722-2
"C10,C10",516010,569580,399550,170030,324210,157166,0,157307,121924,35383,3.445835571,87124,49387,5393,2160,2117,43,516,6,0.021256495,0,hg38,CD-0722-2
"C10,C11",5146,6004,3647,2357,3553,1950,0,1956,1253,703,1.782361309,1188,1937,381,157,154,3,54,2,0.064935065,0,empty,CD-0722-2
"C10,C12",7797,8935,5671,3264,5240,2872,0,2876,1861,1015,1.833497537,1673,1757,267,113,110,3,34,2,0.145454545,0,empty,CD-0722-2
"C10,D1",7365,8393,5182,3211,5064,3008,0,3009,1806,1203,1.501246883,1785,843,157,61,60,1,18,1,0.066666667,0,empty,CD-0722-2
"C10,D2",5038,5594,3751,1843,3340,1734,0,1734,1102,632,1.743670886,942,2316,579,238,236,2,72,2,0.025423729,0,empty,CD-0722-2
"C10,D3",4673,5530,3365,2165,3227,1815,0,1816,1219,597,2.041876047,1087,1606,395,122,122,0,38,0,0.008196721,0,empty,CD-0722-2
"C10,D4",3712,4423,2747,1676,2543,1386,0,1389,919,470,1.955319149,787,1366,353,146,140,6,46,2,0.028571429,0,empty,CD-0722-2
"C10,D5",4401,5121,3246,1875,3116,1713,0,1715,1136,579,1.962003454,993,1668,417,174,172,2,62,1,0.104651163,0,empty,CD-0722-2
"C10,D6",6712,7666,4784,2882,4636,2750,0,2750,1715,1035,1.657004831,1613,1283,358,160,159,1,47,1,0.018867925,0,empty,CD-0722-2
"C10,D7",3894,4468,2956,1512,2764,1453,0,1453,1014,439,2.309794989,855,1888,470,204,198,6,64,2,0.070707071,0,empty,CD-0722-2
"C10,D8",5036,5649,3672,1977,3330,1790,0,1793,1137,656,1.733231707,1030,5346,827,363,356,7,96,2,0.092696629,0,empty,CD-0722-2
"C10,D9",2468,2783,1831,952,1705,933,0,933,598,335,1.785074627,538,987,254,119,119,0,40,0,0.016806723,0,empty,CD-0722-2
"C10,D10",4275,5101,3073,2028,3144,1801,0,1801,1118,683,1.636896047,1108,984,227,103,102,1,32,1,0,0,empty,CD-0722-2
"C10,D11",489304,572600,362634,209966,328941,183413,2,183595,148857,34738,4.285134435,107529,211339,30157,11590,11324,266,1867,6,0.052543271,0,hg38,CD-0722-2
"C10,D12",6233,7121,4646,2475,4171,2261,0,2263,1490,773,1.927554981,1290,3531,811,376,369,7,121,2,0.073170732,0,empty,CD-0722-2
"C10,E1",8203,9427,5881,3546,5532,3061,0,3061,1943,1118,1.737924866,1767,2416,552,195,193,2,59,1,0.10880829,0,empty,CD-0722-2
"C10,E2",5456,6263,3880,2383,3755,2156,0,2160,1366,794,1.720403023,1274,2131,640,238,237,1,51,1,0.164556962,0,empty,CD-0722-2
"C10,E3",3712,4383,2768,1615,2583,1381,0,1381,919,462,1.989177489,824,2375,702,263,263,0,67,0,0.02661597,0,empty,CD-0722-2
"C10,E4",5185,5919,3877,2042,3551,1917,0,1917,1268,649,1.953775039,1081,2204,534,235,233,2,77,1,0.034334764,0,empty,CD-0722-2
"C10,E5",503039,617322,352035,265287,357220,237013,0,237196,169878,67318,2.523515256,140942,11030,668,271,248,23,67,3,0.221774194,0,hg38,CD-0722-2
"C10,E6",9042,10312,6649,3663,6015,3351,0,3351,2107,1244,1.693729904,1921,3700,822,385,382,3,108,2,0.078534031,0,empty,CD-0722-2
"C10,E7",8213,9233,6132,3101,5429,2843,0,2847,1944,903,2.15282392,1582,2388,675,269,261,8,68,2,0.122605364,0,empty,CD-0722-2
"C10,E8",5582,6238,4251,1987,3718,1894,0,1894,1237,657,1.882800609,1010,2798,667,290,289,1,87,1,0.183391003,0,empty,CD-0722-2
"C10,E9",4380,4967,3360,1607,2976,1593,0,1596,1016,580,1.751724138,885,2484,611,244,243,1,84,1,0.111111111,0,empty,CD-0722-2
"C10,E10",4108,4663,3046,1617,2746,1459,0,1461,985,476,2.069327731,839,1297,340,122,121,1,36,1,0.074380165,0,empty,CD-0722-2
"C10,E11",494556,557752,378892,178860,322717,163097,3,163273,119543,43730,2.733661102,92862,106474,11318,4296,4140,156,831,6,0.069082126,0,hg38,CD-0722-2
"C10,E12",6259,7203,4605,2598,4256,2318,0,2320,1557,763,2.040629096,1311,2156,441,156,151,5,52,2,0.006622517,0,empty,CD-0722-2
"C10,F1",6893,7843,5078,2765,4619,2520,0,2522,1600,922,1.735357918,1444,2103,522,214,214,0,61,0,0.065420561,0,empty,CD-0722-2
"C10,F2",5351,6227,3825,2402,3692,2010,0,2020,1304,716,1.82122905,1225,2891,696,306,301,5,86,2,0.106312292,0,empty,CD-0722-2
"C10,F3",4913,5719,3560,2159,3346,1810,0,1812,1199,613,1.955954323,1047,2324,477,223,221,2,69,1,0.140271493,0,empty,CD-0722-2
"C10,F4",7324,8150,5356,2794,4977,2600,0,2610,1716,894,1.919463087,1518,654,124,63,63,0,27,0,0.015873016,0,empty,CD-0722-2
"C10,F5",5927,6441,4323,2118,3899,2012,0,2012,1361,651,2.0906298,1122,2365,582,258,256,2,68,1,0.0234375,0,empty,CD-0722-2
"C10,F6",6309,7430,4504,2926,4337,2455,0,2458,1645,813,2.023370234,1485,2100,571,233,228,5,59,2,0.157894737,0,empty,CD-0722-2
"C10,F7",6215,7093,4529,2564,4308,2435,0,2438,1593,845,1.885207101,1421,1119,261,124,124,0,37,0,0.016129032,0,empty,CD-0722-2
"C10,F8",632287,745009,472147,272862,427303,238441,3,238630,191345,47285,4.046632124,138662,11441,1244,403,392,11,139,2,0.033163265,0,hg38,CD-0722-2
"C10,F9",5633,6410,4244,2166,3890,1991,0,1995,1329,666,1.995495495,1148,3033,574,233,222,11,72,2,0.018018018,0,empty,CD-0722-2
"C10,F10",6508,7314,4909,2405,4299,2257,0,2257,1479,778,1.901028278,1286,1986,667,270,270,0,47,0,0.003703704,0,empty,CD-0722-2
"C10,F11",6267,6916,4551,2365,3978,2064,0,2064,1427,637,2.240188383,1142,1551,320,165,156,9,42,2,0.102564103,0,empty,CD-0722-2
"C10,F12",5968,6739,4344,2395,3994,2123,0,2123,1416,707,2.002828854,1230,234,25,20,20,0,14,0,0.05,0,empty,CD-0722-2
"C10,G1",5988,6753,4420,2333,3951,2062,0,2067,1364,703,1.940256046,1168,2824,726,264,264,0,75,0,0.041666667,0,empty,CD-0722-2
"C10,G2",439420,500786,320191,180595,289728,158391,2,158508,120739,37769,3.196775133,92738,23820,5391,2007,1972,35,399,2,0.039046653,0,hg38,CD-0722-2
"C10,G3",481417,534224,371154,163070,304770,149725,0,149843,111392,38451,2.896985774,84064,43807,6830,2369,2314,55,498,3,0.023336214,0,hg38,CD-0722-2
"C10,G4",12479,14310,8902,5408,8406,5004,0,5007,3112,1895,1.642216359,2918,95,17,11,11,0,6,0,0,0,empty,CD-0722-2
"C10,G5",4437,5106,3200,1906,3020,1656,0,1656,1067,589,1.811544992,962,1905,375,134,132,2,47,2,0.098484848,0,empty,CD-0722-2
"C10,G6",450723,425276,379925,45351,239711,62698,1,62791,47729,15062,3.16883548,24160,338,89,40,39,1,30,1,0,0,empty,CD-0722-2
"C10,G7",4871,5321,3724,1597,3128,1578,0,1579,1055,524,2.013358779,846,2137,517,200,200,0,46,0,0.195,0,empty,CD-0722-2
"C10,G8",3626,4147,2668,1479,2452,1332,0,1332,872,460,1.895652174,793,1832,467,165,163,2,49,2,0.049079755,0,empty,CD-0722-2
"C10,G9",1031675,1225610,766068,459542,696574,395883,1,396225,312850,83375,3.752323838,235718,378943,69282,26337,25960,377,3131,9,0.048189522,0,hg38,CD-0722-2
"C10,G10",5404,6124,3949,2175,3661,2012,0,2017,1303,714,1.824929972,1143,2104,495,208,206,2,67,1,0.004854369,0,empty,CD-0722-2
"C10,G11",1469642,1746149,1100350,645799,981127,563937,0,564381,444100,120281,3.692187461,333102,102183,15088,5439,5322,117,1116,8,0.058624577,0,hg38,CD-0722-2
"C10,G12",4628,5518,3349,2169,3346,1931,0,1933,1265,668,1.893712575,1160,2238,401,181,177,4,74,3,0.039548023,0,empty,CD-0722-2
"C10,H1",5417,6240,4052,2188,3729,1991,0,1991,1391,600,2.318333333,1127,1308,262,113,109,4,48,1,0.018348624,0,empty,CD-0722-2
"C10,H2",5765,6698,4177,2521,3963,2145,0,2149,1458,691,2.109985528,1269,2505,611,251,249,2,76,1,0.044176707,0,empty,CD-0722-2
"C10,H3",4622,5316,3377,1939,3235,1786,0,1786,1220,566,2.155477032,1031,1451,362,136,136,0,51,0,0.073529412,0,empty,CD-0722-2
"C10,H4",550169,685107,378133,306974,391751,263921,0,264090,192035,72055,2.665116925,162829,386,62,34,31,3,15,1,0.064516129,0,empty,CD-0722-2
"C10,H5",6672,7424,4796,2628,4454,2459,0,2463,1649,814,2.025798526,1450,1730,410,195,194,1,78,1,0.06185567,0,empty,CD-0722-2
"C10,H6",4737,5532,3402,2130,3228,1842,0,1843,1260,583,2.161234991,1057,1675,366,174,173,1,54,1,0.040462428,0,empty,CD-0722-2
"C10,H7",5166,5759,3868,1891,3470,1824,0,1824,1256,568,2.211267606,1019,2080,430,173,173,0,73,0,0.098265896,0,empty,CD-0722-2
"C10,H8",6061,7048,4408,2640,4032,2297,0,2300,1548,752,2.058510638,1305,2544,572,245,241,4,77,2,0.037344398,0,empty,CD-0722-2
"C10,H9",4892,5530,3670,1860,3303,1756,0,1758,1238,520,2.380769231,966,989,211,96,96,0,26,0,0,0,empty,CD-0722-2
"C10,H10",500471,584553,373221,211332,332555,180791,0,180946,140749,40197,3.50148021,106889,107626,14060,5257,5141,116,1003,4,0.041626143,0,hg38,CD-0722-2
"C10,H11",5751,6845,3935,2910,4103,2680,0,2682,1483,1199,1.236864053,1596,95,6,6,6,0,5,0,0,0,empty,CD-0722-2
"C10,H12",4838,5708,3447,2261,3309,1907,0,1910,1282,628,2.041401274,1164,1521,510,153,152,1,40,1,0.157894737,0,empty,CD-0722-2
"C11,A1",4081,4739,2895,1844,2856,1668,0,1669,1044,625,1.6704,961,1220,353,136,135,1,27,1,0.007407407,0,empty,CD-0722-2
"C11,A2",509164,587850,383609,204241,337822,180597,3,180807,143238,37569,3.812664697,103966,62880,10113,4028,3965,63,804,3,0.051954603,0,hg38,CD-0722-2
"C11,A3",3705,4292,2728,1564,2520,1420,0,1422,937,485,1.931958763,841,1469,385,163,163,0,42,0,0.073619632,0,empty,CD-0722-2
"C11,A4",792065,893662,606152,287510,505598,258069,1,258293,198172,60121,3.296219291,144920,37361,4254,1809,1760,49,411,3,0.047727273,0,hg38,CD-0722-2
"C11,A5",5057,5773,3650,2123,3527,1929,0,1931,1200,731,1.641586867,1119,1958,465,202,201,1,57,1,0.169154229,0,empty,CD-0722-2
"C11,A6",4574,5322,3328,1994,3218,1864,0,1870,1249,621,2.011272142,1097,2908,714,259,256,3,71,2,0.08984375,0,empty,CD-0722-2
"C11,A7",3972,4559,2855,1704,2707,1529,0,1530,1006,524,1.919847328,873,1829,322,117,117,0,36,0,0.051282051,0,empty,CD-0722-2
"C11,A8",2643,3162,1891,1271,1908,1080,0,1080,748,332,2.253012048,662,1909,434,146,141,5,43,2,0.021276596,0,empty,CD-0722-2
"C11,A9",4559,5318,3390,1928,3088,1671,0,1673,1097,576,1.904513889,939,1748,498,192,191,1,63,1,0.104712042,0,empty,CD-0722-2
"C11,A10",5431,6040,4049,1991,3602,1927,0,1928,1194,734,1.626702997,1012,526,159,62,61,1,14,1,0.081967213,0,empty,CD-0722-2
"C11,A11",3670,4017,2764,1253,2503,1226,0,1227,795,432,1.840277778,668,1864,429,142,141,1,44,1,0.042553191,0,empty,CD-0722-2
"C11,A12",5464,6251,4095,2156,3704,1981,0,1981,1282,699,1.834048641,1110,3300,971,321,317,4,70,2,0.100946372,0,empty,CD-0722-2
"C11,B1",4732,5343,3515,1828,3224,1782,0,1783,1090,693,1.572871573,1004,1281,264,114,112,2,36,1,0.044642857,0,empty,CD-0722-2
"C11,B2",528290,589041,378629,210412,345723,184999,0,185156,143831,41325,3.480483969,108534,37758,6259,2470,2394,76,498,2,0.063492063,0,hg38,CD-0722-2
"C11,B3",1054219,1364436,714476,649960,793992,536970,3,537334,417991,119343,3.50243416,344154,65437,13189,4983,4915,68,985,5,0.049440488,0,hg38,CD-0722-2
"C11,B4",602163,714885,443174,271711,411471,232764,1,232963,187593,45370,4.13473661,138970,86939,11960,4570,4473,97,892,7,0.073328862,0,hg38,CD-0722-2
"C11,B5",7989,6747,4383,2364,4369,2259,0,2261,1592,669,2.379671151,1375,987,227,115,114,1,40,1,0.043859649,0,empty,CD-0722-2
"C11,B6",4985,5839,3479,2360,3580,2112,0,2117,1351,766,1.763707572,1283,1726,313,88,85,3,31,1,0.011764706,0,empty,CD-0722-2
"C11,B7",4762,5612,3545,2067,3284,1784,0,1784,1156,628,1.840764331,1046,1425,374,123,121,2,36,1,0.082644628,0,empty,CD-0722-2
"C11,B8",3547,3964,2665,1299,2357,1261,0,1261,816,445,1.833707865,670,1466,434,187,187,0,49,0,0.080213904,0,empty,CD-0722-2
"C11,B9",697283,819169,514260,304909,468734,264449,5,264660,212267,52393,4.051438169,155870,42283,6878,2570,2493,77,517,3,0.042920176,0,hg38,CD-0722-2
"C11,B10",3085,3553,2229,1324,2147,1208,0,1208,733,475,1.543157895,708,668,253,102,100,2,15,1,0.28,0,empty,CD-0722-2
"C11,B11",12719,14884,9241,5643,8700,5174,0,5176,3198,1978,1.616784631,2980,120,18,13,13,0,8,0,0,0,empty,CD-0722-2
"C11,B12",4028,4568,2958,1610,2763,1507,0,1509,992,517,1.918762089,870,1655,374,142,141,1,53,1,0.063829787,0,empty,CD-0722-2
"C11,C1",15624,17631,12124,5507,10317,5203,0,5205,3487,1718,2.029685681,2927,2956,486,181,179,2,58,2,0.117318436,0,empty,CD-0722-2
"C11,C2",6473,7530,4665,2865,4497,2606,0,2606,1679,927,1.811218986,1539,1835,650,248,248,0,61,0,0.072580645,0,empty,CD-0722-2
"C11,C3",422423,548662,277235,271427,323247,233492,2,233666,174928,58738,2.978106166,147680,2792,358,139,139,0,58,0,0.057553957,0,hg38,CD-0722-2
"C11,C4",4073,4508,3038,1470,2750,1373,0,1374,927,447,2.073825503,773,1234,279,125,121,4,33,2,0.363636364,0,empty,CD-0722-2
"C11,C5",5724,6471,4175,2296,3921,2147,0,2154,1428,726,1.966942149,1208,1473,300,135,133,2,44,1,0.007518797,0,empty,CD-0722-2
"C11,C6",4895,5546,3501,2045,3470,1937,0,1939,1266,673,1.881129272,1165,1392,357,139,139,0,45,0,0.115107914,0,empty,CD-0722-2
"C11,C7",288911,332765,220086,112679,189087,96306,1,96404,73510,22894,3.210884948,56066,19896,3946,1460,1429,31,337,6,0.043386984,0,hg38,CD-0722-2
"C11,C8",7850,8982,5803,3179,5365,2980,1,2985,1930,1055,1.829383886,1742,2980,681,292,289,3,91,2,0.089965398,0,empty,CD-0722-2
"C11,C9",552840,623562,431975,191587,357958,173884,1,174048,129924,44124,2.944519989,96806,37925,4828,1842,1794,48,383,3,0.029542921,0,hg38,CD-0722-2
"C11,C10",5854,6603,4372,2231,3884,2025,0,2030,1310,720,1.819444444,1112,1729,446,172,172,0,40,0,0.151162791,0,empty,CD-0722-2
"C11,C11",5074,5760,3706,2054,3498,1892,0,1896,1258,638,1.971786834,1077,2021,358,160,158,2,47,1,0.03164557,0,empty,CD-0722-2
"C11,C12",7532,8199,5553,2646,5025,2681,0,2683,1742,941,1.851222104,1506,1746,456,185,185,0,54,0,0.124324324,0,empty,CD-0722-2
"C11,D1",13677,17520,9291,8229,10515,7285,0,7293,4781,2512,1.903264331,4509,881,128,68,67,1,23,1,0.223880597,0,empty,CD-0722-2
"C11,D2",6698,7660,5078,2582,4570,2342,0,2343,1532,811,1.889025894,1345,2905,768,290,290,0,76,0,0.027586207,0,empty,CD-0722-2
"C11,D3",4852,5498,3574,1924,3270,1834,0,1834,1183,651,1.817204301,1019,1609,291,122,122,0,48,0,0.040983607,0,empty,CD-0722-2
"C11,D4",3625,4176,2671,1505,2534,1363,0,1366,909,457,1.989059081,759,1061,147,71,64,7,21,1,0.046875,0,empty,CD-0722-2
"C11,D5",4237,4910,3100,1810,2977,1616,0,1618,1061,557,1.904847397,979,1722,546,201,199,2,48,1,0.120603015,0,empty,CD-0722-2
"C11,D6",6884,7903,4772,3131,4737,2816,0,2820,1642,1178,1.393887946,1699,1868,363,147,145,2,44,1,0.15862069,0,empty,CD-0722-2
"C11,D7",3733,4150,2699,1451,2509,1315,0,1315,862,453,1.902869757,778,2693,741,281,280,1,86,1,0.003571429,0,empty,CD-0722-2
"C11,D8",533867,621324,399903,221421,358461,191826,0,191980,147015,44965,3.269542978,112919,59876,8323,3284,3201,83,630,5,0.040924711,0,hg38,CD-0722-2
"C11,D9",2985,3254,2151,1103,1977,1041,0,1043,687,356,1.929775281,563,1127,269,87,87,0,26,0,0.057471264,0,empty,CD-0722-2
"C11,D10",4341,5070,3081,1989,3075,1787,1,1791,1138,653,1.742725881,1085,788,160,65,63,2,22,1,0.19047619,0,empty,CD-0722-2
"C11,D11",4909,5642,3648,1994,3436,1852,0,1854,1167,687,1.698689956,1108,2384,529,198,195,3,58,1,0.051282051,0,empty,CD-0722-2
"C11,D12",655227,748271,502261,246010,427935,220972,1,221167,152828,68339,2.236321866,126967,72297,14424,5481,5389,92,989,5,0.029318983,0,hg38,CD-0722-2
"C11,E1",8026,9151,5816,3335,5314,2961,0,2961,1857,1104,1.682065217,1669,2570,424,161,158,3,50,2,0.120253165,0,empty,CD-0722-2
"C11,E2",5597,6355,4036,2319,3884,2197,0,2197,1410,787,1.791613723,1287,1534,322,152,149,3,46,1,0.147651007,0,empty,CD-0722-2
"C11,E3",408087,462183,318503,143680,268518,132299,2,132393,101283,31110,3.255641273,74168,25956,5692,2064,2042,22,425,3,0.010773751,0,hg38,CD-0722-2
"C11,E4",4770,5723,3555,2168,3441,1908,0,1911,1192,719,1.657858136,1147,2121,537,187,184,3,58,1,0.043478261,0,empty,CD-0722-2
"C11,E5",4364,4707,3290,1417,2864,1466,0,1468,978,490,1.995918367,775,1529,302,116,107,9,29,2,0,0,empty,CD-0722-2
"C11,E6",8253,9389,6020,3369,5626,3112,0,3114,1958,1156,1.693771626,1819,3574,852,312,309,3,90,1,0.071197411,0,empty,CD-0722-2
"C11,E7",7399,8598,5500,3098,5006,2715,0,2716,1885,831,2.268351384,1577,2779,651,269,264,5,83,2,0.151515152,0,empty,CD-0722-2
"C11,E8",5896,6205,4478,1727,3763,1898,0,1901,1228,673,1.824665676,989,3004,636,270,267,3,75,2,0.131086142,0,empty,CD-0722-2
"C11,E9",4049,4607,2980,1627,2718,1463,0,1464,1014,450,2.253333333,840,2381,441,164,160,4,59,2,0.13125,0,empty,CD-0722-2
"C11,E10",4338,4927,3128,1799,2964,1651,0,1655,1047,608,1.722039474,968,1361,373,144,144,0,33,0,0,0,empty,CD-0722-2
"C11,E11",5279,6097,3814,2283,3620,2021,0,2024,1232,792,1.555555556,1179,1786,309,113,111,2,44,2,0.099099099,0,empty,CD-0722-2
"C11,E12",5659,6616,4035,2581,3950,2184,0,2184,1360,824,1.650485437,1334,1813,295,130,119,11,47,2,0.033613445,0,empty,CD-0722-2
"C11,F1",579888,653963,443659,210304,376809,189460,1,189644,151829,37815,4.015046939,106718,123001,24481,9277,9139,138,1527,5,0.043549622,0,hg38,CD-0722-2
"C11,F2",627643,740637,457659,282978,426756,236986,3,237215,190537,46678,4.081944385,142398,6246,2167,698,694,4,273,2,0.040345821,0,hg38,CD-0722-2
"C11,F3",5021,5516,3691,1825,3343,1803,0,1805,1185,620,1.911290323,1030,2350,461,194,188,6,54,2,0.085106383,0,empty,CD-0722-2
"C11,F4",7392,8221,5404,2817,5004,2667,1,2673,1722,951,1.810725552,1507,573,100,46,45,1,19,1,0.355555556,0,empty,CD-0722-2
"C11,F5",5837,6408,4341,2067,3870,2007,0,2011,1302,709,1.836389281,1103,1957,387,176,173,3,55,1,0.063583815,0,empty,CD-0722-2
"C11,F6",5938,7068,4257,2811,4181,2412,0,2417,1471,946,1.554968288,1450,3101,732,264,262,2,58,1,0.007633588,0,empty,CD-0722-2
"C11,F7",6655,7524,4891,2633,4432,2409,0,2409,1627,782,2.08056266,1343,856,228,93,93,0,29,0,0,0,empty,CD-0722-2
"C11,F8",5473,6284,4116,2168,3763,2041,0,2042,1433,609,2.353037767,1146,285,34,19,17,2,16,2,0.058823529,0,empty,CD-0722-2
"C11,F9",5693,6285,4312,1973,3873,1961,0,1961,1285,676,1.900887574,1095,2779,775,259,259,0,74,0,0.073359073,0,empty,CD-0722-2
"C11,F10",6857,7740,4995,2745,4610,2438,0,2438,1618,820,1.973170732,1399,1905,477,213,209,4,47,1,0.186602871,0,empty,CD-0722-2
"C11,F11",491857,556657,374011,182646,322143,165538,2,165715,124033,41682,2.975696944,94456,106581,11860,4632,4500,132,875,6,0.064444444,0,hg38,CD-0722-2
"C11,F12",5580,6295,4067,2228,3728,2064,0,2064,1337,727,1.839064649,1196,112,19,13,13,0,9,0,0,0,empty,CD-0722-2
"C11,G1",6204,7008,4499,2509,4121,2176,0,2177,1419,758,1.872031662,1256,3153,639,217,212,5,65,2,0.103773585,0,empty,CD-0722-2
"C11,G2",3665,4015,2568,1447,2506,1386,0,1387,903,484,1.865702479,826,546,158,65,65,0,24,0,0.092307692,0,empty,CD-0722-2
"C11,G3",7219,8014,5215,2799,4700,2637,0,2644,1671,973,1.717368962,1447,1839,470,200,198,2,69,2,0.060606061,0,empty,CD-0722-2
"C11,G4",748398,866701,559461,307240,497764,275175,0,275399,219178,56221,3.898507675,158873,318,43,16,16,0,9,0,0.3125,0,empty,CD-0722-2
"C11,G5",4262,4811,3095,1716,2902,1642,0,1644,1089,555,1.962162162,909,1837,361,139,137,2,42,2,0.03649635,0,empty,CD-0722-2
"C11,G6",6343,7004,4685,2319,4132,2201,0,2204,1479,725,2.04,1196,159,20,11,8,3,6,1,0,0,empty,CD-0722-2
"C11,G7",4818,5257,3624,1633,3197,1607,0,1608,1045,563,1.856127886,873,2999,782,316,312,4,71,4,0.096153846,0,empty,CD-0722-2
"C11,G8",3269,3644,2481,1163,2262,1190,0,1190,749,441,1.698412698,661,1952,444,133,124,9,46,2,0.072580645,0,empty,CD-0722-2
"C11,G9",4391,5040,3199,1841,3002,1638,0,1638,1044,594,1.757575758,987,1861,398,163,162,1,59,1,0.024691358,0,empty,CD-0722-2
"C11,G10",5203,5991,3756,2235,3633,1998,0,2002,1304,698,1.868194842,1190,2102,587,233,231,2,63,1,0.147186147,0,empty,CD-0722-2
"C11,G11",5207,5846,3863,1983,3495,1832,0,1833,1197,636,1.882075472,1033,1361,380,152,150,2,47,1,0.113333333,0,empty,CD-0722-2
"C11,G12",4558,5174,3335,1839,3102,1688,0,1692,1087,605,1.796694215,949,2354,604,201,200,1,69,1,0.01,0,empty,CD-0722-2
"C11,H1",4795,5451,3558,1893,3361,1810,0,1820,1223,597,2.048576214,1071,1371,289,124,121,3,42,2,0.082644628,0,empty,CD-0722-2
"C11,H2",5154,5900,3789,2111,3636,1993,0,1993,1292,701,1.843081312,1187,1871,639,264,264,0,75,0,0.106060606,0,empty,CD-0722-2
"C11,H3",4309,4973,3061,1912,3067,1736,0,1736,1136,600,1.893333333,1059,1464,344,122,121,1,43,1,0.115702479,0,empty,CD-0722-2
"C11,H4",1128192,1351674,817055,534619,772113,482990,3,483354,353765,129589,2.729899914,285849,5104,2117,774,771,3,172,1,0.02075227,0,hg38,CD-0722-2
"C11,H5",6933,7856,5006,2850,4653,2617,0,2623,1678,945,1.775661376,1533,2443,580,258,251,7,67,2,0.123505976,0,empty,CD-0722-2
"C11,H6",4462,5150,3230,1920,3119,1780,0,1780,1203,577,2.08492201,1051,1573,400,164,163,1,44,1,0.134969325,0,empty,CD-0722-2
"C11,H7",5103,5858,3681,2177,3470,1853,0,1856,1230,626,1.96485623,1099,2243,527,249,245,4,81,2,0.069387755,0,empty,CD-0722-2
"C11,H8",5469,6368,4004,2364,3802,2116,0,2119,1353,766,1.766318538,1237,2614,528,211,210,1,52,1,0.047619048,0,empty,CD-0722-2
"C11,H9",4102,4618,3048,1570,2834,1476,0,1477,1005,472,2.129237288,849,770,225,114,114,0,30,0,0.201754386,0,empty,CD-0722-2
"C11,H10",4911,5411,3649,1762,3267,1729,0,1731,1170,561,2.085561497,934,1425,370,137,135,2,36,2,0.096296296,0,empty,CD-0722-2
"C11,H11",5625,6707,3839,2868,4045,2614,0,2620,1427,1193,1.196144174,1625,32,3,2,2,0,2,0,0.5,0,empty,CD-0722-2
"C11,H12",4462,5036,3184,1852,2939,1658,0,1658,1113,545,2.042201835,936,1453,278,95,94,1,31,1,0.180851064,0,empty,CD-0722-2
"C12,A1",3999,4671,2871,1800,2739,1591,0,1591,995,596,1.669463087,910,825,123,56,52,4,29,2,0.057692308,0,empty,CD-0722-2
"C12,A2",6372,7356,4491,2865,4309,2493,0,2498,1523,975,1.562051282,1485,1314,239,103,102,1,31,1,0.166666667,0,empty,CD-0722-2
"C12,A3",3759,4376,2792,1584,2603,1430,0,1430,944,486,1.942386831,841,1186,326,137,133,4,33,2,0.135338346,0,empty,CD-0722-2
"C12,A4",5672,6412,4134,2278,3829,2062,2,2066,1346,720,1.869444444,1229,706,97,40,38,2,18,2,0.026315789,0,empty,CD-0722-2
"C12,A5",5232,5937,3793,2144,3585,1945,0,1947,1199,748,1.602941176,1130,1121,264,113,108,5,40,2,0.009259259,0,empty,CD-0722-2
"C12,A6",5025,5636,3638,1998,3478,1975,0,1977,1322,655,2.018320611,1123,1837,332,160,158,2,49,1,0.164556962,0,empty,CD-0722-2
"C12,A7",3882,4355,2704,1651,2650,1544,0,1547,936,611,1.531914894,910,722,181,85,85,0,26,0,0.247058824,0,empty,CD-0722-2
"C12,A8",2249,2592,1650,942,1594,899,1,900,604,296,2.040540541,544,1449,372,167,164,3,56,2,0.012195122,0,empty,CD-0722-2
"C12,A9",4431,5150,3294,1856,3068,1685,0,1685,1056,629,1.678855326,987,972,195,77,73,4,34,1,0.01369863,0,empty,CD-0722-2
"C12,A10",5801,6443,4395,2048,3786,1982,0,1984,1243,741,1.677462888,1063,201,84,26,26,0,9,0,0.038461538,0,empty,CD-0722-2
"C12,A11",3687,4011,2767,1244,2419,1218,0,1218,764,454,1.682819383,659,949,210,83,81,2,32,1,0.061728395,0,empty,CD-0722-2
"C12,A12",5704,6357,4256,2101,3709,1959,0,1961,1216,745,1.632214765,1117,2613,791,229,228,1,61,1,0.201754386,0,empty,CD-0722-2
"C12,B1",4414,4991,3133,1858,2958,1662,0,1663,1060,603,1.75787728,998,851,243,68,68,0,25,0,0.014705882,0,empty,CD-0722-2
"C12,B2",4207,4960,2847,2113,2942,1745,0,1745,1096,649,1.688751926,1072,354,75,37,37,0,12,0,0.027027027,0,empty,CD-0722-2
"C12,B3",4286,4921,3039,1882,2997,1677,0,1677,1049,628,1.670382166,1016,1006,164,79,77,2,39,1,0.012987013,0,empty,CD-0722-2
"C12,B4",4985,6042,3446,2596,3577,2176,0,2176,1349,827,1.631197098,1337,878,244,106,105,1,23,1,0.047619048,0,empty,CD-0722-2
"C12,B5",535080,289738,259350,30388,196891,47682,5,48207,35028,13179,2.657864785,20252,1021,281,76,76,0,43,0,0.013157895,0,empty,CD-0722-2
"C12,B6",5098,5718,3720,1998,3433,2063,0,2066,1267,799,1.585732165,1112,1261,412,107,104,3,35,1,0,0,empty,CD-0722-2
"C12,B7",4270,4942,3140,1802,2872,1580,0,1580,1059,521,2.032629559,890,752,156,63,60,3,18,2,0.05,0,empty,CD-0722-2
"C12,B8",3389,3978,2478,1500,2336,1270,0,1272,870,402,2.164179104,723,562,70,36,36,0,17,0,0.027777778,0,empty,CD-0722-2
"C12,B9",6834,8077,4818,3259,4749,2837,0,2838,1844,994,1.855130785,1716,878,206,91,91,0,36,0,0.021978022,0,empty,CD-0722-2
"C12,B10",249994,293613,158909,134704,182677,125353,4,125633,77857,47776,1.629625754,78420,306,51,25,25,0,16,0,0.12,0,empty,CD-0722-2
"C12,B11",8003,9327,5617,3710,5473,3316,0,3318,1813,1505,1.204651163,1974,199,70,28,28,0,10,0,0,0,empty,CD-0722-2
"C12,B12",4091,4812,2973,1839,2837,1593,0,1593,1057,536,1.972014925,951,1047,232,96,93,3,29,1,0.107526882,0,empty,CD-0722-2
"C12,C1",7186,8126,5334,2792,4834,2636,0,2642,1725,917,1.881134133,1484,681,232,72,72,0,20,0,0.291666667,0,empty,CD-0722-2
"C12,C2",6167,6922,4398,2524,4150,2358,0,2365,1529,836,1.828947368,1373,1497,385,156,155,1,44,1,0.019354839,0,empty,CD-0722-2
"C12,C3",6216,6920,4496,2424,4201,2355,0,2361,1529,832,1.837740385,1302,548,85,37,37,0,15,0,0.054054054,0,empty,CD-0722-2
"C12,C4",4342,4974,3222,1752,2909,1515,0,1515,1003,512,1.958984375,884,1434,370,123,123,0,37,0,0.073170732,0,empty,CD-0722-2
"C12,C5",6405,7330,4696,2634,4464,2441,0,2443,1621,822,1.972019465,1432,1075,336,135,131,4,40,2,0.160305344,0,empty,CD-0722-2
"C12,C6",604256,707917,450527,257390,411701,225171,3,225372,171208,54164,3.160918691,133710,87028,10524,4168,4062,106,830,6,0.046282619,0,hg38,CD-0722-2
"C12,C7",7480,8892,5254,3638,5236,3216,0,3220,1911,1309,1.459893048,1966,340,42,14,14,0,9,0,0,0,empty,CD-0722-2
"C12,C8",7980,9067,5832,3235,5398,2986,0,2990,1942,1048,1.853053435,1720,2014,618,197,192,5,71,3,0.072916667,0,empty,CD-0722-2
"C12,C9",5883,6552,4344,2208,3872,2091,0,2091,1430,661,2.163388805,1177,1220,271,96,96,0,20,0,0.0625,0,empty,CD-0722-2
"C12,C10",5704,6282,4146,2136,3861,2101,0,2107,1327,780,1.701282051,1198,1528,330,151,148,3,43,1,0.128378378,0,empty,CD-0722-2
"C12,C11",4868,5523,3550,1973,3326,1895,0,1898,1222,676,1.807692308,1064,1422,208,114,114,0,43,0,0.070175439,0,empty,CD-0722-2
"C12,C12",7470,8419,5505,2914,5022,2679,0,2684,1826,858,2.128205128,1526,1888,627,230,230,0,53,0,0.069565217,0,empty,CD-0722-2
"C12,D1",528724,597109,404701,192408,343709,174767,0,174942,140322,34620,4.053206239,99703,32231,4480,1718,1674,44,366,2,0.008960573,0,hg38,CD-0722-2
"C12,D2",4940,5506,3764,1742,3371,1762,0,1763,1094,669,1.635276532,990,2295,548,213,211,2,67,2,0.09478673,0,empty,CD-0722-2
"C12,D3",513806,638187,359494,278693,372101,244178,0,244368,187408,56960,3.290168539,149154,10348,6733,2354,2349,5,415,1,0.008514261,0,hg38,CD-0722-2
"C12,D4",561899,658731,425102,233629,377413,202745,0,202948,161500,41448,3.896448562,118770,48087,5903,2367,2327,40,547,3,0.049419854,0,hg38,CD-0722-2
"C12,D5",4172,4624,3101,1523,2838,1520,0,1521,1015,506,2.005928854,810,1111,252,78,76,2,33,2,0.078947368,0,empty,CD-0722-2
"C12,D6",6579,7402,4619,2783,4338,2656,0,2659,1590,1069,1.487371375,1524,1131,215,121,121,0,46,0,0.05785124,0,empty,CD-0722-2
"C12,D7",3669,4118,2700,1418,2514,1326,0,1326,863,463,1.863930886,755,1260,234,102,102,0,34,0,0,0,empty,CD-0722-2
"C12,D8",4469,5098,3200,1898,3039,1690,0,1692,1081,611,1.769230769,996,724,203,65,62,3,20,2,0.080645161,0,empty,CD-0722-2
"C12,D9",2507,2960,1886,1074,1687,945,0,945,596,349,1.70773639,559,1253,357,104,102,2,26,1,0,0,empty,CD-0722-2
"C12,D10",4089,4792,2937,1855,2809,1570,0,1571,969,602,1.609634551,934,567,135,44,44,0,14,0,0.295454545,0,empty,CD-0722-2
"C12,D11",4950,5631,3591,2040,3340,1746,0,1747,1169,578,2.022491349,1019,2455,593,239,235,4,61,2,0.034042553,0,empty,CD-0722-2
"C12,D12",604915,703391,456292,247099,402726,217227,1,217411,169122,48289,3.502288306,126850,159568,33164,12911,12737,174,1867,7,0.041297009,0,hg38,CD-0722-2
"C12,E1",8013,8888,5700,3188,5242,2968,0,2973,1912,1061,1.802073516,1663,1917,347,164,162,2,44,2,0.104938272,0,empty,CD-0722-2
"C12,E2",5203,5933,3729,2204,3458,1902,0,1902,1208,694,1.740634006,1103,1319,223,106,104,2,39,2,0.057692308,0,empty,CD-0722-2
"C12,E3",470609,573658,344771,228887,330673,193232,3,193406,156416,36990,4.228602325,115982,96870,21272,8100,7995,105,1435,4,0.056910569,0,hg38,CD-0722-2
"C12,E4",4932,5624,3574,2050,3399,1852,0,1854,1222,632,1.933544304,1098,2046,560,230,225,5,56,1,0.124444444,0,empty,CD-0722-2
"C12,E5",4090,4578,3103,1475,2732,1399,0,1400,957,443,2.16027088,789,857,136,63,62,1,30,1,0.209677419,0,empty,CD-0722-2
"C12,E6",8340,9570,6076,3494,5732,3192,0,3195,2049,1146,1.787958115,1884,2418,546,210,203,7,63,2,0.054187192,0,empty,CD-0722-2
"C12,E7",7335,8365,5356,3009,5006,2701,0,2708,1771,937,1.890074707,1553,1706,324,148,146,2,50,2,0.116438356,0,empty,CD-0722-2
"C12,E8",5637,6158,4216,1942,3730,1875,0,1878,1210,668,1.811377246,1033,1788,343,126,124,2,40,1,0.14516129,0,empty,CD-0722-2
"C12,E9",4444,5137,3227,1910,3066,1686,0,1686,1175,511,2.299412916,1008,1321,381,196,191,5,50,1,0.178010471,0,empty,CD-0722-2
"C12,E10",3642,4179,2705,1474,2530,1362,1,1364,880,484,1.818181818,803,1340,443,165,165,0,49,0,0.006060606,0,empty,CD-0722-2
"C12,E11",5154,5978,3777,2201,3554,1960,0,1964,1260,704,1.789772727,1145,1392,314,90,90,0,32,0,0.033333333,0,empty,CD-0722-2
"C12,E12",5928,6876,4276,2600,4078,2261,0,2261,1505,756,1.990740741,1330,1422,248,130,128,2,40,2,0.0390625,0,empty,CD-0722-2
"C12,F1",6413,7073,4767,2306,4239,2279,0,2280,1442,838,1.720763723,1277,1680,488,220,218,2,56,2,0.055045872,0,empty,CD-0722-2
"C12,F2",5122,5761,3668,2093,3497,1957,0,1960,1213,747,1.623828648,1149,1822,455,177,177,0,55,0,0.11299435,0,empty,CD-0722-2
"C12,F3",4873,5737,3520,2217,3370,1878,0,1879,1231,648,1.899691358,1132,1552,319,141,135,6,44,4,0.059259259,0,empty,CD-0722-2
"C12,F4",6877,7653,5116,2537,4634,2398,1,2403,1652,751,2.199733688,1352,524,107,48,47,1,17,1,0,0,empty,CD-0722-2
"C12,F5",5386,5982,4009,1973,3623,1875,0,1879,1236,643,1.922239502,1091,1298,282,120,120,0,46,0,0.025,0,empty,CD-0722-2
"C12,F6",6129,7204,4430,2774,4248,2454,3,2459,1543,916,1.684497817,1440,2212,451,171,169,2,50,1,0.177514793,0,empty,CD-0722-2
"C12,F7",6174,7088,4532,2556,4190,2288,0,2292,1529,763,2.003931848,1282,416,46,24,24,0,10,0,0.125,0,empty,CD-0722-2
"C12,F8",4818,5330,3647,1683,3154,1638,0,1639,1126,513,2.194931774,855,236,50,21,20,1,11,1,0.15,0,empty,CD-0722-2
"C12,F9",510302,587183,379506,207677,338859,187216,0,187350,141946,45404,3.126288433,108766,83507,24691,9097,9000,97,1335,5,0.013,0,hg38,CD-0722-2
"C12,F10",617694,712256,460042,252214,408490,225303,0,225469,188799,36670,5.148595582,130016,119754,19031,7316,7143,173,1260,5,0.03947921,0,hg38,CD-0722-2
"C12,F11",5867,6487,4463,2024,3803,1951,0,1952,1325,627,2.11323764,1046,1045,285,140,138,2,41,2,0.18115942,0,empty,CD-0722-2
"C12,F12",604662,669929,464869,205060,377833,183746,0,183933,138296,45637,3.030348182,103577,4784,499,171,169,2,44,1,0.100591716,0,hg38,CD-0722-2
"C12,G1",5649,6247,4221,2026,3786,1998,0,1998,1300,698,1.862464183,1127,2101,385,139,136,3,44,1,0.007352941,0,empty,CD-0722-2
"C12,G2",3534,4059,2471,1588,2358,1334,0,1337,872,465,1.875268817,766,384,55,33,33,0,23,0,0.060606061,0,empty,CD-0722-2
"C12,G3",6899,7708,5010,2698,4454,2484,0,2484,1468,1016,1.44488189,1343,1409,258,119,117,2,42,2,0.034188034,0,empty,CD-0722-2
"C12,G4",12532,14590,8798,5792,8598,5251,0,5260,3163,2097,1.508345255,3070,67,13,9,9,0,5,0,0,0,empty,CD-0722-2
"C12,G5",3952,4454,2849,1605,2646,1436,0,1436,907,529,1.714555766,856,1523,364,133,130,3,35,2,0.092307692,0,empty,CD-0722-2
"C12,G6",5512,6186,4005,2181,3727,2053,0,2055,1375,680,2.022058824,1203,96,37,15,15,0,6,0,0,0,empty,CD-0722-2
"C12,G7",5171,5945,3897,2048,3535,1891,0,1896,1263,633,1.995260664,1089,1992,308,136,134,2,52,1,0.007462687,0,empty,CD-0722-2
"C12,G8",3510,3830,2576,1254,2356,1178,0,1179,803,376,2.135638298,676,1330,368,135,135,0,43,0,0.037037037,0,empty,CD-0722-2
"C12,G9",496042,629291,348794,280497,365115,233172,0,233338,176501,56837,3.105389095,146696,16167,5655,1999,1989,10,499,2,0.044243338,0,hg38,CD-0722-2
"C12,G10",5353,6067,3994,2073,3585,1942,0,1944,1290,654,1.972477064,1069,1497,371,130,128,2,47,1,0.046875,0,empty,CD-0722-2
"C12,G11",5145,5801,3833,1968,3392,1734,0,1735,1182,553,2.137432188,1003,1339,324,142,141,1,40,1,0.078014184,0,empty,CD-0722-2
"C12,G12",4428,5342,3104,2238,3285,1966,0,1966,1344,622,2.160771704,1238,1457,336,129,129,0,48,0,0.093023256,0,empty,CD-0722-2
"C12,H1",5210,5755,3779,1976,3496,1856,0,1856,1213,643,1.886469673,1076,1145,375,149,149,0,41,0,0.040268456,0,empty,CD-0722-2
"C12,H2",5111,5872,3727,2145,3526,1901,0,1903,1220,683,1.786237189,1109,1495,257,130,124,6,47,1,0,0,empty,CD-0722-2
"C12,H3",4417,5098,3209,1889,3034,1725,0,1727,1139,588,1.93707483,1026,1254,269,110,110,0,43,0,0.036363636,0,empty,CD-0722-2
"C12,H4",6271,7004,4586,2418,4211,2281,0,2282,1529,753,2.030544489,1328,92,8,4,4,0,4,0,0,0,empty,CD-0722-2
"C12,H5",9064,10375,6762,3613,6084,3267,0,3272,2248,1024,2.1953125,1857,3682,784,309,300,9,92,2,0.086666667,0,empty,CD-0722-2
"C12,H6",4602,5321,3252,2069,3161,1823,1,1826,1191,635,1.875590551,1083,1434,283,118,114,4,41,2,0.061403509,0,empty,CD-0722-2
"C12,H7",4759,5352,3433,1919,3280,1778,0,1779,1172,607,1.930807249,1061,1577,468,198,198,0,60,0,0.065656566,0,empty,CD-0722-2
"C12,H8",417536,460317,315584,144733,263703,134255,0,134383,106985,27398,3.904847069,74617,84572,16126,6263,6173,90,1110,6,0.030941196,0,hg38,CD-0722-2
"C12,H9",4109,4713,3076,1637,2793,1443,0,1443,1035,408,2.536764706,830,636,120,43,41,2,16,2,0.073170732,0,empty,CD-0722-2
"C12,H10",4350,4972,3214,1758,2896,1565,1,1568,1032,536,1.925373134,932,1163,241,106,106,0,37,0,0.028301887,0,empty,CD-0722-2
"C12,H11",5855,7104,3915,3189,4309,2933,0,2933,1570,1363,1.151870873,1797,26,1,1,1,0,1,0,0,0,empty,CD-0722-2
"C12,H12",4468,5233,3221,2012,3133,1775,0,1775,1180,595,1.983193277,1073,984,176,87,87,0,32,0,0.103448276,0,empty,CD-0722-2
"D1,A1",3831,4290,2801,1489,2572,1439,1,1446,942,504,1.869047619,792,1368,288,118,113,5,40,2,0.07079646,0,empty,CD-0722-2
"D1,A2",5440,6266,3949,2317,3681,2081,1,2084,1319,765,1.724183007,1211,2111,443,188,185,3,52,2,0.048648649,0,empty,CD-0722-2
"D1,A3",3498,3819,2551,1268,2366,1277,0,1277,888,389,2.28277635,699,1530,395,140,137,3,44,2,0.087591241,0,empty,CD-0722-2
"D1,A4",5892,6680,4346,2334,4016,2226,0,2226,1448,778,1.861182519,1285,873,242,110,108,2,33,1,0.101851852,0,empty,CD-0722-2
"D1,A5",4590,5257,3244,2013,3202,1800,0,1802,1179,623,1.892455859,1070,2502,542,216,215,1,56,1,0.139534884,0,empty,CD-0722-2
"D1,A6",4547,5283,3305,1978,3220,1862,0,1869,1234,635,1.943307087,1093,2635,772,302,301,1,102,1,0.056478405,0,empty,CD-0722-2
"D1,A7",3534,4106,2579,1527,2402,1341,0,1343,834,509,1.638506876,772,1249,270,98,98,0,42,0,0.06122449,0,empty,CD-0722-2
"D1,A8",2307,2870,1655,1215,1670,972,0,972,674,298,2.261744966,606,2419,508,232,231,1,65,1,0.03030303,0,empty,CD-0722-2
"D1,A9",497922,570611,378711,191900,325748,171950,0,172102,138933,33169,4.188639995,97775,49513,7698,2950,2897,53,645,3,0.021746634,0,hg38,CD-0722-2
"D1,A10",4745,5288,3556,1732,3079,1669,0,1669,1063,606,1.754125413,908,451,62,31,31,0,14,0,0.548387097,0,empty,CD-0722-2
"D1,A11",3310,3668,2437,1231,2275,1213,0,1215,805,410,1.963414634,682,1556,385,162,161,1,47,1,0,0,empty,CD-0722-2
"D1,A12",5309,5853,3909,1944,3360,1776,1,1777,1180,597,1.976549414,969,3448,920,342,340,2,79,1,0.211764706,0,empty,CD-0722-2
"D1,B1",528834,610113,395943,214170,346047,185086,1,185265,146318,38947,3.756849051,107234,144366,17645,6790,6624,166,1214,8,0.076992754,0,hg38,CD-0722-2
"D1,B2",4375,4871,2975,1896,2875,1680,0,1682,1090,592,1.841216216,950,650,95,51,49,2,20,2,0.081632653,0,empty,CD-0722-2
"D1,B3",3919,4587,2782,1805,2797,1612,0,1612,1066,546,1.952380952,950,1585,338,178,177,1,55,1,0.09039548,0,empty,CD-0722-2
"D1,B4",4004,4670,2929,1741,2807,1647,0,1650,1057,593,1.782462057,975,1414,513,174,172,2,42,1,0.139534884,0,empty,CD-0722-2
"D1,B5",4316,2577,1582,995,1875,1037,0,1041,734,307,2.390879479,637,1240,389,112,112,0,35,0,0,0,empty,CD-0722-2
"D1,B6",4384,5138,3085,2053,3106,1883,1,1886,1194,692,1.725433526,1134,1685,363,142,138,4,41,1,0.02173913,0,empty,CD-0722-2
"D1,B7",4272,4694,3128,1566,2890,1595,0,1596,1049,547,1.91773309,881,1408,301,109,108,1,38,1,0.092592593,0,empty,CD-0722-2
"D1,B8",3049,3495,2280,1215,2153,1153,0,1154,778,376,2.069148936,662,1502,334,140,140,0,41,0,0.178571429,0,empty,CD-0722-2
"D1,B9",414411,509299,297464,211835,295254,180898,0,181044,144400,36644,3.940617836,111181,9466,1906,722,710,12,243,2,0.015492958,0,hg38,CD-0722-2
"D1,B10",2841,3197,1991,1206,1957,1078,0,1078,681,397,1.715365239,664,485,54,26,24,2,11,1,0,0,empty,CD-0722-2
"D1,B11",11148,12878,8158,4720,7729,4495,0,4498,2926,1572,1.861323155,2666,336,49,28,28,0,18,0,0.035714286,0,empty,CD-0722-2
"D1,B12",519886,631435,373808,257627,365524,217088,7,217273,181271,36002,5.035025832,132462,127812,22287,8304,8162,142,1382,7,0.054153394,0,hg38,CD-0722-2
"D1,C1",7275,8365,5480,2885,4910,2608,0,2608,1664,944,1.762711864,1477,1007,230,95,94,1,33,1,0.021276596,0,empty,CD-0722-2
"D1,C2",476031,550398,354713,195685,314617,173220,2,173359,134525,38834,3.464103621,100673,108880,21960,8299,8185,114,1258,4,0.020036652,0,hg38,CD-0722-2
"D1,C3",587829,697353,437419,259934,398374,224327,0,224504,173715,50789,3.420327236,133702,49890,5770,2280,2223,57,480,5,0.051282051,0,hg38,CD-0722-2
"D1,C4",3663,4107,2737,1370,2421,1290,0,1290,880,410,2.146341463,716,1708,499,184,182,2,51,1,0.10989011,0,empty,CD-0722-2
"D1,C5",577079,659406,433297,226109,377979,206752,1,206888,160888,46000,3.497565217,118529,78463,9934,3904,3810,94,832,4,0.014435696,0,hg38,CD-0722-2
"D1,C6",5551,6441,4039,2402,3763,2099,0,2099,1394,705,1.977304965,1230,1814,327,136,136,0,53,0,0.029411765,0,empty,CD-0722-2
"D1,C7",6310,7413,4428,2985,4453,2714,0,2717,1638,1079,1.518072289,1623,778,94,40,39,1,14,1,0,0,empty,CD-0722-2
"D1,C8",7260,8229,5290,2939,4816,2624,0,2626,1741,885,1.967231638,1485,3616,819,326,324,2,99,2,0.043209877,0,empty,CD-0722-2
"D1,C9",4809,5484,3532,1952,3289,1799,0,1800,1140,660,1.727272727,1036,1949,438,157,155,2,40,1,0.232258065,0,empty,CD-0722-2
"D1,C10",5545,6400,4051,2349,3764,2050,0,2052,1350,702,1.923076923,1196,1887,403,191,190,1,54,1,0.068421053,0,empty,CD-0722-2
"D1,C11",4602,5253,3370,1883,3195,1760,0,1761,1115,646,1.726006192,1079,1817,461,201,201,0,62,0,0,0,empty,CD-0722-2
"D1,C12",6804,7909,4884,3025,4718,2622,0,2629,1692,937,1.805763074,1567,2249,624,257,255,2,76,2,0.090196078,0,empty,CD-0722-2
"D1,D1",5916,6773,4194,2579,4099,2398,0,2407,1486,921,1.613463626,1428,973,202,68,68,0,32,0,0.161764706,0,empty,CD-0722-2
"D1,D2",539713,616272,412798,203474,352390,182557,0,182703,139938,42765,3.272255349,103214,216372,33299,12501,12274,227,1834,9,0.048965292,0,hg38,CD-0722-2
"D1,D3",4520,5005,3242,1763,3007,1669,0,1669,1099,570,1.928070175,968,1702,461,183,182,1,58,1,0,0,empty,CD-0722-2
"D1,D4",3273,3612,2509,1103,2176,1130,0,1133,768,365,2.104109589,594,1111,250,101,98,3,31,1,0.010204082,0,empty,CD-0722-2
"D1,D5",3950,4743,2923,1820,2898,1598,0,1602,1089,513,2.122807018,975,1462,428,170,165,5,45,1,0.157575758,0,empty,CD-0722-2
"D1,D6",6201,7278,4447,2831,4370,2645,0,2645,1691,954,1.772536688,1579,1448,302,166,164,2,60,2,0.067073171,0,empty,CD-0722-2
"D1,D7",3465,3839,2540,1299,2316,1235,0,1237,795,442,1.798642534,699,2527,539,178,170,8,66,2,0.111764706,0,empty,CD-0722-2
"D1,D8",4379,4841,3148,1693,2942,1591,0,1596,1063,533,1.994371482,913,1465,306,127,124,3,51,2,0.048387097,0,empty,CD-0722-2
"D1,D9",3401,3759,2564,1195,2258,1142,0,1142,793,349,2.272206304,619,1426,443,158,157,1,48,1,0.095541401,0,empty,CD-0722-2
"D1,D10",426540,495919,314785,181134,285683,159634,0,159767,120537,39230,3.072572011,94149,39196,6033,2460,2416,44,477,5,0.028145695,0,hg38,CD-0722-2
"D1,D11",4477,5166,3235,1931,3031,1686,0,1694,1150,544,2.113970588,990,2812,704,258,255,3,74,2,0.074509804,0,empty,CD-0722-2
"D1,D12",818568,1013748,590953,422795,579617,374104,3,374365,272607,101758,2.678973643,225767,127210,63479,22389,22333,56,2503,3,0.01589576,0,hg38,CD-0722-2
"D1,E1",7016,7989,5012,2977,4711,2648,0,2652,1689,963,1.753894081,1588,2490,497,194,191,3,76,1,0.136125654,0,empty,CD-0722-2
"D1,E2",4991,5632,3544,2088,3346,1881,0,1881,1175,706,1.664305949,1094,1662,369,150,148,2,56,1,0.040540541,0,empty,CD-0722-2
"D1,E3",3227,3635,2395,1240,2188,1173,0,1173,725,448,1.618303571,669,2388,606,260,251,9,67,2,0.107569721,0,empty,CD-0722-2
"D1,E4",4601,5103,3288,1815,3046,1635,0,1637,1053,584,1.803082192,927,2205,472,200,196,4,66,2,0.056122449,0,empty,CD-0722-2
"D1,E5",575081,667627,432682,234945,380757,207165,0,207310,163236,44074,3.703680174,119994,104287,15271,5790,5681,109,1026,5,0.057208238,0,hg38,CD-0722-2
"D1,E6",524023,583993,407405,176588,329050,161391,1,161533,117661,43872,2.681915573,89151,131410,18305,7044,6913,131,1208,5,0.061044409,0,hg38,CD-0722-2
"D1,E7",11288,13047,8405,4642,7553,3999,0,4005,2835,1170,2.423076923,2339,6428,1120,489,487,2,121,2,0.059548255,0,empty,CD-0722-2
"D1,E8",5310,5939,3952,1987,3623,1930,0,1932,1265,667,1.896551724,1099,2620,631,230,229,1,66,1,0.113537118,0,empty,CD-0722-2
"D1,E9",3606,4170,2686,1484,2457,1316,0,1318,905,413,2.191283293,774,2600,757,268,266,2,81,1,0.135338346,0,empty,CD-0722-2
"D1,E10",3863,4388,2770,1618,2636,1461,0,1461,910,551,1.65154265,870,1933,579,197,196,1,52,1,0.091836735,0,empty,CD-0722-2
"D1,E11",4591,5204,3418,1786,3198,1777,0,1777,1130,647,1.746522411,1011,1721,175,82,81,1,40,1,0.049382716,0,empty,CD-0722-2
"D1,E12",455179,539629,337205,202424,312800,172647,1,172783,129424,43359,2.98493969,104206,106507,12471,4995,4886,109,962,6,0.050552599,0,hg38,CD-0722-2
"D1,F1",5869,6776,4277,2499,4114,2274,0,2279,1467,812,1.806650246,1347,2216,491,217,210,7,74,2,0.014285714,0,empty,CD-0722-2
"D1,F2",6532,7495,4868,2627,4422,2335,0,2340,1600,740,2.162162162,1384,2851,704,252,245,7,67,1,0.06122449,0,empty,CD-0722-2
"D1,F3",13491,15581,10000,5581,9150,5243,0,5250,3482,1768,1.969457014,3026,3105,614,232,226,6,69,2,0.048672566,0,empty,CD-0722-2
"D1,F4",6874,7537,5044,2493,4474,2357,1,2359,1591,768,2.071614583,1330,629,85,50,48,2,30,2,0,0,empty,CD-0722-2
"D1,F5",538206,614292,404175,210117,350815,185863,0,186033,147393,38640,3.814518634,107494,134391,19307,7424,7252,172,1335,7,0.041092113,0,hg38,CD-0722-2
"D1,F6",5303,5946,3890,2056,3502,1926,0,1928,1263,665,1.89924812,1069,2765,521,224,221,3,68,1,0.063348416,0,empty,CD-0722-2
"D1,F7",6026,7029,4315,2714,4208,2349,0,2352,1523,829,1.837153197,1413,1096,321,111,111,0,36,0,0.036036036,0,empty,CD-0722-2
"D1,F8",1838295,2230293,1338518,891775,1252152,767377,0,767911,601933,165978,3.626583041,459792,38525,7262,2624,2596,28,590,3,0.041987673,0,hg38,CD-0722-2
"D1,F9",5127,5728,3863,1865,3460,1785,0,1785,1193,592,2.015202703,955,3394,679,284,273,11,85,2,0.117216117,0,empty,CD-0722-2
"D1,F10",5900,6672,4466,2206,3955,2052,0,2055,1363,692,1.969653179,1149,1923,422,177,176,1,48,1,0.176136364,0,empty,CD-0722-2
"D1,F11",4862,5390,3649,1741,3263,1657,0,1664,1125,539,2.087198516,939,1802,460,183,183,0,42,0,0.098360656,0,empty,CD-0722-2
"D1,F12",5215,5990,3829,2161,3511,1867,0,1872,1197,675,1.773333333,1077,345,72,18,16,2,13,1,0,0,empty,CD-0722-2
"D1,G1",5646,6269,4156,2113,3764,1984,0,1986,1364,622,2.192926045,1136,2652,717,332,328,4,89,2,0.100609756,0,empty,CD-0722-2
"D1,G2",444102,527051,313693,213358,305066,179668,0,179798,140948,38850,3.628005148,109423,34207,7646,2901,2852,49,568,6,0.038218794,0,hg38,CD-0722-2
"D1,G3",7050,7627,5208,2419,4630,2592,0,2596,1660,936,1.773504274,1386,2082,539,182,182,0,63,0,0.016483516,0,empty,CD-0722-2
"D1,G4",11467,13250,8058,5192,7981,4872,0,4874,2915,1959,1.488004084,2857,155,67,21,21,0,14,0,0,0,empty,CD-0722-2
"D1,G5",3972,4452,2923,1529,2712,1507,0,1507,984,523,1.881453155,820,1798,350,134,134,0,52,0,0.037313433,0,empty,CD-0722-2
"D1,G6",5407,6281,4037,2244,3753,2000,0,2000,1351,649,2.081664099,1163,258,30,21,21,0,7,0,0,0,empty,CD-0722-2
"D1,G7",4351,5155,3256,1899,3001,1585,0,1585,1062,523,2.030592734,929,2683,645,215,209,6,69,3,0.004784689,0,empty,CD-0722-2
"D1,G8",3117,3541,2306,1235,2185,1172,0,1172,788,384,2.052083333,662,1612,295,146,144,2,53,2,0.006944444,0,empty,CD-0722-2
"D1,G9",4097,4604,2965,1639,2729,1505,0,1505,1002,503,1.992047714,882,2079,453,190,189,1,75,1,0.079365079,0,empty,CD-0722-2
"D1,G10",4705,5425,3406,2019,3274,1837,0,1841,1203,638,1.885579937,1088,2586,621,266,265,1,83,1,0.052830189,0,empty,CD-0722-2
"D1,G11",4623,5395,3461,1934,3283,1769,0,1770,1181,589,2.005093379,1021,1728,377,156,154,2,49,2,0.019480519,0,empty,CD-0722-2
"D1,G12",4276,4940,3108,1832,3051,1752,0,1752,1184,568,2.084507042,1032,2806,567,207,199,8,86,2,0.020100503,0,empty,CD-0722-2
"D1,H1",4977,5655,3643,2012,3267,1742,0,1742,1204,538,2.237918216,1000,1555,367,141,141,0,52,0,0.092198582,0,empty,CD-0722-2
"D1,H2",4850,5489,3560,1929,3291,1814,0,1818,1137,681,1.669603524,1055,2948,627,259,256,3,83,1,0.14453125,0,empty,CD-0722-2
"D1,H3",4340,4973,3186,1787,2930,1666,0,1668,1148,520,2.207692308,964,1548,338,153,152,1,64,1,0.072368421,0,empty,CD-0722-2
"D1,H4",1234122,1449658,920342,529316,806084,446453,2,446853,360224,86629,4.158238003,264313,9225,1698,685,670,15,156,2,0.014925373,0,hg38,CD-0722-2
"D1,H5",6084,6982,4395,2587,4191,2279,0,2279,1507,772,1.952072539,1308,2166,753,307,306,1,88,1,0.013071895,0,empty,CD-0722-2
"D1,H6",4096,4821,2907,1914,2800,1542,0,1542,1054,488,2.159836066,919,2029,514,232,229,3,78,1,0.034934498,0,empty,CD-0722-2
"D1,H7",4714,5363,3431,1932,3239,1730,0,1730,1138,592,1.922297297,1032,2462,534,257,255,2,87,1,0.011764706,0,empty,CD-0722-2
"D1,H8",4782,5683,3459,2224,3441,1968,0,1970,1354,616,2.198051948,1166,2330,521,235,233,2,78,2,0.017167382,0,empty,CD-0722-2
"D1,H9",3877,4337,2898,1439,2648,1390,0,1391,934,457,2.043763676,762,1299,381,154,153,1,32,1,0.202614379,0,empty,CD-0722-2
"D1,H10",4166,4858,3068,1790,2936,1616,0,1618,1121,497,2.255533199,936,1697,355,151,149,2,47,2,0.013422819,0,empty,CD-0722-2
"D1,H11",4681,5508,3161,2347,3334,2189,0,2191,1162,1029,1.129251701,1322,57,9,7,7,0,7,0,0,0,empty,CD-0722-2
"D1,H12",444066,519880,326943,192937,299725,165290,1,165414,125165,40249,3.109766702,99020,136840,13016,5120,4930,190,1033,5,0.053955375,0,hg38,CD-0722-2
"D2,A1",4416,5005,3207,1798,3111,1769,0,1770,1168,602,1.940199336,1006,2357,493,186,183,3,60,2,0.158469945,0,empty,CD-0722-2
"D2,A2",6614,7718,4759,2959,4520,2607,0,2609,1579,1030,1.533009709,1526,2182,506,226,220,6,80,2,0.072727273,0,empty,CD-0722-2
"D2,A3",4328,4947,3078,1869,3015,1699,0,1704,1075,629,1.709062003,987,1683,327,121,121,0,65,0,0.033057851,0,empty,CD-0722-2
"D2,A4",6807,7872,4951,2921,4717,2634,0,2637,1710,927,1.844660194,1546,1268,272,105,105,0,35,0,0.00952381,0,empty,CD-0722-2
"D2,A5",5544,6332,3962,2370,3864,2112,0,2114,1399,715,1.956643357,1316,2476,721,306,299,7,66,2,0.133779264,0,empty,CD-0722-2
"D2,A6",10177,11428,7500,3928,6750,3553,0,3553,2505,1048,2.390267176,2006,3347,969,364,359,5,107,2,0.04735376,0,empty,CD-0722-2
"D2,A7",4512,5289,3257,2032,3072,1751,0,1751,1097,654,1.677370031,999,1357,214,104,99,5,39,1,0.161616162,0,empty,CD-0722-2
"D2,A8",2533,2935,1907,1028,1805,1016,0,1019,714,305,2.340983607,569,1980,429,194,193,1,81,1,0.020725389,0,empty,CD-0722-2
"D2,A9",5717,6632,4167,2465,3877,2075,0,2079,1381,698,1.978510029,1210,1985,514,162,159,3,55,3,0.081761006,0,empty,CD-0722-2
"D2,A10",439415,549837,314341,235496,319185,205594,1,205740,145565,60175,2.419027835,125990,6027,1157,490,486,4,141,3,0.020576132,0,hg38,CD-0722-2
"D2,A11",4072,4668,3059,1609,2725,1448,0,1450,886,564,1.570921986,826,1886,321,135,132,3,58,1,0.053030303,0,empty,CD-0722-2
"D2,A12",5657,6244,4236,2008,3691,1906,0,1913,1271,642,1.979750779,1061,3644,912,361,354,7,109,2,0.107344633,0,empty,CD-0722-2
"D2,B1",4794,5590,3428,2162,3306,1882,0,1883,1168,715,1.633566434,1097,1732,424,161,157,4,50,1,0.101910828,0,empty,CD-0722-2
"D2,B2",4952,5910,3251,2659,3474,2142,0,2142,1343,799,1.680851064,1337,1123,209,110,109,1,34,1,0.04587156,0,empty,CD-0722-2
"D2,B3",6527,7637,4776,2861,4516,2587,0,2590,1832,758,2.416886544,1474,2163,463,206,206,0,62,0,0.024271845,0,empty,CD-0722-2
"D2,B4",4973,5972,3530,2442,3533,2147,0,2148,1349,799,1.688360451,1313,1574,259,107,104,3,43,3,0.067307692,0,empty,CD-0722-2
"D2,B5",4620,2758,1666,1092,2009,1150,0,1163,727,436,1.667431193,737,1260,261,91,89,2,36,2,0.213483146,0,empty,CD-0722-2
"D2,B6",5404,5996,3863,2133,3670,2114,0,2116,1353,763,1.773263434,1247,2072,572,190,190,0,43,0,0.010526316,0,empty,CD-0722-2
"D2,B7",4503,4953,3387,1566,3008,1565,0,1569,1035,534,1.938202247,867,1339,283,137,136,1,50,1,0.088235294,0,empty,CD-0722-2
"D2,B8",3550,4143,2663,1480,2494,1366,0,1367,938,429,2.186480186,792,1292,235,117,115,2,54,2,0.173913043,0,empty,CD-0722-2
"D2,B9",605319,718329,443219,275110,409576,234940,1,235139,180965,54174,3.340440063,140582,49679,6790,2515,2462,53,529,4,0.0528026,0,hg38,CD-0722-2
"D2,B10",3143,3631,2322,1309,2195,1175,0,1177,755,422,1.789099526,668,743,163,58,58,0,26,0,0.103448276,0,empty,CD-0722-2
"D2,B11",8727,10316,6254,4062,5912,3545,0,3549,2006,1543,1.300064809,2096,327,40,27,25,2,16,2,0,0,empty,CD-0722-2
"D2,B12",4150,4709,3027,1682,2823,1543,0,1543,1003,540,1.857407407,888,1763,426,150,148,2,67,2,0.040540541,0,empty,CD-0722-2
"D2,C1",8385,9216,6265,2951,5505,2910,0,2910,1846,1064,1.734962406,1599,2023,424,173,171,2,48,1,0.210526316,0,empty,CD-0722-2
"D2,C2",6784,7681,4920,2761,4574,2600,0,2600,1699,901,1.885682575,1496,2262,519,242,240,2,82,1,0.125,0,empty,CD-0722-2
"D2,C3",7099,7918,5299,2619,4779,2567,0,2570,1637,933,1.754555198,1435,1149,223,98,97,1,34,1,0.216494845,0,empty,CD-0722-2
"D2,C4",4460,4963,3337,1626,3000,1570,0,1570,1008,562,1.793594306,901,2302,528,184,179,5,66,3,0.061452514,0,empty,CD-0722-2
"D2,C5",6147,7204,4502,2702,4265,2384,0,2386,1609,777,2.070785071,1431,1981,430,230,227,3,65,1,0.136563877,0,empty,CD-0722-2
"D2,C6",5286,5822,3777,2045,3645,1988,0,1990,1236,754,1.639257294,1149,2929,630,236,231,5,65,1,0.060606061,0,empty,CD-0722-2
"D2,C7",8358,9840,5957,3883,5797,3485,0,3490,2157,1333,1.618154539,2073,492,88,40,37,3,18,1,0,0,empty,CD-0722-2
"D2,C8",8632,9954,6388,3566,5794,3239,0,3243,2166,1077,2.011142061,1859,3227,647,284,281,3,113,2,0.081850534,0,empty,CD-0722-2
"D2,C9",5838,6727,4259,2468,4024,2268,0,2271,1530,741,2.064777328,1288,1696,289,152,151,1,54,1,0.099337748,0,empty,CD-0722-2
"D2,C10",6590,7391,4905,2486,4375,2355,0,2356,1568,788,1.989847716,1252,2533,628,227,225,2,64,1,0.004444444,0,empty,CD-0722-2
"D2,C11",5360,6199,3950,2249,3669,1990,0,1992,1262,730,1.728767123,1145,2441,579,262,260,2,86,2,0.023076923,0,empty,CD-0722-2
"D2,C12",7944,8959,5890,3069,5292,2867,0,2867,1863,1004,1.855577689,1664,1930,522,202,202,0,65,0,0.054455446,0,empty,CD-0722-2
"D2,D1",7075,8437,5012,3425,4924,2922,0,2924,1779,1145,1.55371179,1763,1394,236,109,109,0,40,0,0.027522936,0,empty,CD-0722-2
"D2,D2",5611,6206,4200,2006,3735,1973,0,1976,1242,734,1.692098093,1067,3543,840,335,318,17,102,2,0.050314465,0,empty,CD-0722-2
"D2,D3",4954,5546,3615,1931,3443,1933,1,1937,1239,698,1.775071633,1120,1743,283,138,137,1,58,1,0.04379562,0,empty,CD-0722-2
"D2,D4",4057,4619,3007,1612,2737,1461,0,1461,921,540,1.705555556,808,2189,425,161,154,7,54,2,0.051948052,0,empty,CD-0722-2
"D2,D5",4825,5403,3641,1762,3224,1750,0,1750,1199,551,2.176043557,969,1959,432,171,167,4,66,2,0.119760479,0,empty,CD-0722-2
"D2,D6",7659,9023,5366,3657,5264,3125,0,3128,1855,1273,1.457187745,1898,1752,448,185,184,1,63,1,0.081521739,0,empty,CD-0722-2
"D2,D7",3989,4436,2950,1486,2616,1368,0,1368,897,471,1.904458599,783,2302,505,214,213,1,78,1,0.089201878,0,empty,CD-0722-2
"D2,D8",4872,5597,3629,1968,3343,1830,0,1831,1179,652,1.808282209,1068,1507,318,162,161,1,67,1,0.074534161,0,empty,CD-0722-2
"D2,D9",2621,2957,1979,978,1727,919,0,921,604,317,1.905362776,494,1275,251,107,106,1,40,1,0.028301887,0,empty,CD-0722-2
"D2,D10",4554,5708,3276,2432,3368,1956,0,1958,1292,666,1.93993994,1246,1067,213,82,82,0,27,0,0.024390244,0,empty,CD-0722-2
"D2,D11",5062,5812,3686,2126,3547,1932,0,1932,1275,657,1.940639269,1125,3290,703,284,282,2,104,1,0.04964539,0,empty,CD-0722-2
"D2,D12",6740,7542,4949,2593,4495,2474,0,2474,1587,887,1.789177001,1392,4110,973,406,404,2,153,2,0.091584158,0,empty,CD-0722-2
"D2,E1",8096,9088,5971,3117,5516,3045,0,3050,1867,1183,1.57819104,1713,3451,680,247,245,2,89,2,0.069387755,0,empty,CD-0722-2
"D2,E2",5998,6660,4270,2390,3979,2256,0,2258,1420,838,1.69451074,1285,2346,422,178,176,2,56,2,0.056818182,0,empty,CD-0722-2
"D2,E3",3724,4193,2768,1425,2575,1390,0,1390,928,462,2.008658009,781,2571,615,240,239,1,73,1,0.050209205,0,empty,CD-0722-2
"D2,E4",478205,543745,361886,181859,311596,161636,1,161769,125712,36057,3.48647974,93349,63062,11866,4630,4532,98,865,4,0.036849073,0,hg38,CD-0722-2
"D2,E5",4848,5513,3623,1890,3210,1666,0,1669,1107,562,1.96975089,921,1471,401,154,152,2,56,2,0.046052632,0,empty,CD-0722-2
"D2,E6",9195,10380,6799,3581,6085,3352,0,3354,2150,1204,1.785714286,1835,4385,998,425,415,10,145,1,0.021686747,0,empty,CD-0722-2
"D2,E7",501040,564043,375589,188454,320320,169466,1,169605,134392,35213,3.816545026,95670,125698,22151,8477,8324,153,1422,5,0.031475252,0,hg38,CD-0722-2
"D2,E8",6041,6827,4550,2277,4083,2135,0,2136,1390,746,1.863270777,1186,2961,742,280,275,5,82,2,0.116363636,0,empty,CD-0722-2
"D2,E9",4151,4818,3087,1731,2888,1583,0,1588,1051,537,1.95716946,931,2658,523,231,230,1,92,1,0.030434783,0,empty,CD-0722-2
"D2,E10",614386,724838,449905,274933,417074,245698,2,245895,179907,65988,2.726359338,145346,24895,7794,2719,2696,23,544,2,0.023367953,0,hg38,CD-0722-2
"D2,E11",5630,6156,4204,1952,3728,1968,1,1971,1252,719,1.741307371,1039,2570,505,191,188,3,59,2,0.074468085,0,empty,CD-0722-2
"D2,E12",639382,805356,449156,356200,466190,295473,2,295682,236039,59643,3.957530641,186505,25081,9807,3261,3250,11,779,3,0.027384615,0,hg38,CD-0722-2
"D2,F1",1118187,1283399,852723,430676,722697,388048,2,388388,318403,69985,4.549589198,222896,236697,32335,12705,12459,246,1977,7,0.039489526,0,hg38,CD-0722-2
"D2,F2",5366,6204,3909,2295,3720,2027,0,2031,1266,765,1.654901961,1187,2898,569,249,243,6,84,2,0.024691358,0,empty,CD-0722-2
"D2,F3",1716299,2062330,1215667,846663,1168480,732479,7,733043,592432,140611,4.213269232,446690,313913,45645,18005,17604,401,2402,6,0.057089298,0,hg38,CD-0722-2
"D2,F4",7909,8850,5756,3094,5252,2762,1,2766,1795,971,1.848609681,1576,921,223,92,92,0,40,0,0.130434783,0,empty,CD-0722-2
"D2,F5",1430543,1671541,1051800,619741,931640,532856,7,533311,424974,108337,3.922704155,313224,340559,61366,23567,23174,393,3081,8,0.04319496,0,hg38,CD-0722-2
"D2,F6",6322,7409,4509,2900,4383,2481,0,2486,1547,939,1.647497338,1510,2910,834,358,357,1,83,1,0.140056022,0,empty,CD-0722-2
"D2,F7",7014,7810,5157,2653,4622,2481,0,2484,1671,813,2.055350554,1377,1220,325,113,112,1,54,1,0.026785714,0,empty,CD-0722-2
"D2,F8",5289,5706,3900,1806,3554,1903,0,1905,1224,681,1.797356828,1022,475,59,46,46,0,33,0,0,0,empty,CD-0722-2
"D2,F9",573728,658163,433210,224953,377163,197441,2,197627,154130,43497,3.543462768,114321,264138,37628,14130,13828,302,2061,7,0.036520104,0,hg38,CD-0722-2
"D2,F10",7045,7961,5193,2768,4836,2548,0,2549,1628,921,1.767643865,1497,2037,501,175,171,4,56,3,0.023391813,0,empty,CD-0722-2
"D2,F11",5804,6461,4347,2114,3798,1960,0,1961,1280,681,1.87958884,1093,1943,360,160,159,1,52,1,0.018867925,0,empty,CD-0722-2
"D2,F12",6307,7149,4554,2595,4093,2215,0,2215,1463,752,1.945478723,1263,286,43,33,33,0,17,0,0.03030303,0,empty,CD-0722-2
"D2,G1",902868,1062988,670974,392014,600667,337582,1,337864,270928,66936,4.047567826,197849,181625,24050,9015,8854,161,1698,9,0.03828778,0,hg38,CD-0722-2
"D2,G2",572877,666562,413353,253209,383403,215791,2,215964,166334,49630,3.351480959,129717,33575,4568,1699,1638,61,424,3,0.031746032,0,hg38,CD-0722-2
"D2,G3",9837,11163,7266,3897,6538,3576,0,3580,2289,1291,1.773044152,1997,2750,652,283,283,0,84,0,0.038869258,0,empty,CD-0722-2
"D2,G4",13701,16254,9658,6596,9580,5962,0,5965,3536,2429,1.455743104,3568,233,40,25,22,3,14,1,0,0,empty,CD-0722-2
"D2,G5",579961,687692,424394,263298,393383,225578,1,225790,186386,39404,4.730128921,134770,92556,19744,7561,7441,120,1224,5,0.024055906,0,hg38,CD-0722-2
"D2,G6",6620,7554,4887,2667,4453,2392,0,2394,1537,857,1.793465578,1392,272,99,43,39,4,13,1,0,0,empty,CD-0722-2
"D2,G7",5138,5677,3884,1793,3447,1736,0,1736,1131,605,1.869421488,958,1938,543,238,238,0,79,0,0.084033613,0,empty,CD-0722-2
"D2,G8",534870,635510,390811,244699,365800,209000,2,209161,162302,46859,3.463624917,125840,118627,19811,7684,7531,153,1224,6,0.032001062,0,hg38,CD-0722-2
"D2,G9",4460,5238,3209,2029,3079,1733,0,1733,1107,626,1.768370607,1027,3108,748,296,292,4,91,2,0.010273973,0,empty,CD-0722-2
"D2,G10",5805,6570,4221,2349,3896,2138,0,2140,1430,710,2.014084507,1228,2721,560,255,249,6,90,1,0.040160643,0,empty,CD-0722-2
"D2,G11",5483,6214,4109,2105,3734,1985,0,1988,1306,682,1.914956012,1125,1689,358,164,163,1,64,1,0.012269939,0,empty,CD-0722-2
"D2,G12",4809,5626,3485,2141,3421,1906,0,1909,1234,675,1.828148148,1113,2308,550,261,256,5,97,2,0.03125,0,empty,CD-0722-2
"D2,H1",5201,5871,3789,2082,3507,1859,0,1861,1187,674,1.761127596,1091,1780,434,163,163,0,53,0,0.006134969,0,empty,CD-0722-2
"D2,H2",6713,7642,4981,2661,4609,2529,0,2534,1653,881,1.876276958,1427,2981,561,244,244,0,84,0,0.102459016,0,empty,CD-0722-2
"D2,H3",4674,5384,3380,2004,3258,1763,0,1763,1143,620,1.843548387,1073,2292,378,171,169,2,64,2,0.023668639,0,empty,CD-0722-2
"D2,H4",7065,8085,5292,2793,4707,2555,0,2555,1679,876,1.916666667,1478,338,44,34,30,4,23,1,0.133333333,0,empty,CD-0722-2
"D2,H5",7484,8411,5429,2982,4889,2715,0,2715,1742,973,1.790339157,1559,3289,893,379,376,3,115,2,0.029255319,0,empty,CD-0722-2
"D2,H6",509393,556736,396389,160347,318360,149896,0,150047,116249,33798,3.439523049,81977,66604,14030,5184,5099,85,931,5,0.023141793,0,hg38,CD-0722-2
"D2,H7",5139,5642,3763,1879,3418,1798,0,1802,1183,619,1.911147011,991,2518,586,268,264,4,103,2,0.049242424,0,empty,CD-0722-2
"D2,H8",6030,6886,4401,2485,4035,2302,0,2305,1496,809,1.849196539,1322,2082,463,224,220,4,82,2,0.040909091,0,empty,CD-0722-2
"D2,H9",439122,531111,325014,206097,302708,176776,3,176931,140712,36219,3.885032718,104679,56310,8778,3334,3267,67,714,3,0.063360882,0,hg38,CD-0722-2
"D2,H10",3596167,4440921,2588822,1852099,2408582,1553151,7,1554235,1245438,308797,4.033193328,950467,320919,53937,20846,20460,386,2871,12,0.082404692,0,hg38,CD-0722-2
"D2,H11",5935,7287,4021,3266,4341,2871,0,2874,1530,1344,1.138392857,1773,227,35,21,21,0,12,0,0,0,empty,CD-0722-2
"D2,H12",4504,5184,3252,1932,3069,1733,0,1733,1120,613,1.827079935,1034,1662,331,145,144,1,66,1,0.069444444,0,empty,CD-0722-2
"D3,A1",541604,635620,407116,228504,366967,199817,1,200002,154045,45957,3.351937681,117377,126165,13705,5332,5154,178,940,5,0.063251843,0,hg38,CD-0722-2
"D3,A2",10378,11708,7762,3946,6886,3669,0,3669,2372,1297,1.828835775,2023,3293,755,331,331,0,86,0,0.157099698,0,empty,CD-0722-2
"D3,A3",4058,4512,2888,1624,2695,1450,0,1450,985,465,2.11827957,867,1645,356,142,140,2,53,1,0.007142857,0,empty,CD-0722-2
"D3,A4",6536,7386,4868,2518,4356,2338,0,2343,1573,770,2.042857143,1346,1132,341,139,137,2,38,2,0.116788321,0,empty,CD-0722-2
"D3,A5",5585,6185,4134,2051,3651,1931,0,1931,1245,686,1.814868805,1059,2003,456,226,225,1,61,1,0.013333333,0,empty,CD-0722-2
"D3,A6",5201,6177,3810,2367,3647,2120,0,2122,1407,715,1.967832168,1212,3331,669,310,305,5,110,1,0.032786885,0,empty,CD-0722-2
"D3,A7",4178,4721,3041,1680,2851,1576,0,1578,1013,565,1.792920354,910,1761,243,120,119,1,48,1,0.050420168,0,empty,CD-0722-2
"D3,A8",2531,2918,1878,1040,1740,963,0,963,656,307,2.136807818,567,2093,310,143,142,1,60,1,0.028169014,0,empty,CD-0722-2
"D3,A9",5692,6565,4206,2359,3876,2096,0,2096,1442,654,2.204892966,1186,1793,266,117,116,1,48,1,0.034482759,0,empty,CD-0722-2
"D3,A10",5819,6474,4430,2044,3803,1996,0,2000,1246,754,1.652519894,1064,468,85,38,38,0,14,0,0,0,empty,CD-0722-2
"D3,A11",451009,523923,333860,190063,301133,169783,0,169938,143160,26778,5.3461797,98185,138157,26171,9010,8868,142,1597,5,0.040482634,0,hg38,CD-0722-2
"D3,A12",6163,6948,4549,2399,4043,2168,0,2169,1433,736,1.94701087,1238,4109,1010,409,403,6,122,2,0.034739454,0,empty,CD-0722-2
"D3,B1",4689,5428,3464,1964,3281,1844,1,1847,1184,663,1.785822021,1057,1671,293,126,123,3,44,2,0.073170732,0,empty,CD-0722-2
"D3,B2",5744,6641,3943,2698,3851,2289,0,2289,1506,783,1.923371648,1353,549,77,49,49,0,27,0,0.06122449,0,empty,CD-0722-2
"D3,B3",560648,653649,417888,235761,376858,209777,2,209957,167249,42708,3.916104711,122840,65852,11420,4396,4319,77,819,3,0.034730262,0,hg38,CD-0722-2
"D3,B4",5051,5878,3718,2160,3477,2050,0,2052,1308,744,1.758064516,1199,1725,444,194,194,0,50,0,0.154639175,0,empty,CD-0722-2
"D3,B5",4680,2609,1612,997,1883,1043,0,1046,682,364,1.873626374,644,1139,308,124,122,2,34,1,0.196721311,0,empty,CD-0722-2
"D3,B6",5260,6024,3744,2280,3603,2069,0,2071,1319,752,1.753989362,1229,1946,388,153,153,0,48,0,0.267973856,0,empty,CD-0722-2
"D3,B7",4894,5609,3592,2017,3276,1728,0,1728,1183,545,2.170642202,998,1376,409,139,139,0,45,0,0.064748201,0,empty,CD-0722-2
"D3,B8",3511,4181,2546,1635,2446,1357,0,1357,916,441,2.077097506,802,1548,438,178,176,2,57,2,0.102272727,0,empty,CD-0722-2
"D3,B9",7026,8092,4986,3106,4826,2771,0,2774,1817,957,1.898641588,1663,1458,356,175,172,3,70,1,0.081395349,0,empty,CD-0722-2
"D3,B10",3178,3579,2248,1331,2175,1205,0,1207,781,426,1.833333333,710,685,96,47,42,5,18,1,0.047619048,0,empty,CD-0722-2
"D3,B11",767115,908819,566154,342665,509122,293919,0,294141,226232,67909,3.331399373,174181,9363,1039,392,378,14,117,2,0.055555556,0,hg38,CD-0722-2
"D3,B12",4146,4685,3009,1676,2896,1625,0,1629,1056,573,1.842931937,927,1801,519,214,214,0,54,0,0.060747664,0,empty,CD-0722-2
"D3,C1",7849,8666,5886,2780,5051,2609,0,2612,1626,986,1.649087221,1431,1258,217,76,76,0,30,0,0.052631579,0,empty,CD-0722-2
"D3,C2",6678,7390,4890,2500,4425,2497,0,2503,1643,860,1.910465116,1384,2521,760,285,282,3,73,2,0.113475177,0,empty,CD-0722-2
"D3,C3",7287,8326,5215,3111,4971,2769,0,2769,1791,978,1.831288344,1609,1083,205,74,74,0,35,0,0.202702703,0,empty,CD-0722-2
"D3,C4",4522,5258,3391,1867,3021,1558,0,1561,1019,542,1.880073801,880,2089,533,183,178,5,52,2,0.073033708,0,empty,CD-0722-2
"D3,C5",6462,7367,4773,2594,4391,2436,0,2439,1629,810,2.011111111,1381,2684,439,165,163,2,43,1,0.079754601,0,empty,CD-0722-2
"D3,C6",5310,5986,3878,2108,3598,2048,0,2048,1289,759,1.69828722,1135,1769,513,213,209,4,48,1,0.043062201,0,empty,CD-0722-2
"D3,C7",8113,9612,5694,3918,5681,3469,0,3471,2114,1357,1.557848195,2098,498,163,49,49,0,22,0,0,0,empty,CD-0722-2
"D3,C8",8202,9523,5983,3540,5674,3147,0,3147,2153,994,2.165995976,1852,3474,629,300,296,4,112,2,0.050675676,0,empty,CD-0722-2
"D3,C9",5685,6801,4142,2659,3997,2272,0,2276,1486,790,1.881012658,1350,1629,317,136,135,1,35,1,0.125925926,0,empty,CD-0722-2
"D3,C10",6230,6874,4634,2240,4082,2174,0,2174,1438,736,1.953804348,1208,1957,439,163,159,4,52,2,0.169811321,0,empty,CD-0722-2
"D3,C11",5173,5992,3841,2151,3599,1962,0,1968,1249,719,1.73713491,1150,2417,671,275,274,1,71,1,0.051094891,0,empty,CD-0722-2
"D3,C12",1192120,1414008,868892,545116,792914,462055,2,462459,364871,97588,3.738892077,277153,170281,32460,12300,12124,176,1936,7,0.051963048,0,hg38,CD-0722-2
"D3,D1",7312,8802,5199,3603,5280,3156,0,3156,1898,1258,1.508744038,1911,970,146,53,50,3,28,2,0.04,0,empty,CD-0722-2
"D3,D2",5388,6046,3994,2052,3623,1946,0,1946,1281,665,1.926315789,1089,3217,821,309,303,6,100,3,0.079207921,0,empty,CD-0722-2
"D3,D3",4968,5742,3598,2144,3371,1837,0,1840,1201,639,1.879499218,1096,1941,455,231,231,0,63,0,0.064935065,0,empty,CD-0722-2
"D3,D4",4055,4674,3010,1664,2719,1500,0,1502,944,558,1.691756272,862,1627,346,136,136,0,50,0,0.014705882,0,empty,CD-0722-2
"D3,D5",502081,583800,374224,209576,339438,193277,2,193439,147613,45826,3.221162659,112205,19536,5849,2126,2105,21,431,3,0.0304038,0,hg38,CD-0722-2
"D3,D6",6862,7571,4865,2706,4504,2603,0,2604,1531,1073,1.426840634,1457,2204,682,265,264,1,80,1,0.041666667,0,empty,CD-0722-2
"D3,D7",542394,623278,407664,215614,353696,187463,0,187630,146462,41168,3.557666148,108383,153270,16695,6688,6522,166,1240,5,0.073443729,0,hg38,CD-0722-2
"D3,D8",4883,5388,3668,1720,3302,1768,0,1772,1197,575,2.08173913,996,2083,439,142,140,2,57,2,0.057142857,0,empty,CD-0722-2
"D3,D9",2584,2789,1920,869,1726,901,0,901,609,292,2.085616438,512,1713,462,170,169,1,46,1,0.00591716,0,empty,CD-0722-2
"D3,D10",4965,5843,3480,2363,3439,2013,0,2013,1206,807,1.494423792,1214,1162,305,149,148,1,40,1,0.121621622,0,empty,CD-0722-2
"D3,D11",5232,5872,3781,2091,3425,1791,0,1791,1184,607,1.950576606,1008,3106,721,295,291,4,85,2,0.048109966,0,empty,CD-0722-2
"D3,D12",6524,7404,4817,2587,4391,2358,0,2360,1592,768,2.072916667,1311,3636,607,277,270,7,112,2,0.074074074,0,empty,CD-0722-2
"D3,E1",527972,562500,415573,146927,318722,143211,1,143342,109280,34062,3.208267277,75428,69724,8715,3159,3064,95,692,5,0.015013055,0,hg38,CD-0722-2
"D3,E2",5523,6141,4016,2125,3697,2011,0,2011,1257,754,1.667108753,1148,1948,320,138,138,0,54,0,0.028985507,0,empty,CD-0722-2
"D3,E3",400512,478577,292904,185673,276144,158813,0,158919,132710,26209,5.063527796,94893,241467,53691,18984,18702,282,2600,8,0.051438349,0,hg38,CD-0722-2
"D3,E4",5246,6110,3788,2322,3591,2000,1,2001,1292,709,1.822284908,1175,2682,533,247,245,2,86,1,0.06122449,0,empty,CD-0722-2
"D3,E5",4553,5080,3360,1720,3013,1543,0,1543,993,550,1.805454545,892,2254,593,200,200,0,57,0,0.025,0,empty,CD-0722-2
"D3,E6",568311,636383,439330,197053,359324,179770,3,179919,133345,46574,2.863078112,100374,47475,7888,2952,2892,60,636,4,0.03077455,0,hg38,CD-0722-2
"D3,E7",7841,8783,5834,2949,5212,2703,0,2703,1823,880,2.071590909,1552,3429,848,350,348,2,113,2,0.08908046,0,empty,CD-0722-2
"D3,E8",6078,6796,4521,2275,3954,2046,0,2049,1364,685,1.991240876,1166,3953,936,367,352,15,94,2,0.073863636,0,empty,CD-0722-2
"D3,E9",4411,5110,3239,1871,3062,1663,0,1666,1105,561,1.96969697,966,2189,435,211,211,0,66,0,0.085308057,0,empty,CD-0722-2
"D3,E10",584482,703942,425232,278710,404070,238031,1,238215,188552,49663,3.796629281,144061,70793,10100,3629,3555,74,854,5,0.026160338,0,hg38,CD-0722-2
"D3,E11",5064,5750,3664,2086,3497,1898,0,1900,1231,669,1.840059791,1098,2142,420,152,151,1,53,1,0.125827815,0,empty,CD-0722-2
"D3,E12",6482,7447,4728,2719,4484,2526,0,2527,1726,801,2.154806492,1477,2523,468,216,208,8,60,2,0.173076923,0,empty,CD-0722-2
"D3,F1",7028,8019,5219,2800,4666,2497,0,2499,1532,967,1.584281282,1391,2733,795,287,287,0,88,0,0.055749129,0,empty,CD-0722-2
"D3,F2",5574,6299,3922,2377,3695,2042,0,2044,1291,753,1.714475432,1228,3580,775,271,263,8,80,2,0.182509506,0,empty,CD-0722-2
"D3,F3",5046,5495,3690,1805,3406,1781,0,1784,1159,625,1.8544,1029,3264,745,299,296,3,98,3,0.010135135,0,empty,CD-0722-2
"D3,F4",661713,762603,489019,273584,440620,242432,4,242662,187073,55589,3.365288097,141351,54888,7417,2972,2912,60,545,4,0.067651099,0,hg38,CD-0722-2
"D3,F5",5802,6625,4267,2358,4027,2138,0,2138,1431,707,2.024045262,1254,3239,748,299,291,8,88,2,0.103092784,0,empty,CD-0722-2
"D3,F6",6251,7678,4460,3218,4408,2605,0,2605,1651,954,1.730607966,1606,4095,1085,415,412,3,102,2,0.11407767,0,empty,CD-0722-2
"D3,F7",6788,7767,4959,2808,4575,2449,0,2451,1613,838,1.924821002,1419,1397,419,165,165,0,51,0,0.018181818,0,empty,CD-0722-2
"D3,F8",5293,6119,3914,2205,3636,1981,0,1983,1321,662,1.995468278,1131,424,70,29,29,0,18,0,0.034482759,0,empty,CD-0722-2
"D3,F9",5838,6560,4472,2088,3945,1996,0,1996,1367,629,2.173290938,1099,3713,798,347,346,1,122,1,0.069364162,0,empty,CD-0722-2
"D3,F10",6724,7548,5063,2485,4477,2358,0,2358,1528,830,1.840963855,1318,1819,568,218,217,1,60,1,0.036866359,0,empty,CD-0722-2
"D3,F11",5779,6390,4345,2045,3814,1930,0,1932,1325,607,2.182866557,1067,1982,396,138,136,2,58,1,0.058823529,0,empty,CD-0722-2
"D3,F12",6100,6846,4410,2436,4034,2219,0,2221,1462,759,1.926218709,1301,377,57,35,34,1,19,1,0.058823529,0,empty,CD-0722-2
"D3,G1",6435,7238,4755,2483,4178,2186,0,2189,1451,738,1.966124661,1204,3983,837,292,292,0,98,0,0.01369863,0,empty,CD-0722-2
"D3,G2",3872,4381,2708,1673,2675,1546,0,1546,1033,513,2.013645224,928,629,77,52,50,2,31,1,0.02,0,empty,CD-0722-2
"D3,G3",6965,7611,5039,2572,4469,2476,0,2478,1461,1017,1.436578171,1331,2830,620,272,260,12,81,2,0.092307692,0,empty,CD-0722-2
"D3,G4",2625846,3098155,1949193,1148962,1697459,993531,5,994309,824404,169905,4.852146788,584080,4500,689,299,294,5,74,2,0.091836735,0,hg38,CD-0722-2
"D3,G5",514196,607121,381033,226088,345615,189791,2,189960,149317,40643,3.673867579,113398,166359,27343,10730,10524,206,1613,7,0.059673128,0,hg38,CD-0722-2
"D3,G6",6334,7184,4725,2459,4263,2306,0,2307,1510,797,1.894604768,1321,240,35,21,20,1,10,1,0,0,empty,CD-0722-2
"D3,G7",5166,5736,3878,1858,3414,1753,0,1755,1147,608,1.886513158,968,3340,750,326,322,4,76,2,0.071428571,0,empty,CD-0722-2
"D3,G8",3655,4019,2668,1351,2423,1295,0,1301,805,496,1.622983871,752,2169,511,237,233,4,74,1,0.017167382,0,empty,CD-0722-2
"D3,G9",907972,1056938,675053,381885,600538,330642,0,330896,254290,76606,3.319452784,195384,244306,33262,13027,12687,340,1949,7,0.041459762,0,hg38,CD-0722-2
"D3,G10",5605,6447,4065,2382,3836,2141,0,2141,1382,759,1.820816864,1256,2793,622,295,288,7,82,2,0.128472222,0,empty,CD-0722-2
"D3,G11",5503,6105,4150,1955,3565,1807,0,1810,1279,531,2.4086629,988,1638,563,199,199,0,63,0,0.060301508,0,empty,CD-0722-2
"D3,G12",4807,5579,3450,2129,3448,1985,0,1985,1361,624,2.181089744,1201,2966,729,314,307,7,86,2,0.016286645,0,empty,CD-0722-2
"D3,H1",5432,6198,3930,2268,3721,2018,1,2025,1366,659,2.072837633,1208,1647,396,193,191,2,63,1,0.052356021,0,empty,CD-0722-2
"D3,H2",6468,7425,4632,2793,4340,2423,0,2424,1546,878,1.760820046,1454,3385,1281,422,422,0,93,0,0.033175355,0,empty,CD-0722-2
"D3,H3",4971,5716,3643,2073,3376,1902,0,1905,1253,652,1.921779141,1091,2235,447,206,205,1,65,1,0.019512195,0,empty,CD-0722-2
"D3,H4",6761,7612,5014,2598,4569,2405,0,2411,1571,840,1.870238095,1381,316,98,30,30,0,17,0,0.033333333,0,empty,CD-0722-2
"D3,H5",649365,787616,466341,321275,448161,267934,1,268156,212274,55882,3.79861136,164187,147646,23239,8990,8804,186,1518,4,0.054407088,0,hg38,CD-0722-2
"D3,H6",4783,5493,3471,2022,3333,1899,0,1901,1281,620,2.066129032,1121,2401,353,140,140,0,61,0,0.028571429,0,empty,CD-0722-2
"D3,H7",5267,5823,3919,1904,3595,1909,0,1909,1295,614,2.109120521,1067,3570,848,355,354,1,116,1,0.124293785,0,empty,CD-0722-2
"D3,H8",6079,7303,4318,2985,4198,2449,0,2449,1622,827,1.961305925,1483,2753,374,173,170,3,68,3,0.041176471,0,empty,CD-0722-2
"D3,H9",4499,5031,3375,1656,2958,1498,0,1498,963,535,1.8,830,1527,456,187,186,1,54,1,0.053763441,0,empty,CD-0722-2
"D3,H10",6309,7295,4563,2732,4266,2333,0,2335,1706,629,2.712241653,1345,1742,296,141,138,3,61,2,0.072463768,0,empty,CD-0722-2
"D3,H11",6262,7527,4133,3394,4538,3013,0,3015,1697,1318,1.287556904,1928,80,13,10,10,0,6,0,0,0,empty,CD-0722-2
"D3,H12",4718,5245,3343,1902,3098,1739,0,1739,1122,617,1.818476499,1004,1829,418,166,165,1,49,1,0.048484848,0,empty,CD-0722-2
"D4,A1",4249,4872,3056,1816,2979,1735,3,1740,1131,609,1.857142857,1008,1190,239,109,108,1,42,1,0.055555556,0,empty,CD-0722-2
"D4,A2",6356,7281,4597,2684,4425,2515,0,2516,1557,959,1.623566215,1499,2375,477,182,181,1,69,1,0.08839779,0,empty,CD-0722-2
"D4,A3",3891,4127,2897,1230,2539,1327,0,1331,890,441,2.01814059,724,1556,341,161,159,2,63,1,0,0,empty,CD-0722-2
"D4,A4",6596,7583,4866,2717,4570,2464,0,2465,1622,843,1.924080664,1425,901,205,83,82,1,39,1,0.036585366,0,empty,CD-0722-2
"D4,A5",6621,7131,4886,2245,4373,2265,0,2265,1501,764,1.964659686,1231,3299,604,240,231,9,80,2,0.090909091,0,empty,CD-0722-2
"D4,A6",5010,5866,3687,2179,3576,2070,0,2071,1366,705,1.937588652,1188,3405,861,337,330,7,122,3,0.03030303,0,empty,CD-0722-2
"D4,A7",4230,4995,3128,1867,2945,1694,0,1694,1098,596,1.842281879,1000,1484,254,100,99,1,45,1,0.111111111,0,empty,CD-0722-2
"D4,A8",2563,3004,1800,1204,1818,1067,0,1071,705,366,1.926229508,620,1833,359,156,152,4,60,2,0.078947368,0,empty,CD-0722-2
"D4,A9",4568,5221,3326,1895,3078,1637,1,1648,1040,608,1.710526316,918,1998,444,191,187,4,53,2,0.155080214,0,empty,CD-0722-2
"D4,A10",6357,7078,4849,2229,4157,2167,0,2174,1415,759,1.864295125,1163,746,82,33,33,0,16,0,0,0,empty,CD-0722-2
"D4,A11",3833,4283,2874,1409,2723,1451,1,1456,996,460,2.165217391,801,1990,431,194,192,2,69,1,0.114583333,0,empty,CD-0722-2
"D4,A12",5781,6647,4355,2292,4045,2165,0,2167,1382,785,1.760509554,1248,3790,844,373,368,5,94,2,0.144021739,0,empty,CD-0722-2
"D4,B1",4597,5250,3314,1936,3227,1849,0,1851,1167,684,1.706140351,1092,1400,310,133,133,0,59,0,0.07518797,0,empty,CD-0722-2
"D4,B2",577535,677189,407658,269531,393351,227377,1,227542,178265,49277,3.61761065,137801,100336,12053,4783,4664,119,909,7,0.042881647,0,hg38,CD-0722-2
"D4,B3",431863,507787,319945,187842,295562,165039,2,165154,129432,35722,3.623313364,98075,33894,7030,2695,2658,37,568,2,0.027840482,0,hg38,CD-0722-2
"D4,B4",4838,5736,3429,2307,3549,2181,0,2181,1393,788,1.767766497,1332,1767,352,153,153,0,41,0,0.104575163,0,empty,CD-0722-2
"D4,B5",6708,5148,3044,2104,3366,1911,0,1917,1342,575,2.333913043,1228,1707,450,157,154,3,47,1,0.253246753,0,empty,CD-0722-2
"D4,B6",5252,5942,3800,2142,3590,2104,0,2109,1308,801,1.632958801,1194,1577,399,175,173,2,56,1,0.086705202,0,empty,CD-0722-2
"D4,B7",4937,5619,3651,1968,3331,1789,0,1792,1211,581,2.084337349,1009,1852,322,138,134,4,46,1,0.156716418,0,empty,CD-0722-2
"D4,B8",3555,3969,2655,1314,2448,1340,0,1340,881,459,1.919389978,748,1364,282,120,119,1,50,1,0.084033613,0,empty,CD-0722-2
"D4,B9",6987,8042,5005,3037,4866,2797,0,2798,1747,1051,1.662226451,1669,1416,348,139,136,3,58,1,0.161764706,0,empty,CD-0722-2
"D4,B10",696993,763869,499385,264484,455771,244724,11,245264,197267,47997,4.109986041,142254,17540,2600,1045,1018,27,213,4,0.019646365,0,hg38,CD-0722-2
"D4,B11",7643,8715,5481,3234,5259,3119,0,3121,1748,1373,1.273124545,1798,564,138,36,34,2,20,1,0,0,empty,CD-0722-2
"D4,B12",4169,4932,3001,1931,2996,1749,0,1751,1162,589,1.972835314,1060,1524,359,136,135,1,63,1,0.02962963,0,empty,CD-0722-2
"D4,C1",8133,8939,6128,2811,5267,2680,0,2686,1705,981,1.738022426,1487,1137,298,106,105,1,29,1,0.104761905,0,empty,CD-0722-2
"D4,C2",6751,7785,4864,2921,4570,2563,0,2563,1659,904,1.835176991,1506,2317,479,215,213,2,77,1,0.004694836,0,empty,CD-0722-2
"D4,C3",553433,641177,413245,227932,369249,201400,2,201569,165167,36402,4.537305643,117567,42220,7867,2913,2874,39,591,3,0.028183716,0,hg38,CD-0722-2
"D4,C4",4304,4714,3257,1457,2819,1415,1,1417,928,489,1.897750511,758,2167,561,228,223,5,68,2,0.049327354,0,empty,CD-0722-2
"D4,C5",7703,8787,5738,3049,5291,2847,0,2853,1962,891,2.202020202,1614,2229,645,257,254,3,65,2,0.098425197,0,empty,CD-0722-2
"D4,C6",5182,5712,3752,1960,3478,1861,0,1861,1224,637,1.921507064,1050,2014,426,162,159,3,54,1,0.050314465,0,empty,CD-0722-2
"D4,C7",7715,9224,5378,3846,5506,3395,0,3396,2005,1391,1.441409058,2055,558,92,42,42,0,22,0,0.095238095,0,empty,CD-0722-2
"D4,C8",8371,9571,6109,3462,5693,3151,0,3155,2101,1054,1.993358634,1801,3737,800,294,290,4,96,2,0.093103448,0,empty,CD-0722-2
"D4,C9",8549,10170,6270,3900,5961,3329,0,3333,2208,1125,1.962666667,1994,3418,702,262,257,5,74,2,0.081712062,0,empty,CD-0722-2
"D4,C10",6521,7312,4837,2475,4403,2333,0,2338,1529,809,1.889987639,1328,2796,829,327,326,1,84,1,0.085889571,0,empty,CD-0722-2
"D4,C11",5099,5688,3659,2029,3572,1972,0,1972,1247,725,1.72,1114,2415,593,225,224,1,74,1,0.120535714,0,empty,CD-0722-2
"D4,C12",7578,8419,5519,2900,5118,2722,0,2724,1867,857,2.178529755,1546,2452,772,297,297,0,69,0,0,0,empty,CD-0722-2
"D4,D1",6797,7933,4806,3127,4780,2786,0,2791,1658,1133,1.46337158,1659,919,162,87,84,3,40,1,0,0,empty,CD-0722-2
"D4,D2",5283,5904,3928,1976,3568,1812,0,1812,1220,592,2.060810811,984,3462,933,364,361,3,114,2,0.08033241,0,empty,CD-0722-2
"D4,D3",5242,6034,3776,2258,3620,2068,0,2072,1338,734,1.822888283,1197,2335,461,204,200,4,70,1,0.165,0,empty,CD-0722-2
"D4,D4",3780,4349,2816,1533,2620,1447,0,1449,912,537,1.698324022,815,1701,522,207,207,0,59,0,0,0,empty,CD-0722-2
"D4,D5",674923,836607,481226,355381,483006,298569,1,298776,244218,54558,4.476300451,183923,60883,17517,6485,6434,51,1125,3,0.055020205,0,hg38,CD-0722-2
"D4,D6",673294,803783,493466,310317,459536,263553,3,263785,207020,56765,3.64696556,158445,66118,7859,2931,2867,64,779,7,0.031740495,0,hg38,CD-0722-2
"D4,D7",3989,4338,2972,1366,2634,1431,0,1433,959,474,2.023206751,776,2985,758,288,286,2,106,1,0.034965035,0,empty,CD-0722-2
"D4,D8",4762,5452,3461,1991,3293,1815,0,1817,1155,662,1.744712991,1081,1761,409,132,131,1,44,1,0.076335878,0,empty,CD-0722-2
"D4,D9",2545,2747,1853,894,1693,923,0,923,630,293,2.150170648,510,2079,462,141,138,3,51,1,0.028985507,0,empty,CD-0722-2
"D4,D10",5294,6147,3822,2325,3687,2083,0,2083,1364,719,1.897079277,1206,1290,240,131,129,2,47,2,0,0,empty,CD-0722-2
"D4,D11",5033,5611,3766,1845,3390,1784,0,1786,1144,642,1.781931464,964,2876,673,312,311,1,100,1,0.032154341,0,empty,CD-0722-2
"D4,D12",619162,734990,451344,283646,421687,243535,2,243718,199916,43802,4.564083832,145475,119797,24785,9188,9051,137,1557,6,0.050712628,0,hg38,CD-0722-2
"D4,E1",8124,8948,6016,2932,5328,2871,0,2874,1804,1070,1.685981308,1554,3150,740,289,285,4,90,2,0.129824561,0,empty,CD-0722-2
"D4,E2",5689,6378,4144,2234,3828,2130,0,2131,1358,773,1.756791721,1203,2642,633,217,210,7,68,2,0.223809524,0,empty,CD-0722-2
"D4,E3",3804,4516,2754,1762,2778,1603,0,1604,1045,559,1.86940966,975,3057,767,267,260,7,80,2,0.076923077,0,empty,CD-0722-2
"D4,E4",5077,5987,3673,2314,3595,1977,0,1979,1306,673,1.940564636,1176,3367,900,361,357,4,102,2,0.086834734,0,empty,CD-0722-2
"D4,E5",6112,7024,4447,2577,4206,2259,0,2259,1433,826,1.734866828,1299,1500,258,124,124,0,51,0,0,0,empty,CD-0722-2
"D4,E6",9196,10647,6730,3917,6243,3467,0,3469,2291,1178,1.944821732,1990,4490,1269,443,438,5,128,2,0.098173516,0,empty,CD-0722-2
"D4,E7",7946,8714,5897,2817,5305,2775,0,2777,1820,957,1.901776385,1531,3507,733,322,315,7,100,2,0.041269841,0,empty,CD-0722-2
"D4,E8",6049,6814,4493,2321,3993,2064,0,2066,1362,704,1.934659091,1210,3375,930,322,314,8,89,3,0.092356688,0,empty,CD-0722-2
"D4,E9",819775,973704,606014,367690,558641,326295,0,326528,232005,94523,2.454481978,194616,115016,27193,10161,10051,110,1698,8,0.031937121,0,hg38,CD-0722-2
"D4,E10",4420,5132,3379,1753,3036,1625,0,1628,1042,586,1.778156997,929,2031,619,226,225,1,57,1,0.022222222,0,empty,CD-0722-2
"D4,E11",5422,6125,3828,2297,3693,2111,0,2111,1351,760,1.777631579,1231,2228,468,188,186,2,55,1,0.102150538,0,empty,CD-0722-2
"D4,E12",842382,1045634,611304,434330,598879,363260,1,363546,298404,65142,4.580823432,223597,273964,47258,18092,17802,290,2468,9,0.078137288,0,hg38,CD-0722-2
"D4,F1",6900,7880,5027,2853,4797,2653,0,2654,1748,906,1.929359823,1546,2979,724,275,272,3,103,2,0.014705882,0,empty,CD-0722-2
"D4,F2",5912,6730,4326,2404,4021,2202,0,2208,1410,798,1.766917293,1247,3221,648,251,251,0,84,0,0.051792829,0,empty,CD-0722-2
"D4,F3",5267,6122,3887,2235,3665,2017,0,2022,1328,694,1.913544669,1173,3589,859,306,301,5,86,2,0.056478405,0,empty,CD-0722-2
"D4,F4",7991,8756,5945,2811,5325,2716,1,2720,1786,934,1.912205567,1495,1377,295,91,90,1,41,1,0.122222222,0,empty,CD-0722-2
"D4,F5",5997,6512,4512,2000,3929,1982,0,1984,1341,643,2.085536547,1036,2351,493,219,219,0,82,0,0.141552511,0,empty,CD-0722-2
"D4,F6",5985,6637,4368,2269,3987,2213,0,2217,1406,811,1.733662145,1254,3465,637,273,271,2,78,1,0.099630996,0,empty,CD-0722-2
"D4,F7",6572,7211,4730,2481,4380,2405,0,2405,1600,805,1.98757764,1370,1123,158,82,81,1,35,1,0.012345679,0,empty,CD-0722-2
"D4,F8",5191,5873,3767,2106,3620,1994,0,1995,1269,726,1.747933884,1164,484,86,34,34,0,21,0,0,0,empty,CD-0722-2
"D4,F9",6008,6709,4464,2245,4046,2147,0,2153,1404,749,1.874499332,1211,2971,617,270,262,8,89,2,0.099236641,0,empty,CD-0722-2
"D4,F10",6828,7618,5168,2450,4527,2348,0,2352,1508,844,1.786729858,1324,1793,417,194,191,3,61,2,0.02617801,0,empty,CD-0722-2
"D4,F11",5753,6436,4296,2140,3926,2020,0,2021,1311,710,1.846478873,1169,1624,330,139,138,1,54,1,0.050724638,0,empty,CD-0722-2
"D4,F12",746214,884701,532626,352075,510276,308995,0,309215,222382,86833,2.561030944,187048,12007,1199,456,442,14,110,3,0.031674208,0,hg38,CD-0722-2
"D4,G1",6254,7052,4638,2414,4224,2285,0,2294,1469,825,1.780606061,1271,3503,911,355,346,9,112,2,0.130057803,0,empty,CD-0722-2
"D4,G2",1618501,1894681,1153802,740879,1079319,637480,5,637963,500011,137952,3.624528822,383677,73183,12984,4820,4739,81,931,5,0.049799536,0,hg38,CD-0722-2
"D4,G3",7407,8210,5342,2868,4849,2700,0,2705,1637,1068,1.532771536,1483,2713,905,300,299,1,93,1,0.056856187,0,empty,CD-0722-2
"D4,G4",13473,15732,9522,6210,9359,5581,0,5595,3349,2246,1.49109528,3300,293,71,47,47,0,21,0,0,0,empty,CD-0722-2
"D4,G5",4397,5191,3174,2017,3099,1744,0,1746,1114,632,1.762658228,1026,2062,395,152,147,5,69,1,0.020408163,0,empty,CD-0722-2
"D4,G6",6150,7004,4460,2544,4187,2315,0,2315,1631,684,2.384502924,1329,213,40,21,21,0,14,0,0.142857143,0,empty,CD-0722-2
"D4,G7",5266,5701,3874,1827,3404,1723,1,1727,1148,579,1.982728843,940,8801,1432,566,561,5,150,2,0.060606061,0,empty,CD-0722-2
"D4,G8",3700,4289,2635,1654,2590,1456,1,1459,978,481,2.033264033,850,2136,448,202,200,2,71,1,0.125,0,empty,CD-0722-2
"D4,G9",4609,5398,3373,2025,3197,1774,0,1775,1157,618,1.872168285,1053,3116,820,311,307,4,82,2,0.104234528,0,empty,CD-0722-2
"D4,G10",5556,6501,4064,2437,3896,2214,0,2216,1429,787,1.815756036,1314,2806,718,292,288,4,94,2,0.041666667,0,empty,CD-0722-2
"D4,G11",5396,6048,4025,2023,3549,1853,0,1857,1173,684,1.714912281,1032,1476,298,127,125,2,48,1,0.128,0,empty,CD-0722-2
"D4,G12",649097,821773,456737,365036,482583,305592,0,305817,235288,70529,3.336046165,193717,45908,18015,6091,6061,30,1123,3,0.031512952,0,hg38,CD-0722-2
"D4,H1",5361,6083,3946,2137,3749,2032,0,2032,1353,679,1.99263623,1194,1572,472,184,183,1,67,1,0.071038251,0,empty,CD-0722-2
"D4,H2",5401,6290,3861,2429,3734,2043,0,2045,1340,705,1.90070922,1240,2826,734,270,267,3,101,1,0.041198502,0,empty,CD-0722-2
"D4,H3",4802,5442,3495,1947,3374,1865,0,1865,1244,621,2.003220612,1104,1802,503,225,223,2,78,1,0.067264574,0,empty,CD-0722-2
"D4,H4",6643,7776,4905,2871,4466,2419,0,2419,1601,818,1.957212714,1408,203,25,18,18,0,14,0,0,0,empty,CD-0722-2
"D4,H5",1834614,2232316,1343489,888827,1238849,740770,2,741366,600435,140931,4.260489176,449292,386437,73007,27930,27549,381,3313,9,0.071145958,0,hg38,CD-0722-2
"D4,H6",4756,5496,3454,2042,3290,1921,0,1922,1295,627,2.06539075,1137,2602,674,256,255,1,88,1,0.035294118,0,empty,CD-0722-2
"D4,H7",662663,791778,484260,307518,456070,263003,8,263210,216274,46936,4.607848986,157086,106969,14383,5527,5428,99,1146,3,0.059506264,0,hg38,CD-0722-2
"D4,H8",457062,519362,348859,170503,297824,151986,0,152128,108757,43371,2.507597242,87557,123872,18559,7144,6988,156,1170,7,0.045220378,0,hg38,CD-0722-2
"D4,H9",4397,4906,3224,1682,3019,1624,0,1624,1085,539,2.012987013,938,1291,354,152,151,1,42,1,0.039735099,0,empty,CD-0722-2
"D4,H10",4371,5040,3181,1859,3015,1658,0,1659,1066,593,1.797639123,984,2108,532,213,213,0,82,0,0.107981221,0,empty,CD-0722-2
"D4,H11",5970,7081,4024,3057,4249,2747,0,2747,1478,1269,1.164696612,1659,53,7,5,5,0,4,0,0,0,empty,CD-0722-2
"D4,H12",1529223,1792440,1129671,662769,1015996,572471,3,572962,448362,124600,3.598410915,341828,501929,75493,29349,28822,527,3325,10,0.04975366,0,hg38,CD-0722-2
"D5,A1",580782,718627,413208,305419,424437,271819,0,271959,190311,81648,2.330871546,166667,30734,11018,4085,4057,28,782,3,0.022676855,0,hg38,CD-0722-2
"D5,A2",5469,6225,3998,2227,3658,2040,0,2049,1211,838,1.445107399,1133,1853,457,179,176,3,49,1,0.130681818,0,empty,CD-0722-2
"D5,A3",3347,3805,2393,1412,2328,1318,0,1318,878,440,1.995454545,760,1036,217,93,92,1,37,1,0.108695652,0,empty,CD-0722-2
"D5,A4",6181,6996,4559,2437,4177,2270,0,2274,1476,798,1.84962406,1284,751,125,58,58,0,26,0,0.017241379,0,empty,CD-0722-2
"D5,A5",4772,5507,3502,2005,3287,1815,0,1815,1098,717,1.531380753,1074,2002,406,180,178,2,55,1,0,0,empty,CD-0722-2
"D5,A6",342813,408999,258084,150915,239703,132724,1,132844,103628,29216,3.54696057,78483,116025,14280,5632,5478,154,1125,6,0.046367287,0,hg38,CD-0722-2
"D5,A7",3639,4056,2660,1396,2489,1380,0,1382,890,492,1.808943089,748,1240,229,105,103,2,40,1,0,0,empty,CD-0722-2
"D5,A8",2292,2740,1661,1079,1589,909,0,909,623,286,2.178321678,533,1775,293,136,133,3,56,1,0.045112782,0,empty,CD-0722-2
"D5,A9",407051,507998,279036,228962,300450,206513,2,206644,156086,50558,3.08726611,125631,2787,404,173,173,0,58,0,0.115606936,0,hg38,CD-0722-2
"D5,A10",4846,5244,3656,1588,3170,1631,0,1633,994,639,1.555555556,911,375,116,37,35,2,16,1,0,0,empty,CD-0722-2
"D5,A11",3218,3551,2467,1084,2124,1038,0,1042,721,321,2.246105919,551,1467,279,130,125,5,49,2,0.032,0,empty,CD-0722-2
"D5,A12",773699,966867,522914,443953,561499,391110,1,391347,288861,102486,2.818541069,238529,16770,2704,905,890,15,262,3,0.140449438,0,hg38,CD-0722-2
"D5,B1",644269,738681,487528,251153,424747,223042,2,223221,170392,52829,3.225349713,127728,115720,15486,5945,5823,122,1058,7,0.071440838,0,hg38,CD-0722-2
"D5,B2",4570,5250,3004,2246,3193,1934,0,1934,1181,753,1.568393094,1168,646,183,67,67,0,20,0,0,0,empty,CD-0722-2
"D5,B3",3534,4005,2478,1527,2453,1382,0,1382,932,450,2.071111111,830,1487,250,143,134,9,52,2,0.111940299,0,empty,CD-0722-2
"D5,B4",3637,4256,2583,1673,2620,1521,0,1521,975,546,1.785714286,932,1380,220,95,93,2,42,2,0.053763441,0,empty,CD-0722-2
"D5,B5",4798,3387,1966,1421,2401,1395,0,1409,971,438,2.216894977,918,944,232,93,92,1,31,1,0.304347826,0,empty,CD-0722-2
"D5,B6",4575,5369,3183,2186,3244,1949,0,1949,1222,727,1.68088033,1214,1662,281,143,143,0,42,0,0.090909091,0,empty,CD-0722-2
"D5,B7",4285,4785,3267,1518,2907,1531,0,1531,1036,495,2.092929293,838,951,217,101,99,2,34,2,0.04040404,0,empty,CD-0722-2
"D5,B8",3129,3547,2306,1241,2167,1147,0,1147,752,395,1.903797468,670,1384,437,164,164,0,63,0,0.115853659,0,empty,CD-0722-2
"D5,B9",5949,6752,4264,2488,4003,2288,0,2292,1475,817,1.805385557,1328,1385,280,96,95,1,48,1,0.010526316,0,empty,CD-0722-2
"D5,B10",2707,2978,1947,1031,1778,932,0,934,603,331,1.821752266,508,630,125,47,47,0,14,0,0.404255319,0,empty,CD-0722-2
"D5,B11",7039,8446,5003,3443,4993,3015,0,3018,1743,1275,1.367058824,1826,303,35,24,24,0,16,0,0,0,empty,CD-0722-2
"D5,B12",3450,4108,2419,1689,2528,1439,0,1440,995,445,2.235955056,906,1891,429,174,174,0,51,0,0.022988506,0,empty,CD-0722-2
"D5,C1",7387,8067,5565,2502,4778,2464,0,2464,1576,888,1.774774775,1321,831,174,77,76,1,26,1,0.013157895,0,empty,CD-0722-2
"D5,C2",6431,7260,4635,2625,4341,2443,0,2447,1539,908,1.694933921,1447,1969,499,197,194,3,56,2,0.051546392,0,empty,CD-0722-2
"D5,C3",6231,6917,4618,2299,4227,2275,0,2284,1534,750,2.045333333,1272,916,178,88,86,2,30,2,0.058139535,0,empty,CD-0722-2
"D5,C4",3824,4233,2837,1396,2554,1324,0,1324,871,453,1.922737307,738,2353,489,202,200,2,47,2,0.155,0,empty,CD-0722-2
"D5,C5",5371,6046,3891,2155,3665,2028,0,2031,1276,755,1.690066225,1178,1465,245,128,127,1,57,1,0.05511811,0,empty,CD-0722-2
"D5,C6",414543,522044,280853,241191,313705,215867,0,216000,159788,56212,2.842595887,135212,2367,574,221,220,1,66,1,0.031818182,0,hg38,CD-0722-2
"D5,C7",6484,7839,4493,3346,4757,2939,0,2943,1736,1207,1.438276719,1809,398,48,25,25,0,14,0,0.04,0,empty,CD-0722-2
"D5,C8",7157,8296,5226,3070,4964,2786,0,2789,1850,939,1.970181044,1649,2795,596,286,282,4,106,3,0.035460993,0,empty,CD-0722-2
"D5,C9",4942,5486,3597,1889,3278,1793,0,1795,1142,653,1.748851455,1015,1742,439,128,126,2,39,1,0.055555556,0,empty,CD-0722-2
"D5,C10",5655,6415,4312,2103,3848,2057,0,2057,1359,698,1.946991404,1146,1681,396,165,164,1,56,1,0.012195122,0,empty,CD-0722-2
"D5,C11",4720,5244,3509,1735,3203,1729,0,1731,1129,602,1.875415282,972,2084,572,205,200,5,69,1,0.025,0,empty,CD-0722-2
"D5,C12",6567,7198,4752,2446,4388,2342,0,2344,1509,835,1.807185629,1347,1345,316,142,140,2,43,1,0.028571429,0,empty,CD-0722-2
"D5,D1",6437,7454,4596,2858,4485,2574,0,2579,1552,1027,1.511197663,1519,696,123,56,56,0,24,0,0.071428571,0,empty,CD-0722-2
"D5,D2",5329,6023,3996,2027,3610,1911,0,1913,1261,652,1.93404908,1044,2707,795,287,283,4,88,1,0.028268551,0,empty,CD-0722-2
"D5,D3",4359,4890,3121,1769,3008,1704,0,1704,1172,532,2.203007519,978,1625,363,155,154,1,57,1,0.149350649,0,empty,CD-0722-2
"D5,D4",3437,3907,2495,1412,2322,1270,0,1273,810,463,1.749460043,712,1182,258,100,99,1,35,1,0.060606061,0,empty,CD-0722-2
"D5,D5",3691,4375,2708,1667,2654,1438,0,1446,941,505,1.863366337,873,1741,276,137,137,0,49,0,0.02919708,0,empty,CD-0722-2
"D5,D6",6247,7070,4377,2693,4159,2447,0,2449,1475,974,1.514373717,1401,2093,364,166,161,5,39,2,0.093167702,0,empty,CD-0722-2
"D5,D7",504897,592404,369576,222828,343523,194026,1,194207,159284,34923,4.561005641,115050,202417,30944,11973,11752,221,1846,5,0.05062968,0,hg38,CD-0722-2
"D5,D8",4057,4534,2986,1548,2782,1532,0,1534,1016,518,1.961389961,865,1090,254,119,117,2,49,1,0.094017094,0,empty,CD-0722-2
"D5,D9",2036,2342,1538,804,1433,752,0,752,495,257,1.926070039,432,2061,582,233,228,5,63,2,0.070175439,0,empty,CD-0722-2
"D5,D10",4225,4779,3014,1765,2894,1606,0,1606,1002,604,1.658940397,971,861,170,79,78,1,19,1,0.012820513,0,empty,CD-0722-2
"D5,D11",425385,482130,318327,163803,281008,148102,0,148203,116394,31809,3.65915307,84352,166845,30469,11583,11419,164,1746,4,0.035554777,0,hg38,CD-0722-2
"D5,D12",6152,6958,4513,2445,4106,2269,0,2271,1448,823,1.759416768,1267,3417,758,285,281,4,98,2,0.017793594,0,empty,CD-0722-2
"D5,E1",7228,8473,5211,3262,4950,2820,0,2820,1694,1126,1.504440497,1632,3192,739,261,259,2,77,2,0.088803089,0,empty,CD-0722-2
"D5,E2",4831,5481,3460,2021,3338,1914,0,1914,1210,704,1.71875,1106,1952,303,144,143,1,47,1,0.118881119,0,empty,CD-0722-2
"D5,E3",3558,4098,2657,1441,2519,1390,0,1390,912,478,1.907949791,813,2330,585,244,242,2,73,1,0.020661157,0,empty,CD-0722-2
"D5,E4",4717,5499,3517,1982,3295,1821,0,1822,1146,676,1.695266272,1105,2421,488,228,223,5,99,3,0.076233184,0,empty,CD-0722-2
"D5,E5",4267,4717,3171,1546,2861,1463,0,1463,938,525,1.786666667,822,1502,363,157,156,1,53,1,0.019230769,0,empty,CD-0722-2
"D5,E6",531103,636702,380398,256304,367805,221503,0,221679,181767,39912,4.554194227,132914,60507,20993,7671,7624,47,1423,2,0.028593914,0,hg38,CD-0722-2
"D5,E7",471805,549923,349561,200362,319113,177684,1,177829,134128,43701,3.069220384,103473,58247,10464,3978,3933,45,822,4,0.057716756,0,hg38,CD-0722-2
"D5,E8",5606,6326,4138,2188,3712,1923,0,1927,1313,614,2.138436482,1071,2112,425,203,202,1,67,1,0.128712871,0,empty,CD-0722-2
"D5,E9",3258,3665,2395,1270,2184,1189,0,1189,788,401,1.965087282,668,2544,702,254,252,2,81,1,0.091269841,0,empty,CD-0722-2
"D5,E10",4027,4756,3005,1751,2858,1584,0,1589,1047,542,1.931734317,945,1605,448,140,138,2,56,1,0.086956522,0,empty,CD-0722-2
"D5,E11",4773,5352,3549,1803,3287,1805,0,1806,1117,689,1.621190131,1021,2034,481,185,183,2,48,2,0.109289617,0,empty,CD-0722-2
"D5,E12",5167,6062,3739,2323,3509,1950,0,1950,1269,681,1.863436123,1113,1874,433,197,195,2,75,2,0.076923077,0,empty,CD-0722-2
"D5,F1",6074,6875,4487,2388,4165,2299,0,2299,1482,817,1.813953488,1284,2459,571,213,210,3,65,2,0.023809524,0,empty,CD-0722-2
"D5,F2",5002,5621,3634,1987,3264,1746,0,1749,1105,644,1.715838509,993,3176,636,278,276,2,81,1,0.06884058,0,empty,CD-0722-2
"D5,F3",4506,4967,3233,1734,2944,1551,0,1552,1020,532,1.917293233,900,2531,734,223,222,1,71,1,0.13963964,0,empty,CD-0722-2
"D5,F4",7233,7855,5291,2564,4677,2400,0,2404,1540,864,1.782407407,1356,785,142,61,59,2,28,1,0.050847458,0,empty,CD-0722-2
"D5,F5",5370,6173,3917,2256,3645,1931,0,1931,1256,675,1.860740741,1120,1775,371,155,152,3,54,2,0.046052632,0,empty,CD-0722-2
"D5,F6",5180,6122,3664,2458,3608,2067,0,2068,1299,769,1.689206762,1209,2716,525,216,215,1,73,1,0.051162791,0,empty,CD-0722-2
"D5,F7",6440,7563,4675,2888,4492,2468,0,2470,1644,826,1.99031477,1451,1045,252,104,101,3,39,1,0.01980198,0,empty,CD-0722-2
"D5,F8",4678,5041,3455,1586,3096,1635,1,1638,1130,508,2.224409449,897,299,62,31,31,0,18,0,0.096774194,0,empty,CD-0722-2
"D5,F9",4857,5592,3609,1983,3368,1759,0,1762,1183,579,2.043177893,1043,3394,847,366,363,3,93,2,0.033057851,0,empty,CD-0722-2
"D5,F10",6770,7603,4958,2645,4521,2416,0,2419,1510,909,1.661166117,1389,2037,485,158,157,1,52,1,0.133757962,0,empty,CD-0722-2
"D5,F11",4864,5474,3699,1775,3250,1647,0,1652,1093,559,1.955277281,908,1480,198,95,95,0,46,0,0.042105263,0,empty,CD-0722-2
"D5,F12",5537,6327,4018,2309,3801,2073,0,2077,1382,695,1.988489209,1254,231,34,20,20,0,12,0,0.1,0,empty,CD-0722-2
"D5,G1",5942,6497,4503,1994,3871,1958,0,1959,1244,715,1.73986014,1036,2652,670,227,227,0,81,0,0.105726872,0,empty,CD-0722-2
"D5,G2",3699,4325,2515,1810,2550,1490,1,1492,963,529,1.820415879,915,685,168,73,69,4,39,2,0.028985507,0,empty,CD-0722-2
"D5,G3",6767,7545,5084,2461,4472,2404,0,2404,1424,980,1.453061224,1243,2535,645,267,266,1,65,1,0.109022556,0,empty,CD-0722-2
"D5,G4",12405,14403,8810,5593,8479,5051,1,5056,3078,1978,1.55611729,2969,149,35,23,23,0,19,0,0,0,empty,CD-0722-2
"D5,G5",3791,4436,2691,1745,2669,1524,0,1525,1011,514,1.96692607,926,2126,452,169,165,4,58,3,0.127272727,0,empty,CD-0722-2
"D5,G6",5954,6484,4404,2080,4004,2164,0,2164,1436,728,1.972527473,1182,212,53,21,21,0,11,0,0,0,empty,CD-0722-2
"D5,G7",12139,13893,9230,4663,8297,4380,0,4387,3357,1030,3.259223301,2459,3539,513,220,216,4,65,2,0.055555556,0,empty,CD-0722-2
"D5,G8",553478,683286,396228,287058,397943,239054,0,239223,192307,46916,4.098964106,147702,143965,26890,10570,10426,144,1687,5,0.049107999,0,hg38,CD-0722-2
"D5,G9",484708,590451,346568,243883,345968,216779,1,216921,163320,53601,3.046958079,131053,43137,10626,3971,3921,50,746,4,0.034685029,0,hg38,CD-0722-2
"D5,G10",4744,5456,3485,1971,3324,1822,0,1826,1167,659,1.770864947,1070,2572,548,215,211,4,66,1,0.028436019,0,empty,CD-0722-2
"D5,G11",4669,5162,3465,1697,3072,1598,0,1598,1035,563,1.838365897,905,1482,329,166,163,3,51,2,0.049079755,0,empty,CD-0722-2
"D5,G12",4004,4583,2855,1728,2767,1531,0,1531,1019,512,1.990234375,895,2483,640,263,260,3,98,2,0.019230769,0,empty,CD-0722-2
"D5,H1",4353,4896,3135,1761,2939,1564,0,1564,1030,534,1.928838951,927,1372,304,149,148,1,49,1,0.006756757,0,empty,CD-0722-2
"D5,H2",697748,851943,506093,345850,495054,290443,2,290680,230403,60277,3.822403238,178960,174211,28005,10844,10644,200,1835,7,0.049511462,0,hg38,CD-0722-2
"D5,H3",3850,4363,2846,1517,2601,1442,0,1442,900,542,1.660516605,830,1800,458,200,198,2,62,1,0.005050505,0,empty,CD-0722-2
"D5,H4",5943,6656,4312,2344,3922,2172,0,2172,1433,739,1.939106901,1214,194,51,31,31,0,18,0,0,0,empty,CD-0722-2
"D5,H5",6661,7437,4891,2546,4462,2461,0,2461,1629,832,1.957932692,1414,2003,518,186,183,3,72,2,0.027322404,0,empty,CD-0722-2
"D5,H6",1095985,1357844,789860,567984,781722,477488,4,477834,395944,81890,4.835071437,293380,331819,57442,21862,21491,371,2943,5,0.053231585,0,hg38,CD-0722-2
"D5,H7",488080,540012,376381,163631,317006,158006,6,158121,109646,48475,2.2619082,87514,55634,9496,3494,3433,61,686,4,0.035537431,0,hg38,CD-0722-2
"D5,H8",5066,5834,3669,2165,3436,1917,0,1921,1251,670,1.867164179,1143,2120,440,160,159,1,65,1,0.100628931,0,empty,CD-0722-2
"D5,H9",4727,5352,3500,1852,3186,1672,0,1674,1206,468,2.576923077,946,1375,507,163,161,2,39,1,0,0,empty,CD-0722-2
"D5,H10",3574,4246,2612,1634,2509,1377,0,1379,909,470,1.934042553,838,1283,224,109,108,1,50,1,0.037037037,0,empty,CD-0722-2
"D5,H11",4714,5652,3171,2481,3414,2230,0,2232,1176,1056,1.113636364,1383,43,9,7,6,1,5,1,0,0,empty,CD-0722-2
"D5,H12",3692,4322,2643,1679,2552,1417,0,1417,945,472,2.002118644,862,1416,301,135,135,0,40,0,0.014814815,0,empty,CD-0722-2
"D6,A1",3671,4195,2572,1623,2580,1487,0,1489,931,558,1.668458781,858,1449,376,174,174,0,48,0,0.120689655,0,empty,CD-0722-2
"D6,A2",5827,6500,4171,2329,3813,2136,0,2141,1246,895,1.392178771,1217,1941,452,176,176,0,59,0,0.102272727,0,empty,CD-0722-2
"D6,A3",3552,3958,2612,1346,2473,1368,0,1368,903,465,1.941935484,799,1586,272,134,134,0,42,0,0.119402985,0,empty,CD-0722-2
"D6,A4",6464,7315,4771,2544,4407,2369,0,2374,1459,915,1.594535519,1358,923,174,90,89,1,29,1,0.02247191,0,empty,CD-0722-2
"D6,A5",5017,5515,3692,1823,3300,1728,0,1730,1126,604,1.864238411,1003,2942,760,297,291,6,76,2,0.109965636,0,empty,CD-0722-2
"D6,A6",1125211,1392357,819444,572913,800377,482872,4,483207,398034,85173,4.67324152,294522,531854,109582,40504,39914,590,4228,8,0.053540111,0,hg38,CD-0722-2
"D6,A7",3719,4328,2707,1621,2662,1558,0,1558,998,560,1.782142857,913,1493,354,160,157,3,62,1,0.082802548,0,empty,CD-0722-2
"D6,A8",2241,2655,1666,989,1585,895,0,895,591,304,1.944078947,532,2057,472,185,182,3,66,2,0.021978022,0,empty,CD-0722-2
"D6,A9",3776,4436,2793,1643,2684,1455,0,1457,900,557,1.615798923,876,2328,609,206,203,3,64,1,0.0591133,0,empty,CD-0722-2
"D6,A10",4842,5261,3632,1629,3211,1722,0,1722,1093,629,1.737678855,868,308,53,31,31,0,18,0,0,0,empty,CD-0722-2
"D6,A11",673998,742550,529671,212879,429883,203502,3,203687,163696,39991,4.093320997,110415,53735,13961,5065,5018,47,879,4,0.032483061,0,hg38,CD-0722-2
"D6,A12",4850,5461,3610,1851,3273,1762,0,1762,1155,607,1.902800659,1025,4231,877,366,362,4,100,2,0.071823204,0,empty,CD-0722-2
"D6,B1",4331,4764,3063,1701,2901,1646,0,1646,1035,611,1.693944354,923,1406,310,150,149,1,44,1,0,0,empty,CD-0722-2
"D6,B2",4632,5169,3145,2024,3197,1867,0,1871,1202,669,1.79671151,1107,816,165,80,78,2,35,2,0.064102564,0,empty,CD-0722-2
"D6,B3",3499,3997,2583,1414,2481,1394,0,1396,917,479,1.91440501,808,1830,417,188,187,1,59,1,0.053475936,0,empty,CD-0722-2
"D6,B4",3900,4540,2708,1832,2779,1679,0,1679,1053,626,1.682108626,1036,1637,335,118,118,0,49,0,0.050847458,0,empty,CD-0722-2
"D6,B5",950492,571235,326790,244445,408730,245222,13,246562,205866,40696,5.058629841,158463,42921,8716,3123,3097,26,702,4,0.070713594,0,hg38,CD-0722-2
"D6,B6",527999,615341,394671,220670,355909,196221,0,196384,158178,38206,4.140135057,113979,174991,33384,13405,13182,223,1856,5,0.064330147,0,hg38,CD-0722-2
"D6,B7",4260,4729,3176,1553,2962,1557,0,1557,1000,557,1.795332136,841,1634,361,164,163,1,55,1,0.196319018,0,empty,CD-0722-2
"D6,B8",3519,4018,2560,1458,2433,1286,0,1288,885,403,2.196029777,744,1513,318,165,165,0,47,0,0.084848485,0,empty,CD-0722-2
"D6,B9",5999,6974,4276,2698,4187,2443,0,2443,1578,865,1.824277457,1453,1353,290,128,124,4,61,2,0,0,empty,CD-0722-2
"D6,B10",2866,3169,2030,1139,1949,1071,0,1075,691,384,1.799479167,626,480,71,35,33,2,16,2,0.242424242,0,empty,CD-0722-2
"D6,B11",6528,7655,4590,3065,4461,2659,0,2659,1503,1156,1.30017301,1529,326,79,40,33,7,16,1,0,0,empty,CD-0722-2
"D6,B12",3631,4022,2658,1364,2441,1338,0,1338,848,490,1.730612245,734,1491,382,169,166,3,51,2,0.018072289,0,empty,CD-0722-2
"D6,C1",7666,8561,5757,2804,5099,2683,0,2690,1692,998,1.695390782,1518,1523,418,154,154,0,40,0,0.149350649,0,empty,CD-0722-2
"D6,C2",6478,7181,4658,2523,4318,2372,0,2377,1512,865,1.747976879,1332,2866,665,269,262,7,78,1,0.061068702,0,empty,CD-0722-2
"D6,C3",6411,7248,4737,2511,4400,2412,0,2415,1556,859,1.811408615,1351,943,240,104,99,5,42,1,0.070707071,0,empty,CD-0722-2
"D6,C4",3936,4441,2930,1511,2653,1411,0,1411,905,506,1.788537549,775,2072,483,200,198,2,57,2,0.111111111,0,empty,CD-0722-2
"D6,C5",5594,6430,4053,2377,3840,2099,0,2099,1373,726,1.891184573,1249,2433,528,187,180,7,53,2,0.011111111,0,empty,CD-0722-2
"D6,C6",4712,5413,3431,1982,3322,1883,0,1885,1199,686,1.747813411,1097,2083,501,165,165,0,63,0,0.042424242,0,empty,CD-0722-2
"D6,C7",6822,7902,4854,3048,4781,2921,0,2931,1789,1142,1.566549912,1740,639,142,47,47,0,19,0,0,0,empty,CD-0722-2
"D6,C8",543670,671514,379961,291553,392220,257089,1,257289,178260,79029,2.255627681,158210,12467,1690,628,607,21,178,2,0.113673806,0,hg38,CD-0722-2
"D6,C9",5449,6415,3944,2471,3828,2210,0,2210,1489,721,2.06518724,1292,1915,405,173,171,2,57,1,0.046783626,0,empty,CD-0722-2
"D6,C10",5779,6842,4292,2550,4082,2280,0,2280,1409,871,1.617680827,1315,2259,554,166,165,1,53,1,0.090909091,0,empty,CD-0722-2
"D6,C11",675579,809191,481165,328026,479078,295485,0,295672,197095,98577,1.999401483,179791,6408,1858,491,487,4,167,1,0.036960986,0,hg38,CD-0722-2
"D6,C12",6826,7421,5052,2369,4494,2346,0,2349,1518,831,1.826714801,1293,2668,697,264,261,3,81,1,0.134099617,0,empty,CD-0722-2
"D6,D1",6186,7102,4481,2621,4316,2517,0,2520,1561,959,1.627737226,1485,1342,354,129,128,1,36,1,0.0078125,0,empty,CD-0722-2
"D6,D2",5211,5783,3883,1900,3523,1854,0,1855,1179,676,1.74408284,1046,3448,892,389,387,2,99,2,0.093023256,0,empty,CD-0722-2
"D6,D3",5680,6417,4125,2292,3796,2142,0,2143,1415,728,1.943681319,1224,3867,677,244,240,4,71,1,0.0375,0,empty,CD-0722-2
"D6,D4",3886,4469,2782,1687,2676,1478,0,1479,956,523,1.82791587,832,1542,362,171,169,2,59,1,0.088757396,0,empty,CD-0722-2
"D6,D5",3828,4314,2802,1512,2605,1402,0,1402,930,472,1.970338983,775,2069,517,187,184,3,56,2,0.097826087,0,empty,CD-0722-2
"D6,D6",6829,7821,4740,3081,4661,2828,1,2832,1692,1140,1.484210526,1700,2409,515,201,199,2,59,1,0.020100503,0,empty,CD-0722-2
"D6,D7",3578,3880,2645,1235,2297,1178,0,1178,776,402,1.930348259,627,2393,531,203,198,5,70,3,0.085858586,0,empty,CD-0722-2
"D6,D8",4350,4976,3234,1742,2973,1650,0,1650,1067,583,1.830188679,936,1757,521,217,215,2,61,1,0.03255814,0,empty,CD-0722-2
"D6,D9",2169,2403,1599,804,1532,809,0,814,545,269,2.026022305,491,2026,511,151,149,2,50,2,0.040268456,0,empty,CD-0722-2
"D6,D10",4289,4820,3083,1737,2896,1632,0,1632,1011,621,1.628019324,940,1260,257,137,135,2,49,1,0.059259259,0,empty,CD-0722-2
"D6,D11",4875,5412,3636,1776,3193,1675,0,1677,1115,562,1.983985765,924,3319,888,393,390,3,98,2,0.071794872,0,empty,CD-0722-2
"D6,D12",1231472,1439742,904653,535089,820204,471795,1,472183,384553,87630,4.388371562,279253,352229,55928,21746,21310,436,2803,7,0.037822618,0,hg38,CD-0722-2
"D6,E1",7047,8171,5063,3108,4876,2723,0,2728,1688,1040,1.623076923,1634,3097,682,278,276,2,73,1,0.065217391,0,empty,CD-0722-2
"D6,E2",5156,5803,3665,2138,3558,2033,0,2037,1302,735,1.771428571,1160,2512,415,170,163,7,57,3,0.104294479,0,empty,CD-0722-2
"D6,E3",3683,4173,2709,1464,2574,1424,0,1424,903,521,1.733205374,831,2389,767,329,325,4,80,2,0.163076923,0,empty,CD-0722-2
"D6,E4",4986,5826,3607,2219,3474,1941,0,1947,1262,685,1.842335766,1157,3022,648,268,266,2,86,1,0.120300752,0,empty,CD-0722-2
"D6,E5",4456,4997,3372,1625,3022,1554,1,1561,1041,520,2.001923077,883,1900,551,164,164,0,50,0,0.024390244,0,empty,CD-0722-2
"D6,E6",7976,9133,5815,3318,5363,3018,0,3020,1899,1121,1.694023194,1812,4547,828,333,330,3,105,3,0.021212121,0,empty,CD-0722-2
"D6,E7",7622,8566,5647,2919,5161,2756,1,2760,1880,880,2.136363636,1526,3568,788,304,299,5,92,2,0.023411371,0,empty,CD-0722-2
"D6,E8",5599,6177,4175,2002,3691,1935,0,1939,1273,666,1.911411411,1021,3350,827,337,333,4,93,3,0.096096096,0,empty,CD-0722-2
"D6,E9",3541,4098,2577,1521,2392,1285,0,1285,845,440,1.920454545,772,2852,629,272,272,0,88,0,0.125,0,empty,CD-0722-2
"D6,E10",4123,4694,3054,1640,2862,1538,0,1538,1003,535,1.874766355,863,1828,455,180,178,2,59,2,0.095505618,0,empty,CD-0722-2
"D6,E11",5089,5550,3767,1783,3321,1765,0,1767,1151,616,1.868506494,932,2588,784,280,275,5,66,2,0.021818182,0,empty,CD-0722-2
"D6,E12",5200,6033,3776,2257,3619,2003,0,2003,1254,749,1.67423231,1192,2186,368,177,176,1,65,1,0.056818182,0,empty,CD-0722-2
"D6,F1",470520,588771,320140,268631,347013,236224,2,236378,147839,88539,1.669761348,148091,18351,1624,552,526,26,133,3,0.269961977,0,hg38,CD-0722-2
"D6,F2",5099,5673,3711,1962,3406,1848,0,1848,1163,685,1.697810219,1043,3029,772,329,320,9,93,2,0.046875,0,empty,CD-0722-2
"D6,F3",4636,5013,3449,1564,3112,1648,0,1648,1046,602,1.737541528,904,3686,710,261,255,6,97,2,0.031372549,0,empty,CD-0722-2
"D6,F4",7297,7983,5382,2601,4839,2541,0,2542,1683,859,1.959254948,1404,872,143,85,83,2,43,1,0.048192771,0,empty,CD-0722-2
"D6,F5",5568,6277,4165,2112,3808,1989,0,1994,1242,752,1.651595745,1126,2417,423,161,160,1,71,1,0.1,0,empty,CD-0722-2
"D6,F6",5881,6787,4124,2663,4045,2347,0,2347,1365,982,1.390020367,1418,3727,830,325,320,5,95,2,0.06875,0,empty,CD-0722-2
"D6,F7",663927,748415,509973,238442,433298,220025,1,220178,178232,41946,4.249082153,123907,10285,2231,759,746,13,168,4,0.024128686,0,hg38,CD-0722-2
"D6,F8",4643,5165,3433,1732,3165,1674,0,1676,1065,611,1.74304419,927,467,96,52,51,1,23,1,0.039215686,0,empty,CD-0722-2
"D6,F9",539507,604655,411491,193164,350182,178855,2,179035,140389,38646,3.632691611,100231,115726,14877,5870,5741,129,1147,4,0.031005051,0,hg38,CD-0722-2
"D6,F10",6455,7174,4726,2448,4357,2289,0,2290,1518,772,1.966321244,1257,2319,468,238,236,2,78,2,0.101694915,0,empty,CD-0722-2
"D6,F11",4881,5478,3695,1783,3224,1605,0,1605,1063,542,1.961254613,889,2330,677,244,243,1,61,1,0.098765432,0,empty,CD-0722-2
"D6,F12",537346,627219,389917,237302,361383,204994,3,205163,168214,36949,4.552599529,122321,14755,1943,788,766,22,155,3,0.070496084,0,hg38,CD-0722-2
"D6,G1",5927,6621,4453,2168,3962,2104,0,2104,1402,702,1.997150997,1141,3807,756,312,298,14,86,2,0.087248322,0,empty,CD-0722-2
"D6,G2",3500,3905,2448,1457,2406,1347,0,1350,864,486,1.777777778,756,663,134,69,67,2,44,1,0.014925373,0,empty,CD-0722-2
"D6,G3",6819,7490,5030,2460,4491,2490,0,2491,1455,1036,1.404440154,1315,3052,779,308,303,5,89,3,0.02640264,0,empty,CD-0722-2
"D6,G4",633079,722639,477109,245530,416507,218579,0,218779,169367,49412,3.427649154,126227,1535,235,100,100,0,28,0,0.02,0,hg38,CD-0722-2
"D6,G5",4284,4857,3167,1690,2866,1538,0,1542,1053,489,2.153374233,877,2118,361,157,154,3,70,2,0.116883117,0,empty,CD-0722-2
"D6,G6",6139,7192,4476,2716,4294,2411,1,2416,1627,789,2.062103929,1430,251,38,27,27,0,18,0,0,0,empty,CD-0722-2
"D6,G7",4737,5288,3525,1763,3170,1629,0,1632,1045,587,1.780238501,898,3434,714,242,237,5,76,2,0.037974684,0,empty,CD-0722-2
"D6,G8",3574,3973,2593,1380,2446,1367,0,1367,915,452,2.024336283,753,2651,711,250,242,8,68,1,0.066115702,0,empty,CD-0722-2
"D6,G9",4025,4439,2945,1494,2717,1460,0,1460,950,510,1.862745098,831,2762,775,354,351,3,102,2,0.076923077,0,empty,CD-0722-2
"D6,G10",4790,5422,3514,1908,3287,1808,0,1811,1190,621,1.91626409,1031,3267,846,354,354,0,99,0,0.09039548,0,empty,CD-0722-2
"D6,G11",4907,5573,3664,1909,3339,1824,0,1824,1167,657,1.776255708,1005,1523,462,175,171,4,47,2,0.035087719,0,empty,CD-0722-2
"D6,G12",4072,4582,2956,1626,2839,1600,0,1600,1059,541,1.957486137,898,2766,657,292,289,3,107,1,0.076124567,0,empty,CD-0722-2
"D6,H1",4385,4971,3182,1789,3066,1686,0,1686,1096,590,1.857627119,1008,1472,382,152,151,1,53,1,0.052980132,0,empty,CD-0722-2
"D6,H2",4899,5551,3537,2014,3261,1766,0,1768,1153,615,1.874796748,1008,3184,776,330,329,1,93,1,0.155015198,0,empty,CD-0722-2
"D6,H3",4008,4645,2774,1871,2734,1570,0,1570,1053,517,2.036750484,926,2055,449,165,160,5,56,2,0.04375,0,empty,CD-0722-2
"D6,H4",5857,6554,4223,2331,4004,2172,0,2178,1469,709,2.071932299,1269,175,38,27,27,0,15,0,0.111111111,0,empty,CD-0722-2
"D6,H5",6784,7826,4914,2912,4506,2492,0,2496,1644,852,1.929577465,1466,2233,578,255,253,2,90,1,0.110671937,0,empty,CD-0722-2
"D6,H6",603535,737721,437600,300121,425390,250389,3,250569,200266,50303,3.981193965,153170,262590,42618,16081,15791,290,2280,11,0.04996517,0,hg38,CD-0722-2
"D6,H7",663748,789034,486549,302485,458717,265934,2,266129,213152,52977,4.023481888,158298,28107,5225,1969,1944,25,536,5,0.045781893,0,hg38,CD-0722-2
"D6,H8",4920,5749,3570,2179,3465,1926,0,1929,1249,680,1.836764706,1172,2519,436,216,213,3,77,1,0.070422535,0,empty,CD-0722-2
"D6,H9",4020,4501,3004,1497,2715,1432,0,1434,983,451,2.179600887,788,1585,404,144,144,0,43,0,0.027777778,0,empty,CD-0722-2
"D6,H10",4316,5071,3156,1915,3063,1718,0,1722,1146,576,1.989583333,1038,1593,430,205,202,3,77,2,0.178217822,0,empty,CD-0722-2
"D6,H11",608300,722466,447923,274543,418834,237245,2,237491,186276,51215,3.637137557,142553,3222,468,173,168,5,49,3,0.005952381,0,hg38,CD-0722-2
"D6,H12",3626,4128,2602,1526,2475,1396,0,1396,931,465,2.002150538,794,1777,413,198,197,1,56,1,0.152284264,0,empty,CD-0722-2
"D7,A1",4440,5262,3169,2093,3198,1849,0,1849,1207,642,1.880062305,1128,1588,317,143,140,3,62,2,0.05,0,empty,CD-0722-2
"D7,A2",6696,7586,5000,2586,4459,2442,0,2444,1529,915,1.671038251,1349,1596,302,147,147,0,40,0,0.034013605,0,empty,CD-0722-2
"D7,A3",3912,4428,2854,1574,2735,1494,0,1497,969,528,1.835227273,874,1230,250,98,97,1,27,1,0.010309278,0,empty,CD-0722-2
"D7,A4",7231,8134,5280,2854,4857,2636,0,2640,1713,927,1.84789644,1542,1003,271,142,142,0,38,0,0.154929577,0,empty,CD-0722-2
"D7,A5",545379,631945,401230,230715,364026,202829,1,203007,170029,32978,5.15583116,118853,131125,20465,8111,7986,125,1390,3,0.048585024,0,hg38,CD-0722-2
"D7,A6",464881,572820,340436,232384,330033,195257,1,195392,154714,40678,3.803382664,118998,132260,24968,9967,9834,133,1571,3,0.04728493,0,hg38,CD-0722-2
"D7,A7",4330,5018,3108,1910,3096,1775,0,1780,1138,642,1.77258567,1029,1851,597,208,206,2,65,1,0.009708738,0,empty,CD-0722-2
"D7,A8",2592,2972,1948,1024,1769,937,1,940,625,315,1.984126984,515,1846,337,151,150,1,59,1,0.013333333,0,empty,CD-0722-2
"D7,A9",4652,5287,3433,1854,3171,1714,0,1714,1152,562,2.049822064,976,1515,462,160,158,2,53,1,0.050632911,0,empty,CD-0722-2
"D7,A10",5620,6305,4235,2070,3780,2035,0,2035,1297,738,1.757452575,1128,506,125,29,29,0,14,0,0,0,empty,CD-0722-2
"D7,A11",4095,4572,3036,1536,2748,1440,0,1442,1014,428,2.369158879,811,1456,391,156,156,0,38,0,0.064102564,0,empty,CD-0722-2
"D7,A12",6070,6701,4516,2185,3875,2039,0,2039,1378,661,2.084720121,1114,4640,1239,487,483,4,104,2,0.02484472,0,empty,CD-0722-2
"D7,B1",5247,5867,3832,2035,3501,1982,0,1987,1293,694,1.863112392,1105,1425,280,113,112,1,36,1,0.035714286,0,empty,CD-0722-2
"D7,B2",5128,5799,3469,2330,3477,2073,0,2073,1328,745,1.782550336,1251,623,109,52,52,0,27,0,0.057692308,0,empty,CD-0722-2
"D7,B3",613362,775221,432356,342865,446115,279440,1,279665,226211,53454,4.231881618,176151,128500,20194,8067,7935,132,1428,5,0.036042848,0,hg38,CD-0722-2
"D7,B4",4995,5771,3559,2212,3419,1979,0,1981,1326,655,2.024427481,1154,1232,331,115,114,1,37,1,0.078947368,0,empty,CD-0722-2
"D7,B5",5161,3231,1952,1279,2312,1306,0,1311,876,435,2.013793103,850,1265,404,112,108,4,34,1,0.037037037,0,empty,CD-0722-2
"D7,B6",5426,6345,3802,2543,3762,2206,0,2206,1416,790,1.792405063,1300,2076,423,188,187,1,63,1,0.021390374,0,empty,CD-0722-2
"D7,B7",5022,5701,3759,1942,3391,1779,0,1779,1137,642,1.771028037,1019,1641,407,178,177,1,56,1,0.06779661,0,empty,CD-0722-2
"D7,B8",3842,4381,2795,1586,2552,1332,0,1335,921,414,2.224637681,777,1251,231,127,120,7,36,3,0.033333333,0,empty,CD-0722-2
"D7,B9",7422,8306,5360,2946,5063,2941,0,2944,1844,1100,1.676363636,1697,1192,294,139,137,2,54,2,0.02189781,0,empty,CD-0722-2
"D7,B10",3423,3685,2380,1305,2264,1217,1,1230,832,398,2.090452261,716,499,136,70,70,0,17,0,0.171428571,0,empty,CD-0722-2
"D7,B11",8138,9647,5824,3823,5623,3419,0,3419,1874,1545,1.212944984,2022,242,20,12,12,0,11,0,0,0,empty,CD-0722-2
"D7,B12",4412,5133,3171,1962,3095,1748,0,1750,1189,561,2.11942959,1042,1620,398,145,139,6,45,2,0.021582734,0,empty,CD-0722-2
"D7,C1",8455,9431,6345,3086,5601,2985,0,2987,1931,1056,1.828598485,1668,1154,361,128,127,1,28,1,0,0,empty,CD-0722-2
"D7,C2",7461,8582,5389,3193,5009,2800,0,2803,1786,1017,1.756145526,1629,2378,651,254,254,0,72,0,0,0,empty,CD-0722-2
"D7,C3",7460,8646,5426,3220,5138,2816,0,2816,1831,985,1.858883249,1645,965,201,76,75,1,27,1,0.013333333,0,empty,CD-0722-2
"D7,C4",4596,5020,3456,1564,3090,1603,0,1603,1076,527,2.041745731,883,1848,383,169,165,4,57,1,0.072727273,0,empty,CD-0722-2
"D7,C5",658476,825014,444177,380837,476540,329439,5,329675,250960,78715,3.188210633,203809,6677,900,354,336,18,78,2,0.139880952,0,hg38,CD-0722-2
"D7,C6",528984,595437,398917,196520,345654,178727,2,178904,137261,41643,3.296136205,102492,46747,9495,3732,3680,52,668,3,0.03125,0,hg38,CD-0722-2
"D7,C7",8006,9489,5589,3900,5544,3326,0,3327,1986,1341,1.48098434,1992,634,150,66,66,0,19,0,0.075757576,0,empty,CD-0722-2
"D7,C8",1177654,1356760,882251,474509,766321,418150,1,418480,326929,91551,3.57100414,241885,263541,35038,13760,13429,331,2160,8,0.042222057,0,hg38,CD-0722-2
"D7,C9",5922,6625,4329,2296,3963,2189,0,2190,1452,738,1.967479675,1230,1520,402,158,157,1,44,1,0.050955414,0,empty,CD-0722-2
"D7,C10",6817,7539,5043,2496,4412,2349,0,2357,1511,846,1.786052009,1302,1461,286,138,136,2,47,1,0.110294118,0,empty,CD-0722-2
"D7,C11",5998,6926,4355,2571,4042,2220,0,2220,1435,785,1.828025478,1303,1638,431,204,202,2,62,1,0.143564356,0,empty,CD-0722-2
"D7,C12",8062,8992,6005,2987,5428,2886,0,2888,1925,963,1.998961578,1613,2040,571,242,242,0,63,0,0.020661157,0,empty,CD-0722-2
"D7,D1",633090,631448,524558,106890,353532,121579,0,121736,91728,30008,3.056784857,54867,44634,4935,1893,1835,58,405,5,0.067574932,0,hg38,CD-0722-2
"D7,D2",6089,6443,4590,1853,3887,2017,0,2019,1310,709,1.847672779,1036,2648,712,291,290,1,88,1,0.079310345,0,empty,CD-0722-2
"D7,D3",487333,567927,364970,202957,328309,175349,0,175487,134976,40511,3.331835798,103874,68106,9436,3614,3540,74,686,4,0.070056497,0,hg38,CD-0722-2
"D7,D4",4653,5115,3458,1657,3133,1684,0,1684,1111,573,1.938917976,952,1400,288,118,118,0,48,0,0.025423729,0,empty,CD-0722-2
"D7,D5",4731,5513,3468,2045,3339,1841,0,1841,1223,618,1.978964401,1093,1822,569,199,197,2,53,1,0.182741117,0,empty,CD-0722-2
"D7,D6",7477,8867,5233,3634,5200,3090,0,3094,1881,1213,1.550700742,1881,2350,542,203,198,5,68,2,0.025252525,0,empty,CD-0722-2
"D7,D7",4131,4702,3075,1627,2832,1468,0,1468,970,498,1.947791165,827,3117,593,280,278,2,87,1,0.035971223,0,empty,CD-0722-2
"D7,D8",5201,5979,3745,2234,3540,1920,0,1922,1304,618,2.110032362,1136,1506,382,159,156,3,54,2,0.051282051,0,empty,CD-0722-2
"D7,D9",2753,3047,2039,1008,1796,966,0,966,655,311,2.106109325,531,1565,339,161,159,2,38,1,0.006289308,0,empty,CD-0722-2
"D7,D10",5698,6962,4127,2835,4033,2331,0,2334,1540,794,1.939546599,1442,1077,264,121,120,1,32,1,0.141666667,0,empty,CD-0722-2
"D7,D11",1447608,1582131,1122366,459765,881824,430867,2,431316,338367,92949,3.64035116,237160,184564,32632,11822,11628,194,1835,4,0.027433781,0,hg38,CD-0722-2
"D7,D12",7101,7960,5320,2640,4799,2593,0,2595,1727,868,1.989631336,1446,3555,957,374,367,7,104,2,0.114441417,0,empty,CD-0722-2
"D7,E1",8584,9840,6151,3689,5792,3191,0,3199,2045,1154,1.772097054,1836,2130,436,155,154,1,62,1,0.012987013,0,empty,CD-0722-2
"D7,E2",6012,6856,4374,2482,4121,2338,0,2340,1464,876,1.671232877,1379,1463,305,112,112,0,42,0,0.080357143,0,empty,CD-0722-2
"D7,E3",4071,4534,3038,1496,2785,1446,0,1448,933,515,1.811650485,807,2118,547,233,228,5,70,2,0.021929825,0,empty,CD-0722-2
"D7,E4",5702,6540,4171,2369,3704,2028,0,2028,1265,763,1.657929227,1167,2208,363,162,158,4,70,1,0.006329114,0,empty,CD-0722-2
"D7,E5",5060,5688,3770,1918,3413,1794,0,1796,1142,654,1.74617737,998,1644,507,178,175,3,41,2,0,0,empty,CD-0722-2
"D7,E6",9546,11193,6935,4258,6552,3659,0,3666,2322,1344,1.727678571,2229,3889,1033,385,383,2,108,1,0.11227154,0,empty,CD-0722-2
"D7,E7",975542,1091360,744158,347202,612998,314439,2,314718,247458,67260,3.679125781,175896,75522,11777,4442,4331,111,925,4,0.018933272,0,hg38,CD-0722-2
"D7,E8",6631,7418,5024,2394,4448,2326,0,2331,1520,811,1.874229346,1284,3007,805,300,296,4,88,2,0.077702703,0,empty,CD-0722-2
"D7,E9",4251,4738,3110,1628,2891,1603,0,1603,1083,520,2.082692308,913,2258,572,247,247,0,75,0,0.028340081,0,empty,CD-0722-2
"D7,E10",5134,5715,3811,1904,3423,1830,0,1832,1163,669,1.738415546,1016,1552,466,187,187,0,48,0,0.064171123,0,empty,CD-0722-2
"D7,E11",5511,6191,4010,2181,3681,1926,0,1926,1248,678,1.840707965,1084,2146,529,187,187,0,53,0,0.101604278,0,empty,CD-0722-2
"D7,E12",6589,7630,4807,2823,4460,2443,0,2447,1612,835,1.930538922,1439,1654,395,191,191,0,55,0,0.094240838,0,empty,CD-0722-2
"D7,F1",7630,8653,5586,3067,5176,2883,0,2890,1866,1024,1.822265625,1664,2444,779,277,277,0,84,0,0.068592058,0,empty,CD-0722-2
"D7,F2",5726,6447,4146,2301,3909,2121,0,2126,1391,735,1.892517007,1203,2335,553,252,250,2,71,1,0.096,0,empty,CD-0722-2
"D7,F3",5449,5963,3932,2031,3511,1873,0,1875,1242,633,1.962085308,1088,2582,629,275,272,3,82,1,0.011029412,0,empty,CD-0722-2
"D7,F4",1633824,1855894,1226046,629848,1050760,572182,14,572704,421550,151154,2.788877569,332290,19484,1900,720,701,19,194,3,0.029957204,0,hg38,CD-0722-2
"D7,F5",6646,7461,4920,2541,4449,2351,0,2359,1563,796,1.963567839,1349,2350,472,189,188,1,70,1,0.085106383,0,empty,CD-0722-2
"D7,F6",521361,598880,392489,206391,342120,178742,0,178935,141194,37741,3.741130336,103722,161799,19609,7878,7664,214,1264,5,0.082202505,0,hg38,CD-0722-2
"D7,F7",7321,8091,5448,2643,4793,2515,0,2517,1671,846,1.975177305,1366,1683,546,228,228,0,48,0,0.157894737,0,empty,CD-0722-2
"D7,F8",5687,6524,4171,2353,3815,2097,0,2099,1415,684,2.06871345,1196,281,55,36,36,0,20,0,0.138888889,0,empty,CD-0722-2
"D7,F9",5939,6797,4464,2333,4010,2086,0,2090,1385,705,1.964539007,1189,3165,822,290,289,1,92,1,0.048442907,0,empty,CD-0722-2
"D7,F10",7210,7865,5410,2455,4665,2398,0,2399,1576,823,1.914945322,1261,1484,387,148,147,1,35,1,0.034013605,0,empty,CD-0722-2
"D7,F11",5926,6430,4518,1912,3920,1993,0,1993,1311,682,1.92228739,1050,1936,353,143,142,1,45,1,0.126760563,0,empty,CD-0722-2
"D7,F12",6646,7516,4828,2688,4444,2439,1,2442,1653,789,2.095057034,1430,215,36,11,11,0,5,0,0,0,empty,CD-0722-2
"D7,G1",6777,7669,5038,2631,4588,2461,0,2463,1580,883,1.789354473,1384,2638,584,207,202,5,78,2,0.04950495,0,empty,CD-0722-2
"D7,G2",4628,5066,3129,1937,3000,1702,0,1707,1088,619,1.757673667,1008,1982,305,107,105,2,39,2,0.180952381,0,empty,CD-0722-2
"D7,G3",7398,8236,5350,2886,4912,2731,0,2733,1665,1068,1.558988764,1575,2417,638,248,246,2,68,2,0.024390244,0,empty,CD-0722-2
"D7,G4",14248,16884,10026,6858,9942,6065,0,6066,3692,2374,1.555181129,3631,156,41,27,27,0,16,0,0,0,empty,CD-0722-2
"D7,G5",4777,5508,3487,2021,3256,1769,0,1769,1171,598,1.95819398,1035,1830,441,156,156,0,45,0,0.064102564,0,empty,CD-0722-2
"D7,G6",690917,825352,496926,328426,473872,283834,0,284063,234164,49899,4.692759374,171134,443,152,66,66,0,23,0,0.181818182,0,empty,CD-0722-2
"D7,G7",5320,5998,3942,2056,3463,1777,0,1778,1145,633,1.808846761,966,2854,877,297,294,3,82,2,0.006802721,0,empty,CD-0722-2
"D7,G8",589546,734499,418970,315529,421801,260594,0,260807,206520,54287,3.804225689,163047,35305,13101,4908,4896,12,943,4,0.032679739,0,hg38,CD-0722-2
"D7,G9",4945,5792,3588,2204,3519,2007,0,2013,1347,666,2.022522523,1207,2765,593,262,258,4,75,2,0.093023256,0,empty,CD-0722-2
"D7,G10",5929,6885,4458,2427,3989,2155,0,2157,1407,750,1.876,1221,2424,595,242,241,1,77,1,0.020746888,0,empty,CD-0722-2
"D7,G11",5658,6320,4163,2157,3794,2042,0,2042,1363,679,2.00736377,1124,1552,472,174,170,4,47,1,0.258823529,0,empty,CD-0722-2
"D7,G12",5123,6049,3683,2366,3614,2051,0,2055,1357,698,1.944126074,1215,2383,529,239,236,3,69,2,0.097457627,0,empty,CD-0722-2
"D7,H1",525687,612920,389854,223066,352770,193483,0,193616,145608,48008,3.032994501,115348,82108,10395,3996,3889,107,790,5,0.054255593,0,hg38,CD-0722-2
"D7,H2",6998,7778,5140,2638,4787,2537,0,2539,1685,854,1.973067916,1490,2460,735,292,286,6,69,2,0.101398601,0,empty,CD-0722-2
"D7,H3",4811,5664,3515,2149,3380,1831,0,1832,1209,623,1.940609952,1103,1577,284,112,109,3,47,2,0.055045872,0,empty,CD-0722-2
"D7,H4",7258,8188,5331,2857,4888,2677,0,2677,1800,877,2.052451539,1568,165,30,23,22,1,18,1,0.045454545,0,empty,CD-0722-2
"D7,H5",7808,8891,5812,3079,5178,2870,0,2873,1836,1037,1.770491803,1645,2191,581,259,259,0,78,0,0.069498069,0,empty,CD-0722-2
"D7,H6",4770,5298,3432,1866,3169,1812,0,1812,1305,507,2.573964497,1019,2322,866,276,273,3,82,2,0.051282051,0,empty,CD-0722-2
"D7,H7",5671,6279,4223,2056,3823,1966,0,1971,1347,624,2.158653846,1070,2801,787,357,352,5,104,2,0.099431818,0,empty,CD-0722-2
"D7,H8",6074,7282,4417,2865,4161,2379,0,2381,1556,825,1.886060606,1398,2223,515,249,246,3,71,2,0.134146341,0,empty,CD-0722-2
"D7,H9",5932,6569,4451,2118,3876,1961,0,1963,1372,591,2.321489002,1078,1267,152,65,58,7,28,2,0.103448276,0,empty,CD-0722-2
"D7,H10",4787,5492,3478,2014,3220,1738,0,1740,1206,534,2.258426966,1014,1711,212,103,103,0,45,0,0.019417476,0,empty,CD-0722-2
"D7,H11",5853,6767,4060,2707,4058,2608,0,2612,1428,1184,1.206081081,1563,65,10,7,7,0,1,0,1,0,empty,CD-0722-2
"D7,H12",4571,5249,3224,2025,3162,1802,2,1807,1199,608,1.972039474,1073,1866,499,170,166,4,47,2,0.060240964,0,empty,CD-0722-2
"D8,A1",3801,4462,2727,1735,2682,1556,0,1556,1039,517,2.00967118,881,1343,283,128,127,1,48,1,0.102362205,0,empty,CD-0722-2
"D8,A2",338475,381081,252251,128830,219458,114516,0,114621,86277,28344,3.04392464,65881,71100,12118,4745,4668,77,875,6,0.049057412,0,hg38,CD-0722-2
"D8,A3",460649,555952,335875,220077,321303,188295,3,188432,148829,39603,3.758023382,114188,13078,2048,782,772,10,246,2,0.090673575,0,hg38,CD-0722-2
"D8,A4",5827,6730,4200,2530,4053,2287,0,2288,1441,847,1.701298701,1360,959,267,105,101,4,33,2,0.069306931,0,empty,CD-0722-2
"D8,A5",4749,5131,3568,1563,3165,1648,0,1648,1090,558,1.953405018,872,1943,423,165,163,2,51,1,0.006134969,0,empty,CD-0722-2
"D8,A6",4377,5479,3122,2357,3233,1916,0,1919,1229,690,1.78115942,1190,3010,696,288,287,1,109,1,0.045296167,0,empty,CD-0722-2
"D8,A7",3570,4133,2639,1494,2427,1356,0,1357,857,500,1.714,750,1298,295,130,129,1,47,1,0.031007752,0,empty,CD-0722-2
"D8,A8",2423,2743,1736,1007,1711,967,0,969,671,298,2.251677852,558,2164,519,224,224,0,64,0,0.013392857,0,empty,CD-0722-2
"D8,A9",4097,4634,3066,1568,2793,1498,0,1498,987,511,1.931506849,852,1871,321,155,150,5,56,2,0.08,0,empty,CD-0722-2
"D8,A10",4623,5006,3584,1422,2995,1524,1,1529,973,556,1.75,793,452,119,62,62,0,19,0,0.370967742,0,empty,CD-0722-2
"D8,A11",3474,3904,2604,1300,2311,1156,0,1160,767,393,1.951653944,637,1458,308,151,151,0,60,0,0.006622517,0,empty,CD-0722-2
"D8,A12",5177,5659,3957,1702,3347,1706,0,1706,1148,558,2.05734767,916,3333,672,281,278,3,94,1,0.100719424,0,empty,CD-0722-2
"D8,B1",4126,4736,3016,1720,2884,1601,0,1604,1027,577,1.779896014,929,1761,546,224,222,2,63,2,0.099099099,0,empty,CD-0722-2
"D8,B2",4718,5370,3245,2125,3164,1887,0,1888,1189,699,1.701001431,1101,611,111,62,62,0,19,0,0,0,empty,CD-0722-2
"D8,B3",3839,4436,2847,1589,2719,1530,0,1530,1019,511,1.994129159,864,1907,350,177,173,4,62,2,0.046242775,0,empty,CD-0722-2
"D8,B4",323397,408198,225652,182546,238116,150969,0,151043,116959,34084,3.431492783,95201,16414,6133,2206,2199,7,486,2,0.031377899,0,hg38,CD-0722-2
"D8,B5",7993,7122,4155,2967,4621,2645,0,2656,1937,719,2.694019471,1667,1048,270,122,121,1,44,1,0.198347107,0,empty,CD-0722-2
"D8,B6",4408,5058,3187,1871,3093,1811,0,1812,1129,683,1.653001464,1091,1698,406,175,171,4,49,1,0.070175439,0,empty,CD-0722-2
"D8,B7",4620,5227,3438,1789,3175,1678,0,1678,1102,576,1.913194444,973,2491,531,223,221,2,60,2,0.162895928,0,empty,CD-0722-2
"D8,B8",2991,3444,2260,1184,2062,1096,0,1099,730,369,1.978319783,641,1369,294,120,119,1,48,1,0.050420168,0,empty,CD-0722-2
"D8,B9",5948,6781,4320,2461,4046,2345,1,2352,1472,880,1.672727273,1321,1326,302,132,130,2,53,2,0.161538462,0,empty,CD-0722-2
"D8,B10",2812,3219,1893,1326,1973,1106,0,1106,713,393,1.814249364,672,396,90,37,36,1,11,1,0.027777778,0,empty,CD-0722-2
"D8,B11",6869,8234,4799,3435,4726,2822,0,2826,1586,1240,1.279032258,1713,312,40,29,29,0,19,0,0.034482759,0,empty,CD-0722-2
"D8,B12",3759,4232,2741,1491,2556,1409,0,1409,921,488,1.887295082,803,1686,400,152,152,0,57,0,0.046052632,0,empty,CD-0722-2
"D8,C1",6987,7888,5219,2669,4691,2426,0,2428,1509,919,1.642002176,1400,1077,212,98,97,1,24,1,0.051546392,0,empty,CD-0722-2
"D8,C2",5867,6846,4186,2660,4165,2451,0,2451,1634,817,2,1492,2403,590,268,265,3,77,2,0.067924528,0,empty,CD-0722-2
"D8,C3",6154,7109,4488,2621,4343,2405,0,2410,1551,859,1.805587893,1422,946,255,117,117,0,34,0,0.025641026,0,empty,CD-0722-2
"D8,C4",4008,4446,3041,1405,2706,1407,0,1411,894,517,1.729206963,772,2053,512,203,202,1,52,1,0.01980198,0,empty,CD-0722-2
"D8,C5",5652,6354,4151,2203,3757,2042,0,2045,1345,700,1.921428571,1129,1492,299,142,142,0,55,0,0.147887324,0,empty,CD-0722-2
"D8,C6",5098,5766,3698,2068,3506,1952,0,1952,1276,676,1.887573964,1127,1689,308,158,157,1,46,1,0.057324841,0,empty,CD-0722-2
"D8,C7",6440,7864,4557,3307,4618,2838,0,2839,1707,1132,1.50795053,1714,379,77,36,36,0,11,0,0,0,empty,CD-0722-2
"D8,C8",7591,8405,5411,2994,5067,2842,0,2842,1877,965,1.94507772,1645,3448,749,342,336,6,115,2,0.023809524,0,empty,CD-0722-2
"D8,C9",513855,632432,372809,259623,363879,214456,2,214632,167793,46839,3.582335233,132634,85107,9603,3820,3701,119,750,5,0.054579843,0,hg38,CD-0722-2
"D8,C10",5610,6273,4109,2164,3766,2082,0,2085,1393,692,2.01300578,1163,2022,390,119,116,3,42,2,0.094827586,0,empty,CD-0722-2
"D8,C11",4960,5533,3614,1919,3318,1825,0,1828,1118,710,1.574647887,1031,2015,495,188,181,7,61,2,0.08839779,0,empty,CD-0722-2
"D8,C12",6996,7887,5213,2674,4731,2505,0,2511,1739,772,2.252590674,1436,1892,501,194,192,2,60,1,0.015625,0,empty,CD-0722-2
"D8,D1",37241,43827,26850,16977,25350,14455,0,14470,10843,3627,2.989523022,8731,5146,763,314,311,3,85,1,0.061093248,0,empty,CD-0722-2
"D8,D2",266116,334999,175804,159195,198159,141945,1,142057,99508,42549,2.338668359,87313,8131,1081,391,374,17,112,2,0.328877005,0,hg38,CD-0722-2
"D8,D3",4454,5141,3188,1953,3102,1742,0,1743,1166,577,2.020797227,1039,1657,300,124,124,0,49,0,0.016129032,0,empty,CD-0722-2
"D8,D4",3402,3778,2573,1205,2275,1186,0,1186,783,403,1.94292804,640,1399,284,120,120,0,38,0,0.191666667,0,empty,CD-0722-2
"D8,D5",3947,4470,2967,1503,2720,1465,0,1465,924,541,1.707948244,833,1784,499,183,183,0,52,0,0.087431694,0,empty,CD-0722-2
"D8,D6",6154,6879,4359,2520,4170,2462,0,2462,1489,973,1.530318602,1399,1864,297,148,145,3,53,2,0.117241379,0,empty,CD-0722-2
"D8,D7",3486,3874,2544,1330,2332,1209,0,1211,847,364,2.326923077,663,2358,595,252,250,2,86,2,0.08,0,empty,CD-0722-2
"D8,D8",4623,5375,3338,2037,3138,1739,0,1740,1197,543,2.20441989,1005,1614,508,211,210,1,59,1,0.152380952,0,empty,CD-0722-2
"D8,D9",2223,2625,1608,1017,1608,903,0,905,580,325,1.784615385,531,1597,384,208,205,3,52,1,0.053658537,0,empty,CD-0722-2
"D8,D10",4613,5533,3315,2218,3242,1808,0,1808,1200,608,1.973684211,1098,972,207,71,70,1,26,1,0.1,0,empty,CD-0722-2
"D8,D11",1065411,1276395,777928,498467,734325,437359,2,437689,319110,118579,2.691117314,263468,332073,51182,19402,19017,385,2819,10,0.028132723,0,hg38,CD-0722-2
"D8,D12",5614,6268,4132,2136,3810,2078,0,2078,1360,718,1.894150418,1151,3519,868,347,346,1,102,1,0.072254335,0,empty,CD-0722-2
"D8,E1",7052,7993,5155,2838,4846,2654,0,2654,1699,955,1.779057592,1501,2354,546,239,230,9,72,2,0.1,0,empty,CD-0722-2
"D8,E2",4866,5742,3421,2321,3491,1994,0,1998,1282,716,1.790502793,1205,1790,509,188,188,0,55,0,0.063829787,0,empty,CD-0722-2
"D8,E3",3338,4032,2390,1642,2458,1390,0,1392,939,453,2.072847682,843,2088,517,201,198,3,59,2,0.217171717,0,empty,CD-0722-2
"D8,E4",4596,5248,3314,1934,3116,1700,0,1700,1132,568,1.992957746,989,2269,402,203,202,1,84,1,0.02970297,0,empty,CD-0722-2
"D8,E5",4160,4688,3089,1599,2770,1468,0,1468,932,536,1.73880597,802,1395,276,131,127,4,41,3,0.181102362,0,empty,CD-0722-2
"D8,E6",36282,42008,26256,15752,24462,14000,1,14008,11802,2206,5.349954669,8174,5999,2028,613,607,6,175,1,0.026359143,0,empty,CD-0722-2
"D8,E7",6689,7587,4992,2595,4461,2470,0,2476,1596,880,1.813636364,1368,2903,854,354,348,6,98,2,0.045977011,0,empty,CD-0722-2
"D8,E8",56340,65964,40357,25607,38525,23520,0,23532,17561,5971,2.941048401,13660,3696,532,222,216,6,72,2,0.009259259,0,empty,CD-0722-2
"D8,E9",3856,4467,2831,1636,2610,1408,0,1408,926,482,1.921161826,820,2126,419,179,176,3,69,2,0.159090909,0,empty,CD-0722-2
"D8,E10",3960,4807,2856,1951,2835,1582,0,1585,1014,571,1.775831874,973,2673,662,215,211,4,81,3,0.08056872,0,empty,CD-0722-2
"D8,E11",4753,5307,3481,1826,3215,1823,0,1823,1170,653,1.791730475,1018,1757,462,201,200,1,60,1,0.04,0,empty,CD-0722-2
"D8,E12",10330,12742,7133,5609,7472,4826,1,4838,2130,2708,0.786558346,2823,3237,917,256,252,4,125,1,0.027777778,0,empty,CD-0722-2
"D8,F1",6340,7051,4573,2478,4246,2309,0,2309,1468,841,1.745541023,1337,2771,537,213,211,2,73,1,0.037914692,0,empty,CD-0722-2
"D8,F2",4776,5230,3529,1701,3217,1711,1,1713,1083,630,1.719047619,947,3343,813,316,312,4,102,2,0.115384615,0,empty,CD-0722-2
"D8,F3",4378,4937,3255,1682,2987,1572,0,1572,1070,502,2.131474104,899,2851,829,282,278,4,92,1,0.086330935,0,empty,CD-0722-2
"D8,F4",1908313,2153311,1442147,711164,1207633,650874,23,651546,511485,140061,3.651873112,371133,149030,17198,6771,6571,200,1207,7,0.053720895,0,hg38,CD-0722-2
"D8,F5",5238,5912,3835,2077,3541,1853,0,1855,1132,723,1.565698479,1081,2124,411,147,138,9,66,2,0.014492754,0,empty,CD-0722-2
"D8,F6",5368,6249,3883,2366,3775,2177,0,2179,1361,818,1.663814181,1350,2783,681,266,264,2,71,2,0.132575758,0,empty,CD-0722-2
"D8,F7",6152,7062,4497,2565,4219,2324,1,2328,1527,801,1.906367041,1334,1164,291,112,112,0,48,0,0.008928571,0,empty,CD-0722-2
"D8,F8",4985,5520,3761,1759,3306,1777,0,1777,1168,609,1.917898194,950,361,94,39,39,0,19,0,0.025641026,0,empty,CD-0722-2
"D8,F9",5159,5781,3845,1936,3424,1793,1,1794,1204,590,2.040677966,975,2989,741,302,297,5,97,2,0.067340067,0,empty,CD-0722-2
"D8,F10",6256,6901,4686,2215,4154,2194,0,2199,1463,736,1.987771739,1215,1931,472,192,190,2,66,1,0.142105263,0,empty,CD-0722-2
"D8,F11",4794,5377,3535,1842,3230,1683,0,1683,1092,591,1.847715736,979,1741,361,144,143,1,48,1,0.048951049,0,empty,CD-0722-2
"D8,F12",5437,6284,3985,2299,3756,2017,0,2021,1327,694,1.912103746,1185,517,135,49,47,2,23,1,0.234042553,0,empty,CD-0722-2
"D8,G1",5542,6231,4157,2074,3685,1966,0,1968,1309,659,1.986342944,1111,2982,715,265,263,2,93,1,0.140684411,0,empty,CD-0722-2
"D8,G2",4059,4620,2791,1829,2766,1645,0,1649,1094,555,1.971171171,987,695,165,83,81,2,41,1,0.049382716,0,empty,CD-0722-2
"D8,G3",6494,7248,4717,2531,4271,2348,0,2350,1444,906,1.593818985,1329,2074,616,231,231,0,71,0,0.082251082,0,empty,CD-0722-2
"D8,G4",12027,13587,8468,5119,8207,4947,0,4951,3041,1910,1.592146597,2855,156,29,22,21,1,15,1,0,0,empty,CD-0722-2
"D8,G5",3714,4258,2688,1570,2597,1471,0,1471,926,545,1.699082569,857,1773,317,145,145,0,64,0,0.151724138,0,empty,CD-0722-2
"D8,G6",5762,6604,4295,2309,3912,2141,0,2142,1435,707,2.02970297,1205,168,18,10,10,0,7,0,0,0,empty,CD-0722-2
"D8,G7",4520,4889,3350,1539,2983,1582,0,1582,1033,549,1.881602914,872,2286,509,238,237,1,62,1,0.181434599,0,empty,CD-0722-2
"D8,G8",3429,3975,2498,1477,2392,1318,0,1320,886,434,2.041474654,791,1868,484,198,197,1,54,1,0.045685279,0,empty,CD-0722-2
"D8,G9",4313,4928,3129,1799,2996,1613,0,1615,1070,545,1.963302752,938,2739,737,284,281,3,81,2,0.117437722,0,empty,CD-0722-2
"D8,G10",4810,5402,3548,1854,3322,1894,0,1894,1249,645,1.936434109,1057,2421,683,289,286,3,88,1,0.101398601,0,empty,CD-0722-2
"D8,G11",4651,5430,3451,1979,3231,1736,0,1736,1168,568,2.056338028,1002,2004,455,214,212,2,58,2,0.169811321,0,empty,CD-0722-2
"D8,G12",2342536,2867007,1687823,1179184,1625500,1008349,6,1009088,806921,202167,3.991358629,620593,531134,75565,29805,29192,613,3688,10,0.060427514,0,hg38,CD-0722-2
"D8,H1",465666,546362,340897,205465,314885,176320,2,176457,137650,38807,3.547040482,105587,64882,10335,4067,4010,57,798,4,0.073067332,0,hg38,CD-0722-2
"D8,H2",6857,7926,5015,2911,4776,2666,0,2666,1710,956,1.788702929,1594,2298,624,252,248,4,77,3,0.088709677,0,empty,CD-0722-2
"D8,H3",4094,4496,3003,1493,2673,1425,0,1428,944,484,1.950413223,802,1543,270,135,133,2,51,2,0.270676692,0,empty,CD-0722-2
"D8,H4",5779,6498,4233,2265,3839,2113,0,2114,1376,738,1.864498645,1244,186,29,19,19,0,13,0,0,0,empty,CD-0722-2
"D8,H5",847389,1043345,611112,432233,588558,355827,3,356063,280894,75169,3.736833003,218938,87781,22973,8916,8838,78,1428,4,0.041298936,0,hg38,CD-0722-2
"D8,H6",978331,1198672,699804,498868,688286,419005,0,419333,333898,85435,3.908210921,258927,324481,55691,21479,21077,402,2764,9,0.042558239,0,hg38,CD-0722-2
"D8,H7",4870,5347,3492,1855,3203,1679,0,1681,1157,524,2.208015267,949,2039,561,247,239,8,89,2,0.008368201,0,empty,CD-0722-2
"D8,H8",477418,565723,354850,210873,323033,179200,2,179372,136408,42964,3.174937157,106441,170940,19709,7744,7533,211,1459,8,0.058940661,0,hg38,CD-0722-2
"D8,H9",4956,5673,3666,2007,3347,1816,0,1816,1212,604,2.006622517,1027,989,301,149,148,1,49,1,0.074324324,0,empty,CD-0722-2
"D8,H10",10230,11890,7681,4209,6877,3588,0,3591,2493,1098,2.270491803,2170,4243,778,339,331,8,103,2,0.003021148,0,empty,CD-0722-2
"D8,H11",5176,6070,3499,2571,3661,2402,0,2405,1259,1146,1.098603839,1435,64,17,14,14,0,10,0,0,0,empty,CD-0722-2
"D8,H12",3869,4351,2652,1699,2594,1471,0,1473,942,531,1.774011299,855,1462,346,162,160,2,65,1,0.04375,0,empty,CD-0722-2
"D9,A1",3710,4250,2627,1623,2555,1478,0,1483,987,496,1.989919355,864,1139,206,73,73,0,26,0,0.01369863,0,empty,CD-0722-2
"D9,A2",426007,487645,318776,168869,279563,150531,0,150714,119174,31540,3.778503488,86582,53231,9074,3562,3494,68,688,4,0.021179164,0,hg38,CD-0722-2
"D9,A3",3396,3772,2508,1264,2304,1203,1,1207,825,382,2.159685864,671,1248,322,88,88,0,29,0,0.170454545,0,empty,CD-0722-2
"D9,A4",6176,6959,4552,2407,4156,2287,0,2291,1489,802,1.856608479,1256,596,97,39,38,1,13,1,0.157894737,0,empty,CD-0722-2
"D9,A5",5020,5724,3657,2067,3490,1933,0,1937,1225,712,1.720505618,1168,1791,331,137,137,0,54,0,0.03649635,0,empty,CD-0722-2
"D9,A6",249702,289180,192163,97017,167126,87313,1,87407,66950,20457,3.272718385,50075,40770,5740,2182,2138,44,494,3,0.019644528,0,hg38,CD-0722-2
"D9,A7",3717,4287,2686,1601,2561,1470,2,1475,872,603,1.446102819,823,988,158,50,50,0,25,0,0.02,0,empty,CD-0722-2
"D9,A8",257101,298425,192340,106085,173923,94786,0,94883,75926,18957,4.005169594,54642,134203,15102,5978,5823,155,1128,4,0.033144427,0,hg38,CD-0722-2
"D9,A9",4073,4813,3082,1731,2926,1604,0,1606,1046,560,1.867857143,938,1541,220,124,124,0,48,0,0.072580645,0,empty,CD-0722-2
"D9,A10",4850,5419,3651,1768,3294,1723,0,1723,1048,675,1.552592593,949,391,38,29,29,0,21,0,0.034482759,0,empty,CD-0722-2
"D9,A11",3678,4087,2706,1381,2485,1301,0,1303,866,437,1.981693364,740,1617,330,153,152,1,48,1,0.171052632,0,empty,CD-0722-2
"D9,A12",5358,5879,4085,1794,3539,1834,0,1835,1233,602,2.048172757,985,2750,540,232,229,3,80,2,0.07860262,0,empty,CD-0722-2
"D9,B1",4255,4727,3118,1609,2875,1586,0,1588,1032,556,1.856115108,888,994,130,66,66,0,32,0,0.015151515,0,empty,CD-0722-2
"D9,B2",4528,5167,3033,2134,3154,1918,0,1924,1187,737,1.610583446,1164,550,84,46,45,1,21,1,0.022222222,0,empty,CD-0722-2
"D9,B3",4035,4700,2946,1754,2768,1534,0,1537,1049,488,2.149590164,906,1727,360,148,147,1,52,1,0.081632653,0,empty,CD-0722-2
"D9,B4",4421,5098,3157,1941,3052,1796,0,1796,1147,649,1.767334361,1062,1309,243,99,99,0,30,0,0.121212121,0,empty,CD-0722-2
"D9,B5",5356,3856,2334,1522,2650,1529,0,1537,1153,384,3.002604167,967,876,150,62,62,0,27,0,0.048387097,0,empty,CD-0722-2
"D9,B6",4749,5538,3375,2163,3301,1901,0,1905,1254,651,1.926267281,1122,1394,405,156,154,2,34,1,0.012987013,0,empty,CD-0722-2
"D9,B7",79551,92182,53734,38448,54279,35886,0,35916,23771,12145,1.957266365,20967,931,194,75,75,0,30,0,0,0,empty,CD-0722-2
"D9,B8",3207,3676,2362,1314,2203,1178,0,1180,776,404,1.920792079,677,1140,303,131,130,1,36,1,0.346153846,0,empty,CD-0722-2
"D9,B9",6336,7146,4620,2526,4272,2408,0,2410,1535,875,1.754285714,1372,1217,261,142,140,2,48,1,0.092857143,0,empty,CD-0722-2
"D9,B10",405064,442776,278780,163996,267832,148832,12,149280,122572,26708,4.589336528,88565,32774,3566,1421,1382,39,348,4,0.040520984,0,hg38,CD-0722-2
"D9,B11",447456,553768,308374,245394,318554,214763,0,214892,156102,58790,2.655247491,131117,324,33,9,9,0,8,0,0,0,empty,CD-0722-2
"D9,B12",3673,4148,2676,1472,2564,1340,0,1340,897,443,2.0248307,751,1573,427,165,161,4,40,2,0.155279503,0,empty,CD-0722-2
"D9,C1",7330,8231,5466,2765,4792,2537,0,2539,1586,953,1.664218258,1440,782,196,82,81,1,28,1,0.024691358,0,empty,CD-0722-2
"D9,C2",6374,7233,4586,2647,4317,2439,0,2440,1557,883,1.763306908,1408,1977,564,221,221,0,53,0,0.067873303,0,empty,CD-0722-2
"D9,C3",774506,924310,576072,348238,524410,293800,1,294048,229842,64206,3.579758901,175143,30626,4600,1736,1702,34,390,3,0.046415981,0,hg38,CD-0722-2
"D9,C4",4077,4618,3024,1594,2824,1511,0,1515,1004,511,1.964774951,858,1895,527,179,179,0,44,0,0.055865922,0,empty,CD-0722-2
"D9,C5",511158,573417,390410,183007,328205,165520,1,165652,126028,39624,3.180597618,93516,31455,6212,2573,2543,30,504,3,0.02359418,0,hg38,CD-0722-2
"D9,C6",5150,5797,3717,2080,3543,1940,0,1944,1285,659,1.949924127,1110,1437,213,99,99,0,35,0,0.04040404,0,empty,CD-0722-2
"D9,C7",6840,8009,4790,3219,4835,2923,0,2929,1736,1193,1.455155071,1759,427,90,45,45,0,11,0,0,0,empty,CD-0722-2
"D9,C8",7412,8362,5367,2995,4962,2780,0,2780,1841,939,1.960596379,1579,2632,550,250,248,2,77,2,0.14516129,0,empty,CD-0722-2
"D9,C9",5293,6085,3862,2223,3691,2110,0,2110,1344,766,1.754569191,1240,1244,354,157,157,0,47,0,0.063694268,0,empty,CD-0722-2
"D9,C10",6053,6825,4486,2339,4001,2144,0,2144,1393,751,1.854860186,1213,1914,359,159,158,1,47,1,0.063291139,0,empty,CD-0722-2
"D9,C11",4999,5581,3678,1903,3308,1790,0,1790,1146,644,1.779503106,1002,1554,309,126,126,0,45,0,0.063492063,0,empty,CD-0722-2
"D9,C12",6942,7553,5136,2417,4598,2404,0,2409,1616,793,2.037831021,1305,1591,423,153,151,2,57,1,0.046357616,0,empty,CD-0722-2
"D9,D1",6459,7598,4540,3058,4573,2720,0,2721,1636,1085,1.507834101,1626,730,155,59,58,1,19,1,0.086206897,0,empty,CD-0722-2
"D9,D2",4977,5577,3667,1910,3382,1749,1,1752,1092,660,1.654545455,1025,2819,772,323,321,2,79,2,0.037383178,0,empty,CD-0722-2
"D9,D3",535530,623978,398761,225217,358893,195971,0,196131,147927,48204,3.068770227,115162,52348,7218,2724,2639,85,581,5,0.062144752,0,hg38,CD-0722-2
"D9,D4",630524,772599,456116,316483,442799,266096,1,266304,216594,49710,4.357151479,161615,51884,8121,3189,3141,48,730,4,0.037567654,0,hg38,CD-0722-2
"D9,D5",4164,4790,3157,1633,2894,1513,0,1515,962,553,1.73960217,877,1560,401,185,182,3,55,1,0.082417582,0,empty,CD-0722-2
"D9,D6",6474,7405,4458,2947,4388,2587,1,2592,1593,999,1.594594595,1556,1764,339,136,134,2,54,1,0.044776119,0,empty,CD-0722-2
"D9,D7",413938,464045,315838,148207,265641,133133,2,133248,105722,27526,3.840805057,74508,159627,23668,9418,9250,168,1618,6,0.038702703,0,hg38,CD-0722-2
"D9,D8",4340,4851,3180,1671,2956,1618,1,1621,1062,559,1.899821109,925,1346,294,110,110,0,45,0,0.090909091,0,empty,CD-0722-2
"D9,D9",2268,2478,1627,851,1504,830,0,830,532,298,1.785234899,473,1278,227,107,106,1,34,1,0.009433962,0,empty,CD-0722-2
"D9,D10",4965,5887,3561,2326,3454,1911,0,1911,1261,650,1.94,1165,980,276,112,110,2,22,2,0.136363636,0,empty,CD-0722-2
"D9,D11",4796,5708,3462,2246,3418,1886,0,1892,1207,685,1.762043796,1155,2301,460,199,199,0,70,0,0.070351759,0,empty,CD-0722-2
"D9,D12",6106,6961,4506,2455,4100,2177,0,2184,1427,757,1.885072655,1232,3752,822,338,337,1,102,1,0.09495549,0,empty,CD-0722-2
"D9,E1",9600,11336,7120,4216,6763,3839,0,3839,2445,1394,1.753945481,2286,2526,716,269,265,4,76,2,0.022641509,0,empty,CD-0722-2
"D9,E2",5235,6269,3798,2471,3750,2127,1,2128,1332,796,1.673366834,1292,1705,391,143,143,0,61,0,0.020979021,0,empty,CD-0722-2
"D9,E3",3557,4066,2652,1414,2426,1287,0,1287,850,437,1.945080092,744,2386,606,228,228,0,65,0,0.188596491,0,empty,CD-0722-2
"D9,E4",4952,5585,3666,1919,3380,1819,0,1820,1178,642,1.834890966,1046,2956,597,245,245,0,76,0,0.06122449,0,empty,CD-0722-2
"D9,E5",4030,4444,3062,1382,2780,1426,0,1432,973,459,2.119825708,791,1132,224,85,84,1,24,1,0,0,empty,CD-0722-2
"D9,E6",8368,9567,6103,3464,5535,3044,0,3046,1959,1087,1.802207912,1732,2705,563,264,261,3,86,2,0.076628352,0,empty,CD-0722-2
"D9,E7",7277,8258,5434,2824,4956,2620,0,2625,1691,934,1.810492505,1512,3395,1017,354,348,6,90,2,0.091954023,0,empty,CD-0722-2
"D9,E8",5516,6173,4102,2071,3703,1948,0,1949,1292,657,1.96651446,1106,2449,506,181,180,1,66,1,0.083333333,0,empty,CD-0722-2
"D9,E9",3811,4459,2701,1758,2705,1541,0,1543,1051,492,2.136178862,936,2638,686,283,281,2,70,2,0.085409253,0,empty,CD-0722-2
"D9,E10",351622,463043,228604,234439,273826,198719,1,198816,118186,80630,1.465781967,129396,2527,791,259,258,1,66,1,0.124031008,0,hg38,CD-0722-2
"D9,E11",476938,543600,361029,182571,314467,164067,2,164205,124867,39338,3.174208145,94359,129539,18974,6877,6725,152,1215,6,0.021263941,0,hg38,CD-0722-2
"D9,E12",5593,6513,4004,2509,3902,2180,0,2182,1515,667,2.271364318,1291,1867,410,181,178,3,68,2,0.039325843,0,empty,CD-0722-2
"D9,F1",6372,6999,4642,2357,4251,2316,0,2318,1512,806,1.875930521,1308,1938,509,201,201,0,56,0,0.069651741,0,empty,CD-0722-2
"D9,F2",5689,6525,4120,2405,3820,2088,0,2089,1396,693,2.014430014,1217,2434,659,251,248,3,76,2,0.016129032,0,empty,CD-0722-2
"D9,F3",4653,4998,3401,1597,3080,1641,0,1641,1100,541,2.033271719,918,2405,554,238,234,4,66,3,0.08974359,0,empty,CD-0722-2
"D9,F4",651963,736086,487598,248488,424561,226248,8,226468,176703,49765,3.550748518,128254,40932,7797,2988,2917,71,568,2,0.031882071,0,hg38,CD-0722-2
"D9,F5",468501,588186,311566,276620,340835,238539,0,238691,165477,73214,2.260182479,148717,4639,739,283,280,3,92,3,0.035714286,0,hg38,CD-0722-2
"D9,F6",5711,6649,4192,2457,3875,2141,0,2143,1366,777,1.758043758,1229,2817,535,211,204,7,56,2,0.06372549,0,empty,CD-0722-2
"D9,F7",6566,7415,4754,2661,4479,2502,0,2502,1617,885,1.827118644,1457,979,208,56,56,0,20,0,0.178571429,0,empty,CD-0722-2
"D9,F8",5405,6165,3991,2174,3663,1978,0,1980,1343,637,2.108320251,1119,356,63,35,35,0,16,0,0,0,empty,CD-0722-2
"D9,F9",974397,1190050,690703,499347,684144,432855,6,433217,342671,90546,3.784496278,262248,85267,18246,6785,6710,75,1348,4,0.052757079,0,hg38,CD-0722-2
"D9,F10",636550,723680,485532,238148,412342,211862,3,212050,165275,46775,3.533404596,120491,85594,9539,3691,3591,100,783,7,0.023948761,0,hg38,CD-0722-2
"D9,F11",5232,5934,3965,1969,3491,1767,0,1770,1188,582,2.041237113,956,1574,311,135,130,5,40,1,0.046153846,0,empty,CD-0722-2
"D9,F12",5736,6623,4181,2442,3845,2098,0,2099,1414,685,2.064233577,1212,142,17,10,10,0,10,0,0,0,empty,CD-0722-2
"D9,G1",5805,6629,4300,2329,3999,2112,0,2112,1373,739,1.857916103,1229,3425,831,333,330,3,92,2,0.045454545,0,empty,CD-0722-2
"D9,G2",3640,4265,2487,1778,2495,1455,0,1455,982,473,2.076109937,888,509,86,61,61,0,29,0,0.049180328,0,empty,CD-0722-2
"D9,G3",7471,8352,5468,2884,4955,2830,0,2832,1692,1140,1.484210526,1573,2227,469,204,199,5,76,2,0.035175879,0,empty,CD-0722-2
"D9,G4",12036,14197,8559,5638,8434,5093,0,5101,2988,2113,1.414103171,3070,155,24,15,15,0,9,0,0.066666667,0,empty,CD-0722-2
"D9,G5",4126,4923,2993,1930,2891,1648,0,1648,1096,552,1.985507246,985,1559,319,138,137,1,40,1,0.02919708,0,empty,CD-0722-2
"D9,G6",6030,6891,4426,2465,4154,2252,0,2255,1473,782,1.883631714,1301,269,69,35,35,0,10,0,0,0,empty,CD-0722-2
"D9,G7",4674,5088,3530,1558,3055,1528,0,1529,988,541,1.826247689,837,2263,419,177,175,2,51,1,0.137142857,0,empty,CD-0722-2
"D9,G8",3368,3580,2453,1127,2207,1149,0,1149,780,369,2.113821138,624,1825,368,163,163,0,60,0,0.012269939,0,empty,CD-0722-2
"D9,G9",4184,4852,3080,1772,2918,1615,1,1622,1064,558,1.906810036,950,1788,341,148,146,2,59,1,0.01369863,0,empty,CD-0722-2
"D9,G10",4920,5646,3543,2103,3390,1895,0,1895,1197,698,1.714899713,1118,2496,475,206,204,2,63,2,0.088235294,0,empty,CD-0722-2
"D9,G11",4833,5424,3629,1795,3192,1675,0,1676,1131,545,2.075229358,912,1458,366,159,159,0,46,0,0.088050314,0,empty,CD-0722-2
"D9,G12",4346,4957,3155,1802,2993,1693,0,1695,1120,575,1.947826087,980,1937,375,179,179,0,66,0,0.067039106,0,empty,CD-0722-2
"D9,H1",528610,597822,398992,198830,343788,180494,0,180641,146201,34440,4.245092915,103647,64832,9677,3684,3617,67,683,5,0.020182472,0,hg38,CD-0722-2
"D9,H2",4779,5354,3491,1863,3183,1709,0,1711,1129,582,1.939862543,959,2101,621,260,259,1,75,1,0.181467181,0,empty,CD-0722-2
"D9,H3",487040,558007,357410,200597,319416,176677,4,176810,134982,41828,3.227072774,103158,72461,10707,4281,4211,70,826,5,0.030634054,0,hg38,CD-0722-2
"D9,H4",6036,6603,4335,2268,3928,2106,0,2107,1385,722,1.918282548,1176,221,24,18,17,1,11,1,0,0,empty,CD-0722-2
"D9,H5",6479,7232,4641,2591,4353,2422,0,2426,1579,847,1.864226682,1388,2551,633,237,234,3,66,1,0.213675214,0,empty,CD-0722-2
"D9,H6",4031,4757,2908,1849,2877,1685,0,1685,1108,577,1.920277296,997,1943,535,218,214,4,63,2,0.028037383,0,empty,CD-0722-2
"D9,H7",4921,5441,3558,1883,3377,1776,0,1779,1241,538,2.30669145,1012,1670,423,197,195,2,71,1,0.071794872,0,empty,CD-0722-2
"D9,H8",5406,6116,3909,2207,3622,2013,0,2014,1308,706,1.852691218,1114,2011,357,137,137,0,66,0,0.138686131,0,empty,CD-0722-2
"D9,H9",4137,4753,3147,1606,2788,1453,0,1458,1008,450,2.24,826,1106,273,119,119,0,31,0,0,0,empty,CD-0722-2
"D9,H10",4234,4848,3161,1687,2857,1562,0,1565,1109,456,2.432017544,859,1801,367,137,135,2,52,2,0.074074074,0,empty,CD-0722-2
"D9,H11",5201,5960,3465,2495,3577,2280,0,2283,1217,1066,1.141651032,1386,115,10,2,2,0,2,0,0,0,empty,CD-0722-2
"D9,H12",4093,4759,2862,1897,2836,1661,0,1661,1154,507,2.276134122,1000,1861,326,136,134,2,41,1,0.074626866,0,empty,CD-0722-2
"D10,A1",3662,4311,2587,1724,2539,1478,0,1481,951,530,1.794339623,880,1005,290,105,101,4,32,2,0.00990099,0,empty,CD-0722-2
"D10,A2",5447,6296,3966,2330,3752,2141,0,2141,1304,837,1.557945042,1269,1632,361,157,157,0,47,0,0.038216561,0,empty,CD-0722-2
"D10,A3",3546,3934,2652,1282,2418,1325,0,1325,907,418,2.169856459,730,1090,227,102,102,0,40,0,0.274509804,0,empty,CD-0722-2
"D10,A4",1093289,1247820,832912,414908,703789,371335,3,371699,300710,70989,4.236008396,211260,58275,8056,3081,3020,61,635,2,0.048013245,0,hg38,CD-0722-2
"D10,A5",4501,5013,3262,1751,3047,1626,0,1626,1031,595,1.732773109,950,2047,625,220,219,1,44,1,0.073059361,0,empty,CD-0722-2
"D10,A6",8671,9875,6490,3385,5847,3071,0,3071,2126,945,2.24973545,1771,2371,682,293,292,1,84,1,0.106164384,0,empty,CD-0722-2
"D10,A7",3506,4051,2563,1488,2478,1427,0,1431,973,458,2.124454148,843,885,194,90,90,0,31,0,0.111111111,0,empty,CD-0722-2
"D10,A8",2082,2414,1588,826,1450,783,0,784,512,272,1.882352941,463,1385,249,126,125,1,48,1,0.16,0,empty,CD-0722-2
"D10,A9",4888,5757,3704,2053,3470,1935,0,1935,1317,618,2.131067961,1131,1271,325,123,122,1,40,1,0.098360656,0,empty,CD-0722-2
"D10,A10",4652,5263,3470,1793,3166,1681,0,1683,1024,659,1.553869499,950,312,27,13,12,1,9,1,0.166666667,0,empty,CD-0722-2
"D10,A11",3403,3794,2590,1204,2217,1125,0,1126,741,385,1.924675325,605,1317,343,154,154,0,39,0,0.090909091,0,empty,CD-0722-2
"D10,A12",4995,5752,3641,2111,3305,1780,0,1780,1187,593,2.001686341,1034,2481,559,219,216,3,67,2,0.027777778,0,empty,CD-0722-2
"D10,B1",4046,4703,2914,1789,2801,1584,0,1584,974,610,1.596721311,900,1019,173,87,87,0,28,0,0.149425287,0,empty,CD-0722-2
"D10,B2",4305,4887,2932,1955,2923,1709,0,1710,1061,649,1.634822804,1009,470,108,48,48,0,19,0,0.020833333,0,empty,CD-0722-2
"D10,B3",554028,679404,402425,276979,393684,231729,0,231884,191114,40770,4.687613441,142009,103651,21385,8152,8060,92,1382,3,0.065508685,0,hg38,CD-0722-2
"D10,B4",4024,4626,2833,1793,2854,1681,0,1684,1044,640,1.63125,1026,1188,264,76,73,3,31,1,0.109589041,0,empty,CD-0722-2
"D10,B5",4091,2398,1436,962,1704,980,0,984,661,323,2.046439628,624,838,135,69,69,0,25,0,0.217391304,0,empty,CD-0722-2
"D10,B6",4487,5209,3129,2080,3083,1815,0,1816,1151,665,1.730827068,1068,1413,156,84,84,0,32,0,0.035714286,0,empty,CD-0722-2
"D10,B7",3994,4495,3041,1454,2718,1436,0,1438,998,440,2.268181818,788,1285,305,101,99,2,38,2,0.141414141,0,empty,CD-0722-2
"D10,B8",2964,3319,2193,1126,1994,1072,0,1072,690,382,1.806282723,612,1005,237,72,72,0,32,0,0.291666667,0,empty,CD-0722-2
"D10,B9",5869,6792,4153,2639,4162,2432,0,2436,1528,908,1.682819383,1478,949,129,75,73,2,38,1,0.123287671,0,empty,CD-0722-2
"D10,B10",2826,3252,2017,1235,1960,1063,0,1067,695,372,1.86827957,625,464,141,56,56,0,20,0,0,0,empty,CD-0722-2
"D10,B11",6660,7795,4733,3062,4634,2781,0,2783,1505,1278,1.177621283,1649,190,29,19,19,0,12,0,0.052631579,0,empty,CD-0722-2
"D10,B12",3653,4170,2666,1504,2527,1429,0,1431,952,479,1.987473904,796,1088,311,132,132,0,46,0,0.075757576,0,empty,CD-0722-2
"D10,C1",7083,7917,5178,2739,4688,2541,0,2547,1592,955,1.667015707,1439,664,127,53,53,0,24,0,0.018867925,0,empty,CD-0722-2
"D10,C2",5761,6687,4179,2508,4030,2301,1,2302,1504,798,1.884711779,1307,1838,477,201,197,4,45,2,0.091370558,0,empty,CD-0722-2
"D10,C3",599745,714762,444735,270027,411776,232376,2,232547,187702,44845,4.185572528,138113,47541,6684,2605,2562,43,536,2,0.050351288,0,hg38,CD-0722-2
"D10,C4",3680,4022,2731,1291,2467,1284,0,1285,819,466,1.75751073,726,1313,213,97,95,2,36,1,0.126315789,0,empty,CD-0722-2
"D10,C5",5709,6595,4231,2364,3947,2176,0,2177,1465,712,2.05758427,1252,1400,295,132,132,0,46,0,0.015151515,0,empty,CD-0722-2
"D10,C6",5376,6021,3854,2167,3662,2004,0,2006,1387,619,2.240710824,1174,1121,269,120,118,2,30,2,0.025423729,0,empty,CD-0722-2
"D10,C7",843821,993497,637245,356252,565735,314718,2,315005,256744,58261,4.406790134,183013,6608,770,313,309,4,101,2,0,0,hg38,CD-0722-2
"D10,C8",12391,14948,8727,6221,8900,5538,0,5540,3939,1601,2.460337289,3350,2756,747,272,270,2,86,1,0.022222222,0,empty,CD-0722-2
"D10,C9",8675,9946,6421,3525,5905,3134,0,3134,2159,975,2.214358974,1855,4378,699,290,287,3,79,2,0.076655052,0,empty,CD-0722-2
"D10,C10",5598,6305,4145,2160,3669,1953,0,1955,1272,683,1.862371889,1075,1595,358,150,149,1,44,1,0.033557047,0,empty,CD-0722-2
"D10,C11",4670,5259,3365,1894,3229,1745,0,1745,1141,604,1.889072848,1049,1290,403,143,142,1,48,1,0,0,empty,CD-0722-2
"D10,C12",6624,7481,4798,2683,4513,2420,0,2426,1663,763,2.179554391,1413,1935,505,163,162,1,53,1,0.018518519,0,empty,CD-0722-2
"D10,D1",6955,8254,4878,3376,4992,3052,0,3056,1790,1266,1.413902054,1894,767,129,50,50,0,20,0,0.02,0,empty,CD-0722-2
"D10,D2",4905,5504,3616,1888,3327,1724,0,1728,1114,614,1.814332248,1015,2450,651,243,239,4,64,2,0.087866109,0,empty,CD-0722-2
"D10,D3",4257,4883,2996,1887,2962,1699,0,1704,1160,544,2.132352941,1020,1312,343,135,133,2,45,1,0.030075188,0,empty,CD-0722-2
"D10,D4",3240,3670,2488,1182,2213,1158,0,1158,796,362,2.198895028,651,964,193,89,86,3,28,3,0,0,empty,CD-0722-2
"D10,D5",3896,4729,2804,1925,2858,1664,0,1664,1174,490,2.395918367,1023,1220,142,77,71,6,38,2,0.042253521,0,empty,CD-0722-2
"D10,D6",207773,240356,158769,81587,138664,73851,0,73915,55768,18147,3.073125034,42530,21591,2779,1110,1077,33,261,3,0.117920149,0,hg38,CD-0722-2
"D10,D7",3476,3941,2624,1317,2389,1262,0,1262,812,450,1.804444444,710,1915,380,133,132,1,54,1,0.083333333,0,empty,CD-0722-2
"D10,D8",16672,18745,12775,5970,10909,5298,2,5301,3776,1525,2.476065574,2971,15096,2878,1077,1048,29,266,5,0.038167939,0,empty,CD-0722-2
"D10,D9",2027,2328,1468,860,1445,759,0,759,503,256,1.96484375,469,1134,271,101,99,2,25,1,0.03030303,0,empty,CD-0722-2
"D10,D10",526263,648203,374055,274148,377485,232574,0,232756,183417,49339,3.717485154,143882,10535,1369,523,517,6,174,3,0.079303675,0,hg38,CD-0722-2
"D10,D11",4324,5036,3092,1944,3079,1659,0,1659,1069,590,1.811864407,1008,2248,476,213,209,4,70,1,0.028708134,0,empty,CD-0722-2
"D10,D12",5811,6785,4290,2495,3998,2257,0,2261,1441,820,1.757317073,1263,3299,896,340,334,6,92,2,0.041916168,0,empty,CD-0722-2
"D10,E1",6651,7706,4857,2849,4551,2566,0,2568,1608,960,1.675,1478,1990,312,106,104,2,39,2,0.134615385,0,empty,CD-0722-2
"D10,E2",618317,699983,475517,224466,403682,193670,2,193818,153287,40531,3.781969357,115341,202698,28450,10960,10699,261,1795,7,0.05065894,0,hg38,CD-0722-2
"D10,E3",3365,3953,2491,1462,2321,1222,0,1222,780,442,1.764705882,706,1536,538,223,219,4,61,1,0.105022831,0,empty,CD-0722-2
"D10,E4",4791,5442,3473,1969,3233,1727,0,1732,1106,626,1.766773163,1029,1943,354,157,153,4,52,2,0.052287582,0,empty,CD-0722-2
"D10,E5",1775821,2096139,1312907,783232,1180735,687758,3,688284,557128,131156,4.247827015,403886,173898,24464,9172,8957,215,1596,7,0.040080384,0,hg38,CD-0722-2
"D10,E6",7836,8730,5774,2956,5206,2830,0,2832,1814,1018,1.781925344,1602,2940,619,248,246,2,89,2,0.016260163,0,empty,CD-0722-2
"D10,E7",338519,370209,262168,108041,214108,102724,0,102810,78398,24412,3.211453384,56462,43550,5695,2296,2238,58,509,3,0.018319929,0,hg38,CD-0722-2
"D10,E8",5147,5909,3879,2030,3509,1861,0,1867,1225,642,1.908099688,1062,1831,392,128,126,2,48,1,0.134920635,0,empty,CD-0722-2
"D10,E9",3589,4253,2575,1678,2556,1452,0,1453,963,490,1.965306122,881,2016,380,148,147,1,56,1,0.054421769,0,empty,CD-0722-2
"D10,E10",3777,4252,2810,1442,2595,1384,0,1384,924,460,2.008695652,793,1283,395,168,168,0,51,0,0.047619048,0,empty,CD-0722-2
"D10,E11",4638,5074,3375,1699,3072,1664,0,1665,1042,623,1.672552167,934,1510,176,91,89,2,33,2,0.078651685,0,empty,CD-0722-2
"D10,E12",5236,6170,3782,2388,3732,2065,0,2067,1356,711,1.907172996,1261,1730,254,113,110,3,40,2,0.018181818,0,empty,CD-0722-2
"D10,F1",572479,658518,423299,235219,378291,208344,0,208536,159604,48932,3.261751001,121045,133450,17047,6697,6551,146,1243,7,0.033582659,0,hg38,CD-0722-2
"D10,F2",550133,667420,393254,274166,389360,243205,0,243382,169925,73457,2.313258097,148771,33789,14953,5614,5590,24,927,2,0.044364937,0,hg38,CD-0722-2
"D10,F3",477663,564676,349764,214912,327971,185125,1,185252,145883,39369,3.705529732,111053,151745,25206,9632,9453,179,1473,4,0.083994499,0,hg38,CD-0722-2
"D10,F4",6650,7381,4977,2404,4430,2244,1,2248,1443,805,1.792546584,1238,720,157,77,74,3,30,1,0.027027027,0,empty,CD-0722-2
"D10,F5",5828,6555,4292,2263,3858,2068,0,2068,1410,658,2.142857143,1186,1804,298,120,117,3,51,2,0.136752137,0,empty,CD-0722-2
"D10,F6",5302,5868,3824,2044,3466,1933,0,1934,1272,662,1.921450151,1068,1800,308,134,134,0,44,0,0.067164179,0,empty,CD-0722-2
"D10,F7",547993,624737,415860,208877,360467,189239,0,189401,146885,42516,3.45481701,108721,15772,3156,1292,1257,35,273,3,0.036595068,0,hg38,CD-0722-2
"D10,F8",4504,5083,3324,1759,3094,1713,0,1715,1086,629,1.726550079,973,318,69,30,29,1,18,1,0.344827586,0,empty,CD-0722-2
"D10,F9",4932,5465,3714,1751,3333,1781,0,1783,1217,566,2.150176678,997,2577,449,236,234,2,75,2,0.017094017,0,empty,CD-0722-2
"D10,F10",5899,6565,4410,2155,3888,2033,0,2033,1328,705,1.883687943,1092,1721,317,145,144,1,48,1,0.006944444,0,empty,CD-0722-2
"D10,F11",4887,5383,3654,1729,3282,1734,0,1734,1164,570,2.042105263,967,1362,229,99,98,1,29,1,0.102040816,0,empty,CD-0722-2
"D10,F12",5234,5953,3779,2174,3560,1997,0,1997,1264,733,1.724420191,1166,184,44,25,25,0,10,0,0,0,empty,CD-0722-2
"D10,G1",484892,550254,365810,184444,319474,168607,2,168786,130652,38134,3.426128914,96457,69526,12546,4506,4408,98,837,4,0.045598911,0,hg38,CD-0722-2
"D10,G2",3651,4129,2426,1703,2524,1489,0,1490,973,517,1.882011605,887,540,179,63,62,1,32,1,0.048387097,0,empty,CD-0722-2
"D10,G3",6264,6890,4515,2375,4146,2313,1,2317,1431,886,1.615124153,1272,2184,498,165,163,2,52,1,0.006134969,0,empty,CD-0722-2
"D10,G4",11370,13458,7879,5579,8061,4939,0,4940,2937,2003,1.466300549,3046,151,47,21,21,0,7,0,0,0,empty,CD-0722-2
"D10,G5",489781,569984,368588,201396,327175,174176,0,174344,129985,44359,2.930295994,102708,104593,10349,4098,3959,139,838,6,0.061631725,0,hg38,CD-0722-2
"D10,G6",5902,6604,4316,2288,3894,2118,0,2124,1378,746,1.847184987,1206,121,25,18,18,0,10,0,0.055555556,0,empty,CD-0722-2
"D10,G7",4464,4997,3347,1650,2968,1488,0,1488,1013,475,2.132631579,815,1858,377,145,145,0,60,0,0.103448276,0,empty,CD-0722-2
"D10,G8",3194,3551,2306,1245,2187,1171,0,1171,793,378,2.097883598,656,1365,278,114,114,0,38,0,0.236842105,0,empty,CD-0722-2
"D10,G9",3942,4412,2870,1542,2701,1422,0,1427,956,471,2.029723992,853,2063,510,216,214,2,65,2,0.060747664,0,empty,CD-0722-2
"D10,G10",4866,5741,3612,2129,3432,1931,0,1931,1242,689,1.802612482,1137,1865,562,188,187,1,63,1,0.085561497,0,empty,CD-0722-2
"D10,G11",4775,5339,3541,1798,3215,1683,0,1684,1154,530,2.177358491,950,1352,238,94,93,1,45,1,0.107526882,0,empty,CD-0722-2
"D10,G12",4077,4676,2911,1765,2857,1621,0,1624,1043,581,1.795180723,949,1819,391,173,172,1,68,1,0.058139535,0,empty,CD-0722-2
"D10,H1",4617,5215,3372,1843,3128,1653,0,1653,1096,557,1.967684022,953,1164,240,104,95,9,34,2,0.063157895,0,empty,CD-0722-2
"D10,H2",4543,5296,3298,1998,3202,1789,0,1789,1179,610,1.932786885,1058,2049,409,199,199,0,66,0,0.095477387,0,empty,CD-0722-2
"D10,H3",4016,4687,2904,1783,2787,1553,0,1557,1074,483,2.223602484,921,1367,364,120,120,0,42,0,0.175,0,empty,CD-0722-2
"D10,H4",5763,6392,4143,2249,3822,2039,0,2040,1359,681,1.995594714,1201,127,29,16,16,0,14,0,0.1875,0,empty,CD-0722-2
"D10,H5",6263,6978,4552,2426,4143,2254,0,2258,1446,812,1.780788177,1265,1859,311,144,140,4,61,1,0.014285714,0,empty,CD-0722-2
"D10,H6",3882,4469,2877,1592,2757,1540,0,1542,1039,503,2.065606362,901,1927,517,223,220,3,64,1,0.036363636,0,empty,CD-0722-2
"D10,H7",4388,4933,3242,1691,2978,1544,1,1547,1021,526,1.941064639,886,1875,330,149,147,2,71,2,0.102040816,0,empty,CD-0722-2
"D10,H8",4852,5606,3448,2158,3412,1944,0,1944,1221,723,1.68879668,1121,1517,266,106,105,1,41,1,0.123809524,0,empty,CD-0722-2
"D10,H9",3779,4277,2783,1494,2541,1344,8,1357,937,420,2.230952381,773,877,180,62,62,0,23,0,0.193548387,0,empty,CD-0722-2
"D10,H10",3763,4292,2781,1511,2560,1332,0,1332,894,438,2.04109589,762,1293,244,79,79,0,38,0,0.17721519,0,empty,CD-0722-2
"D10,H11",5048,5944,3436,2508,3496,2270,0,2275,1216,1059,1.148253069,1357,26,2,2,2,0,2,0,0,0,empty,CD-0722-2
"D10,H12",3865,4300,2709,1591,2573,1452,0,1452,981,471,2.082802548,845,1419,228,122,118,4,38,2,0.118644068,0,empty,CD-0722-2
"D11,A1",3767,4445,2713,1732,2712,1567,0,1567,972,595,1.633613445,913,1023,160,72,72,0,35,0,0.069444444,0,empty,CD-0722-2
"D11,A2",6437,7307,4703,2604,4468,2452,0,2453,1574,879,1.790671217,1386,1949,311,137,133,4,50,2,0.172932331,0,empty,CD-0722-2
"D11,A3",879411,1075044,647760,427284,621199,368615,1,368883,305310,63573,4.8025105,222940,132141,19612,7675,7542,133,1376,5,0.049721559,0.007518797,hg38,CD-0722-2
"D11,A4",697547,878740,492045,386695,505376,314958,1,315203,253193,62010,4.0830995,196492,106674,10631,4325,4189,136,858,11,0.102888518,0,hg38,CD-0722-2
"D11,A5",4931,5531,3648,1883,3372,1843,0,1846,1181,665,1.77593985,1052,1432,432,153,151,2,43,2,0.099337748,0,empty,CD-0722-2
"D11,A6",4626,5342,3391,1951,3222,1825,0,1828,1203,625,1.9248,1053,2751,828,323,322,1,97,1,0.090062112,0,empty,CD-0722-2
"D11,A7",3640,4212,2684,1528,2648,1511,0,1512,986,526,1.874524715,858,1205,199,95,93,2,38,1,0.107526882,0,empty,CD-0722-2
"D11,A8",2373,2814,1704,1110,1711,975,0,981,661,320,2.065625,584,1758,304,141,141,0,39,0,0.007092199,0,empty,CD-0722-2
"D11,A9",384894,492115,263570,228545,289432,199476,2,199614,143224,56390,2.539882958,123947,8506,796,323,310,13,86,2,0.306451613,0,hg38,CD-0722-2
"D11,A10",5503,6352,4090,2262,3871,2201,0,2203,1539,664,2.317771084,1242,427,62,34,34,0,19,0,0.029411765,0,empty,CD-0722-2
"D11,A11",894918,1024333,678495,345838,587968,315299,2,315577,241147,74430,3.2399167,179439,188875,24912,9742,9523,219,1604,7,0.067310721,0,hg38,CD-0722-2
"D11,A12",5387,6037,4038,1999,3630,1915,0,1917,1271,646,1.96749226,1095,2887,683,296,289,7,96,3,0.107266436,0,empty,CD-0722-2
"D11,B1",4377,5036,3199,1837,2994,1681,0,1684,1041,643,1.618973561,945,830,182,82,76,6,32,2,0.013157895,0,empty,CD-0722-2
"D11,B2",4829,5357,3369,1988,3332,1921,0,1923,1236,687,1.799126638,1124,573,132,50,49,1,16,1,0.040816327,0,empty,CD-0722-2
"D11,B3",3821,4259,2717,1542,2648,1466,0,1466,939,527,1.781783681,861,1354,218,119,115,4,58,2,0.017391304,0,empty,CD-0722-2
"D11,B4",4401,5007,3098,1909,3049,1782,3,1785,1139,646,1.763157895,1044,1278,232,90,88,2,32,1,0.068181818,0,empty,CD-0722-2
"D11,B5",5180,3708,2180,1528,2596,1550,0,1556,1085,471,2.303609342,1006,965,199,87,83,4,26,1,0.012048193,0,empty,CD-0722-2
"D11,B6",4831,5700,3395,2305,3529,2102,0,2104,1332,772,1.725388601,1268,1107,308,103,101,2,36,2,0.01980198,0,empty,CD-0722-2
"D11,B7",635463,765532,467380,298152,443558,257574,0,257760,204545,53215,3.843747064,153870,48407,11073,4192,4147,45,854,3,0.057632023,0,hg38,CD-0722-2
"D11,B8",3190,3694,2330,1364,2215,1250,0,1250,841,409,2.056234719,721,1287,286,135,133,2,45,2,0.067669173,0,empty,CD-0722-2
"D11,B9",6428,7354,4628,2726,4420,2544,0,2549,1622,927,1.749730313,1469,985,274,112,112,0,56,0,0.035714286,0,empty,CD-0722-2
"D11,B10",347927,378351,235242,143109,232041,139544,11,139885,106657,33228,3.209853136,80900,5492,3541,1299,1297,2,274,1,0.00154202,0,hg38,CD-0722-2
"D11,B11",7637,9050,5360,3690,5334,3265,0,3265,1799,1466,1.227148704,1996,376,65,45,44,1,22,1,0.045454545,0,empty,CD-0722-2
"D11,B12",3907,4565,2858,1707,2715,1476,0,1477,1007,470,2.142553191,878,1322,335,121,118,3,49,2,0.016949153,0,empty,CD-0722-2
"D11,C1",11547,12589,8771,3818,7366,3721,0,3726,2503,1223,2.046606705,2013,1892,287,117,116,1,41,1,0.051724138,0,empty,CD-0722-2
"D11,C2",6063,7139,4295,2844,4281,2473,0,2473,1574,899,1.75083426,1527,2076,630,196,190,6,66,2,0.042105263,0,empty,CD-0722-2
"D11,C3",6244,6933,4661,2272,4234,2279,0,2279,1478,801,1.845193508,1237,790,157,75,75,0,29,0,0.013333333,0,empty,CD-0722-2
"D11,C4",4058,4554,3046,1508,2767,1448,0,1450,873,577,1.512998267,815,1565,363,176,176,0,50,0,0.136363636,0,empty,CD-0722-2
"D11,C5",5593,6518,4095,2423,3968,2197,0,2204,1486,718,2.069637883,1284,1518,184,84,82,2,37,1,0.097560976,0,empty,CD-0722-2
"D11,C6",4953,5822,3528,2294,3482,1955,0,1958,1236,722,1.711911357,1177,1123,347,126,125,1,46,1,0.008,0,empty,CD-0722-2
"D11,C7",310616,374171,217717,156454,232701,153972,0,154056,102394,51662,1.981998374,92214,704,119,65,65,0,16,0,0.030769231,0,empty,CD-0722-2
"D11,C8",7635,8823,5548,3275,5398,2989,0,2994,2010,984,2.042682927,1773,2690,619,234,231,3,95,1,0.142857143,0,empty,CD-0722-2
"D11,C9",5181,5981,3781,2200,3635,2021,0,2021,1335,686,1.94606414,1203,1283,262,108,108,0,34,0,0.37037037,0,empty,CD-0722-2
"D11,C10",5850,6731,4359,2372,3985,2172,0,2173,1435,738,1.944444444,1220,1851,277,124,124,0,44,0,0.161290323,0,empty,CD-0722-2
"D11,C11",4791,5479,3558,1921,3353,1833,0,1833,1159,674,1.71958457,1078,1602,308,130,130,0,50,0,0.030769231,0,empty,CD-0722-2
"D11,C12",6804,7560,4815,2745,4630,2494,0,2497,1642,855,1.920467836,1462,2075,532,202,195,7,54,2,0.112820513,0,empty,CD-0722-2
"D11,D1",6230,7236,4452,2784,4385,2599,0,2603,1591,1012,1.572134387,1515,649,112,60,58,2,28,1,0,0,empty,CD-0722-2
"D11,D2",926544,1141115,678573,462542,661262,398832,2,399114,333928,65186,5.122695057,242709,4971,1730,589,585,4,219,2,0.064957265,0,hg38,CD-0722-2
"D11,D3",4740,5371,3507,1864,3243,1792,0,1794,1198,596,2.010067114,1030,1216,297,143,139,4,54,1,0.014388489,0,empty,CD-0722-2
"D11,D4",702496,901155,498392,402763,519337,324182,3,324405,267113,57292,4.662308874,205887,131374,20172,7735,7588,147,1366,8,0.048892989,0,hg38,CD-0722-2
"D11,D5",4070,4526,3017,1509,2835,1548,0,1550,1027,523,1.963671128,896,1348,265,120,113,7,56,2,0.115044248,0,empty,CD-0722-2
"D11,D6",6389,7471,4410,3061,4402,2591,0,2593,1523,1070,1.423364486,1567,1518,400,176,176,0,51,0,0.153409091,0,empty,CD-0722-2
"D11,D7",3600,3928,2698,1230,2466,1260,0,1260,882,378,2.333333333,692,1888,471,202,202,0,83,0,0.084158416,0,empty,CD-0722-2
"D11,D8",4244,4779,3218,1561,2916,1559,0,1559,1011,548,1.844890511,888,1000,260,117,117,0,43,0,0.025641026,0,empty,CD-0722-2
"D11,D9",2276,2480,1699,781,1497,781,0,787,520,267,1.947565543,439,1376,351,129,129,0,43,0,0.031007752,0,empty,CD-0722-2
"D11,D10",4252,4942,3083,1859,3038,1766,0,1768,1151,617,1.86547812,1049,727,160,52,52,0,25,0,0.057692308,0,empty,CD-0722-2
"D11,D11",824220,1016490,587664,428826,592446,387601,1,387838,279193,108645,2.569773114,234335,37252,2183,854,794,60,197,6,0.277078086,0,hg38,CD-0722-2
"D11,D12",533224,618356,399864,218492,357168,191951,4,192108,149619,42489,3.521358469,112727,222857,24017,9287,9037,250,1546,9,0.056434658,0,hg38,CD-0722-2
"D11,E1",7300,8095,5267,2828,4855,2680,1,2684,1735,949,1.828240253,1529,1910,328,157,157,0,63,0,0.038216561,0,empty,CD-0722-2
"D11,E2",5260,5825,3733,2092,3477,1919,0,1919,1262,657,1.920852359,1101,1247,219,97,97,0,44,0,0.082474227,0,empty,CD-0722-2
"D11,E3",885626,1066961,653364,413597,618109,359174,2,359497,288238,71259,4.044934675,214575,260358,31966,12866,12554,312,2256,9,0.035845149,0,hg38,CD-0722-2
"D11,E4",4578,5329,3344,1985,3224,1801,0,1802,1152,650,1.772307692,1097,2277,464,186,182,4,82,2,0.148351648,0,empty,CD-0722-2
"D11,E5",4141,4689,3109,1580,2895,1510,0,1510,963,547,1.760511883,866,1066,314,123,122,1,39,1,0.016393443,0,empty,CD-0722-2
"D11,E6",603745,684957,461920,223037,389401,200879,2,201084,152795,48289,3.164178177,112358,75103,16200,6291,6214,77,1113,6,0.040231735,0,hg38,CD-0722-2
"D11,E7",7158,8109,5267,2842,4791,2572,0,2575,1674,901,1.857935627,1490,2420,535,243,240,3,86,2,0.025,0,empty,CD-0722-2
"D11,E8",5426,5951,4111,1840,3502,1753,0,1753,1120,633,1.769352291,904,2617,529,229,228,1,73,1,0.048245614,0,empty,CD-0722-2
"D11,E9",3889,4452,2873,1579,2688,1484,0,1487,996,491,2.028513238,871,2182,480,199,197,2,78,2,0.106598985,0,empty,CD-0722-2
"D11,E10",4062,4684,3027,1657,2741,1466,0,1466,972,494,1.967611336,826,1141,292,114,113,1,38,1,0.07079646,0,empty,CD-0722-2
"D11,E11",5130,5610,3725,1885,3355,1855,0,1860,1133,727,1.558459422,1061,1876,593,203,203,0,56,0,0.098522167,0,empty,CD-0722-2
"D11,E12",5470,6223,4011,2212,3802,2046,0,2048,1272,776,1.639175258,1193,1536,314,103,102,1,45,1,0.039215686,0,empty,CD-0722-2
"D11,F1",6600,7404,4801,2603,4442,2383,0,2387,1545,842,1.834916865,1351,1944,426,193,189,4,65,2,0.068783069,0,empty,CD-0722-2
"D11,F2",4994,5675,3587,2088,3412,1871,0,1873,1182,691,1.710564399,1087,2430,654,234,230,4,75,2,0.139130435,0,empty,CD-0722-2
"D11,F3",4498,5007,3313,1694,3079,1653,0,1653,1050,603,1.741293532,939,2498,547,215,209,6,68,2,0.033492823,0,empty,CD-0722-2
"D11,F4",6900,7785,5087,2698,4699,2457,0,2459,1602,857,1.869311552,1439,832,182,78,77,1,39,1,0.025974026,0,empty,CD-0722-2
"D11,F5",5366,5824,3903,1921,3528,1807,0,1809,1165,644,1.809006211,989,2263,485,194,194,0,67,0,0.06185567,0,empty,CD-0722-2
"D11,F6",5760,6579,4129,2450,3960,2271,0,2271,1431,840,1.703571429,1326,2199,566,213,208,5,50,2,0.125,0,empty,CD-0722-2
"D11,F7",587351,631666,462320,169346,362362,168673,1,168846,130846,38000,3.443315789,87935,40940,6467,2436,2384,52,527,4,0.042365772,0,hg38,CD-0722-2
"D11,F8",4703,5450,3517,1933,3342,1831,0,1834,1229,605,2.031404959,1054,493,54,37,37,0,27,0,0.027027027,0,empty,CD-0722-2
"D11,F9",3302082,3336121,2664115,672006,1797654,881965,3,882789,629135,253654,2.480288109,360130,155685,21136,7901,7722,179,1462,5,0.053095053,0,hg38,CD-0722-2
"D11,F10",5953,6796,4407,2389,4103,2162,0,2164,1428,736,1.940217391,1267,1325,320,144,143,1,55,1,0.258741259,0,empty,CD-0722-2
"D11,F11",5096,5431,3855,1576,3357,1698,0,1701,1148,553,2.075949367,882,1269,201,101,100,1,40,1,0.03,0,empty,CD-0722-2
"D11,F12",5655,6408,4096,2312,3736,2065,0,2069,1407,662,2.125377644,1163,158,22,14,14,0,10,0,0.214285714,0,empty,CD-0722-2
"D11,G1",5591,6142,4113,2029,3768,1976,0,1977,1284,693,1.852813853,1099,3136,659,274,273,1,104,1,0.076923077,0,empty,CD-0722-2
"D11,G2",3733,4051,2576,1475,2506,1481,0,1481,957,524,1.826335878,863,590,118,60,59,1,39,1,0.016949153,0,empty,CD-0722-2
"D11,G3",6593,7207,4800,2407,4339,2411,0,2416,1492,924,1.614718615,1301,1970,398,178,175,3,51,2,0.137142857,0,empty,CD-0722-2
"D11,G4",12006,13844,8509,5335,8345,5095,0,5099,3114,1985,1.568765743,2971,160,34,24,24,0,14,0,0,0,empty,CD-0722-2
"D11,G5",4124,4767,3001,1766,2884,1642,0,1643,1057,586,1.803754266,953,1785,439,206,203,3,58,2,0.064039409,0,empty,CD-0722-2
"D11,G6",6026,6563,4546,2017,3965,2069,0,2071,1363,708,1.925141243,1102,210,47,20,20,0,11,0,0,0,empty,CD-0722-2
"D11,G7",4500,4826,3369,1457,2879,1409,6,1415,920,495,1.858585859,746,2121,445,183,183,0,51,0,0.071038251,0,empty,CD-0722-2
"D11,G8",3259,3612,2372,1240,2237,1198,0,1200,789,411,1.919708029,666,1624,409,166,161,5,66,2,0.062111801,0,empty,CD-0722-2
"D11,G9",3956,4403,2915,1488,2722,1511,0,1511,967,544,1.777573529,814,1744,269,133,131,2,59,2,0.053435115,0,empty,CD-0722-2
"D11,G10",5170,5952,3631,2321,3516,1993,0,1995,1313,682,1.925219941,1202,2112,662,262,259,3,82,2,0.054054054,0,empty,CD-0722-2
"D11,G11",4905,5372,3640,1732,3278,1742,0,1747,1168,579,2.017271157,950,1590,284,116,116,0,45,0,0.034482759,0,empty,CD-0722-2
"D11,G12",474655,543856,356594,187262,320766,170982,0,171125,131218,39907,3.28809482,99613,60708,11928,4479,4402,77,795,3,0.026351658,0,hg38,CD-0722-2
"D11,H1",4922,5455,3620,1835,3312,1798,0,1798,1237,561,2.204991087,995,1380,330,149,144,5,46,1,0.076388889,0,empty,CD-0722-2
"D11,H2",5875,6506,4235,2271,3938,2232,0,2232,1493,739,2.0202977,1261,2134,555,219,214,5,66,2,0.074766355,0,empty,CD-0722-2
"D11,H3",4396,4952,3115,1837,2913,1621,0,1624,1021,603,1.693200663,931,1514,292,143,141,2,54,1,0.156028369,0,empty,CD-0722-2
"D11,H4",6210,7163,4553,2610,4252,2353,0,2355,1547,808,1.91460396,1362,137,20,16,16,0,11,0,0.125,0,empty,CD-0722-2
"D11,H5",6464,7490,4683,2807,4379,2424,0,2432,1564,868,1.801843318,1411,1703,403,182,180,2,82,2,0.022222222,0,empty,CD-0722-2
"D11,H6",532870,655781,386252,269529,382263,227476,0,227675,183123,44552,4.110320524,139748,54428,27300,10462,10445,17,1533,3,0.028338918,0,hg38,CD-0722-2
"D11,H7",477806,565198,346775,218423,332542,190700,2,190831,155308,35523,4.37204065,114025,139835,27822,10315,10165,150,1619,6,0.046728972,0,hg38,CD-0722-2
"D11,H8",5360,6175,3903,2272,3728,2145,0,2145,1391,754,1.844827586,1227,1669,316,150,146,4,65,2,0.034246575,0,empty,CD-0722-2
"D11,H9",4958,5581,3709,1872,3343,1790,0,1791,1242,549,2.262295082,988,1141,217,87,85,2,37,2,0,0,empty,CD-0722-2
"D11,H10",4074,4559,2912,1647,2773,1546,0,1546,1011,535,1.889719626,899,1610,377,163,162,1,58,1,0.098765432,0,empty,CD-0722-2
"D11,H11",5455,6523,3759,2764,3939,2601,0,2606,1461,1145,1.275982533,1585,114,45,23,23,0,8,0,0.086956522,0,empty,CD-0722-2
"D11,H12",468832,544350,347325,197025,318800,174433,1,174550,134787,39763,3.389759324,102912,171942,13967,5632,5398,234,1036,8,0.074842534,0,hg38,CD-0722-2
"D12,A1",3795,4339,2680,1659,2601,1502,0,1502,990,512,1.93359375,854,1117,198,68,65,3,22,1,0.107692308,0,empty,CD-0722-2
"D12,A2",5575,6423,4024,2399,3757,2136,0,2142,1307,835,1.565269461,1240,1188,286,147,145,2,43,1,0.213793103,0,empty,CD-0722-2
"D12,A3",3373,3714,2432,1282,2252,1247,0,1247,796,451,1.764966741,724,1011,160,75,75,0,32,0,0.133333333,0,empty,CD-0722-2
"D12,A4",6251,7043,4569,2474,4135,2264,0,2264,1452,812,1.78817734,1261,854,222,84,80,4,19,2,0.075,0,empty,CD-0722-2
"D12,A5",4743,5267,3520,1747,3172,1716,0,1717,1101,616,1.787337662,948,1654,320,153,151,2,48,1,0.046357616,0,empty,CD-0722-2
"D12,A6",4108,4569,3060,1509,2780,1501,0,1501,996,505,1.972277228,807,2507,678,263,260,3,68,1,0.107692308,0,empty,CD-0722-2
"D12,A7",3947,4375,2818,1557,2607,1469,0,1473,912,561,1.625668449,822,1094,271,107,106,1,34,1,0.179245283,0,empty,CD-0722-2
"D12,A8",2262,2627,1634,993,1594,847,1,848,559,289,1.934256055,501,1344,239,104,101,3,40,2,0,0,empty,CD-0722-2
"D12,A9",3898,4361,2967,1394,2638,1394,0,1398,917,481,1.906444906,772,1523,373,189,187,2,50,2,0.14973262,0,empty,CD-0722-2
"D12,A10",4596,5248,3498,1750,3151,1633,0,1637,1033,604,1.710264901,952,325,60,26,25,1,8,1,0,0,empty,CD-0722-2
"D12,A11",3291,3691,2498,1193,2244,1154,0,1156,727,429,1.694638695,639,1357,355,148,146,2,44,2,0.089041096,0,empty,CD-0722-2
"D12,A12",5037,5774,3781,1993,3333,1718,0,1719,1106,613,1.804241436,959,2872,596,229,228,1,76,1,0.021929825,0,empty,CD-0722-2
"D12,B1",4087,4676,2923,1753,2830,1633,0,1636,1048,588,1.782312925,956,849,240,74,74,0,32,0,0.040540541,0,empty,CD-0722-2
"D12,B2",4253,4766,2930,1836,2978,1803,0,1806,1089,717,1.518828452,1055,505,257,71,71,0,19,0,0,0,empty,CD-0722-2
"D12,B3",3474,3996,2476,1520,2423,1377,0,1380,941,439,2.143507973,820,1374,297,127,123,4,45,1,0.056910569,0,empty,CD-0722-2
"D12,B4",4031,4855,2906,1949,2884,1681,0,1685,1055,630,1.674603175,1014,960,155,70,65,5,22,1,0.076923077,0,empty,CD-0722-2
"D12,B5",550871,298667,184191,114476,214585,114430,10,115339,89171,26168,3.40763528,73040,54497,8705,3120,3064,56,653,6,0.069843342,0,hg38,CD-0722-2
"D12,B6",4615,5422,3269,2153,3236,1959,0,1961,1181,780,1.514102564,1163,1362,367,173,171,2,55,1,0.052631579,0,empty,CD-0722-2
"D12,B7",4109,4756,3093,1663,2899,1587,0,1587,1041,546,1.906593407,906,929,168,63,61,2,27,1,0,0,empty,CD-0722-2
"D12,B8",3057,3473,2235,1238,2046,1058,0,1058,722,336,2.148809524,595,922,288,137,134,3,36,1,0,0,empty,CD-0722-2
"D12,B9",5844,6903,4213,2690,4163,2391,0,2396,1488,908,1.63876652,1430,1082,254,92,91,1,42,1,0,0,empty,CD-0722-2
"D12,B10",2793,3199,2002,1197,1987,1102,0,1102,693,409,1.694376528,651,476,147,55,55,0,16,0,0,0,empty,CD-0722-2
"D12,B11",6991,8110,4957,3153,4684,2805,0,2806,1595,1211,1.317093311,1618,215,25,19,19,0,10,0,0.157894737,0,empty,CD-0722-2
"D12,B12",3628,4222,2583,1639,2469,1371,0,1373,893,480,1.860416667,802,1275,272,120,103,17,32,2,0.077669903,0,empty,CD-0722-2
"D12,C1",7565,8517,5589,2928,5057,2749,0,2751,1698,1053,1.612535613,1544,764,74,35,35,0,12,0,0,0,empty,CD-0722-2
"D12,C2",5785,6683,4178,2505,3979,2300,0,2302,1514,788,1.921319797,1353,1490,425,182,181,1,43,1,0.093922652,0,empty,CD-0722-2
"D12,C3",6150,6882,4577,2305,4099,2197,0,2200,1387,813,1.70602706,1190,684,90,35,32,3,13,2,0,0,empty,CD-0722-2
"D12,C4",3795,4358,2864,1494,2577,1351,0,1351,874,477,1.832285115,785,1616,359,140,139,1,33,1,0.158273381,0,empty,CD-0722-2
"D12,C5",5429,6226,4062,2164,3629,1947,3,1954,1277,677,1.886262925,1127,1345,320,127,125,2,34,2,0.144,0,empty,CD-0722-2
"D12,C6",4856,5470,3498,1972,3304,1787,0,1789,1224,565,2.166371681,1047,1371,334,135,133,2,34,1,0.112781955,0,empty,CD-0722-2
"D12,C7",6636,7966,4731,3235,4632,2831,0,2834,1654,1180,1.401694915,1709,344,69,28,28,0,17,0,0.035714286,0,empty,CD-0722-2
"D12,C8",7297,8156,5330,2826,4815,2617,0,2621,1758,863,2.037079954,1482,2349,491,250,244,6,74,3,0.081967213,0,empty,CD-0722-2
"D12,C9",5049,5726,3728,1998,3416,1870,0,1871,1276,595,2.144537815,1082,1448,295,106,105,1,36,1,0,0,empty,CD-0722-2
"D12,C10",5751,6473,4258,2215,3821,2091,0,2093,1318,775,1.700645161,1160,1804,352,150,146,4,46,1,0.034246575,0,empty,CD-0722-2
"D12,C11",373872,414699,284376,130323,239223,114372,0,114465,95328,19137,4.981345038,64819,147390,30967,11016,10850,166,1726,8,0.035483871,0,hg38,CD-0722-2
"D12,C12",7031,8070,5146,2924,4686,2531,0,2534,1644,890,1.847191011,1480,1291,392,146,146,0,47,0,0.006849315,0,empty,CD-0722-2
"D12,D1",5811,6697,4067,2630,4038,2389,0,2393,1414,979,1.44433095,1431,833,179,70,68,2,18,1,0.014705882,0,empty,CD-0722-2
"D12,D2",4877,5322,3592,1730,3253,1681,0,1682,1155,527,2.191650854,921,2473,644,246,243,3,56,1,0.106995885,0,empty,CD-0722-2
"D12,D3",4535,5110,3332,1778,3030,1625,0,1626,1053,573,1.837696335,923,1193,278,123,120,3,36,3,0.091666667,0,empty,CD-0722-2
"D12,D4",3450,3760,2598,1162,2276,1226,0,1226,815,411,1.98296837,659,1096,268,102,101,1,27,1,0.207920792,0,empty,CD-0722-2
"D12,D5",3699,4233,2696,1537,2578,1386,0,1388,886,502,1.764940239,810,1315,155,100,97,3,35,2,0,0,empty,CD-0722-2
"D12,D6",6738,7987,4855,3132,4718,2739,0,2740,1649,1091,1.511457379,1616,2944,447,194,189,5,54,2,0.042328042,0,empty,CD-0722-2
"D12,D7",3539,3970,2622,1348,2349,1218,0,1218,798,420,1.9,685,1588,304,88,88,0,43,0,0.056818182,0,empty,CD-0722-2
"D12,D8",4007,4527,2905,1622,2712,1504,0,1505,991,514,1.928015564,852,1099,332,128,126,2,43,1,0.087301587,0,empty,CD-0722-2
"D12,D9",1934,2170,1419,751,1315,694,0,694,451,243,1.855967078,382,1016,173,72,71,1,29,1,0.042253521,0,empty,CD-0722-2
"D12,D10",4541,5325,3164,2161,3171,1855,0,1856,1217,639,1.904538341,1122,597,56,34,32,2,18,2,0,0,empty,CD-0722-2
"D12,D11",4168,4644,3052,1592,2869,1513,0,1514,948,566,1.674911661,845,2943,696,294,289,5,80,2,0.076124567,0,empty,CD-0722-2
"D12,D12",650391,784550,474220,310330,446551,259924,2,260082,200515,59567,3.366209478,156649,221041,34246,13193,12950,243,2109,8,0.048262548,0,hg38,CD-0722-2
"D12,E1",7032,7997,5018,2979,4783,2756,0,2756,1751,1005,1.742288557,1579,2135,505,188,184,4,56,1,0.059782609,0,empty,CD-0722-2
"D12,E2",4946,5709,3586,2123,3463,1990,0,1991,1250,741,1.686909582,1183,1831,562,201,199,2,46,2,0.050251256,0,empty,CD-0722-2
"D12,E3",3514,3975,2679,1296,2356,1228,0,1229,797,432,1.844907407,661,1924,448,167,164,3,48,1,0.006097561,0,empty,CD-0722-2
"D12,E4",388842,433921,294628,139293,249513,126392,0,126488,97682,28806,3.391029647,71525,61803,10858,4099,3998,101,732,4,0.033266633,0,hg38,CD-0722-2
"D12,E5",4106,4633,3067,1566,2765,1434,0,1434,955,479,1.993736952,785,1090,258,96,95,1,26,1,0.105263158,0,empty,CD-0722-2
"D12,E6",7438,8227,5360,2867,4911,2683,0,2683,1663,1020,1.630392157,1504,2293,628,273,272,1,67,1,0.227941176,0,empty,CD-0722-2
"D12,E7",7278,8215,5448,2767,4833,2600,0,2602,1754,848,2.068396226,1479,2032,498,203,203,0,61,0,0.044334975,0,empty,CD-0722-2
"D12,E8",5159,5895,3836,2059,3523,1867,0,1873,1169,704,1.660511364,1105,2128,511,215,210,5,65,1,0.09047619,0,empty,CD-0722-2
"D12,E9",3586,4074,2666,1408,2446,1310,0,1311,901,410,2.197560976,758,2184,426,202,201,1,57,1,0.044776119,0,empty,CD-0722-2
"D12,E10",3689,4221,2724,1497,2588,1418,0,1418,926,492,1.882113821,824,1555,525,192,191,1,42,1,0,0,empty,CD-0722-2
"D12,E11",4523,5264,3273,1991,3136,1754,0,1754,1177,577,2.039861352,1023,1887,391,151,147,4,40,2,0.068027211,0,empty,CD-0722-2
"D12,E12",5428,6360,3935,2425,3827,2198,0,2201,1437,764,1.880890052,1304,1360,271,132,130,2,49,1,0.115384615,0,empty,CD-0722-2
"D12,F1",6007,6747,4335,2412,4059,2168,0,2171,1359,812,1.67364532,1270,1765,468,184,180,4,57,2,0.022222222,0,empty,CD-0722-2
"D12,F2",4885,5423,3575,1848,3242,1736,0,1741,1161,580,2.001724138,992,2411,468,196,192,4,57,1,0.09375,0,empty,CD-0722-2
"D12,F3",4487,5138,3330,1808,3114,1680,0,1680,1054,626,1.68370607,967,2048,512,213,210,3,57,2,0.066666667,0,empty,CD-0722-2
"D12,F4",6907,7777,5099,2678,4670,2493,1,2496,1700,796,2.135678392,1444,522,108,55,53,2,27,2,0.018867925,0,empty,CD-0722-2
"D12,F5",5356,5976,3940,2036,3579,1836,0,1838,1178,660,1.784848485,1048,1559,345,132,132,0,52,0,0.166666667,0,empty,CD-0722-2
"D12,F6",5613,6460,3996,2464,3741,2124,0,2124,1330,794,1.675062972,1241,2397,553,226,226,0,56,0,0.132743363,0,empty,CD-0722-2
"D12,F7",5734,6300,4244,2056,3909,2085,0,2088,1339,749,1.787716956,1175,997,223,87,86,1,30,1,0.069767442,0,empty,CD-0722-2
"D12,F8",4325,5012,3137,1875,2967,1619,0,1623,1072,551,1.945553539,950,284,34,22,21,1,16,1,0,0,empty,CD-0722-2
"D12,F9",549965,627490,418674,208816,359558,185127,1,185322,140243,45079,3.111049491,105535,132661,18373,7396,7235,161,1237,5,0.037871458,0,hg38,CD-0722-2
"D12,F10",5859,6637,4468,2169,4034,2123,0,2125,1359,766,1.774151436,1176,1613,415,138,137,1,35,1,0.02189781,0,empty,CD-0722-2
"D12,F11",4825,5346,3680,1666,3194,1609,0,1611,1059,552,1.918478261,869,1670,287,109,104,5,34,2,0.163461538,0,empty,CD-0722-2
"D12,F12",5317,6048,3885,2163,3588,1917,0,1918,1257,661,1.901664145,1104,149,18,12,12,0,10,0,0,0,empty,CD-0722-2
"D12,G1",6815,7772,4852,2920,4765,2800,0,2801,1810,991,1.826437941,1635,2514,548,223,220,3,66,2,0.090909091,0,empty,CD-0722-2
"D12,G2",688812,821518,496652,324866,472903,276739,1,276952,224471,52481,4.277186029,166670,71112,10824,4238,4158,80,830,5,0.043290043,0,hg38,CD-0722-2
"D12,G3",6655,7344,4887,2457,4303,2383,0,2384,1448,936,1.547008547,1290,1859,391,163,163,0,52,0,0.024539877,0,empty,CD-0722-2
"D12,G4",11961,13867,8436,5431,8391,5069,0,5072,3074,1998,1.538538539,3020,113,16,13,13,0,8,0,0,0,empty,CD-0722-2
"D12,G5",3699,4505,2661,1844,2656,1491,0,1494,984,510,1.929411765,913,1444,295,119,119,0,47,0,0.092436975,0,empty,CD-0722-2
"D12,G6",2871389,3343820,2162426,1181394,1811751,1036077,6,1036955,845123,191832,4.405537137,599469,22744,3521,1359,1335,24,317,4,0.056179775,0,hg38,CD-0722-2
"D12,G7",4460,5087,3392,1695,3053,1561,0,1563,1036,527,1.965844402,907,1581,290,122,122,0,38,0,0.163934426,0,empty,CD-0722-2
"D12,G8",3183,3460,2400,1060,2169,1147,0,1147,739,408,1.81127451,640,1540,318,127,124,3,43,2,0.080645161,0,empty,CD-0722-2
"D12,G9",3966,4470,2935,1535,2630,1447,0,1447,982,465,2.111827957,793,1626,364,165,165,0,53,0,0.03030303,0,empty,CD-0722-2
"D12,G10",4755,5579,3382,2197,3258,1818,0,1818,1156,662,1.746223565,1079,1604,312,129,129,0,46,0,0.046511628,0,empty,CD-0722-2
"D12,G11",4805,5510,3569,1941,3303,1757,0,1757,1155,602,1.918604651,1016,1244,338,109,109,0,28,0,0.04587156,0,empty,CD-0722-2
"D12,G12",322043,342568,251790,90778,201110,84911,0,85010,71989,13021,5.528684433,45211,146102,32124,11271,11122,149,1814,6,0.030749865,0,hg38,CD-0722-2
"D12,H1",455528,545145,330214,214931,315147,181417,0,181536,145506,36030,4.038467943,110007,48856,10852,4029,3969,60,747,4,0.053665911,0,hg38,CD-0722-2
"D12,H2",4860,5426,3541,1885,3187,1690,0,1693,1081,612,1.766339869,976,2000,693,252,251,1,65,1,0.043824701,0,empty,CD-0722-2
"D12,H3",589383,708787,428992,279795,402706,235602,0,235768,193979,41789,4.641867477,141892,95405,17207,6508,6398,110,1140,8,0.046889653,0,hg38,CD-0722-2
"D12,H4",5955,6940,4359,2581,4104,2250,0,2252,1424,828,1.719806763,1332,132,19,17,17,0,10,0,0,0,empty,CD-0722-2
"D12,H5",7555,8735,5510,3225,5146,2882,0,2882,1941,941,2.062699256,1683,2672,581,188,186,2,60,1,0.02688172,0,empty,CD-0722-2
"D12,H6",4059,4817,2843,1974,2816,1648,0,1648,1075,573,1.87609075,987,1722,325,143,143,0,53,0,0.013986014,0,empty,CD-0722-2
"D12,H7",4449,5056,3214,1842,3045,1663,3,1666,1111,555,2.001801802,983,1545,378,160,159,1,53,1,0.037735849,0,empty,CD-0722-2
"D12,H8",4815,5387,3414,1973,3247,1828,0,1832,1197,635,1.88503937,1039,2284,473,201,200,1,64,1,0.1,0,empty,CD-0722-2
"D12,H9",3774,4226,2827,1399,2554,1321,0,1323,865,458,1.888646288,753,1142,302,130,129,1,38,1,0.031007752,0,empty,CD-0722-2
"D12,H10",3801,4316,2805,1511,2644,1434,0,1436,933,503,1.854870775,840,1580,282,101,96,5,43,2,0.020833333,0,empty,CD-0722-2
"D12,H11",5245,6208,3603,2605,3696,2432,0,2432,1315,1117,1.177260519,1461,41,2,2,2,0,2,0,0,0,empty,CD-0722-2
"D12,H12",3879,4481,2847,1634,2663,1510,0,1510,1000,510,1.960784314,882,1091,197,92,91,1,30,1,0.054945055,0,empty,CD-0722-2
"E1,A1",3771,4373,2680,1693,2603,1509,0,1509,1000,509,1.964636542,852,1202,190,78,77,1,30,1,0.181818182,0,empty,CD-0722-2
"E1,A2",461277,533553,345069,188484,308404,166263,1,166383,131781,34602,3.808479279,96254,119772,20616,8274,8086,188,1342,4,0.059732872,0,hg38,CD-0722-2
"E1,A3",319059,404927,214918,190009,239283,165858,1,165927,118017,47910,2.463306199,104107,4491,506,185,180,5,59,2,0.133333333,0,hg38,CD-0722-2
"E1,A4",5675,6440,4127,2313,3921,2171,0,2171,1349,822,1.641119221,1252,755,96,56,53,3,29,1,0.169811321,0,empty,CD-0722-2
"E1,A5",4900,5504,3592,1912,3243,1718,0,1720,1108,612,1.810457516,968,1840,355,190,185,5,56,2,0.081081081,0,empty,CD-0722-2
"E1,A6",4660,5466,3402,2064,3312,1862,0,1863,1218,645,1.888372093,1085,3025,741,283,280,3,79,1,0.032142857,0,empty,CD-0722-2
"E1,A7",439830,509212,330644,178568,296360,158784,1,158906,128570,30336,4.23819884,91807,143658,21083,8080,7945,135,1336,5,0.060792952,0,hg38,CD-0722-2
"E1,A8",2170,2339,1635,704,1471,784,0,784,526,258,2.03875969,424,2214,591,236,230,6,79,2,0.039130435,0,empty,CD-0722-2
"E1,A9",4090,4826,2999,1827,2926,1655,0,1657,1075,582,1.847079038,983,1838,429,145,139,6,52,1,0.007194245,0,empty,CD-0722-2
"E1,A10",210518,267049,142869,124180,158559,105184,0,105260,82092,23168,3.543335635,66978,3647,1884,695,691,4,150,1,0.05065123,0,hg38,CD-0722-2
"E1,A11",3409,3761,2552,1209,2336,1236,0,1241,812,429,1.892773893,680,1572,315,135,133,2,37,1,0.030075188,0,empty,CD-0722-2
"E1,A12",5191,5791,3863,1928,3403,1797,0,1799,1191,608,1.958881579,999,3210,822,322,316,6,106,2,0.066455696,0,empty,CD-0722-2
"E1,B1",535103,608630,408457,200173,350056,178089,0,178233,137843,40390,3.412800198,101772,105204,16725,6151,6019,132,1039,5,0.05682007,0,hg38,CD-0722-2
"E1,B2",4697,5378,3171,2207,3283,2025,0,2025,1321,704,1.876420455,1222,826,107,54,51,3,22,1,0.392156863,0,empty,CD-0722-2
"E1,B3",3848,4450,2723,1727,2644,1494,0,1494,999,495,2.018181818,867,1606,390,179,178,1,60,1,0.157303371,0,empty,CD-0722-2
"E1,B4",4132,4920,2906,2014,3003,1828,0,1829,1159,670,1.729850746,1097,1148,137,55,53,2,22,1,0.037735849,0,empty,CD-0722-2
"E1,B5",4751,3154,1808,1346,2179,1268,0,1287,828,459,1.803921569,833,1035,344,123,122,1,38,1,0.196721311,0,empty,CD-0722-2
"E1,B6",4738,5434,3373,2061,3261,1903,0,1903,1174,729,1.61042524,1098,1699,459,184,182,2,40,2,0.291208791,0,empty,CD-0722-2
"E1,B7",4200,5109,3199,1910,3071,1686,0,1688,1153,535,2.155140187,965,1521,348,134,131,3,44,2,0.083969466,0,empty,CD-0722-2
"E1,B8",3186,3760,2348,1412,2185,1160,0,1162,770,392,1.964285714,671,958,144,74,73,1,33,1,0.109589041,0,empty,CD-0722-2
"E1,B9",6043,6936,4376,2560,4202,2412,0,2412,1514,898,1.68596882,1417,1131,228,100,97,3,53,2,0.041237113,0,empty,CD-0722-2
"E1,B10",2936,3285,2059,1226,2037,1144,0,1145,703,442,1.590497738,675,378,52,31,31,0,15,0,0,0,empty,CD-0722-2
"E1,B11",6821,7889,4883,3006,4738,2815,0,2819,1578,1241,1.271555197,1583,305,27,16,16,0,11,0,0,0,empty,CD-0722-2
"E1,B12",3564,4084,2571,1513,2528,1422,0,1422,934,488,1.913934426,831,1952,486,179,176,3,58,1,0.068181818,0,empty,CD-0722-2
"E1,C1",951654,1167673,657626,510047,677927,459056,2,459333,341757,117576,2.906690141,276805,7557,765,268,253,15,89,2,0.059288538,0,hg38,CD-0722-2
"E1,C2",5998,6880,4344,2536,4088,2332,0,2332,1473,859,1.714784633,1327,1944,457,173,171,2,50,1,0.076023392,0,empty,CD-0722-2
"E1,C3",6444,7127,4728,2399,4375,2391,0,2391,1520,871,1.745120551,1304,1044,145,77,74,3,27,2,0.108108108,0,empty,CD-0722-2
"E1,C4",3776,4138,2797,1341,2599,1333,0,1333,842,491,1.714867617,749,1917,426,196,195,1,57,1,0.066666667,0,empty,CD-0722-2
"E1,C5",5429,6359,3958,2401,3768,2118,0,2119,1358,761,1.784494087,1228,1556,389,140,140,0,41,0,0.064285714,0,empty,CD-0722-2
"E1,C6",4554,5195,3312,1883,3202,1789,0,1789,1138,651,1.748079877,1036,1379,316,140,139,1,44,1,0.021582734,0,empty,CD-0722-2
"E1,C7",6766,7822,4799,3023,4656,2836,0,2837,1727,1110,1.555855856,1636,327,104,44,44,0,23,0,0,0,empty,CD-0722-2
"E1,C8",484887,563289,359647,203642,326301,179582,0,179706,142353,37353,3.811019195,104860,240494,38438,14757,14501,256,2231,10,0.059375216,0,hg38,CD-0722-2
"E1,C9",4810,5366,3590,1776,3324,1802,0,1810,1188,622,1.909967846,1031,1779,437,192,192,0,44,0,0.171875,0,empty,CD-0722-2
"E1,C10",5480,6168,4091,2077,3681,1991,0,1993,1309,684,1.91374269,1088,2546,579,232,228,4,67,2,0.061403509,0,empty,CD-0722-2
"E1,C11",4700,5140,3467,1673,3154,1671,1,1674,1032,642,1.607476636,913,1966,351,156,155,1,51,1,0.025806452,0,empty,CD-0722-2
"E1,C12",780636,983510,526337,457173,571632,397114,1,397354,281533,115821,2.430759534,249981,5067,988,312,308,4,90,2,0.172077922,0,hg38,CD-0722-2
"E1,D1",6496,7340,4607,2733,4430,2649,0,2650,1565,1085,1.442396313,1494,768,114,58,57,1,16,1,0.263157895,0,empty,CD-0722-2
"E1,D2",490789,565210,370649,194561,326575,173899,1,174034,140463,33571,4.184057669,99203,217069,44303,16903,16711,192,2382,5,0.072945964,0,hg38,CD-0722-2
"E1,D3",4602,5326,3328,1998,3166,1740,0,1742,1120,622,1.800643087,1021,1682,384,156,156,0,51,0,0.032051282,0,empty,CD-0722-2
"E1,D4",358316,403310,274243,129067,236004,119761,0,119859,94245,25614,3.679433123,67619,40418,5771,2251,2204,47,444,2,0.068965517,0,hg38,CD-0722-2
"E1,D5",4066,4611,2930,1681,2805,1569,0,1571,1057,514,2.056420233,888,1399,315,152,152,0,48,0,0.197368421,0,empty,CD-0722-2
"E1,D6",6204,7196,4291,2905,4374,2664,0,2673,1559,1114,1.3994614,1588,1687,374,154,147,7,53,1,0.074829932,0,empty,CD-0722-2
"E1,D7",3670,4103,2732,1371,2421,1273,0,1275,846,429,1.972027972,716,2225,391,149,149,0,61,0,0.080536913,0,empty,CD-0722-2
"E1,D8",4345,4976,3167,1809,2966,1637,0,1637,1116,521,2.142034549,932,1495,414,122,121,1,49,1,0.016528926,0,empty,CD-0722-2
"E1,D9",2229,2439,1634,805,1465,756,0,757,509,248,2.052419355,421,1243,249,132,132,0,42,0,0.090909091,0,empty,CD-0722-2
"E1,D10",4067,4636,2881,1755,2845,1620,0,1624,1043,581,1.795180723,986,1193,261,113,112,1,39,1,0.080357143,0,empty,CD-0722-2
"E1,D11",4480,4993,3307,1686,3045,1613,0,1613,1038,575,1.805217391,907,2800,822,343,342,1,81,1,0.081871345,0,empty,CD-0722-2
"E1,D12",5688,6588,4233,2355,3994,2152,0,2152,1423,729,1.951989026,1242,3663,988,421,415,6,121,2,0.043373494,0,empty,CD-0722-2
"E1,E1",7446,8314,5375,2939,5081,2879,0,2886,1791,1095,1.635616438,1662,2720,675,309,305,4,77,1,0.026229508,0,empty,CD-0722-2
"E1,E2",5147,6024,3689,2335,3563,1998,0,2002,1287,715,1.8,1200,1783,461,169,169,0,52,0,0.071005917,0,empty,CD-0722-2
"E1,E3",3173,3539,2307,1232,2187,1157,0,1157,736,421,1.748218527,677,2332,608,230,228,2,75,2,0.048245614,0,empty,CD-0722-2
"E1,E4",4828,5493,3534,1959,3346,1862,0,1864,1175,689,1.705370102,1095,2192,429,189,187,2,70,2,0.010695187,0,empty,CD-0722-2
"E1,E5",4303,4758,3206,1552,2912,1524,0,1526,1013,513,1.974658869,848,1683,404,187,187,0,53,0,0.085561497,0,empty,CD-0722-2
"E1,E6",7951,9090,5884,3206,5318,2933,0,2938,1861,1077,1.727948004,1691,3702,972,370,368,2,107,2,0.035326087,0,empty,CD-0722-2
"E1,E7",9381,10506,7119,3387,6170,3211,0,3211,2203,1008,2.185515873,1780,5086,1112,452,449,3,126,1,0.051224944,0,empty,CD-0722-2
"E1,E8",5562,6326,4145,2181,3777,1999,0,2003,1318,685,1.924087591,1137,2927,547,229,228,1,74,1,0.074561404,0,empty,CD-0722-2
"E1,E9",3908,4610,2819,1791,2761,1558,0,1559,1045,514,2.03307393,917,2787,686,274,271,3,84,2,0.044280443,0,empty,CD-0722-2
"E1,E10",3926,4573,2916,1657,2767,1543,0,1543,1050,493,2.129817444,901,1439,400,164,163,1,52,1,0.049079755,0,empty,CD-0722-2
"E1,E11",5030,5817,3648,2169,3497,1988,0,1988,1257,731,1.719562244,1154,2063,421,166,166,0,44,0,0.012048193,0,empty,CD-0722-2
"E1,E12",5439,6464,3954,2510,3899,2167,3,2170,1347,823,1.636695018,1305,1736,389,184,182,2,55,2,0.21978022,0,empty,CD-0722-2
"E1,F1",5908,6584,4411,2173,3896,2104,0,2106,1397,709,1.970380818,1128,2070,460,198,198,0,65,0,0.060606061,0,empty,CD-0722-2
"E1,F2",100708,122229,74405,47824,71417,41138,0,41172,33401,7771,4.298159825,24780,4539,908,340,336,4,116,2,0.038690476,0,empty,CD-0722-2
"E1,F3",10240,12023,7610,4413,7076,3997,0,4000,2677,1323,2.023431595,2350,3193,861,321,319,2,82,2,0.103448276,0,empty,CD-0722-2
"E1,F4",6633,7209,4897,2312,4470,2353,0,2354,1545,809,1.909765142,1310,902,151,68,65,3,36,1,0.153846154,0,empty,CD-0722-2
"E1,F5",5388,6086,3976,2110,3600,1934,0,1938,1222,716,1.706703911,1083,2369,622,230,229,1,61,1,0.034934498,0,empty,CD-0722-2
"E1,F6",5635,6466,3979,2487,3876,2264,0,2266,1449,817,1.773561812,1334,2637,699,288,283,5,83,1,0.070671378,0,empty,CD-0722-2
"E1,F7",6244,7171,4553,2618,4310,2367,0,2372,1595,777,2.052767053,1391,1292,298,112,110,2,37,2,0.1,0,empty,CD-0722-2
"E1,F8",5158,6026,3850,2176,3658,2022,0,2022,1336,686,1.947521866,1148,474,72,47,46,1,28,1,0.043478261,0,empty,CD-0722-2
"E1,F9",5009,5632,3785,1847,3447,1795,0,1797,1167,630,1.852380952,1020,3486,993,373,367,6,91,2,0.171662125,0,empty,CD-0722-2
"E1,F10",6064,6679,4609,2070,4043,2109,0,2111,1345,766,1.755874674,1147,1521,395,170,170,0,51,0,0.158823529,0,empty,CD-0722-2
"E1,F11",4904,5373,3688,1685,3294,1698,0,1700,1098,602,1.823920266,922,1727,389,164,163,1,47,1,0.17791411,0,empty,CD-0722-2
"E1,F12",5435,6006,4072,1934,3575,1904,0,1904,1234,670,1.841791045,1034,172,31,17,17,0,7,0,0.294117647,0,empty,CD-0722-2
"E1,G1",5638,6402,4199,2203,3787,2039,0,2041,1356,685,1.979562044,1135,2865,826,336,335,1,84,1,0.110447761,0,empty,CD-0722-2
"E1,G2",3424,3974,2304,1670,2455,1450,0,1452,945,507,1.863905325,929,643,215,93,92,1,35,1,0.097826087,0,empty,CD-0722-2
"E1,G3",6494,7281,4812,2469,4364,2461,0,2463,1456,1007,1.445878848,1358,2613,605,246,246,0,70,0,0.004065041,0,empty,CD-0722-2
"E1,G4",2019473,2341724,1515851,825873,1304953,728579,5,729190,595192,133998,4.441797639,422521,8268,980,455,447,8,92,3,0.06935123,0,hg38,CD-0722-2
"E1,G5",3889,4473,2837,1636,2669,1482,0,1482,943,539,1.749536178,849,1472,309,131,129,2,49,1,0.069767442,0,empty,CD-0722-2
"E1,G6",5736,6394,4212,2182,3923,2109,0,2115,1416,699,2.025751073,1209,251,64,19,19,0,9,0,0,0,empty,CD-0722-2
"E1,G7",4405,4980,3323,1657,3044,1581,0,1583,1034,549,1.883424408,882,2859,650,254,254,0,65,0,0.106299213,0,empty,CD-0722-2
"E1,G8",3415,3728,2540,1188,2284,1172,0,1172,793,379,2.092348285,653,1816,404,156,152,4,58,1,0.197368421,0,empty,CD-0722-2
"E1,G9",4045,4507,2911,1596,2702,1483,0,1490,930,560,1.660714286,848,2691,676,263,260,3,81,2,0.007692308,0,empty,CD-0722-2
"E1,G10",377432,475708,255108,220600,280480,194673,0,194782,139680,55102,2.534935211,120411,8529,1030,369,355,14,136,3,0.16056338,0,hg38,CD-0722-2
"E1,G11",4642,5333,3370,1963,3225,1788,0,1788,1183,605,1.955371901,1052,1368,296,132,128,4,48,1,0.015625,0,empty,CD-0722-2
"E1,G12",4231,4784,3079,1705,2904,1600,0,1602,1022,580,1.762068966,912,2716,623,263,262,1,89,1,0.057251908,0,empty,CD-0722-2
"E1,H1",4829,5302,3562,1740,3258,1696,0,1696,1166,530,2.2,1009,1244,265,99,99,0,39,0,0.04040404,0,empty,CD-0722-2
"E1,H2",568837,675673,416500,259173,391364,224776,3,224990,176340,48650,3.624665982,135219,198273,20882,8327,8065,262,1401,6,0.103285803,0,hg38,CD-0722-2
"E1,H3",4325,4938,3102,1836,2993,1680,0,1680,1105,575,1.92173913,1010,1993,363,149,148,1,58,1,0.033783784,0,empty,CD-0722-2
"E1,H4",5981,6881,4402,2479,4052,2247,0,2247,1517,730,2.078082192,1294,147,17,13,13,0,12,0,0.153846154,0,empty,CD-0722-2
"E1,H5",670779,795159,494375,300784,454435,256423,2,256649,202839,53810,3.769540978,153403,112112,20223,7882,7750,132,1312,5,0.051741935,0,hg38,CD-0722-2
"E1,H6",3846,4370,2823,1547,2696,1495,0,1497,993,504,1.970238095,868,2282,600,215,201,14,69,2,0.124378109,0,empty,CD-0722-2
"E1,H7",4692,5252,3373,1879,3176,1688,0,1688,1141,547,2.085923218,1006,2415,642,298,294,4,88,2,0.040816327,0,empty,CD-0722-2
"E1,H8",996427,1224619,712955,511664,701406,429835,0,430099,343228,86871,3.951007816,264719,136824,29300,11245,11085,160,1760,5,0.043662607,0,hg38,CD-0722-2
"E1,H9",4439,4951,3314,1637,2985,1550,0,1550,1063,487,2.18275154,868,1279,215,73,72,1,31,1,0.027777778,0,empty,CD-0722-2
"E1,H10",5843,6544,4340,2204,3976,2123,0,2123,1518,605,2.509090909,1197,1646,279,126,126,0,53,0,0.047619048,0,empty,CD-0722-2
"E1,H11",5276,6238,3564,2674,3807,2498,0,2498,1359,1139,1.193151888,1532,47,6,4,4,0,2,0,0,0,empty,CD-0722-2
"E1,H12",4230,4991,3049,1942,2957,1763,0,1765,1121,644,1.74068323,1101,1304,282,132,132,0,32,0,0.090909091,0,empty,CD-0722-2
"E2,A1",3732,4358,2723,1635,2621,1482,0,1485,945,540,1.75,875,1526,254,106,104,2,36,1,0.269230769,0,empty,CD-0722-2
"E2,A2",5684,6340,4148,2192,3757,2102,0,2103,1328,775,1.713548387,1147,1842,440,174,174,0,44,0,0.24137931,0,empty,CD-0722-2
"E2,A3",3701,4096,2720,1376,2425,1299,0,1299,861,438,1.965753425,696,960,242,116,113,3,43,1,0.008849558,0,empty,CD-0722-2
"E2,A4",6580,7267,4766,2501,4325,2402,0,2402,1498,904,1.657079646,1365,776,242,91,91,0,28,0,0.197802198,0,empty,CD-0722-2
"E2,A5",5030,5728,3689,2039,3470,1916,0,1919,1188,731,1.625170999,1083,2284,442,205,202,3,48,2,0.094059406,0,empty,CD-0722-2
"E2,A6",587536,706114,437126,268988,408017,232111,3,232317,182225,50092,3.637806436,139235,154040,21101,8131,7949,182,1491,7,0.022644358,0,hg38,CD-0722-2
"E2,A7",3959,4826,2821,2005,2912,1723,1,1730,1018,712,1.429775281,1081,1466,371,164,164,0,44,0,0.024390244,0,empty,CD-0722-2
"E2,A8",2452,2704,1784,920,1653,918,0,918,606,312,1.942307692,522,2002,500,223,220,3,61,2,0.181818182,0,empty,CD-0722-2
"E2,A9",3970,4627,2901,1726,2766,1490,0,1493,970,523,1.854684512,882,1551,344,158,157,1,49,1,0.152866242,0,empty,CD-0722-2
"E2,A10",370718,439487,275223,164264,254504,143650,0,143777,112141,31636,3.544727526,84589,22151,3436,1323,1287,36,290,2,0.042735043,0,hg38,CD-0722-2
"E2,A11",3560,4000,2761,1239,2465,1280,2,1284,874,410,2.131707317,682,2334,450,185,184,1,59,1,0.081521739,0,empty,CD-0722-2
"E2,A12",544698,624851,408408,216443,355083,190588,2,190747,153001,37746,4.053436126,109141,368942,46687,18643,18171,472,2584,10,0.053216664,0,hg38,CD-0722-2
"E2,B1",4195,4709,2998,1711,2879,1638,0,1643,990,653,1.516079632,956,1110,248,100,100,0,34,0,0.02,0,empty,CD-0722-2
"E2,B2",554843,622854,400529,222325,360003,192050,0,192213,148918,43295,3.439611964,113323,27648,2702,1018,988,30,262,2,0.024291498,0,hg38,CD-0722-2
"E2,B3",4409,5138,3151,1987,3005,1654,0,1657,1057,600,1.761666667,1009,1297,217,100,99,1,37,1,0.03030303,0,empty,CD-0722-2
"E2,B4",4336,5212,3033,2179,3146,1922,0,1925,1170,755,1.549668874,1158,1562,422,155,153,2,41,1,0.039215686,0,empty,CD-0722-2
"E2,B5",4348,2603,1617,986,1891,1054,0,1061,713,348,2.048850575,651,1369,259,100,100,0,29,0,0.17,0,empty,CD-0722-2
"E2,B6",4542,5261,3252,2009,3152,1841,0,1841,1137,704,1.615056818,1068,1482,381,152,151,1,45,1,0.072847682,0,empty,CD-0722-2
"E2,B7",4165,4759,3082,1677,2969,1591,0,1594,1048,546,1.919413919,903,908,237,114,112,2,40,2,0.151785714,0,empty,CD-0722-2
"E2,B8",3289,3963,2416,1547,2423,1346,0,1350,908,442,2.054298643,797,1372,276,120,120,0,29,0,0.058333333,0,empty,CD-0722-2
"E2,B9",457593,521403,340698,180705,297946,158313,1,158468,122613,35855,3.41969042,91421,78984,10047,3901,3773,128,767,3,0.042671614,0,hg38,CD-0722-2
"E2,B10",2926,3305,1980,1325,2041,1160,0,1161,733,428,1.712616822,695,632,171,50,50,0,17,0,0.02,0,empty,CD-0722-2
"E2,B11",11288,12825,8180,4645,7434,4198,0,4205,2423,1782,1.359708193,2426,197,16,12,12,0,11,0,0,0,empty,CD-0722-2
"E2,B12",3869,4295,2866,1429,2574,1391,1,1394,910,484,1.880165289,747,7092,400,178,166,12,58,3,0.018072289,0,empty,CD-0722-2
"E2,C1",8081,8954,6018,2936,5313,2854,0,2858,1769,1089,1.624426079,1590,1034,195,98,93,5,31,2,0.075268817,0,empty,CD-0722-2
"E2,C2",6513,7424,4644,2780,4415,2515,0,2518,1630,888,1.835585586,1497,1817,506,200,196,4,65,2,0.102040816,0,empty,CD-0722-2
"E2,C3",6497,7339,4812,2527,4341,2358,0,2359,1505,854,1.762295082,1290,794,171,76,76,0,31,0,0.026315789,0,empty,CD-0722-2
"E2,C4",3953,4370,2938,1432,2704,1411,0,1411,931,480,1.939583333,807,1450,377,157,156,1,47,1,0.064102564,0,empty,CD-0722-2
"E2,C5",7254,8328,5292,3036,4917,2713,0,2715,1838,877,2.095781072,1545,1852,437,206,204,2,58,1,0.181372549,0,empty,CD-0722-2
"E2,C6",4737,5676,3447,2229,3444,1965,0,1968,1257,711,1.767932489,1191,2078,519,166,163,3,52,2,0.098159509,0,empty,CD-0722-2
"E2,C7",6984,8273,4921,3352,4954,3044,1,3047,1778,1269,1.401103231,1855,308,34,20,19,1,11,1,0,0,empty,CD-0722-2
"E2,C8",7425,8205,5452,2753,4933,2736,0,2736,1794,942,1.904458599,1498,3281,621,220,218,2,84,1,0.146788991,0,empty,CD-0722-2
"E2,C9",4943,5931,3606,2325,3568,1985,0,1985,1371,614,2.232899023,1210,1424,200,100,92,8,38,2,0.043478261,0,empty,CD-0722-2
"E2,C10",5836,6568,4360,2208,3907,2063,0,2069,1364,705,1.934751773,1162,2396,537,189,188,1,59,1,0.10106383,0,empty,CD-0722-2
"E2,C11",5223,5780,3810,1970,3434,1876,0,1877,1240,637,1.946624804,1067,2489,427,171,169,2,59,1,0,0,empty,CD-0722-2
"E2,C12",6793,7435,4955,2480,4461,2302,0,2309,1520,789,1.926489227,1255,8379,661,275,260,15,73,2,0.038461538,0,empty,CD-0722-2
"E2,D1",6320,7399,4426,2973,4368,2625,0,2628,1542,1086,1.419889503,1583,1059,186,65,65,0,24,0,0.061538462,0,empty,CD-0722-2
"E2,D2",1017079,1163083,765066,398017,662789,359531,2,359848,290172,69676,4.16459039,204356,320412,48305,17583,17179,404,2550,8,0.047325223,0,hg38,CD-0722-2
"E2,D3",4516,5304,3188,2116,3237,1876,0,1881,1230,651,1.889400922,1149,1864,371,133,132,1,60,1,0.007575758,0,empty,CD-0722-2
"E2,D4",3518,3993,2609,1384,2375,1330,0,1330,888,442,2.009049774,762,1365,284,133,133,0,56,0,0.097744361,0,empty,CD-0722-2
"E2,D5",4170,4682,3039,1643,2790,1500,0,1502,988,514,1.922178988,876,1836,347,141,139,2,51,2,0.057553957,0,empty,CD-0722-2
"E2,D6",750044,904247,541090,363157,515033,304906,2,305154,244190,60964,4.005478643,185270,207367,30359,11785,11552,233,1879,8,0.062067175,0,hg38,CD-0722-2
"E2,D7",3439,3804,2607,1197,2343,1216,0,1216,795,421,1.888361045,677,2098,473,209,206,3,65,2,0.087378641,0,empty,CD-0722-2
"E2,D8",4231,4740,3035,1705,2842,1589,0,1590,991,599,1.65442404,936,1325,266,95,94,1,49,1,0,0,empty,CD-0722-2
"E2,D9",2211,2448,1624,824,1489,768,0,770,504,266,1.894736842,448,1501,330,158,155,3,49,1,0.025806452,0,empty,CD-0722-2
"E2,D10",4789,5454,3369,2085,3237,1829,0,1829,1204,625,1.9264,1056,989,200,87,87,0,28,0,0.126436782,0,empty,CD-0722-2
"E2,D11",398538,442175,307383,134792,254665,125509,1,125619,94270,31349,3.007113465,69455,41179,6289,2508,2452,56,533,3,0.033442088,0,hg38,CD-0722-2
"E2,D12",6227,7048,4546,2502,4213,2300,0,2303,1531,772,1.983160622,1292,10567,1335,561,551,10,142,2,0.070780399,0,empty,CD-0722-2
"E2,E1",7512,8387,5386,3001,4955,2786,0,2790,1692,1098,1.540983607,1572,2202,477,193,190,3,65,2,0.031578947,0,empty,CD-0722-2
"E2,E2",5132,5750,3680,2070,3508,1916,1,1924,1173,751,1.561917443,1148,1948,414,190,188,2,50,1,0.127659574,0,empty,CD-0722-2
"E2,E3",3662,4174,2788,1386,2474,1312,0,1312,870,442,1.968325792,719,1963,421,188,184,4,82,1,0.092391304,0,empty,CD-0722-2
"E2,E4",4840,5367,3584,1783,3180,1690,0,1692,1067,625,1.7072,935,2240,553,252,251,1,64,1,0.09561753,0,empty,CD-0722-2
"E2,E5",4326,4756,3286,1470,2824,1430,1,1431,914,517,1.767891683,753,1389,236,103,102,1,38,1,0.107843137,0,empty,CD-0722-2
"E2,E6",7745,8884,5674,3210,5253,2890,0,2890,1878,1012,1.855731225,1681,3065,683,272,271,1,93,1,0.103321033,0,empty,CD-0722-2
"E2,E7",11132,12208,8503,3705,7020,3433,0,3434,2369,1065,2.224413146,1827,4938,1222,485,482,3,123,2,0.047717842,0,empty,CD-0722-2
"E2,E8",5563,6441,4149,2292,3882,2036,0,2040,1288,752,1.712765957,1188,2428,469,199,198,1,53,1,0.237373737,0,empty,CD-0722-2
"E2,E9",3503,3909,2550,1359,2307,1251,0,1251,835,416,2.007211538,696,2375,514,218,214,4,66,2,0.093457944,0,empty,CD-0722-2
"E2,E10",4042,4587,3011,1576,2703,1423,0,1423,958,465,2.060215054,790,1429,320,154,154,0,55,0,0.025974026,0,empty,CD-0722-2
"E2,E11",484557,542749,370620,172129,314684,158903,0,159049,125995,33054,3.811792824,89500,64765,12244,4795,4700,95,804,4,0.026595745,0,hg38,CD-0722-2
"E2,E12",1181260,1424687,857675,567012,820138,513837,0,514207,366881,147326,2.490266484,310564,14100,1257,522,501,21,181,5,0.191616766,0,hg38,CD-0722-2
"E2,F1",6238,6929,4501,2428,4217,2344,0,2348,1462,886,1.650112867,1319,2720,685,244,243,1,85,1,0.04526749,0,empty,CD-0722-2
"E2,F2",4995,5638,3546,2092,3332,1849,0,1852,1218,634,1.921135647,1055,2540,720,286,284,2,82,1,0.035211268,0,empty,CD-0722-2
"E2,F3",433384,486303,330180,156123,281716,141691,0,141839,109933,31906,3.445527487,80827,86008,18768,7208,7103,105,1097,5,0.043643531,0,hg38,CD-0722-2
"E2,F4",7130,7979,5173,2806,4743,2556,1,2559,1687,872,1.934633028,1485,881,130,64,64,0,27,0,0.0625,0,empty,CD-0722-2
"E2,F5",5912,6223,4365,1858,3798,1937,0,1937,1232,705,1.74751773,1031,2376,604,215,212,3,78,2,0.014150943,0,empty,CD-0722-2
"E2,F6",1117003,1386339,786286,600053,792635,508808,0,509155,382582,126573,3.022619358,315482,82755,25357,9704,9629,75,1513,4,0.079759061,0,hg38,CD-0722-2
"E2,F7",6479,7416,4751,2665,4510,2503,0,2505,1620,885,1.830508475,1451,1397,316,127,124,3,36,1,0.169354839,0,empty,CD-0722-2
"E2,F8",683092,809495,506328,303167,463103,261025,1,261225,204496,56729,3.604787675,154364,6852,945,368,365,3,112,1,0.101369863,0,hg38,CD-0722-2
"E2,F9",5168,5824,3803,2021,3562,1884,0,1887,1220,667,1.829085457,1077,2833,484,232,228,4,75,1,0.096491228,0,empty,CD-0722-2
"E2,F10",1219996,1355506,935561,419945,761975,388649,1,388996,316930,72066,4.397774262,217329,68564,12055,4370,4304,66,871,5,0.023931227,0,hg38,CD-0722-2
"E2,F11",5253,5937,3927,2010,3472,1854,0,1856,1249,607,2.057660626,1016,2205,237,94,91,3,43,2,0.010989011,0,empty,CD-0722-2
"E2,F12",5603,6583,4106,2477,3875,2149,0,2157,1350,807,1.672862454,1268,530,61,37,37,0,15,0,0,0,empty,CD-0722-2
"E2,G1",5895,6540,4367,2173,3964,2054,0,2060,1324,736,1.798913043,1121,3444,888,326,324,2,106,1,0.040123457,0,empty,CD-0722-2
"E2,G2",3764,4139,2587,1552,2498,1418,0,1418,920,498,1.847389558,818,677,111,72,71,1,37,1,0.126760563,0,empty,CD-0722-2
"E2,G3",7004,7951,5181,2770,4693,2631,0,2638,1566,1072,1.460820896,1419,2335,713,252,248,4,69,1,0.016129032,0,empty,CD-0722-2
"E2,G4",1021492,1194834,770512,424322,674041,379047,4,379425,305443,73982,4.128612365,218360,3192,390,175,171,4,41,1,0.058479532,0,hg38,CD-0722-2
"E2,G5",3859,4379,2811,1568,2642,1508,0,1509,942,567,1.661375661,851,1575,302,132,127,5,59,2,0,0,empty,CD-0722-2
"E2,G6",659519,733320,511189,222131,416536,203203,0,203404,154592,48812,3.16709006,112559,11846,1468,590,580,10,129,2,0.037931034,0,hg38,CD-0722-2
"E2,G7",4760,5274,3563,1711,3135,1619,0,1621,1057,564,1.874113475,901,2307,607,232,232,0,60,0,0.051724138,0,empty,CD-0722-2
"E2,G8",3439,3853,2533,1320,2266,1229,0,1229,760,469,1.620469083,686,2057,554,225,225,0,59,0,0.097777778,0,empty,CD-0722-2
"E2,G9",4118,4604,3048,1556,2784,1491,0,1493,977,516,1.893410853,850,2959,681,294,291,3,73,2,0.054982818,0,empty,CD-0722-2
"E2,G10",4974,5935,3592,2343,3534,2014,0,2015,1271,744,1.708333333,1195,2462,714,281,275,6,71,2,0.203636364,0,empty,CD-0722-2
"E2,G11",4950,5474,3633,1841,3261,1712,0,1712,1127,585,1.926495726,952,1485,397,162,159,3,52,2,0.056603774,0,empty,CD-0722-2
"E2,G12",4136,4825,3004,1821,3041,1765,0,1766,1181,585,2.018803419,1066,7879,1065,399,394,5,123,1,0.063451777,0,empty,CD-0722-2
"E2,H1",4523,4952,3318,1634,2932,1541,0,1542,1035,507,2.041420118,848,1429,219,119,117,2,44,1,0.008547009,0,empty,CD-0722-2
"E2,H2",5604,6356,4180,2176,3789,2113,0,2115,1336,779,1.715019255,1214,2093,507,192,190,2,62,2,0.042105263,0,empty,CD-0722-2
"E2,H3",3965,4748,2874,1874,2750,1575,4,1579,1051,528,1.990530303,919,1490,343,156,156,0,60,0,0.032051282,0,empty,CD-0722-2
"E2,H4",6005,6770,4544,2226,3983,2121,0,2123,1387,736,1.88451087,1177,202,25,17,17,0,14,0,0,0,empty,CD-0722-2
"E2,H5",6615,7497,4830,2667,4410,2346,0,2346,1542,804,1.917910448,1351,3478,725,292,288,4,90,2,0.013888889,0,empty,CD-0722-2
"E2,H6",4042,4654,2954,1700,2698,1493,0,1494,974,520,1.873076923,836,1936,486,202,202,0,66,0,0.168316832,0,empty,CD-0722-2
"E2,H7",4689,5422,3423,1999,3167,1715,0,1717,1116,601,1.856905158,998,2469,565,189,187,2,75,1,0.13368984,0,empty,CD-0722-2
"E2,H8",5197,5781,3717,2064,3498,1976,0,1978,1283,695,1.846043165,1116,2050,465,195,195,0,74,0,0.056410256,0,empty,CD-0722-2
"E2,H9",4221,4666,3202,1464,2753,1371,0,1374,950,424,2.240566038,743,1458,367,172,171,1,43,1,0.233918129,0,empty,CD-0722-2
"E2,H10",4740,5448,3493,1955,3283,1799,0,1799,1197,602,1.988372093,1030,1556,241,112,111,1,49,1,0.072072072,0,empty,CD-0722-2
"E2,H11",5372,6562,3547,3015,3844,2551,0,2554,1346,1208,1.114238411,1599,138,24,11,11,0,8,0,0.090909091,0,empty,CD-0722-2
"E2,H12",516917,627125,358134,268991,365453,239843,0,239996,173583,66413,2.613690091,146509,8261,690,313,295,18,84,3,0.13220339,0,hg38,CD-0722-2
"E3,A1",3454,3872,2497,1375,2424,1382,0,1384,903,481,1.877338877,775,1350,250,76,76,0,36,0,0.184210526,0,empty,CD-0722-2
"E3,A2",5346,5965,3865,2100,3544,1925,0,1925,1243,682,1.822580645,1098,2922,602,250,246,4,67,2,0.215447154,0,empty,CD-0722-2
"E3,A3",3199,3623,2288,1335,2231,1230,0,1234,784,450,1.742222222,744,1686,391,157,156,1,46,1,0.019230769,0,empty,CD-0722-2
"E3,A4",5693,6494,4205,2289,3860,2076,0,2078,1338,740,1.808108108,1169,1239,263,106,105,1,31,1,0.095238095,0,empty,CD-0722-2
"E3,A5",4600,5146,3438,1708,3080,1659,0,1661,1065,596,1.786912752,920,2386,554,190,186,4,60,2,0.086021505,0,empty,CD-0722-2
"E3,A6",3754,4486,2741,1745,2736,1587,0,1587,1031,556,1.854316547,951,3503,886,393,388,5,122,2,0.103092784,0,empty,CD-0722-2
"E3,A7",3329,3917,2445,1472,2343,1348,0,1348,829,519,1.597302505,783,1743,405,169,167,2,51,2,0.035928144,0,empty,CD-0722-2
"E3,A8",2034,2462,1524,938,1482,814,0,814,558,256,2.1796875,469,2206,501,229,224,5,59,2,0.044642857,0,empty,CD-0722-2
"E3,A9",3482,4152,2545,1607,2531,1362,0,1364,879,485,1.812371134,856,2418,541,239,238,1,69,1,0.012605042,0,empty,CD-0722-2
"E3,A10",4191,4652,3152,1500,2806,1486,0,1487,923,564,1.636524823,824,547,84,29,28,1,15,1,0.25,0,empty,CD-0722-2
"E3,A11",2847,3199,2179,1020,1970,991,0,995,663,332,1.996987952,551,3101,579,211,206,5,54,2,0.160194175,0,empty,CD-0722-2
"E3,A12",4516,5214,3348,1866,3052,1622,0,1623,1067,556,1.919064748,906,14111,1756,742,730,12,181,3,0.030136986,0,empty,CD-0722-2
"E3,B1",402180,442682,314129,128553,255611,120751,1,120842,97767,23075,4.236923077,66036,35392,6912,2520,2497,23,516,5,0.026031237,0,hg38,CD-0722-2
"E3,B2",718518,815091,517290,297801,478317,271137,4,271350,198277,73073,2.713409878,160310,25016,3892,1530,1492,38,322,4,0.018096515,0,hg38,CD-0722-2
"E3,B3",4679,5542,3404,2138,3448,1923,0,1923,1351,572,2.361888112,1170,1967,459,172,172,0,68,0,0.081395349,0,empty,CD-0722-2
"E3,B4",420676,507379,306756,200623,296320,171068,3,171247,135981,35266,3.855866841,104065,102359,10875,4263,4114,149,900,3,0.073407876,0,hg38,CD-0722-2
"E3,B5",4129,2500,1501,999,1772,1024,0,1031,710,321,2.211838006,636,1618,361,128,126,2,42,1,0.238095238,0,empty,CD-0722-2
"E3,B6",3916,4421,2810,1611,2731,1599,1,1600,1034,566,1.826855124,926,2013,438,195,195,0,49,0,0.138461538,0,empty,CD-0722-2
"E3,B7",3762,4234,2786,1448,2541,1377,0,1379,921,458,2.010917031,756,1576,671,252,248,4,63,2,0.080645161,0,empty,CD-0722-2
"E3,B8",2784,2938,2068,870,1769,904,0,904,596,308,1.935064935,480,1474,365,158,158,0,46,0,0.037974684,0,empty,CD-0722-2
"E3,B9",5150,5998,3719,2279,3669,2155,0,2155,1323,832,1.590144231,1275,1588,269,132,129,3,69,2,0.069767442,0,empty,CD-0722-2
"E3,B10",2452,2719,1723,996,1713,935,0,936,610,326,1.871165644,534,768,91,47,45,2,17,1,0,0,empty,CD-0722-2
"E3,B11",5980,7071,4211,2860,4281,2595,0,2596,1407,1189,1.183347351,1553,398,109,38,38,0,17,0,0,0,empty,CD-0722-2
"E3,B12",3161,3730,2292,1438,2278,1303,0,1304,831,473,1.756871036,781,7518,992,409,394,15,102,2,0.025380711,0,empty,CD-0722-2
"E3,C1",6588,7345,4918,2427,4434,2339,0,2343,1445,898,1.609131403,1322,1224,274,102,102,0,40,0,0.039215686,0,empty,CD-0722-2
"E3,C2",5336,5952,3925,2027,3633,2042,2,2046,1335,711,1.877637131,1166,2343,792,293,292,1,76,1,0.020547945,0,empty,CD-0722-2
"E3,C3",5753,6449,4309,2140,3970,2155,0,2155,1369,786,1.74173028,1184,1171,212,85,85,0,30,0,0.023529412,0,empty,CD-0722-2
"E3,C4",404383,471513,300237,171276,275893,152154,2,152300,112889,39411,2.864403339,89404,168424,27288,10588,10402,186,1647,10,0.042395693,0,hg38,CD-0722-2
"E3,C5",562158,666154,416638,249516,385939,215224,2,215389,176118,39271,4.484683354,127650,294655,49421,18905,18599,306,2493,5,0.071831819,0,hg38,CD-0722-2
"E3,C6",4591,5180,3290,1890,3193,1795,0,1795,1151,644,1.787267081,1043,1673,358,148,147,1,52,1,0.156462585,0,empty,CD-0722-2
"E3,C7",555240,657828,414889,242939,378614,209161,2,209276,157111,52165,3.011808684,124419,31279,3104,1144,1102,42,275,3,0.047186933,0,hg38,CD-0722-2
"E3,C8",6452,7369,4671,2698,4418,2429,0,2431,1578,853,1.849941383,1399,3526,677,321,317,4,105,3,0.088328076,0,empty,CD-0722-2
"E3,C9",4318,4987,3152,1835,3013,1673,0,1673,1085,588,1.845238095,963,2228,452,146,145,1,40,1,0.144827586,0,empty,CD-0722-2
"E3,C10",5193,6001,3784,2217,3529,1930,0,1930,1232,698,1.76504298,1110,2829,488,201,201,0,58,0,0.029850746,0,empty,CD-0722-2
"E3,C11",4229,4725,3101,1624,2925,1626,0,1630,1021,609,1.676518883,886,2566,476,169,165,4,60,2,0.084848485,0,empty,CD-0722-2
"E3,C12",509398,611044,365957,245087,354440,214180,3,214357,169240,45117,3.751135935,128008,61773,5509,2144,2093,51,544,2,0.045389393,0,hg38,CD-0722-2
"E3,D1",5489,6097,3979,2118,3707,2110,0,2112,1319,793,1.663303909,1186,788,110,64,60,4,26,1,0.1,0,empty,CD-0722-2
"E3,D2",4914,5652,3725,1927,3363,1756,0,1759,1130,629,1.796502385,997,3339,769,294,292,2,106,1,0.023972603,0,empty,CD-0722-2
"E3,D3",464819,559301,336711,222590,327904,192161,3,192342,150240,42102,3.568476557,116256,128613,19968,7720,7576,144,1361,4,0.052402323,0,hg38,CD-0722-2
"E3,D4",2913,3254,2119,1135,2061,1147,0,1147,697,450,1.548888889,666,1810,319,129,126,3,41,2,0,0,empty,CD-0722-2
"E3,D5",3562,4001,2648,1353,2466,1351,0,1355,887,468,1.895299145,747,2065,429,166,164,2,54,2,0.12195122,0,empty,CD-0722-2
"E3,D6",5590,6416,3918,2498,3851,2242,0,2243,1374,869,1.581127733,1324,2254,438,186,184,2,67,2,0.081521739,0,empty,CD-0722-2
"E3,D7",3093,3490,2293,1197,2106,1150,0,1150,788,362,2.17679558,648,2901,787,293,291,2,87,2,0.127147766,0,empty,CD-0722-2
"E3,D8",3819,4449,2773,1676,2785,1602,0,1604,1062,542,1.959409594,927,1644,567,184,181,3,60,1,0.209944751,0,empty,CD-0722-2
"E3,D9",1976,2242,1447,795,1392,793,0,793,528,265,1.99245283,462,1972,344,118,116,2,45,1,0.068965517,0,empty,CD-0722-2
"E3,D10",5267,6171,3806,2365,3731,2196,0,2200,1392,808,1.722772277,1284,1228,322,120,116,4,40,1,0.060344828,0,empty,CD-0722-2
"E3,D11",3912,4416,2855,1561,2735,1444,0,1446,943,503,1.874751491,837,4133,1028,389,389,0,123,0,0.097686375,0,empty,CD-0722-2
"E3,D12",5436,6460,3978,2482,3809,2114,0,2119,1367,752,1.817819149,1276,11330,1837,697,681,16,183,5,0.029368576,0,empty,CD-0722-2
"E3,E1",6320,7052,4569,2483,4216,2334,0,2337,1510,827,1.825876663,1310,3301,811,312,312,0,83,0,0.064102564,0,empty,CD-0722-2
"E3,E2",4483,5080,3216,1864,3131,1734,0,1736,1142,594,1.922558923,1008,1868,366,189,183,6,63,2,0.043715847,0,empty,CD-0722-2
"E3,E3",3207,3694,2325,1369,2254,1269,0,1271,828,443,1.869074492,762,2988,782,303,300,3,88,1,0.136666667,0,empty,CD-0722-2
"E3,E4",4135,4592,3035,1557,2818,1518,0,1524,1007,517,1.947775629,848,2622,679,280,277,3,84,2,0.119133574,0,empty,CD-0722-2
"E3,E5",3852,4248,2843,1405,2579,1311,0,1313,854,459,1.860566449,747,1591,411,167,167,0,58,0,0.083832335,0,empty,CD-0722-2
"E3,E6",6992,8108,5131,2977,4869,2766,0,2770,1857,913,2.033953998,1624,4165,1042,421,414,7,119,2,0.062801932,0,empty,CD-0722-2
"E3,E7",6045,6718,4474,2244,4055,2188,0,2195,1398,797,1.754077792,1221,3714,1034,414,413,1,96,1,0.065375303,0,empty,CD-0722-2
"E3,E8",4952,5579,3649,1930,3406,1794,0,1797,1136,661,1.718608169,1024,3853,711,330,325,5,91,2,0.126153846,0,empty,CD-0722-2
"E3,E9",3306,3931,2408,1523,2332,1313,0,1316,878,438,2.00456621,774,3404,859,330,330,0,84,0,0.078787879,0,empty,CD-0722-2
"E3,E10",3677,4290,2712,1578,2609,1423,0,1423,921,502,1.834661355,853,2774,600,237,236,1,69,1,0.055084746,0,empty,CD-0722-2
"E3,E11",4275,4715,3088,1627,2888,1604,0,1606,1041,565,1.842477876,911,3450,629,210,207,3,60,1,0.06763285,0,empty,CD-0722-2
"E3,E12",4644,5276,3357,1919,3328,1855,0,1858,1211,647,1.871715611,1099,3667,504,222,218,4,82,2,0.091743119,0,empty,CD-0722-2
"E3,F1",5526,5978,4048,1930,3726,1992,0,1994,1225,769,1.592977893,1073,2568,633,228,228,0,75,0,0.074561404,0,empty,CD-0722-2
"E3,F2",4576,5136,3377,1759,3126,1686,0,1688,1094,594,1.841750842,981,3612,886,322,318,4,94,2,0.066037736,0,empty,CD-0722-2
"E3,F3",843606,1027671,623398,404273,595172,348904,1,349217,285705,63512,4.498441239,211797,267827,46602,17916,17654,262,2530,6,0.051886258,0,hg38,CD-0722-2
"E3,F4",6585,7526,4717,2809,4514,2425,0,2425,1590,835,1.904191617,1432,1093,246,93,92,1,42,1,0.086956522,0,empty,CD-0722-2
"E3,F5",5324,5751,3873,1878,3494,1811,0,1815,1145,670,1.708955224,1018,3300,1261,397,392,5,93,2,0.130102041,0,empty,CD-0722-2
"E3,F6",4756,5598,3361,2237,3372,1930,0,1931,1214,717,1.693165969,1205,3919,1176,411,410,1,101,1,0.112195122,0,empty,CD-0722-2
"E3,F7",5572,6227,4049,2178,3793,2053,1,2054,1358,696,1.951149425,1134,1048,139,71,70,1,23,1,0.014285714,0,empty,CD-0722-2
"E3,F8",4120,4738,3014,1724,2890,1574,0,1574,1042,532,1.958646617,929,332,86,42,42,0,19,0,0.047619048,0,empty,CD-0722-2
"E3,F9",4557,5118,3415,1703,3101,1624,0,1627,1097,530,2.069811321,922,3888,865,331,321,10,100,2,0.105919003,0,empty,CD-0722-2
"E3,F10",5750,6560,4394,2166,4016,2161,0,2161,1417,744,1.904569892,1215,1852,362,167,167,0,63,0,0.041916168,0,empty,CD-0722-2
"E3,F11",4192,4624,3112,1512,2779,1449,1,1453,991,462,2.145021645,797,2927,597,236,232,4,56,2,0.211206897,0,empty,CD-0722-2
"E3,F12",1009475,1200001,732229,467772,685289,405114,5,405449,316406,89043,3.553406781,244314,4009,762,329,326,3,83,1,0.064417178,0,hg38,CD-0722-2
"E3,G1",5286,5845,3905,1940,3560,1852,0,1858,1213,645,1.880620155,1026,3843,913,347,345,2,96,1,0.049275362,0,empty,CD-0722-2
"E3,G2",3188,3445,2245,1200,2167,1201,0,1201,742,459,1.616557734,710,650,74,47,45,2,29,1,0.111111111,0,empty,CD-0722-2
"E3,G3",5712,6473,4196,2277,3871,2132,0,2134,1324,810,1.634567901,1175,2914,521,213,213,0,77,0,0.0657277,0,empty,CD-0722-2
"E3,G4",11259,12973,7948,5025,7671,4574,0,4580,2773,1807,1.534587714,2695,188,40,25,24,1,12,1,0,0,empty,CD-0722-2
"E3,G5",3722,4441,2659,1782,2685,1538,0,1538,997,541,1.842883549,971,2014,400,177,173,4,58,2,0.161849711,0,empty,CD-0722-2
"E3,G6",1615293,1925292,1202970,722322,1083510,628702,0,629185,510831,118354,4.316127888,368815,14506,2621,1037,1024,13,246,3,0.052734375,0,hg38,CD-0722-2
"E3,G7",4068,4640,3012,1628,2754,1469,0,1472,991,481,2.06029106,846,3559,888,347,344,3,84,1,0.072674419,0,empty,CD-0722-2
"E3,G8",3283,3642,2409,1233,2196,1185,0,1190,815,375,2.173333333,676,2144,655,265,263,2,80,1,0.102661597,0,empty,CD-0722-2
"E3,G9",3563,4006,2597,1409,2449,1295,0,1297,817,480,1.702083333,759,2809,647,266,264,2,90,2,0.011363636,0,empty,CD-0722-2
"E3,G10",4413,5048,3207,1841,3092,1733,0,1742,1114,628,1.77388535,1024,3193,844,322,312,10,85,1,0.157051282,0,empty,CD-0722-2
"E3,G11",4406,5085,3177,1908,3018,1628,0,1633,1118,515,2.170873786,956,1486,388,148,146,2,53,1,0.116438356,0,empty,CD-0722-2
"E3,G12",3840,4486,2777,1709,2759,1564,0,1564,1051,513,2.048732943,921,8143,1287,533,519,14,119,2,0.096339114,0,empty,CD-0722-2
"E3,H1",420133,493280,306472,186808,288893,163672,0,163796,127795,36001,3.549762507,98277,71067,11156,4250,4182,68,821,3,0.054519369,0,hg38,CD-0722-2
"E3,H2",4313,4929,3179,1750,3017,1721,2,1723,1078,645,1.671317829,1006,2891,667,252,252,0,81,0,0.047619048,0,empty,CD-0722-2
"E3,H3",3446,3937,2586,1351,2411,1335,0,1335,871,464,1.877155172,736,2138,391,159,159,0,65,0,0.012578616,0,empty,CD-0722-2
"E3,H4",5623,6536,4033,2503,3851,2101,0,2101,1369,732,1.870218579,1239,162,27,19,19,0,12,0,0,0,empty,CD-0722-2
"E3,H5",5950,6819,4250,2569,4164,2351,0,2352,1464,888,1.648648649,1408,2408,699,315,313,2,90,2,0.051118211,0,empty,CD-0722-2
"E3,H6",3643,4419,2593,1826,2636,1516,0,1518,997,521,1.913627639,939,2526,590,212,212,0,71,0,0.009433962,0,empty,CD-0722-2
"E3,H7",4029,4271,2976,1295,2720,1450,0,1454,946,508,1.862204724,787,3530,1026,359,356,3,90,2,0.146067416,0,empty,CD-0722-2
"E3,H8",576635,641725,447148,194577,366745,182996,0,183171,149275,33896,4.403911966,100978,317736,33963,13615,13201,414,2167,9,0.036663889,0,hg38,CD-0722-2
"E3,H9",3359,3740,2539,1201,2236,1121,0,1121,753,368,2.046195652,601,1470,265,107,107,0,41,0,0.018691589,0,empty,CD-0722-2
"E3,H10",3502,3993,2537,1456,2529,1420,0,1420,953,467,2.040685225,857,2155,488,173,170,3,60,2,0.052941176,0,empty,CD-0722-2
"E3,H11",4176,4942,2915,2027,3023,1953,0,1955,1121,834,1.3441247,1170,163,4,2,2,0,2,0,0,0,empty,CD-0722-2
"E3,H12",3515,4097,2546,1551,2358,1350,0,1350,894,456,1.960526316,789,5116,487,171,166,5,62,2,0.054216867,0,empty,CD-0722-2
"E4,A1",4065,4657,2924,1733,2816,1627,6,1636,1013,623,1.62600321,964,978,176,97,96,1,31,1,0.385416667,0,empty,CD-0722-2
"E4,A2",494042,552138,379224,172914,315978,156024,1,156156,121064,35092,3.449903112,87622,93584,14301,5612,5523,89,992,5,0.042368278,0,hg38,CD-0722-2
"E4,A3",3664,4199,2616,1583,2507,1390,0,1390,938,452,2.075221239,822,1255,311,120,120,0,36,0,0.066666667,0,empty,CD-0722-2
"E4,A4",6197,6913,4619,2294,4221,2254,0,2255,1418,837,1.694145759,1245,706,136,55,55,0,20,0,0.054545455,0,empty,CD-0722-2
"E4,A5",5314,5898,3917,1981,3550,1931,0,1934,1218,716,1.701117318,1103,2120,665,231,230,1,52,1,0,0,empty,CD-0722-2
"E4,A6",4582,5472,3402,2070,3328,1917,0,1919,1267,652,1.943251534,1122,3088,701,246,239,7,74,2,0.138075314,0,empty,CD-0722-2
"E4,A7",3919,4500,2915,1585,2755,1568,0,1568,959,609,1.574712644,866,1432,254,117,116,1,39,1,0.137931034,0,empty,CD-0722-2
"E4,A8",2357,2773,1774,999,1672,930,0,930,644,286,2.251748252,530,1916,501,199,196,3,61,1,0.204081633,0,empty,CD-0722-2
"E4,A9",6236,7148,4552,2596,4324,2493,0,2493,1624,869,1.86881473,1477,1344,242,105,105,0,44,0,0.123809524,0,empty,CD-0722-2
"E4,A10",610906,768447,422370,346077,450778,306441,0,306617,219098,87519,2.50343354,189622,17451,454,225,181,44,60,2,0.237569061,0,hg38,CD-0722-2
"E4,A11",3634,3986,2780,1206,2443,1231,0,1231,816,415,1.96626506,681,1713,351,121,121,0,41,0,0.024793388,0,empty,CD-0722-2
"E4,A12",5353,5801,3911,1890,3508,1788,0,1791,1175,616,1.907467532,989,4840,699,318,311,7,97,3,0.083601286,0,empty,CD-0722-2
"E4,B1",4437,5135,3168,1967,3112,1762,0,1763,1100,663,1.659125189,1072,861,283,111,109,2,38,2,0,0,empty,CD-0722-2
"E4,B2",4737,5545,3131,2414,3258,1954,0,1954,1248,706,1.767705382,1221,373,98,41,41,0,15,0,0.048780488,0,empty,CD-0722-2
"E4,B3",3692,4075,2733,1342,2532,1354,0,1354,921,433,2.127020785,754,1379,233,115,115,0,42,0,0.060869565,0,empty,CD-0722-2
"E4,B4",4595,5345,3258,2087,3239,1893,0,1900,1182,718,1.646239554,1167,1073,259,105,104,1,26,1,0.144230769,0,empty,CD-0722-2
"E4,B5",1417268,777862,485324,292538,551302,298079,19,300147,228378,71769,3.182125988,188025,148296,22164,8404,8221,183,1542,7,0.03673519,0,hg38,CD-0722-2
"E4,B6",4842,5548,3510,2038,3386,1944,0,1946,1197,749,1.598130841,1149,1586,438,194,192,2,49,1,0.067708333,0,empty,CD-0722-2
"E4,B7",4403,5078,3258,1820,3004,1657,0,1662,1075,587,1.831345826,957,1187,258,123,123,0,36,0,0.097560976,0,empty,CD-0722-2
"E4,B8",3210,3836,2397,1439,2229,1201,0,1203,779,424,1.837264151,695,1046,294,111,110,1,33,1,0.072727273,0,empty,CD-0722-2
"E4,B9",6865,7797,4800,2997,4532,2594,0,2595,1563,1032,1.514534884,1551,1225,431,158,157,1,52,1,0.025477707,0,empty,CD-0722-2
"E4,B10",3033,3437,2148,1289,2087,1127,0,1127,701,426,1.645539906,676,540,88,35,35,0,12,0,0.457142857,0,empty,CD-0722-2
"E4,B11",7180,8351,4991,3360,4927,3003,0,3011,1682,1329,1.265613243,1778,181,20,14,14,0,10,0,0.071428571,0,empty,CD-0722-2
"E4,B12",3980,4495,2900,1595,2767,1521,0,1521,997,524,1.902671756,880,2515,535,195,188,7,43,2,0.132978723,0,empty,CD-0722-2
"E4,C1",7600,8517,5763,2754,5092,2679,0,2682,1658,1024,1.619140625,1495,874,243,110,109,1,37,1,0.201834862,0,empty,CD-0722-2
"E4,C2",6499,7419,4674,2745,4294,2433,0,2440,1556,884,1.760180995,1363,1563,425,176,171,5,61,2,0.011695906,0,empty,CD-0722-2
"E4,C3",7977,8951,5861,3090,5415,2952,0,2954,2002,952,2.102941176,1690,953,268,109,109,0,33,0,0.146788991,0,empty,CD-0722-2
"E4,C4",3904,4386,2971,1415,2684,1383,0,1384,866,518,1.671814672,791,1660,262,100,97,3,39,3,0.154639175,0,empty,CD-0722-2
"E4,C5",653900,798127,470380,327747,459329,272479,0,272700,219487,53213,4.124687576,167796,56408,6914,2636,2573,63,601,5,0.03653323,0,hg38,CD-0722-2
"E4,C6",7549,8657,5625,3032,5224,2945,0,2948,2102,846,2.48463357,1659,1680,342,148,148,0,41,0,0.067567568,0,empty,CD-0722-2
"E4,C7",7210,8426,5048,3378,5094,3055,0,3057,1899,1158,1.639896373,1849,334,38,19,18,1,6,1,0,0,empty,CD-0722-2
"E4,C8",7351,8194,5403,2791,4959,2740,0,2740,1762,978,1.801635992,1518,2618,636,267,265,2,83,1,0.026415094,0,empty,CD-0722-2
"E4,C9",7527,8612,5569,3043,5093,2726,0,2728,1832,896,2.044642857,1540,2458,383,156,142,14,45,3,0.070422535,0,empty,CD-0722-2
"E4,C10",993517,1160551,721232,439319,666210,402100,3,402416,288484,113932,2.532071762,234314,13635,6163,2284,2267,17,317,2,0.028672254,0,hg38,CD-0722-2
"E4,C11",5068,5888,3719,2169,3441,1903,0,1903,1233,670,1.840298507,1094,2122,525,198,197,1,44,1,0.020304569,0,empty,CD-0722-2
"E4,C12",7048,7880,5217,2663,4619,2468,0,2468,1654,814,2.031941032,1349,2527,339,142,136,6,47,3,0.102941176,0,empty,CD-0722-2
"E4,D1",6591,7680,4633,3047,4560,2705,0,2709,1606,1103,1.456029012,1633,994,94,44,44,0,19,0,0.272727273,0,empty,CD-0722-2
"E4,D2",5291,5997,3983,2014,3509,1838,0,1838,1162,676,1.718934911,1021,2055,493,214,210,4,60,2,0.004761905,0,empty,CD-0722-2
"E4,D3",4865,5480,3517,1963,3311,1838,0,1841,1214,627,1.936204147,1037,1136,261,117,117,0,32,0,0.025641026,0,empty,CD-0722-2
"E4,D4",3462,3858,2548,1310,2443,1323,0,1325,882,443,1.990970655,760,1284,283,109,108,1,37,1,0.101851852,0,empty,CD-0722-2
"E4,D5",4152,4770,3064,1706,2898,1565,0,1572,1008,564,1.787234043,923,1334,351,149,147,2,47,2,0.163265306,0,empty,CD-0722-2
"E4,D6",6938,8073,4816,3257,4720,2808,0,2811,1700,1111,1.530153015,1690,1878,418,166,158,8,57,2,0.025316456,0,empty,CD-0722-2
"E4,D7",3626,4118,2658,1460,2493,1323,0,1326,842,484,1.739669421,740,2259,515,217,215,2,62,2,0.088372093,0,empty,CD-0722-2
"E4,D8",4463,4944,3185,1759,3005,1630,0,1631,1027,604,1.700331126,951,1466,270,124,119,5,47,2,0.168067227,0,empty,CD-0722-2
"E4,D9",2212,2580,1608,972,1495,820,0,821,514,307,1.674267101,504,1073,267,115,111,4,32,1,0.126126126,0,empty,CD-0722-2
"E4,D10",1369349,1656209,1002873,653336,939272,559147,6,559566,461238,98328,4.690810349,337390,137172,15215,6083,5925,158,1262,8,0.047594937,0,hg38,CD-0722-2
"E4,D11",4683,5336,3479,1857,3267,1769,0,1770,1127,643,1.752721617,1006,2309,460,219,219,0,72,0,0.01826484,0,empty,CD-0722-2
"E4,D12",6087,7145,4387,2758,4280,2439,1,2445,1624,821,1.978075518,1442,3626,935,353,353,0,103,0,0.025495751,0,empty,CD-0722-2
"E4,E1",517817,592208,382506,209702,340037,185507,2,185663,143104,42559,3.362485021,107693,80849,14210,5380,5298,82,994,6,0.061532654,0,hg38,CD-0722-2
"E4,E2",5427,6212,3891,2321,3772,2118,0,2119,1361,758,1.795514512,1266,2273,402,161,156,5,46,1,0.269230769,0,empty,CD-0722-2
"E4,E3",3672,4264,2740,1524,2511,1344,0,1344,849,495,1.715151515,787,1935,525,209,207,2,52,1,0.115942029,0,empty,CD-0722-2
"E4,E4",4952,5739,3605,2134,3465,1880,0,1882,1206,676,1.784023669,1115,2317,541,182,180,2,63,2,0.038888889,0,empty,CD-0722-2
"E4,E5",5953,6818,4379,2439,4042,2214,0,2214,1460,754,1.936339523,1268,1589,386,145,142,3,50,1,0.098591549,0,empty,CD-0722-2
"E4,E6",8462,9519,6246,3273,5615,3005,0,3007,1998,1009,1.980178394,1710,3474,815,317,313,4,97,1,0.153354633,0,empty,CD-0722-2
"E4,E7",6945,7543,5167,2376,4536,2369,0,2373,1556,817,1.904528764,1298,2472,451,171,167,4,65,2,0.083832335,0,empty,CD-0722-2
"E4,E8",5908,6625,4367,2258,3915,2063,0,2066,1313,753,1.743691899,1172,2125,407,207,206,1,65,1,0.067961165,0,empty,CD-0722-2
"E4,E9",3844,4352,2689,1663,2629,1474,0,1474,999,475,2.103157895,870,2215,448,182,179,3,66,2,0.184357542,0,empty,CD-0722-2
"E4,E10",4181,4532,3067,1465,2731,1444,0,1444,949,495,1.917171717,788,1587,457,160,158,2,49,2,0.018987342,0,empty,CD-0722-2
"E4,E11",5099,5936,3701,2235,3570,2036,0,2036,1277,759,1.682476943,1218,1594,350,150,150,0,42,0,0.026666667,0,empty,CD-0722-2
"E4,E12",142445,149634,109398,40236,86983,45684,0,45731,31163,14568,2.139140582,21402,3090,745,291,281,10,96,2,0.384341637,0,empty,CD-0722-2
"E4,F1",6770,7537,4898,2639,4414,2420,0,2423,1489,934,1.594218415,1320,2266,573,187,182,5,66,2,0.065934066,0,empty,CD-0722-2
"E4,F2",632030,753610,461459,292151,433093,249704,1,249874,197947,51927,3.812024573,149973,164524,27029,10475,10286,189,1750,5,0.054540152,0,hg38,CD-0722-2
"E4,F3",4938,5540,3709,1831,3224,1712,1,1720,1093,627,1.743221691,954,2675,596,262,262,0,85,0,0.026717557,0,empty,CD-0722-2
"E4,F4",623165,696951,472950,224001,404117,208256,5,208479,164640,43839,3.755560118,117584,8848,1393,546,537,9,147,2,0.04283054,0,hg38,CD-0722-2
"E4,F5",505161,569535,379464,190071,326932,170977,0,171119,132245,38874,3.401888151,97928,99146,11142,4400,4278,122,851,7,0.037868163,0,hg38,CD-0722-2
"E4,F6",5577,6488,4036,2452,3791,2115,0,2115,1345,770,1.746753247,1216,2308,696,220,212,8,62,2,0.108490566,0,empty,CD-0722-2
"E4,F7",6321,7307,4689,2618,4466,2517,0,2518,1629,889,1.832395951,1454,930,124,58,52,6,24,1,0.019230769,0,empty,CD-0722-2
"E4,F8",5545,6362,4208,2154,3736,2014,0,2016,1310,706,1.855524079,1121,181,46,26,26,0,17,0,0,0,empty,CD-0722-2
"E4,F9",5183,5833,3851,1982,3567,1930,0,1933,1288,645,1.996899225,1114,2139,462,221,219,2,78,1,0.050228311,0,empty,CD-0722-2
"E4,F10",6649,7387,4842,2545,4298,2297,0,2299,1501,798,1.880952381,1306,1450,319,152,150,2,45,2,0.02,0,empty,CD-0722-2
"E4,F11",5234,5947,3940,2007,3490,1896,0,1899,1268,631,2.009508716,1037,1655,277,139,139,0,39,0,0.079136691,0,empty,CD-0722-2
"E4,F12",5792,6644,4176,2468,3928,2202,0,2204,1444,760,1.9,1292,364,88,45,43,2,11,1,0.581395349,0,empty,CD-0722-2
"E4,G1",6070,6794,4570,2224,4075,2118,0,2120,1407,713,1.973352034,1186,2223,529,181,180,1,68,1,0.072222222,0,empty,CD-0722-2
"E4,G2",3695,4051,2589,1462,2459,1381,0,1382,884,498,1.775100402,792,610,89,54,53,1,30,1,0.037735849,0,empty,CD-0722-2
"E4,G3",7737,8588,5754,2834,5021,2723,0,2728,1656,1072,1.544776119,1460,1796,317,167,166,1,64,1,0.030120482,0,empty,CD-0722-2
"E4,G4",12729,14632,9004,5628,8750,5290,0,5298,3150,2148,1.466480447,3087,113,24,16,16,0,11,0,0,0,empty,CD-0722-2
"E4,G5",619388,765399,446063,319336,439186,262285,2,262444,210789,51655,4.080708547,162296,121185,16841,6861,6717,144,1303,7,0.058806015,0,hg38,CD-0722-2
"E4,G6",6148,6891,4490,2401,3948,2106,0,2106,1381,725,1.904827586,1208,146,13,7,7,0,7,0,0,0,empty,CD-0722-2
"E4,G7",4881,5450,3615,1835,3249,1634,0,1635,1115,520,2.144230769,903,6954,1011,417,409,8,128,1,0.056234719,0,empty,CD-0722-2
"E4,G8",3332,3791,2433,1358,2263,1219,0,1221,817,404,2.022277228,693,1337,383,149,149,0,53,0,0.033557047,0,empty,CD-0722-2
"E4,G9",4119,4775,2995,1780,2887,1574,0,1576,1063,513,2.072124756,952,2170,466,200,199,1,57,1,0.075376884,0,empty,CD-0722-2
"E4,G10",5494,6378,4029,2349,3807,2159,0,2161,1406,755,1.862251656,1262,1968,611,212,211,1,62,1,0.004739336,0,empty,CD-0722-2
"E4,G11",5058,5582,3807,1775,3290,1628,0,1632,1081,551,1.961887477,924,1039,272,109,107,2,36,2,0.009345794,0,empty,CD-0722-2
"E4,G12",4257,4774,3054,1720,2905,1651,0,1652,1071,581,1.843373494,940,3386,669,267,263,4,79,2,0.011406844,0,empty,CD-0722-2
"E4,H1",4433,4915,3251,1664,3009,1614,0,1616,1056,560,1.885714286,922,1737,408,144,142,2,42,2,0.126760563,0,empty,CD-0722-2
"E4,H2",5183,5984,3742,2242,3505,1965,0,1965,1262,703,1.795163585,1153,1906,534,192,189,3,67,2,0.005291005,0,empty,CD-0722-2
"E4,H3",4340,4963,3165,1798,2975,1642,0,1642,1071,571,1.875656743,967,1427,236,101,100,1,31,1,0.01,0,empty,CD-0722-2
"E4,H4",6395,7296,4644,2652,4313,2333,0,2333,1495,838,1.784009547,1386,154,39,22,22,0,12,0,0,0,empty,CD-0722-2
"E4,H5",6856,7861,5040,2821,4580,2495,0,2500,1610,890,1.808988764,1396,2041,550,211,209,2,70,2,0.023923445,0,empty,CD-0722-2
"E4,H6",4153,4846,2884,1962,2904,1705,0,1706,1110,596,1.862416107,1032,2127,526,202,200,2,66,1,0.025,0,empty,CD-0722-2
"E4,H7",4776,5265,3527,1738,3243,1702,0,1702,1150,552,2.083333333,972,2290,435,188,184,4,65,2,0.119565217,0,empty,CD-0722-2
"E4,H8",5550,6449,3919,2530,3835,2221,2,2229,1368,861,1.588850174,1319,2127,484,229,224,5,69,2,0.075892857,0,empty,CD-0722-2
"E4,H9",4030,4562,3011,1551,2677,1400,0,1402,948,454,2.088105727,823,984,194,86,85,1,27,1,0.070588235,0,empty,CD-0722-2
"E4,H10",767029,913441,572428,341013,520080,294651,1,294905,241316,53589,4.50308832,174836,204571,24075,9700,9450,250,1701,9,0.052380952,0,hg38,CD-0722-2
"E4,H11",5581,6733,3773,2960,4062,2678,0,2681,1410,1271,1.109362707,1646,87,38,16,16,0,4,0,0.8125,0,empty,CD-0722-2
"E4,H12",4162,4658,2900,1758,2790,1595,0,1595,1037,558,1.858422939,935,2443,402,164,161,3,54,3,0.118012422,0,empty,CD-0722-2
"E5,A1",3676,4169,2694,1475,2608,1453,0,1456,921,535,1.721495327,856,1886,353,186,185,1,52,1,0.086486486,0,empty,CD-0722-2
"E5,A2",5470,6351,4049,2302,3879,2155,0,2157,1351,806,1.67617866,1230,2072,502,201,199,2,53,1,0.060301508,0,empty,CD-0722-2
"E5,A3",3473,4171,2450,1721,2483,1392,0,1395,951,444,2.141891892,882,1659,265,112,111,1,45,1,0.081081081,0,empty,CD-0722-2
"E5,A4",5958,6700,4455,2245,4229,2258,0,2260,1404,856,1.640186916,1259,1182,221,94,94,0,42,0,0.042553191,0,empty,CD-0722-2
"E5,A5",4683,5421,3426,1995,3319,1814,0,1814,1153,661,1.744326778,1052,2906,572,258,255,3,69,1,0.094117647,0,empty,CD-0722-2
"E5,A6",4290,4885,3206,1679,3015,1707,0,1707,1108,599,1.849749583,934,3719,873,400,397,3,114,2,0.052896725,0,empty,CD-0722-2
"E5,A7",3715,4386,2680,1706,2696,1548,0,1548,991,557,1.779174147,951,1650,363,130,130,0,46,0,0.107692308,0,empty,CD-0722-2
"E5,A8",2039,2238,1502,736,1441,796,0,796,554,242,2.289256198,423,2206,475,199,197,2,60,2,0.040609137,0,empty,CD-0722-2
"E5,A9",3919,4474,2937,1537,2742,1446,0,1447,947,500,1.894,802,2615,389,182,178,4,64,2,0.061797753,0,empty,CD-0722-2
"E5,A10",5140,5542,3890,1652,3411,1776,0,1777,1097,680,1.613235294,915,535,91,50,49,1,25,1,0.040816327,0,empty,CD-0722-2
"E5,A11",3498,3836,2510,1326,2366,1234,0,1237,849,388,2.18814433,719,3274,707,269,269,0,78,0,0.014869888,0,empty,CD-0722-2
"E5,A12",910109,1074337,663072,411265,628302,364508,3,364809,297672,67137,4.433799544,216326,272006,64626,24323,24101,222,3103,7,0.031036057,0,hg38,CD-0722-2
"E5,B1",4245,4631,3163,1468,2846,1571,0,1571,991,580,1.70862069,822,2206,529,178,176,2,48,1,0.090909091,0,empty,CD-0722-2
"E5,B2",4262,4822,2885,1937,3011,1789,0,1792,1105,687,1.608442504,1094,810,177,77,73,4,27,1,0.082191781,0,empty,CD-0722-2
"E5,B3",3716,4220,2662,1558,2652,1477,0,1478,1006,472,2.131355932,863,2140,413,167,161,6,61,2,0.118012422,0,empty,CD-0722-2
"E5,B4",4009,4817,2845,1972,2981,1774,0,1774,1105,669,1.651718984,1083,1872,497,144,143,1,49,1,0.174825175,0,empty,CD-0722-2
"E5,B5",5626,4217,2641,1576,2902,1587,0,1593,1092,501,2.179640719,978,1345,282,115,113,2,40,1,0.026548673,0,empty,CD-0722-2
"E5,B6",4583,5228,3230,1998,3215,1906,0,1911,1193,718,1.661559889,1126,2283,404,177,176,1,55,1,0.085227273,0,empty,CD-0722-2
"E5,B7",554048,705091,374672,330419,421457,297704,1,297902,221321,76581,2.890024941,182643,7323,1157,381,373,8,126,3,0.08310992,0,hg38,CD-0722-2
"E5,B8",2815,3099,2055,1044,1964,1045,0,1045,682,363,1.878787879,589,2468,651,236,233,3,66,1,0.090128755,0,empty,CD-0722-2
"E5,B9",5999,6975,4294,2681,4289,2499,0,2506,1619,887,1.825253664,1468,2036,420,177,176,1,57,1,0.022727273,0,empty,CD-0722-2
"E5,B10",360999,375003,261321,113682,231651,111967,12,112352,81546,30806,2.647081737,62888,32527,5155,2019,1997,22,422,4,0.089133701,0,hg38,CD-0722-2
"E5,B11",9155,10775,6511,4264,6419,3790,0,3792,2448,1344,1.821428571,2252,434,68,24,23,1,17,1,0.173913043,0,empty,CD-0722-2
"E5,B12",480365,584667,345448,239219,350591,210124,2,210295,171179,39116,4.376188772,128587,12359,2010,645,632,13,166,2,0.077531646,0,hg38,CD-0722-2
"E5,C1",7477,8198,5645,2553,4952,2563,0,2564,1688,876,1.926940639,1403,1366,246,108,107,1,36,1,0.112149533,0,empty,CD-0722-2
"E5,C2",6736,7753,4779,2974,4737,2726,0,2729,1788,941,1.90010627,1613,2455,539,231,231,0,75,0,0.069264069,0,empty,CD-0722-2
"E5,C3",839405,916570,654445,262125,537691,259235,2,259477,195664,63813,3.06620908,140475,41621,6466,2497,2448,49,498,3,0.029003268,0,hg38,CD-0722-2
"E5,C4",3878,4338,2909,1429,2678,1426,0,1426,951,475,2.002105263,756,2403,446,167,157,10,41,3,0.01910828,0,empty,CD-0722-2
"E5,C5",5370,6239,3915,2324,3795,2084,0,2084,1373,711,1.931082982,1224,2274,499,213,211,2,53,1,0.118483412,0,empty,CD-0722-2
"E5,C6",4500,5013,3242,1771,3197,1789,0,1789,1165,624,1.866987179,1005,1850,566,210,210,0,53,0,0.023809524,0,empty,CD-0722-2
"E5,C7",6800,8147,4813,3334,4970,3050,0,3055,1801,1254,1.436204147,1873,771,87,38,38,0,20,0,0.052631579,0,empty,CD-0722-2
"E5,C8",7415,8448,5353,3095,5231,2882,0,2889,1910,979,1.950970378,1700,3451,742,320,316,4,127,2,0.066455696,0,empty,CD-0722-2
"E5,C9",4991,5756,3641,2115,3510,1941,0,1942,1253,689,1.818577649,1134,2807,644,216,209,7,54,2,0.04784689,0,empty,CD-0722-2
"E5,C10",5502,6306,4015,2291,3891,2148,0,2150,1341,809,1.657601978,1257,2935,553,269,263,6,74,1,0.129277567,0,empty,CD-0722-2
"E5,C11",4600,5145,3371,1774,3172,1632,0,1632,1033,599,1.724540902,933,3860,837,293,287,6,90,2,0.034843206,0,empty,CD-0722-2
"E5,C12",6943,7736,5110,2626,4831,2630,0,2635,1747,888,1.967342342,1493,7306,946,399,392,7,127,2,0.081632653,0,empty,CD-0722-2
"E5,D1",6304,7366,4523,2843,4419,2572,0,2573,1546,1027,1.505355404,1486,1487,215,86,83,3,31,2,0.096385542,0,empty,CD-0722-2
"E5,D2",817833,951320,606017,345303,566409,325808,1,326030,223188,102842,2.170202835,190563,115414,19387,7418,7284,134,1331,5,0.037753981,0,hg38,CD-0722-2
"E5,D3",4410,4997,3176,1821,3131,1799,1,1802,1165,637,1.8288854,1068,2714,677,315,313,2,78,1,0.086261981,0,empty,CD-0722-2
"E5,D4",3514,4058,2606,1452,2520,1372,0,1372,914,458,1.995633188,808,1892,363,140,136,4,47,2,0.014705882,0,empty,CD-0722-2
"E5,D5",628602,755584,460093,295491,445668,256819,0,257005,195411,61594,3.17256551,155098,154148,19902,7936,7753,183,1500,8,0.051077002,0,hg38,CD-0722-2
"E5,D6",6257,7163,4383,2780,4395,2655,0,2659,1568,1091,1.437213566,1527,2326,509,207,207,0,67,0,0.15942029,0,empty,CD-0722-2
"E5,D7",1499642,1760926,1118617,642309,1009070,574071,4,574586,472736,101850,4.641492391,334074,309332,55739,21842,21487,355,2920,9,0.051054126,0,hg38,CD-0722-2
"E5,D8",3963,4487,2992,1495,2811,1505,0,1505,984,521,1.888675624,843,1881,475,207,204,3,58,2,0.024509804,0,empty,CD-0722-2
"E5,D9",2088,2415,1543,872,1498,789,0,793,543,250,2.172,454,2473,525,207,202,5,74,2,0.059405941,0,empty,CD-0722-2
"E5,D10",4205,5059,3050,2009,3007,1755,0,1757,1118,639,1.749608764,1057,1198,176,76,76,0,29,0,0.078947368,0,empty,CD-0722-2
"E5,D11",4520,4924,3336,1588,3053,1606,0,1606,1044,562,1.857651246,876,4955,918,365,362,3,106,2,0.069060773,0,empty,CD-0722-2
"E5,D12",5884,6849,4312,2537,4204,2334,0,2337,1519,818,1.856968215,1382,9669,1670,635,628,7,158,2,0.076433121,0,empty,CD-0722-2
"E5,E1",7253,8120,5252,2868,4941,2787,1,2788,1753,1035,1.693719807,1566,3715,686,305,302,3,86,2,0.039735099,0,empty,CD-0722-2
"E5,E2",5222,6096,3697,2399,3783,2164,0,2166,1385,781,1.773367478,1301,1978,479,198,197,1,56,1,0.025380711,0,empty,CD-0722-2
"E5,E3",3404,3911,2538,1373,2407,1285,0,1287,845,442,1.911764706,751,2720,612,294,291,3,75,2,0.082474227,0,empty,CD-0722-2
"E5,E4",4638,5429,3303,2126,3301,1874,0,1878,1201,677,1.774002954,1165,2719,590,269,267,2,77,1,0.052434457,0,empty,CD-0722-2
"E5,E5",358618,457664,238858,218806,275154,196358,1,196486,149230,47256,3.157905874,122092,2310,841,280,278,2,81,2,0.129496403,0,hg38,CD-0722-2
"E5,E6",7743,8888,5678,3210,5422,3023,0,3026,1926,1100,1.750909091,1711,4565,1061,448,445,3,114,2,0.141573034,0,empty,CD-0722-2
"E5,E7",6527,7353,4878,2475,4561,2444,0,2445,1658,787,2.106734435,1357,3566,870,356,354,2,121,2,0.132768362,0,empty,CD-0722-2
"E5,E8",5500,6161,4086,2075,3745,1943,0,1946,1247,699,1.78397711,1082,3681,981,355,350,5,104,2,0.1,0,empty,CD-0722-2
"E5,E9",3527,4056,2583,1473,2490,1355,0,1356,927,429,2.160839161,771,3370,593,240,238,2,102,1,0.088235294,0,empty,CD-0722-2
"E5,E10",398121,504415,267447,236968,304461,210689,1,210803,124807,85996,1.451311689,133491,2781,751,286,283,3,83,2,0.169611307,0,hg38,CD-0722-2
"E5,E11",4988,5693,3589,2104,3488,1947,0,1947,1248,699,1.785407725,1100,3020,492,215,211,4,77,1,0.042654028,0,empty,CD-0722-2
"E5,E12",864816,1005359,646175,359184,591646,325300,1,325567,261934,63633,4.116323291,192023,147083,21524,8567,8424,143,1436,4,0.028846154,0,hg38,CD-0722-2
"E5,F1",6269,7039,4486,2553,4293,2396,0,2404,1523,881,1.728717367,1337,3329,871,325,322,3,83,2,0.102484472,0,empty,CD-0722-2
"E5,F2",5417,6009,4038,1971,3669,1937,0,1941,1308,633,2.066350711,1109,2966,765,368,362,6,97,3,0.055248619,0,empty,CD-0722-2
"E5,F3",4315,4935,2988,1947,3084,1696,0,1696,1123,573,1.959860384,1028,2959,580,242,241,1,73,1,0.161825726,0,empty,CD-0722-2
"E5,F4",6953,7622,5151,2471,4703,2441,0,2451,1597,854,1.870023419,1328,1186,310,126,125,1,44,1,0.016,0,empty,CD-0722-2
"E5,F5",5519,6047,4127,1920,3729,2002,0,2002,1343,659,2.037936267,1059,2863,835,324,320,4,86,2,0.0625,0,empty,CD-0722-2
"E5,F6",5641,6521,4113,2408,3958,2235,0,2238,1413,825,1.712727273,1310,3498,1061,390,390,0,96,0,0.087179487,0,empty,CD-0722-2
"E5,F7",6316,7319,4630,2689,4411,2407,0,2409,1599,810,1.974074074,1425,1440,320,120,117,3,35,1,0.05982906,0,empty,CD-0722-2
"E5,F8",4678,5275,3433,1842,3313,1831,0,1833,1262,571,2.210157618,1027,395,67,32,32,0,17,0,0,0,empty,CD-0722-2
"E5,F9",5251,6159,3932,2227,3732,1979,0,1979,1339,640,2.0921875,1134,5588,1090,432,428,4,117,1,0.011682243,0,empty,CD-0722-2
"E5,F10",6244,6863,4728,2135,4292,2268,0,2268,1481,787,1.881829733,1238,2569,485,191,191,0,72,0,0.010471204,0,empty,CD-0722-2
"E5,F11",477632,529325,369126,160199,311854,152254,2,152394,116313,36081,3.223663424,83744,142839,19396,7719,7524,195,1304,8,0.041334397,0,hg38,CD-0722-2
"E5,F12",5442,6340,3943,2397,3793,2085,0,2088,1359,729,1.864197531,1256,961,200,89,89,0,28,0,0,0,empty,CD-0722-2
"E5,G1",5664,6285,4201,2084,3911,2058,0,2058,1293,765,1.690196078,1150,4333,961,306,301,5,92,1,0.186046512,0,empty,CD-0722-2
"E5,G2",3565,4128,2454,1674,2559,1467,0,1468,973,495,1.965656566,894,790,141,81,79,2,36,2,0.025316456,0,empty,CD-0722-2
"E5,G3",6277,6870,4628,2242,4265,2400,0,2401,1454,947,1.535374868,1260,3116,1016,350,344,6,82,1,0.084302326,0,empty,CD-0722-2
"E5,G4",619868,715727,461894,253833,422705,229864,0,230063,179004,51059,3.505826593,133865,2261,375,136,133,3,37,2,0.112781955,0,hg38,CD-0722-2
"E5,G5",3770,4365,2686,1679,2735,1545,0,1545,1004,541,1.855822551,918,1918,418,163,161,2,56,2,0.01863354,0,empty,CD-0722-2
"E5,G6",5763,6382,4214,2168,3864,2084,0,2088,1414,674,2.097922849,1167,253,49,19,18,1,13,1,0,0,empty,CD-0722-2
"E5,G7",90368,101370,68672,32698,60123,31022,3,31056,24667,6389,3.860854594,17361,9073,1922,719,718,1,191,1,0.027855153,0,empty,CD-0722-2
"E5,G8",3764,4179,2820,1359,2527,1314,0,1315,872,443,1.968397291,690,2948,712,307,305,2,97,2,0.019672131,0,empty,CD-0722-2
"E5,G9",4021,4716,2945,1771,2920,1606,0,1610,1060,550,1.927272727,962,3218,682,259,258,1,97,1,0.015503876,0,empty,CD-0722-2
"E5,G10",4822,5488,3532,1956,3308,1796,0,1796,1192,604,1.973509934,991,3616,750,301,296,5,102,2,0.027027027,0,empty,CD-0722-2
"E5,G11",4893,5394,3599,1795,3360,1760,0,1761,1181,580,2.036206897,1000,2142,576,248,246,2,67,2,0.113821138,0,empty,CD-0722-2
"E5,G12",4252,4852,3090,1762,2997,1687,0,1687,1119,568,1.970070423,989,6808,891,377,374,3,125,2,0.114973262,0,empty,CD-0722-2
"E5,H1",4603,5074,3353,1721,3120,1647,0,1650,1115,535,2.08411215,913,1877,300,161,159,2,63,1,0.006289308,0,empty,CD-0722-2
"E5,H2",630715,727341,476076,251265,425962,225823,0,226018,164714,61304,2.686839358,131727,101222,19309,7205,7104,101,1229,4,0.046875,0,hg38,CD-0722-2
"E5,H3",4242,5058,3037,2021,3019,1723,0,1723,1114,609,1.829228243,1058,2257,562,250,246,4,66,2,0.028455285,0,empty,CD-0722-2
"E5,H4",6064,6787,4404,2383,4075,2241,0,2243,1476,767,1.924380704,1288,204,24,20,20,0,17,0,0.05,0,empty,CD-0722-2
"E5,H5",6181,7151,4524,2627,4435,2477,0,2484,1629,855,1.905263158,1495,2487,700,281,280,1,93,1,0.032142857,0,empty,CD-0722-2
"E5,H6",3767,4375,2713,1662,2708,1505,0,1505,985,520,1.894230769,891,2294,635,242,241,1,79,1,0.053941909,0,empty,CD-0722-2
"E5,H7",4521,5201,3300,1901,3199,1757,0,1759,1142,617,1.85089141,1007,2785,644,257,256,1,89,1,0.12109375,0,empty,CD-0722-2
"E5,H8",4938,5633,3546,2087,3419,1924,0,1926,1265,661,1.91376702,1121,3028,684,239,235,4,79,2,0.076595745,0,empty,CD-0722-2
"E5,H9",4397,4700,3318,1382,2921,1464,0,1464,982,482,2.037344398,753,2039,467,169,164,5,40,2,0.036585366,0,empty,CD-0722-2
"E5,H10",4327,4902,3221,1681,2994,1586,0,1587,1070,517,2.069632495,861,1976,419,169,168,1,66,1,0.113095238,0,empty,CD-0722-2
"E5,H11",4929,6072,3366,2706,3716,2462,0,2462,1295,1167,1.109682948,1512,60,17,10,9,1,5,1,0,0,empty,CD-0722-2
"E5,H12",3925,4622,2740,1882,2736,1563,0,1563,1060,503,2.107355865,921,5693,599,270,259,11,76,2,0.057915058,0,empty,CD-0722-2
"E6,A1",4237,4946,3024,1922,2851,1631,0,1631,1033,598,1.727424749,951,1546,319,142,141,1,34,1,0.113475177,0,empty,CD-0722-2
"E6,A2",6203,6918,4491,2427,4167,2335,0,2339,1453,886,1.639954853,1353,1891,496,215,214,1,69,1,0.028037383,0,empty,CD-0722-2
"E6,A3",437518,482643,338220,144423,274497,132375,2,132503,99582,32921,3.024877738,73366,39758,5980,2305,2259,46,500,3,0.020362992,0,hg38,CD-0722-2
"E6,A4",6638,7445,4959,2486,4349,2309,0,2310,1472,838,1.756563246,1272,1050,208,80,79,1,24,1,0.050632911,0,empty,CD-0722-2
"E6,A5",5397,6011,4030,1981,3562,1893,0,1897,1241,656,1.891768293,1062,2439,511,189,189,0,51,0,0.08994709,0,empty,CD-0722-2
"E6,A6",4791,5669,3480,2189,3293,1852,0,1857,1188,669,1.775784753,1108,2874,735,282,281,1,76,1,0.213523132,0,empty,CD-0722-2
"E6,A7",4058,4811,2981,1830,2781,1611,0,1611,1078,533,2.022514071,957,1461,275,98,97,1,28,1,0.06185567,0,empty,CD-0722-2
"E6,A8",2322,2550,1720,830,1527,800,0,802,548,254,2.157480315,413,2325,515,198,197,1,51,1,0.147208122,0,empty,CD-0722-2
"E6,A9",4410,4927,3370,1557,2951,1582,0,1584,1055,529,1.994328922,857,1672,381,163,162,1,59,1,0.018518519,0,empty,CD-0722-2
"E6,A10",5598,6244,4211,2033,3630,1957,0,1959,1223,736,1.661684783,1075,405,39,14,14,0,11,0,0,0,empty,CD-0722-2
"E6,A11",410012,460027,316611,143416,261749,128901,1,128991,96587,32404,2.980712258,71893,88232,13739,5079,5005,74,874,5,0.072327672,0,hg38,CD-0722-2
"E6,A12",5668,6412,4162,2250,3719,1992,0,1994,1277,717,1.781032078,1135,3870,1120,449,445,4,100,3,0.085393258,0,empty,CD-0722-2
"E6,B1",4694,5319,3380,1939,3161,1839,0,1840,1169,671,1.742175857,1068,1022,296,118,118,0,36,0,0.322033898,0,empty,CD-0722-2
"E6,B2",6617,7941,4346,3595,4795,3180,0,3183,1952,1231,1.585702681,1990,829,143,74,72,2,22,2,0.055555556,0,empty,CD-0722-2
"E6,B3",558551,655271,417206,238065,372973,203990,0,204170,158168,46002,3.438285292,120813,118408,15325,5919,5802,117,1144,6,0.051878663,0,hg38,CD-0722-2
"E6,B4",4679,5574,3316,2258,3357,1995,0,1995,1179,816,1.444852941,1251,1292,307,111,111,0,32,0,0.036036036,0,empty,CD-0722-2
"E6,B5",4523,2861,1689,1172,2030,1149,0,1158,772,386,2,751,1072,269,99,98,1,24,1,0.193877551,0,empty,CD-0722-2
"E6,B6",5435,6207,3806,2401,3564,2089,0,2093,1237,856,1.445093458,1237,2133,505,218,217,1,59,1,0.105990783,0,empty,CD-0722-2
"E6,B7",4808,5557,3557,2000,3295,1790,0,1794,1188,606,1.96039604,1021,1387,270,128,125,3,44,2,0,0,empty,CD-0722-2
"E6,B8",3431,3828,2537,1291,2250,1151,0,1152,749,403,1.858560794,638,1284,219,126,125,1,49,1,0.136,0,empty,CD-0722-2
"E6,B9",6590,7632,4697,2935,4544,2636,0,2639,1711,928,1.84375,1556,1443,391,165,164,1,56,1,0.030487805,0,empty,CD-0722-2
"E6,B10",3205,3415,2236,1179,2072,1125,0,1127,743,384,1.934895833,633,633,176,65,65,0,15,0,0.076923077,0,empty,CD-0722-2
"E6,B11",9256,10673,6664,4009,6205,3621,0,3627,2064,1563,1.320537428,2183,290,61,22,21,1,14,1,0.047619048,0,empty,CD-0722-2
"E6,B12",659063,814623,468945,345678,466061,284823,0,285033,228838,56195,4.07221283,175482,109528,21035,8016,7898,118,1411,6,0.045961003,0,hg38,CD-0722-2
"E6,C1",8048,8825,5967,2858,5207,2733,0,2737,1685,1052,1.601711027,1507,1252,86,44,44,0,23,0,0.181818182,0,empty,CD-0722-2
"E6,C2",6728,7541,4920,2621,4418,2494,0,2496,1595,901,1.770255272,1431,2742,787,316,313,3,82,2,0.185303514,0,empty,CD-0722-2
"E6,C3",7092,8085,5210,2875,4731,2555,0,2559,1590,969,1.640866873,1480,918,195,101,97,4,32,2,0.041237113,0,empty,CD-0722-2
"E6,C4",4264,4900,3100,1800,2915,1547,0,1547,1024,523,1.95793499,939,2300,454,158,156,2,56,2,0.044871795,0,empty,CD-0722-2
"E6,C5",8876,10240,6586,3654,5986,3179,0,3186,2189,997,2.19558676,1879,1836,483,200,200,0,58,0,0.05,0,empty,CD-0722-2
"E6,C6",4945,5704,3567,2137,3479,1955,0,1955,1267,688,1.841569767,1170,1693,269,127,127,0,54,0,0.015748031,0,empty,CD-0722-2
"E6,C7",7623,9047,5388,3659,5301,3231,0,3234,1909,1325,1.440754717,1919,446,73,27,27,0,10,0,0.037037037,0,empty,CD-0722-2
"E6,C8",8036,8979,5993,2986,5343,2902,0,2902,1876,1026,1.828460039,1588,3232,853,337,334,3,110,2,0.095808383,0,empty,CD-0722-2
"E6,C9",5703,6537,4212,2325,3862,2090,0,2090,1413,677,2.087149188,1220,1726,324,137,135,2,43,2,0.17037037,0,empty,CD-0722-2
"E6,C10",6252,7141,4667,2474,4181,2265,0,2267,1418,849,1.670200236,1275,2168,533,205,205,0,51,0,0.087804878,0,empty,CD-0722-2
"E6,C11",5723,6499,4094,2405,3761,2114,0,2118,1315,803,1.637608966,1240,2080,441,179,173,6,57,2,0.115606936,0,empty,CD-0722-2
"E6,C12",578222,648219,442784,205435,364340,179725,5,179918,135314,44604,3.03367411,101791,70444,15694,6222,6145,77,986,7,0.042799024,0,hg38,CD-0722-2
"E6,D1",7184,8418,5099,3319,4812,2822,0,2826,1732,1094,1.583180987,1667,1004,120,57,53,4,22,1,0.056603774,0,empty,CD-0722-2
"E6,D2",5420,6092,3992,2100,3586,1827,0,1830,1223,607,2.014827018,1058,3163,658,278,274,4,80,2,0.051094891,0,empty,CD-0722-2
"E6,D3",12023,13851,9168,4683,7954,4213,0,4215,2938,1277,2.300704777,2421,2145,494,232,231,1,62,1,0.073593074,0,empty,CD-0722-2
"E6,D4",7751,9047,5805,3242,5253,2882,0,2888,2084,804,2.592039801,1662,1634,416,176,171,5,46,3,0.210526316,0,empty,CD-0722-2
"E6,D5",410738,456688,316883,139805,260124,125746,0,125850,103965,21885,4.750514051,70288,51875,12681,4749,4687,62,824,4,0.016428419,0,hg38,CD-0722-2
"E6,D6",1091856,1205675,838635,367040,672043,334780,2,335150,262837,72313,3.634712984,187382,78628,11105,4196,4117,79,886,5,0.02696138,0,hg38,CD-0722-2
"E6,D7",3927,4290,2920,1370,2540,1333,0,1333,883,450,1.962222222,749,2248,595,236,236,0,70,0,0.105932203,0,empty,CD-0722-2
"E6,D8",4584,5245,3314,1931,3010,1593,0,1594,1050,544,1.930147059,921,1563,408,165,164,1,54,1,0.006097561,0,empty,CD-0722-2
"E6,D9",111801,144885,72124,72761,85246,61957,0,61999,40322,21677,1.860128247,39690,1875,565,167,167,0,65,0,0.161676647,0,hg38,CD-0722-2
"E6,D10",5473,6360,3881,2479,3759,2097,0,2100,1397,703,1.987197724,1251,1185,333,137,137,0,34,0,0.240875912,0,empty,CD-0722-2
"E6,D11",5061,5853,3714,2139,3439,1870,0,1871,1212,659,1.839150228,1069,3271,1034,370,369,1,95,1,0.046070461,0,empty,CD-0722-2
"E6,D12",6334,7403,4655,2748,4334,2362,0,2364,1517,847,1.791027155,1393,4457,1218,404,399,5,102,1,0.112781955,0,empty,CD-0722-2
"E6,E1",612955,703619,453721,249898,396076,217619,3,217778,169699,48079,3.529586722,126334,130148,16976,6533,6373,160,1185,8,0.058998902,0,hg38,CD-0722-2
"E6,E2",5810,6822,4197,2625,3978,2282,0,2282,1544,738,2.092140921,1340,2304,406,180,179,1,54,1,0.072625698,0,empty,CD-0722-2
"E6,E3",3749,4186,2781,1405,2511,1370,0,1372,924,448,2.0625,760,2344,451,230,230,0,72,0,0.1,0,empty,CD-0722-2
"E6,E4",5149,5533,3757,1776,3466,1882,0,1884,1221,663,1.841628959,1048,2486,568,257,256,1,85,1,0.0625,0,empty,CD-0722-2
"E6,E5",4537,5097,3397,1700,2980,1536,0,1539,1004,535,1.876635514,851,1317,262,115,112,3,37,1,0.178571429,0,empty,CD-0722-2
"E6,E6",8622,9870,6248,3622,5848,3246,0,3246,2000,1246,1.605136437,1914,3712,920,389,380,9,119,2,0.113157895,0,empty,CD-0722-2
"E6,E7",7290,8274,5300,2974,4959,2698,0,2702,1730,972,1.779835391,1574,2793,601,245,243,2,63,2,0.144032922,0,empty,CD-0722-2
"E6,E8",6295,7014,4678,2336,4017,2084,0,2085,1372,713,1.924263675,1156,3088,1034,384,379,5,89,2,0.089709763,0,empty,CD-0722-2
"E6,E9",4041,4442,3029,1413,2654,1380,0,1385,920,465,1.978494624,739,2452,661,243,241,2,76,1,0,0,empty,CD-0722-2
"E6,E10",4350,4831,3176,1655,2896,1552,1,1556,1030,526,1.958174905,906,1338,395,142,142,0,47,0,0.021126761,0,empty,CD-0722-2
"E6,E11",5257,6089,3792,2297,3657,2038,0,2040,1241,799,1.553191489,1229,2295,545,216,216,0,55,0,0.064814815,0,empty,CD-0722-2
"E6,E12",6203,7328,4297,3031,4284,2462,0,2462,1542,920,1.676086957,1494,2174,499,241,233,8,74,2,0.081545064,0,empty,CD-0722-2
"E6,F1",7158,8227,5219,3008,4853,2681,0,2690,1647,1043,1.579098754,1591,2213,515,227,221,6,75,2,0.018099548,0,empty,CD-0722-2
"E6,F2",5482,6106,3997,2109,3617,1932,0,1933,1281,652,1.964723926,1103,3183,822,322,317,5,93,3,0.031545741,0,empty,CD-0722-2
"E6,F3",4937,5616,3542,2074,3263,1753,0,1753,1141,612,1.864379085,1031,2600,616,244,240,4,82,3,0.016666667,0,empty,CD-0722-2
"E6,F4",8623,9414,6449,2965,5566,2829,1,2836,1882,954,1.972746331,1577,931,106,52,52,0,33,0,0.076923077,0,empty,CD-0722-2
"E6,F5",5907,6673,4317,2356,3905,2045,0,2047,1333,714,1.866946779,1197,2602,526,190,186,4,59,4,0.021505376,0,empty,CD-0722-2
"E6,F6",6186,7090,4409,2681,4130,2401,0,2404,1513,891,1.698092031,1437,3163,759,319,317,2,77,2,0.028391167,0,empty,CD-0722-2
"E6,F7",6851,7873,5011,2862,4652,2587,0,2588,1690,898,1.881959911,1508,1254,254,100,98,2,33,1,0.010204082,0,empty,CD-0722-2
"E6,F8",5261,6087,3886,2201,3464,1844,0,1845,1238,607,2.039538715,1056,394,128,64,64,0,18,0,0.140625,0,empty,CD-0722-2
"E6,F9",5385,6030,4091,1939,3541,1814,0,1817,1168,649,1.799691834,1000,3256,651,285,283,2,97,2,0.035335689,0,empty,CD-0722-2
"E6,F10",7038,7985,5269,2716,4609,2360,0,2361,1499,862,1.738979118,1320,2173,579,231,225,6,58,3,0.111111111,0,empty,CD-0722-2
"E6,F11",5626,6147,4140,2007,3693,1887,0,1891,1275,616,2.069805195,1055,1787,502,206,206,0,68,0,0.09223301,0,empty,CD-0722-2
"E6,F12",6087,6775,4430,2345,4029,2171,0,2172,1412,760,1.857894737,1235,261,82,38,38,0,12,0,0,0,empty,CD-0722-2
"E6,G1",6317,7051,4707,2344,4139,2223,0,2223,1477,746,1.979892761,1198,3437,764,277,276,1,88,1,0.018115942,0,empty,CD-0722-2
"E6,G2",3868,4170,2679,1491,2503,1436,0,1436,995,441,2.256235828,790,579,74,43,43,0,22,0,0,0,empty,CD-0722-2
"E6,G3",667184,784134,495848,288286,440634,243028,0,243237,186206,57031,3.26499623,144919,128586,16856,6643,6460,183,1177,4,0.060371517,0,hg38,CD-0722-2
"E6,G4",13303,15328,9342,5986,9163,5572,0,5578,3347,2231,1.500224115,3295,103,12,7,7,0,7,0,0,0,empty,CD-0722-2
"E6,G5",4590,5221,3261,1960,3006,1685,0,1686,1111,575,1.932173913,1002,1533,326,141,140,1,51,1,0.007142857,0,empty,CD-0722-2
"E6,G6",613638,688890,466709,222181,387587,201098,1,201273,154046,47227,3.261820569,113326,3893,692,274,273,1,67,1,0.025641026,0,hg38,CD-0722-2
"E6,G7",2141886,2462690,1594595,868095,1365779,779153,1,779846,609676,170170,3.582746665,452588,254525,39381,14992,14706,286,2067,8,0.036175711,0,hg38,CD-0722-2
"E6,G8",3558,3856,2654,1202,2282,1209,0,1209,791,418,1.892344498,623,1939,619,230,227,3,55,1,0.092511013,0,empty,CD-0722-2
"E6,G9",4421,4929,3315,1614,2880,1495,0,1495,953,542,1.758302583,810,2274,565,241,239,2,81,1,0.025104603,0,empty,CD-0722-2
"E6,G10",5495,6367,4108,2259,3701,2008,0,2010,1322,688,1.921511628,1147,2971,888,346,343,3,84,2,0.131195335,0,empty,CD-0722-2
"E6,G11",5429,6141,4038,2103,3633,1939,0,1945,1231,714,1.724089636,1070,1626,545,236,235,1,59,1,0.080851064,0,empty,CD-0722-2
"E6,G12",4569,5417,3312,2105,3173,1801,0,1803,1188,615,1.931707317,1095,2308,652,262,261,1,76,1,0.061302682,0,empty,CD-0722-2
"E6,H1",5024,5524,3749,1775,3250,1735,0,1737,1119,618,1.810679612,937,1605,301,104,99,5,39,1,0.03030303,0,empty,CD-0722-2
"E6,H2",7367,8486,5440,3046,5060,2717,0,2719,1845,874,2.110983982,1619,3162,816,304,304,0,79,0,0.144736842,0,empty,CD-0722-2
"E6,H3",5228,5756,3783,1973,3420,1899,0,1900,1320,580,2.275862069,1057,2896,402,170,168,2,69,2,0.089285714,0,empty,CD-0722-2
"E6,H4",338486,357722,267107,90615,200582,86024,1,86148,66884,19264,3.471968439,45282,975,235,70,69,1,29,1,0.014492754,0,empty,CD-0722-2
"E6,H5",6943,8133,4975,3158,4731,2665,0,2668,1690,978,1.72801636,1638,2308,775,291,288,3,86,2,0.055555556,0,empty,CD-0722-2
"E6,H6",4397,4865,3205,1660,2944,1649,0,1649,1129,520,2.171153846,948,2476,514,211,209,2,68,1,0.157894737,0,empty,CD-0722-2
"E6,H7",5312,6074,3932,2142,3582,1930,1,1931,1253,678,1.848082596,1103,2667,470,226,222,4,71,2,0.09009009,0,empty,CD-0722-2
"E6,H8",5701,6551,4146,2405,3794,2108,0,2108,1358,750,1.810666667,1251,2276,422,187,184,3,63,2,0.02173913,0,empty,CD-0722-2
"E6,H9",612714,718440,455217,263223,406137,226101,1,226254,179739,46515,3.864108352,133528,95067,15896,6165,6078,87,1148,3,0.055939454,0,hg38,CD-0722-2
"E6,H10",4177,4860,3101,1759,2852,1558,1,1564,995,569,1.748681898,900,1417,269,108,106,2,45,1,0.08490566,0,empty,CD-0722-2
"E6,H11",5887,7033,4036,2997,4106,2693,0,2697,1375,1322,1.040090772,1626,44,4,4,4,0,3,0,0,0,empty,CD-0722-2
"E6,H12",4492,5175,3171,2004,2972,1676,0,1681,1115,566,1.969964664,985,1440,287,128,125,3,30,2,0.088,0,empty,CD-0722-2
"E7,A1",3677,4236,2646,1590,2518,1439,0,1439,902,537,1.679702048,821,1601,308,138,137,1,50,1,0.04379562,0,empty,CD-0722-2
"E7,A2",4790,5450,3411,2039,3349,1897,0,1901,1163,738,1.575880759,1117,1553,450,201,197,4,54,2,0.065989848,0,empty,CD-0722-2
"E7,A3",3752,4320,2689,1631,2646,1536,0,1538,1095,443,2.471783296,895,1499,304,145,143,2,43,1,0.034965035,0,empty,CD-0722-2
"E7,A4",630760,716216,483660,232556,410511,211933,1,212150,160819,51331,3.132980071,119621,38099,4867,1891,1846,45,394,4,0.063380282,0,hg38,CD-0722-2
"E7,A5",4540,5300,3380,1920,3125,1710,0,1713,1097,616,1.780844156,981,2188,407,164,152,12,45,3,0.039473684,0,empty,CD-0722-2
"E7,A6",4054,4682,2916,1766,2851,1604,0,1606,1000,606,1.650165017,913,2833,672,291,285,6,111,3,0.105263158,0,empty,CD-0722-2
"E7,A7",3501,3979,2432,1547,2467,1470,0,1470,893,577,1.547660312,882,1492,345,128,124,4,49,2,0.169354839,0,empty,CD-0722-2
"E7,A8",2281,2626,1675,951,1572,869,0,871,614,257,2.389105058,495,2412,756,260,259,1,63,1,0.092664093,0,empty,CD-0722-2
"E7,A9",3589,4024,2674,1350,2393,1278,0,1278,828,450,1.84,683,1833,418,165,162,3,37,1,0.259259259,0,empty,CD-0722-2
"E7,A10",4188,4733,3116,1617,2867,1537,0,1540,933,607,1.537067545,864,504,155,66,64,2,17,2,0,0,empty,CD-0722-2
"E7,A11",3324,3604,2500,1104,2148,1089,0,1089,756,333,2.27027027,560,1945,347,191,184,7,59,2,0.092391304,0,empty,CD-0722-2
"E7,A12",4566,5243,3398,1845,3109,1663,0,1663,1128,535,2.108411215,922,3295,617,289,286,3,109,2,0.027972028,0,empty,CD-0722-2
"E7,B1",4045,4608,2952,1656,2767,1557,0,1560,981,579,1.694300518,926,1415,292,125,124,1,41,1,0.056451613,0,empty,CD-0722-2
"E7,B2",4324,4842,2986,1856,2912,1708,0,1708,1102,606,1.818481848,984,749,200,70,68,2,18,1,0.014705882,0,empty,CD-0722-2
"E7,B3",393424,437099,305905,131194,256357,122866,0,122959,93305,29654,3.14645579,67853,27655,8055,2958,2936,22,546,3,0.039509537,0,hg38,CD-0722-2
"E7,B4",3942,4738,2804,1934,2823,1704,0,1711,1074,637,1.686028257,1050,1508,231,93,91,2,32,2,0.043956044,0,empty,CD-0722-2
"E7,B5",4105,2468,1478,990,1779,1019,0,1023,687,336,2.044642857,658,1353,307,109,109,0,33,0,0.211009174,0,empty,CD-0722-2
"E7,B6",4337,4999,3002,1997,3006,1792,0,1797,1131,666,1.698198198,1064,1962,542,180,176,4,46,1,0.119318182,0,empty,CD-0722-2
"E7,B7",4058,4555,3033,1522,2776,1489,0,1489,981,508,1.931102362,852,1287,287,107,102,5,37,1,0.029411765,0,empty,CD-0722-2
"E7,B8",3071,3369,2268,1101,2029,1055,0,1055,682,373,1.828418231,613,1474,432,204,204,0,55,0,0.093137255,0,empty,CD-0722-2
"E7,B9",5745,6636,4187,2449,3890,2244,0,2246,1427,819,1.742368742,1312,1461,288,104,104,0,42,0,0.048076923,0,empty,CD-0722-2
"E7,B10",2777,3186,1939,1247,1945,1116,0,1117,712,405,1.758024691,687,578,93,44,43,1,15,1,0.046511628,0,empty,CD-0722-2
"E7,B11",8457,9983,6128,3855,5851,3440,0,3440,2099,1341,1.565249814,2051,274,49,19,19,0,8,0,0.052631579,0,empty,CD-0722-2
"E7,B12",3350,3823,2439,1384,2355,1291,0,1294,876,418,2.09569378,767,1821,597,196,194,2,44,2,0.051546392,0,empty,CD-0722-2
"E7,C1",7070,7521,5271,2250,4444,2301,0,2301,1431,870,1.644827586,1217,1142,331,166,166,0,56,0,0.174698795,0,empty,CD-0722-2
"E7,C2",5807,6567,4243,2324,3885,2163,0,2167,1380,787,1.753494282,1206,1992,645,224,224,0,63,0,0.0625,0,empty,CD-0722-2
"E7,C3",1550442,1886188,1120096,766092,1074947,658509,4,659041,502863,156178,3.219806887,400908,156856,18354,7354,7141,213,1274,8,0.06707744,0,hg38,CD-0722-2
"E7,C4",3661,4177,2734,1443,2491,1298,0,1301,863,438,1.970319635,743,1898,490,191,189,2,53,2,0.148148148,0,empty,CD-0722-2
"E7,C5",5354,6128,3930,2198,3741,2085,0,2090,1338,752,1.779255319,1219,1820,378,155,152,3,55,2,0.065789474,0,empty,CD-0722-2
"E7,C6",4806,5390,3546,1844,3269,1800,0,1802,1202,600,2.003333333,1029,1712,375,126,126,0,44,0,0.055555556,0,empty,CD-0722-2
"E7,C7",6060,7217,4297,2920,4285,2531,0,2534,1492,1042,1.431861804,1485,350,109,46,46,0,12,0,0.086956522,0,empty,CD-0722-2
"E7,C8",7090,8022,5143,2879,4858,2696,0,2699,1747,952,1.835084034,1602,3583,773,290,287,3,109,3,0.076655052,0,empty,CD-0722-2
"E7,C9",4618,5361,3425,1936,3146,1723,0,1723,1082,641,1.68798752,977,2015,530,187,182,5,48,2,0.005494505,0,empty,CD-0722-2
"E7,C10",5495,6615,4010,2605,3892,2174,0,2175,1396,779,1.792041078,1321,2173,551,208,208,0,53,0,0.110576923,0,empty,CD-0722-2
"E7,C11",4600,5322,3301,2021,3184,1749,0,1753,1154,599,1.92654424,1032,2181,580,246,240,6,61,2,0.045833333,0,empty,CD-0722-2
"E7,C12",6611,7297,4873,2424,4421,2444,0,2448,1668,780,2.138461538,1354,2111,395,160,157,3,47,2,0.012738854,0,empty,CD-0722-2
"E7,D1",5969,6930,4211,2719,4260,2466,0,2469,1520,949,1.601685985,1489,1155,308,130,129,1,32,1,0.139534884,0,empty,CD-0722-2
"E7,D2",5048,5634,3829,1805,3396,1739,0,1742,1126,616,1.827922078,921,3228,978,396,395,1,106,1,0.144303797,0,empty,CD-0722-2
"E7,D3",4151,4829,3009,1820,2917,1624,0,1630,1102,528,2.087121212,985,1670,383,153,149,4,55,2,0.013422819,0,empty,CD-0722-2
"E7,D4",3274,3961,2410,1551,2277,1248,0,1250,807,443,1.821670429,755,1516,339,134,131,3,47,2,0.015267176,0,empty,CD-0722-2
"E7,D5",512680,620160,371011,249149,361048,210817,1,210949,169394,41555,4.0763807,129052,168030,21758,8520,8336,184,1492,8,0.052303263,0,hg38,CD-0722-2
"E7,D6",6093,7004,4380,2624,4079,2411,0,2413,1439,974,1.477412731,1373,2209,512,232,226,6,62,2,0.084070796,0,empty,CD-0722-2
"E7,D7",3483,4011,2524,1487,2486,1386,0,1386,899,487,1.845995893,825,1884,515,198,197,1,59,1,0.040609137,0,empty,CD-0722-2
"E7,D8",3956,4660,2908,1752,2775,1513,0,1513,983,530,1.854716981,888,1557,458,180,178,2,45,1,0.02247191,0,empty,CD-0722-2
"E7,D9",2534,2820,1904,916,1634,799,0,799,543,256,2.12109375,438,1663,335,150,148,2,45,1,0.054054054,0,empty,CD-0722-2
"E7,D10",4774,5726,3457,2269,3452,2027,0,2029,1364,665,2.05112782,1236,1202,195,96,96,0,36,0,0.197916667,0,empty,CD-0722-2
"E7,D11",476189,539318,366303,173015,311326,156668,1,156802,124030,32772,3.784633223,87415,118109,18535,7042,6919,123,1286,6,0.062870357,0,hg38,CD-0722-2
"E7,D12",5734,6300,4173,2127,3845,2063,0,2065,1323,742,1.783018868,1142,4022,983,405,398,7,123,2,0.092964824,0,empty,CD-0722-2
"E7,E1",6980,7886,5123,2763,4721,2611,0,2614,1662,952,1.745798319,1479,2667,697,292,292,0,76,0,0.065068493,0,empty,CD-0722-2
"E7,E2",4931,5577,3568,2009,3421,1874,1,1879,1201,678,1.771386431,1098,1832,397,146,145,1,49,1,0.082758621,0,empty,CD-0722-2
"E7,E3",3275,3640,2475,1165,2271,1206,0,1206,783,423,1.85106383,675,2167,467,185,181,4,63,2,0.071823204,0,empty,CD-0722-2
"E7,E4",4437,5060,3172,1888,3038,1661,0,1663,1083,580,1.867241379,976,3082,878,320,319,1,83,1,0.053291536,0,empty,CD-0722-2
"E7,E5",4143,4497,3135,1362,2702,1330,0,1337,824,513,1.606237817,731,1754,578,220,219,1,52,1,0.123287671,0,empty,CD-0722-2
"E7,E6",7154,8155,5251,2904,4774,2623,0,2629,1611,1018,1.582514735,1522,4452,896,361,354,7,107,2,0.050847458,0,empty,CD-0722-2
"E7,E7",6223,7113,4611,2502,4228,2301,0,2309,1517,792,1.91540404,1317,3055,498,222,219,3,92,2,0.059360731,0,empty,CD-0722-2
"E7,E8",5302,5863,4103,1760,3515,1800,0,1800,1165,635,1.834645669,995,3119,670,279,276,3,80,2,0.06884058,0,empty,CD-0722-2
"E7,E9",3253,3805,2385,1420,2271,1260,0,1261,824,437,1.885583524,710,2786,551,214,210,4,67,2,0.076190476,0,empty,CD-0722-2
"E7,E10",4249,4868,3112,1756,2900,1616,0,1617,1086,531,2.04519774,935,2003,454,199,198,1,58,1,0.090909091,0,empty,CD-0722-2
"E7,E11",4531,5155,3271,1884,3122,1704,0,1706,1138,568,2.003521127,952,2661,582,220,218,2,64,1,0.027522936,0,empty,CD-0722-2
"E7,E12",5049,5853,3665,2188,3490,1900,0,1900,1245,655,1.900763359,1154,1904,463,187,183,4,64,2,0.18579235,0,empty,CD-0722-2
"E7,F1",5963,6490,4418,2072,3983,2118,0,2119,1319,800,1.64875,1170,1649,364,134,133,1,50,1,0.127819549,0,empty,CD-0722-2
"E7,F2",5742,6544,4137,2407,3998,2179,0,2180,1452,728,1.994505495,1297,2701,733,329,324,5,77,2,0.077160494,0,empty,CD-0722-2
"E7,F3",4250,4978,3115,1863,2990,1644,0,1646,1059,587,1.804088586,969,2560,406,173,170,3,63,2,0.117647059,0,empty,CD-0722-2
"E7,F4",6692,7298,4979,2319,4376,2181,0,2187,1412,775,1.821935484,1195,1109,238,90,87,3,39,2,0,0,empty,CD-0722-2
"E7,F5",487429,524449,378339,146110,302572,139911,3,140070,108640,31430,3.456570156,76064,34143,8192,2940,2902,38,563,2,0.016540317,0,hg38,CD-0722-2
"E7,F6",5514,6648,4028,2620,3817,2221,0,2221,1388,833,1.666266507,1334,3435,751,251,247,4,78,2,0.076923077,0,empty,CD-0722-2
"E7,F7",6078,7051,4505,2546,4221,2287,0,2289,1508,781,1.930857875,1313,1477,357,110,108,2,33,2,0.009259259,0,empty,CD-0722-2
"E7,F8",4344,4929,3164,1765,3006,1592,0,1592,1060,532,1.992481203,920,308,29,21,21,0,12,0,0,0,empty,CD-0722-2
"E7,F9",4905,5603,3624,1979,3385,1788,0,1788,1166,622,1.874598071,1010,3591,876,303,296,7,92,2,0.037162162,0,empty,CD-0722-2
"E7,F10",6124,6928,4636,2292,4138,2145,0,2145,1427,718,1.987465181,1212,1870,410,168,164,4,61,2,0.006097561,0,empty,CD-0722-2
"E7,F11",4756,5196,3641,1555,3155,1585,0,1588,1094,494,2.214574899,834,2080,382,187,186,1,48,1,0.016129032,0,empty,CD-0722-2
"E7,F12",5480,6243,3958,2285,3679,1966,0,1966,1265,701,1.804564907,1180,230,54,25,24,1,10,1,0.083333333,0,empty,CD-0722-2
"E7,G1",5706,6169,4218,1951,3766,1973,0,1973,1273,700,1.818571429,1095,3216,613,274,274,0,80,0,0.047445255,0,empty,CD-0722-2
"E7,G2",3836,4357,2692,1665,2568,1429,0,1432,949,483,1.964803313,839,3149,412,162,152,10,56,3,0.065789474,0,empty,CD-0722-2
"E7,G3",7022,7616,5214,2402,4660,2551,0,2551,1586,965,1.643523316,1358,2299,632,296,294,2,75,2,0.017006803,0,empty,CD-0722-2
"E7,G4",11784,13754,8194,5560,8223,5112,0,5116,3047,2069,1.472692122,3047,121,9,7,6,1,4,1,0.166666667,0,empty,CD-0722-2
"E7,G5",3808,4268,2748,1520,2597,1439,0,1439,950,489,1.942740286,826,2211,517,249,248,1,63,1,0.080645161,0,empty,CD-0722-2
"E7,G6",6070,6819,4454,2365,4020,2186,0,2189,1487,702,2.118233618,1229,140,8,7,7,0,6,0,0,0,empty,CD-0722-2
"E7,G7",4394,4920,3285,1635,2966,1559,0,1563,1055,508,2.076771654,857,3037,836,308,295,13,75,3,0.128813559,0,empty,CD-0722-2
"E7,G8",3283,3674,2427,1247,2186,1134,0,1138,708,430,1.646511628,652,2072,439,208,207,1,78,1,0.106280193,0,empty,CD-0722-2
"E7,G9",867881,1024902,634883,390019,589983,337839,3,338142,268140,70002,3.830461987,203055,310559,46312,17971,17581,390,2465,7,0.056765827,0,hg38,CD-0722-2
"E7,G10",4490,5042,3281,1761,3051,1685,0,1686,1096,590,1.857627119,977,2781,866,303,302,1,70,1,0.069536424,0,empty,CD-0722-2
"E7,G11",477872,554573,348984,205589,322894,183228,1,183360,158261,25099,6.305470337,106760,139984,30811,11613,11450,163,1801,5,0.043144105,0,hg38,CD-0722-2
"E7,G12",4151,4898,3011,1887,2963,1700,0,1700,1146,554,2.068592058,1009,2564,481,227,224,3,75,1,0.022321429,0,empty,CD-0722-2
"E7,H1",497402,614777,349352,265425,360192,224869,2,225043,179991,45052,3.995183344,140373,13708,5244,1862,1858,4,421,2,0.026910657,0,hg38,CD-0722-2
"E7,H2",4975,5698,3695,2003,3393,1763,0,1763,1178,585,2.013675214,999,2464,667,252,246,6,78,2,0.048780488,0,empty,CD-0722-2
"E7,H3",4011,4643,2924,1719,2738,1500,0,1500,1026,474,2.164556962,898,1793,315,129,124,5,51,1,0.080645161,0,empty,CD-0722-2
"E7,H4",598858,712706,440550,272156,407170,229873,1,230043,189952,40091,4.738021002,137064,8618,958,393,385,8,103,2,0.020779221,0,hg38,CD-0722-2
"E7,H5",6423,7162,4695,2467,4213,2303,0,2304,1491,813,1.833948339,1290,2579,569,218,218,0,75,0,0.197247706,0,empty,CD-0722-2
"E7,H6",3633,4053,2599,1454,2449,1391,0,1393,908,485,1.872164948,805,2033,507,200,195,5,60,2,0.01025641,0,empty,CD-0722-2
"E7,H7",4317,4929,3216,1713,2998,1610,0,1610,1064,546,1.948717949,936,2330,766,276,269,7,83,2,0.074349442,0,empty,CD-0722-2
"E7,H8",4641,5470,3290,2180,3331,1895,0,1895,1240,655,1.893129771,1178,2231,424,169,162,7,62,2,0.055555556,0,empty,CD-0722-2
"E7,H9",4107,4553,3019,1534,2775,1461,0,1463,1010,453,2.229580574,840,1372,243,80,79,1,27,1,0.126582278,0,empty,CD-0722-2
"E7,H10",3834,4469,2804,1665,2519,1348,0,1349,902,447,2.017897092,746,1512,327,142,140,2,61,1,0.057142857,0,empty,CD-0722-2
"E7,H11",4368,5172,3015,2157,3179,2061,0,2061,1131,930,1.216129032,1248,43,11,6,6,0,5,0,0,0,empty,CD-0722-2
"E7,H12",3725,4078,2637,1441,2413,1382,0,1386,926,460,2.013043478,779,1708,447,153,152,1,41,1,0.131578947,0,empty,CD-0722-2
"E8,A1",3672,4250,2658,1592,2515,1427,0,1431,956,475,2.012631579,808,1336,229,78,77,1,30,1,0.116883117,0,empty,CD-0722-2
"E8,A2",5436,6005,3975,2030,3655,2066,0,2068,1270,798,1.591478697,1171,1867,481,195,193,2,56,1,0.020725389,0,empty,CD-0722-2
"E8,A3",3367,3886,2468,1418,2328,1293,0,1295,892,403,2.213399504,725,1060,326,172,172,0,44,0,0.005813953,0,empty,CD-0722-2
"E8,A4",5770,6478,4368,2110,3789,2045,0,2047,1298,749,1.732977303,1107,887,246,118,117,1,28,1,0.239316239,0,empty,CD-0722-2
"E8,A5",4754,5522,3515,2007,3229,1780,0,1781,1128,653,1.727411945,974,1737,395,164,158,6,48,2,0.037974684,0,empty,CD-0722-2
"E8,A6",4404,5107,3244,1863,3048,1775,0,1778,1195,583,2.04974271,1046,2521,514,199,195,4,72,1,0.128205128,0,empty,CD-0722-2
"E8,A7",456543,539577,340099,199478,312636,175715,2,175874,141873,34001,4.17261257,102852,100042,10003,4073,3941,132,866,5,0.039076377,0,hg38,CD-0722-2
"E8,A8",2048,2204,1514,690,1343,730,0,730,512,218,2.348623853,390,1560,391,151,151,0,51,0,0.039735099,0,empty,CD-0722-2
"E8,A9",3984,4724,2972,1752,2701,1448,0,1448,931,517,1.800773694,824,1967,293,125,125,0,44,0,0.032,0,empty,CD-0722-2
"E8,A10",319184,377570,235892,141678,218162,122726,0,122806,98326,24480,4.016584967,72223,63281,9965,3888,3785,103,711,4,0.066314399,0,hg38,CD-0722-2
"E8,A11",3397,3936,2598,1338,2301,1215,0,1215,802,413,1.94188862,668,1486,373,142,140,2,51,1,0.021428571,0,empty,CD-0722-2
"E8,A12",5145,5759,3797,1962,3459,1832,0,1833,1225,608,2.014802632,1048,3671,876,314,312,2,80,1,0.064102564,0,empty,CD-0722-2
"E8,B1",4096,4694,2996,1698,2842,1599,0,1601,1020,581,1.755593804,948,1183,275,110,109,1,35,1,0.018348624,0,empty,CD-0722-2
"E8,B2",4071,4545,2800,1745,2807,1640,3,1649,1042,607,1.716639209,973,649,140,54,53,1,20,1,0,0,empty,CD-0722-2
"E8,B3",3654,4235,2648,1587,2561,1422,0,1422,969,453,2.139072848,850,1556,472,192,191,1,59,1,0.151832461,0,empty,CD-0722-2
"E8,B4",33122,36149,23385,12764,21160,11823,0,11841,8928,2913,3.064881565,6779,8522,1123,467,454,13,125,2,0.052863436,0,empty,CD-0722-2
"E8,B5",4166,2522,1503,1019,1847,1039,0,1045,647,398,1.625628141,663,1024,306,127,117,10,36,2,0.068376068,0,empty,CD-0722-2
"E8,B6",4698,5718,3308,2410,3462,2124,0,2127,1355,772,1.755181347,1356,1571,353,117,114,3,40,1,0.149122807,0,empty,CD-0722-2
"E8,B7",3918,4413,2920,1493,2596,1380,0,1382,920,462,1.991341991,761,1753,326,137,136,1,40,1,0.058823529,0,empty,CD-0722-2
"E8,B8",3219,3847,2435,1412,2334,1276,0,1276,838,438,1.913242009,757,882,186,87,86,1,35,1,0,0,empty,CD-0722-2
"E8,B9",6168,7221,4429,2792,4312,2477,0,2480,1584,896,1.767857143,1447,1130,299,97,97,0,29,0,0.12371134,0,empty,CD-0722-2
"E8,B10",2824,3191,2067,1124,2004,1081,0,1087,719,368,1.953804348,643,572,103,35,35,0,13,0,0,0,empty,CD-0722-2
"E8,B11",515333,631632,370682,260950,359461,217024,1,217187,164997,52190,3.161467714,133054,4683,1165,426,423,3,109,2,0.122931442,0,hg38,CD-0722-2
"E8,B12",3711,4222,2661,1561,2534,1394,0,1394,923,471,1.959660297,825,1628,455,173,169,4,42,1,0.153846154,0,empty,CD-0722-2
"E8,C1",6905,7743,5241,2502,4544,2358,0,2360,1537,823,1.867557716,1292,1044,254,97,96,1,25,1,0,0,empty,CD-0722-2
"E8,C2",590601,719346,427032,292314,411322,246667,0,246860,194207,52653,3.688431808,149194,90121,12819,4955,4858,97,962,4,0.040757513,0,hg38,CD-0722-2
"E8,C3",6233,7218,4651,2567,4327,2452,0,2452,1585,867,1.828143022,1389,1056,181,78,76,2,31,1,0.184210526,0,empty,CD-0722-2
"E8,C4",3731,4159,2725,1434,2475,1248,0,1249,851,398,2.138190955,715,1865,341,146,143,3,50,2,0.006993007,0,empty,CD-0722-2
"E8,C5",5406,6241,4017,2224,3747,2042,0,2042,1336,706,1.892351275,1191,1578,288,128,127,1,43,1,0.220472441,0,empty,CD-0722-2
"E8,C6",4721,5333,3451,1882,3270,1821,0,1828,1180,648,1.820987654,1052,1788,509,184,178,6,48,2,0.117977528,0,empty,CD-0722-2
"E8,C7",6381,7709,4613,3096,4563,2768,0,2770,1636,1134,1.442680776,1668,544,137,62,61,1,15,1,0.016393443,0,empty,CD-0722-2
"E8,C8",7060,8039,5239,2800,4818,2596,0,2599,1712,887,1.930101466,1470,2991,796,310,309,1,94,1,0.067961165,0,empty,CD-0722-2
"E8,C9",5005,5953,3650,2303,3494,1945,0,1945,1277,668,1.911676647,1185,1857,392,185,185,0,49,0,0.102702703,0,empty,CD-0722-2
"E8,C10",5411,5957,4004,1953,3486,1805,0,1805,1124,681,1.65051395,993,1503,370,155,153,2,44,2,0.026143791,0,empty,CD-0722-2
"E8,C11",4557,5110,3329,1781,3058,1665,0,1665,1101,564,1.95212766,931,1763,486,173,173,0,60,0,0.104046243,0,empty,CD-0722-2
"E8,C12",7485,8289,5472,2817,4902,2634,0,2634,1705,929,1.835306781,1504,2106,627,243,243,0,62,0,0.111111111,0,empty,CD-0722-2
"E8,D1",9378,11039,6824,4215,6498,3661,0,3666,2236,1430,1.563636364,2195,4678,506,201,197,4,53,2,0.045685279,0,empty,CD-0722-2
"E8,D2",4598,5295,3494,1801,3232,1773,0,1773,1186,587,2.02044293,1019,2344,467,203,199,4,76,2,0.110552764,0,empty,CD-0722-2
"E8,D3",4362,4871,3101,1770,2897,1629,0,1633,1071,562,1.90569395,911,1537,329,132,131,1,37,1,0.236641221,0,empty,CD-0722-2
"E8,D4",3316,3931,2410,1521,2322,1277,0,1280,833,447,1.863534676,762,1338,283,144,144,0,33,0,0.305555556,0,empty,CD-0722-2
"E8,D5",3999,4507,2955,1552,2718,1465,0,1471,934,537,1.739292365,860,1661,381,197,194,3,51,2,0.067010309,0,empty,CD-0722-2
"E8,D6",5929,6836,4139,2697,4070,2448,0,2454,1457,997,1.461384152,1456,1554,362,179,174,5,49,1,0.034482759,0,empty,CD-0722-2
"E8,D7",3436,3880,2468,1412,2347,1250,0,1251,825,426,1.936619718,749,1904,349,151,143,8,42,2,0.167832168,0,empty,CD-0722-2
"E8,D8",613809,746325,443337,302988,427631,255695,0,255907,197356,58551,3.370668306,156107,37513,9923,3693,3657,36,803,3,0.029805852,0,hg38,CD-0722-2
"E8,D9",2256,2639,1648,991,1516,814,0,814,508,306,1.660130719,475,1472,366,159,157,2,47,1,0,0,empty,CD-0722-2
"E8,D10",4130,4796,2980,1816,2857,1621,0,1621,1013,608,1.666118421,975,635,149,64,64,0,22,0,0,0,empty,CD-0722-2
"E8,D11",4835,5473,3560,1913,3260,1799,0,1799,1161,638,1.819749216,1025,3008,955,378,374,4,87,2,0.136363636,0,empty,CD-0722-2
"E8,D12",5732,6515,4163,2352,3920,2164,0,2164,1408,756,1.862433862,1264,3225,737,260,258,2,82,1,0.089147287,0,empty,CD-0722-2
"E8,E1",7386,8310,5359,2951,4850,2723,0,2723,1742,981,1.775739042,1530,2859,598,252,246,6,82,3,0.032520325,0,empty,CD-0722-2
"E8,E2",4830,5488,3375,2113,3240,1838,0,1839,1175,664,1.769578313,1095,1791,441,207,206,1,54,1,0.067961165,0,empty,CD-0722-2
"E8,E3",3126,3482,2311,1171,2139,1159,0,1159,761,398,1.912060302,617,2153,547,231,231,0,65,0,0.021645022,0,empty,CD-0722-2
"E8,E4",4356,5157,3171,1986,3008,1624,0,1624,1070,554,1.931407942,964,2227,493,198,195,3,60,2,0.143589744,0,empty,CD-0722-2
"E8,E5",3944,4341,2969,1372,2703,1405,0,1407,921,486,1.895061728,773,1618,313,135,134,1,38,1,0.194029851,0,empty,CD-0722-2
"E8,E6",431954,420530,361815,58715,234756,72766,0,72851,54338,18513,2.935126668,30531,161063,20176,7749,7573,176,1364,6,0.072098244,0,hg38,CD-0722-2
"E8,E7",6473,6989,4851,2138,4256,2168,0,2168,1434,734,1.953678474,1177,2969,876,325,321,4,84,2,0.099688474,0,empty,CD-0722-2
"E8,E8",7207,8180,5445,2735,4867,2624,0,2627,1827,800,2.28375,1435,3449,1013,373,364,9,81,2,0.206043956,0,empty,CD-0722-2
"E8,E9",3634,4171,2641,1530,2462,1345,0,1347,881,466,1.89055794,792,2028,427,183,181,2,65,2,0.08839779,0,empty,CD-0722-2
"E8,E10",3675,4162,2726,1436,2492,1320,0,1320,826,494,1.672064777,734,1743,303,128,128,0,40,0,0.1171875,0,empty,CD-0722-2
"E8,E11",4680,5272,3441,1831,3193,1721,0,1727,1081,646,1.673374613,967,2124,346,137,137,0,52,0,0.04379562,0,empty,CD-0722-2
"E8,E12",447074,512479,337346,175133,297514,155175,0,155320,121057,34263,3.533169892,90517,107149,14568,5750,5648,102,996,4,0.044263456,0,hg38,CD-0722-2
"E8,F1",510023,587394,380223,207171,337212,182231,1,182409,143964,38445,3.74467421,105967,154897,26834,10623,10463,160,1625,8,0.063652872,0.00625,hg38,CD-0722-2
"E8,F2",4801,5397,3356,2041,3185,1750,0,1755,1105,650,1.7,1000,2544,454,199,197,2,62,1,0.07106599,0,empty,CD-0722-2
"E8,F3",4501,5142,3305,1837,3098,1676,0,1677,1079,598,1.804347826,967,2106,549,218,217,1,50,1,0.078341014,0,empty,CD-0722-2
"E8,F4",618693,700702,467252,233450,405369,211628,3,211803,156162,55641,2.80659945,121220,45390,4978,1780,1711,69,395,5,0.039158387,0,hg38,CD-0722-2
"E8,F5",5117,5697,3849,1848,3380,1780,0,1780,1146,634,1.807570978,961,2097,446,153,151,2,61,2,0.145695364,0,empty,CD-0722-2
"E8,F6",5506,6342,3981,2361,3777,2164,0,2169,1387,782,1.773657289,1260,2709,693,267,265,2,71,2,0.041509434,0,empty,CD-0722-2
"E8,F7",5893,6663,4432,2231,4114,2246,0,2251,1416,835,1.695808383,1318,1214,249,84,81,3,27,1,0.012345679,0,empty,CD-0722-2
"E8,F8",4505,5305,3332,1973,3210,1803,0,1803,1204,599,2.010016694,1086,288,46,29,29,0,15,0,0,0,empty,CD-0722-2
"E8,F9",5356,6056,4050,2006,3631,1874,0,1878,1210,668,1.811377246,1074,2951,875,344,343,1,74,1,0.104956268,0,empty,CD-0722-2
"E8,F10",5898,6492,4427,2065,3806,1981,0,1983,1314,669,1.964125561,1050,1772,480,176,173,3,54,1,0.167630058,0,empty,CD-0722-2
"E8,F11",6703,7393,4783,2610,4403,2343,0,2345,1648,697,2.364418938,1336,4557,814,328,326,2,81,2,0.039877301,0,empty,CD-0722-2
"E8,F12",5510,6135,4040,2095,3581,1918,0,1920,1263,657,1.922374429,1090,527,38,22,21,1,9,1,0.095238095,0,empty,CD-0722-2
"E8,G1",5441,6007,4138,1869,3602,1877,0,1881,1192,689,1.730043541,1050,2814,793,321,320,1,77,1,0.028125,0,empty,CD-0722-2
"E8,G2",4113,4679,2851,1828,2770,1629,0,1631,1032,599,1.722871452,943,768,225,96,95,1,26,1,0.189473684,0,empty,CD-0722-2
"E8,G3",6118,6842,4406,2436,4144,2334,0,2336,1390,946,1.469344609,1301,2143,538,252,250,2,70,1,0.168,0,empty,CD-0722-2
"E8,G4",11143,13031,7949,5082,7753,4727,0,4734,2870,1864,1.539699571,2798,110,12,9,9,0,7,0,0.111111111,0,empty,CD-0722-2
"E8,G5",3602,3952,2608,1344,2438,1332,0,1335,887,448,1.979910714,763,1847,504,173,172,1,45,1,0.122093023,0,empty,CD-0722-2
"E8,G6",1319949,1550139,1009331,540808,868449,474376,1,474789,394214,80575,4.892510084,274433,11965,1825,739,718,21,175,3,0.032033426,0,hg38,CD-0722-2
"E8,G7",4267,4771,3150,1621,2896,1498,0,1498,939,559,1.679785331,867,2200,319,151,145,6,60,2,0.027586207,0,empty,CD-0722-2
"E8,G8",3099,3460,2255,1205,2072,1102,0,1106,738,368,2.005434783,610,1678,463,186,184,2,49,2,0.027173913,0,empty,CD-0722-2
"E8,G9",361206,410443,273031,137412,237546,122866,1,122962,94505,28457,3.320975507,70790,73194,15001,5425,5355,70,938,5,0.028011204,0,hg38,CD-0722-2
"E8,G10",4847,5662,3493,2169,3352,1855,0,1862,1176,686,1.714285714,1133,2106,527,241,234,7,68,3,0.042735043,0,empty,CD-0722-2
"E8,G11",4673,5414,3461,1953,3222,1731,0,1731,1146,585,1.958974359,1008,1394,429,142,136,6,39,2,0.102941176,0,empty,CD-0722-2
"E8,G12",4251,5006,3073,1933,2989,1711,0,1711,1102,609,1.80952381,1039,2420,566,235,234,1,85,1,0.051282051,0,empty,CD-0722-2
"E8,H1",4656,5366,3449,1917,3244,1701,0,1702,1142,560,2.039285714,1005,1292,337,142,142,0,38,0,0.112676056,0,empty,CD-0722-2
"E8,H2",4679,5283,3463,1820,3237,1815,0,1817,1163,654,1.778287462,1063,1893,405,182,181,1,60,1,0.060773481,0,empty,CD-0722-2
"E8,H3",4337,4994,3212,1782,2956,1651,0,1655,1100,555,1.981981982,943,1888,632,213,213,0,54,0,0.084507042,0,empty,CD-0722-2
"E8,H4",5799,6540,4218,2322,3859,2128,0,2130,1386,744,1.862903226,1197,158,40,15,15,0,9,0,0.133333333,0,empty,CD-0722-2
"E8,H5",6157,7118,4491,2627,4165,2315,0,2317,1550,767,2.020860495,1356,2071,622,236,235,1,75,1,0.017021277,0,empty,CD-0722-2
"E8,H6",4057,4635,2922,1713,2695,1504,0,1504,1049,455,2.305494505,854,2261,598,221,220,1,67,1,0.059090909,0,empty,CD-0722-2
"E8,H7",4548,5121,3259,1862,3149,1716,0,1716,1120,596,1.879194631,1024,1911,376,167,166,1,57,1,0.204819277,0,empty,CD-0722-2
"E8,H8",5259,6106,3781,2325,3600,2065,0,2065,1373,692,1.984104046,1235,2738,590,233,232,1,69,1,0.086206897,0,empty,CD-0722-2
"E8,H9",3945,4501,2945,1556,2552,1328,0,1329,929,400,2.3225,754,1399,339,132,131,1,39,1,0.030534351,0,empty,CD-0722-2
"E8,H10",41793,48085,31843,16242,27448,14356,0,14374,10803,3571,3.025203024,8174,6174,1071,468,461,7,124,2,0.075921909,0,empty,CD-0722-2
"E8,H11",5203,6318,3507,2811,3799,2509,0,2510,1320,1190,1.109243697,1533,114,24,12,11,1,3,1,0,0,empty,CD-0722-2
"E8,H12",3732,4361,2666,1695,2642,1509,0,1509,1039,470,2.210638298,916,1614,311,107,102,5,31,1,0.049019608,0,empty,CD-0722-2
"E9,A1",3520,3992,2490,1502,2424,1438,0,1438,939,499,1.881763527,836,1042,184,63,62,1,21,1,0.129032258,0,empty,CD-0722-2
"E9,A2",5244,6241,3787,2454,3734,2166,0,2172,1344,828,1.623188406,1283,2071,432,199,192,7,45,2,0.140625,0,empty,CD-0722-2
"E9,A3",3184,3624,2259,1365,2226,1259,0,1261,838,423,1.98108747,732,1198,386,166,163,3,49,1,0,0,empty,CD-0722-2
"E9,A4",6000,6564,4407,2157,3902,2055,0,2063,1356,707,1.917963225,1096,911,198,76,76,0,29,0,0.065789474,0,empty,CD-0722-2
"E9,A5",4907,5451,3494,1957,3235,1800,0,1802,1107,695,1.592805755,1023,2019,389,156,155,1,51,1,0.006451613,0,empty,CD-0722-2
"E9,A6",403595,473679,303093,170586,271548,148300,4,148413,114914,33499,3.430371056,87041,109065,11980,4829,4672,157,1014,5,0.057577055,0,hg38,CD-0722-2
"E9,A7",3499,3983,2583,1400,2403,1345,0,1345,846,499,1.695390782,743,1071,203,83,81,2,33,2,0.135802469,0,empty,CD-0722-2
"E9,A8",2135,2383,1571,812,1455,799,0,801,531,270,1.966666667,460,1680,435,158,156,2,50,1,0.070512821,0,empty,CD-0722-2
"E9,A9",412390,481476,308190,173286,276370,150777,0,150893,117706,33187,3.546750234,88032,94253,14125,5614,5499,115,1023,5,0.03509729,0,hg38,CD-0722-2
"E9,A10",4191,4424,3130,1294,2601,1333,0,1333,857,476,1.800420168,670,420,127,35,35,0,17,0,0,0,empty,CD-0722-2
"E9,A11",3127,3640,2333,1307,2143,1153,0,1155,731,424,1.724056604,661,1640,285,139,137,2,51,2,0.080291971,0,empty,CD-0722-2
"E9,A12",4625,4965,3424,1541,2964,1523,0,1523,1055,468,2.254273504,826,2913,799,316,305,11,83,2,0.131147541,0,empty,CD-0722-2
"E9,B1",828714,987941,617534,370407,560076,323856,0,324078,269013,55065,4.885371833,189373,31913,9398,3477,3454,23,766,2,0.063404748,0,hg38,CD-0722-2
"E9,B2",4449,5088,3030,2058,3093,1832,0,1832,1076,756,1.423280423,1133,495,58,33,31,2,21,1,0.032258065,0,empty,CD-0722-2
"E9,B3",465933,574239,335158,239081,332449,198050,0,198174,156528,41646,3.758536234,122380,57517,6317,2651,2568,83,577,3,0.03271028,0,hg38,CD-0722-2
"E9,B4",3595,4213,2554,1659,2586,1576,0,1576,969,607,1.596375618,949,1384,428,170,167,3,49,1,0.083832335,0,empty,CD-0722-2
"E9,B5",4104,2538,1508,1030,1862,1071,0,1075,694,381,1.82152231,686,987,148,72,70,2,34,1,0.028571429,0,empty,CD-0722-2
"E9,B6",216057,277950,141805,136145,163055,117459,2,117556,85101,32455,2.622122939,73995,5051,813,313,308,5,77,3,0.042207792,0,hg38,CD-0722-2
"E9,B7",4198,4802,3155,1647,2895,1590,1,1591,996,595,1.67394958,918,1148,430,143,143,0,44,0,0.125874126,0,empty,CD-0722-2
"E9,B8",2942,3401,2179,1222,2078,1111,0,1112,745,367,2.029972752,642,979,240,107,107,0,39,0,0.168224299,0,empty,CD-0722-2
"E9,B9",5760,6717,4095,2622,3877,2259,0,2260,1461,799,1.82853567,1278,1058,226,122,115,7,50,2,0.069565217,0,empty,CD-0722-2
"E9,B10",2624,2971,1819,1152,1900,1039,0,1046,670,376,1.781914894,666,448,67,35,33,2,12,1,0,0,empty,CD-0722-2
"E9,B11",9227,10878,6621,4257,6513,3964,0,3965,2567,1398,1.836194564,2353,365,129,31,31,0,19,0,0.225806452,0,empty,CD-0722-2
"E9,B12",3450,3783,2492,1291,2301,1240,0,1242,826,416,1.985576923,679,1400,278,117,117,0,44,0,0.153846154,0,empty,CD-0722-2
"E9,C1",7169,8033,5345,2688,4722,2478,0,2484,1582,902,1.753880266,1363,771,170,95,93,2,31,2,0,0,empty,CD-0722-2
"E9,C2",1085838,1245336,798570,446766,701371,394149,4,394523,327030,67493,4.845391374,230821,258589,39742,15621,15280,341,2275,8,0.031806283,0,hg38,CD-0722-2
"E9,C3",10086,12037,7089,4948,7225,4440,0,4446,2841,1605,1.770093458,2671,860,167,72,72,0,38,0,0.041666667,0,empty,CD-0722-2
"E9,C4",3682,4147,2684,1463,2562,1369,0,1369,894,475,1.882105263,797,1317,329,136,136,0,44,0,0.044117647,0,empty,CD-0722-2
"E9,C5",5033,5712,3673,2039,3468,1910,0,1922,1223,699,1.749642346,1142,1866,487,190,182,8,47,2,0.021978022,0,empty,CD-0722-2
"E9,C6",4592,5213,3333,1880,3093,1691,0,1695,1102,593,1.858347386,953,1485,338,118,116,2,42,1,0.068965517,0,empty,CD-0722-2
"E9,C7",6215,7137,4430,2707,4302,2592,0,2595,1628,967,1.683557394,1512,464,59,34,33,1,21,1,0.03030303,0,empty,CD-0722-2
"E9,C8",6653,7471,4780,2691,4503,2500,0,2500,1617,883,1.831257078,1442,2839,536,238,235,3,76,1,0.195744681,0,empty,CD-0722-2
"E9,C9",4603,5340,3351,1989,3262,1815,0,1816,1198,618,1.938511327,1068,1518,290,126,126,0,41,0,0.238095238,0,empty,CD-0722-2
"E9,C10",5590,6404,4196,2208,3837,2093,0,2095,1370,725,1.889655172,1147,1967,399,162,161,1,55,1,0.080745342,0,empty,CD-0722-2
"E9,C11",4572,5065,3199,1866,3055,1649,0,1651,1097,554,1.980144404,956,1771,418,172,172,0,61,0,0.11627907,0,empty,CD-0722-2
"E9,C12",6362,7230,4695,2535,4321,2300,0,2302,1489,813,1.831488315,1314,1698,459,207,203,4,53,2,0.073891626,0,empty,CD-0722-2
"E9,D1",5980,6837,4198,2639,4080,2376,0,2376,1402,974,1.439425051,1407,923,160,73,62,11,29,3,0.048387097,0,empty,CD-0722-2
"E9,D2",4925,5363,3672,1691,3156,1596,0,1596,1072,524,2.045801527,878,2366,494,218,214,4,79,2,0.056074766,0,empty,CD-0722-2
"E9,D3",4016,4577,2843,1734,2759,1522,0,1522,998,524,1.904580153,894,1717,427,169,165,4,62,2,0.139393939,0,empty,CD-0722-2
"E9,D4",3950,4553,2903,1650,2694,1454,0,1455,1005,450,2.233333333,832,1385,329,139,136,3,42,2,0,0,empty,CD-0722-2
"E9,D5",3843,4291,2813,1478,2556,1409,0,1411,925,486,1.903292181,802,1861,416,170,165,5,52,2,0.054545455,0,empty,CD-0722-2
"E9,D6",6044,6872,4272,2600,4152,2424,0,2427,1497,930,1.609677419,1413,1491,412,174,174,0,61,0,0.057471264,0,empty,CD-0722-2
"E9,D7",3265,3577,2318,1259,2211,1200,0,1200,819,381,2.149606299,675,2465,592,211,208,3,65,2,0.019230769,0,empty,CD-0722-2
"E9,D8",487181,620327,336064,284263,361096,235179,0,235325,182668,52657,3.469016465,149916,13160,6027,2181,2180,1,505,1,0.044036697,0,hg38,CD-0722-2
"E9,D9",2425,2768,1739,1029,1702,933,0,935,658,277,2.375451264,559,1323,357,128,126,2,38,2,0.015873016,0,empty,CD-0722-2
"E9,D10",3997,4505,2854,1651,2725,1543,0,1543,978,565,1.730973451,899,821,142,62,62,0,33,0,0.016129032,0,empty,CD-0722-2
"E9,D11",4138,4470,3010,1460,2760,1482,0,1486,949,537,1.767225326,810,2355,479,236,233,3,76,2,0.111587983,0,empty,CD-0722-2
"E9,D12",5780,6405,4145,2260,3865,2132,0,2136,1370,766,1.788511749,1247,3037,755,306,303,3,108,1,0.059405941,0,empty,CD-0722-2
"E9,E1",6765,7491,4875,2616,4487,2462,0,2466,1523,943,1.615058324,1399,2343,592,256,254,2,86,1,0.05511811,0,empty,CD-0722-2
"E9,E2",967423,1205549,682420,523129,696375,436111,1,436409,347486,88923,3.907717913,273107,137122,20719,8051,7888,163,1511,8,0.048047667,0,hg38,CD-0722-2
"E9,E3",388868,450074,298467,151607,259822,133530,2,133654,101428,32226,3.147396512,76463,152923,23688,9260,9091,169,1567,4,0.027059729,0,hg38,CD-0722-2
"E9,E4",923354,1035502,701358,334144,586273,303298,4,303606,245053,58553,4.185148498,172636,101358,16417,6550,6429,121,1211,4,0.028931405,0,hg38,CD-0722-2
"E9,E5",4251,4742,3200,1542,2855,1496,0,1498,998,500,1.996,802,1526,387,129,128,1,42,1,0.0234375,0,empty,CD-0722-2
"E9,E6",491467,552405,375980,176425,312983,156924,3,157089,122076,35013,3.486590695,88779,121338,16588,6434,6273,161,1136,6,0.056910569,0,hg38,CD-0722-2
"E9,E7",6489,7424,4825,2599,4343,2289,0,2291,1534,757,2.026420079,1296,2883,843,312,304,8,78,2,0.118421053,0,empty,CD-0722-2
"E9,E8",5250,5982,3895,2087,3633,1913,0,1917,1247,670,1.86119403,1121,2085,397,190,186,4,70,1,0.021505376,0,empty,CD-0722-2
"E9,E9",3464,3957,2469,1488,2332,1287,0,1291,869,422,2.059241706,761,2341,508,231,224,7,67,2,0.165178571,0,empty,CD-0722-2
"E9,E10",3933,4387,2890,1497,2726,1432,0,1436,960,476,2.016806723,833,1471,424,155,154,1,50,1,0.025974026,0,empty,CD-0722-2
"E9,E11",4667,5148,3405,1743,3138,1729,0,1729,1138,591,1.925549915,964,1527,357,149,145,4,50,1,0.04137931,0,empty,CD-0722-2
"E9,E12",5148,5811,3756,2055,3520,1906,0,1911,1213,698,1.73782235,1142,1801,446,234,231,3,74,3,0.060606061,0,empty,CD-0722-2
"E9,F1",5935,6659,4307,2352,4046,2216,1,2217,1415,802,1.764339152,1271,1686,279,127,125,2,58,2,0.048,0,empty,CD-0722-2
"E9,F2",2198842,2789056,1429504,1359552,1590027,1147814,3,1148561,733382,415179,1.766423639,727796,7014,2596,689,681,8,314,2,0.038179148,0,hg38,CD-0722-2
"E9,F3",4474,5148,3231,1917,3028,1647,0,1654,1111,543,2.046040516,977,2515,623,248,243,5,78,1,0.057613169,0,empty,CD-0722-2
"E9,F4",6588,7397,4874,2523,4400,2300,0,2300,1439,861,1.671312427,1283,797,171,84,81,3,29,3,0.148148148,0,empty,CD-0722-2
"E9,F5",5493,6088,4031,2057,3681,1908,0,1909,1230,679,1.811487482,1075,2144,267,151,144,7,61,2,0.013888889,0,empty,CD-0722-2
"E9,F6",5001,5691,3626,2065,3341,1879,0,1879,1151,728,1.581043956,1099,2667,577,236,234,2,70,1,0.08974359,0,empty,CD-0722-2
"E9,F7",5975,6761,4362,2399,4059,2246,0,2249,1461,788,1.854060914,1278,1341,294,129,126,3,42,2,0.087301587,0,empty,CD-0722-2
"E9,F8",4268,4829,3148,1681,2954,1581,0,1582,1061,521,2.03646833,904,475,54,35,34,1,22,1,0.029411765,0,empty,CD-0722-2
"E9,F9",4689,5238,3486,1752,3104,1638,0,1639,1067,572,1.865384615,883,2991,672,258,253,5,74,2,0.102766798,0,empty,CD-0722-2
"E9,F10",6107,6766,4583,2183,4107,2134,0,2134,1385,749,1.849132176,1168,1579,424,196,191,5,47,2,0.09947644,0,empty,CD-0722-2
"E9,F11",4522,5148,3397,1751,3048,1585,0,1587,1078,509,2.117878193,888,1803,487,198,193,5,45,2,0.212435233,0,empty,CD-0722-2
"E9,F12",1153243,1336993,846017,490976,747784,421515,1,421813,343027,78786,4.353908055,248833,13372,1735,658,649,9,178,3,0.055469954,0,hg38,CD-0722-2
"E9,G1",5632,6232,4179,2053,3748,1969,0,1971,1329,642,2.070093458,1092,3136,821,304,303,1,88,1,0.122112211,0,empty,CD-0722-2
"E9,G2",3454,3847,2401,1446,2296,1295,0,1295,821,474,1.732067511,777,665,224,103,103,0,39,0,0.029126214,0,empty,CD-0722-2
"E9,G3",6390,7043,4579,2464,4218,2401,0,2403,1444,959,1.505735141,1346,2613,626,189,184,5,71,3,0.027173913,0,empty,CD-0722-2
"E9,G4",11655,13733,8197,5536,8150,5015,0,5021,3063,1958,1.564351379,3022,205,26,18,18,0,9,0,0,0,empty,CD-0722-2
"E9,G5",4017,4596,2928,1668,2727,1514,0,1515,1018,497,2.048289738,866,1329,372,157,157,0,53,0,0.012738854,0,empty,CD-0722-2
"E9,G6",5778,6376,4213,2163,3775,1981,0,1986,1317,669,1.968609865,1129,201,59,37,37,0,9,0,0.621621622,0,empty,CD-0722-2
"E9,G7",509297,582535,384223,198312,337935,178905,1,179054,141429,37625,3.758910299,102980,129129,17617,6798,6649,149,1260,5,0.042111596,0,hg38,CD-0722-2
"E9,G8",3170,3561,2262,1299,2147,1151,0,1151,764,387,1.974160207,675,1931,586,225,225,0,65,0,0.088888889,0,empty,CD-0722-2
"E9,G9",3652,4118,2709,1409,2437,1271,0,1275,806,469,1.718550107,714,1949,385,163,159,4,59,2,0.044025157,0,empty,CD-0722-2
"E9,G10",4604,5140,3359,1781,3079,1676,0,1677,1091,586,1.861774744,951,2226,320,150,150,0,67,0,0.106666667,0,empty,CD-0722-2
"E9,G11",4756,5360,3504,1856,3163,1740,0,1740,1146,594,1.929292929,979,1399,340,140,139,1,47,1,0.064748201,0,empty,CD-0722-2
"E9,G12",3851,4408,2854,1554,2691,1520,0,1520,961,559,1.719141324,878,2487,452,228,228,0,99,0,0.127192982,0,empty,CD-0722-2
"E9,H1",4075,4692,2986,1706,2809,1501,1,1505,1002,503,1.992047714,857,1696,449,182,180,2,65,2,0.1,0,empty,CD-0722-2
"E9,H2",6575,7526,4918,2608,4514,2417,0,2419,1684,735,2.291156463,1368,2197,476,180,171,9,68,2,0.058479532,0,empty,CD-0722-2
"E9,H3",3750,4303,2671,1632,2587,1419,0,1419,900,519,1.734104046,817,1672,367,160,156,4,59,3,0.128205128,0,empty,CD-0722-2
"E9,H4",791138,969324,561154,408170,547042,354552,2,354806,276782,78024,3.547395673,213878,6483,1183,411,400,11,100,3,0.04,0,hg38,CD-0722-2
"E9,H5",6183,6983,4466,2517,4167,2335,0,2337,1470,867,1.69550173,1317,1955,406,185,183,2,72,1,0.120218579,0,empty,CD-0722-2
"E9,H6",3611,4107,2508,1599,2435,1396,0,1396,931,465,2.002150538,853,2421,612,312,310,2,124,2,0.125806452,0,empty,CD-0722-2
"E9,H7",380501,428876,286798,142078,250188,128850,8,128964,104046,24918,4.175535757,73596,112875,17496,7099,6982,117,1248,6,0.050988256,0,hg38,CD-0722-2
"E9,H8",4898,5697,3598,2099,3328,1863,0,1865,1221,644,1.895962733,1092,1968,422,178,174,4,70,1,0.011494253,0,empty,CD-0722-2
"E9,H9",600915,708589,442352,266237,403836,226352,2,226536,183316,43220,4.241462286,134131,139307,19078,7781,7625,156,1371,9,0.079081967,0,hg38,CD-0722-2
"E9,H10",4696,4895,3203,1692,2910,1574,0,1575,1057,518,2.040540541,895,1900,363,178,176,2,75,1,0.085227273,0,empty,CD-0722-2
"E9,H11",4629,5574,3082,2492,3331,2221,0,2221,1159,1062,1.0913371,1403,112,52,13,13,0,4,0,0,0,empty,CD-0722-2
"E9,H12",3546,3882,2542,1340,2369,1362,1,1363,892,471,1.893842887,773,1473,225,97,95,2,48,1,0.052631579,0,empty,CD-0722-2
"E10,A1",2797,3223,2024,1199,1964,1102,0,1102,715,387,1.84754522,637,1249,269,80,79,1,12,1,0.303797468,0,empty,CD-0722-2
"E10,A2",4249,4918,3124,1794,2969,1674,3,1677,1033,644,1.604037267,987,2200,484,169,169,0,56,0,0.100591716,0,empty,CD-0722-2
"E10,A3",2833,3317,2017,1300,1906,1058,0,1058,705,353,1.997167139,621,1618,485,147,141,6,40,2,0.028368794,0,empty,CD-0722-2
"E10,A4",4259,4617,3129,1488,2776,1466,0,1468,1013,455,2.226373626,779,1123,237,85,85,0,33,0,0.223529412,0,empty,CD-0722-2
"E10,A5",236505,260690,182033,78657,152486,73194,0,73261,57968,15293,3.790492382,41001,55186,9220,3434,3342,92,677,3,0.038599641,0,hg38,CD-0722-2
"E10,A6",3529,4082,2597,1485,2382,1328,0,1328,881,447,1.970917226,746,3179,637,243,242,1,85,1,0.136363636,0,empty,CD-0722-2
"E10,A7",2861,3250,2106,1144,1963,1095,0,1095,681,414,1.644927536,639,1423,288,146,142,4,41,2,0.126760563,0,empty,CD-0722-2
"E10,A8",1664,1914,1234,680,1153,624,0,624,431,193,2.233160622,358,1994,434,186,185,1,52,1,0.12972973,0,empty,CD-0722-2
"E10,A9",2896,3286,2181,1105,2005,1054,0,1054,704,350,2.011428571,578,2107,459,136,134,2,41,2,0.097014925,0,empty,CD-0722-2
"E10,A10",3654,4063,2761,1302,2436,1266,0,1266,815,451,1.807095344,689,347,21,18,18,0,14,0,0.055555556,0,empty,CD-0722-2
"E10,A11",2595,2883,1875,1008,1733,922,0,922,608,314,1.936305732,524,1709,312,123,121,2,44,2,0.123966942,0,empty,CD-0722-2
"E10,A12",3989,4378,2930,1448,2608,1385,0,1385,860,525,1.638095238,782,3629,743,295,292,3,82,1,0.099315068,0,empty,CD-0722-2
"E10,B1",3214,3623,2344,1279,2116,1171,0,1171,692,479,1.444676409,661,1206,325,118,116,2,44,1,0.017241379,0,empty,CD-0722-2
"E10,B2",3200,3649,2146,1503,2196,1302,0,1302,816,486,1.679012346,810,999,146,56,55,1,16,1,0.127272727,0,empty,CD-0722-2
"E10,B3",365564,432293,272300,159993,250904,138814,2,138944,101915,37029,2.75230225,82897,93623,11007,4342,4235,107,881,5,0.035419126,0,hg38,CD-0722-2
"E10,B4",3267,3864,2335,1529,2278,1346,0,1349,824,525,1.56952381,803,1364,299,129,129,0,36,0,0,0,empty,CD-0722-2
"E10,B5",9011,8733,5541,3192,5294,2838,1,2846,2129,717,2.969316597,1702,1273,368,129,125,4,40,2,0.184,0,empty,CD-0722-2
"E10,B6",3696,4367,2644,1723,2592,1543,0,1543,941,602,1.563122924,900,1986,387,124,123,1,43,1,0.048780488,0,empty,CD-0722-2
"E10,B7",3011,3486,2191,1295,2141,1218,0,1219,801,418,1.916267943,715,1484,310,106,103,3,33,1,0.058252427,0,empty,CD-0722-2
"E10,B8",2416,2882,1736,1146,1665,921,0,921,589,332,1.774096386,545,1260,239,76,75,1,35,1,0.026666667,0,empty,CD-0722-2
"E10,B9",4678,5276,3538,1738,3097,1674,0,1675,1055,620,1.701612903,894,1117,302,137,135,2,46,2,0.155555556,0,empty,CD-0722-2
"E10,B10",2096,2199,1506,693,1387,723,0,724,452,272,1.661764706,395,670,178,67,67,0,24,0,0.089552239,0,empty,CD-0722-2
"E10,B11",5132,5832,3662,2170,3550,2149,0,2151,1231,920,1.338043478,1231,231,59,33,33,0,16,0,0.060606061,0,empty,CD-0722-2
"E10,B12",353589,462009,242260,219749,271674,182346,5,182453,144889,37564,3.857123842,116994,13566,4619,1660,1646,14,457,3,0.016403402,0,hg38,CD-0722-2
"E10,C1",5299,5860,4012,1848,3473,1807,0,1809,1173,636,1.844339623,966,1354,515,178,178,0,40,0,0.011235955,0,empty,CD-0722-2
"E10,C2",4448,5140,3163,1977,3124,1794,0,1796,1170,626,1.869009585,1081,2754,645,262,260,2,67,1,0.057692308,0,empty,CD-0722-2
"E10,C3",5340,6194,3921,2273,3641,1995,0,1995,1324,671,1.973174367,1140,1046,84,38,38,0,20,0,0.026315789,0,empty,CD-0722-2
"E10,C4",2834,3139,2078,1061,1934,990,0,991,651,340,1.914705882,574,2353,603,254,250,4,52,2,0.2,0,empty,CD-0722-2
"E10,C5",3884,4445,2844,1601,2689,1422,0,1422,942,480,1.9625,815,1500,406,139,137,2,49,1,0.072992701,0,empty,CD-0722-2
"E10,C6",3479,3915,2520,1395,2374,1253,0,1259,862,397,2.171284635,716,1567,419,169,166,3,51,1,0.060240964,0,empty,CD-0722-2
"E10,C7",5058,6131,3566,2565,3576,2176,0,2177,1327,850,1.561176471,1315,563,175,71,70,1,14,1,0.271428571,0,empty,CD-0722-2
"E10,C8",5594,6471,4173,2298,3767,1978,0,1979,1265,714,1.771708683,1106,3226,728,351,349,2,111,2,0.037249284,0,empty,CD-0722-2
"E10,C9",763907,890183,578278,311905,508639,275820,1,276026,220122,55904,3.9375,161052,107079,15970,5975,5832,143,1098,6,0.03377915,0,hg38,CD-0722-2
"E10,C10",4096,4605,3055,1550,2781,1544,0,1546,1004,542,1.852398524,841,1986,461,173,171,2,48,1,0.058479532,0,empty,CD-0722-2
"E10,C11",3604,4192,2578,1614,2494,1426,0,1426,947,479,1.977035491,833,2349,497,165,157,8,49,2,0.108280255,0,empty,CD-0722-2
"E10,C12",5505,6102,4006,2096,3585,1919,0,1920,1260,660,1.909090909,1057,1921,625,210,209,1,57,1,0.052631579,0,empty,CD-0722-2
"E10,D1",92708,124003,55876,68127,74805,57697,0,57729,19049,38680,0.492476732,38256,4149,1740,240,238,2,79,2,0.029411765,0,empty,CD-0722-2
"E10,D2",3618,4054,2743,1311,2387,1223,0,1225,743,482,1.541493776,638,3498,950,344,342,2,100,1,0.078947368,0,empty,CD-0722-2
"E10,D3",3359,3740,2494,1246,2273,1255,0,1255,853,402,2.121890547,685,1645,282,106,103,3,41,2,0.165048544,0,empty,CD-0722-2
"E10,D4",3105,3512,2344,1168,2148,1180,0,1180,765,415,1.843373494,662,1623,380,133,131,2,39,1,0.091603053,0,empty,CD-0722-2
"E10,D5",3054,3449,2205,1244,2116,1170,0,1172,782,390,2.005128205,673,1633,319,146,146,0,51,0,0.089041096,0,empty,CD-0722-2
"E10,D6",4609,5262,3201,2061,3182,1876,0,1876,1112,764,1.455497382,1144,1992,435,169,167,2,61,2,0.05988024,0,empty,CD-0722-2
"E10,D7",2813,3167,2071,1096,1866,987,0,989,664,325,2.043076923,579,2093,564,247,246,1,79,1,0.24796748,0,empty,CD-0722-2
"E10,D8",6525,7521,5024,2497,4420,2255,0,2258,1618,640,2.528125,1266,6003,1125,460,449,11,120,3,0.028953229,0,empty,CD-0722-2
"E10,D9",1654,1813,1186,627,1120,579,0,579,399,180,2.216666667,319,1617,339,147,145,2,45,1,0.006896552,0,empty,CD-0722-2
"E10,D10",2959,3407,2095,1312,2059,1164,0,1164,771,393,1.961832061,730,1169,208,92,86,6,33,3,0.046511628,0,empty,CD-0722-2
"E10,D11",3514,3943,2617,1326,2386,1237,0,1237,734,503,1.459244533,711,3153,839,309,305,4,83,1,0.108196721,0,empty,CD-0722-2
"E10,D12",4264,4905,3084,1821,2961,1639,0,1641,1062,579,1.834196891,965,3925,1050,448,445,3,119,1,0.065168539,0,empty,CD-0722-2
"E10,E1",5302,5909,3879,2030,3563,1967,0,1972,1175,797,1.474278545,1112,2599,477,184,183,1,65,1,0.163934426,0,empty,CD-0722-2
"E10,E2",3804,4278,2735,1543,2586,1397,0,1397,856,541,1.582255083,800,2692,582,215,209,6,60,2,0.119617225,0,empty,CD-0722-2
"E10,E3",2614,2971,1894,1077,1829,1028,0,1028,668,360,1.855555556,604,2245,548,198,197,1,62,1,0.060913706,0,empty,CD-0722-2
"E10,E4",3552,4056,2614,1442,2408,1322,0,1326,881,445,1.979775281,754,2323,589,234,230,4,90,2,0.047826087,0,empty,CD-0722-2
"E10,E5",3232,3659,2403,1256,2147,1115,0,1116,718,398,1.804020101,586,1573,357,132,130,2,50,2,0.046153846,0,empty,CD-0722-2
"E10,E6",5840,6592,4212,2380,3933,2167,0,2167,1369,798,1.715538847,1298,3767,1070,377,376,1,88,1,0.109042553,0,empty,CD-0722-2
"E10,E7",5199,5769,3787,1982,3467,1847,0,1848,1227,621,1.975845411,1057,3554,791,302,301,1,91,1,0.102990033,0,empty,CD-0722-2
"E10,E8",3935,4489,2911,1578,2745,1421,0,1421,916,505,1.813861386,849,3210,730,322,316,6,86,3,0.091772152,0,empty,CD-0722-2
"E10,E9",2981,3271,2200,1071,1975,1043,0,1049,720,329,2.188449848,588,2511,642,248,247,1,75,1,0.165991903,0,empty,CD-0722-2
"E10,E10",2728,2985,2061,924,1849,958,0,958,616,342,1.801169591,500,2088,604,246,243,3,56,2,0.004115226,0,empty,CD-0722-2
"E10,E11",299955,321838,238589,83249,187015,81262,0,81359,65566,15793,4.151586146,42763,60266,19430,6656,6583,73,1036,4,0.016709707,0,hg38,CD-0722-2
"E10,E12",647209,752405,481971,270434,434199,236493,0,236701,185420,51281,3.615764123,139809,156867,21799,8422,8195,227,1486,5,0.038194021,0,hg38,CD-0722-2
"E10,F1",314402,349589,241950,107639,202675,100553,0,100634,76846,23788,3.230452329,56543,20144,4481,1614,1589,25,398,3,0.04279421,0,hg38,CD-0722-2
"E10,F2",359594,417126,267884,149242,241103,129748,2,129886,101116,28770,3.514633299,76230,185968,20081,7531,7345,186,1400,9,0.040571818,0,hg38,CD-0722-2
"E10,F3",422016,491473,317090,174383,282688,151870,0,151991,117009,34982,3.344834486,88283,200685,32684,12661,12404,257,1845,4,0.047081587,0,hg38,CD-0722-2
"E10,F4",5238,5734,3847,1887,3500,1862,0,1862,1265,597,2.118927973,1007,875,131,70,67,3,26,1,0.059701493,0,empty,CD-0722-2
"E10,F5",798308,984089,543048,441041,571862,383264,1,383495,323296,60199,5.370454659,237951,35520,7180,2419,2378,41,580,6,0.013877208,0,hg38,CD-0722-2
"E10,F6",4120,4826,2946,1880,2911,1691,0,1691,1094,597,1.832495812,1049,2780,725,209,203,6,55,1,0.014778325,0,empty,CD-0722-2
"E10,F7",4516,5154,3295,1859,3104,1703,0,1703,1103,600,1.838333333,998,1209,290,106,104,2,27,2,0.105769231,0,empty,CD-0722-2
"E10,F8",3414,3787,2555,1232,2241,1181,0,1181,782,399,1.959899749,634,378,34,27,27,0,17,0,0.074074074,0,empty,CD-0722-2
"E10,F9",3897,4373,2971,1402,2592,1301,0,1304,848,456,1.859649123,716,3159,777,317,311,6,84,2,0.077170418,0,empty,CD-0722-2
"E10,F10",4591,5118,3359,1759,3031,1612,0,1616,1011,605,1.67107438,918,1960,433,186,182,4,51,1,0.115384615,0,empty,CD-0722-2
"E10,F11",3946,4426,3014,1412,2618,1321,0,1323,856,467,1.832976445,709,1714,364,133,133,0,46,0,0.060150376,0,empty,CD-0722-2
"E10,F12",417512,494219,304292,189927,282142,160386,2,160515,129804,30711,4.226628895,96359,7698,1523,605,594,11,136,2,0.043771044,0,hg38,CD-0722-2
"E10,G1",3965,4526,2994,1532,2745,1421,0,1423,909,514,1.76848249,794,3038,663,284,280,4,87,2,0.028571429,0,empty,CD-0722-2
"E10,G2",2707,3044,1908,1136,1892,1088,0,1090,708,382,1.853403141,637,803,247,84,82,2,26,1,0.182926829,0,empty,CD-0722-2
"E10,G3",6084,6886,4345,2541,4114,2378,0,2382,1609,773,2.081500647,1375,2543,549,240,237,3,65,1,0.156118143,0,empty,CD-0722-2
"E10,G4",8749,10023,6111,3912,5995,3571,0,3574,2136,1438,1.485396384,2111,105,15,10,10,0,8,0,0.4,0,empty,CD-0722-2
"E10,G5",2805,3234,2026,1208,1945,1104,0,1104,680,424,1.603773585,679,2221,619,274,272,2,54,2,0.088235294,0,empty,CD-0722-2
"E10,G6",4128,4422,3125,1297,2694,1382,0,1382,954,428,2.228971963,725,169,37,22,17,5,11,1,0,0,empty,CD-0722-2
"E10,G7",324558,379303,239002,140301,222292,129760,0,129854,102021,27833,3.665469048,74808,56344,15224,5225,5168,57,911,3,0.011609907,0,hg38,CD-0722-2
"E10,G8",326050,380704,244335,136369,219538,118415,2,118504,93153,25351,3.674529604,69902,101761,13844,5542,5443,99,1051,5,0.052177108,0,hg38,CD-0722-2
"E10,G9",3066,3521,2219,1302,2093,1122,0,1122,705,417,1.690647482,645,2653,440,170,166,4,56,2,0.06626506,0,empty,CD-0722-2
"E10,G10",3874,4229,2814,1415,2582,1418,0,1418,889,529,1.680529301,774,2858,691,271,268,3,73,2,0.059701493,0,empty,CD-0722-2
"E10,G11",3583,4085,2655,1430,2493,1323,0,1323,862,461,1.869848156,763,1609,397,171,169,2,54,2,0.01183432,0,empty,CD-0722-2
"E10,G12",3274,3627,2368,1259,2283,1221,0,1223,832,391,2.127877238,728,2411,515,212,210,2,81,1,0.147619048,0,empty,CD-0722-2
"E10,H1",3632,4019,2686,1333,2364,1265,0,1266,849,417,2.035971223,677,1487,319,143,141,2,52,1,0.035460993,0,empty,CD-0722-2
"E10,H2",3543,4081,2580,1501,2465,1373,0,1376,862,514,1.677042802,810,2500,683,257,245,12,63,2,0.228571429,0,empty,CD-0722-2
"E10,H3",2910,3320,2121,1199,2027,1111,0,1111,719,392,1.834183673,659,1614,348,131,130,1,52,1,0.007692308,0,empty,CD-0722-2
"E10,H4",4451,5079,3245,1834,3005,1617,0,1617,1063,554,1.918772563,963,262,69,46,46,0,19,0,0.282608696,0,empty,CD-0722-2
"E10,H5",4506,4875,3221,1654,2986,1629,0,1630,1097,533,2.058161351,939,2093,491,228,226,2,75,1,0.048672566,0,empty,CD-0722-2
"E10,H6",3018,3455,2123,1332,2063,1163,0,1164,793,371,2.137466307,702,2087,452,159,151,8,50,2,0.105960265,0,empty,CD-0722-2
"E10,H7",3438,3842,2591,1251,2296,1241,0,1241,860,381,2.257217848,644,2425,609,226,225,1,79,1,0.022222222,0,empty,CD-0722-2
"E10,H8",3918,4613,2810,1803,2721,1537,0,1539,958,581,1.648881239,920,1986,405,188,182,6,62,2,0.126373626,0,empty,CD-0722-2
"E10,H9",3109,3581,2266,1315,2097,1109,0,1110,737,373,1.975871314,637,1193,250,83,82,1,32,1,0.12195122,0,empty,CD-0722-2
"E10,H10",3135,3634,2321,1313,2110,1147,0,1150,771,379,2.034300792,679,1672,324,154,152,2,48,1,0.125,0,empty,CD-0722-2
"E10,H11",3740,4301,2654,1647,2640,1685,0,1685,875,810,1.080246914,985,143,10,10,10,0,6,0,0,0,empty,CD-0722-2
"E10,H12",2978,3377,2146,1231,2034,1137,3,1141,774,367,2.108991826,673,1727,296,127,123,4,43,1,0.146341463,0,empty,CD-0722-2
"E11,A1",3608,4037,2609,1428,2467,1412,0,1413,916,497,1.84305835,797,1626,279,130,126,4,49,2,0.126984127,0,empty,CD-0722-2
"E11,A2",5587,6402,4098,2304,3855,2170,0,2170,1440,730,1.97260274,1257,2214,450,202,201,1,67,1,0,0,empty,CD-0722-2
"E11,A3",3208,3554,2373,1181,2205,1201,0,1201,783,418,1.873205742,692,1627,282,136,133,3,64,1,0.187969925,0,empty,CD-0722-2
"E11,A4",1591359,1859374,1188315,671059,1035955,591975,3,592435,479445,112990,4.243251615,345039,64093,9215,3839,3761,78,736,4,0.054772667,0,hg38,CD-0722-2
"E11,A5",4688,5396,3498,1898,3254,1768,0,1768,1145,623,1.83788122,1028,2345,489,220,217,3,61,1,0.032258065,0,empty,CD-0722-2
"E11,A6",4125,4730,2949,1781,2955,1668,0,1668,1088,580,1.875862069,1006,3632,896,369,362,7,116,2,0.085635359,0,empty,CD-0722-2
"E11,A7",3742,4470,2757,1713,2714,1611,0,1611,1034,577,1.79202773,974,1735,361,193,193,0,73,0,0.082901554,0,empty,CD-0722-2
"E11,A8",2237,2421,1677,744,1523,814,0,814,543,271,2.003690037,429,2112,468,189,189,0,68,0,0.026455026,0,empty,CD-0722-2
"E11,A9",5994,6982,4463,2519,4192,2345,0,2357,1705,652,2.615030675,1355,2265,506,167,166,1,65,1,0.072289157,0,empty,CD-0722-2
"E11,A10",4309,4827,3215,1612,2826,1509,0,1515,949,566,1.676678445,846,466,138,38,37,1,25,1,0.162162162,0,empty,CD-0722-2
"E11,A11",855539,1005666,638661,367005,575312,322753,3,323035,254923,68112,3.742703195,188008,262342,42789,16166,15841,325,2382,9,0.036929487,0,hg38,CD-0722-2
"E11,A12",4618,5205,3441,1764,3071,1590,0,1593,1011,582,1.737113402,911,3455,784,316,311,5,112,2,0.035369775,0,empty,CD-0722-2
"E11,B1",3840,4435,2763,1672,2634,1481,0,1483,909,574,1.583623693,844,975,169,76,76,0,45,0,0.013157895,0,empty,CD-0722-2
"E11,B2",4462,5155,3101,2054,3072,1846,0,1848,1182,666,1.774774775,1049,775,185,87,87,0,28,0,0.057471264,0,empty,CD-0722-2
"E11,B3",981990,1175092,711961,463131,678758,400304,4,400576,328339,72237,4.545302269,242895,179616,24257,9360,9158,202,1643,5,0.037016816,0,hg38,CD-0722-2
"E11,B4",3855,4389,2703,1686,2680,1495,0,1496,962,534,1.801498127,915,1684,447,160,156,4,55,2,0.096153846,0,empty,CD-0722-2
"E11,B5",6228,4611,3060,1551,3112,1635,0,1644,1145,499,2.294589178,962,1387,234,108,107,1,47,1,0.280373832,0,empty,CD-0722-2
"E11,B6",4357,5058,3026,2032,3074,1845,0,1847,1162,685,1.696350365,1130,1861,416,180,179,1,54,1,0.072625698,0,empty,CD-0722-2
"E11,B7",610570,735850,445740,290110,425707,249732,2,249901,198412,51489,3.853483268,150246,100469,14152,5326,5206,120,1015,4,0.050710718,0,hg38,CD-0722-2
"E11,B8",2797,3154,2021,1133,1934,1060,0,1060,711,349,2.037249284,607,1593,228,87,86,1,48,1,0.162790698,0,empty,CD-0722-2
"E11,B9",405336,478292,297932,180360,278035,157869,2,157980,126617,31363,4.037145681,94203,9328,3306,1293,1288,5,299,2,0.033385093,0,hg38,CD-0722-2
"E11,B10",771178,785040,556774,228266,469088,219532,19,220498,168224,52274,3.218119907,123305,123200,12348,4993,4866,127,970,8,0.063090834,0,hg38,CD-0722-2
"E11,B11",7257,8252,5233,3019,4864,2871,0,2874,1626,1248,1.302884615,1633,365,18,15,15,0,9,0,0.266666667,0,empty,CD-0722-2
"E11,B12",625828,734876,470430,264446,426434,235553,2,235764,188808,46956,4.020955788,137513,239864,40690,15669,15390,279,2124,8,0.041975309,0,hg38,CD-0722-2
"E11,C1",10471,11403,8047,3356,6793,3432,0,3432,2297,1135,2.023788546,1872,3279,602,237,228,9,62,2,0.118421053,0,empty,CD-0722-2
"E11,C2",6051,6690,4276,2414,4055,2310,0,2311,1536,775,1.981935484,1295,2170,507,232,229,3,71,2,0.091703057,0,empty,CD-0722-2
"E11,C3",7089,7869,5149,2720,4837,2654,0,2656,1731,925,1.871351351,1508,1198,222,107,105,2,34,2,0.171428571,0,empty,CD-0722-2
"E11,C4",383628,426082,296451,129631,248563,120447,0,120553,97437,23116,4.215132376,66686,39843,9807,3685,3657,28,659,3,0.022149303,0,hg38,CD-0722-2
"E11,C5",5065,5696,3717,1979,3442,1852,0,1853,1231,622,1.979099678,1082,2380,578,246,235,11,76,2,0.055319149,0,empty,CD-0722-2
"E11,C6",4488,5101,3281,1820,3043,1693,0,1693,1156,537,2.152700186,927,1921,490,160,160,0,49,0,0.04375,0,empty,CD-0722-2
"E11,C7",7324,8528,5172,3356,5113,3017,0,3017,1855,1162,1.596385542,1821,896,146,61,61,0,22,0,0,0,empty,CD-0722-2
"E11,C8",6793,7743,4923,2820,4623,2604,0,2607,1723,884,1.949095023,1493,3485,739,346,345,1,137,1,0.020289855,0,empty,CD-0722-2
"E11,C9",4627,5431,3410,2021,3213,1786,0,1786,1179,607,1.942339374,1048,1909,333,151,151,0,57,0,0.01986755,0,empty,CD-0722-2
"E11,C10",5584,6364,3990,2374,3814,2108,0,2112,1302,810,1.607407407,1246,2201,388,202,201,1,68,1,0.109452736,0,empty,CD-0722-2
"E11,C11",4400,5057,3174,1883,3108,1714,0,1714,1112,602,1.84717608,996,2640,658,294,293,1,97,1,0.017064846,0,empty,CD-0722-2
"E11,C12",6275,7002,4468,2534,4291,2333,0,2333,1520,813,1.869618696,1362,2644,714,266,264,2,85,1,0.128787879,0,empty,CD-0722-2
"E11,D1",5695,6633,4056,2577,3963,2340,0,2342,1431,911,1.570801317,1412,1126,214,80,78,2,40,2,0.230769231,0,empty,CD-0722-2
"E11,D2",6334,7214,4766,2448,4253,2153,0,2160,1406,754,1.864721485,1241,3951,1138,453,452,1,134,1,0.050884956,0,empty,CD-0722-2
"E11,D3",4025,4629,2960,1669,2857,1586,0,1588,1021,567,1.800705467,910,1786,416,157,156,1,63,1,0.044871795,0,empty,CD-0722-2
"E11,D4",3327,3847,2435,1412,2325,1294,1,1295,839,456,1.839912281,740,1999,519,216,213,3,61,2,0.056338028,0,empty,CD-0722-2
"E11,D5",3951,4408,2732,1676,2622,1471,0,1471,981,490,2.002040816,852,2181,545,211,209,2,69,1,0.09569378,0,empty,CD-0722-2
"E11,D6",5940,6676,4190,2486,4082,2414,0,2418,1521,897,1.695652174,1417,2332,397,197,194,3,63,2,0.12371134,0,empty,CD-0722-2
"E11,D7",452134,529345,334515,194830,305264,168575,0,168730,133819,34911,3.833147146,99799,184883,26378,10265,10046,219,1696,9,0.038025085,0,hg38,CD-0722-2
"E11,D8",3899,4522,2791,1731,2754,1556,0,1557,1001,556,1.800359712,922,1559,363,172,170,2,66,1,0.070588235,0,empty,CD-0722-2
"E11,D9",334472,404199,240104,164095,234206,138422,2,138549,113385,25164,4.505841679,83786,111301,21978,8192,8052,140,1461,5,0.029806259,0,hg38,CD-0722-2
"E11,D10",4094,4745,2867,1878,2837,1633,0,1633,1048,585,1.791452991,956,1288,317,99,99,0,39,0,0.121212121,0,empty,CD-0722-2
"E11,D11",5299,5982,3877,2105,3613,1980,0,1983,1260,723,1.742738589,1155,3818,786,301,295,6,112,3,0.040677966,0,empty,CD-0722-2
"E11,D12",6073,6860,4347,2513,4222,2388,0,2389,1552,837,1.854241338,1414,4388,905,427,421,6,163,2,0.054631829,0,empty,CD-0722-2
"E11,E1",9079,10565,6693,3872,6174,3417,0,3418,2283,1135,2.011453744,1990,3175,950,350,348,2,105,2,0.040229885,0,empty,CD-0722-2
"E11,E2",399269,465640,295872,169768,271585,149520,0,149622,119355,30267,3.943403707,88324,122892,14114,5701,5543,158,1139,6,0.07523002,0,hg38,CD-0722-2
"E11,E3",3258,3608,2404,1204,2155,1124,0,1125,720,405,1.777777778,620,2621,577,235,229,6,73,2,0.104803493,0,empty,CD-0722-2
"E11,E4",4539,5040,3288,1752,3066,1664,0,1664,1102,562,1.960854093,939,2836,725,303,295,8,97,1,0.047457627,0,empty,CD-0722-2
"E11,E5",4147,4472,3129,1343,2782,1421,0,1424,931,493,1.888438134,759,1449,373,155,154,1,50,1,0.012987013,0,empty,CD-0722-2
"E11,E6",721338,846504,540563,305941,480312,268118,0,268354,214268,54086,3.961616685,156057,182657,32647,12798,12624,174,2041,6,0.054737009,0,hg38,CD-0722-2
"E11,E7",6248,6932,4682,2250,4126,2145,1,2152,1408,744,1.892473118,1188,3609,823,352,350,2,122,1,0.071428571,0,empty,CD-0722-2
"E11,E8",5165,5669,3914,1755,3446,1819,0,1819,1109,710,1.561971831,957,3036,874,314,312,2,90,2,0.032051282,0,empty,CD-0722-2
"E11,E9",3002,3336,2205,1131,2004,1072,0,1072,744,328,2.268292683,590,3571,826,333,325,8,101,2,0.027692308,0,empty,CD-0722-2
"E11,E10",3978,4479,2838,1641,2647,1410,0,1410,906,504,1.797619048,835,1933,458,210,210,0,70,0,0.023809524,0,empty,CD-0722-2
"E11,E11",4576,5091,3323,1768,3021,1658,1,1662,1052,610,1.724590164,903,2815,840,319,317,2,74,2,0.167192429,0,empty,CD-0722-2
"E11,E12",5488,6522,3947,2575,3880,2179,0,2179,1423,756,1.882275132,1328,2426,488,198,197,1,76,1,0.015228426,0,empty,CD-0722-2
"E11,F1",7952,8747,5351,3396,5282,3147,0,3148,1677,1471,1.140040789,1854,3023,806,300,300,0,96,0,0.073333333,0,empty,CD-0722-2
"E11,F2",475044,540616,354436,186180,314082,168564,0,168697,134718,33979,3.964742929,97930,114601,19264,7503,7385,118,1251,4,0.049559919,0,hg38,CD-0722-2
"E11,F3",4114,4641,2924,1717,2840,1544,0,1546,956,590,1.620338983,917,2742,731,330,329,1,92,1,0.136778116,0,empty,CD-0722-2
"E11,F4",6553,7212,4913,2299,4393,2250,0,2256,1469,787,1.866581957,1270,1162,302,131,129,2,54,1,0.03875969,0,empty,CD-0722-2
"E11,F5",5420,5698,3992,1706,3513,1880,0,1887,1248,639,1.953051643,1000,2454,485,232,230,2,85,2,0.126086957,0,empty,CD-0722-2
"E11,F6",504922,592967,376239,216728,340612,185249,2,185389,145349,40040,3.630094905,109694,188997,27159,10282,10052,230,1669,5,0.056406685,0,hg38,CD-0722-2
"E11,F7",716132,871086,522844,348242,503558,297122,2,297350,236440,60910,3.881792809,180078,65271,13171,5177,5098,79,1002,4,0.040800314,0,hg38,CD-0722-2
"E11,F8",4231,4711,3057,1654,2880,1525,0,1525,1029,496,2.074596774,875,404,52,25,25,0,21,0,0.04,0,empty,CD-0722-2
"E11,F9",4928,5360,3646,1714,3307,1704,0,1704,1106,598,1.849498328,921,3552,965,351,351,0,113,0,0.037037037,0,empty,CD-0722-2
"E11,F10",6155,6829,4584,2245,4126,2144,0,2146,1414,732,1.931693989,1183,2452,629,268,266,2,72,1,0.015037594,0,empty,CD-0722-2
"E11,F11",4577,5075,3489,1586,3013,1543,0,1543,1019,524,1.944656489,817,1947,351,155,153,2,52,2,0.196078431,0,empty,CD-0722-2
"E11,F12",4919,5446,3606,1840,3333,1762,0,1762,1157,605,1.912396694,1011,383,34,25,25,0,14,0,0.04,0,empty,CD-0722-2
"E11,G1",5663,6502,4198,2304,3898,2101,0,2104,1416,688,2.058139535,1217,3289,823,296,293,3,103,3,0.088737201,0,empty,CD-0722-2
"E11,G2",3759,4242,2623,1619,2542,1458,0,1460,931,529,1.759924386,856,786,130,78,78,0,39,0,0,0,empty,CD-0722-2
"E11,G3",6252,6961,4440,2521,4197,2358,0,2361,1406,955,1.472251309,1348,2719,664,300,295,5,95,1,0.084745763,0,empty,CD-0722-2
"E11,G4",11700,13618,8275,5343,8236,4956,0,4966,2952,2014,1.465739821,2992,174,15,10,9,1,7,1,0,0,empty,CD-0722-2
"E11,G5",1185571,1426639,866225,560414,809663,477160,2,477540,372649,104891,3.552726163,287700,284965,53327,21205,20916,289,2784,5,0.037196405,0,hg38,CD-0722-2
"E11,G6",5720,6370,4218,2152,3815,2120,0,2121,1457,664,2.194277108,1173,378,62,41,41,0,20,0,0,0,empty,CD-0722-2
"E11,G7",4155,4555,3176,1379,2845,1483,0,1488,953,535,1.781308411,810,3446,656,241,231,10,76,2,0.034632035,0,empty,CD-0722-2
"E11,G8",2960,3211,2188,1023,2050,1051,0,1051,716,335,2.137313433,606,2016,478,199,197,2,76,1,0.121827411,0,empty,CD-0722-2
"E11,G9",3812,4425,2669,1756,2624,1453,0,1453,964,489,1.971370143,873,2842,608,247,236,11,93,2,0.033898305,0,empty,CD-0722-2
"E11,G10",4594,5295,3376,1919,3174,1743,0,1744,1124,620,1.812903226,1006,2855,769,327,323,4,106,1,0.043343653,0,empty,CD-0722-2
"E11,G11",5865,6590,4445,2145,3960,2069,0,2073,1373,700,1.961428571,1171,1883,456,136,135,1,55,1,0.074074074,0,empty,CD-0722-2
"E11,G12",3956,4526,2882,1644,2802,1583,0,1583,1017,566,1.796819788,900,2825,745,301,295,6,99,2,0.071186441,0,empty,CD-0722-2
"E11,H1",3985,4380,2912,1468,2542,1349,0,1358,881,477,1.846960168,720,1654,473,176,175,1,65,1,0.04,0,empty,CD-0722-2
"E11,H2",4567,5391,3269,2122,3201,1806,0,1809,1163,646,1.800309598,1085,2431,423,192,188,4,67,2,0.069148936,0,empty,CD-0722-2
"E11,H3",3685,4119,2685,1434,2437,1303,0,1303,835,468,1.784188034,757,2119,552,224,223,1,73,1,0.085201794,0,empty,CD-0722-2
"E11,H4",5929,6523,4377,2146,3832,2022,0,2023,1326,697,1.902439024,1103,270,55,24,24,0,19,0,0.083333333,0,empty,CD-0722-2
"E11,H5",6192,6981,4460,2521,4203,2343,0,2344,1499,845,1.773964497,1361,2070,351,183,182,1,98,1,0.049450549,0,empty,CD-0722-2
"E11,H6",3894,4460,2728,1732,2680,1564,0,1565,1095,470,2.329787234,919,2393,603,258,256,2,84,1,0.078125,0,empty,CD-0722-2
"E11,H7",4431,4981,3202,1779,3011,1599,0,1599,1132,467,2.423982869,922,2793,530,265,262,3,107,1,0.061068702,0,empty,CD-0722-2
"E11,H8",4773,5348,3347,2001,3270,1884,0,1886,1237,649,1.906009245,1083,2931,669,258,253,5,91,2,0.138339921,0,empty,CD-0722-2
"E11,H9",3703,4228,2763,1465,2528,1299,0,1301,898,403,2.228287841,741,1607,366,160,159,1,54,1,0.012578616,0,empty,CD-0722-2
"E11,H10",3516,4136,2489,1647,2452,1360,0,1362,892,470,1.89787234,815,1747,406,220,217,3,74,2,0.082949309,0,empty,CD-0722-2
"E11,H11",4515,5271,3123,2148,3250,2139,0,2139,1189,950,1.251578947,1264,80,18,11,11,0,6,0,0,0,empty,CD-0722-2
"E11,H12",3452,3816,2470,1346,2363,1331,0,1334,874,460,1.9,760,1830,344,143,141,2,57,2,0.120567376,0,empty,CD-0722-2
"E12,A1",562108,684451,411091,273360,395830,231311,0,231519,186629,44890,4.157473825,140527,103996,11950,4562,4428,134,960,5,0.047199639,0,hg38,CD-0722-2
"E12,A2",5582,6432,3991,2441,3827,2174,0,2174,1393,781,1.783610755,1285,1830,328,148,144,4,53,2,0.097222222,0,empty,CD-0722-2
"E12,A3",3484,4000,2539,1461,2417,1350,0,1350,911,439,2.075170843,793,1058,254,109,109,0,45,0,0.155963303,0,empty,CD-0722-2
"E12,A4",6116,7030,4564,2466,4140,2240,0,2240,1474,766,1.924281984,1269,731,160,89,89,0,32,0,0.112359551,0,empty,CD-0722-2
"E12,A5",4810,5345,3564,1781,3298,1771,0,1773,1145,628,1.823248408,984,2055,548,192,185,7,53,1,0.124324324,0,empty,CD-0722-2
"E12,A6",326800,392439,244826,147613,226361,128631,1,128730,92446,36284,2.54784478,76430,48399,8914,3434,3372,62,617,4,0.037366548,0,hg38,CD-0722-2
"E12,A7",3587,4128,2560,1568,2483,1426,0,1426,898,528,1.700757576,814,1673,349,118,111,7,47,3,0.027027027,0,empty,CD-0722-2
"E12,A8",2335,2771,1698,1073,1635,937,0,939,631,308,2.048701299,537,2148,418,192,191,1,55,1,0.235602094,0,empty,CD-0722-2
"E12,A9",4329,5059,3195,1864,2984,1610,0,1612,1024,588,1.741496599,924,1717,453,190,190,0,52,0,0.063157895,0,empty,CD-0722-2
"E12,A10",4840,5235,3631,1604,3152,1648,1,1649,1082,567,1.908289242,873,549,33,18,18,0,11,0,0,0,empty,CD-0722-2
"E12,A11",3505,3824,2684,1140,2367,1179,1,1180,780,400,1.95,627,1575,346,145,141,4,57,1,0.070921986,0,empty,CD-0722-2
"E12,A12",4977,5278,3724,1554,3162,1645,0,1646,1108,538,2.059479554,863,3773,812,262,259,3,81,2,0.05019305,0,empty,CD-0722-2
"E12,B1",4311,4868,3100,1768,2856,1614,0,1616,1015,601,1.688851913,885,1216,357,120,119,1,43,1,0.12605042,0,empty,CD-0722-2
"E12,B2",4682,5494,3198,2296,3291,1989,0,1993,1189,804,1.478855721,1227,538,67,26,26,0,14,0,0,0,empty,CD-0722-2
"E12,B3",3609,4101,2596,1505,2439,1319,0,1319,863,456,1.89254386,749,1536,359,156,153,3,63,1,0.006535948,0,empty,CD-0722-2
"E12,B4",4192,5061,2993,2068,3033,1814,0,1816,1160,656,1.768292683,1097,1505,285,146,146,0,50,0,0.102739726,0,empty,CD-0722-2
"E12,B5",512229,278867,174851,104016,199236,103374,5,104054,78201,25853,3.024832708,65437,81578,9964,3795,3686,109,707,4,0.075691807,0,hg38,CD-0722-2
"E12,B6",494846,595447,357149,238298,341080,199755,2,199899,168966,30933,5.462321792,120584,113572,15784,6314,6184,130,1240,6,0.053201811,0,hg38,CD-0722-2
"E12,B7",4434,4896,3308,1588,2881,1491,0,1492,967,525,1.841904762,820,1431,474,157,157,0,60,0,0.01910828,0,empty,CD-0722-2
"E12,B8",3239,3579,2460,1119,2154,1120,0,1121,751,370,2.02972973,596,1397,330,126,126,0,43,0,0.015873016,0,empty,CD-0722-2
"E12,B9",479615,562944,350874,212070,321436,181119,0,181265,140303,40962,3.425198965,107607,110622,15843,6198,6077,121,1060,5,0.04755636,0,hg38,CD-0722-2
"E12,B10",2816,3087,2050,1037,1909,1049,0,1051,674,377,1.787798408,574,384,28,22,22,0,11,0,0,0,empty,CD-0722-2
"E12,B11",7077,8464,4967,3497,4995,3029,0,3032,1645,1387,1.186012978,1894,264,54,34,34,0,12,0,0,0,empty,CD-0722-2
"E12,B12",3759,4330,2762,1568,2594,1424,0,1428,949,479,1.981210856,818,1724,376,151,149,2,35,2,0.020134228,0,empty,CD-0722-2
"E12,C1",7637,8411,5691,2720,4909,2577,1,2587,1619,968,1.672520661,1389,1087,247,103,102,1,30,1,0.039215686,0,empty,CD-0722-2
"E12,C2",6176,6937,4503,2434,4094,2320,0,2320,1530,790,1.936708861,1306,1964,478,231,230,1,75,1,0.043478261,0,empty,CD-0722-2
"E12,C3",7477,8540,5540,3000,5025,2794,0,2795,1880,915,2.054644809,1572,1120,324,115,113,2,50,1,0.017699115,0,empty,CD-0722-2
"E12,C4",3961,4488,2943,1545,2642,1368,0,1369,887,482,1.840248963,761,1744,314,154,154,0,52,0,0.123376623,0,empty,CD-0722-2
"E12,C5",5631,6460,4170,2290,3794,2049,0,2049,1388,661,2.099848714,1159,1860,566,205,202,3,51,2,0.04950495,0,empty,CD-0722-2
"E12,C6",4799,5520,3400,2120,3329,1873,0,1874,1227,647,1.896445131,1124,1921,312,123,123,0,51,0,0,0,empty,CD-0722-2
"E12,C7",6899,8347,4776,3571,4927,3080,0,3087,1782,1305,1.365517241,1897,478,138,55,52,3,17,1,0.019230769,0,empty,CD-0722-2
"E12,C8",7141,8279,5151,3128,4925,2836,0,2838,1798,1040,1.728846154,1645,3171,710,292,286,6,97,2,0.041958042,0,empty,CD-0722-2
"E12,C9",5417,6394,3903,2491,3693,2087,0,2088,1379,709,1.944992948,1254,1719,513,203,197,6,49,2,0.157360406,0,empty,CD-0722-2
"E12,C10",5789,6449,4275,2174,3795,2004,4,2009,1296,713,1.817671809,1087,1889,387,195,194,1,58,1,0.005154639,0,empty,CD-0722-2
"E12,C11",1123626,1340455,815318,525137,767752,463937,2,464284,361551,102733,3.519326799,279841,110359,16053,6190,6056,134,1190,5,0.02675033,0,hg38,CD-0722-2
"E12,C12",6999,7699,5217,2482,4442,2374,0,2376,1558,818,1.904645477,1284,1626,410,168,165,3,53,2,0.036363636,0,empty,CD-0722-2
"E12,D1",6396,7587,4538,3049,4545,2667,0,2668,1608,1060,1.516981132,1626,992,245,89,88,1,35,1,0.011363636,0,empty,CD-0722-2
"E12,D2",4902,5389,3812,1577,3271,1665,0,1665,1113,552,2.016304348,876,2613,531,235,232,3,82,1,0.043103448,0,empty,CD-0722-2
"E12,D3",4593,5350,3325,2025,3161,1782,0,1787,1141,646,1.76625387,1049,1343,204,113,112,1,48,1,0.008928571,0,empty,CD-0722-2
"E12,D4",3519,4049,2573,1476,2386,1290,0,1293,848,445,1.905617978,771,1629,394,168,167,1,51,1,0.047904192,0,empty,CD-0722-2
"E12,D5",3974,4568,2892,1676,2777,1516,0,1518,971,547,1.775137112,891,1817,381,151,148,3,47,1,0.013513514,0,empty,CD-0722-2
"E12,D6",6730,7840,4644,3196,4606,2793,1,2800,1620,1180,1.372881356,1662,1740,379,181,179,2,62,1,0.111731844,0,empty,CD-0722-2
"E12,D7",3477,3843,2547,1296,2275,1226,0,1226,773,453,1.706401766,692,1927,585,228,228,0,82,0,0.013157895,0,empty,CD-0722-2
"E12,D8",4079,4577,3071,1506,2724,1388,0,1388,923,465,1.984946237,767,1433,369,169,167,2,62,1,0.095808383,0,empty,CD-0722-2
"E12,D9",2174,2399,1611,788,1426,733,0,734,454,280,1.621428571,434,1309,287,116,106,10,39,1,0.066037736,0,empty,CD-0722-2
"E12,D10",4154,4896,3010,1886,2944,1695,0,1695,1038,657,1.579908676,1031,927,307,129,128,1,45,1,0.1328125,0,empty,CD-0722-2
"E12,D11",4857,5523,3657,1866,3296,1742,0,1742,1118,624,1.791666667,950,2543,588,232,229,3,91,1,0.048034934,0,empty,CD-0722-2
"E12,D12",5774,6439,4245,2194,3874,2090,0,2096,1343,753,1.783532537,1169,3983,894,365,363,2,123,2,0.016528926,0,empty,CD-0722-2
"E12,E1",7416,8398,5399,2999,4954,2759,0,2763,1779,984,1.807926829,1571,2209,347,168,163,5,58,2,0.012269939,0,empty,CD-0722-2
"E12,E2",5100,5793,3634,2159,3505,1928,0,1931,1228,703,1.746799431,1146,2005,434,189,188,1,57,1,0.074468085,0,empty,CD-0722-2
"E12,E3",3514,4087,2600,1487,2439,1356,0,1356,903,453,1.993377483,777,2632,679,241,238,3,75,2,0.029411765,0,empty,CD-0722-2
"E12,E4",4947,5415,3586,1829,3239,1728,0,1732,1134,598,1.89632107,975,2239,444,209,206,3,73,3,0.009708738,0,empty,CD-0722-2
"E12,E5",4398,4978,3337,1641,2964,1497,0,1497,990,507,1.952662722,848,1308,385,175,173,2,48,2,0.034682081,0,empty,CD-0722-2
"E12,E6",7782,8845,5784,3061,5264,2884,0,2884,1907,977,1.951893552,1610,3120,798,297,293,4,91,1,0.133105802,0,empty,CD-0722-2
"E12,E7",380134,415417,297047,118370,236730,111000,0,111115,87945,23170,3.795640915,60221,41411,8753,3171,3122,49,678,4,0.024983985,0,hg38,CD-0722-2
"E12,E8",5564,6222,4212,2010,3735,1929,0,1930,1237,693,1.784992785,1064,2712,515,197,194,3,56,2,0,0,empty,CD-0722-2
"E12,E9",3724,4301,2740,1561,2614,1453,0,1453,944,509,1.854616896,834,2504,678,294,294,0,93,0,0.119047619,0,empty,CD-0722-2
"E12,E10",543818,634243,406022,228221,364738,197807,1,197971,150304,47667,3.153208719,116243,160889,26532,10303,10135,168,1527,4,0.074888999,0,hg38,CD-0722-2
"E12,E11",5095,5786,3700,2086,3364,1849,0,1854,1182,672,1.758928571,1052,2193,557,217,216,1,68,1,0.12037037,0,empty,CD-0722-2
"E12,E12",5205,5867,3752,2115,3584,1957,0,1959,1233,726,1.698347107,1145,1870,308,140,140,0,68,0,0,0,empty,CD-0722-2
"E12,F1",6349,6928,4656,2272,4201,2235,0,2235,1453,782,1.858056266,1288,2165,443,198,197,1,85,1,0.040609137,0,empty,CD-0722-2
"E12,F2",486226,576789,351012,225777,332823,192465,0,192602,160249,32353,4.953141903,116137,148284,20828,8339,8176,163,1473,8,0.059809198,0,hg38,CD-0722-2
"E12,F3",4703,5392,3442,1950,3174,1704,0,1708,1155,553,2.088607595,976,2709,799,311,309,2,84,2,0.129449838,0,empty,CD-0722-2
"E12,F4",6994,7635,5281,2354,4571,2360,0,2362,1603,759,2.11198946,1248,831,156,65,63,2,27,2,0.158730159,0,empty,CD-0722-2
"E12,F5",5621,6190,4117,2073,3778,1998,0,1998,1295,703,1.842105263,1159,1835,552,221,221,0,69,0,0.135746606,0,empty,CD-0722-2
"E12,F6",5815,6607,4256,2351,3881,2114,0,2119,1358,761,1.784494087,1211,2813,682,275,274,1,73,1,0.149635036,0,empty,CD-0722-2
"E12,F7",6107,6915,4599,2316,4223,2304,3,2308,1451,857,1.693115519,1276,1286,331,107,106,1,37,1,0,0,empty,CD-0722-2
"E12,F8",610956,755308,438281,317027,436461,269217,1,269397,214358,55039,3.894656516,165558,2659,848,325,324,1,101,1,0.012345679,0,hg38,CD-0722-2
"E12,F9",517155,570157,401341,168816,328097,158312,1,158484,128523,29961,4.28967658,86887,122622,21314,7714,7581,133,1350,4,0.02057776,0,hg38,CD-0722-2
"E12,F10",6317,7193,4764,2429,4226,2209,0,2211,1438,773,1.860284605,1237,1909,433,188,183,5,55,3,0.016393443,0,empty,CD-0722-2
"E12,F11",4993,5757,3745,2012,3389,1757,0,1759,1195,564,2.118794326,1012,1995,305,135,135,0,55,0,0.155555556,0,empty,CD-0722-2
"E12,F12",5705,6525,4149,2376,3843,2047,0,2049,1315,734,1.791553134,1172,176,30,17,17,0,13,0,0,0,empty,CD-0722-2
"E12,G1",1326966,1483206,1016673,466533,830662,429602,4,430034,359187,70847,5.069897102,238547,222075,25431,8499,8236,263,1578,7,0.088271005,0,hg38,CD-0722-2
"E12,G2",3677,4230,2590,1640,2487,1419,0,1419,950,469,2.025586354,830,604,127,60,59,1,24,1,0,0,empty,CD-0722-2
"E12,G3",7064,7825,5225,2600,4587,2523,0,2524,1523,1001,1.521478521,1365,2397,500,232,227,5,68,2,0.088105727,0,empty,CD-0722-2
"E12,G4",11951,13930,8406,5524,8313,5072,0,5076,3018,2058,1.466472303,2976,182,28,19,19,0,11,0,0,0,empty,CD-0722-2
"E12,G5",4022,4509,2938,1571,2720,1488,0,1488,935,553,1.690777577,852,1646,348,151,146,5,51,1,0.136986301,0,empty,CD-0722-2
"E12,G6",5852,6475,4383,2092,3883,2077,0,2081,1368,713,1.918653576,1121,210,62,38,37,1,18,1,0.054054054,0,empty,CD-0722-2
"E12,G7",4615,5224,3479,1745,3140,1672,0,1674,1076,598,1.799331104,915,2782,695,283,277,6,68,3,0.151624549,0,empty,CD-0722-2
"E12,G8",3173,3599,2283,1316,2229,1225,0,1225,822,403,2.039702233,711,1440,252,120,120,0,48,0,0.025,0,empty,CD-0722-2
"E12,G9",4087,4865,2920,1945,2921,1609,0,1611,1071,540,1.983333333,1018,2571,431,199,198,1,84,1,0.085858586,0,empty,CD-0722-2
"E12,G10",5157,6029,3771,2258,3572,1971,0,1974,1255,719,1.745479833,1162,2263,638,254,249,5,68,2,0.084337349,0,empty,CD-0722-2
"E12,G11",4866,5386,3624,1762,3155,1614,0,1614,1066,548,1.945255474,872,1813,378,157,155,2,71,2,0.070967742,0,empty,CD-0722-2
"E12,G12",4216,4900,3045,1855,3020,1737,0,1737,1091,646,1.688854489,1041,2429,475,185,183,2,82,1,0.021857923,0,empty,CD-0722-2
"E12,H1",4410,4877,3282,1595,2954,1602,0,1604,1038,566,1.833922261,884,1261,298,138,134,4,46,2,0.171641791,0,empty,CD-0722-2
"E12,H2",760687,917602,557112,360490,523438,301434,0,301685,245131,56554,4.334459101,182140,305808,48804,19697,19330,367,2529,12,0.054061045,0,hg38,CD-0722-2
"E12,H3",4207,4871,3010,1861,2903,1606,0,1607,1056,551,1.916515426,951,1702,296,149,144,5,62,2,0.020833333,0,empty,CD-0722-2
"E12,H4",6246,7140,4549,2591,4212,2334,0,2335,1564,771,2.028534371,1377,254,37,24,24,0,18,0,0.041666667,0,empty,CD-0722-2
"E12,H5",7661,8795,5522,3273,5184,2893,0,2897,1920,977,1.965199591,1703,2977,738,273,267,6,100,2,0.086142322,0,empty,CD-0722-2
"E12,H6",3898,4542,2827,1715,2754,1582,0,1582,1022,560,1.825,925,1909,484,216,214,2,69,2,0.08411215,0,empty,CD-0722-2
"E12,H7",4540,4866,3394,1472,2972,1543,0,1543,1025,518,1.978764479,811,1763,307,143,141,2,67,1,0.106382979,0,empty,CD-0722-2
"E12,H8",5362,6288,3836,2452,3727,2176,0,2186,1407,779,1.806161746,1303,2269,401,156,155,1,70,1,0.058064516,0,empty,CD-0722-2
"E12,H9",4631,5230,3482,1748,3088,1575,0,1576,1045,531,1.967984934,892,1191,357,140,132,8,38,2,0.015151515,0,empty,CD-0722-2
"E12,H10",3880,4537,2802,1735,2633,1508,0,1513,971,542,1.791512915,880,1389,291,135,133,2,52,1,0.030075188,0,empty,CD-0722-2
"E12,H11",5305,6109,3608,2501,3721,2405,0,2408,1299,1109,1.171325518,1475,59,8,7,7,0,5,0,0,0,empty,CD-0722-2
"E12,H12",4065,4527,2964,1563,2684,1491,0,1491,965,526,1.83460076,804,1394,218,94,93,1,49,1,0.032258065,0,empty,CD-0722-2
"F1,A1",3451,3789,2451,1338,2310,1277,0,1277,838,439,1.908883827,714,1341,396,154,152,2,39,1,0.052631579,0,empty,CD-0722-2
"F1,A2",5273,5882,3784,2098,3576,2040,0,2045,1299,746,1.741286863,1123,2014,547,244,242,2,81,2,0.008264463,0,empty,CD-0722-2
"F1,A3",3129,3616,2254,1362,2124,1162,0,1165,771,394,1.956852792,675,1444,319,120,116,4,43,4,0.00862069,0,empty,CD-0722-2
"F1,A4",5930,6803,4259,2544,4125,2310,0,2312,1499,813,1.843788438,1364,963,181,73,72,1,34,1,0.027777778,0,empty,CD-0722-2
"F1,A5",4536,4956,3308,1648,3019,1566,0,1566,1000,566,1.766784452,873,2100,575,185,181,4,48,2,0.110497238,0,empty,CD-0722-2
"F1,A6",4046,4791,2947,1844,2832,1648,0,1650,1067,583,1.830188679,941,2916,801,331,330,1,94,1,0.024242424,0,empty,CD-0722-2
"F1,A7",490046,593268,357285,235983,343394,202412,4,202577,160933,41644,3.864494285,121784,113933,17778,7066,6910,156,1249,4,0.070911722,0,hg38,CD-0722-2
"F1,A8",481484,567839,357384,210455,331893,185957,2,186092,155500,30592,5.083028243,109630,208984,32704,12580,12349,231,1912,5,0.03587335,0,hg38,CD-0722-2
"F1,A9",3567,3997,2681,1316,2387,1295,0,1296,859,437,1.965675057,722,2122,641,240,235,5,66,2,0.034042553,0,empty,CD-0722-2
"F1,A10",4427,4940,3309,1631,2998,1577,0,1579,972,607,1.601317957,896,451,139,64,64,0,23,0,0.03125,0,empty,CD-0722-2
"F1,A11",3172,3533,2346,1187,2194,1173,0,1173,812,361,2.249307479,684,1424,386,145,144,1,53,1,0.152777778,0,empty,CD-0722-2
"F1,A12",505495,475233,430429,44804,261957,64081,3,64220,46946,17274,2.717726062,22831,192806,21963,8348,8067,281,1486,5,0.074501054,0,hg38,CD-0722-2
"F1,B1",3850,4338,2762,1576,2597,1439,0,1442,893,549,1.626593807,831,1927,406,176,168,8,58,2,0.089285714,0,empty,CD-0722-2
"F1,B2",1523321,1764573,1041605,722968,1021883,613312,0,613702,491985,121717,4.042040142,375661,109566,17548,6810,6684,126,1274,4,0.057600239,0,hg38,CD-0722-2
"F1,B3",3302,3811,2434,1377,2255,1224,0,1226,802,424,1.891509434,696,2198,481,224,223,1,66,1,0.094170404,0,empty,CD-0722-2
"F1,B4",3678,4193,2605,1588,2612,1514,0,1514,945,569,1.660808436,902,1298,205,96,96,0,35,0,0.145833333,0,empty,CD-0722-2
"F1,B5",4920,3499,2218,1281,2361,1274,0,1284,884,400,2.21,773,1262,304,107,105,2,48,2,0.028571429,0,empty,CD-0722-2
"F1,B6",4051,4670,2872,1798,2813,1676,0,1678,1019,659,1.546282246,1007,1605,497,175,174,1,48,1,0.028735632,0,empty,CD-0722-2
"F1,B7",399523,504939,277079,227860,296335,201278,1,201408,147534,53874,2.738500947,124113,4785,687,274,270,4,59,2,0.192592593,0,hg38,CD-0722-2
"F1,B8",2760,3033,2020,1013,1823,947,0,948,607,341,1.780058651,526,1361,365,146,143,3,49,2,0.034965035,0,empty,CD-0722-2
"F1,B9",5451,6178,3870,2308,3688,2094,0,2096,1357,739,1.836265223,1194,900,195,109,108,1,56,1,0.055555556,0,empty,CD-0722-2
"F1,B10",363974,404623,253119,151504,243882,134395,12,134775,102401,32374,3.163062952,80455,37714,4047,1549,1507,42,332,6,0.058394161,0,hg38,CD-0722-2
"F1,B11",6311,7337,4400,2937,4377,2661,0,2664,1438,1226,1.172920065,1596,340,34,20,20,0,14,0,0.05,0,empty,CD-0722-2
"F1,B12",3205,3569,2383,1186,2197,1152,0,1153,772,381,2.026246719,630,1788,521,183,182,1,49,1,0.032967033,0,empty,CD-0722-2
"F1,C1",7084,7987,5222,2765,4586,2423,0,2425,1540,885,1.740112994,1366,1328,312,133,131,2,39,2,0.007633588,0,empty,CD-0722-2
"F1,C2",595249,661324,456479,204845,376554,189960,1,190093,148522,41571,3.57273099,104940,5797,2442,686,684,2,233,1,0.055555556,0,hg38,CD-0722-2
"F1,C3",5622,6250,4136,2114,3819,2032,0,2039,1283,756,1.697089947,1162,1234,248,84,84,0,35,0,0.071428571,0,empty,CD-0722-2
"F1,C4",3375,3715,2474,1241,2284,1172,0,1178,746,432,1.726851852,670,1934,397,174,173,1,64,1,0.213872832,0,empty,CD-0722-2
"F1,C5",5026,5680,3710,1970,3432,1867,0,1867,1238,629,1.968203498,1080,1819,305,129,129,0,54,0,0.023255814,0,empty,CD-0722-2
"F1,C6",4290,4983,3077,1906,3021,1704,0,1706,1026,680,1.508823529,1001,1920,484,157,153,4,49,2,0.08496732,0,empty,CD-0722-2
"F1,C7",6478,7632,4606,3026,4664,2840,0,2844,1708,1136,1.503521127,1666,590,210,78,78,0,25,0,0,0,empty,CD-0722-2
"F1,C8",75113,89540,58838,30702,51010,27184,0,27198,21591,5607,3.850722311,15574,8079,2220,897,892,5,239,2,0.039237668,0,empty,CD-0722-2
"F1,C9",4545,5273,3207,2066,3225,1826,0,1828,1186,642,1.847352025,1111,1950,451,178,175,3,63,2,0.057142857,0,empty,CD-0722-2
"F1,C10",1527799,1796139,1128714,667425,1012333,585833,3,586338,477152,109186,4.370084077,342866,293422,49335,18992,18651,341,2727,7,0.032598788,0,hg38,CD-0722-2
"F1,C11",4385,4963,3123,1840,2936,1633,0,1633,1014,619,1.63812601,943,1962,349,158,150,8,55,2,0.053333333,0,empty,CD-0722-2
"F1,C12",449114,530770,326272,204498,312500,180472,1,180634,142672,37962,3.7582846,107217,100165,23092,8943,8845,98,1360,4,0.075975127,0,hg38,CD-0722-2
"F1,D1",5774,7008,4084,2924,4186,2508,1,2513,1531,982,1.559063136,1535,760,63,42,37,5,25,1,0,0,empty,CD-0722-2
"F1,D2",4673,5453,3552,1901,3246,1681,0,1685,1064,621,1.713365539,971,3639,981,353,352,1,107,1,0.0625,0,empty,CD-0722-2
"F1,D3",4025,4505,2888,1617,2701,1568,0,1568,1021,547,1.86654479,870,1380,378,163,163,0,67,0,0.079754601,0,empty,CD-0722-2
"F1,D4",3132,3608,2346,1262,2127,1162,0,1163,742,421,1.762470309,662,1518,283,113,112,1,43,1,0.008928571,0,empty,CD-0722-2
"F1,D5",3612,4018,2645,1373,2398,1318,0,1318,878,440,1.995454545,718,1914,417,168,166,2,65,1,0.102409639,0,empty,CD-0722-2
"F1,D6",5757,6620,4094,2526,4031,2350,0,2352,1409,943,1.49416755,1421,2033,489,177,175,2,53,1,0.125714286,0,empty,CD-0722-2
"F1,D7",3111,3411,2300,1111,2086,1091,0,1091,674,417,1.616306954,597,1735,392,194,192,2,62,2,0.046875,0,empty,CD-0722-2
"F1,D8",3816,4279,2772,1507,2578,1362,0,1365,881,484,1.820247934,792,1368,286,126,125,1,50,1,0.096,0,empty,CD-0722-2
"F1,D9",1949,2246,1392,854,1348,729,0,731,475,256,1.85546875,443,1575,387,153,153,0,45,0,0.150326797,0,empty,CD-0722-2
"F1,D10",3686,4321,2631,1690,2614,1457,0,1462,924,538,1.717472119,859,1060,214,112,111,1,36,1,0.072072072,0,empty,CD-0722-2
"F1,D11",4210,5020,3126,1894,3014,1632,0,1632,1005,627,1.602870813,979,2885,622,289,288,1,91,1,0.059027778,0,empty,CD-0722-2
"F1,D12",5327,6050,3835,2215,3640,1973,0,1973,1277,696,1.834770115,1133,3956,981,414,413,1,128,1,0.062953995,0,empty,CD-0722-2
"F1,E1",6640,7318,4865,2453,4405,2401,0,2401,1560,841,1.854934602,1298,2589,534,200,194,6,76,3,0.036082474,0,empty,CD-0722-2
"F1,E2",4751,5299,3377,1922,3145,1738,0,1738,1077,661,1.62934947,1013,1960,400,169,168,1,68,1,0.083333333,0,empty,CD-0722-2
"F1,E3",3014,3484,2227,1257,2131,1139,0,1139,742,397,1.869017632,672,2412,554,243,242,1,77,1,0.049586777,0,empty,CD-0722-2
"F1,E4",958840,1150197,695282,454915,657592,385777,2,386033,307089,78944,3.889959972,233599,125212,19205,7281,7123,158,1303,6,0.047592307,0,hg38,CD-0722-2
"F1,E5",3785,4254,2846,1408,2446,1250,0,1257,828,429,1.93006993,669,1626,353,158,154,4,57,3,0.012987013,0,empty,CD-0722-2
"F1,E6",338694,368163,253624,114539,217146,116640,2,116725,62113,54612,1.137350765,63618,6582,1514,663,654,9,270,1,0.042813456,0,hg38,CD-0722-2
"F1,E7",9564,10821,7171,3650,6369,3216,1,3217,2205,1012,2.178853755,1861,13910,1465,650,632,18,175,3,0.091772152,0,empty,CD-0722-2
"F1,E8",5184,5765,3943,1822,3430,1817,0,1817,1205,612,1.968954248,1000,2794,611,317,311,6,87,2,0.099678457,0,empty,CD-0722-2
"F1,E9",3254,3666,2388,1278,2200,1153,0,1157,771,386,1.997409326,664,2843,680,246,242,4,80,1,0.111570248,0,empty,CD-0722-2
"F1,E10",3484,3966,2538,1428,2467,1343,0,1346,885,461,1.919739696,809,2051,519,202,200,2,53,1,0.14,0,empty,CD-0722-2
"F1,E11",4401,4891,3291,1600,2947,1592,0,1596,1023,573,1.785340314,837,2136,444,187,183,4,68,2,0.071038251,0,empty,CD-0722-2
"F1,E12",4786,5446,3570,1876,3288,1834,0,1840,1181,659,1.792109256,1009,1872,361,179,179,0,86,0,0.016759777,0,empty,CD-0722-2
"F1,F1",5682,6422,4097,2325,3773,2070,0,2070,1309,761,1.720105125,1174,1801,353,154,154,0,62,0,0.155844156,0,empty,CD-0722-2
"F1,F2",5326,5935,3940,1995,3559,1826,0,1832,1170,662,1.767371601,1029,3089,746,304,297,7,108,2,0.070707071,0,empty,CD-0722-2
"F1,F3",7491,8671,5490,3181,5004,2799,0,2800,1807,993,1.819738167,1599,2636,646,295,293,2,79,1,0.105802048,0,empty,CD-0722-2
"F1,F4",602144,683801,453789,230012,396750,208085,3,208269,162203,46066,3.521100161,119238,24699,4081,1598,1565,33,339,3,0.033226837,0,hg38,CD-0722-2
"F1,F5",4858,5340,3500,1840,3247,1735,0,1736,1125,611,1.841243863,963,2417,459,211,209,2,77,2,0.023923445,0,empty,CD-0722-2
"F1,F6",5396,6389,3840,2549,3772,2216,0,2223,1457,766,1.902088773,1318,2753,684,229,229,0,64,0,0.034934498,0,empty,CD-0722-2
"F1,F7",5848,6526,4322,2204,3811,2033,0,2036,1309,727,1.800550206,1110,1032,225,98,98,0,35,0,0.132653061,0,empty,CD-0722-2
"F1,F8",452085,561513,318579,242934,329105,207969,3,208105,179421,28684,6.255089946,128129,6523,1893,626,624,2,180,1,0.084935897,0,hg38,CD-0722-2
"F1,F9",1119302,1276905,846723,430182,726447,387928,8,388284,324037,64247,5.043612931,219704,473603,61882,25021,24387,634,2855,8,0.08676754,0,hg38,CD-0722-2
"F1,F10",5648,6231,4239,1992,3756,1914,0,1914,1194,720,1.658333333,1066,1952,317,153,150,3,64,2,0.04,0,empty,CD-0722-2
"F1,F11",1079354,1232643,816374,416269,699963,378042,2,378308,317467,60841,5.217978008,215000,205281,30701,12364,12137,227,1897,4,0.08321661,0,hg38,CD-0722-2
"F1,F12",4977,5699,3602,2097,3406,1878,0,1880,1189,691,1.720694645,1108,275,28,17,17,0,12,0,0.235294118,0,empty,CD-0722-2
"F1,G1",5177,5833,3854,1979,3542,1885,0,1887,1230,657,1.872146119,1050,3195,886,289,288,1,100,1,0.069444444,0,empty,CD-0722-2
"F1,G2",3321,3648,2362,1286,2194,1248,0,1251,800,451,1.77383592,677,771,167,84,84,0,51,0,0.083333333,0,empty,CD-0722-2
"F1,G3",6141,6794,4486,2308,4007,2234,0,2234,1313,921,1.425624321,1219,2297,704,263,257,6,66,2,0.062256809,0,empty,CD-0722-2
"F1,G4",11491,13386,8116,5270,8015,4921,0,4926,2955,1971,1.499238965,2868,216,20,10,10,0,8,0,0.3,0,empty,CD-0722-2
"F1,G5",3373,3966,2447,1519,2425,1322,0,1324,850,474,1.793248945,777,1897,501,177,172,5,67,1,0.034883721,0,empty,CD-0722-2
"F1,G6",5276,5991,3866,2125,3510,1947,0,1947,1263,684,1.846491228,1121,288,75,34,34,0,17,0,0,0,empty,CD-0722-2
"F1,G7",4103,4526,3077,1449,2795,1418,0,1418,877,541,1.621072089,786,3002,594,211,206,5,55,2,0.058252427,0,empty,CD-0722-2
"F1,G8",3089,3546,2209,1337,2112,1140,1,1145,752,393,1.913486005,705,1738,284,115,110,5,52,1,0.136363636,0,empty,CD-0722-2
"F1,G9",3882,4432,2819,1613,2684,1461,0,1462,957,505,1.895049505,861,2310,447,204,199,5,80,1,0.120603015,0,empty,CD-0722-2
"F1,G10",4419,5065,3141,1924,3050,1710,0,1714,1072,642,1.669781931,1011,3028,677,297,296,1,94,1,0.006756757,0,empty,CD-0722-2
"F1,G11",4200,4767,3085,1682,2877,1510,0,1511,985,526,1.872623574,873,1780,433,190,189,1,58,1,0.105820106,0,empty,CD-0722-2
"F1,G12",4162,4821,2960,1861,2865,1608,0,1610,1079,531,2.032015066,963,3056,785,324,320,4,102,2,0.075,0,empty,CD-0722-2
"F1,H1",3852,4489,2800,1689,2697,1468,0,1470,984,486,2.024691358,885,1298,204,102,102,0,52,0,0.058823529,0,empty,CD-0722-2
"F1,H2",4439,5005,3255,1750,2956,1614,0,1616,1061,555,1.911711712,886,2666,614,263,257,6,85,1,0.171206226,0,empty,CD-0722-2
"F1,H3",547049,690901,374213,316688,400996,270030,1,270201,194964,75237,2.591331393,170214,46125,15169,5522,5478,44,992,4,0.01460387,0,hg38,CD-0722-2
"F1,H4",5372,6279,3811,2468,3749,2088,0,2091,1330,761,1.747700394,1305,255,53,32,30,2,18,2,0.033333333,0,empty,CD-0722-2
"F1,H5",5974,6875,4364,2511,4101,2241,0,2244,1476,768,1.921875,1308,2576,571,259,250,9,84,2,0.096,0,empty,CD-0722-2
"F1,H6",3615,4113,2623,1490,2429,1386,0,1388,936,452,2.07079646,789,1829,527,213,213,0,69,0,0.009389671,0,empty,CD-0722-2
"F1,H7",4208,4689,3065,1624,2882,1533,0,1535,994,541,1.837338262,894,2415,585,238,234,4,80,2,0.064102564,0,empty,CD-0722-2
"F1,H8",4746,5532,3392,2140,3336,1875,0,1875,1161,714,1.62605042,1114,2552,575,239,232,7,77,2,0.030172414,0,empty,CD-0722-2
"F1,H9",3349,3845,2535,1310,2314,1238,1,1240,817,423,1.93144208,704,1308,440,183,180,3,45,2,0.005555556,0,empty,CD-0722-2
"F1,H10",4901,5709,3699,2010,3343,1765,0,1765,1270,495,2.565656566,1011,2143,436,202,200,2,56,1,0.13,0,empty,CD-0722-2
"F1,H11",4786,5884,3242,2642,3589,2381,0,2382,1316,1066,1.234521576,1490,47,6,3,3,0,3,0,0,0,empty,CD-0722-2
"F1,H12",3500,4045,2468,1577,2390,1403,0,1406,899,507,1.773175542,835,1352,314,167,164,3,45,2,0.042682927,0,empty,CD-0722-2
"F2,A1",4651,5391,3398,1993,3257,1863,0,1864,1187,677,1.753323486,1067,1966,506,178,175,3,55,2,0.005714286,0,empty,CD-0722-2
"F2,A2",6794,7714,5019,2695,4663,2577,0,2581,1590,991,1.60443996,1463,2053,403,174,169,5,66,2,0.076923077,0,empty,CD-0722-2
"F2,A3",3874,4233,2857,1376,2570,1412,0,1412,904,508,1.779527559,765,1978,432,171,170,1,67,1,0.035294118,0,empty,CD-0722-2
"F2,A4",6846,7517,5018,2499,4503,2462,0,2464,1559,905,1.722651934,1349,1171,205,90,89,1,31,1,0.011235955,0,empty,CD-0722-2
"F2,A5",5787,6620,4190,2430,3921,2152,0,2154,1408,746,1.887399464,1235,2836,662,277,273,4,78,1,0.164835165,0,empty,CD-0722-2
"F2,A6",5482,6405,4062,2343,3891,2202,0,2205,1482,723,2.049792531,1286,3893,880,382,380,2,132,1,0.168421053,0,empty,CD-0722-2
"F2,A7",4540,5266,3293,1973,3215,1808,0,1811,1163,648,1.794753086,1041,1915,315,135,132,3,66,2,0.060606061,0,empty,CD-0722-2
"F2,A8",368604,450573,268339,182234,263568,155353,0,155456,127045,28411,4.471683503,94422,283676,53745,20842,20554,288,2670,6,0.051863384,0,hg38,CD-0722-2
"F2,A9",4652,5345,3435,1910,3209,1761,0,1766,1105,661,1.671709531,1010,3012,800,296,288,8,80,2,0.010416667,0,empty,CD-0722-2
"F2,A10",7096,7940,5397,2543,4722,2500,0,2502,1638,864,1.895833333,1375,567,136,63,63,0,25,0,0.174603175,0,empty,CD-0722-2
"F2,A11",4093,4737,3136,1601,2829,1474,0,1474,957,517,1.85106383,838,2537,670,252,246,6,76,2,0.020325203,0,empty,CD-0722-2
"F2,A12",6326,7093,4628,2465,4158,2234,0,2237,1416,821,1.724725944,1272,4690,874,359,357,2,113,2,0.06442577,0,empty,CD-0722-2
"F2,B1",5047,5549,3730,1819,3342,1851,0,1851,1144,707,1.618104668,1014,2127,679,278,276,2,73,1,0.007246377,0,empty,CD-0722-2
"F2,B2",4942,5545,3348,2197,3389,1994,0,1997,1231,766,1.607049608,1166,957,182,89,88,1,32,1,0.170454545,0,empty,CD-0722-2
"F2,B3",4776,5612,3466,2146,3494,1966,0,1969,1364,605,2.254545455,1197,2255,395,177,176,1,62,1,0.073863636,0,empty,CD-0722-2
"F2,B4",554299,643256,417795,225461,371503,197711,2,197897,153957,43940,3.503800637,115130,116681,13521,5431,5299,132,1016,3,0.050009436,0,hg38,CD-0722-2
"F2,B5",4869,2874,1717,1157,2063,1140,0,1153,726,427,1.700234192,742,1503,436,137,136,1,37,1,0.014705882,0,empty,CD-0722-2
"F2,B6",5866,6746,4202,2544,4074,2399,0,2404,1484,920,1.613043478,1404,2499,861,330,330,0,78,0,0.033333333,0,empty,CD-0722-2
"F2,B7",4736,5410,3505,1905,3285,1814,0,1816,1182,634,1.864353312,1029,1926,465,172,172,0,51,0,0.081395349,0,empty,CD-0722-2
"F2,B8",3595,4000,2683,1317,2451,1296,0,1296,835,461,1.811279826,739,1984,455,202,198,4,62,2,0.065656566,0,empty,CD-0722-2
"F2,B9",429264,461516,336618,124898,265032,118896,0,119022,92816,26206,3.541784324,63666,17864,3700,1548,1514,34,345,2,0.036988111,0,hg38,CD-0722-2
"F2,B10",3282,3606,2345,1261,2204,1157,0,1162,768,394,1.949238579,655,812,144,60,59,1,31,1,0.084745763,0,empty,CD-0722-2
"F2,B11",15619,16908,11653,5255,9804,5231,0,5236,3159,2077,1.520943669,2806,523,94,52,52,0,18,0,0.173076923,0,empty,CD-0722-2
"F2,B12",4409,5000,3163,1837,3067,1671,0,1672,1108,564,1.964539007,971,2620,673,282,281,1,77,1,0.071174377,0,empty,CD-0722-2
"F2,C1",8344,9450,6296,3154,5646,3036,0,3036,1871,1165,1.606008584,1707,1675,390,125,123,2,42,1,0.073170732,0,empty,CD-0722-2
"F2,C2",7184,8248,5222,3026,4937,2821,0,2824,1792,1032,1.736434109,1666,2991,927,336,336,0,99,0,0.035714286,0,empty,CD-0722-2
"F2,C3",7127,7913,5285,2628,4854,2624,0,2631,1638,993,1.649546828,1445,1091,245,108,106,2,48,1,0.254716981,0,empty,CD-0722-2
"F2,C4",4614,5073,3448,1625,3092,1586,0,1586,1054,532,1.981203008,907,2115,426,216,213,3,85,2,0.037558685,0,empty,CD-0722-2
"F2,C5",6492,7286,4829,2457,4296,2313,0,2313,1512,801,1.887640449,1282,2554,658,280,278,2,72,1,0.028776978,0,empty,CD-0722-2
"F2,C6",674990,787980,500776,287204,456654,250015,1,250222,198220,52002,3.81177647,148148,245958,31461,12455,12137,318,1868,5,0.060641015,0,hg38,CD-0722-2
"F2,C7",7997,9566,5568,3998,5779,3605,0,3607,2071,1536,1.348307292,2221,509,91,52,52,0,25,0,0.153846154,0,empty,CD-0722-2
"F2,C8",8739,9928,6420,3508,5992,3292,0,3294,2144,1150,1.864347826,1882,4238,857,325,318,7,119,1,0.091194969,0,empty,CD-0722-2
"F2,C9",6320,7337,4607,2730,4351,2404,0,2409,1562,847,1.844155844,1438,2255,481,182,178,4,63,2,0.06741573,0,empty,CD-0722-2
"F2,C10",638408,710364,488276,222088,404713,200302,1,200567,149778,50789,2.949024395,112118,136177,18111,6906,6722,184,1214,7,0.036447486,0,hg38,CD-0722-2
"F2,C11",5469,6304,3982,2322,3724,2017,0,2019,1292,727,1.777166437,1197,2685,633,244,241,3,73,2,0.161825726,0,empty,CD-0722-2
"F2,C12",8163,9223,5958,3265,5454,2974,0,2981,1954,1027,1.902629017,1746,2814,937,341,338,3,82,2,0.020710059,0,empty,CD-0722-2
"F2,D1",7734,9119,5452,3667,5435,3257,2,3260,1954,1306,1.496171516,1972,1389,266,132,116,16,36,2,0.112068966,0,empty,CD-0722-2
"F2,D2",5399,6024,4064,1960,3694,1954,0,1956,1309,647,2.023183926,1058,4922,1392,533,529,4,134,2,0.043478261,0,empty,CD-0722-2
"F2,D3",5390,6394,3822,2572,3862,2264,0,2265,1531,734,2.085831063,1387,2057,351,174,174,0,66,0,0.08045977,0,empty,CD-0722-2
"F2,D4",5298,6160,3993,2167,3690,1921,0,1921,1261,660,1.910606061,1143,2091,422,169,166,3,54,2,0.048192771,0,empty,CD-0722-2
"F2,D5",572155,677973,424050,253923,393116,218855,2,219052,174679,44373,3.936605593,131172,136973,21519,8372,8204,168,1442,4,0.05814237,0,hg38,CD-0722-2
"F2,D6",7479,8664,5240,3424,5126,3009,0,3013,1784,1229,1.451586656,1812,2530,586,213,212,1,66,1,0.179245283,0,empty,CD-0722-2
"F2,D7",4316,4856,3286,1570,2897,1542,0,1542,1042,500,2.084,816,2616,752,341,338,3,105,1,0.053254438,0,empty,CD-0722-2
"F2,D8",5536,6364,4019,2345,3867,2117,0,2117,1394,723,1.928077455,1220,1843,526,214,214,0,68,0,0.130841121,0,empty,CD-0722-2
"F2,D9",2717,2937,2012,925,1805,968,0,968,617,351,1.757834758,541,1740,321,172,170,2,61,1,0.047058824,0,empty,CD-0722-2
"F2,D10",5470,6264,3939,2325,3673,2025,0,2028,1275,753,1.693227092,1170,1330,253,110,109,1,38,1,0.009174312,0,empty,CD-0722-2
"F2,D11",5534,6336,4119,2217,3799,2049,0,2051,1349,702,1.921652422,1163,4820,1178,465,463,2,134,1,0.099352052,0,empty,CD-0722-2
"F2,D12",581940,665815,438091,227724,382297,200326,0,200532,146278,54254,2.696169868,115956,174702,35069,12898,12723,175,1860,5,0.026487464,0,hg38,CD-0722-2
"F2,E1",8426,9342,6062,3280,5627,3135,0,3141,1918,1223,1.568274734,1760,3830,774,333,328,5,106,1,0.100609756,0,empty,CD-0722-2
"F2,E2",5938,6781,4228,2553,4083,2276,0,2278,1370,908,1.508810573,1372,2315,541,213,209,4,61,2,0.148325359,0,empty,CD-0722-2
"F2,E3",4149,4796,3104,1692,2777,1487,0,1489,992,497,1.995975855,842,3312,797,335,327,8,102,2,0.036697248,0,empty,CD-0722-2
"F2,E4",5406,6254,3999,2255,3686,1989,0,1991,1325,666,1.989489489,1128,3253,723,314,303,11,106,2,0.135313531,0,empty,CD-0722-2
"F2,E5",4713,5197,3479,1718,3092,1606,1,1609,1015,594,1.708754209,864,1767,507,213,213,0,57,0,0.051643192,0,empty,CD-0722-2
"F2,E6",9545,10951,7007,3944,6580,3662,0,3667,2349,1318,1.782245827,2102,5015,1146,457,456,1,131,1,0.046052632,0,empty,CD-0722-2
"F2,E7",11542,12973,8621,4352,7536,3869,0,3874,2531,1343,1.884586746,2142,11195,1649,577,566,11,163,2,0.086572438,0,empty,CD-0722-2
"F2,E8",6204,6723,4702,2021,4098,2106,0,2109,1367,742,1.842318059,1127,3289,861,345,342,3,111,2,0.067251462,0,empty,CD-0722-2
"F2,E9",490545,595179,357362,237817,343980,204949,0,205089,164676,40413,4.074827407,123872,28863,5091,1770,1741,29,496,4,0.06777714,0,hg38,CD-0722-2
"F2,E10",4139,4655,3025,1630,2919,1559,0,1559,1028,531,1.935969868,919,2601,787,268,258,10,76,2,0.120155039,0,empty,CD-0722-2
"F2,E11",641497,757372,471448,285924,438728,250266,1,250484,193968,56516,3.432090028,148171,214452,32663,12131,11887,244,1875,8,0.055102213,0,hg38,CD-0722-2
"F2,E12",6909,8159,4856,3303,4920,2849,0,2851,1803,1048,1.720419847,1807,2703,490,211,208,3,71,2,0.043269231,0,empty,CD-0722-2
"F2,F1",580103,658916,440032,218884,378890,194903,1,195079,154063,41016,3.756168325,111804,150738,19683,7272,7123,149,1357,7,0.056717675,0,hg38,CD-0722-2
"F2,F2",5784,6600,4180,2420,3956,2190,0,2191,1438,753,1.909694555,1325,3233,760,302,298,4,100,2,0.070469799,0,empty,CD-0722-2
"F2,F3",5746,6287,4240,2047,3725,1985,0,1988,1375,613,2.243066884,1058,3857,781,308,296,12,99,3,0.067567568,0,empty,CD-0722-2
"F2,F4",8056,8977,5882,3095,5488,2885,0,2890,1901,989,1.922143579,1632,1286,285,122,122,0,49,0,0.008196721,0,empty,CD-0722-2
"F2,F5",6141,6883,4534,2349,4209,2205,0,2207,1443,764,1.888743455,1242,3183,636,243,234,9,105,1,0.008547009,0,empty,CD-0722-2
"F2,F6",6848,7935,4910,3025,4660,2655,0,2658,1674,984,1.701219512,1601,3090,621,291,288,3,86,2,0.072916667,0,empty,CD-0722-2
"F2,F7",7293,8116,5390,2726,4849,2628,0,2630,1686,944,1.786016949,1479,1563,432,171,171,0,60,0,0.052631579,0,empty,CD-0722-2
"F2,F8",607253,691786,462448,229338,399355,206522,1,206718,159221,47497,3.352232773,117636,37240,4656,1893,1849,44,388,2,0.02812331,0,hg38,CD-0722-2
"F2,F9",6153,6818,4685,2133,4105,2105,0,2105,1383,722,1.915512465,1164,4312,815,327,320,7,113,2,0.075,0,empty,CD-0722-2
"F2,F10",7221,8251,5433,2818,4778,2506,0,2509,1640,869,1.887226697,1397,2652,722,284,281,3,74,1,0.06405694,0,empty,CD-0722-2
"F2,F11",6092,6922,4642,2280,4164,2151,0,2159,1445,714,2.023809524,1243,2376,602,237,233,4,63,2,0.060085837,0,empty,CD-0722-2
"F2,F12",6426,7071,4747,2324,4316,2359,0,2359,1563,796,1.963567839,1340,407,82,42,42,0,12,0,0.023809524,0,empty,CD-0722-2
"F2,G1",8144,9134,6027,3107,5484,2846,0,2847,1869,978,1.911042945,1635,22839,3019,1181,1146,35,271,2,0.07504363,0,empty,CD-0722-2
"F2,G2",643984,743025,462844,280181,429801,240977,0,241117,183955,57162,3.218134425,143343,55165,8574,3279,3211,68,655,5,0.045157272,0,hg38,CD-0722-2
"F2,G3",7338,7954,5360,2594,4770,2628,0,2630,1602,1028,1.558365759,1426,3659,969,347,341,6,104,2,0.020527859,0,empty,CD-0722-2
"F2,G4",14033,16337,9840,6497,9721,5842,0,5843,3535,2308,1.531629116,3456,204,45,22,21,1,13,1,0,0,empty,CD-0722-2
"F2,G5",4446,5062,3237,1825,3020,1684,0,1684,1085,599,1.811352254,956,2418,531,236,230,6,82,2,0.086956522,0,empty,CD-0722-2
"F2,G6",6795,7388,4944,2444,4582,2396,0,2396,1621,775,2.091612903,1334,218,42,25,25,0,15,0,0.32,0,empty,CD-0722-2
"F2,G7",602427,682831,462109,220722,395501,200676,4,200869,151867,49002,3.099200033,113667,162866,21787,8460,8281,179,1380,7,0.063760415,0,hg38,CD-0722-2
"F2,G8",3889,4467,2886,1581,2678,1426,0,1426,944,482,1.958506224,808,2550,589,222,218,4,77,1,0.04587156,0,empty,CD-0722-2
"F2,G9",4815,5653,3492,2161,3333,1880,0,1884,1253,631,1.985736926,1101,3289,635,290,288,2,85,1,0.076388889,0,empty,CD-0722-2
"F2,G10",539271,671653,366319,305334,393226,267625,0,267786,194926,72860,2.675349986,164626,41014,9638,3537,3481,56,707,4,0.047112899,0,hg38,CD-0722-2
"F2,G11",5775,6367,4265,2102,3865,2060,0,2060,1384,676,2.047337278,1130,2174,579,211,205,6,80,2,0.073170732,0,empty,CD-0722-2
"F2,G12",1277124,1575294,913776,661518,915283,562634,4,563084,428087,134997,3.171085283,349075,343564,54884,20795,20414,381,2884,7,0.058489272,0,hg38,CD-0722-2
"F2,H1",559097,638089,420936,217153,367076,193315,2,193506,147065,46441,3.166706143,112362,82515,8983,3433,3317,116,708,7,0.044317154,0,hg38,CD-0722-2
"F2,H2",5649,6310,4220,2090,3772,2014,0,2016,1327,689,1.925979681,1135,3516,725,290,290,0,101,0,0.106896552,0,empty,CD-0722-2
"F2,H3",5008,5787,3662,2125,3376,1915,0,1915,1215,700,1.735714286,1072,2151,434,196,194,2,76,1,0.015463918,0,empty,CD-0722-2
"F2,H4",6924,7901,5079,2822,4669,2550,0,2551,1736,815,2.13006135,1468,364,93,61,61,0,26,0,0.229508197,0,empty,CD-0722-2
"F2,H5",7676,8977,5534,3443,5344,2981,0,2983,1964,1019,1.927379784,1806,4604,814,378,368,10,118,2,0.125,0,empty,CD-0722-2
"F2,H6",4945,5819,3609,2210,3459,2006,0,2007,1330,677,1.964549483,1202,2976,659,274,269,5,103,2,0.018587361,0,empty,CD-0722-2
"F2,H7",5720,6527,4283,2244,3988,2125,0,2130,1449,681,2.127753304,1219,3494,844,334,324,10,121,3,0.055555556,0,empty,CD-0722-2
"F2,H8",12815,15160,9366,5794,9027,5180,0,5181,3749,1432,2.61801676,3078,2837,591,240,238,2,74,2,0.054621849,0,empty,CD-0722-2
"F2,H9",4806,5326,3628,1698,3129,1615,0,1615,1094,521,2.099808061,856,1595,363,185,183,2,51,2,0.12568306,0,empty,CD-0722-2
"F2,H10",4746,5441,3474,1967,3267,1786,0,1786,1239,547,2.265082267,1050,2625,632,273,270,3,88,3,0.114814815,0,empty,CD-0722-2
"F2,H11",6331,7604,4341,3263,4514,2956,0,2958,1621,1337,1.212415856,1760,112,21,10,10,0,3,0,0,0,empty,CD-0722-2
"F2,H12",5086,5651,3664,1987,3372,1901,0,1901,1307,594,2.2003367,1092,2395,491,213,211,2,63,1,0.109004739,0,empty,CD-0722-2
"F3,A1",3873,4394,2746,1648,2759,1597,0,1605,1089,516,2.110465116,947,1809,379,117,115,2,35,1,0.165217391,0,empty,CD-0722-2
"F3,A2",6814,7961,4995,2966,4671,2650,0,2651,1721,930,1.850537634,1546,2263,526,203,198,5,54,2,0.065656566,0,empty,CD-0722-2
"F3,A3",508056,616333,367555,248778,356358,211336,0,211472,170465,41007,4.1569732,128957,83005,11734,4543,4449,94,882,8,0.046752079,0,hg38,CD-0722-2
"F3,A4",496610,557662,378630,179032,320120,164569,1,164691,124769,39922,3.125319373,92327,16339,3572,1299,1283,16,268,3,0.038191738,0,hg38,CD-0722-2
"F3,A5",984308,1168624,716952,451672,674489,406708,2,407034,303332,103702,2.925035197,240555,181402,32347,11965,11734,231,1861,5,0.034941197,0,hg38,CD-0722-2
"F3,A6",4648,5359,3320,2039,3265,1931,0,1933,1284,649,1.978428351,1087,3027,754,310,304,6,99,2,0.131578947,0,empty,CD-0722-2
"F3,A7",3644,4318,2589,1729,2646,1540,0,1540,967,573,1.687609075,925,1468,248,94,90,4,41,1,0.1,0,empty,CD-0722-2
"F3,A8",2595,2933,1909,1024,1773,959,0,960,670,290,2.310344828,535,2304,481,172,168,4,56,3,0.089285714,0,empty,CD-0722-2
"F3,A9",539003,643282,399463,243819,370358,211095,0,211287,168940,42347,3.989420738,125045,92946,17435,6575,6472,103,1146,6,0.072466007,0,hg38,CD-0722-2
"F3,A10",5724,6392,4326,2066,3848,2029,0,2031,1260,771,1.634241245,1148,285,74,35,35,0,23,0,0.057142857,0,empty,CD-0722-2
"F3,A11",3712,4181,2780,1401,2536,1327,0,1331,893,438,2.038812785,741,1664,416,125,122,3,48,2,0.172131148,0,empty,CD-0722-2
"F3,A12",574621,664538,438483,226055,375526,197374,0,197554,144171,53383,2.700691231,112842,27306,8762,3152,3137,15,744,2,0.016257571,0,hg38,CD-0722-2
"F3,B1",4432,5191,3203,1988,3137,1803,0,1804,1155,649,1.779661017,1100,1404,348,113,113,0,44,0,0.10619469,0,empty,CD-0722-2
"F3,B2",5082,5827,3446,2381,3545,2128,0,2128,1366,762,1.792650919,1282,608,131,57,57,0,21,0,0.122807018,0,empty,CD-0722-2
"F3,B3",3931,4510,2887,1623,2734,1532,0,1532,1019,513,1.986354776,873,1705,405,191,188,3,54,2,0.159574468,0,empty,CD-0722-2
"F3,B4",4601,5430,3305,2125,3309,1930,0,1931,1208,723,1.670816044,1188,1330,283,113,106,7,40,2,0.150943396,0,empty,CD-0722-2
"F3,B5",4240,2571,1647,924,1852,1015,0,1022,677,345,1.962318841,608,994,209,103,98,5,34,1,0.142857143,0,empty,CD-0722-2
"F3,B6",5107,5916,3563,2353,3617,2179,0,2181,1273,908,1.401982379,1290,1568,474,193,193,0,58,0,0.041450777,0,empty,CD-0722-2
"F3,B7",4274,4782,3260,1522,2818,1486,0,1488,946,542,1.745387454,784,1361,282,115,112,3,32,1,0.035714286,0,empty,CD-0722-2
"F3,B8",3220,3676,2350,1326,2245,1206,0,1207,784,423,1.853427896,705,1292,368,134,131,3,47,2,0.045801527,0,empty,CD-0722-2
"F3,B9",693471,827185,510947,316238,471924,273910,2,274158,221234,52924,4.180220694,162382,72689,11082,4205,4117,88,804,4,0.048336167,0,hg38,CD-0722-2
"F3,B10",2995,3475,2137,1338,2064,1169,1,1174,723,451,1.603104213,701,550,43,26,26,0,13,0,0,0,empty,CD-0722-2
"F3,B11",7436,8638,5148,3490,5058,3022,0,3025,1777,1248,1.423878205,1809,277,38,30,29,1,14,1,0.137931034,0,empty,CD-0722-2
"F3,B12",4057,4635,2988,1647,2768,1537,0,1537,1014,523,1.938814532,863,1469,339,151,149,2,48,1,0.147651007,0,empty,CD-0722-2
"F3,C1",1029488,1134693,797066,337627,641212,316169,1,316462,248466,67996,3.654126713,174911,39461,7837,2807,2761,46,541,4,0.022093444,0,hg38,CD-0722-2
"F3,C2",6372,7376,4591,2785,4383,2497,0,2500,1604,896,1.790178571,1464,2027,529,190,188,2,57,1,0.175531915,0,empty,CD-0722-2
"F3,C3",1233667,1482271,924468,557803,834460,477664,6,478120,402755,75365,5.344058913,283116,134800,17014,6740,6574,166,1169,6,0.067386675,0,hg38,CD-0722-2
"F3,C4",3936,4314,2967,1347,2724,1362,0,1367,885,482,1.836099585,771,2088,441,175,174,1,49,1,0.063218391,0,empty,CD-0722-2
"F3,C5",5496,6308,4023,2285,3828,2091,0,2097,1371,726,1.888429752,1219,1743,300,135,135,0,53,0,0.088888889,0,empty,CD-0722-2
"F3,C6",4761,5422,3475,1947,3401,1847,0,1847,1240,607,2.042833608,1076,1628,302,121,121,0,51,0,0.016528926,0,empty,CD-0722-2
"F3,C7",6914,8657,4817,3840,5137,3212,0,3217,1891,1326,1.426093514,2044,466,165,70,70,0,17,0,0,0,empty,CD-0722-2
"F3,C8",584871,679557,438396,241161,390733,211669,1,211835,174667,37168,4.69939195,122743,193349,27489,10889,10656,233,1831,7,0.038006757,0,hg38,CD-0722-2
"F3,C9",5250,6310,3854,2456,3727,2096,0,2101,1391,710,1.95915493,1291,1564,309,143,140,3,50,2,0.014285714,0,empty,CD-0722-2
"F3,C10",552634,651238,407231,244007,374887,212588,0,212748,164513,48235,3.410656163,126532,20064,2004,725,705,20,209,4,0.053900709,0,hg38,CD-0722-2
"F3,C11",4959,5596,3667,1929,3348,1821,0,1823,1242,581,2.137693632,1030,1737,382,146,145,1,46,1,0.110344828,0,empty,CD-0722-2
"F3,C12",574363,657659,433145,224514,375157,197150,0,197326,150486,46840,3.212766866,114452,68907,12942,4794,4723,71,894,7,0.046368833,0,hg38,CD-0722-2
"F3,D1",6445,7309,4577,2732,4405,2587,0,2591,1556,1035,1.503381643,1508,974,179,75,75,0,29,0,0.36,0,empty,CD-0722-2
"F3,D2",5033,5492,3768,1724,3354,1747,0,1749,1082,667,1.622188906,941,2982,677,278,277,1,86,1,0.119133574,0,empty,CD-0722-2
"F3,D3",4799,5318,3571,1747,3243,1816,0,1820,1213,607,1.998352554,999,1330,271,122,119,3,42,2,0.226890756,0,empty,CD-0722-2
"F3,D4",3839,4385,2845,1540,2607,1410,0,1411,942,469,2.008528785,798,1458,368,133,133,0,46,0,0.052631579,0,empty,CD-0722-2
"F3,D5",4305,5075,3145,1930,3024,1648,0,1649,1077,572,1.882867133,999,1706,283,122,122,0,43,0,0.032786885,0,empty,CD-0722-2
"F3,D6",6327,7481,4424,3057,4464,2705,0,2714,1630,1084,1.503690037,1658,1705,369,153,153,0,56,0,0.032679739,0,empty,CD-0722-2
"F3,D7",3508,3926,2668,1258,2358,1246,0,1246,836,410,2.03902439,677,1882,477,234,234,0,66,0,0.081196581,0,empty,CD-0722-2
"F3,D8",4353,4956,3218,1738,2997,1597,0,1599,1054,545,1.933944954,937,1503,446,190,190,0,53,0,0.068421053,0,empty,CD-0722-2
"F3,D9",2717,3069,2017,1052,1866,977,0,978,629,349,1.802292264,549,1254,279,128,127,1,40,1,0.228346457,0,empty,CD-0722-2
"F3,D10",5097,5980,3556,2424,3574,2154,0,2155,1305,850,1.535294118,1301,1053,281,127,127,0,36,0,0.031496063,0,empty,CD-0722-2
"F3,D11",4956,5653,3714,1939,3387,1787,0,1789,1182,607,1.947281713,1023,2796,675,272,270,2,97,2,0.044444444,0,empty,CD-0722-2
"F3,D12",6199,7231,4520,2711,4305,2402,0,2408,1555,853,1.822977726,1430,3484,939,368,365,3,118,1,0.01369863,0,empty,CD-0722-2
"F3,E1",7792,8644,5779,2865,5106,2770,0,2771,1738,1033,1.682478219,1536,2970,670,257,249,8,77,2,0.100401606,0,empty,CD-0722-2
"F3,E2",5266,6070,3739,2331,3635,2041,0,2043,1299,744,1.745967742,1243,2082,481,182,179,3,61,1,0.134078212,0,empty,CD-0722-2
"F3,E3",3371,3970,2527,1443,2358,1281,0,1281,845,436,1.938073394,723,2628,624,259,259,0,70,0,0.046332046,0,empty,CD-0722-2
"F3,E4",5080,5647,3754,1893,3510,1846,0,1849,1213,636,1.907232704,1070,2511,613,283,281,2,88,1,0.028469751,0,empty,CD-0722-2
"F3,E5",4244,4722,3185,1537,2822,1461,0,1462,976,486,2.008230453,813,1634,379,162,161,1,48,1,0.111801242,0,empty,CD-0722-2
"F3,E6",8050,9113,5835,3278,5524,3073,0,3077,1988,1089,1.825528007,1773,3179,604,238,237,1,84,1,0.021097046,0,empty,CD-0722-2
"F3,E7",7287,8223,5521,2702,4961,2584,0,2584,1655,929,1.781485468,1459,3551,832,318,317,1,83,1,0.135646688,0,empty,CD-0722-2
"F3,E8",1115024,1280036,841776,438260,726232,389191,2,389561,310191,79370,3.908164294,222881,190893,37005,13917,13697,220,2162,10,0.055997664,0,hg38,CD-0722-2
"F3,E9",4114,4723,3052,1671,2807,1505,0,1506,996,510,1.952941176,895,2286,511,225,224,1,74,1,0.035714286,0,empty,CD-0722-2
"F3,E10",4104,4690,3040,1650,2783,1500,0,1500,970,530,1.830188679,849,1937,409,196,196,0,48,0,0.005102041,0,empty,CD-0722-2
"F3,E11",5071,5882,3721,2161,3487,1985,0,1987,1238,749,1.652870494,1157,2134,749,269,268,1,69,1,0.212686567,0,empty,CD-0722-2
"F3,E12",5836,6889,4211,2678,4201,2361,0,2363,1537,826,1.860774818,1454,1790,441,207,202,5,57,2,0.054455446,0,empty,CD-0722-2
"F3,F1",6367,7272,4568,2704,4379,2441,0,2442,1586,856,1.852803738,1438,2153,442,182,179,3,63,1,0.083798883,0,empty,CD-0722-2
"F3,F2",5847,6731,4264,2467,4103,2238,0,2238,1510,728,2.074175824,1321,2577,618,206,203,3,66,2,0.113300493,0,empty,CD-0722-2
"F3,F3",4603,5285,3310,1975,3253,1816,0,1817,1198,619,1.935379645,1084,2912,760,253,251,2,76,1,0.023904382,0,empty,CD-0722-2
"F3,F4",6950,7701,5103,2598,4711,2447,1,2454,1644,810,2.02962963,1380,622,124,50,50,0,25,0,0,0,empty,CD-0722-2
"F3,F5",5846,6496,4362,2134,3917,2058,0,2060,1360,700,1.942857143,1126,2094,618,195,194,1,63,1,0.015463918,0,empty,CD-0722-2
"F3,F6",5808,6836,4176,2660,4015,2291,0,2294,1398,896,1.560267857,1340,2902,748,261,260,1,64,1,0.065384615,0,empty,CD-0722-2
"F3,F7",6343,7092,4673,2419,4236,2295,0,2298,1501,797,1.883312422,1301,1009,190,91,91,0,33,0,0.065934066,0,empty,CD-0722-2
"F3,F8",4888,5548,3625,1923,3357,1835,0,1838,1197,641,1.867394696,1032,326,30,26,25,1,21,1,0,0,empty,CD-0722-2
"F3,F9",5332,5882,4035,1847,3503,1811,0,1812,1228,584,2.102739726,979,2827,724,329,326,3,105,2,0.101226994,0,empty,CD-0722-2
"F3,F10",561480,643355,420632,222723,370921,201482,2,201619,157740,43879,3.594885936,115037,89567,14959,5355,5217,138,1019,5,0.027985432,0,hg38,CD-0722-2
"F3,F11",884593,1014158,678650,335508,576667,307614,2,307888,253665,54223,4.678180846,173642,81615,13784,5434,5338,96,983,5,0.051704758,0,hg38,CD-0722-2
"F3,F12",5779,6626,4145,2481,3965,2168,0,2169,1371,798,1.718045113,1295,260,32,24,24,0,9,0,0.041666667,0,empty,CD-0722-2
"F3,G1",5760,6427,4310,2117,3987,2110,0,2110,1424,686,2.075801749,1186,3488,905,354,352,2,88,2,0.042613636,0,empty,CD-0722-2
"F3,G2",3681,4190,2480,1710,2633,1559,1,1560,1026,534,1.921348315,991,662,165,71,71,0,32,0,0.070422535,0,empty,CD-0722-2
"F3,G3",679949,807523,506052,301471,460848,256564,2,256792,201325,55467,3.629635639,152867,121346,18212,6906,6755,151,1149,7,0.063952628,0,hg38,CD-0722-2
"F3,G4",12659,14757,8986,5771,8814,5257,0,5261,3077,2184,1.408882784,3136,161,31,19,18,1,13,1,0,0,empty,CD-0722-2
"F3,G5",4062,4817,2941,1876,2821,1592,0,1592,1081,511,2.115459883,959,1926,485,173,173,0,60,0,0.040462428,0,empty,CD-0722-2
"F3,G6",5775,6627,4267,2360,3911,2128,0,2128,1374,754,1.822281167,1241,266,57,23,23,0,8,0,0,0,empty,CD-0722-2
"F3,G7",4656,5034,3513,1521,3135,1581,0,1581,1031,550,1.874545455,856,2649,792,255,253,2,67,2,0.007905138,0,empty,CD-0722-2
"F3,G8",3402,3878,2400,1478,2326,1266,0,1272,826,446,1.852017937,758,1573,383,187,186,1,59,1,0.043010753,0,empty,CD-0722-2
"F3,G9",4088,4854,2968,1886,2947,1639,0,1641,1115,526,2.119771863,972,2450,582,224,221,3,86,3,0.099547511,0,empty,CD-0722-2
"F3,G10",5908,6880,4327,2553,4190,2374,0,2374,1550,824,1.881067961,1374,2300,520,224,218,6,74,2,0.077981651,0,empty,CD-0722-2
"F3,G11",4915,5585,3692,1893,3378,1768,0,1773,1169,604,1.935430464,1021,1290,273,114,114,0,42,0,0.131578947,0,empty,CD-0722-2
"F3,G12",1132003,1396001,812712,583289,810953,493802,3,494196,382622,111574,3.429311488,307792,81178,19643,7271,7161,110,1265,9,0.031699483,0,hg38,CD-0722-2
"F3,H1",4887,5465,3525,1940,3391,1842,0,1843,1228,615,1.996747967,1051,1334,313,113,110,3,45,1,0.136363636,0,empty,CD-0722-2
"F3,H2",4989,5806,3682,2124,3560,1949,0,1949,1251,698,1.79226361,1178,2199,423,207,206,1,70,1,0.038834951,0,empty,CD-0722-2
"F3,H3",4441,4947,3182,1765,2934,1549,0,1549,1065,484,2.200413223,910,1528,371,173,172,1,59,1,0.104651163,0,empty,CD-0722-2
"F3,H4",6405,7342,4702,2640,4325,2360,0,2363,1518,845,1.796449704,1404,285,45,24,23,1,10,1,0,0,empty,CD-0722-2
"F3,H5",6702,7503,4828,2675,4383,2427,0,2428,1572,856,1.836448598,1367,1944,470,192,190,2,72,2,0.068421053,0,empty,CD-0722-2
"F3,H6",4291,4929,3163,1766,2911,1640,0,1640,1113,527,2.111954459,931,2012,506,181,176,5,57,2,0.022727273,0,empty,CD-0722-2
"F3,H7",4813,5435,3524,1911,3300,1745,0,1745,1195,550,2.172727273,999,2193,537,253,244,9,96,2,0.069672131,0,empty,CD-0722-2
"F3,H8",5563,6206,4029,2177,3746,2053,0,2056,1360,696,1.954022989,1181,2206,498,207,204,3,75,2,0.073529412,0,empty,CD-0722-2
"F3,H9",4133,4633,3072,1561,2796,1475,0,1475,969,506,1.915019763,837,1059,181,83,82,1,36,1,0.048780488,0,empty,CD-0722-2
"F3,H10",4098,4723,3077,1646,2764,1516,0,1517,1023,494,2.070850202,860,1471,239,132,130,2,61,1,0.061538462,0,empty,CD-0722-2
"F3,H11",5766,6993,3928,3065,4205,2749,0,2752,1497,1255,1.192828685,1713,91,8,8,8,0,6,0,0.125,0,empty,CD-0722-2
"F3,H12",4284,4970,3103,1867,3028,1725,0,1726,1116,610,1.829508197,1037,1717,347,133,130,3,41,1,0.053846154,0,empty,CD-0722-2
"F4,A1",554703,650946,416965,233981,376298,203611,0,203782,158025,45757,3.453569946,119529,93074,10847,4144,4023,121,780,3,0.053691275,0,hg38,CD-0722-2
"F4,A2",6391,7430,4574,2856,4339,2471,0,2471,1498,973,1.539568345,1441,1809,323,132,127,5,45,2,0.070866142,0,empty,CD-0722-2
"F4,A3",3706,4061,2705,1356,2473,1373,0,1375,927,448,2.069196429,756,1692,462,178,177,1,64,1,0.056497175,0,empty,CD-0722-2
"F4,A4",6955,7740,5029,2711,4737,2597,0,2598,1736,862,2.013921114,1449,1020,289,130,130,0,40,0,0.076923077,0,empty,CD-0722-2
"F4,A5",5388,5979,3996,1983,3638,1962,0,1962,1261,701,1.798858773,1096,1454,274,130,127,3,45,3,0.047244094,0,empty,CD-0722-2
"F4,A6",11805,13433,8686,4747,7869,4303,0,4306,3041,1265,2.403952569,2476,3021,541,229,226,3,89,2,0.128318584,0,empty,CD-0722-2
"F4,A7",4141,4548,3056,1492,2784,1568,0,1570,1050,520,2.019230769,847,1089,225,119,118,1,57,1,0.016949153,0,empty,CD-0722-2
"F4,A8",2593,2970,1840,1130,1793,1018,0,1018,701,317,2.211356467,601,2123,451,205,200,5,68,2,0.015,0,empty,CD-0722-2
"F4,A9",4483,5224,3308,1916,3174,1731,1,1736,1155,581,1.987951807,993,2059,471,202,199,3,69,2,0.020100503,0,empty,CD-0722-2
"F4,A10",5667,6281,4269,2012,3662,1957,0,1959,1227,732,1.676229508,1049,598,114,68,66,2,20,1,0.484848485,0,empty,CD-0722-2
"F4,A11",3884,4256,2893,1363,2610,1322,0,1324,875,449,1.948775056,709,1602,272,145,144,1,51,1,0.097222222,0,empty,CD-0722-2
"F4,A12",563538,636149,431147,205002,359140,182702,3,182877,137365,45512,3.018214976,103427,105816,16588,6430,6307,123,1144,3,0.03139369,0,hg38,CD-0722-2
"F4,B1",4535,5323,3159,2164,3204,1854,0,1854,1153,701,1.644793153,1113,1045,123,58,58,0,30,0,0.034482759,0,empty,CD-0722-2
"F4,B2",4875,5657,3246,2411,3477,2118,0,2122,1304,818,1.594132029,1280,770,195,69,68,1,31,1,0.014705882,0,empty,CD-0722-2
"F4,B3",5746,6731,4114,2617,4123,2330,0,2330,1574,756,2.082010582,1373,1738,304,140,138,2,70,1,0.086956522,0,empty,CD-0722-2
"F4,B4",4722,5582,3321,2261,3298,1991,0,1994,1249,745,1.676510067,1233,1625,328,127,123,4,35,2,0.25203252,0,empty,CD-0722-2
"F4,B5",4531,2739,1705,1034,1996,1120,0,1130,778,352,2.210227273,678,1286,300,84,84,0,32,0,0.285714286,0,empty,CD-0722-2
"F4,B6",768107,940510,539975,400535,541912,352300,2,352561,262763,89798,2.926156485,213177,29922,6599,2371,2326,45,501,2,0.015907137,0,hg38,CD-0722-2
"F4,B7",4791,5264,3626,1638,3226,1710,1,1711,1089,622,1.750803859,923,1263,269,114,112,2,44,1,0.008928571,0,empty,CD-0722-2
"F4,B8",507361,575335,386776,188559,329021,169351,1,169506,131415,38091,3.450027566,96422,51462,6415,2472,2410,62,516,3,0.06846473,0,hg38,CD-0722-2
"F4,B9",6670,7661,4841,2820,4618,2659,0,2664,1625,1039,1.56400385,1551,1297,291,106,104,2,48,1,0,0,empty,CD-0722-2
"F4,B10",3292,3541,2257,1284,2187,1216,0,1221,770,451,1.707317073,693,515,98,52,52,0,22,0,0.134615385,0,empty,CD-0722-2
"F4,B11",7776,8921,5512,3409,5374,3199,0,3203,1808,1395,1.296057348,1900,377,50,35,33,2,27,1,0.121212121,0,empty,CD-0722-2
"F4,B12",4214,4817,3065,1752,2889,1607,0,1607,1039,568,1.829225352,924,1762,366,163,158,5,64,2,0.069620253,0,empty,CD-0722-2
"F4,C1",8255,9065,6215,2850,5444,2881,0,2886,1843,1043,1.767018217,1566,1166,168,62,61,1,31,1,0.180327869,0,empty,CD-0722-2
"F4,C2",6928,7903,4953,2950,4820,2761,0,2763,1820,943,1.930010604,1623,2626,507,204,204,0,62,0,0.112745098,0,empty,CD-0722-2
"F4,C3",7152,8040,5242,2798,4932,2720,0,2724,1792,932,1.922746781,1569,976,194,96,94,2,36,1,0,0,empty,CD-0722-2
"F4,C4",4126,4598,3076,1522,2836,1457,5,1463,1009,454,2.22246696,821,1593,406,167,164,3,57,2,0.091463415,0,empty,CD-0722-2
"F4,C5",6315,7350,4756,2594,4405,2404,1,2405,1570,835,1.880239521,1399,1715,526,187,187,0,78,0,0.112299465,0,empty,CD-0722-2
"F4,C6",5226,5759,3725,2034,3449,1866,0,1866,1262,604,2.089403974,1041,1205,279,110,108,2,52,2,0.046296296,0,empty,CD-0722-2
"F4,C7",7386,8852,5129,3723,5252,3228,0,3230,1970,1260,1.563492063,1985,432,109,43,43,0,25,0,0.139534884,0,empty,CD-0722-2
"F4,C8",8014,8970,5788,3182,5316,2901,0,2906,1853,1053,1.759734093,1664,3043,654,294,293,1,104,1,0.04778157,0,empty,CD-0722-2
"F4,C9",7851,9277,5727,3550,5418,2918,0,2920,1949,971,2.007209063,1761,2293,446,161,160,1,54,1,0.06875,0,empty,CD-0722-2
"F4,C10",6239,6821,4669,2152,4115,2126,0,2127,1403,724,1.937845304,1166,1747,314,147,146,1,54,1,0.130136986,0,empty,CD-0722-2
"F4,C11",5613,6554,4045,2509,3793,2130,0,2130,1406,724,1.94198895,1243,2102,632,231,228,3,82,1,0.00877193,0,empty,CD-0722-2
"F4,C12",7489,8393,5603,2790,5038,2651,0,2654,1711,943,1.814422057,1498,1809,452,172,171,1,65,1,0.023391813,0,empty,CD-0722-2
"F4,D1",609098,741039,441879,299160,426267,249393,2,249604,202346,47258,4.281730077,152256,72297,10618,4232,4134,98,769,4,0.062893082,0,hg38,CD-0722-2
"F4,D2",5613,6250,4151,2099,3744,1931,0,1931,1183,748,1.581550802,1096,2913,932,348,340,8,105,2,0.064705882,0,empty,CD-0722-2
"F4,D3",5055,5873,3636,2237,3454,1923,0,1928,1263,665,1.89924812,1157,1516,398,163,163,0,74,0,0.09202454,0,empty,CD-0722-2
"F4,D4",3785,4346,2760,1586,2570,1373,0,1375,902,473,1.906976744,764,1458,247,112,109,3,41,2,0.018348624,0,empty,CD-0722-2
"F4,D5",4455,5108,3267,1841,3160,1711,0,1711,1109,602,1.842192691,970,1578,289,132,130,2,59,2,0.046153846,0,empty,CD-0722-2
"F4,D6",7043,7978,4946,3032,4761,2786,0,2788,1696,1092,1.553113553,1625,2252,546,229,226,3,69,1,0.048672566,0,empty,CD-0722-2
"F4,D7",3953,4494,2896,1598,2764,1501,0,1502,1007,495,2.034343434,885,2026,486,215,214,1,86,1,0.070093458,0,empty,CD-0722-2
"F4,D8",5365,6085,3848,2237,3685,2008,0,2008,1328,680,1.952941176,1178,2081,546,212,210,2,72,2,0.052380952,0,empty,CD-0722-2
"F4,D9",2538,2751,1863,888,1670,886,0,888,602,286,2.104895105,472,1731,345,175,174,1,50,1,0.045977011,0,empty,CD-0722-2
"F4,D10",4421,5167,3197,1970,3138,1778,0,1778,1139,639,1.782472613,1077,925,190,104,98,6,44,2,0.132653061,0,empty,CD-0722-2
"F4,D11",5090,5633,3830,1803,3360,1802,0,1803,1138,665,1.711278195,944,2885,573,238,235,3,94,2,0.212765957,0,empty,CD-0722-2
"F4,D12",6387,7277,4694,2583,4334,2388,1,2392,1542,850,1.814117647,1387,3177,916,410,405,5,125,2,0.056790123,0,empty,CD-0722-2
"F4,E1",8229,9234,5988,3246,5483,3022,0,3025,1864,1161,1.605512489,1735,2433,452,200,194,6,72,2,0.118556701,0,empty,CD-0722-2
"F4,E2",5836,6762,4161,2601,4082,2335,0,2335,1435,900,1.594444444,1371,1541,362,143,140,3,56,2,0.05,0,empty,CD-0722-2
"F4,E3",3966,4444,2961,1483,2605,1388,0,1394,910,484,1.880165289,761,1859,493,235,233,2,86,2,0.017167382,0,empty,CD-0722-2
"F4,E4",649216,804489,462883,341606,461246,281844,2,282044,227700,54344,4.189974974,175232,216811,39782,15373,15127,246,2219,9,0.043630594,0,hg38,CD-0722-2
"F4,E5",6364,7069,4692,2377,4239,2281,0,2284,1449,835,1.735329341,1284,1418,471,156,154,2,43,1,0.064935065,0,empty,CD-0722-2
"F4,E6",8908,10043,6640,3403,6072,3412,0,3415,2175,1240,1.754032258,1924,3697,813,386,385,1,124,1,0.054545455,0,empty,CD-0722-2
"F4,E7",531408,617867,394356,223511,350232,193243,0,193356,151632,41724,3.634167386,112554,228784,28031,10872,10598,274,1789,8,0.06633327,0,hg38,CD-0722-2
"F4,E8",1915282,2224275,1444017,780258,1229187,693448,2,694053,568647,125406,4.534448113,395604,468592,94464,36117,35618,499,3758,9,0.048009433,0,hg38,CD-0722-2
"F4,E9",312193,355946,232039,123907,205795,111110,2,111198,78252,32946,2.375159352,64107,251682,9255,3851,3512,339,852,8,0.15261959,0,hg38,CD-0722-2
"F4,E10",4447,4890,3266,1624,2932,1512,0,1513,965,548,1.760948905,868,1209,281,104,102,2,44,1,0.049019608,0,empty,CD-0722-2
"F4,E11",5636,6297,4105,2192,3808,2131,0,2134,1358,776,1.75,1231,1726,365,171,169,2,58,1,0.035502959,0,empty,CD-0722-2
"F4,E12",6226,7329,4562,2767,4409,2417,0,2421,1623,798,2.033834586,1443,1985,510,226,224,2,75,1,0.075892857,0,empty,CD-0722-2
"F4,F1",2451796,2843732,1819642,1024090,1564808,892064,6,892860,706707,186153,3.796377174,520098,253772,53282,19888,19624,264,2787,10,0.057225846,0,hg38,CD-0722-2
"F4,F2",5465,6173,3910,2263,3708,2073,0,2073,1355,718,1.88718663,1208,2465,544,225,222,3,78,2,0.058558559,0,empty,CD-0722-2
"F4,F3",1211356,1459243,878437,580806,827949,492339,3,492701,380956,111745,3.409154772,299961,258003,39514,15176,14823,353,2361,4,0.05120421,0,hg38,CD-0722-2
"F4,F4",687911,779794,515578,264216,448696,235737,7,235961,177800,58161,3.057031344,135959,38030,4672,1873,1820,53,408,3,0.052747253,0,hg38,CD-0722-2
"F4,F5",6207,6608,4580,2028,4078,2129,0,2131,1344,787,1.707750953,1117,2488,361,184,180,4,85,2,0.005555556,0,empty,CD-0722-2
"F4,F6",6441,7528,4592,2936,4438,2613,0,2617,1661,956,1.737447699,1559,2708,562,253,251,2,81,1,0.015936255,0,empty,CD-0722-2
"F4,F7",7101,8028,5173,2855,4856,2619,0,2622,1743,879,1.982935154,1545,926,114,68,68,0,32,0,0.044117647,0,empty,CD-0722-2
"F4,F8",5123,5827,3809,2018,3418,1823,0,1823,1167,656,1.778963415,971,353,43,30,30,0,22,0,0.133333333,0,empty,CD-0722-2
"F4,F9",676123,785580,503471,282109,451005,257448,0,257645,202026,55619,3.632319891,147383,44021,8963,3334,3277,57,684,3,0.032956973,0,hg38,CD-0722-2
"F4,F10",6794,7635,5110,2525,4457,2279,0,2279,1473,806,1.827543424,1271,1563,353,143,140,3,55,2,0,0,empty,CD-0722-2
"F4,F11",5909,6445,4441,2004,3877,1963,0,1965,1277,688,1.856104651,1056,1436,230,105,104,1,44,1,0.048076923,0,empty,CD-0722-2
"F4,F12",6207,6945,4496,2449,4035,2140,0,2146,1424,722,1.972299169,1247,277,57,35,34,1,19,1,0,0,empty,CD-0722-2
"F4,G1",6316,6932,4676,2256,4203,2209,0,2209,1423,786,1.81043257,1209,2965,663,293,292,1,107,1,0.116438356,0,empty,CD-0722-2
"F4,G2",4043,4512,2807,1705,2752,1546,0,1547,1010,537,1.880819367,903,681,93,58,58,0,40,0,0,0,empty,CD-0722-2
"F4,G3",7214,7946,5275,2671,4806,2637,0,2642,1568,1074,1.459962756,1485,2274,679,285,284,1,84,1,0.123239437,0,empty,CD-0722-2
"F4,G4",13907,16184,9580,6604,9671,5921,0,5925,3695,2230,1.656950673,3574,199,35,14,14,0,12,0,0,0,empty,CD-0722-2
"F4,G5",4738,5371,3428,1943,3200,1778,0,1778,1148,630,1.822222222,1015,1843,408,163,161,2,68,1,0.01242236,0,empty,CD-0722-2
"F4,G6",6500,7389,4819,2570,4424,2408,0,2409,1594,815,1.955828221,1338,170,54,37,37,0,20,0,0,0,empty,CD-0722-2
"F4,G7",5097,5642,3831,1811,3445,1757,0,1757,1172,585,2.003418803,996,6432,1238,537,529,8,159,3,0.083175803,0,empty,CD-0722-2
"F4,G8",3692,4261,2712,1549,2562,1404,0,1404,940,464,2.025862069,838,1758,485,155,154,1,79,1,0.051948052,0,empty,CD-0722-2
"F4,G9",4521,5289,3355,1934,3082,1694,0,1694,1091,603,1.809286899,989,2085,627,273,269,4,88,2,0.12267658,0,empty,CD-0722-2
"F4,G10",5606,6544,4059,2485,3956,2258,0,2258,1481,777,1.906048906,1346,2300,594,245,243,2,69,1,0.032921811,0,empty,CD-0722-2
"F4,G11",5449,6216,4018,2198,3674,1984,0,1992,1336,656,2.036585366,1127,1274,309,148,148,0,59,0,0.006756757,0,empty,CD-0722-2
"F4,G12",483790,537366,370933,166433,314145,154225,4,154364,119104,35260,3.377878616,87053,39001,7048,2534,2494,40,544,3,0.027265437,0,hg38,CD-0722-2
"F4,H1",4831,5236,3569,1667,3292,1735,0,1735,1184,551,2.148820327,912,1558,282,107,106,1,51,1,0.160377358,0,empty,CD-0722-2
"F4,H2",8643,9790,6427,3363,5769,3045,0,3045,2197,848,2.590801887,1764,2544,608,247,244,3,72,3,0.024590164,0,empty,CD-0722-2
"F4,H3",4909,5497,3509,1988,3380,1905,0,1907,1261,646,1.952012384,1124,1684,434,204,202,2,80,2,0.079207921,0,empty,CD-0722-2
"F4,H4",6350,7073,4634,2439,4251,2287,1,2289,1491,798,1.868421053,1324,227,64,41,39,2,26,1,0.205128205,0,empty,CD-0722-2
"F4,H5",7137,8253,5174,3079,4857,2619,0,2619,1672,947,1.765575502,1588,2133,469,213,213,0,76,0,0.03286385,0,empty,CD-0722-2
"F4,H6",638240,802380,432527,369853,462057,319922,0,320118,261034,59084,4.418015029,196687,24704,1251,479,431,48,146,4,0.102088167,0,hg38,CD-0722-2
"F4,H7",474581,565754,333461,232293,330893,209658,4,209800,160173,49627,3.227537429,124979,28374,16282,5832,5820,12,872,2,0.017697595,0,hg38,CD-0722-2
"F4,H8",10829,12501,7920,4581,7398,4100,0,4104,2759,1345,2.051301115,2408,2105,420,202,199,3,85,2,0.025125628,0,empty,CD-0722-2
"F4,H9",4191,4575,3162,1413,2772,1399,0,1406,967,439,2.202733485,800,1330,373,154,149,5,49,2,0.134228188,0,empty,CD-0722-2
"F4,H10",1321357,1557775,983596,574179,870404,497158,5,497575,414971,82604,5.023618711,292712,149907,20406,8019,7856,163,1463,6,0.042515275,0,hg38,CD-0722-2
"F4,H11",5696,6768,3851,2917,4067,2647,0,2648,1432,1216,1.177631579,1605,139,33,27,27,0,14,0,0.111111111,0,empty,CD-0722-2
"F4,H12",4585,5021,3285,1736,2962,1636,0,1636,1080,556,1.942446043,913,1878,318,144,143,1,51,1,0.174825175,0,empty,CD-0722-2
"F5,A1",4422,5061,3111,1950,3131,1806,0,1806,1127,679,1.659793814,1068,1215,361,115,114,1,36,1,0.078947368,0,empty,CD-0722-2
"F5,A2",6556,7477,4816,2661,4423,2518,0,2519,1593,926,1.720302376,1410,2188,480,197,194,3,60,2,0.082474227,0,empty,CD-0722-2
"F5,A3",4033,4538,2902,1636,2857,1565,0,1565,1088,477,2.280922432,921,1788,359,124,122,2,37,1,0.139344262,0,empty,CD-0722-2
"F5,A4",6292,6993,4677,2316,4214,2267,0,2267,1474,793,1.858764187,1239,804,163,62,62,0,27,0,0.032258065,0,empty,CD-0722-2
"F5,A5",5586,6050,4148,1902,3701,1962,0,1964,1276,688,1.854651163,1062,2057,412,188,184,4,52,1,0.255434783,0,empty,CD-0722-2
"F5,A6",8662,10280,6331,3949,6166,3491,0,3497,2477,1020,2.428431373,2104,3022,680,242,240,2,82,1,0.008333333,0,empty,CD-0722-2
"F5,A7",4429,5196,3178,2018,3105,1805,0,1807,1155,652,1.771472393,1053,1791,385,178,169,9,51,2,0.065088757,0,empty,CD-0722-2
"F5,A8",2446,2736,1885,851,1627,861,0,861,599,262,2.286259542,430,1638,271,124,122,2,47,2,0.06557377,0,empty,CD-0722-2
"F5,A9",475155,562840,354641,208199,322778,179337,0,179482,143978,35504,4.055261379,105557,81148,13080,5062,4983,79,920,4,0.059201284,0,hg38,CD-0722-2
"F5,A10",6269,6865,4778,2087,4131,2190,0,2190,1397,793,1.761664565,1145,446,92,47,47,0,22,0,0,0,empty,CD-0722-2
"F5,A11",4002,4586,2987,1599,2757,1474,0,1480,939,541,1.735674677,819,1997,502,173,172,1,39,1,0.174418605,0,empty,CD-0722-2
"F5,A12",599912,694737,448379,246358,392825,214641,1,214808,170729,44079,3.873250301,124312,135284,23487,8585,8427,158,1575,6,0.037261184,0,hg38,CD-0722-2
"F5,B1",4882,5437,3581,1856,3256,1742,0,1742,1101,641,1.717628705,978,992,147,47,46,1,24,1,0.02173913,0,empty,CD-0722-2
"F5,B2",4978,5663,3343,2320,3409,2083,0,2084,1303,781,1.66837388,1232,779,147,55,55,0,21,0,0.054545455,0,empty,CD-0722-2
"F5,B3",806109,982634,588804,393830,561785,329768,0,329992,264042,65950,4.003669447,200895,121779,16824,6488,6388,100,1236,5,0.069035692,0,hg38,CD-0722-2
"F5,B4",4923,5722,3481,2241,3476,2055,0,2061,1311,750,1.748,1264,1632,310,109,107,2,31,2,0.317757009,0,empty,CD-0722-2
"F5,B5",8594,7426,4662,2764,4804,2660,0,2670,1960,710,2.76056338,1647,1098,204,95,91,4,32,1,0.087912088,0,empty,CD-0722-2
"F5,B6",679011,847848,458491,389357,495971,332639,2,332852,234760,98092,2.393263467,209928,93842,15523,5854,5744,110,1077,4,0.028203343,0,hg38,CD-0722-2
"F5,B7",4982,5596,3714,1882,3347,1758,0,1758,1193,565,2.111504425,1001,1564,299,136,133,3,52,2,0.022556391,0,empty,CD-0722-2
"F5,B8",879050,1024491,653832,370659,586054,328230,3,328514,276771,51743,5.348955414,190931,157159,22417,8723,8545,178,1510,5,0.055822118,0,hg38,CD-0722-2
"F5,B9",7128,8137,5153,2984,4873,2782,0,2788,1744,1044,1.670498084,1611,1347,170,86,86,0,43,0,0.023255814,0,empty,CD-0722-2
"F5,B10",3238,3559,2296,1263,2152,1210,0,1214,755,459,1.644880174,664,547,110,49,49,0,17,0,0,0,empty,CD-0722-2
"F5,B11",1092302,1227785,843208,384577,686831,350616,3,351007,287159,63848,4.497541035,194809,23714,2642,1092,1054,38,257,2,0.028462998,0,hg38,CD-0722-2
"F5,B12",1281478,1536082,926506,609576,883518,527588,3,527930,456799,71131,6.421939801,317869,25277,10807,3546,3534,12,735,2,0.049518959,0,hg38,CD-0722-2
"F5,C1",8335,9179,6204,2975,5346,2816,0,2825,1780,1045,1.703349282,1527,1429,445,149,147,2,36,2,0.013605442,0,empty,CD-0722-2
"F5,C2",8520,9876,5996,3880,5721,3442,0,3452,2236,1216,1.838815789,2016,2362,549,217,214,3,61,1,0.102803738,0,empty,CD-0722-2
"F5,C3",6884,7706,5024,2682,4713,2526,2,2529,1578,951,1.659305994,1467,896,179,58,58,0,27,0,0.155172414,0,empty,CD-0722-2
"F5,C4",4562,5127,3383,1744,3147,1636,0,1636,1059,577,1.835355286,930,1701,359,166,166,0,52,0,0.078313253,0,empty,CD-0722-2
"F5,C5",6153,6945,4467,2478,4340,2426,0,2430,1630,800,2.0375,1410,1892,464,194,194,0,61,0,0.025773196,0,empty,CD-0722-2
"F5,C6",6060,7163,4344,2819,4168,2355,0,2356,1575,781,2.016645327,1381,2011,499,187,187,0,52,0,0.13368984,0,empty,CD-0722-2
"F5,C7",7675,9114,5378,3736,5440,3375,0,3375,2024,1351,1.498149519,2056,728,231,71,71,0,22,0,0.084507042,0,empty,CD-0722-2
"F5,C8",506890,545668,399420,146248,313688,141044,1,141180,104774,36406,2.877932209,75594,38459,7869,2845,2817,28,612,2,0.030173944,0,hg38,CD-0722-2
"F5,C9",464479,533327,349162,184165,307974,165672,0,165781,134009,31772,4.217833312,96391,34620,4636,1772,1734,38,395,4,0.048442907,0,hg38,CD-0722-2
"F5,C10",6390,7196,4765,2431,4247,2226,0,2227,1427,800,1.78375,1234,2386,464,159,156,3,46,2,0.025641026,0,empty,CD-0722-2
"F5,C11",5449,6172,3995,2177,3718,2001,0,2001,1296,705,1.838297872,1142,1918,516,209,206,3,70,2,0.053398058,0,empty,CD-0722-2
"F5,C12",7893,8692,5860,2832,5198,2769,0,2769,1864,905,2.059668508,1518,2137,500,219,215,4,61,1,0.111627907,0,empty,CD-0722-2
"F5,D1",8558,10441,6019,4422,6185,3786,0,3793,2112,1681,1.256395003,2320,850,200,68,68,0,23,0,0.014705882,0,empty,CD-0722-2
"F5,D2",5495,6219,4074,2145,3781,1977,0,1977,1320,657,2.00913242,1150,3316,1035,397,396,1,101,1,0.133838384,0,empty,CD-0722-2
"F5,D3",5449,6108,3934,2174,3631,1996,0,1998,1375,623,2.2070626,1129,1618,263,110,109,1,42,1,0.036697248,0,empty,CD-0722-2
"F5,D4",4248,4776,3098,1678,2894,1605,0,1608,1047,561,1.86631016,916,1396,292,127,125,2,50,1,0.008,0,empty,CD-0722-2
"F5,D5",4714,5387,3435,1952,3269,1797,0,1799,1203,596,2.018456376,1053,1535,444,162,161,1,45,1,0.229813665,0,empty,CD-0722-2
"F5,D6",6957,8024,4824,3200,4801,2866,0,2871,1679,1192,1.408557047,1715,2408,586,214,213,1,54,1,0.093896714,0,empty,CD-0722-2
"F5,D7",4231,4724,3121,1603,2871,1529,0,1529,1021,508,2.00984252,858,2549,585,229,225,4,82,2,0.048888889,0,empty,CD-0722-2
"F5,D8",4942,5804,3598,2206,3356,1859,0,1860,1194,666,1.792792793,1066,1484,377,147,143,4,46,2,0.132867133,0,empty,CD-0722-2
"F5,D9",2512,2803,1871,932,1670,854,0,854,598,256,2.3359375,452,1959,467,172,172,0,45,0,0.029069767,0,empty,CD-0722-2
"F5,D10",5326,6010,3878,2132,3729,2122,0,2122,1386,736,1.883152174,1216,1241,363,138,137,1,35,1,0.175182482,0,empty,CD-0722-2
"F5,D11",5449,6264,4001,2263,3637,1984,1,1989,1285,704,1.825284091,1133,5273,989,346,335,11,109,2,0.041791045,0,empty,CD-0722-2
"F5,D12",6549,7510,4788,2722,4526,2500,0,2502,1563,939,1.664536741,1444,3688,893,380,374,6,119,2,0.06684492,0,empty,CD-0722-2
"F5,E1",8202,9314,5901,3413,5514,3106,0,3109,1975,1134,1.741622575,1792,2922,681,291,289,2,84,2,0.110726644,0,empty,CD-0722-2
"F5,E2",5791,6478,4051,2427,3953,2214,0,2222,1427,795,1.794968553,1329,1842,251,98,98,0,36,0,0.020408163,0,empty,CD-0722-2
"F5,E3",3951,4563,2966,1597,2879,1565,0,1565,1026,539,1.903525046,916,2585,705,298,296,2,80,2,0.040540541,0,empty,CD-0722-2
"F5,E4",5641,6354,4063,2291,3832,2155,0,2155,1375,780,1.762820513,1261,2463,571,218,215,3,60,2,0.055813953,0,empty,CD-0722-2
"F5,E5",4802,5359,3610,1749,3286,1714,0,1716,1143,573,1.994764398,960,1535,253,129,128,1,49,1,0.015625,0,empty,CD-0722-2
"F5,E6",8909,10342,6432,3910,6188,3598,0,3603,2296,1307,1.756694721,2147,3992,838,346,341,5,107,3,0.120234604,0,empty,CD-0722-2
"F5,E7",8152,9006,6006,3000,5431,2847,0,2851,1897,954,1.988469602,1618,3112,684,257,251,6,86,2,0.079681275,0,empty,CD-0722-2
"F5,E8",692646,794242,522240,272002,454307,246493,0,246718,194702,52016,3.743117502,140435,247148,39644,14973,14639,334,2149,9,0.03231095,0,hg38,CD-0722-2
"F5,E9",4125,4769,3024,1745,2916,1599,0,1599,1011,588,1.719387755,959,2728,595,244,243,1,81,1,0.082304527,0,empty,CD-0722-2
"F5,E10",7830,8393,5703,2690,4946,2533,0,2536,1692,844,2.004739336,1373,1996,443,169,168,1,43,1,0.101190476,0,empty,CD-0722-2
"F5,E11",5669,6405,4143,2262,3818,2064,0,2071,1339,732,1.829234973,1196,2266,657,277,275,2,66,2,0.065454545,0,empty,CD-0722-2
"F5,E12",6204,6952,4583,2369,4259,2308,0,2311,1517,794,1.910579345,1335,2056,405,163,161,2,71,1,0.062111801,0,empty,CD-0722-2
"F5,F1",7468,8360,5441,2919,4888,2624,0,2625,1658,967,1.714581179,1478,2756,814,274,273,1,86,1,0.084249084,0,empty,CD-0722-2
"F5,F2",5470,6199,3943,2256,3742,2019,0,2019,1315,704,1.867897727,1189,3172,808,321,319,2,116,2,0.031347962,0,empty,CD-0722-2
"F5,F3",5187,5938,3729,2209,3558,1943,0,1945,1301,644,2.020186335,1138,3001,759,300,292,8,94,1,0.006849315,0,empty,CD-0722-2
"F5,F4",814822,940650,606275,334375,544651,310255,7,310525,225201,85324,2.639362899,180633,8367,1871,639,637,2,161,1,0.06122449,0,hg38,CD-0722-2
"F5,F5",6208,6751,4540,2211,4071,2187,0,2188,1423,765,1.860130719,1231,2635,735,274,272,2,78,1,0.102941176,0,empty,CD-0722-2
"F5,F6",6670,7760,4785,2975,4599,2625,0,2634,1634,1000,1.634,1598,2792,627,270,268,2,65,1,0.048507463,0,empty,CD-0722-2
"F5,F7",6968,7884,5065,2819,4761,2603,0,2609,1675,934,1.793361884,1510,1032,174,88,88,0,34,0,0.045454545,0,empty,CD-0722-2
"F5,F8",5228,5988,3847,2141,3633,1989,0,1990,1338,652,2.052147239,1151,518,105,58,58,0,28,0,0.017241379,0,empty,CD-0722-2
"F5,F9",1102639,1260460,835832,424628,716668,384605,1,384944,300610,84334,3.564517277,219666,186138,38719,14077,13894,183,2036,7,0.040449115,0,hg38,CD-0722-2
"F5,F10",7071,7997,5213,2784,4724,2511,0,2511,1585,926,1.711663067,1438,1861,322,108,102,6,34,3,0.098039216,0,empty,CD-0722-2
"F5,F11",6116,6664,4597,2067,3924,1987,0,1987,1360,627,2.169059011,1069,2033,479,148,145,3,45,1,0.131034483,0,empty,CD-0722-2
"F5,F12",6108,7379,4387,2992,4339,2459,0,2464,1630,834,1.954436451,1502,146,39,23,23,0,18,0,0.043478261,0,empty,CD-0722-2
"F5,G1",6368,7069,4784,2285,4303,2259,0,2259,1454,805,1.80621118,1228,3453,760,281,275,6,78,2,0.072727273,0,empty,CD-0722-2
"F5,G2",4048,4533,2832,1701,2758,1559,0,1562,1028,534,1.925093633,923,633,125,49,48,1,27,1,0,0,empty,CD-0722-2
"F5,G3",7569,8339,5449,2890,4939,2770,0,2770,1643,1127,1.457852706,1542,2833,639,237,232,5,74,2,0.073275862,0,empty,CD-0722-2
"F5,G4",13829,16267,9691,6576,9686,5927,0,5928,3646,2282,1.597721297,3543,115,17,12,12,0,10,0,0,0,empty,CD-0722-2
"F5,G5",4516,5202,3251,1951,3150,1779,0,1782,1190,592,2.010135135,1034,1786,363,134,129,5,50,2,0.108527132,0,empty,CD-0722-2
"F5,G6",6774,7678,5030,2648,4597,2506,0,2515,1607,908,1.769823789,1444,238,45,17,15,2,10,1,0.133333333,0,empty,CD-0722-2
"F5,G7",11035,12493,8129,4364,7423,4000,0,4011,2947,1064,2.769736842,2274,3589,598,211,208,3,62,1,0.048076923,0,empty,CD-0722-2
"F5,G8",4325,4868,3123,1745,2974,1585,0,1588,1041,547,1.903107861,933,1868,284,137,136,1,47,1,0.110294118,0,empty,CD-0722-2
"F5,G9",598122,752605,421518,331087,432954,272522,0,272712,213945,58767,3.640563582,170445,65579,26398,9682,9655,27,1533,3,0.048679441,0,hg38,CD-0722-2
"F5,G10",5744,6548,4137,2411,3949,2189,0,2193,1398,795,1.758490566,1271,2533,737,266,264,2,71,1,0.064393939,0,empty,CD-0722-2
"F5,G11",5507,6409,3988,2421,3761,2038,0,2041,1315,726,1.811294766,1186,2070,452,164,161,3,52,1,0.031055901,0,empty,CD-0722-2
"F5,G12",4709,5424,3336,2088,3303,1827,0,1828,1138,690,1.649275362,1079,2487,688,267,265,2,75,2,0.049056604,0,empty,CD-0722-2
"F5,H1",581263,674627,431335,243292,388625,213343,4,213522,157985,55537,2.844680123,126181,43168,6339,2461,2389,72,547,5,0.036416911,0,hg38,CD-0722-2
"F5,H2",9548,11100,6845,4255,6613,3924,2,3932,2720,1212,2.244224422,2383,3004,725,309,306,3,90,1,0.065359477,0,empty,CD-0722-2
"F5,H3",6598,7851,4747,3104,4732,2814,0,2814,1867,947,1.971488912,1671,2010,461,192,190,2,63,1,0.068421053,0,empty,CD-0722-2
"F5,H4",6719,7595,4941,2654,4603,2456,0,2460,1630,830,1.963855422,1427,292,115,34,34,0,12,0,0,0,empty,CD-0722-2
"F5,H5",7176,8136,5182,2954,4846,2629,0,2633,1650,983,1.678535097,1548,2292,625,215,213,2,65,2,0.0657277,0,empty,CD-0722-2
"F5,H6",4619,5408,3385,2023,3168,1782,0,1782,1210,572,2.115384615,1016,2523,647,239,236,3,61,2,0.177966102,0,empty,CD-0722-2
"F5,H7",5532,5979,4016,1963,3681,1983,0,1986,1344,642,2.093457944,1076,2731,499,249,246,3,94,1,0.077235772,0,empty,CD-0722-2
"F5,H8",5981,6888,4347,2541,4016,2214,0,2219,1436,783,1.833971903,1293,2367,385,163,160,3,59,1,0.14375,0,empty,CD-0722-2
"F5,H9",1240543,1496352,872432,623920,853992,559473,3,559856,427060,132796,3.215910118,336487,14558,1036,407,396,11,115,3,0.171717172,0,hg38,CD-0722-2
"F5,H10",4341,5095,3181,1914,2975,1608,0,1608,1079,529,2.039697543,929,1325,171,102,102,0,49,0,0.019607843,0,empty,CD-0722-2
"F5,H11",6202,7266,4266,3000,4336,2776,0,2778,1532,1246,1.22953451,1679,37,9,8,8,0,6,0,0.125,0,empty,CD-0722-2
"F5,H12",4580,5192,3394,1798,3185,1815,0,1820,1198,622,1.926045016,1050,1890,298,123,122,1,43,1,0.081967213,0,empty,CD-0722-2
"F6,A1",4163,4963,3002,1961,3050,1753,1,1754,1160,594,1.952861953,1015,1864,357,126,126,0,39,0,0.015873016,0,empty,CD-0722-2
"F6,A2",6907,7824,4985,2839,4730,2674,0,2675,1649,1026,1.607212476,1550,2273,551,228,227,1,56,1,0.035242291,0,empty,CD-0722-2
"F6,A3",3965,4438,2929,1509,2743,1513,0,1518,986,532,1.853383459,848,1567,347,136,135,1,46,1,0.074074074,0,empty,CD-0722-2
"F6,A4",6535,7511,4766,2745,4646,2575,0,2575,1651,924,1.786796537,1506,1229,263,111,111,0,29,0,0.126126126,0,empty,CD-0722-2
"F6,A5",5127,5389,3806,1583,3460,1789,0,1792,1179,613,1.923327896,970,2875,636,233,230,3,66,1,0.008695652,0,empty,CD-0722-2
"F6,A6",273564,352783,191053,161730,208644,135336,0,135416,103977,31439,3.307261681,85671,15573,6469,2183,2171,12,553,2,0.040994933,0,hg38,CD-0722-2
"F6,A7",4061,4623,2948,1675,2947,1704,0,1704,1099,605,1.816528926,1001,1461,406,184,182,2,46,1,0.027472527,0,empty,CD-0722-2
"F6,A8",2506,3008,1851,1157,1840,1052,0,1052,707,345,2.049275362,622,2224,644,249,248,1,59,1,0.088709677,0,empty,CD-0722-2
"F6,A9",4862,5601,3611,1990,3400,1853,0,1855,1222,633,1.930489731,1080,2213,445,210,208,2,60,1,0.134615385,0,empty,CD-0722-2
"F6,A10",5914,6620,4382,2238,4129,2162,1,2165,1361,804,1.69278607,1246,434,105,23,22,1,14,1,0.045454545,0,empty,CD-0722-2
"F6,A11",4077,4650,3077,1573,2922,1524,0,1524,1037,487,2.12936345,871,3096,565,210,205,5,56,2,0.136585366,0,empty,CD-0722-2
"F6,A12",5801,6535,4350,2185,3950,2080,0,2083,1335,748,1.784759358,1136,4513,1059,385,377,8,109,2,0.159151194,0,empty,CD-0722-2
"F6,B1",4732,5495,3385,2110,3388,1948,1,1949,1248,701,1.780313837,1169,1442,364,146,146,0,41,0,0,0,empty,CD-0722-2
"F6,B2",4655,5345,3127,2218,3245,1939,0,1939,1189,750,1.585333333,1169,748,153,76,76,0,34,0,0,0,empty,CD-0722-2
"F6,B3",4458,5354,3231,2123,3159,1818,0,1818,1175,643,1.827371695,1051,1768,366,164,163,1,60,1,0.018404908,0,empty,CD-0722-2
"F6,B4",5421,6337,3917,2420,3916,2419,0,2421,1461,960,1.521875,1376,1566,362,119,117,2,39,1,0.051282051,0,empty,CD-0722-2
"F6,B5",8554,7423,4532,2891,4934,2756,0,2765,1980,785,2.522292994,1702,1018,202,94,91,3,30,2,0.021978022,0,empty,CD-0722-2
"F6,B6",5342,6073,3834,2239,3840,2191,0,2198,1416,782,1.810741688,1283,2739,652,250,249,1,61,1,0.084337349,0,empty,CD-0722-2
"F6,B7",4628,5033,3501,1532,3125,1587,0,1589,1127,462,2.439393939,831,1277,278,122,121,1,40,1,0.041322314,0,empty,CD-0722-2
"F6,B8",3559,4012,2655,1357,2480,1313,0,1313,902,411,2.194647202,758,1662,353,122,119,3,39,2,0.109243697,0,empty,CD-0722-2
"F6,B9",6952,8039,4998,3041,4901,2876,0,2876,1826,1050,1.739047619,1649,1591,409,151,150,1,55,1,0.053333333,0,empty,CD-0722-2
"F6,B10",3657,3959,2528,1431,2443,1379,0,1381,887,494,1.795546559,820,576,106,38,38,0,11,0,0,0,empty,CD-0722-2
"F6,B11",8412,9623,5981,3642,5782,3454,0,3456,1957,1499,1.305537025,2005,237,27,14,14,0,9,0,0.071428571,0,empty,CD-0722-2
"F6,B12",4383,4956,3203,1753,3119,1693,0,1694,1159,535,2.16635514,999,1713,378,159,158,1,42,1,0.14556962,0,empty,CD-0722-2
"F6,C1",7674,8676,5658,3018,5299,2936,0,2938,1822,1116,1.632616487,1662,1401,243,123,123,0,32,0,0.016260163,0,empty,CD-0722-2
"F6,C2",665186,773434,499520,273914,452568,242389,3,242627,178766,63861,2.799298476,142680,80668,16133,6442,6375,67,1080,3,0.035137255,0,hg38,CD-0722-2
"F6,C3",6888,7632,5027,2605,4713,2538,0,2538,1594,944,1.688559322,1430,1003,235,107,107,0,34,0,0.186915888,0,empty,CD-0722-2
"F6,C4",4590,5086,3433,1653,3121,1559,0,1559,1022,537,1.903165736,871,2372,587,230,224,6,55,3,0.102678571,0,empty,CD-0722-2
"F6,C5",6639,7409,4835,2574,4482,2444,0,2444,1611,833,1.933973589,1415,2534,657,213,213,0,70,0,0.0657277,0,empty,CD-0722-2
"F6,C6",5423,6243,3886,2357,3889,2154,0,2157,1416,741,1.910931174,1263,2460,703,273,270,3,65,1,0.103703704,0,empty,CD-0722-2
"F6,C7",7474,9108,5237,3871,5562,3465,0,3468,2075,1393,1.489590811,2138,354,141,44,44,0,13,0,0.5,0,empty,CD-0722-2
"F6,C8",8217,9346,5938,3408,5800,3239,0,3241,2159,1082,1.995378928,1887,4206,1040,415,408,7,112,2,0.129901961,0,empty,CD-0722-2
"F6,C9",567785,663895,426323,237572,393755,213473,0,213663,162897,50766,3.208781468,125960,112892,14008,5505,5364,141,982,7,0.062453393,0,hg38,CD-0722-2
"F6,C10",6137,6804,4512,2292,4274,2334,0,2339,1484,855,1.735672515,1336,2055,418,144,142,2,41,2,0.063380282,0,empty,CD-0722-2
"F6,C11",5453,6282,3923,2359,3818,2076,0,2076,1327,749,1.771695594,1226,2106,588,241,239,2,68,1,0.10041841,0,empty,CD-0722-2
"F6,C12",7822,8840,5741,3099,5302,2831,0,2833,1809,1024,1.766601563,1653,1914,434,174,167,7,48,2,0.053892216,0,empty,CD-0722-2
"F6,D1",517677,592367,383404,208963,354661,194504,3,194689,160169,34520,4.639889919,112016,62540,7694,2887,2827,60,626,6,0.015564202,0,hg38,CD-0722-2
"F6,D2",5412,5970,4090,1880,3714,1957,0,1959,1273,686,1.855685131,1087,3518,1048,384,383,1,88,1,0.130548303,0,empty,CD-0722-2
"F6,D3",8200,9418,6210,3208,5709,3015,1,3017,2031,986,2.059837728,1709,2712,485,197,196,1,58,1,0.091836735,0,empty,CD-0722-2
"F6,D4",3846,4517,2770,1747,2752,1527,0,1528,979,549,1.783242259,916,1359,377,157,157,0,48,0,0.076433121,0,empty,CD-0722-2
"F6,D5",5100,5831,3858,1973,3574,1864,1,1869,1298,571,2.273204904,1068,1977,427,181,180,1,60,1,0.027777778,0,empty,CD-0722-2
"F6,D6",7253,8311,5103,3208,4998,2900,0,2903,1774,1129,1.571302037,1655,2753,669,246,243,3,73,1,0.082304527,0,empty,CD-0722-2
"F6,D7",3920,4420,2897,1523,2751,1441,0,1446,968,478,2.025104603,802,2939,666,260,254,6,69,1,0.066929134,0,empty,CD-0722-2
"F6,D8",464147,524261,352916,171345,313744,157966,3,158123,116209,41914,2.772558095,90925,44977,5129,1938,1890,48,469,6,0.00952381,0,hg38,CD-0722-2
"F6,D9",2602,3006,1928,1078,1808,920,0,920,596,324,1.839506173,526,1538,432,153,151,2,47,1,0.01986755,0,empty,CD-0722-2
"F6,D10",4449,5100,3209,1891,3103,1716,0,1718,1079,639,1.6885759,1023,1054,191,82,81,1,32,1,0.037037037,0,empty,CD-0722-2
"F6,D11",5149,5852,3801,2051,3573,1916,0,1921,1293,628,2.058917197,1107,3114,616,244,241,3,80,2,0.049792531,0,empty,CD-0722-2
"F6,D12",7221,8161,5423,2738,4839,2588,0,2596,1707,889,1.920134983,1424,4269,1120,477,468,9,151,2,0.066239316,0,empty,CD-0722-2
"F6,E1",8712,9746,6270,3476,5773,3199,0,3200,1997,1203,1.660016625,1801,3318,741,265,260,5,75,2,0.046153846,0,empty,CD-0722-2
"F6,E2",440665,497075,333884,163191,295897,151465,1,151594,115037,36557,3.146784474,87300,55569,9150,3418,3351,67,669,3,0.025663981,0,hg38,CD-0722-2
"F6,E3",3716,4199,2779,1420,2672,1441,0,1446,918,528,1.738636364,840,2900,783,307,306,1,87,1,0.088235294,0,empty,CD-0722-2
"F6,E4",797063,867488,624939,242549,501595,234682,0,234898,190236,44662,4.259459944,126886,174450,27291,10722,10480,242,1668,5,0.025667939,0,hg38,CD-0722-2
"F6,E5",4459,4965,3361,1604,3058,1604,0,1606,1056,550,1.92,881,1507,416,169,163,6,50,2,0.110429448,0,empty,CD-0722-2
"F6,E6",8901,10407,6490,3917,6419,3675,0,3679,2345,1334,1.757871064,2184,3957,874,344,342,2,99,2,0.058479532,0,empty,CD-0722-2
"F6,E7",7910,8889,5861,3028,5503,2930,0,2930,1867,1063,1.756349953,1666,3105,733,288,286,2,87,1,0.006993007,0,empty,CD-0722-2
"F6,E8",6335,7113,4736,2377,4366,2307,0,2307,1533,774,1.980620155,1304,3908,925,326,326,0,83,0,0.076687117,0,empty,CD-0722-2
"F6,E9",4476,4984,3308,1676,3054,1670,1,1674,1117,557,2.005385996,930,3212,827,309,305,4,83,1,0.068852459,0,empty,CD-0722-2
"F6,E10",4245,4707,3127,1580,2939,1567,0,1570,1004,566,1.77385159,878,1924,518,204,203,1,52,1,0.068965517,0,empty,CD-0722-2
"F6,E11",5695,6530,4157,2373,3855,2101,0,2103,1294,809,1.599505562,1214,2387,513,206,204,2,52,1,0.137254902,0,empty,CD-0722-2
"F6,E12",6531,7360,4745,2615,4407,2389,0,2391,1539,852,1.806338028,1367,2126,332,164,162,2,58,1,0.098765432,0,empty,CD-0722-2
"F6,F1",7146,8023,5182,2841,4926,2658,0,2658,1744,914,1.90809628,1530,2130,434,188,187,1,72,1,0.064171123,0,empty,CD-0722-2
"F6,F2",5320,5882,3916,1966,3669,1930,0,1935,1228,707,1.736916549,1094,3841,1246,485,482,3,115,2,0.078838174,0,empty,CD-0722-2
"F6,F3",5167,5885,3785,2100,3649,1971,0,1974,1322,652,2.027607362,1161,2673,591,271,271,0,81,0,0.04797048,0,empty,CD-0722-2
"F6,F4",7581,8401,5613,2788,5298,2740,0,2753,1802,951,1.894847529,1552,899,191,90,90,0,25,0,0,0,empty,CD-0722-2
"F6,F5",619192,707647,466731,240916,417947,220619,1,220804,173117,47687,3.630276595,126059,144076,16407,6274,6119,155,1328,6,0.030397124,0,hg38,CD-0722-2
"F6,F6",6087,7076,4320,2756,4305,2473,0,2477,1570,907,1.730981257,1469,3084,774,318,318,0,82,0,0.091194969,0,empty,CD-0722-2
"F6,F7",748326,907521,545456,362065,528832,310262,2,310524,247623,62901,3.936710068,188538,89375,12406,4707,4580,127,881,4,0.066375546,0,hg38,CD-0722-2
"F6,F8",4987,5691,3622,2069,3583,1930,0,1930,1267,663,1.911010558,1142,295,38,26,26,0,20,0,0.076923077,0,empty,CD-0722-2
"F6,F9",5888,6631,4435,2196,4003,2098,0,2100,1422,678,2.097345133,1169,3285,830,342,331,11,77,2,0.087613293,0,empty,CD-0722-2
"F6,F10",6737,7495,5058,2437,4562,2401,0,2405,1582,823,1.922235723,1311,2496,573,232,227,5,58,2,0.035242291,0,empty,CD-0722-2
"F6,F11",585036,658168,448567,209601,391455,197603,2,197805,151185,46620,3.242921493,110877,153148,16681,6491,6299,192,1190,7,0.073503731,0,hg38,CD-0722-2
"F6,F12",6403,7031,4730,2301,4228,2298,0,2301,1529,772,1.980569948,1252,238,22,16,16,0,14,0,0,0,empty,CD-0722-2
"F6,G1",6192,6916,4633,2283,4274,2194,0,2196,1433,763,1.878112713,1224,3341,917,310,308,2,83,1,0.045454545,0,empty,CD-0722-2
"F6,G2",3899,4307,2715,1592,2734,1571,0,1572,997,575,1.733913043,924,654,245,103,102,1,33,1,0.205882353,0,empty,CD-0722-2
"F6,G3",7972,8797,5880,2917,5373,2857,0,2859,1774,1085,1.635023041,1532,3146,750,283,281,2,72,2,0.160142349,0,empty,CD-0722-2
"F6,G4",863580,1009510,644757,364753,589553,326485,2,326730,256749,69981,3.668838685,190490,2710,503,218,214,4,39,1,0.098130841,0,hg38,CD-0722-2
"F6,G5",4373,4911,3151,1760,3047,1698,0,1698,1124,574,1.958188153,978,1773,465,207,207,0,71,0,0.014492754,0,empty,CD-0722-2
"F6,G6",6245,6980,4644,2336,4256,2300,0,2306,1544,762,2.026246719,1254,168,31,27,27,0,12,0,0.037037037,0,empty,CD-0722-2
"F6,G7",4892,5571,3659,1912,3465,1784,0,1785,1169,616,1.897727273,1034,2893,646,234,232,2,71,1,0.099137931,0,empty,CD-0722-2
"F6,G8",3648,4038,2638,1400,2564,1358,0,1360,909,451,2.015521064,790,2000,562,244,242,2,64,2,0.099173554,0,empty,CD-0722-2
"F6,G9",4549,5134,3328,1806,3166,1749,0,1749,1079,670,1.610447761,1021,2950,598,271,270,1,82,1,0.096296296,0,empty,CD-0722-2
"F6,G10",5740,6647,4235,2412,4085,2266,0,2273,1445,828,1.745169082,1299,2970,821,332,328,4,91,1,0.051829268,0,empty,CD-0722-2
"F6,G11",5314,5977,3973,2004,3715,1957,0,1959,1236,723,1.709543568,1094,1882,707,236,231,5,53,1,0.082251082,0,empty,CD-0722-2
"F6,G12",4744,5568,3370,2198,3519,2008,0,2008,1300,708,1.836158192,1224,2654,633,240,231,9,89,2,0.086580087,0,empty,CD-0722-2
"F6,H1",5420,6009,3975,2034,3704,1922,0,1929,1243,686,1.811953353,1119,1272,195,86,84,2,42,1,0.035714286,0,empty,CD-0722-2
"F6,H2",5488,6279,3943,2336,3853,2139,0,2141,1340,801,1.672908864,1243,2820,598,251,246,5,86,2,0.154471545,0,empty,CD-0722-2
"F6,H3",586445,702175,426386,275789,415124,240245,1,240390,188827,51563,3.662063883,146360,133804,17799,6871,6705,166,1185,6,0.04847129,0,hg38,CD-0722-2
"F6,H4",6529,7567,4774,2793,4598,2464,0,2475,1573,902,1.743902439,1478,279,55,34,34,0,17,0,0.088235294,0,empty,CD-0722-2
"F6,H5",6943,7800,5108,2692,4735,2569,0,2569,1656,913,1.813800657,1463,2301,799,309,308,1,89,1,0.022727273,0,empty,CD-0722-2
"F6,H6",4714,5521,3410,2111,3372,1946,0,1950,1280,670,1.910447761,1144,2317,481,194,193,1,70,1,0.03626943,0,empty,CD-0722-2
"F6,H7",5413,6146,3928,2218,3839,2134,0,2138,1425,713,1.998597475,1244,2759,569,260,256,4,86,2,0.13671875,0,empty,CD-0722-2
"F6,H8",5904,6776,4259,2517,4151,2295,0,2295,1521,774,1.965116279,1354,2366,530,193,184,9,62,1,0.048913043,0,empty,CD-0722-2
"F6,H9",4433,5032,3252,1780,3139,1639,0,1639,1064,575,1.850434783,973,1336,377,144,142,2,42,1,0.091549296,0,empty,CD-0722-2
"F6,H10",5015,5467,3754,1713,3391,1792,0,1797,1253,544,2.303308824,989,1829,560,234,231,3,49,1,0.168831169,0,empty,CD-0722-2
"F6,H11",6001,7272,4114,3158,4503,2977,0,2977,1523,1454,1.047455296,1814,84,4,3,3,0,3,0,0,0,empty,CD-0722-2
"F6,H12",4802,5346,3470,1876,3265,1843,0,1844,1188,656,1.81097561,1033,1608,384,184,184,0,52,0,0.114130435,0,empty,CD-0722-2
"F7,A1",4648,5181,3348,1833,3185,1815,0,1818,1184,634,1.867507886,1010,947,191,86,85,1,34,1,0.070588235,0,empty,CD-0722-2
"F7,A2",7124,8216,5158,3058,4846,2763,0,2765,1685,1080,1.560185185,1608,1289,416,177,175,2,54,2,0.04,0,empty,CD-0722-2
"F7,A3",4101,4775,2997,1778,2875,1583,0,1587,1049,538,1.949814126,931,1254,216,93,90,3,39,1,0,0,empty,CD-0722-2
"F7,A4",788911,936172,584540,351632,533131,304465,1,304678,240369,64309,3.737719448,179271,31277,4847,2017,1993,24,460,2,0.078775715,0,hg38,CD-0722-2
"F7,A5",6090,6744,4510,2234,4112,2261,0,2266,1446,820,1.763414634,1240,1685,571,163,161,2,54,1,0.02484472,0,empty,CD-0722-2
"F7,A6",5733,6866,4180,2686,4126,2386,0,2386,1568,818,1.916870416,1420,2340,591,232,230,2,68,1,0.02173913,0,empty,CD-0722-2
"F7,A7",1088836,1258547,821945,436602,715592,384989,1,385257,297620,87637,3.396054178,222909,163577,22345,8477,8262,215,1467,8,0.044178165,0,hg38,CD-0722-2
"F7,A8",2569,3198,1839,1359,1926,1139,0,1140,735,405,1.814814815,716,1908,502,169,169,0,51,0,0.136094675,0,empty,CD-0722-2
"F7,A9",7899,9133,5860,3273,5463,3078,0,3078,2246,832,2.699519231,1770,1227,278,102,101,1,48,1,0,0,empty,CD-0722-2
"F7,A10",6077,6768,4546,2222,4004,2092,0,2095,1316,779,1.689345315,1156,240,33,23,23,0,13,0,0,0,empty,CD-0722-2
"F7,A11",4181,4663,3195,1468,2860,1500,0,1500,994,506,1.964426877,825,1075,224,110,109,1,45,1,0.027522936,0,empty,CD-0722-2
"F7,A12",6291,7089,4764,2325,4191,2194,0,2196,1445,751,1.924101198,1233,2475,581,232,232,0,69,0,0.112068966,0,empty,CD-0722-2
"F7,B1",5171,5962,3858,2104,3493,1948,0,1950,1187,763,1.55570118,1112,1054,241,73,66,7,27,2,0.121212121,0,empty,CD-0722-2
"F7,B2",5275,6034,3598,2436,3600,2138,0,2138,1354,784,1.727040816,1277,570,105,55,55,0,22,0,0,0,empty,CD-0722-2
"F7,B3",4972,6046,3600,2446,3646,2124,0,2126,1417,709,1.998589563,1286,1374,384,158,156,2,32,2,0,0,empty,CD-0722-2
"F7,B4",594435,774391,382880,391511,472320,352607,1,352824,226679,126145,1.796971739,226848,6579,2433,627,622,5,289,2,0.069131833,0,hg38,CD-0722-2
"F7,B5",5755,3913,2351,1562,2662,1569,0,1574,1089,485,2.245360825,963,1420,261,119,118,1,34,1,0.025423729,0,empty,CD-0722-2
"F7,B6",5850,6853,4200,2653,4042,2380,0,2382,1509,873,1.728522337,1373,1371,240,76,75,1,28,1,0.026666667,0,empty,CD-0722-2
"F7,B7",5102,5986,3768,2218,3543,1953,0,1953,1316,637,2.065934066,1159,993,228,105,105,0,37,0,0.019047619,0,empty,CD-0722-2
"F7,B8",3894,4313,2882,1431,2601,1403,0,1405,929,476,1.951680672,776,1098,294,124,123,1,41,1,0.008130081,0,empty,CD-0722-2
"F7,B9",7595,8583,5461,3122,5125,2959,0,2960,1862,1098,1.695810565,1698,925,295,120,119,1,47,1,0.025210084,0,empty,CD-0722-2
"F7,B10",3432,4025,2374,1651,2492,1445,3,1453,938,515,1.821359223,899,347,65,30,30,0,9,0,0,0,empty,CD-0722-2
"F7,B11",8626,10182,6093,4089,6141,3724,0,3725,2100,1625,1.292307692,2256,186,23,18,18,0,13,0,0.055555556,0,empty,CD-0722-2
"F7,B12",4617,5335,3386,1949,3256,1765,0,1767,1194,573,2.083769634,1047,1338,451,151,148,3,45,2,0.101351351,0,empty,CD-0722-2
"F7,C1",8781,9780,6660,3120,5738,2982,0,2983,1883,1100,1.711818182,1619,747,141,78,78,0,35,0,0.102564103,0,empty,CD-0722-2
"F7,C2",7103,8321,5036,3285,4976,2874,0,2878,1871,1007,1.857994042,1720,1979,626,247,243,4,67,1,0.0781893,0,empty,CD-0722-2
"F7,C3",7598,8712,5529,3183,5264,2900,0,2909,1889,1020,1.851960784,1677,924,287,135,135,0,36,0,0.096296296,0,empty,CD-0722-2
"F7,C4",4975,5852,3665,2187,3438,1829,0,1831,1193,638,1.869905956,1104,1447,277,95,91,4,34,2,0.043956044,0,empty,CD-0722-2
"F7,C5",6994,7971,5112,2859,4794,2635,0,2636,1760,876,2.00913242,1534,1611,343,119,118,1,42,1,0.127118644,0,empty,CD-0722-2
"F7,C6",6925,8273,5030,3243,4953,2756,0,2760,1837,923,1.990249187,1639,1424,337,107,107,0,32,0,0.214953271,0,empty,CD-0722-2
"F7,C7",8979,10883,6314,4569,6322,3857,0,3864,2303,1561,1.475336323,2405,426,80,25,25,0,11,0,0,0,empty,CD-0722-2
"F7,C8",9071,10643,6506,4137,6283,3447,0,3452,2324,1128,2.060283688,2064,2676,518,222,218,4,83,2,0.091743119,0,empty,CD-0722-2
"F7,C9",6134,7114,4554,2560,4172,2312,0,2312,1516,796,1.904522613,1340,1154,258,83,83,0,24,0,0,0,empty,CD-0722-2
"F7,C10",6841,7650,5012,2638,4571,2468,0,2471,1608,863,1.863267671,1432,1358,295,132,127,5,39,1,0.141732283,0,empty,CD-0722-2
"F7,C11",5833,6919,4255,2664,4103,2255,0,2257,1416,841,1.683709869,1363,1585,363,154,153,1,50,1,0.058823529,0,empty,CD-0722-2
"F7,C12",537858,596535,414668,181867,344541,167504,1,167666,126230,41436,3.046384786,93434,48481,14181,5064,5019,45,821,4,0.05260012,0,hg38,CD-0722-2
"F7,D1",7888,9064,5526,3538,5460,3236,0,3236,1894,1342,1.411326379,1923,650,120,59,57,2,19,1,0.105263158,0,empty,CD-0722-2
"F7,D2",5838,6452,4456,1996,3863,1960,0,1960,1248,712,1.752808989,1014,2494,666,275,272,3,81,2,0.0625,0,empty,CD-0722-2
"F7,D3",5469,6196,4009,2187,3735,2070,0,2070,1353,717,1.887029289,1175,1653,425,162,160,2,51,2,0.11875,0,empty,CD-0722-2
"F7,D4",4333,5041,3196,1845,3103,1742,0,1743,1198,545,2.198165138,1000,1345,283,125,124,1,34,1,0.169354839,0,empty,CD-0722-2
"F7,D5",5098,5748,3779,1969,3513,1897,0,1897,1263,634,1.992113565,1083,1409,255,117,115,2,36,2,0,0,empty,CD-0722-2
"F7,D6",7896,8925,5678,3247,5343,3114,0,3116,1928,1188,1.622895623,1759,1874,504,233,229,4,56,2,0.139737991,0,empty,CD-0722-2
"F7,D7",4518,5341,3304,2037,3144,1709,0,1709,1196,513,2.331384016,1040,1500,410,129,127,2,37,1,0.023622047,0,empty,CD-0722-2
"F7,D8",5576,6562,3962,2600,3835,2084,1,2094,1400,694,2.017291066,1256,1106,330,123,123,0,46,0,0.032520325,0,empty,CD-0722-2
"F7,D9",2696,3085,1966,1119,1930,1053,0,1054,673,381,1.766404199,653,1125,270,116,116,0,31,0,0.232758621,0,empty,CD-0722-2
"F7,D10",559539,656725,413951,242774,379382,209398,0,209518,166256,43262,3.843003097,125373,68021,9406,3756,3645,111,723,2,0.070233196,0,hg38,CD-0722-2
"F7,D11",5592,6445,4057,2388,3821,2052,0,2052,1342,710,1.890140845,1159,2534,750,272,263,9,80,2,0.076045627,0,empty,CD-0722-2
"F7,D12",7601,8521,5529,2992,5032,2739,1,2742,1799,943,1.907741251,1607,3084,932,362,354,8,104,2,0.070621469,0,empty,CD-0722-2
"F7,E1",9063,10206,6490,3716,6056,3411,0,3418,2119,1299,1.631254811,1984,2021,352,146,145,1,51,1,0.117241379,0,empty,CD-0722-2
"F7,E2",6109,7099,4323,2776,4246,2426,0,2427,1573,854,1.841920375,1445,1463,401,119,118,1,45,1,0.084745763,0,empty,CD-0722-2
"F7,E3",4204,4754,3122,1632,2838,1517,0,1518,1007,511,1.970645793,845,1570,318,169,169,0,61,0,0.130177515,0,empty,CD-0722-2
"F7,E4",5617,6249,4155,2094,3777,2049,0,2056,1341,715,1.875524476,1167,1799,452,196,196,0,57,0,0.081632653,0,empty,CD-0722-2
"F7,E5",5068,5685,3834,1851,3320,1727,0,1730,1145,585,1.957264957,948,1080,201,81,81,0,32,0,0.024691358,0,empty,CD-0722-2
"F7,E6",628287,710765,478265,232500,403405,208325,0,208520,166329,42191,3.94228627,117108,115725,15523,6076,5970,106,1159,5,0.031658291,0,hg38,CD-0722-2
"F7,E7",8263,9109,6115,2994,5543,2931,0,2937,1882,1055,1.783886256,1673,2287,727,268,266,2,58,2,0.105263158,0,empty,CD-0722-2
"F7,E8",6637,7376,4930,2446,4408,2304,0,2304,1520,784,1.93877551,1280,2763,616,260,252,8,68,2,0.075396825,0,empty,CD-0722-2
"F7,E9",4483,5036,3369,1667,3001,1545,0,1549,1059,490,2.16122449,886,1869,630,227,227,0,66,0,0.044052863,0,empty,CD-0722-2
"F7,E10",4815,5543,3654,1889,3310,1734,0,1734,1158,576,2.010416667,981,1639,420,195,194,1,52,1,0.046391753,0,empty,CD-0722-2
"F7,E11",5981,7084,4408,2676,4176,2350,0,2350,1433,917,1.562704471,1383,1415,323,129,127,2,42,2,0.05511811,0,empty,CD-0722-2
"F7,E12",6812,7895,4948,2947,4720,2625,0,2626,1726,900,1.917777778,1543,1818,313,147,144,3,51,1,0.013888889,0,empty,CD-0722-2
"F7,F1",7760,8688,5663,3025,5174,2810,0,2815,1750,1065,1.643192488,1596,1782,367,154,154,0,52,0,0.012987013,0,empty,CD-0722-2
"F7,F2",6085,6759,4362,2397,4060,2174,0,2175,1454,721,2.016643551,1230,2404,542,272,268,4,64,1,0.108208955,0,empty,CD-0722-2
"F7,F3",5647,6233,4113,2120,3883,2056,0,2062,1336,726,1.840220386,1208,1937,413,175,174,1,53,1,0.132183908,0,empty,CD-0722-2
"F7,F4",8381,9365,6270,3095,5797,3103,1,3110,2034,1076,1.890334572,1720,686,136,62,61,1,23,1,0.016393443,0,empty,CD-0722-2
"F7,F5",6597,7218,4872,2346,4272,2189,0,2193,1415,778,1.818766067,1211,1911,461,219,219,0,75,0,0.01369863,0,empty,CD-0722-2
"F7,F6",7278,8385,5289,3096,5052,2881,0,2881,1831,1050,1.743809524,1663,2653,659,230,226,4,59,2,0.057522124,0,empty,CD-0722-2
"F7,F7",1551141,1836052,1143527,692525,1039819,601234,5,601694,491551,110143,4.462843758,357494,170698,21594,8343,8146,197,1414,6,0.054873558,0,hg38,CD-0722-2
"F7,F8",5714,6384,4196,2188,3922,2074,0,2076,1399,677,2.066469719,1158,325,54,22,22,0,11,0,0,0,empty,CD-0722-2
"F7,F9",537789,604927,409249,195678,348476,178050,0,178199,142289,35910,3.962378168,101290,63289,10153,3698,3617,81,727,4,0.017970694,0,hg38,CD-0722-2
"F7,F10",7276,8020,5456,2564,4705,2360,0,2364,1545,819,1.886446886,1265,1601,434,175,174,1,42,1,0.051724138,0,empty,CD-0722-2
"F7,F11",6280,7059,4660,2399,4155,2119,0,2119,1452,667,2.176911544,1223,1509,385,159,159,0,42,0,0.012578616,0,empty,CD-0722-2
"F7,F12",6629,7654,4769,2885,4597,2527,0,2530,1607,923,1.741061755,1528,145,17,12,12,0,7,0,0,0,empty,CD-0722-2
"F7,G1",6734,7449,5134,2315,4531,2321,0,2321,1568,753,2.082337317,1216,2394,568,234,233,1,72,1,0.128755365,0,empty,CD-0722-2
"F7,G2",509312,604421,353123,251298,351797,208334,0,208483,165516,42967,3.852165615,128342,29019,4769,1797,1758,39,348,4,0.07337884,0,hg38,CD-0722-2
"F7,G3",8204,9066,6044,3022,5351,2961,0,2964,1753,1211,1.447563997,1607,1794,452,164,163,1,52,1,0.049079755,0,empty,CD-0722-2
"F7,G4",15096,17651,10753,6898,10618,6469,0,6469,3943,2526,1.560965954,3787,138,46,21,21,0,11,0,0,0,empty,CD-0722-2
"F7,G5",1334665,1619778,976683,643095,915011,546930,2,547378,446160,101218,4.407911636,331552,120929,19635,7811,7676,135,1362,5,0.063053674,0,hg38,CD-0722-2
"F7,G6",656310,719358,511677,207681,410822,193617,0,193813,154561,39252,3.937659228,106530,1239,263,105,101,4,28,2,0.01980198,0,hg38,CD-0722-2
"F7,G7",5324,5801,3984,1817,3495,1774,0,1777,1175,602,1.951827243,965,2054,530,197,196,1,53,1,0.137755102,0,empty,CD-0722-2
"F7,G8",263037,250390,228232,22158,145266,34649,1,34694,21578,13116,1.645166209,10970,3073,653,245,244,1,105,1,0.098360656,0,empty,CD-0722-2
"F7,G9",4880,5582,3529,2053,3389,1854,0,1855,1238,617,2.006482982,1133,2046,410,169,168,1,61,1,0.095238095,0,empty,CD-0722-2
"F7,G10",6061,6835,4430,2405,4254,2365,0,2365,1535,830,1.84939759,1356,1773,494,220,217,3,74,1,0.01843318,0,empty,CD-0722-2
"F7,G11",5821,6454,4399,2055,3839,2024,0,2024,1323,701,1.887303852,1088,1323,319,108,107,1,39,1,0.074766355,0,empty,CD-0722-2
"F7,G12",5195,5974,3679,2295,3651,2110,0,2112,1378,734,1.877384196,1257,2025,550,211,210,1,67,1,0.1,0,empty,CD-0722-2
"F7,H1",5704,6462,4172,2290,4038,2179,0,2180,1498,682,2.196480938,1290,1291,385,140,139,1,47,1,0.201438849,0,empty,CD-0722-2
"F7,H2",788825,933866,585640,348226,535446,296189,0,296425,225096,71329,3.155743106,177569,121962,17053,6496,6358,138,1187,5,0.040736081,0,hg38,CD-0722-2
"F7,H3",5341,6059,3865,2194,3654,2046,0,2048,1378,670,2.056716418,1195,1270,268,105,105,0,51,0,0.114285714,0,empty,CD-0722-2
"F7,H4",7364,8316,5347,2969,4870,2677,0,2681,1742,939,1.855165069,1548,225,56,21,21,0,12,0,0.238095238,0,empty,CD-0722-2
"F7,H5",1087824,1265189,823665,441524,709709,386668,3,387026,300448,86578,3.470258033,223819,109037,15444,5949,5832,117,1177,6,0.023491084,0,hg38,CD-0722-2
"F7,H6",4985,5779,3556,2223,3573,2009,0,2016,1334,682,1.95601173,1238,1798,457,214,213,1,62,1,0.0657277,0,empty,CD-0722-2
"F7,H7",5622,6269,4150,2119,3863,2044,0,2044,1371,673,2.037147103,1146,1984,498,180,178,2,62,1,0.123595506,0,empty,CD-0722-2
"F7,H8",6446,7476,4639,2837,4366,2494,0,2496,1621,875,1.852571429,1475,1609,347,167,167,0,67,0,0.071856287,0,empty,CD-0722-2
"F7,H9",5299,5922,4015,1907,3635,1941,0,1943,1299,644,2.017080745,1064,1236,310,114,110,4,38,1,0,0,empty,CD-0722-2
"F7,H10",4759,5376,3570,1806,3280,1744,0,1744,1185,559,2.119856887,996,1152,209,107,106,1,50,1,0.047169811,0,empty,CD-0722-2
"F7,H11",6291,7617,4270,3347,4573,3020,1,3021,1639,1382,1.185962373,1850,81,24,15,15,0,6,0,0,0,empty,CD-0722-2
"F7,H12",4793,5590,3457,2133,3274,1849,0,1857,1269,588,2.158163265,1073,1213,177,68,68,0,28,0,0.147058824,0,empty,CD-0722-2
"F8,A1",3373,3984,2342,1642,2453,1419,0,1422,910,512,1.77734375,886,851,140,55,54,1,29,1,0.074074074,0,empty,CD-0722-2
"F8,A2",377434,425968,285391,140577,244138,124918,2,125019,94074,30945,3.040038778,71130,60524,8688,3585,3533,52,679,2,0.064817436,0,hg38,CD-0722-2
"F8,A3",602779,707589,448352,259237,403700,223478,0,223665,174727,48938,3.57037476,131796,67829,15601,5859,5820,39,1099,3,0.041408935,0,hg38,CD-0722-2
"F8,A4",5727,6513,4188,2325,3927,2174,1,2179,1371,808,1.696782178,1245,810,162,92,91,1,26,1,0,0,empty,CD-0722-2
"F8,A5",386053,451480,282841,168639,262963,148244,1,148360,117810,30550,3.856301146,87840,99543,9971,4006,3858,148,902,5,0.0469155,0,hg38,CD-0722-2
"F8,A6",3726,4439,2729,1710,2629,1475,0,1477,926,551,1.680580762,866,2658,675,250,244,6,70,2,0.06147541,0,empty,CD-0722-2
"F8,A7",3406,3853,2577,1276,2286,1315,0,1315,826,489,1.689161554,731,995,356,148,147,1,46,1,0.074829932,0,empty,CD-0722-2
"F8,A8",2080,2389,1485,904,1468,799,0,801,518,283,1.830388693,484,1549,355,145,145,0,49,0,0.006896552,0,empty,CD-0722-2
"F8,A9",3484,4054,2508,1546,2379,1310,0,1312,827,485,1.705154639,778,1752,463,158,155,3,63,2,0.090322581,0,empty,CD-0722-2
"F8,A10",4126,4522,3120,1402,2737,1507,0,1507,890,617,1.442463533,765,387,56,32,32,0,13,0,0,0,empty,CD-0722-2
"F8,A11",2921,3219,2198,1021,2023,1060,0,1069,680,389,1.748071979,579,1352,290,137,136,1,46,1,0.110294118,0,empty,CD-0722-2
"F8,A12",4352,5097,3154,1943,3013,1660,0,1663,1076,587,1.833049404,975,3101,609,254,247,7,83,2,0.133603239,0,empty,CD-0722-2
"F8,B1",3933,4523,2760,1763,2643,1564,0,1566,974,592,1.64527027,934,1213,350,159,159,0,47,0,0.006289308,0,empty,CD-0722-2
"F8,B2",4648,5213,3227,1986,3226,1901,0,1901,1236,665,1.858646617,1117,561,107,32,32,0,11,0,0,0,empty,CD-0722-2
"F8,B3",488225,610362,344551,265811,353955,218085,0,218260,173454,44806,3.871222604,136854,125284,21354,8319,8201,118,1381,4,0.061821729,0,hg38,CD-0722-2
"F8,B4",8703,9868,6547,3321,5818,3106,0,3109,2007,1102,1.82123412,1778,1664,388,146,141,5,41,2,0.092198582,0,empty,CD-0722-2
"F8,B5",3898,2353,1396,957,1704,1006,0,1011,653,358,1.824022346,650,1066,304,116,115,1,31,1,0.060869565,0,empty,CD-0722-2
"F8,B6",4265,4832,3000,1832,2818,1593,0,1595,953,642,1.484423676,946,1507,513,191,188,3,54,1,0.04787234,0,empty,CD-0722-2
"F8,B7",498378,575630,378207,197423,331110,175209,0,175362,135183,40179,3.364518778,101022,136296,15919,6058,5892,166,1090,7,0.067888663,0,hg38,CD-0722-2
"F8,B8",2907,3236,2183,1053,1903,1000,0,1002,667,335,1.991044776,528,985,234,79,79,0,35,0,0.075949367,0,empty,CD-0722-2
"F8,B9",5492,6248,3943,2305,3725,2182,0,2182,1393,789,1.765525982,1209,1039,268,101,100,1,35,1,0.07,0,empty,CD-0722-2
"F8,B10",2562,2999,1795,1204,1815,995,0,995,679,316,2.148734177,600,473,38,17,16,1,10,1,0,0,empty,CD-0722-2
"F8,B11",6301,7201,4462,2739,4176,2515,0,2517,1445,1072,1.347947761,1434,422,166,69,69,0,19,0,0.304347826,0,empty,CD-0722-2
"F8,B12",3382,3797,2507,1290,2265,1204,0,1204,804,400,2.01,663,1250,375,159,159,0,53,0,0.044025157,0,empty,CD-0722-2
"F8,C1",520815,583953,394110,189843,333418,174103,3,174269,135737,38532,3.522708398,97304,37615,6696,2492,2437,55,503,2,0.022979073,0,hg38,CD-0722-2
"F8,C2",5513,6054,4044,2010,3619,1941,0,1943,1247,696,1.791666667,1084,2612,420,170,167,3,59,2,0.023952096,0,empty,CD-0722-2
"F8,C3",611296,751116,441472,309644,431161,256869,1,257059,202225,54834,3.687949083,157675,81524,11902,4481,4389,92,848,4,0.056960583,0,hg38,CD-0722-2
"F8,C4",857600,1027626,615429,412197,593302,362303,1,362538,259020,103518,2.502173535,217798,73195,10154,3914,3827,87,852,4,0.04285341,0,hg38,CD-0722-2
"F8,C5",5002,5568,3665,1903,3385,1836,0,1836,1171,665,1.760902256,1054,1904,466,201,199,2,45,1,0.065326633,0,empty,CD-0722-2
"F8,C6",4120,4715,2949,1766,2861,1599,0,1600,1064,536,1.985074627,923,1503,405,141,139,2,40,2,0.079136691,0,empty,CD-0722-2
"F8,C7",693191,832777,510632,322145,472436,270731,2,270924,213773,57151,3.74049448,161713,16016,2359,890,854,36,219,2,0.050351288,0,hg38,CD-0722-2
"F8,C8",434731,493922,327462,166460,284808,150622,1,150766,120516,30250,3.984,85997,65894,9105,3432,3346,86,753,6,0.035564854,0,hg38,CD-0722-2
"F8,C9",4297,4939,3245,1694,2975,1629,0,1629,1067,562,1.898576512,926,1384,222,114,114,0,41,0,0.078947368,0,empty,CD-0722-2
"F8,C10",5139,5825,3833,1992,3443,1839,0,1841,1188,653,1.819295559,1025,1932,476,215,214,1,63,1,0.060747664,0,empty,CD-0722-2
"F8,C11",4236,4850,3021,1829,2925,1595,0,1595,1053,542,1.942804428,941,1781,343,110,103,7,45,2,0.106796117,0,empty,CD-0722-2
"F8,C12",7243,8299,5238,3061,4884,2688,0,2688,1812,876,2.068493151,1556,1736,371,143,143,0,51,0,0.027972028,0,empty,CD-0722-2
"F8,D1",6079,7054,4297,2757,4149,2426,0,2429,1510,919,1.643090316,1433,1020,164,80,79,1,30,1,0.037974684,0,empty,CD-0722-2
"F8,D2",4765,5158,3592,1566,3061,1536,0,1539,930,609,1.527093596,825,2380,572,209,206,3,57,2,0.13592233,0,empty,CD-0722-2
"F8,D3",4053,4462,2935,1527,2622,1472,0,1473,913,560,1.630357143,823,1112,354,114,114,0,38,0,0.01754386,0,empty,CD-0722-2
"F8,D4",3261,3862,2414,1448,2230,1196,0,1196,784,412,1.902912621,689,926,177,86,84,2,40,2,0.011904762,0,empty,CD-0722-2
"F8,D5",3537,4124,2635,1489,2486,1342,0,1342,842,500,1.684,776,1624,465,167,167,0,48,0,0.053892216,0,empty,CD-0722-2
"F8,D6",5914,6771,4173,2598,3897,2202,0,2204,1322,882,1.498866213,1320,1549,307,150,150,0,48,0,0.02,0,empty,CD-0722-2
"F8,D7",3122,3438,2349,1089,2050,1084,0,1085,717,368,1.948369565,585,1994,418,167,164,3,59,1,0.134146341,0,empty,CD-0722-2
"F8,D8",588941,723329,423195,300134,414868,250763,0,250954,201806,49148,4.106087735,153958,77219,14733,5702,5632,70,1050,3,0.049893466,0,hg38,CD-0722-2
"F8,D9",2052,2332,1449,883,1449,756,0,756,497,259,1.918918919,452,1418,349,130,128,2,39,1,0.21875,0,empty,CD-0722-2
"F8,D10",4144,4859,2983,1876,2854,1627,0,1628,1040,588,1.768707483,979,818,107,43,43,0,19,0,0,0,empty,CD-0722-2
"F8,D11",424280,490574,315779,174795,281320,152266,1,152391,115491,36900,3.129837398,88721,178515,23524,9155,8958,197,1508,6,0.059723152,0,hg38,CD-0722-2
"F8,D12",1097637,1374408,789205,585203,786226,516075,1,516408,378870,137538,2.754656895,315609,74362,18878,6890,6816,74,1297,2,0.057071596,0,hg38,CD-0722-2
"F8,E1",6426,7148,4768,2380,4234,2306,0,2308,1439,869,1.655926352,1295,2099,433,145,144,1,46,1,0.055555556,0,empty,CD-0722-2
"F8,E2",4785,5353,3459,1894,3158,1734,0,1734,1124,610,1.842622951,999,1291,274,145,141,4,45,1,0.085106383,0,empty,CD-0722-2
"F8,E3",3154,3543,2352,1191,2136,1130,0,1130,745,385,1.935064935,645,1973,549,220,218,2,56,2,0.188073394,0,empty,CD-0722-2
"F8,E4",4158,4963,2956,2007,2882,1597,0,1597,1060,537,1.973929236,967,2037,457,188,185,3,57,1,0.108108108,0,empty,CD-0722-2
"F8,E5",3905,4427,2895,1532,2680,1413,0,1413,957,456,2.098684211,826,1228,212,92,92,0,38,0,0.032608696,0,empty,CD-0722-2
"F8,E6",6870,7800,4990,2810,4740,2690,0,2694,1701,993,1.712990937,1540,3191,717,309,300,9,89,2,0.076666667,0,empty,CD-0722-2
"F8,E7",5867,6730,4354,2376,3995,2185,0,2185,1406,779,1.804878049,1250,2556,602,258,254,4,73,2,0.082677165,0,empty,CD-0722-2
"F8,E8",6111,6788,4621,2167,4007,2115,0,2116,1377,739,1.863328823,1128,2560,535,239,238,1,67,1,0.096638655,0,empty,CD-0722-2
"F8,E9",3028,3606,2137,1469,2164,1190,1,1192,761,431,1.765661253,736,2163,494,230,226,4,66,1,0.057522124,0,empty,CD-0722-2
"F8,E10",3749,4204,2768,1436,2505,1313,0,1317,873,444,1.966216216,764,2419,391,169,168,1,45,1,0.077380952,0,empty,CD-0722-2
"F8,E11",4434,5172,3222,1950,3125,1743,0,1747,1131,616,1.836038961,1036,1701,263,124,123,1,39,1,0.097560976,0,empty,CD-0722-2
"F8,E12",4685,5385,3415,1970,3283,1845,0,1847,1125,722,1.558171745,1075,1839,261,108,107,1,51,1,0.112149533,0,empty,CD-0722-2
"F8,F1",5563,6065,4007,2058,3656,1982,0,1984,1230,754,1.631299735,1125,2461,811,293,293,0,68,0,0.081911263,0,empty,CD-0722-2
"F8,F2",4884,5492,3568,1924,3341,1820,0,1823,1182,641,1.84399376,1078,2988,703,303,302,1,89,1,0.049668874,0,empty,CD-0722-2
"F8,F3",3893,4377,2840,1537,2690,1472,0,1473,956,517,1.849129594,831,1964,450,188,185,3,77,1,0.016216216,0,empty,CD-0722-2
"F8,F4",6306,6965,4539,2426,4149,2194,0,2196,1474,722,2.041551247,1216,880,97,33,32,1,24,1,0.0625,0,empty,CD-0722-2
"F8,F5",5248,5839,3792,2047,3486,1823,0,1823,1190,633,1.879936809,1043,1680,314,150,147,3,54,2,0.081632653,0,empty,CD-0722-2
"F8,F6",4737,5382,3518,1864,3144,1740,0,1742,1127,615,1.832520325,966,1873,555,202,199,3,68,3,0.055276382,0,empty,CD-0722-2
"F8,F7",5779,6588,4231,2357,3992,2193,0,2203,1387,816,1.699754902,1258,887,209,109,109,0,42,0,0.036697248,0,empty,CD-0722-2
"F8,F8",4677,5270,3517,1753,3122,1647,0,1647,1120,527,2.125237192,904,257,39,27,26,1,19,1,0.230769231,0,empty,CD-0722-2
"F8,F9",533403,617735,400454,217281,356313,192643,3,192809,150568,42241,3.564498947,111923,101923,12105,4794,4692,102,1073,5,0.039215686,0,hg38,CD-0722-2
"F8,F10",1093263,1183804,860164,323640,665575,308805,4,309111,240812,68299,3.525849573,166010,73743,18595,6581,6497,84,1091,6,0.020624904,0,hg38,CD-0722-2
"F8,F11",4543,5168,3449,1719,3059,1608,0,1615,1053,562,1.87366548,898,1682,295,135,135,0,37,0,0.111111111,0,empty,CD-0722-2
"F8,F12",6740,7595,5019,2576,4414,2289,0,2289,1652,637,2.593406593,1261,442,55,33,33,0,17,0,0.060606061,0,empty,CD-0722-2
"F8,G1",5391,5857,3992,1865,3523,1790,0,1793,1186,607,1.953871499,990,2630,705,313,312,1,99,1,0.067307692,0,empty,CD-0722-2
"F8,G2",3927,4546,2686,1860,2702,1642,0,1642,1030,612,1.683006536,981,653,158,69,68,1,31,1,0,0,empty,CD-0722-2
"F8,G3",6666,7470,4773,2697,4499,2510,0,2510,1503,1007,1.492552135,1429,1917,356,154,152,2,56,1,0.052631579,0,empty,CD-0722-2
"F8,G4",10962,12665,7664,5001,7639,4692,0,4694,2892,1802,1.604883463,2785,145,13,9,8,1,5,1,0,0,empty,CD-0722-2
"F8,G5",3696,4187,2692,1495,2522,1363,0,1363,911,452,2.015486726,822,1378,358,149,149,0,52,0,0.046979866,0,empty,CD-0722-2
"F8,G6",5177,5762,3791,1971,3488,1874,2,1878,1233,645,1.911627907,1067,172,40,18,18,0,11,0,0,0,empty,CD-0722-2
"F8,G7",4097,4750,3137,1613,2783,1484,0,1487,999,488,2.047131148,858,2502,466,190,186,4,43,2,0.010752688,0,empty,CD-0722-2
"F8,G8",3122,3706,2227,1479,2141,1210,0,1213,760,453,1.677704194,717,1772,479,162,160,2,50,2,0.075,0,empty,CD-0722-2
"F8,G9",3565,3982,2550,1432,2388,1321,0,1321,843,478,1.763598326,752,2159,568,210,209,1,69,1,0.081339713,0,empty,CD-0722-2
"F8,G10",4343,5050,3149,1901,2971,1691,0,1691,1057,634,1.667192429,969,2190,563,224,222,2,65,1,0.022522523,0,empty,CD-0722-2
"F8,G11",4325,4845,3236,1609,2900,1510,0,1510,995,515,1.932038835,809,1557,343,154,152,2,36,2,0.078947368,0,empty,CD-0722-2
"F8,G12",512848,658115,354676,303439,388062,251733,1,251911,195921,55990,3.499214145,161118,46722,17964,6762,6731,31,1143,5,0.054969544,0,hg38,CD-0722-2
"F8,H1",3908,4322,2940,1382,2552,1300,0,1301,849,452,1.878318584,679,976,206,97,96,1,48,1,0.010416667,0,empty,CD-0722-2
"F8,H2",7247,8328,5283,3045,4984,2779,0,2779,1963,816,2.405637255,1609,2238,451,197,193,4,75,2,0.010362694,0,empty,CD-0722-2
"F8,H3",3748,4414,2716,1698,2621,1464,0,1469,928,541,1.715341959,885,1645,469,127,127,0,40,0,0.338582677,0,empty,CD-0722-2
"F8,H4",5374,5853,3965,1888,3401,1815,0,1820,1165,655,1.778625954,976,225,73,25,25,0,12,0,0.48,0,empty,CD-0722-2
"F8,H5",5978,7018,4331,2687,4161,2366,0,2372,1550,822,1.885644769,1421,1971,484,175,173,2,61,2,0.023121387,0,empty,CD-0722-2
"F8,H6",4065,4754,2919,1835,2867,1680,0,1682,1141,541,2.109057301,1024,1472,242,121,121,0,49,0,0.049586777,0,empty,CD-0722-2
"F8,H7",4246,4836,3127,1709,2895,1539,0,1540,997,543,1.836095764,890,2140,530,229,218,11,67,2,0.151376147,0,empty,CD-0722-2
"F8,H8",4572,5222,3303,1919,3119,1758,0,1759,1087,672,1.617559524,1037,2096,566,238,235,3,65,1,0.110638298,0,empty,CD-0722-2
"F8,H9",724720,843345,534945,308400,480899,280583,2,280779,210890,69889,3.017499177,162877,36718,8220,2995,2954,41,572,2,0.048408937,0,hg38,CD-0722-2
"F8,H10",13368,14899,10130,4769,8533,4304,0,4306,3094,1212,2.552805281,2418,4578,813,345,339,6,119,3,0.073746313,0,empty,CD-0722-2
"F8,H11",4373,5177,3067,2110,3107,1984,0,1985,1077,908,1.186123348,1182,68,6,4,4,0,4,0,0,0,empty,CD-0722-2
"F8,H12",3190,3572,2281,1291,2185,1240,0,1242,806,436,1.848623853,735,1250,219,101,100,1,40,1,0.06,0,empty,CD-0722-2
"F9,A1",3496,4077,2531,1546,2446,1427,0,1427,924,503,1.836978131,855,878,114,56,55,1,25,1,0.090909091,0,empty,CD-0722-2
"F9,A2",1052370,1214593,780322,434271,686572,380889,3,381218,313207,68011,4.605240329,220622,196369,25519,10634,10383,251,1775,7,0.066069537,0,hg38,CD-0722-2
"F9,A3",3205,3506,2331,1175,2161,1166,0,1166,764,402,1.900497512,654,1539,248,101,99,2,27,2,0.171717172,0,empty,CD-0722-2
"F9,A4",579009,663372,438642,224730,378222,199643,2,199851,148156,51695,2.865963826,115241,51008,6109,2391,2302,89,447,4,0.077758471,0,hg38,CD-0722-2
"F9,A5",409129,481510,297319,184191,280902,161772,1,161902,126151,35751,3.528600599,96109,15933,5027,1826,1818,8,456,3,0.067656766,0,hg38,CD-0722-2
"F9,A6",62180,70956,48086,22870,41764,22348,0,22361,16204,6157,2.631801202,12348,6601,3226,1164,1151,13,254,2,0.004344049,0,empty,CD-0722-2
"F9,A7",3472,3960,2494,1466,2352,1345,1,1348,875,473,1.849894292,766,1408,349,148,147,1,37,1,0.238095238,0,empty,CD-0722-2
"F9,A8",2026,2366,1516,850,1451,805,0,805,542,263,2.060836502,491,2008,455,121,119,2,41,1,0.100840336,0,empty,CD-0722-2
"F9,A9",3542,3891,2678,1213,2355,1216,0,1216,800,416,1.923076923,656,1747,537,216,216,0,55,0,0.027777778,0,empty,CD-0722-2
"F9,A10",3900,4426,2877,1549,2652,1440,0,1442,841,601,1.399334443,830,291,26,19,15,4,14,1,0,0,empty,CD-0722-2
"F9,A11",3079,3539,2324,1215,2184,1171,0,1175,780,395,1.974683544,674,2406,798,319,317,2,68,1,0.135646688,0,empty,CD-0722-2
"F9,A12",4379,4762,3214,1548,2888,1502,0,1502,1004,498,2.016064257,860,3934,875,323,317,6,86,2,0.085173502,0,empty,CD-0722-2
"F9,B1",3865,4288,2752,1536,2601,1464,0,1466,931,535,1.740186916,835,1570,397,148,147,1,41,1,0.040816327,0,empty,CD-0722-2
"F9,B2",4182,4531,2775,1756,2770,1669,0,1669,997,672,1.483630952,983,643,128,61,61,0,22,0,0.016393443,0,empty,CD-0722-2
"F9,B3",3224,3615,2311,1304,2221,1246,0,1246,810,436,1.857798165,739,1395,252,109,104,5,44,3,0,0,empty,CD-0722-2
"F9,B4",3338,3720,2312,1408,2276,1303,0,1303,817,486,1.681069959,769,1670,298,118,118,0,34,0,0.06779661,0,empty,CD-0722-2
"F9,B5",466619,259618,159392,100226,186457,101582,5,102164,79248,22916,3.458195147,64490,81658,11311,4034,3937,97,798,7,0.037846076,0,hg38,CD-0722-2
"F9,B6",4083,4804,2819,1985,2855,1711,0,1713,1102,611,1.803600655,1035,1569,405,156,155,1,58,1,0.012903226,0,empty,CD-0722-2
"F9,B7",4037,4479,3044,1435,2725,1457,0,1457,936,521,1.796545106,784,1354,304,120,120,0,36,0,0.25,0,empty,CD-0722-2
"F9,B8",2844,3136,2118,1018,1860,943,1,946,656,290,2.262068966,512,1298,289,104,100,4,33,1,0.09,0,empty,CD-0722-2
"F9,B9",5391,6292,3866,2426,3844,2226,0,2230,1424,806,1.76674938,1342,1355,414,145,144,1,56,1,0.076388889,0,empty,CD-0722-2
"F9,B10",2478,2768,1733,1035,1765,961,0,963,623,340,1.832352941,561,464,112,55,54,1,12,1,0,0,empty,CD-0722-2
"F9,B11",5931,6903,4196,2707,4090,2432,1,2433,1362,1071,1.271708683,1434,190,28,20,20,0,9,0,0.1,0,empty,CD-0722-2
"F9,B12",3284,3813,2369,1444,2296,1327,0,1329,865,464,1.864224138,786,1667,369,136,133,3,45,1,0.045112782,0,empty,CD-0722-2
"F9,C1",6844,7734,5075,2659,4559,2444,0,2449,1565,884,1.770361991,1367,1115,229,81,80,1,27,1,0.05,0,empty,CD-0722-2
"F9,C2",525321,676705,345794,330911,393760,280074,1,280241,212047,68194,3.109467109,177281,3671,1139,381,377,4,111,2,0.061007958,0,hg38,CD-0722-2
"F9,C3",617157,739610,455872,283738,424361,240788,3,240991,189205,51786,3.653593635,145146,62119,7842,3135,3065,70,644,6,0.07862969,0,hg38,CD-0722-2
"F9,C4",321226,385648,225233,160415,227565,139870,1,139973,110778,29195,3.794416852,85517,15776,4937,1788,1777,11,410,2,0.060213844,0,hg38,CD-0722-2
"F9,C5",5158,5766,3738,2028,3555,1964,0,1964,1315,649,2.026194145,1142,1964,529,196,193,3,49,1,0.025906736,0,empty,CD-0722-2
"F9,C6",4337,5047,3101,1946,3034,1724,0,1724,1127,597,1.887772194,992,1149,241,126,123,3,37,2,0,0,empty,CD-0722-2
"F9,C7",471903,529883,363770,166113,304976,150128,0,150262,121124,29138,4.156908504,84807,8437,1468,565,555,10,138,2,0.030630631,0,hg38,CD-0722-2
"F9,C8",6487,7229,4799,2430,4320,2354,0,2358,1539,819,1.879120879,1304,2987,693,287,282,5,81,3,0.028368794,0,empty,CD-0722-2
"F9,C9",867524,1022548,638018,384530,588185,333043,1,333339,256974,76365,3.365075624,198528,162511,22310,8793,8615,178,1479,5,0.045850261,0,hg38,CD-0722-2
"F9,C10",5459,6195,4009,2186,3651,1958,0,1958,1292,666,1.93993994,1103,1614,371,168,166,2,54,1,0.018072289,0,empty,CD-0722-2
"F9,C11",4540,5025,3367,1658,3065,1661,0,1661,1030,631,1.632329635,884,1574,483,177,175,2,49,1,0.165714286,0,empty,CD-0722-2
"F9,C12",506424,593850,368843,225007,346024,194749,0,194926,160771,34155,4.707099985,116457,198124,33839,13187,12911,276,1854,10,0.082332894,0,hg38,CD-0722-2
"F9,D1",5590,6271,3990,2281,3794,2211,0,2212,1349,863,1.563151796,1258,986,205,61,61,0,24,0,0.032786885,0,empty,CD-0722-2
"F9,D2",4867,5425,3586,1839,3280,1740,0,1744,1112,632,1.759493671,985,3098,1037,392,386,6,90,3,0.077720207,0,empty,CD-0722-2
"F9,D3",436075,548049,298844,249205,320899,220981,2,221120,157546,63574,2.478151446,135583,3192,466,194,190,4,63,1,0.068421053,0,hg38,CD-0722-2
"F9,D4",3227,3647,2374,1273,2134,1156,0,1156,700,456,1.535087719,639,1713,472,199,198,1,49,1,0.005050505,0,empty,CD-0722-2
"F9,D5",3576,4097,2555,1542,2512,1354,0,1358,850,508,1.673228346,831,1869,529,188,187,1,70,1,0.064171123,0,empty,CD-0722-2
"F9,D6",6151,7170,4360,2810,4161,2441,0,2446,1477,969,1.524251806,1440,2211,524,218,218,0,58,0,0,0,empty,CD-0722-2
"F9,D7",3146,3661,2339,1322,2232,1187,0,1187,768,419,1.832935561,680,2399,534,244,242,2,68,2,0.061983471,0,empty,CD-0722-2
"F9,D8",3833,4328,2806,1522,2534,1377,0,1377,886,491,1.804480652,793,1159,293,130,130,0,44,0,0.046153846,0,empty,CD-0722-2
"F9,D9",1969,2177,1501,676,1343,680,0,680,441,239,1.845188285,359,1437,281,136,134,2,43,1,0.082089552,0,empty,CD-0722-2
"F9,D10",4037,4593,2797,1796,2775,1547,0,1550,918,632,1.452531646,929,1030,108,53,51,2,26,2,0.196078431,0,empty,CD-0722-2
"F9,D11",3922,4329,2899,1430,2626,1399,0,1401,915,486,1.882716049,781,3404,1059,389,383,6,82,2,0.120104439,0,empty,CD-0722-2
"F9,D12",5642,6479,4094,2385,3829,2129,0,2131,1408,723,1.947441217,1239,3782,991,350,349,1,107,1,0.034383954,0,empty,CD-0722-2
"F9,E1",6532,7252,4732,2520,4321,2399,0,2407,1510,897,1.683389075,1321,2692,502,185,185,0,53,0,0.048648649,0,empty,CD-0722-2
"F9,E2",4843,5496,3535,1961,3343,1853,0,1855,1127,728,1.548076923,1089,1959,328,124,122,2,44,1,0.172131148,0,empty,CD-0722-2
"F9,E3",3339,3810,2487,1323,2265,1198,0,1200,778,422,1.843601896,704,2172,532,201,200,1,62,1,0.02,0,empty,CD-0722-2
"F9,E4",4316,4898,3112,1786,2840,1550,1,1556,1024,532,1.92481203,871,2902,531,288,281,7,81,3,0.149466192,0,empty,CD-0722-2
"F9,E5",4223,4683,3211,1472,2729,1369,0,1370,896,474,1.890295359,724,1460,299,129,128,1,44,1,0.109375,0,empty,CD-0722-2
"F9,E6",6880,7899,5026,2873,4760,2678,0,2679,1706,973,1.753340185,1566,3536,720,325,323,2,100,1,0.077399381,0,empty,CD-0722-2
"F9,E7",809405,917700,624924,292776,520024,267117,1,267350,219080,48270,4.538636834,148700,158318,18368,6969,6756,213,1342,8,0.054026051,0,hg38,CD-0722-2
"F9,E8",5424,6006,4170,1836,3576,1814,0,1815,1227,588,2.086734694,974,3079,889,341,339,2,75,2,0.017699115,0,empty,CD-0722-2
"F9,E9",3015,3484,2253,1231,2078,1148,0,1150,738,412,1.791262136,647,2848,594,227,224,3,78,2,0.022321429,0,empty,CD-0722-2
"F9,E10",3774,4380,2773,1607,2626,1451,0,1451,910,541,1.68207024,822,1991,334,147,146,1,48,1,0.102739726,0,empty,CD-0722-2
"F9,E11",4465,5119,3270,1849,3080,1719,0,1719,1109,610,1.818032787,978,2337,692,260,259,1,62,1,0.196911197,0,empty,CD-0722-2
"F9,E12",4628,5295,3239,2056,3245,1820,0,1820,1223,597,2.048576214,1085,1713,410,157,157,0,49,0,0.044585987,0,empty,CD-0722-2
"F9,F1",5728,6303,4209,2094,3795,1996,0,1997,1266,731,1.731874145,1114,2440,492,212,209,3,65,2,0.052631579,0,empty,CD-0722-2
"F9,F2",4978,5472,3745,1727,3227,1697,0,1697,1111,586,1.895904437,924,3360,804,331,330,1,75,1,0.06969697,0,empty,CD-0722-2
"F9,F3",4221,4811,3011,1800,2854,1579,0,1580,1048,532,1.969924812,923,2393,524,228,221,7,71,2,0.054298643,0,empty,CD-0722-2
"F9,F4",6479,7271,4702,2569,4385,2343,2,2347,1492,855,1.74502924,1365,798,181,71,71,0,23,0,0.056338028,0,empty,CD-0722-2
"F9,F5",5316,5786,3875,1911,3467,1804,0,1805,1190,615,1.93495935,977,2583,686,236,232,4,66,1,0.056034483,0,empty,CD-0722-2
"F9,F6",4824,5671,3527,2144,3342,1919,0,1919,1252,667,1.877061469,1108,3258,701,276,272,4,70,2,0.088235294,0,empty,CD-0722-2
"F9,F7",5925,6888,4332,2556,4079,2276,0,2277,1448,829,1.74668275,1336,1222,211,77,75,2,26,1,0.026666667,0,empty,CD-0722-2
"F9,F8",5354,6144,4032,2112,3753,1975,0,1975,1372,603,2.275290216,1104,251,36,24,24,0,15,0,0.083333333,0,empty,CD-0722-2
"F9,F9",4539,5177,3364,1813,3144,1678,0,1678,1086,592,1.834459459,984,2896,519,206,205,1,70,1,0.004878049,0,empty,CD-0722-2
"F9,F10",6010,6726,4521,2205,4006,2097,0,2102,1388,714,1.943977591,1166,1637,360,138,136,2,45,1,0.095588235,0,empty,CD-0722-2
"F9,F11",4396,4904,3356,1548,2930,1560,0,1562,1058,504,2.099206349,841,2000,371,173,171,2,45,2,0.093567251,0,empty,CD-0722-2
"F9,F12",5209,5791,3791,2000,3421,1830,0,1833,1187,646,1.8374613,1031,267,17,11,11,0,7,0,0.272727273,0,empty,CD-0722-2
"F9,G1",5528,6345,4056,2289,3775,2038,0,2038,1306,732,1.784153005,1192,2786,498,195,193,2,66,2,0.056994819,0,empty,CD-0722-2
"F9,G2",490260,594451,336864,257587,348450,230693,1,230880,159837,71043,2.249862759,141659,1326,181,95,89,6,39,2,0.112359551,0,empty,CD-0722-2
"F9,G3",6150,6785,4454,2331,3987,2209,0,2213,1380,833,1.656662665,1247,2761,658,265,264,1,71,1,0,0,empty,CD-0722-2
"F9,G4",11246,13007,7864,5143,7811,4754,0,4761,2869,1892,1.516384778,2874,95,29,16,16,0,9,0,0.0625,0,empty,CD-0722-2
"F9,G5",3804,4507,2723,1784,2647,1507,0,1507,971,536,1.811567164,916,1836,459,191,190,1,58,1,0.026315789,0,empty,CD-0722-2
"F9,G6",5549,6216,4091,2125,3715,1982,0,1984,1330,654,2.033639144,1092,178,47,22,22,0,7,0,0,0,empty,CD-0722-2
"F9,G7",4283,4645,3243,1402,2761,1363,0,1364,858,506,1.695652174,729,2287,496,173,173,0,41,0,0.260115607,0,empty,CD-0722-2
"F9,G8",360793,384472,283033,101439,221694,98654,0,98742,72734,26008,2.796601046,52793,48624,9170,3615,3565,50,686,3,0.035904628,0,hg38,CD-0722-2
"F9,G9",3879,4447,2859,1588,2630,1415,0,1415,885,530,1.669811321,796,2349,515,183,183,0,63,0,0.043715847,0,empty,CD-0722-2
"F9,G10",4439,5176,3288,1888,3120,1760,0,1761,1115,646,1.726006192,1007,2210,641,242,242,0,77,0,0.037190083,0,empty,CD-0722-2
"F9,G11",4433,4947,3300,1647,2964,1591,0,1594,1040,554,1.877256318,873,1793,418,158,156,2,40,2,0.044871795,0,empty,CD-0722-2
"F9,G12",3701,4273,2676,1597,2574,1439,0,1441,866,575,1.506086957,852,2599,586,283,283,0,80,0,0.148409894,0,empty,CD-0722-2
"F9,H1",3817,4244,2801,1443,2604,1353,0,1353,895,458,1.954148472,784,1264,232,80,80,0,31,0,0.2375,0,empty,CD-0722-2
"F9,H2",4416,5093,3142,1951,3019,1673,0,1673,1063,610,1.742622951,986,2515,533,220,218,2,77,1,0.02293578,0,empty,CD-0722-2
"F9,H3",3588,4217,2622,1595,2492,1387,0,1388,902,486,1.855967078,805,1961,349,127,122,5,43,2,0.081967213,0,empty,CD-0722-2
"F9,H4",5465,6173,3988,2185,3659,1986,0,1993,1310,683,1.918008785,1161,130,29,15,15,0,10,0,0,0,empty,CD-0722-2
"F9,H5",7064,8034,5051,2983,4808,2740,0,2743,1620,1123,1.442564559,1584,1957,387,181,179,2,68,1,0.022346369,0,empty,CD-0722-2
"F9,H6",3556,4019,2491,1528,2418,1445,0,1445,965,480,2.010416667,836,2113,479,181,178,3,62,1,0.06741573,0,empty,CD-0722-2
"F9,H7",4120,4632,2987,1645,2824,1511,0,1512,962,550,1.749090909,870,2123,408,190,189,1,55,1,0.015873016,0,empty,CD-0722-2
"F9,H8",4687,5478,3382,2096,3191,1823,0,1825,1182,643,1.838258165,1074,2654,539,185,179,6,70,3,0.044692737,0,empty,CD-0722-2
"F9,H9",3288,3595,2447,1148,2195,1143,1,1144,751,393,1.910941476,643,1206,276,125,123,2,30,1,0.284552846,0,empty,CD-0722-2
"F9,H10",3421,3868,2459,1409,2284,1248,0,1250,802,448,1.790178571,726,1441,294,118,118,0,45,0,0.025423729,0,empty,CD-0722-2
"F9,H11",4319,5228,2973,2255,3151,2078,0,2078,1168,910,1.283516484,1250,83,9,7,7,0,5,0,0,0,empty,CD-0722-2
"F9,H12",3361,3738,2401,1337,2192,1245,0,1246,820,426,1.924882629,719,1486,402,172,168,4,58,2,0.029761905,0,empty,CD-0722-2
"F10,A1",3921,4664,2774,1890,2694,1551,0,1552,1046,506,2.067193676,912,1119,266,92,88,4,28,1,0.113636364,0,empty,CD-0722-2
"F10,A2",5729,6594,4199,2395,3976,2275,0,2275,1398,877,1.594070696,1305,1505,344,151,150,1,57,1,0.013333333,0,empty,CD-0722-2
"F10,A3",3427,3971,2483,1488,2440,1372,0,1374,874,500,1.748,829,1125,269,118,118,0,37,0,0.093220339,0,empty,CD-0722-2
"F10,A4",5957,6791,4338,2453,4067,2298,0,2298,1474,824,1.788834951,1312,854,131,42,42,0,25,0,0.023809524,0,empty,CD-0722-2
"F10,A5",4688,5098,3465,1633,3068,1607,0,1610,1022,588,1.738095238,867,2053,467,195,193,2,50,1,0.093264249,0,empty,CD-0722-2
"F10,A6",4678,5556,3351,2205,3361,1977,0,1977,1316,661,1.990922844,1200,2288,545,239,238,1,60,1,0.277310924,0,empty,CD-0722-2
"F10,A7",3560,4111,2513,1598,2536,1469,0,1472,918,554,1.657039711,879,1063,213,95,95,0,25,0,0.168421053,0,empty,CD-0722-2
"F10,A8",2165,2419,1591,828,1449,799,0,799,564,235,2.4,433,1813,466,179,178,1,55,1,0.005617978,0,empty,CD-0722-2
"F10,A9",3931,4630,2846,1784,2718,1504,0,1505,1000,505,1.98019802,864,1750,586,214,214,0,58,0,0.177570093,0,empty,CD-0722-2
"F10,A10",4995,5683,3734,1949,3374,1808,0,1810,1135,675,1.681481481,1024,362,67,45,43,2,14,1,0.11627907,0,empty,CD-0722-2
"F10,A11",3544,4061,2658,1403,2372,1236,0,1239,796,443,1.796839729,716,1465,449,185,184,1,52,1,0.038043478,0,empty,CD-0722-2
"F10,A12",5147,5654,3791,1863,3465,1867,0,1867,1178,689,1.709724238,1035,3336,786,299,296,3,92,2,0.033783784,0,empty,CD-0722-2
"F10,B1",4458,4989,3236,1753,2938,1658,0,1658,1052,606,1.735973597,910,1148,297,113,111,2,33,2,0.108108108,0,empty,CD-0722-2
"F10,B2",4404,5078,2907,2171,3031,1808,0,1810,1093,717,1.524407252,1130,613,176,81,81,0,22,0,0.135802469,0,empty,CD-0722-2
"F10,B3",3953,4551,2888,1663,2731,1525,0,1529,1031,498,2.070281124,899,1297,328,150,150,0,64,0,0.006666667,0,empty,CD-0722-2
"F10,B4",4246,4756,3070,1686,2963,1698,0,1698,1105,593,1.863406408,972,1436,353,117,116,1,34,1,0.00862069,0,empty,CD-0722-2
"F10,B5",4635,2824,1711,1113,2055,1135,0,1147,757,390,1.941025641,728,1507,364,92,92,0,31,0,0.032608696,0,empty,CD-0722-2
"F10,B6",4800,5508,3434,2074,3289,1878,0,1882,1173,709,1.654442877,1140,1777,529,206,205,1,57,1,0.107317073,0,empty,CD-0722-2
"F10,B7",4279,4888,3161,1727,2946,1619,0,1619,1062,557,1.906642729,927,1458,430,160,160,0,45,0,0.0875,0,empty,CD-0722-2
"F10,B8",3133,3476,2353,1123,2124,1104,0,1106,755,351,2.150997151,631,1030,233,98,98,0,32,0,0.06122449,0,empty,CD-0722-2
"F10,B9",6390,7175,4586,2589,4304,2387,0,2389,1585,804,1.971393035,1380,1259,318,130,130,0,46,0,0.123076923,0,empty,CD-0722-2
"F10,B10",2888,3076,2123,953,1976,1061,0,1064,679,385,1.763636364,577,460,187,58,58,0,21,0,0.034482759,0,empty,CD-0722-2
"F10,B11",6873,7804,4882,2922,4677,2787,0,2790,1568,1222,1.28314239,1584,338,88,40,40,0,12,0,0.475,0,empty,CD-0722-2
"F10,B12",3839,4335,2767,1568,2680,1501,0,1503,1015,488,2.079918033,906,1599,394,138,134,4,41,1,0.059701493,0,empty,CD-0722-2
"F10,C1",485185,539336,369113,170223,307871,154960,2,155087,115881,39206,2.955695557,87215,54857,6058,2485,2410,75,480,2,0.06846473,0,hg38,CD-0722-2
"F10,C2",1309591,1579455,944947,634508,890346,533030,2,533417,424996,108421,3.919867922,323794,203673,33596,12790,12535,255,2055,6,0.07140008,0,hg38,CD-0722-2
"F10,C3",6546,7127,4715,2412,4387,2398,0,2400,1536,864,1.777777778,1348,1058,195,71,69,2,32,1,0.057971014,0,empty,CD-0722-2
"F10,C4",3978,4443,2945,1498,2718,1404,0,1406,948,458,2.069868996,842,1557,373,141,140,1,40,1,0.135714286,0,empty,CD-0722-2
"F10,C5",5468,6220,4040,2180,3644,1933,0,1936,1256,680,1.847058824,1113,1473,375,127,125,2,42,1,0.184,0,empty,CD-0722-2
"F10,C6",4687,5350,3441,1909,3286,1832,0,1834,1191,643,1.852255054,1052,1659,411,164,164,0,49,0,0.006097561,0,empty,CD-0722-2
"F10,C7",6578,7949,4619,3330,4799,2935,1,2943,1745,1198,1.456594324,1816,347,75,36,36,0,15,0,0,0,empty,CD-0722-2
"F10,C8",7229,8373,5321,3052,5042,2825,0,2826,1903,923,2.061755146,1617,2985,624,268,261,7,82,3,0.134099617,0,empty,CD-0722-2
"F10,C9",6527,7518,4818,2700,4443,2404,0,2404,1673,731,2.288645691,1397,2266,610,180,180,0,43,0,0.138888889,0,empty,CD-0722-2
"F10,C10",5798,6374,4186,2188,3813,2035,0,2039,1333,706,1.888101983,1141,1663,388,158,151,7,55,3,0.092715232,0,empty,CD-0722-2
"F10,C11",4666,5490,3384,2106,3265,1822,0,1825,1160,665,1.744360902,1079,2347,750,283,283,0,60,0,0.014134276,0,empty,CD-0722-2
"F10,C12",6752,7723,4972,2751,4579,2453,0,2457,1608,849,1.893992933,1423,1834,388,149,149,0,44,0,0.154362416,0,empty,CD-0722-2
"F10,D1",7304,8616,5232,3384,5040,2976,0,2976,1762,1214,1.451400329,1797,859,126,52,52,0,23,0,0.038461538,0,empty,CD-0722-2
"F10,D2",374741,421805,286183,135622,244347,124990,3,125123,91441,33682,2.714832848,69488,241403,41268,15204,14940,264,2187,9,0.055823293,0,hg38,CD-0722-2
"F10,D3",4896,5495,3511,1984,3268,1821,0,1821,1186,635,1.867716535,1050,1977,375,151,149,2,49,2,0.073825503,0,empty,CD-0722-2
"F10,D4",3618,4238,2647,1591,2451,1359,0,1359,917,442,2.074660633,755,1360,329,133,132,1,37,1,0.159090909,0,empty,CD-0722-2
"F10,D5",4117,4565,3072,1493,2750,1507,0,1510,1010,500,2.02,828,1718,372,174,174,0,49,0,0.091954023,0,empty,CD-0722-2
"F10,D6",6364,7240,4435,2805,4294,2591,0,2592,1566,1026,1.526315789,1500,1753,419,173,168,5,49,1,0.005952381,0,empty,CD-0722-2
"F10,D7",3740,4262,2662,1600,2624,1445,0,1448,984,464,2.120689655,845,2049,470,174,173,1,61,1,0.023121387,0,empty,CD-0722-2
"F10,D8",8311,9304,6424,2880,5510,2749,0,2753,1913,840,2.277380952,1585,3681,786,297,294,3,72,2,0.139455782,0,empty,CD-0722-2
"F10,D9",2160,2481,1580,901,1477,808,0,808,564,244,2.31147541,451,1561,396,160,159,1,40,1,0.050314465,0,empty,CD-0722-2
"F10,D10",4111,4755,2928,1827,2876,1683,0,1688,1101,587,1.875638842,1021,1002,273,138,138,0,40,0,0.028985507,0,empty,CD-0722-2
"F10,D11",4518,4978,3403,1575,3085,1590,0,1595,1043,552,1.889492754,907,2521,614,236,235,1,78,1,0.059574468,0,empty,CD-0722-2
"F10,D12",6201,7207,4469,2738,4278,2439,0,2440,1576,864,1.824074074,1447,4161,932,360,354,6,112,3,0.101694915,0,empty,CD-0722-2
"F10,E1",7207,7939,5242,2697,4734,2589,0,2592,1579,1013,1.558736426,1447,2732,505,192,184,8,62,1,0.054347826,0,empty,CD-0722-2
"F10,E2",5001,5652,3553,2099,3359,1886,0,1886,1183,703,1.682788051,1120,1965,249,117,109,8,48,3,0.018348624,0,empty,CD-0722-2
"F10,E3",455230,557458,332153,225305,322386,192346,0,192493,154050,38443,4.007231486,116427,53289,16206,6124,6073,51,1074,3,0.061584061,0,hg38,CD-0722-2
"F10,E4",850645,1048452,601167,447285,604075,380739,4,381024,270649,110375,2.45208607,235436,142682,26735,10431,10284,147,1571,10,0.047841307,0,hg38,CD-0722-2
"F10,E5",568458,648266,430247,218019,372083,195137,0,195301,143026,52275,2.736030607,111353,114231,14964,5589,5451,138,1020,3,0.051733627,0,hg38,CD-0722-2
"F10,E6",7811,9138,5536,3602,5389,3063,0,3069,1994,1075,1.854883721,1876,3584,809,273,268,5,98,2,0.048507463,0,empty,CD-0722-2
"F10,E7",6966,7591,5216,2375,4552,2348,0,2353,1569,784,2.00127551,1308,2749,571,266,265,1,80,1,0.086792453,0,empty,CD-0722-2
"F10,E8",5596,6264,4235,2029,3711,1896,0,1897,1283,614,2.089576547,1031,2762,694,255,251,4,60,1,0.247011952,0,empty,CD-0722-2
"F10,E9",3641,4115,2661,1454,2547,1430,0,1430,952,478,1.991631799,845,2483,577,204,201,3,71,2,0.004975124,0,empty,CD-0722-2
"F10,E10",3994,4374,2911,1463,2603,1402,0,1404,931,473,1.968287526,771,1837,519,203,201,2,50,1,0.084577114,0,empty,CD-0722-2
"F10,E11",4846,5361,3517,1844,3263,1772,0,1772,1178,594,1.983164983,1024,2255,467,181,177,4,43,2,0.124293785,0,empty,CD-0722-2
"F10,E12",5456,6207,3946,2261,3720,2101,0,2104,1360,744,1.827956989,1220,2035,296,129,123,6,45,2,0.073170732,0,empty,CD-0722-2
"F10,F1",6205,6876,4576,2300,4168,2226,0,2229,1415,814,1.738329238,1238,2133,394,192,187,5,59,2,0.053475936,0,empty,CD-0722-2
"F10,F2",4913,5646,3624,2022,3357,1826,1,1833,1171,662,1.768882175,1062,2989,887,323,323,0,75,0,0.114551084,0,empty,CD-0722-2
"F10,F3",4667,5302,3382,1920,3116,1703,0,1703,1138,565,2.014159292,993,3020,772,311,310,1,75,1,0.14516129,0,empty,CD-0722-2
"F10,F4",7230,8101,5346,2755,4840,2529,0,2536,1707,829,2.059107358,1430,795,155,72,72,0,36,0,0.055555556,0,empty,CD-0722-2
"F10,F5",6119,6590,4421,2169,4112,2170,0,2173,1435,738,1.944444444,1207,2430,589,270,264,6,64,2,0.125,0,empty,CD-0722-2
"F10,F6",5472,6279,3931,2348,3664,2083,0,2087,1301,786,1.655216285,1220,2431,461,178,174,4,59,1,0.097701149,0,empty,CD-0722-2
"F10,F7",6191,6901,4529,2372,4179,2300,0,2304,1510,794,1.901763224,1291,1145,270,118,116,2,33,1,0.155172414,0,empty,CD-0722-2
"F10,F8",4709,5309,3416,1893,3193,1746,0,1748,1238,510,2.42745098,1019,269,28,22,21,1,19,1,0.047619048,0,empty,CD-0722-2
"F10,F9",5119,5688,3865,1823,3528,1849,0,1851,1252,599,2.09015025,1031,3530,1124,417,414,3,85,2,0.118357488,0,empty,CD-0722-2
"F10,F10",801200,902072,609510,292562,508787,254775,2,255044,203030,52014,3.903372169,144322,12411,3960,1401,1381,20,459,3,0.032585083,0,hg38,CD-0722-2
"F10,F11",4954,5428,3799,1629,3393,1712,0,1712,1201,511,2.350293542,954,1481,268,110,107,3,38,2,0.056074766,0,empty,CD-0722-2
"F10,F12",5575,6240,4037,2203,3598,1912,0,1915,1297,618,2.098705502,1097,260,18,8,7,1,7,1,0,0,empty,CD-0722-2
"F10,G1",454054,560978,307407,253571,327689,224210,0,224347,165356,58991,2.803071655,136881,8023,1259,485,480,5,131,2,0.097916667,0,hg38,CD-0722-2
"F10,G2",3574,4159,2443,1716,2515,1451,0,1454,904,550,1.643636364,867,417,99,51,50,1,25,1,0.1,0,empty,CD-0722-2
"F10,G3",6678,7214,4827,2387,4314,2351,0,2353,1422,931,1.527389903,1281,2723,660,203,199,4,69,1,0.015075377,0,empty,CD-0722-2
"F10,G4",12291,14623,8432,6191,8616,5311,0,5311,3220,2091,1.539933046,3262,157,16,11,11,0,9,0,0,0,empty,CD-0722-2
"F10,G5",3850,4423,2803,1620,2664,1499,0,1504,964,540,1.785185185,891,1850,467,192,192,0,46,0,0.072916667,0,empty,CD-0722-2
"F10,G6",5553,6303,4029,2274,3767,2073,0,2081,1380,701,1.968616262,1218,147,35,20,20,0,11,0,0,0,empty,CD-0722-2
"F10,G7",4419,5077,3313,1764,3083,1651,0,1656,1065,591,1.802030457,929,2824,827,286,285,1,67,1,0.042105263,0,empty,CD-0722-2
"F10,G8",830004,940488,628622,311866,536745,278377,3,278625,209934,68691,3.056208237,160424,173866,22388,8454,8256,198,1493,8,0.037306202,0,hg38,CD-0722-2
"F10,G9",4132,4611,3000,1611,2761,1509,0,1509,1005,504,1.994047619,875,2543,515,239,237,2,69,1,0.012658228,0,empty,CD-0722-2
"F10,G10",6345,7640,4645,2995,4539,2579,0,2581,1746,835,2.091017964,1560,2803,537,219,219,0,79,0,0.050228311,0,empty,CD-0722-2
"F10,G11",4705,5464,3501,1963,3237,1760,0,1762,1217,545,2.233027523,1042,1746,464,198,197,1,56,1,0.137055838,0,empty,CD-0722-2
"F10,G12",4379,5046,3155,1891,2983,1717,0,1718,1116,602,1.853820598,1016,2532,719,278,275,3,83,2,0.021818182,0,empty,CD-0722-2
"F10,H1",4679,5284,3501,1783,3210,1731,0,1731,1157,574,2.015679443,990,1495,332,151,145,6,45,2,0,0,empty,CD-0722-2
"F10,H2",5123,5854,3747,2107,3528,1924,0,1924,1198,726,1.650137741,1100,2202,600,216,214,2,65,1,0.060747664,0,empty,CD-0722-2
"F10,H3",4162,4623,3017,1606,2754,1528,0,1531,992,539,1.840445269,860,1717,438,147,141,6,48,2,0.063829787,0,empty,CD-0722-2
"F10,H4",5912,6755,4387,2368,4012,2154,0,2154,1415,739,1.914749662,1278,336,58,34,34,0,15,0,0,0,empty,CD-0722-2
"F10,H5",6455,7209,4775,2434,4298,2333,0,2333,1557,776,2.006443299,1284,1720,480,180,178,2,57,1,0.005617978,0,empty,CD-0722-2
"F10,H6",140868,162046,100780,61266,97775,63142,0,63185,40134,23051,1.741095831,34572,2489,751,259,256,3,70,2,0.15625,0,hg38,CD-0722-2
"F10,H7",4609,5116,3413,1703,3073,1624,0,1626,1108,518,2.138996139,915,2030,627,239,238,1,74,1,0.042016807,0,empty,CD-0722-2
"F10,H8",5458,6378,3976,2402,3622,2066,0,2068,1320,748,1.764705882,1167,1772,446,182,180,2,64,1,0.05,0,empty,CD-0722-2
"F10,H9",3841,4307,2960,1347,2571,1349,0,1349,900,449,2.004454343,719,1127,237,106,104,2,32,2,0.038461538,0,empty,CD-0722-2
"F10,H10",3904,4378,2850,1528,2632,1399,0,1399,933,466,2.002145923,782,1414,280,126,123,3,44,2,0.016260163,0,empty,CD-0722-2
"F10,H11",5458,6259,3767,2492,3865,2544,0,2544,1332,1212,1.099009901,1462,62,11,8,8,0,7,0,0,0,empty,CD-0722-2
"F10,H12",3863,4398,2722,1676,2684,1461,0,1465,956,509,1.878192534,872,1647,285,123,122,1,32,1,0.254098361,0,empty,CD-0722-2
"F11,A1",3987,4476,2884,1592,2682,1560,0,1560,1032,528,1.954545455,842,1495,292,139,139,0,53,0,0.151079137,0,empty,CD-0722-2
"F11,A2",8477,9540,6318,3222,5619,3036,0,3036,2051,985,2.082233503,1727,2745,338,174,174,0,60,0,0.114942529,0,empty,CD-0722-2
"F11,A3",891697,1081630,637182,444448,624953,379417,1,379690,291121,88569,3.286940126,233638,74405,7278,2898,2816,82,656,4,0.051136364,0,hg38,CD-0722-2
"F11,A4",5947,6899,4319,2580,4169,2325,0,2325,1490,835,1.784431138,1360,750,47,37,36,1,23,1,0.027777778,0,empty,CD-0722-2
"F11,A5",5250,5893,3801,2092,3534,1940,0,1947,1268,679,1.867452135,1134,1922,523,181,180,1,52,1,0.088888889,0,empty,CD-0722-2
"F11,A6",6342,7557,4646,2911,4461,2531,0,2535,1739,796,2.184673367,1473,2560,527,231,225,6,87,1,0.048888889,0,empty,CD-0722-2
"F11,A7",3805,4424,2769,1655,2604,1492,0,1493,953,540,1.764814815,907,1242,252,130,129,1,48,1,0.069767442,0,empty,CD-0722-2
"F11,A8",2569,2839,1921,918,1709,921,0,921,622,299,2.080267559,492,1837,474,181,179,2,47,2,0.067039106,0,empty,CD-0722-2
"F11,A9",4356,5021,3228,1793,2955,1597,0,1598,1074,524,2.049618321,893,1525,369,162,162,0,50,0,0.080246914,0,empty,CD-0722-2
"F11,A10",5419,5937,4131,1806,3503,1826,0,1826,1125,701,1.604850214,959,390,39,23,23,0,11,0,0,0,empty,CD-0722-2
"F11,A11",3790,4320,2807,1513,2610,1375,0,1375,920,455,2.021978022,798,1274,232,108,107,1,40,1,0.065420561,0,empty,CD-0722-2
"F11,A12",5271,5864,3875,1989,3465,1843,1,1844,1199,645,1.858914729,1017,3140,741,281,279,2,90,2,0.014336918,0,empty,CD-0722-2
"F11,B1",4488,5214,3217,1997,3103,1793,0,1793,1081,712,1.518258427,1057,1085,296,127,126,1,35,1,0.087301587,0,empty,CD-0722-2
"F11,B2",5311,6397,3575,2822,3767,2278,0,2279,1440,839,1.716328963,1437,676,216,89,87,2,17,1,0.264367816,0,empty,CD-0722-2
"F11,B3",3909,4421,2809,1612,2717,1493,0,1495,970,525,1.847619048,880,1754,362,140,139,1,48,1,0.143884892,0,empty,CD-0722-2
"F11,B4",4682,5307,3271,2036,3191,1912,2,1915,1161,754,1.539787798,1103,1474,353,154,152,2,47,2,0,0,empty,CD-0722-2
"F11,B5",4233,2539,1590,949,1831,1007,0,1019,703,316,2.224683544,634,981,169,76,70,6,31,2,0.057142857,0,empty,CD-0722-2
"F11,B6",5018,5901,3579,2322,3570,2108,0,2115,1333,782,1.704603581,1268,1549,434,170,166,4,44,2,0.126506024,0,empty,CD-0722-2
"F11,B7",4588,5110,3517,1593,3125,1666,0,1670,1111,559,1.987477639,931,1234,216,76,74,2,24,1,0.121621622,0,empty,CD-0722-2
"F11,B8",406869,469371,301836,167535,271217,147956,1,148091,125639,22452,5.595893462,85547,98535,15851,6382,6266,116,1107,5,0.083945101,0,hg38,CD-0722-2
"F11,B9",526901,620270,386695,233575,357036,201142,0,201311,163772,37539,4.362716109,119925,70829,8651,3435,3373,62,706,3,0.047139045,0,hg38,CD-0722-2
"F11,B10",3150,3521,2186,1335,2188,1160,0,1162,742,420,1.766666667,732,591,87,35,35,0,21,0,0,0,empty,CD-0722-2
"F11,B11",668720,784636,493535,291101,444606,250946,2,251165,199008,52157,3.815556876,147834,9491,1326,516,505,11,111,2,0.099009901,0,hg38,CD-0722-2
"F11,B12",3896,4527,2786,1741,2736,1491,0,1491,968,523,1.850860421,901,1886,661,242,238,4,61,2,0.079831933,0,empty,CD-0722-2
"F11,C1",11560,12761,8879,3882,7441,3846,0,3847,2532,1315,1.925475285,2103,2617,376,170,167,3,46,2,0.125748503,0,empty,CD-0722-2
"F11,C2",686713,820158,503717,316441,468704,271560,2,271764,214509,57255,3.746554886,162422,38239,8293,3098,3059,39,663,5,0.02092187,0,hg38,CD-0722-2
"F11,C3",516491,589687,392401,197286,340672,176753,1,176931,144380,32551,4.435501213,102100,15343,2473,967,951,16,221,3,0.005257624,0,hg38,CD-0722-2
"F11,C4",4056,4749,3020,1729,2854,1537,0,1540,981,559,1.754919499,890,1670,466,210,207,3,59,2,0.125603865,0,empty,CD-0722-2
"F11,C5",598200,690832,450654,240178,395417,209949,2,210094,163839,46255,3.542081937,123084,99468,7485,3142,3024,118,706,5,0.05952381,0,hg38,CD-0722-2
"F11,C6",4919,5565,3613,1952,3352,1865,0,1869,1259,610,2.063934426,1052,1311,279,107,107,0,38,0,0.037383178,0,empty,CD-0722-2
"F11,C7",7310,8913,5083,3830,5311,3277,0,3277,1931,1346,1.4346211,1980,723,129,76,76,0,20,0,0.026315789,0,empty,CD-0722-2
"F11,C8",7922,9142,5803,3339,5409,3047,0,3049,1996,1053,1.895536562,1781,3163,731,317,316,1,118,1,0.050632911,0,empty,CD-0722-2
"F11,C9",5474,6218,3975,2243,3809,2112,0,2114,1410,704,2.002840909,1215,1582,303,141,138,3,36,1,0.101449275,0,empty,CD-0722-2
"F11,C10",576229,661821,431423,230398,378314,202817,1,203034,159938,43096,3.711202896,116620,73386,12563,4694,4605,89,919,6,0.045168295,0,hg38,CD-0722-2
"F11,C11",591450,707283,427430,279853,408440,237773,2,238000,186620,51380,3.632152589,144494,89182,12248,4906,4786,120,949,8,0.045967405,0,hg38,CD-0722-2
"F11,C12",7345,8071,5371,2700,4804,2550,1,2553,1648,905,1.820994475,1414,1621,417,170,169,1,49,1,0.00591716,0,empty,CD-0722-2
"F11,D1",6697,7651,4806,2845,4603,2686,0,2686,1693,993,1.704934542,1549,597,54,29,28,1,19,1,0.071428571,0,empty,CD-0722-2
"F11,D2",8840,9925,6617,3308,5859,3024,0,3026,2214,812,2.726600985,1667,3660,896,347,344,3,107,2,0.119186047,0,empty,CD-0722-2
"F11,D3",4869,5421,3512,1909,3288,1840,0,1844,1226,618,1.98381877,1044,1257,147,67,64,3,32,3,0.15625,0,empty,CD-0722-2
"F11,D4",3592,4004,2638,1366,2401,1298,0,1300,864,436,1.981651376,695,1107,351,133,130,3,41,1,0.046153846,0,empty,CD-0722-2
"F11,D5",4197,4974,3055,1919,2921,1626,0,1628,1034,594,1.740740741,979,1308,195,96,96,0,36,0,0.125,0,empty,CD-0722-2
"F11,D6",419014,525413,280287,245126,308156,214047,2,214169,152012,62157,2.445613527,133977,4474,468,200,197,3,79,2,0.025380711,0,hg38,CD-0722-2
"F11,D7",522856,635622,375936,259686,365612,221851,0,222015,172350,49665,3.47025068,134771,125047,20861,7882,7709,173,1396,5,0.040472175,0,hg38,CD-0722-2
"F11,D8",4548,5151,3251,1900,3096,1724,0,1726,1126,600,1.876666667,1030,1353,358,124,124,0,48,0,0.016129032,0,empty,CD-0722-2
"F11,D9",2830,3242,2094,1148,1927,1002,0,1002,676,326,2.073619632,585,1203,248,102,101,1,34,1,0.01980198,0,empty,CD-0722-2
"F11,D10",4644,5506,3306,2200,3388,1976,0,1976,1241,735,1.688435374,1208,980,190,83,82,1,31,1,0.024390244,0,empty,CD-0722-2
"F11,D11",1035467,1282322,744959,537363,738593,477787,1,478084,348492,129592,2.689147478,287628,49119,10759,3729,3690,39,856,2,0.050677507,0,hg38,CD-0722-2
"F11,D12",6370,7214,4615,2599,4346,2404,0,2415,1568,847,1.851239669,1418,3283,658,319,317,2,105,1,0.047318612,0,empty,CD-0722-2
"F11,E1",7803,8542,5652,2890,5018,2734,0,2735,1685,1050,1.604761905,1483,2657,488,181,180,1,69,1,0.022222222,0,empty,CD-0722-2
"F11,E2",537549,618716,402210,216506,359529,193586,0,193738,144139,49599,2.906086816,113377,31871,3098,1170,1133,37,351,2,0.028243601,0,hg38,CD-0722-2
"F11,E3",3647,4043,2668,1375,2470,1286,0,1290,859,431,1.993039443,738,1842,363,158,156,2,56,2,0.057692308,0,empty,CD-0722-2
"F11,E4",576114,696024,417651,278373,400600,236431,1,236592,183120,53472,3.42459605,143725,140119,18929,7573,7397,176,1293,6,0.052048128,0,hg38,CD-0722-2
"F11,E5",4271,4751,3144,1607,2903,1538,0,1541,1008,533,1.891181989,854,1149,236,99,98,1,35,1,0.030612245,0,empty,CD-0722-2
"F11,E6",8199,9257,5958,3299,5579,3102,0,3103,1958,1145,1.710043668,1774,2885,810,310,298,12,93,2,0.060402685,0,empty,CD-0722-2
"F11,E7",7298,8288,5332,2956,4985,2673,0,2675,1763,912,1.933114035,1544,2015,407,167,167,0,69,0,0.083832335,0,empty,CD-0722-2
"F11,E8",504505,634853,345711,289142,372488,255050,0,255220,160393,94827,1.691427547,158065,3119,784,275,273,2,84,2,0.054945055,0,hg38,CD-0722-2
"F11,E9",4094,4629,3013,1616,2794,1558,0,1559,1028,531,1.935969868,878,1995,311,154,151,3,59,2,0.052980132,0,empty,CD-0722-2
"F11,E10",4266,4717,3181,1536,2826,1499,0,1507,991,516,1.920542636,824,1221,241,103,103,0,34,0,0,0,empty,CD-0722-2
"F11,E11",609171,727238,445384,281854,421870,247188,0,247364,193268,54096,3.572685596,147134,119473,20550,7690,7535,155,1322,7,0.064631719,0,hg38,CD-0722-2
"F11,E12",5762,6817,4218,2599,4108,2306,0,2309,1474,835,1.765269461,1389,1767,320,161,158,3,56,2,0.107594937,0,empty,CD-0722-2
"F11,F1",6670,7439,4874,2565,4414,2387,0,2387,1457,930,1.566666667,1339,2138,426,179,178,1,60,1,0.056179775,0,empty,CD-0722-2
"F11,F2",5608,6135,4081,2054,3725,1984,0,1991,1313,678,1.936578171,1128,2797,609,277,277,0,80,0,0.064981949,0,empty,CD-0722-2
"F11,F3",4864,5484,3552,1932,3243,1743,0,1743,1119,624,1.793269231,994,2226,633,281,280,1,79,1,0.103571429,0,empty,CD-0722-2
"F11,F4",1519589,1745721,1126567,619154,991622,556360,11,556851,455845,101006,4.51304873,323308,80462,11842,4676,4569,107,843,4,0.048588313,0,hg38,CD-0722-2
"F11,F5",5659,6374,4215,2159,3749,2001,0,2003,1305,698,1.869627507,1110,1929,421,183,182,1,68,1,0.098901099,0,empty,CD-0722-2
"F11,F6",5790,6515,4140,2375,3950,2195,0,2199,1363,836,1.630382775,1277,2893,682,309,303,6,71,2,0.085808581,0,empty,CD-0722-2
"F11,F7",6434,7205,4831,2374,4277,2284,0,2287,1456,831,1.752105897,1237,777,185,89,89,0,32,0,0.033707865,0,empty,CD-0722-2
"F11,F8",4916,5763,3632,2131,3463,1911,1,1919,1254,665,1.885714286,1129,333,51,36,35,1,21,1,0.114285714,0,empty,CD-0722-2
"F11,F9",5618,6209,4182,2027,3657,1909,0,1910,1292,618,2.090614887,1041,2901,641,227,222,5,72,2,0.13963964,0,empty,CD-0722-2
"F11,F10",634599,732107,474003,258104,418955,227960,1,228148,176399,51749,3.408742198,131167,89384,16109,5961,5844,117,1092,4,0.060574949,0,hg38,CD-0722-2
"F11,F11",5419,5969,4077,1892,3629,1901,0,1903,1246,657,1.896499239,1050,1303,281,127,125,2,43,1,0.168,0,empty,CD-0722-2
"F11,F12",592811,701515,432804,268711,400318,227828,1,227984,178027,49957,3.5636047,136815,7493,773,347,340,7,107,3,0.038235294,0,hg38,CD-0722-2
"F11,G1",5887,6576,4357,2219,3998,2091,0,2099,1304,795,1.640251572,1184,2389,583,208,201,7,82,2,0.054726368,0,empty,CD-0722-2
"F11,G2",545012,632581,383861,248720,367818,209981,2,210136,162329,47807,3.395506934,127182,21026,4768,1736,1716,20,365,2,0.071678322,0,hg38,CD-0722-2
"F11,G3",632160,755056,460614,294442,434086,251561,0,251776,191096,60680,3.149241925,151714,130741,22876,8351,8192,159,1409,4,0.038330078,0,hg38,CD-0722-2
"F11,G4",12541,14765,8862,5903,8895,5452,0,5462,3264,2198,1.484986351,3290,171,17,12,11,1,9,1,0,0,empty,CD-0722-2
"F11,G5",4204,4896,2986,1910,2954,1664,0,1664,1071,593,1.806070826,1006,1899,427,206,204,2,65,2,0.019607843,0,empty,CD-0722-2
"F11,G6",6069,6843,4469,2374,4083,2237,0,2237,1483,754,1.966843501,1278,166,42,24,24,0,12,0,0.25,0,empty,CD-0722-2
"F11,G7",4735,5252,3578,1674,3159,1625,0,1625,1072,553,1.938517179,894,2355,583,190,189,1,56,1,0.005291005,0,empty,CD-0722-2
"F11,G8",3852,4371,2761,1610,2562,1388,0,1393,909,484,1.878099174,780,1452,282,129,128,1,49,1,0.0078125,0,empty,CD-0722-2
"F11,G9",4437,5110,3223,1887,2951,1598,0,1602,1048,554,1.891696751,921,2145,611,236,235,1,77,1,0.165957447,0,empty,CD-0722-2
"F11,G10",5182,5958,3829,2129,3540,1951,0,1954,1266,688,1.840116279,1120,2352,682,298,293,5,85,2,0.098976109,0,empty,CD-0722-2
"F11,G11",5250,6087,3842,2245,3601,1982,0,1986,1271,715,1.777622378,1186,1348,277,92,92,0,40,0,0.086956522,0,empty,CD-0722-2
"F11,G12",4404,5001,3155,1846,2922,1664,0,1668,1063,605,1.757024793,941,2101,540,239,239,0,73,0,0.133891213,0,empty,CD-0722-2
"F11,H1",4855,5456,3536,1920,3354,1850,0,1851,1185,666,1.779279279,1063,1336,308,122,122,0,36,0,0.147540984,0,empty,CD-0722-2
"F11,H2",6102,6953,4386,2567,4311,2495,0,2495,1619,876,1.848173516,1417,1989,412,203,203,0,64,0,0.088669951,0,empty,CD-0722-2
"F11,H3",4323,4807,3140,1667,2880,1534,0,1536,973,563,1.728241563,846,1552,229,107,107,0,37,0,0.158878505,0,empty,CD-0722-2
"F11,H4",779373,925700,570425,355275,521796,304766,1,305026,236149,68877,3.428561058,180767,4887,770,289,286,3,79,1,0,0,hg38,CD-0722-2
"F11,H5",6737,7746,4852,2894,4622,2605,1,2614,1652,962,1.717255717,1546,2208,692,240,239,1,71,1,0.062761506,0,empty,CD-0722-2
"F11,H6",4328,5031,3093,1938,2974,1755,0,1755,1131,624,1.8125,1034,1710,533,234,226,8,64,2,0.185840708,0,empty,CD-0722-2
"F11,H7",5060,5499,3681,1818,3308,1711,0,1712,1228,484,2.537190083,925,2042,529,206,205,1,70,1,0.156097561,0,empty,CD-0722-2
"F11,H8",5430,6296,3815,2481,3771,2116,0,2116,1370,746,1.836461126,1282,1968,383,220,218,2,77,2,0.036697248,0,empty,CD-0722-2
"F11,H9",5267,6090,3852,2238,3568,1936,0,1938,1308,630,2.076190476,1119,1320,246,119,118,1,39,1,0.110169492,0,empty,CD-0722-2
"F11,H10",4268,4838,3227,1611,2803,1509,0,1511,1034,477,2.167714885,821,1843,297,113,102,11,49,3,0.019607843,0,empty,CD-0722-2
"F11,H11",5749,6857,3833,3024,4200,2773,0,2775,1523,1252,1.216453674,1708,55,3,2,2,0,2,0,0,0,empty,CD-0722-2
"F11,H12",4544,5289,3218,2071,3162,1820,0,1821,1198,623,1.922953451,1104,1744,339,109,103,6,42,2,0.155339806,0,empty,CD-0722-2
"F12,A1",629312,765065,454557,310508,443366,264297,1,264487,218637,45850,4.768527808,161558,143334,21554,7983,7802,181,1319,8,0.070751089,0,hg38,CD-0722-2
"F12,A2",614524,705383,465486,239897,400952,210987,1,211179,166242,44937,3.699445891,121072,104197,18399,7377,7237,140,1161,6,0.027773939,0,hg38,CD-0722-2
"F12,A3",4113,4609,2995,1614,2776,1507,0,1508,1003,505,1.986138614,854,1281,336,125,123,2,37,2,0.073170732,0,empty,CD-0722-2
"F12,A4",6439,7430,4694,2736,4469,2484,0,2488,1518,970,1.564948454,1441,1214,332,121,118,3,36,1,0.008474576,0,empty,CD-0722-2
"F12,A5",5845,6340,4324,2016,3790,1968,0,1968,1247,721,1.729542302,1048,2532,666,272,271,1,70,1,0.151291513,0,empty,CD-0722-2
"F12,A6",621014,758433,453439,304994,431719,256306,2,256507,212568,43939,4.837797856,154656,132032,27739,10661,10530,131,1654,5,0.046533713,0,hg38,CD-0722-2
"F12,A7",4423,5129,3179,1950,3070,1749,0,1755,1143,612,1.867647059,1055,1787,346,143,141,2,43,2,0.021276596,0,empty,CD-0722-2
"F12,A8",2857,3173,2188,985,1870,1007,0,1007,656,351,1.868945869,542,1810,420,169,168,1,42,1,0.077380952,0,empty,CD-0722-2
"F12,A9",5287,6056,3953,2103,3658,2012,0,2016,1322,694,1.904899135,1129,2068,545,212,210,2,53,1,0.047619048,0,empty,CD-0722-2
"F12,A10",6654,7400,4983,2417,4357,2277,0,2277,1403,874,1.605263158,1213,586,123,46,45,1,14,1,0,0,empty,CD-0722-2
"F12,A11",4228,4609,3142,1467,2811,1476,0,1477,956,521,1.834932821,825,1889,490,183,182,1,43,1,0.065934066,0,empty,CD-0722-2
"F12,A12",6462,7254,4814,2440,4284,2293,0,2296,1543,753,2.049136786,1319,3948,1032,356,355,1,83,1,0.16056338,0,empty,CD-0722-2
"F12,B1",5013,5618,3673,1945,3378,1861,0,1863,1201,662,1.814199396,1069,1337,329,155,152,3,32,2,0.039473684,0,empty,CD-0722-2
"F12,B2",5031,5828,3448,2380,3400,2040,1,2042,1305,737,1.770691995,1212,597,114,51,48,3,14,1,0.0625,0,empty,CD-0722-2
"F12,B3",5737,6571,4190,2381,3971,2176,0,2176,1422,754,1.885941645,1281,1412,348,163,160,3,53,2,0.05625,0,empty,CD-0722-2
"F12,B4",589726,687550,445229,242321,394261,210719,0,210927,167960,42967,3.909046478,123569,15759,3907,1318,1299,19,331,2,0.036951501,0,hg38,CD-0722-2
"F12,B5",378875,216786,118815,97971,156135,102118,4,102710,63903,38807,1.646687453,65987,1602,467,103,102,1,34,1,0.039215686,0,hg38,CD-0722-2
"F12,B6",5990,6897,4222,2675,4117,2437,0,2442,1533,909,1.686468647,1454,2250,818,242,241,1,54,1,0.045643154,0,empty,CD-0722-2
"F12,B7",5050,5685,3712,1973,3352,1822,0,1822,1207,615,1.962601626,1051,1167,224,81,80,1,32,1,0.025,0,empty,CD-0722-2
"F12,B8",4300,5043,3166,1877,2990,1661,0,1661,1132,529,2.139886578,968,1155,394,134,134,0,39,0,0.111940299,0,empty,CD-0722-2
"F12,B9",7527,8569,5353,3216,5232,3058,0,3058,1976,1082,1.826247689,1806,1291,385,157,151,6,51,2,0.046357616,0,empty,CD-0722-2
"F12,B10",3295,3928,2330,1598,2369,1317,0,1317,867,450,1.926666667,795,413,100,51,51,0,12,0,0.156862745,0,empty,CD-0722-2
"F12,B11",9051,10798,6306,4492,6396,3898,0,3899,2094,1805,1.160110803,2406,258,40,17,15,2,6,2,0,0,empty,CD-0722-2
"F12,B12",697847,861827,492730,369097,500509,326564,1,326779,221698,105081,2.109781978,200140,36273,1784,704,659,45,155,3,0.318664643,0,hg38,CD-0722-2
"F12,C1",8165,9173,6135,3038,5386,2887,0,2887,1821,1066,1.708255159,1594,1235,277,108,108,0,30,0,0.185185185,0,empty,CD-0722-2
"F12,C2",7203,8228,5122,3106,4872,2787,0,2787,1817,970,1.873195876,1638,2088,576,241,241,0,66,0,0.107883817,0,empty,CD-0722-2
"F12,C3",7199,8121,5368,2753,4798,2608,0,2610,1670,940,1.776595745,1429,947,203,78,77,1,28,1,0,0,empty,CD-0722-2
"F12,C4",4952,5604,3671,1933,3300,1709,0,1710,1128,582,1.93814433,969,2255,603,217,215,2,52,1,0.051162791,0,empty,CD-0722-2
"F12,C5",714981,838213,536036,302177,478102,259803,2,260012,205495,54517,3.76937469,151750,158309,26419,10646,10445,201,1538,6,0.065581618,0,hg38,CD-0722-2
"F12,C6",5767,6602,4054,2548,3960,2228,0,2229,1465,764,1.917539267,1340,1291,224,98,97,1,40,1,0,0,empty,CD-0722-2
"F12,C7",8525,10296,5937,4359,6132,3887,0,3889,2267,1622,1.397657213,2408,520,146,33,33,0,12,0,0,0,empty,CD-0722-2
"F12,C8",8992,10055,6614,3441,5885,3200,0,3208,2117,1091,1.940421632,1777,2942,739,271,269,2,96,2,0.078066914,0,empty,CD-0722-2
"F12,C9",6621,7732,4902,2830,4591,2551,0,2551,1692,859,1.969732247,1490,2104,496,179,177,2,42,2,0.062146893,0,empty,CD-0722-2
"F12,C10",7151,8102,5367,2735,4719,2556,0,2562,1623,939,1.728434505,1426,2288,518,193,191,2,49,2,0.136125654,0,empty,CD-0722-2
"F12,C11",5693,6570,4117,2453,3891,2174,0,2179,1447,732,1.976775956,1267,2233,623,207,206,1,61,1,0.033980583,0,empty,CD-0722-2
"F12,C12",8466,9445,6115,3330,5617,3015,0,3021,2007,1014,1.979289941,1758,2188,540,211,210,1,60,1,0.176190476,0,empty,CD-0722-2
"F12,D1",7618,8740,5509,3231,5209,3043,0,3043,1796,1247,1.440256616,1728,733,229,70,66,4,26,2,0.045454545,0,empty,CD-0722-2
"F12,D2",5764,6371,4326,2045,3772,2010,0,2012,1248,764,1.633507853,1078,3196,742,288,276,12,87,2,0.02173913,0,empty,CD-0722-2
"F12,D3",5596,6500,3946,2554,3784,2174,0,2174,1461,713,2.049088359,1322,1318,254,103,96,7,33,2,0.072916667,0,empty,CD-0722-2
"F12,D4",566195,673764,418172,255592,386729,217283,0,217445,168254,49191,3.420422435,130556,117496,10318,4043,3889,154,749,4,0.104911288,0,hg38,CD-0722-2
"F12,D5",5016,5598,3640,1958,3334,1837,0,1839,1165,674,1.728486647,1071,1722,492,196,196,0,55,0,0.147959184,0,empty,CD-0722-2
"F12,D6",7851,9155,5429,3726,5315,3167,1,3178,1937,1241,1.560838034,1894,2422,659,276,269,7,68,1,0.044609665,0,empty,CD-0722-2
"F12,D7",4341,5023,3191,1832,2992,1574,0,1579,993,586,1.694539249,921,2064,472,142,141,1,52,1,0.042553191,0,empty,CD-0722-2
"F12,D8",644140,763296,477306,285990,435922,242390,2,242597,182745,59852,3.053281428,145786,85580,12455,4720,4626,94,838,4,0.043666234,0,hg38,CD-0722-2
"F12,D9",2625,2800,1937,863,1729,934,0,936,619,317,1.952681388,507,1744,407,139,138,1,37,1,0.072463768,0,empty,CD-0722-2
"F12,D10",4796,5518,3400,2118,3336,1928,0,1930,1230,700,1.757142857,1138,1006,263,104,103,1,32,1,0.019417476,0,empty,CD-0722-2
"F12,D11",5622,6516,4206,2310,3834,2050,0,2054,1295,759,1.706192358,1151,2697,845,257,253,4,70,2,0.055335968,0,empty,CD-0722-2
"F12,D12",6923,7749,5117,2632,4627,2528,0,2528,1700,828,2.053140097,1428,3668,938,331,329,2,118,1,0.006079027,0,empty,CD-0722-2
"F12,E1",8759,10089,6292,3797,6029,3453,0,3460,2171,1289,1.684251358,2004,2915,673,302,298,4,61,2,0.077181208,0,empty,CD-0722-2
"F12,E2",5951,6911,4301,2610,4072,2242,0,2242,1433,809,1.771322621,1352,2203,481,187,185,2,50,1,0.091891892,0,empty,CD-0722-2
"F12,E3",463810,539449,350415,189034,312121,169264,0,169400,133496,35904,3.718137255,98344,85198,18050,6809,6711,98,1174,7,0.018179109,0,hg38,CD-0722-2
"F12,E4",708219,858021,518456,339565,488723,282459,1,282646,216268,66378,3.258127693,171411,159271,26001,10043,9890,153,1597,5,0.037209302,0,hg38,CD-0722-2
"F12,E5",4883,5415,3714,1701,3313,1687,0,1689,1123,566,1.98409894,949,1307,261,136,133,3,35,2,0.022556391,0,empty,CD-0722-2
"F12,E6",9677,11051,7108,3943,6525,3694,0,3694,2386,1308,1.824159021,2086,3884,891,342,332,10,98,3,0.048192771,0,empty,CD-0722-2
"F12,E7",8974,10153,6664,3489,6041,3211,0,3213,2126,1087,1.955841766,1819,3110,741,294,288,6,84,2,0.079861111,0,empty,CD-0722-2
"F12,E8",6317,7174,4775,2399,4275,2224,0,2230,1466,764,1.918848168,1286,2638,536,227,226,1,68,1,0.013274336,0,empty,CD-0722-2
"F12,E9",4642,5536,3456,2080,3330,1879,0,1880,1220,660,1.848484848,1109,2678,699,248,244,4,72,2,0.06147541,0,empty,CD-0722-2
"F12,E10",4663,5251,3442,1809,3097,1653,0,1654,1042,612,1.702614379,956,1833,360,129,128,1,38,1,0.109375,0,empty,CD-0722-2
"F12,E11",5721,6342,4223,2119,3808,2054,0,2058,1323,735,1.8,1152,1991,428,149,146,3,48,2,0.02739726,0,empty,CD-0722-2
"F12,E12",6784,8077,4809,3268,4761,2735,0,2741,1767,974,1.814168378,1692,1932,424,149,148,1,60,1,0.067567568,0,empty,CD-0722-2
"F12,F1",7376,8267,5378,2889,4893,2632,0,2632,1656,976,1.696721311,1527,2867,756,291,286,5,86,1,0.104895105,0,empty,CD-0722-2
"F12,F2",5835,6323,4255,2068,3810,1989,0,1992,1275,717,1.778242678,1104,3104,756,303,301,2,72,1,0.162790698,0,empty,CD-0722-2
"F12,F3",648297,723296,498184,225112,412898,203969,0,204133,156148,47985,3.25410024,114946,182478,18164,7334,7109,225,1269,6,0.070192713,0,hg38,CD-0722-2
"F12,F4",7989,8597,5868,2729,5248,2793,0,2794,1886,908,2.077092511,1531,787,206,64,62,2,28,1,0.112903226,0,empty,CD-0722-2
"F12,F5",6508,7184,4859,2325,4339,2283,0,2289,1458,831,1.754512635,1299,2193,510,178,177,1,60,1,0.101694915,0,empty,CD-0722-2
"F12,F6",6924,7917,5017,2900,4721,2723,0,2726,1686,1040,1.621153846,1604,3048,614,270,263,7,72,1,0.190114068,0,empty,CD-0722-2
"F12,F7",7251,8313,5342,2971,4994,2749,0,2749,1846,903,2.044296788,1600,1211,177,81,80,1,31,1,0.075,0,empty,CD-0722-2
"F12,F8",1041538,1224764,792991,431773,689980,373180,1,373502,310292,63210,4.908906819,216621,36072,6033,2299,2260,39,475,2,0.069469027,0,hg38,CD-0722-2
"F12,F9",6174,6982,4694,2288,4172,2151,0,2153,1418,735,1.929251701,1165,3049,657,269,264,5,93,2,0.045454545,0,empty,CD-0722-2
"F12,F10",7013,7710,5301,2409,4674,2423,0,2425,1571,854,1.839578454,1340,2668,890,297,294,3,68,2,0.081632653,0,empty,CD-0722-2
"F12,F11",6528,7177,4876,2301,4145,2117,0,2121,1428,693,2.060606061,1123,1736,211,99,96,3,36,2,0.104166667,0,empty,CD-0722-2
"F12,F12",6401,7485,4647,2838,4373,2415,0,2422,1606,816,1.968137255,1489,193,13,8,8,0,7,0,0,0,empty,CD-0722-2
"F12,G1",6610,7226,4839,2387,4379,2284,0,2286,1522,764,1.992146597,1292,3276,760,329,325,4,89,2,0.076923077,0,empty,CD-0722-2
"F12,G2",4344,4961,2932,2029,2960,1777,0,1777,1191,586,2.032423208,1084,731,140,62,61,1,33,1,0.016393443,0,empty,CD-0722-2
"F12,G3",7884,8455,5719,2736,5064,2811,0,2812,1638,1174,1.395229983,1484,2561,644,264,264,0,81,0,0.053030303,0,empty,CD-0722-2
"F12,G4",1124301,1351137,827373,523764,765941,460105,1,460487,374714,85773,4.368670794,271830,1052,373,157,157,0,39,0,0.012738854,0,hg38,CD-0722-2
"F12,G5",4465,4899,3172,1727,3014,1669,0,1673,1109,564,1.966312057,958,2009,565,190,185,5,52,2,0.064864865,0,empty,CD-0722-2
"F12,G6",6514,7576,4773,2803,4425,2446,0,2446,1598,848,1.884433962,1404,274,45,13,13,0,4,0,0,0,empty,CD-0722-2
"F12,G7",5545,6157,4180,1977,3704,1889,0,1891,1210,681,1.776798825,1082,3374,1043,380,375,5,80,2,0.104,0,empty,CD-0722-2
"F12,G8",4007,4398,2878,1520,2689,1460,0,1460,933,527,1.770398482,826,1779,605,226,224,2,60,1,0.09375,0,empty,CD-0722-2
"F12,G9",4807,5296,3580,1716,3206,1750,0,1750,1177,573,2.054101222,973,2577,774,244,242,2,71,2,0.033057851,0,empty,CD-0722-2
"F12,G10",6171,7128,4485,2643,4248,2420,0,2422,1543,879,1.755403868,1439,2328,709,284,284,0,83,0,0.088028169,0,empty,CD-0722-2
"F12,G11",5784,6693,4292,2401,3780,2000,0,2000,1317,683,1.928257687,1141,1634,531,215,212,3,52,1,0.141509434,0,empty,CD-0722-2
"F12,G12",5097,6001,3687,2314,3637,2113,0,2115,1394,721,1.933425798,1245,2537,609,252,251,1,80,1,0.099601594,0,empty,CD-0722-2
"F12,H1",5876,6700,4385,2315,3969,2119,0,2125,1462,663,2.205128205,1211,1379,374,176,174,2,49,2,0.16091954,0,empty,CD-0722-2
"F12,H2",5725,6575,4112,2463,3804,2080,0,2082,1373,709,1.936530324,1210,2572,657,261,258,3,67,2,0.062015504,0,empty,CD-0722-2
"F12,H3",5146,6030,3808,2222,3665,2053,0,2053,1308,745,1.755704698,1227,1981,528,210,210,0,58,0,0.123809524,0,empty,CD-0722-2
"F12,H4",6965,7722,5132,2590,4551,2452,0,2455,1585,870,1.82183908,1381,209,39,28,28,0,17,0,0.035714286,0,empty,CD-0722-2
"F12,H5",7896,9045,5699,3346,5292,2913,0,2913,1956,957,2.043887147,1716,2830,815,294,289,5,67,2,0.083044983,0,empty,CD-0722-2
"F12,H6",523542,650526,356011,294515,379688,259695,1,259863,161105,98758,1.631310881,160181,3633,1437,459,457,2,91,2,0.29321663,0,hg38,CD-0722-2
"F12,H7",5806,6590,4361,2229,3977,2099,0,2101,1367,734,1.86239782,1203,2328,498,221,212,9,71,2,0.004716981,0,empty,CD-0722-2
"F12,H8",6377,7260,4573,2687,4214,2348,0,2352,1561,791,1.973451327,1388,2205,513,195,190,5,59,2,0.163157895,0,empty,CD-0722-2
"F12,H9",4894,5531,3622,1909,3245,1688,0,1690,1152,538,2.141263941,938,1299,301,135,131,4,39,1,0.053435115,0,empty,CD-0722-2
"F12,H10",5530,6384,4132,2252,3695,2008,0,2010,1362,648,2.101851852,1158,1597,350,125,122,3,36,1,0.040983607,0,empty,CD-0722-2
"F12,H11",6590,7804,4492,3312,4712,3102,0,3102,1607,1495,1.074916388,1872,51,15,9,9,0,6,0,0,0,empty,CD-0722-2
"F12,H12",4962,5506,3509,1997,3371,1916,0,1918,1242,676,1.837278107,1122,1748,476,158,158,0,45,0,0.107594937,0,empty,CD-0722-2
"G1,A1",3906,4446,2786,1660,2678,1519,0,1526,975,551,1.769509982,882,1306,213,87,84,3,34,2,0.083333333,0,empty,CD-0722-2
"G1,A2",6165,7140,4495,2645,4264,2449,0,2450,1436,1014,1.41617357,1423,1598,396,212,207,5,67,1,0.086956522,0,empty,CD-0722-2
"G1,A3",3744,4295,2716,1579,2582,1402,0,1402,888,514,1.727626459,805,1532,313,137,135,2,50,1,0.022222222,0,empty,CD-0722-2
"G1,A4",5829,6537,4206,2331,3934,2186,0,2186,1371,815,1.682208589,1243,720,176,79,78,1,25,1,0.012820513,0,empty,CD-0722-2
"G1,A5",4976,5682,3643,2039,3547,1928,0,1930,1194,736,1.622282609,1147,1767,359,129,129,0,50,0,0.023255814,0,empty,CD-0722-2
"G1,A6",482813,594230,352273,241957,342539,201900,2,202035,171046,30989,5.519571461,122603,151489,31349,12364,12211,153,1862,5,0.055687495,0,hg38,CD-0722-2
"G1,A7",4327,5151,3138,2013,3038,1795,0,1797,1137,660,1.722727273,1057,1466,240,92,89,3,43,1,0.056179775,0,empty,CD-0722-2
"G1,A8",2536,2996,1876,1120,1793,1007,0,1007,623,384,1.622395833,575,1842,488,172,169,3,58,2,0.071005917,0,empty,CD-0722-2
"G1,A9",4338,4906,3253,1653,2887,1522,0,1522,1054,468,2.252136752,848,1653,390,165,163,2,52,1,0.024539877,0,empty,CD-0722-2
"G1,A10",694554,821580,515830,305750,474373,265512,1,265712,205947,59765,3.445946624,157367,59143,6856,2710,2616,94,605,4,0.053899083,0,hg38,CD-0722-2
"G1,A11",3663,4145,2765,1380,2541,1327,0,1327,903,424,2.129716981,739,1736,327,155,153,2,54,1,0.039215686,0,empty,CD-0722-2
"G1,A12",5394,6113,3972,2141,3585,1920,0,1923,1226,697,1.758967001,1116,2463,446,219,215,4,78,2,0.03255814,0,empty,CD-0722-2
"G1,B1",2546465,2966240,1899485,1066755,1633520,935512,5,936327,750000,186327,4.025181536,543526,404676,61891,23656,23214,442,3253,10,0.049582149,0,hg38,CD-0722-2
"G1,B2",4345,4768,2965,1803,2950,1722,0,1722,1076,646,1.665634675,1007,712,119,62,61,1,24,1,0.147540984,0,empty,CD-0722-2
"G1,B3",4052,4431,2984,1447,2745,1494,0,1494,1032,462,2.233766234,798,1579,284,148,147,1,63,1,0.088435374,0,empty,CD-0722-2
"G1,B4",4722,5579,3378,2201,3403,2022,0,2022,1282,740,1.732432432,1220,1084,209,78,76,2,29,2,0.131578947,0,empty,CD-0722-2
"G1,B5",5270,3836,2347,1489,2651,1480,0,1484,1063,421,2.524940618,922,902,270,124,123,1,36,1,0.105691057,0,empty,CD-0722-2
"G1,B6",322876,360741,249893,110848,211579,104304,0,104388,80297,24091,3.333070441,57886,6274,848,325,319,6,90,2,0.034482759,0,hg38,CD-0722-2
"G1,B7",4437,5073,3224,1849,3073,1698,0,1700,1090,610,1.786885246,983,1193,278,137,136,1,46,1,0.066176471,0,empty,CD-0722-2
"G1,B8",3540,3984,2629,1355,2387,1313,0,1313,905,408,2.218137255,719,1163,224,109,104,5,53,2,0.163461538,0,empty,CD-0722-2
"G1,B9",537292,604134,411618,192516,348332,179026,1,179217,140471,38746,3.625432303,100778,18770,2598,926,901,25,258,3,0.025527192,0,hg38,CD-0722-2
"G1,B10",2867,3187,2018,1169,2033,1139,0,1139,736,403,1.82630273,700,569,118,30,30,0,11,0,0.366666667,0,empty,CD-0722-2
"G1,B11",7691,9114,5468,3646,5453,3337,0,3341,1859,1482,1.254385965,2026,300,51,26,26,0,18,0,0,0,empty,CD-0722-2
"G1,B12",4018,4573,2831,1742,2769,1557,0,1557,1047,510,2.052941176,926,1344,291,141,138,3,46,2,0.072463768,0,empty,CD-0722-2
"G1,C1",7568,8199,5672,2527,4901,2568,0,2568,1602,966,1.658385093,1384,803,250,106,106,0,26,0,0.018867925,0,empty,CD-0722-2
"G1,C2",6036,6995,4351,2644,4125,2344,0,2347,1515,832,1.820913462,1385,2284,464,179,176,3,67,2,0.034090909,0,empty,CD-0722-2
"G1,C3",6204,7042,4648,2394,4338,2395,0,2395,1559,836,1.864832536,1374,873,189,91,90,1,35,1,0.088888889,0,empty,CD-0722-2
"G1,C4",4063,4441,2965,1476,2765,1443,0,1443,947,496,1.909274194,804,1438,405,182,182,0,49,0,0.137362637,0,empty,CD-0722-2
"G1,C5",568124,648516,431068,217448,373898,194874,1,195087,148624,46463,3.198760304,111961,113406,11943,5011,4896,115,958,5,0.049632353,0,hg38,CD-0722-2
"G1,C6",565368,662081,417359,244722,387822,215597,1,215789,167948,47841,3.510545348,128326,88621,16075,6413,6333,80,1085,4,0.03315964,0,hg38,CD-0722-2
"G1,C7",7272,8780,5099,3681,5282,3319,0,3323,1966,1357,1.448784083,2048,608,161,92,91,1,31,1,0.076923077,0,empty,CD-0722-2
"G1,C8",471803,534061,358649,175412,309438,159296,1,159428,120254,39174,3.069740134,91221,39261,6662,2499,2432,67,584,3,0.042763158,0,hg38,CD-0722-2
"G1,C9",5603,6377,4142,2235,3839,2145,0,2145,1392,753,1.848605578,1223,1654,355,133,130,3,45,2,0.030769231,0,empty,CD-0722-2
"G1,C10",6036,6859,4445,2414,4071,2192,0,2192,1383,809,1.709517923,1259,2206,562,227,225,2,48,1,0.177777778,0,empty,CD-0722-2
"G1,C11",4759,5371,3390,1981,3325,1800,0,1803,1111,692,1.605491329,1060,1759,389,164,162,2,51,1,0.024691358,0,empty,CD-0722-2
"G1,C12",7280,8204,5355,2849,4906,2680,0,2683,1741,942,1.848195329,1525,1759,427,173,169,4,59,2,0.047337278,0,empty,CD-0722-2
"G1,D1",7186,8582,5159,3423,5090,3004,0,3005,1825,1180,1.546610169,1798,710,128,61,61,0,27,0,0.114754098,0,empty,CD-0722-2
"G1,D2",4862,5416,3655,1761,3281,1683,0,1683,1060,623,1.701444623,946,3168,909,360,354,6,101,2,0.087570621,0,empty,CD-0722-2
"G1,D3",1432530,1683622,1077947,605675,959271,534856,3,535323,434454,100869,4.307111204,315099,146826,20118,7937,7759,178,1452,4,0.041113546,0,hg38,CD-0722-2
"G1,D4",3940,4510,2877,1633,2761,1523,0,1523,995,528,1.884469697,904,1377,278,130,129,1,45,1,0.031007752,0,empty,CD-0722-2
"G1,D5",4157,4789,3008,1781,2876,1577,0,1577,1042,535,1.947663551,912,1839,546,225,222,3,68,2,0.027027027,0,empty,CD-0722-2
"G1,D6",6825,7833,4754,3079,4674,2788,0,2789,1651,1138,1.450790861,1651,1816,532,215,213,2,68,2,0.164319249,0,empty,CD-0722-2
"G1,D7",3674,4099,2719,1380,2480,1285,0,1286,856,430,1.990697674,706,1982,408,177,172,5,71,2,0.023255814,0,empty,CD-0722-2
"G1,D8",4485,5192,3273,1919,3099,1703,0,1705,1135,570,1.99122807,1016,1086,231,127,125,2,51,2,0.024,0,empty,CD-0722-2
"G1,D9",2321,2592,1728,864,1517,793,0,793,516,277,1.862815884,465,904,235,108,107,1,31,1,0.093457944,0,empty,CD-0722-2
"G1,D10",4854,5536,3467,2069,3336,1849,0,1852,1213,639,1.89827856,1093,899,145,46,45,1,23,1,0.066666667,0,empty,CD-0722-2
"G1,D11",4807,5458,3566,1892,3303,1779,0,1780,1174,606,1.937293729,1011,2470,778,344,337,7,105,1,0.103857567,0,empty,CD-0722-2
"G1,D12",6037,6848,4349,2499,4119,2306,1,2310,1554,756,2.055555556,1350,3643,807,329,328,1,118,1,0.042682927,0,empty,CD-0722-2
"G1,E1",7637,8571,5592,2979,5123,2783,0,2787,1700,1087,1.563937443,1635,2195,484,192,192,0,63,0,0.125,0,empty,CD-0722-2
"G1,E2",5224,5877,3808,2069,3595,2003,0,2008,1282,726,1.76584022,1143,1332,219,122,121,1,49,1,0.066115702,0,empty,CD-0722-2
"G1,E3",3459,4029,2586,1443,2361,1269,0,1269,853,416,2.050480769,721,2067,565,223,222,1,66,1,0.076576577,0,empty,CD-0722-2
"G1,E4",5008,5873,3622,2251,3459,1910,1,1911,1176,735,1.6,1151,2386,550,250,245,5,79,1,0.06122449,0,empty,CD-0722-2
"G1,E5",4272,4852,3215,1637,2862,1522,0,1523,967,556,1.739208633,808,1189,348,138,136,2,45,1,0.007352941,0,empty,CD-0722-2
"G1,E6",8251,9315,6013,3302,5587,3127,0,3132,2011,1121,1.793933988,1814,3300,865,390,382,8,110,2,0.060209424,0,empty,CD-0722-2
"G1,E7",12423,13944,9481,4463,8179,4188,0,4189,2948,1241,2.375503626,2361,5923,1023,438,433,5,138,1,0.036951501,0,empty,CD-0722-2
"G1,E8",5692,6259,4221,2038,3786,1916,0,1916,1228,688,1.784883721,1048,2546,459,214,208,6,72,2,0.004807692,0,empty,CD-0722-2
"G1,E9",4129,4711,3042,1669,2810,1542,0,1543,1023,520,1.967307692,880,2488,595,220,218,2,78,1,0.100917431,0,empty,CD-0722-2
"G1,E10",3963,4523,2962,1561,2807,1506,0,1507,998,509,1.960707269,885,1456,446,171,171,0,53,0,0.011695906,0,empty,CD-0722-2
"G1,E11",5116,5836,3809,2027,3575,1993,0,1993,1269,724,1.752762431,1144,1888,478,190,187,3,57,1,0.080213904,0,empty,CD-0722-2
"G1,E12",5888,6951,4254,2697,4076,2251,0,2257,1474,783,1.882503193,1325,1416,252,132,128,4,63,2,0.0390625,0,empty,CD-0722-2
"G1,F1",6565,7469,4680,2789,4474,2478,0,2481,1606,875,1.835428571,1455,2135,489,221,219,2,64,1,0.068493151,0,empty,CD-0722-2
"G1,F2",7213,8152,5453,2699,4755,2460,0,2461,1660,801,2.072409488,1356,2884,674,273,272,1,89,1,0.047794118,0,empty,CD-0722-2
"G1,F3",14206,16816,10383,6433,9576,5475,0,5478,3684,1794,2.053511706,3252,2283,481,209,207,2,83,1,0.043478261,0,empty,CD-0722-2
"G1,F4",7366,7963,5266,2697,4840,2562,3,2571,1669,902,1.850332594,1471,785,97,62,61,1,47,1,0,0,empty,CD-0722-2
"G1,F5",5422,6107,3911,2196,3693,1947,0,1953,1270,683,1.859443631,1163,2333,351,168,167,1,60,1,0.179640719,0,empty,CD-0722-2
"G1,F6",566382,661237,425623,235614,379897,203927,0,204084,160289,43795,3.659984016,119886,87977,8434,3461,3323,138,804,5,0.026482094,0,hg38,CD-0722-2
"G1,F7",6244,7202,4552,2650,4338,2462,0,2465,1609,856,1.879672897,1451,923,213,99,98,1,37,1,0.173469388,0,empty,CD-0722-2
"G1,F8",4686,5400,3467,1933,3286,1745,0,1745,1162,583,1.993138937,1024,370,91,45,43,2,26,2,0.023255814,0,empty,CD-0722-2
"G1,F9",5306,6014,3990,2024,3598,1919,0,1920,1266,654,1.935779817,1069,3054,599,221,213,8,81,2,0.004694836,0,empty,CD-0722-2
"G1,F10",631918,730599,473579,257020,419865,228288,2,228479,181024,47455,3.814645454,132450,152832,17276,6725,6527,198,1191,6,0.098973495,0,hg38,CD-0722-2
"G1,F11",5334,6108,3970,2138,3662,1946,0,1950,1241,709,1.750352609,1093,1385,253,118,115,3,41,2,0.052173913,0,empty,CD-0722-2
"G1,F12",5766,6312,4200,2112,3884,2072,0,2076,1351,725,1.863448276,1199,263,64,34,32,2,13,1,0.03125,0,empty,CD-0722-2
"G1,G1",5813,6488,4306,2182,3959,2129,0,2129,1420,709,2.002820874,1229,2519,696,258,256,2,77,1,0.05078125,0,empty,CD-0722-2
"G1,G2",3610,4125,2506,1619,2518,1455,0,1459,955,504,1.89484127,900,717,191,100,100,0,46,0,0.14,0,empty,CD-0722-2
"G1,G3",6572,7118,4770,2348,4375,2412,0,2412,1427,985,1.448730964,1341,2021,521,198,194,4,66,2,0.051546392,0,empty,CD-0722-2
"G1,G4",13341,15794,9437,6357,9365,5724,0,5728,3463,2265,1.528918322,3389,182,37,22,20,2,15,2,0.1,0,empty,CD-0722-2
"G1,G5",3979,4538,3004,1534,2768,1527,0,1528,1053,475,2.216842105,873,1872,626,213,210,3,62,2,0.033333333,0,empty,CD-0722-2
"G1,G6",546770,605992,422750,183242,348249,170515,3,170639,133427,37212,3.58559067,95455,1870,257,99,96,3,31,2,0.09375,0,empty,CD-0722-2
"G1,G7",4696,5247,3530,1717,3088,1622,0,1622,1070,552,1.938405797,912,2367,540,184,179,5,64,2,0.089385475,0,empty,CD-0722-2
"G1,G8",3623,3976,2693,1283,2374,1244,0,1246,820,426,1.924882629,668,1376,387,183,182,1,60,1,0.065934066,0,empty,CD-0722-2
"G1,G9",4090,4536,2889,1647,2837,1606,0,1608,1038,570,1.821052632,952,2063,512,191,189,2,66,2,0.111111111,0,empty,CD-0722-2
"G1,G10",5207,6052,3798,2254,3655,2059,0,2059,1336,723,1.847856155,1221,2217,537,263,261,2,82,1,0.091954023,0,empty,CD-0722-2
"G1,G11",4959,5706,3695,2011,3546,1977,0,1977,1251,726,1.723140496,1121,1466,342,162,161,1,57,1,0.049689441,0,empty,CD-0722-2
"G1,G12",4599,5270,3310,1960,3238,1801,1,1810,1116,694,1.608069164,1056,2476,526,232,227,5,99,1,0.13215859,0,empty,CD-0722-2
"G1,H1",397018,443498,304565,138933,259165,125636,0,125762,93105,32657,2.850996724,71527,61247,9518,3742,3675,67,681,5,0.058503401,0,hg38,CD-0722-2
"G1,H2",1131694,1336133,825910,510223,770125,443054,7,443433,372566,70867,5.257256551,267286,233182,38459,14859,14602,257,2159,7,0.075126695,0,hg38,CD-0722-2
"G1,H3",4712,5380,3445,1935,3175,1787,0,1788,1170,618,1.893203883,993,1579,363,134,131,3,65,2,0.083969466,0,empty,CD-0722-2
"G1,H4",6388,7281,4721,2560,4311,2367,0,2374,1503,871,1.725602755,1355,199,33,24,23,1,15,1,0,0,empty,CD-0722-2
"G1,H5",6507,7507,4743,2764,4463,2445,0,2452,1578,874,1.805491991,1445,2255,616,259,259,0,86,0,0.088803089,0,empty,CD-0722-2
"G1,H6",4132,4656,2925,1731,2796,1562,1,1563,1017,546,1.862637363,944,1652,339,154,153,1,69,1,0.019607843,0,empty,CD-0722-2
"G1,H7",907129,1033916,685788,348128,597138,321099,7,321404,260989,60415,4.319937102,181356,467093,83722,33190,32519,671,3650,12,0.16147483,0,hg38,CD-0722-2
"G1,H8",5522,6623,4024,2599,3779,2120,1,2125,1438,687,2.093158661,1213,1985,478,213,208,5,90,3,0.052884615,0,empty,CD-0722-2
"G1,H9",4954,5529,3690,1839,3391,1770,0,1770,1216,554,2.194945848,1035,1444,268,120,118,2,37,2,0.237288136,0,empty,CD-0722-2
"G1,H10",9485,11027,7140,3887,6425,3407,0,3411,2443,968,2.523760331,1997,2547,371,169,169,0,58,0,0.100591716,0,empty,CD-0722-2
"G1,H11",5885,7177,4082,3095,4329,2846,0,2847,1553,1294,1.20015456,1714,102,16,13,13,0,9,0,0,0,empty,CD-0722-2
"G1,H12",4340,5017,3124,1893,3010,1729,0,1730,1172,558,2.100358423,1008,1343,247,124,117,7,46,1,0.068376068,0,empty,CD-0722-2
"G2,A1",4155,4704,2971,1733,2760,1530,0,1530,979,551,1.77676951,858,1474,329,137,137,0,46,0,0.01459854,0,empty,CD-0722-2
"G2,A2",5866,6773,4211,2562,4062,2304,0,2304,1382,922,1.498915401,1370,2176,395,162,162,0,62,0,0.012345679,0,empty,CD-0722-2
"G2,A3",3828,4266,2848,1418,2510,1340,0,1349,856,493,1.736308316,738,1316,279,150,145,5,46,2,0.020689655,0,empty,CD-0722-2
"G2,A4",6524,7189,4751,2438,4347,2365,0,2367,1575,792,1.988636364,1328,776,175,71,69,2,30,1,0.014492754,0,empty,CD-0722-2
"G2,A5",5173,5610,3757,1853,3426,1842,0,1843,1189,654,1.818042813,1016,3197,541,220,217,3,55,2,0.004608295,0,empty,CD-0722-2
"G2,A6",9318,10448,7087,3361,6256,3244,0,3250,2282,968,2.357438017,1826,3585,710,332,326,6,107,2,0.064417178,0,empty,CD-0722-2
"G2,A7",4238,4781,3083,1698,2922,1652,0,1652,1070,582,1.838487973,950,1731,350,155,152,3,46,2,0.184210526,0,empty,CD-0722-2
"G2,A8",2378,2611,1778,833,1630,888,0,888,598,290,2.062068966,476,1944,358,162,157,5,58,2,0.038216561,0,empty,CD-0722-2
"G2,A9",4115,4620,3036,1584,2820,1516,0,1519,992,527,1.882352941,861,1839,415,144,140,4,43,3,0.128571429,0,empty,CD-0722-2
"G2,A10",5428,5834,4052,1782,3525,1821,0,1825,1161,664,1.748493976,987,362,89,43,41,2,22,2,0,0,empty,CD-0722-2
"G2,A11",3694,4214,2748,1466,2527,1332,0,1334,906,428,2.11682243,785,1733,386,173,169,4,59,2,0.100591716,0,empty,CD-0722-2
"G2,A12",5412,6130,4059,2071,3556,1890,0,1896,1234,662,1.864048338,1028,3651,1093,425,421,4,101,1,0.078384798,0,empty,CD-0722-2
"G2,B1",4445,4951,3240,1711,2945,1638,0,1638,1075,563,1.909413854,900,1056,236,97,93,4,41,2,0,0,empty,CD-0722-2
"G2,B2",4792,5388,3217,2171,3325,2024,0,2024,1264,760,1.663157895,1226,684,118,51,51,0,19,0,0.019607843,0,empty,CD-0722-2
"G2,B3",4011,4728,2947,1781,2805,1513,0,1515,998,517,1.930367505,887,1615,275,113,113,0,56,0,0.07079646,0,empty,CD-0722-2
"G2,B4",4592,5421,3266,2155,3160,1852,0,1852,1137,715,1.59020979,1086,1873,376,151,146,5,40,2,0.246575342,0,empty,CD-0722-2
"G2,B5",6148,4809,2874,1935,3162,1788,0,1792,1250,542,2.306273063,1120,1072,162,71,70,1,27,1,0.157142857,0,empty,CD-0722-2
"G2,B6",5035,5720,3619,2101,3376,1919,0,1920,1269,651,1.949308756,1072,1858,474,204,200,4,63,2,0.005,0,empty,CD-0722-2
"G2,B7",4742,5269,3546,1723,3136,1662,0,1662,1134,528,2.147727273,899,1626,368,192,191,1,67,1,0.104712042,0,empty,CD-0722-2
"G2,B8",3404,3810,2534,1276,2313,1245,0,1252,802,450,1.782222222,728,1317,190,94,92,2,45,2,0.065217391,0,empty,CD-0722-2
"G2,B9",6229,7105,4392,2713,4344,2482,0,2487,1573,914,1.721006565,1491,1192,172,88,87,1,48,1,0,0,empty,CD-0722-2
"G2,B10",3151,3497,2285,1212,2173,1173,0,1173,727,446,1.630044843,681,629,154,65,63,2,22,1,0,0,empty,CD-0722-2
"G2,B11",12488,13581,9238,4343,7963,4206,0,4207,2488,1719,1.447353112,2311,351,53,31,31,0,19,0,0.193548387,0,empty,CD-0722-2
"G2,B12",3976,4567,2857,1710,2792,1589,0,1592,1045,547,1.910420475,913,2052,603,222,217,5,62,1,0.00921659,0,empty,CD-0722-2
"G2,C1",1277501,1442644,968444,474200,805005,422288,2,422681,332408,90273,3.682252722,239604,147070,21426,8287,8100,187,1399,4,0.060617284,0,hg38,CD-0722-2
"G2,C2",6342,7019,4670,2349,4170,2332,0,2334,1517,817,1.856793146,1306,2767,763,298,296,2,77,2,0.02027027,0,empty,CD-0722-2
"G2,C3",6752,7608,4988,2620,4585,2493,0,2498,1562,936,1.668803419,1348,965,183,100,100,0,39,0,0.04,0,empty,CD-0722-2
"G2,C4",4254,4706,3219,1487,2880,1482,0,1484,949,535,1.773831776,799,1948,455,206,205,1,65,1,0.029268293,0,empty,CD-0722-2
"G2,C5",5990,7113,4374,2739,4287,2436,0,2440,1574,866,1.817551963,1466,3070,542,229,227,2,65,1,0.035242291,0,empty,CD-0722-2
"G2,C6",5114,5692,3632,2060,3476,1949,0,1951,1281,670,1.911940299,1089,2124,638,221,216,5,63,2,0.018518519,0,empty,CD-0722-2
"G2,C7",609520,712122,459127,252995,407195,218982,3,219158,165972,53186,3.120595645,128261,31315,4426,1722,1690,32,342,2,0.076923077,0,hg38,CD-0722-2
"G2,C8",844310,969128,645821,323307,551185,293113,2,293374,234710,58664,4.000920496,165862,183834,29597,11520,11317,203,1860,8,0.054961562,0,hg38,CD-0722-2
"G2,C9",5286,6275,3848,2427,3720,2127,0,2129,1369,760,1.801315789,1248,1725,289,130,126,4,35,2,0.119047619,0,empty,CD-0722-2
"G2,C10",670818,765511,513116,252395,435359,226269,0,226469,171574,54895,3.125494125,128693,86631,14374,5518,5422,96,1062,5,0.04334194,0,hg38,CD-0722-2
"G2,C11",5341,6323,3869,2454,3708,2020,0,2022,1246,776,1.605670103,1254,2142,498,209,205,4,58,3,0.053658537,0,empty,CD-0722-2
"G2,C12",614351,698769,467941,230828,396048,204084,1,204293,152237,52056,2.92448517,116382,59787,14237,5311,5264,47,970,2,0.04350304,0,hg38,CD-0722-2
"G2,D1",6608,7420,4707,2713,4608,2707,0,2708,1685,1023,1.647116325,1572,779,211,83,82,1,36,1,0.012195122,0,empty,CD-0722-2
"G2,D2",5364,5879,4005,1874,3484,1805,0,1809,1197,612,1.955882353,983,3261,810,300,298,2,89,2,0.063758389,0,empty,CD-0722-2
"G2,D3",4775,5676,3460,2216,3348,1904,0,1907,1292,615,2.100813008,1144,1751,510,228,228,0,54,0,0.083333333,0,empty,CD-0722-2
"G2,D4",4286,4816,3221,1595,2839,1514,0,1514,1009,505,1.998019802,830,1348,403,152,151,1,50,1,0.006622517,0,empty,CD-0722-2
"G2,D5",4238,4666,3236,1430,2766,1462,0,1464,936,528,1.772727273,768,1884,411,143,143,0,54,0,0.013986014,0,empty,CD-0722-2
"G2,D6",7282,8434,5169,3265,4958,2950,0,2958,1791,1167,1.53470437,1778,2099,541,218,218,0,66,0,0.036697248,0,empty,CD-0722-2
"G2,D7",3696,4029,2792,1237,2379,1218,0,1218,802,416,1.927884615,651,2808,655,258,246,12,69,2,0.024390244,0,empty,CD-0722-2
"G2,D8",4343,5045,3144,1901,2995,1641,0,1641,1067,574,1.858885017,986,1647,408,175,173,2,58,1,0.132947977,0,empty,CD-0722-2
"G2,D9",2258,2613,1670,943,1588,855,0,855,568,287,1.979094077,507,1874,454,149,145,4,42,3,0.124137931,0,empty,CD-0722-2
"G2,D10",4857,5536,3478,2058,3238,1839,0,1841,1158,683,1.695461201,1079,1355,296,129,129,0,58,0,0.015503876,0,empty,CD-0722-2
"G2,D11",4972,5693,3693,2000,3505,1897,0,1897,1225,672,1.822916667,1115,3233,776,318,310,8,101,3,0.135483871,0,empty,CD-0722-2
"G2,D12",6303,7007,4586,2421,4297,2323,0,2323,1464,859,1.704307334,1323,4157,1000,428,426,2,138,2,0.014084507,0,empty,CD-0722-2
"G2,E1",7875,8867,5743,3124,5219,2952,0,2954,1866,1088,1.715073529,1649,2443,392,196,193,3,66,1,0.264248705,0,empty,CD-0722-2
"G2,E2",5403,6150,3907,2243,3655,2074,0,2074,1302,772,1.686528497,1197,1936,482,227,223,4,58,2,0.089686099,0,empty,CD-0722-2
"G2,E3",3819,4538,2804,1734,2706,1477,0,1483,975,508,1.919291339,874,2651,817,271,269,2,75,1,0,0,empty,CD-0722-2
"G2,E4",5144,5744,3719,2025,3500,1920,1,1928,1241,687,1.806404658,1107,3109,820,332,327,5,89,2,0.097859327,0,empty,CD-0722-2
"G2,E5",563574,640741,423894,216847,366180,195558,1,195747,161329,34418,4.687343832,110686,194259,19936,8052,7824,228,1441,7,0.05700409,0,hg38,CD-0722-2
"G2,E6",653040,789918,475434,314484,448855,273884,2,274085,209943,64142,3.273097191,164319,40245,11709,4457,4420,37,789,4,0.017873303,0,hg38,CD-0722-2
"G2,E7",459345,512873,351188,161685,292748,146882,1,147031,112321,34710,3.235983866,81636,40527,8278,3203,3162,41,623,4,0.05028463,0,hg38,CD-0722-2
"G2,E8",5854,6627,4365,2262,3875,2007,0,2009,1318,691,1.907380608,1152,2827,517,219,209,10,74,1,0.110047847,0,empty,CD-0722-2
"G2,E9",3854,4266,2895,1371,2518,1345,0,1347,876,471,1.859872611,721,3181,840,278,273,5,71,2,0.179487179,0,empty,CD-0722-2
"G2,E10",4427,4786,3351,1435,2862,1455,0,1461,979,482,2.031120332,771,1515,408,181,180,1,51,1,0.083333333,0,empty,CD-0722-2
"G2,E11",5299,5974,3859,2115,3589,2018,0,2019,1303,716,1.819832402,1136,2581,730,172,172,0,54,0,0.058139535,0,empty,CD-0722-2
"G2,E12",5846,7018,4201,2817,4072,2300,0,2302,1452,850,1.708235294,1395,2200,330,198,195,3,63,2,0.030769231,0,empty,CD-0722-2
"G2,F1",6843,7743,5025,2718,4569,2490,0,2490,1579,911,1.733260154,1419,2642,568,243,237,6,84,1,0.016877637,0,empty,CD-0722-2
"G2,F2",5015,5574,3646,1928,3461,1853,0,1853,1206,647,1.863987635,1050,2852,529,227,223,4,69,3,0.049327354,0,empty,CD-0722-2
"G2,F3",4988,5708,3630,2078,3407,1873,0,1873,1213,660,1.837878788,1079,3449,921,324,323,1,86,1,0.089783282,0,empty,CD-0722-2
"G2,F4",7314,7884,5532,2352,4840,2512,0,2513,1625,888,1.829954955,1338,835,103,60,60,0,35,0,0.016666667,0,empty,CD-0722-2
"G2,F5",763867,890605,567892,322713,503749,282916,3,283168,225501,57667,3.910399362,164167,39561,7379,2787,2731,56,710,6,0.054924936,0,hg38,CD-0722-2
"G2,F6",5902,6998,4201,2797,4136,2401,0,2403,1539,864,1.78125,1425,3002,639,255,253,2,65,2,0.075098814,0,empty,CD-0722-2
"G2,F7",6816,7777,5019,2758,4624,2551,0,2555,1619,936,1.729700855,1436,977,244,94,94,0,28,0,0.095744681,0,empty,CD-0722-2
"G2,F8",5142,5808,3729,2079,3466,1902,0,1902,1315,587,2.240204429,1065,493,25,16,16,0,12,0,0.1875,0,empty,CD-0722-2
"G2,F9",5653,6414,4190,2224,3817,2026,0,2026,1369,657,2.083713851,1188,3790,800,335,332,3,95,2,0.087349398,0,empty,CD-0722-2
"G2,F10",1036784,1313310,702341,610969,772849,539713,1,540047,323248,216799,1.491003187,338174,3101,797,219,217,2,78,2,0.036866359,0,hg38,CD-0722-2
"G2,F11",522140,585092,398217,186875,334858,172186,0,172333,134193,38140,3.518432092,96482,116557,12746,5057,4928,129,970,5,0.072037338,0,hg38,CD-0722-2
"G2,F12",5811,6473,4288,2185,3862,2039,0,2041,1339,702,1.907407407,1166,250,26,14,13,1,8,1,0,0,empty,CD-0722-2
"G2,G1",570917,655857,430072,225785,377626,201125,1,201318,157269,44049,3.570319417,115898,185149,32316,12093,11911,182,1711,7,0.045168332,0,hg38,CD-0722-2
"G2,G2",3966,4541,2776,1765,2659,1526,0,1528,974,554,1.758122744,898,697,180,79,79,0,35,0,0.025316456,0,empty,CD-0722-2
"G2,G3",8712,9799,6257,3542,5814,3189,0,3196,2019,1177,1.71537808,1847,2640,574,205,203,2,69,1,0.103448276,0,empty,CD-0722-2
"G2,G4",12857,15220,8923,6297,8953,5514,0,5522,3296,2226,1.480682839,3284,185,40,18,18,0,13,0,0.055555556,0,empty,CD-0722-2
"G2,G5",4189,4865,3013,1852,2863,1572,0,1572,1073,499,2.150300601,927,1688,336,138,138,0,53,0,0.043478261,0,empty,CD-0722-2
"G2,G6",6165,6888,4635,2253,4226,2282,1,2283,1527,756,2.01984127,1251,150,37,23,23,0,7,0,0.043478261,0,empty,CD-0722-2
"G2,G7",4687,5130,3485,1645,3121,1589,0,1598,1009,589,1.713073005,886,2712,578,230,228,2,64,1,0.122807018,0,empty,CD-0722-2
"G2,G8",3533,4027,2543,1484,2414,1282,0,1283,831,452,1.838495575,740,2053,464,156,152,4,57,1,0.046052632,0,empty,CD-0722-2
"G2,G9",4631,5129,3423,1706,3151,1730,0,1732,1118,614,1.820846906,945,2740,731,259,258,1,90,1,0.108527132,0,empty,CD-0722-2
"G2,G10",5532,6360,4040,2320,3795,2124,0,2127,1380,747,1.847389558,1234,2601,466,194,191,3,65,2,0.104712042,0,empty,CD-0722-2
"G2,G11",5253,5886,3859,2027,3571,1853,0,1858,1257,601,2.091514143,1088,1159,221,133,132,1,49,1,0.083333333,0,empty,CD-0722-2
"G2,G12",4863,5406,3571,1835,3340,1871,0,1871,1217,654,1.860856269,1069,3285,886,351,347,4,95,2,0.097982709,0,empty,CD-0722-2
"G2,H1",4810,5540,3518,2022,3266,1760,0,1762,1210,552,2.192028986,1008,1261,220,103,103,0,42,0,0.048543689,0,empty,CD-0722-2
"G2,H2",1800627,2122920,1342049,780871,1192286,673840,4,674369,533315,141054,3.780927872,399897,328562,47515,17823,17434,389,2521,7,0.043076747,0,hg38,CD-0722-2
"G2,H3",4464,5154,3190,1964,3097,1792,0,1792,1175,617,1.904376013,1063,1844,383,146,146,0,54,0,0.150684932,0,empty,CD-0722-2
"G2,H4",6625,7537,4857,2680,4446,2401,0,2404,1576,828,1.903381643,1417,276,32,18,18,0,10,0,0.222222222,0,empty,CD-0722-2
"G2,H5",6998,7871,5106,2765,4669,2578,0,2582,1654,928,1.782327586,1477,3692,689,271,266,5,81,3,0.131578947,0,empty,CD-0722-2
"G2,H6",4321,4954,3145,1809,2917,1592,0,1592,1063,529,2.009451796,932,2155,491,189,188,1,68,1,0.042553191,0,empty,CD-0722-2
"G2,H7",4905,5570,3567,2003,3347,1786,1,1792,1126,666,1.690690691,1056,2739,598,251,249,2,94,2,0.02811245,0,empty,CD-0722-2
"G2,H8",5507,6326,3974,2352,3813,2155,0,2155,1387,768,1.805989583,1253,2299,415,173,173,0,58,0,0.144508671,0,empty,CD-0722-2
"G2,H9",5686,6572,4235,2337,3906,2097,0,2105,1515,590,2.56779661,1215,1330,255,113,111,2,32,2,0.036036036,0,empty,CD-0722-2
"G2,H10",485289,559278,363101,196177,317886,169886,0,170057,130922,39135,3.345394148,99163,164658,21711,8460,8261,199,1373,5,0.06718315,0,hg38,CD-0722-2
"G2,H11",5620,6757,3802,2955,4066,2669,0,2669,1465,1204,1.216777409,1673,88,6,2,1,1,1,1,0,0,empty,CD-0722-2
"G2,H12",4341,4875,3124,1751,2901,1662,0,1662,1100,562,1.957295374,947,1272,313,131,126,5,49,2,0.031746032,0,empty,CD-0722-2
"G3,A1",3344,3647,2424,1223,2222,1254,0,1254,842,412,2.04368932,678,1435,384,123,118,5,36,1,0.118644068,0,empty,CD-0722-2
"G3,A2",8562,9439,6602,2837,5559,2814,0,2819,1874,945,1.983068783,1484,2580,618,192,189,3,49,1,0.121693122,0,empty,CD-0722-2
"G3,A3",3018,3479,2186,1293,2133,1223,0,1225,821,404,2.032178218,721,1307,185,100,100,0,25,0,0.17,0,empty,CD-0722-2
"G3,A4",609090,701913,458437,243476,402810,216445,3,216597,166185,50412,3.296536539,124878,62562,7284,2923,2855,68,564,3,0.050087566,0,hg38,CD-0722-2
"G3,A5",4237,4763,3061,1702,2984,1641,0,1641,1066,575,1.853913043,961,1567,294,125,123,2,38,2,0.048780488,0,empty,CD-0722-2
"G3,A6",3574,4249,2623,1626,2580,1497,0,1497,963,534,1.803370787,864,2611,642,241,226,15,68,3,0.044247788,0,empty,CD-0722-2
"G3,A7",3353,3891,2437,1454,2377,1367,0,1368,863,505,1.708910891,791,927,87,44,43,1,25,1,0.046511628,0,empty,CD-0722-2
"G3,A8",1883,2057,1438,619,1272,678,0,680,441,239,1.845188285,356,1573,397,160,154,6,39,1,0.233766234,0,empty,CD-0722-2
"G3,A9",3518,3763,2473,1290,2391,1318,0,1320,866,454,1.907488987,727,1577,365,127,125,2,33,1,0.064,0,empty,CD-0722-2
"G3,A10",3789,4241,2852,1389,2520,1295,0,1298,811,487,1.665297741,701,357,85,36,36,0,9,0,0.388888889,0,empty,CD-0722-2
"G3,A11",2819,3070,2062,1008,1919,971,0,973,616,357,1.725490196,550,1632,406,142,139,3,45,1,0.100719424,0,empty,CD-0722-2
"G3,A12",4026,4572,2929,1643,2755,1493,0,1493,990,503,1.968190855,867,3027,588,273,270,3,79,2,0.088888889,0,empty,CD-0722-2
"G3,B1",3626,4037,2622,1415,2396,1342,1,1343,814,529,1.538752363,775,959,259,94,94,0,28,0,0.031914894,0,empty,CD-0722-2
"G3,B2",4338,5134,2924,2210,3039,1834,0,1834,1150,684,1.68128655,1127,634,84,43,42,1,16,1,0,0,empty,CD-0722-2
"G3,B3",3189,3703,2342,1361,2205,1215,0,1217,784,433,1.810623557,705,1674,496,149,149,0,50,0,0.067114094,0,empty,CD-0722-2
"G3,B4",3151,3702,2271,1431,2275,1326,0,1326,849,477,1.779874214,795,1614,321,159,159,0,43,0,0.100628931,0,empty,CD-0722-2
"G3,B5",558365,368512,189478,179034,264186,176972,3,177630,141209,36421,3.877131325,118019,15651,8923,2992,2987,5,665,2,0.042182792,0,hg38,CD-0722-2
"G3,B6",9320,11897,6716,5181,7001,4341,0,4353,3315,1038,3.193641618,2737,2779,598,242,236,6,62,3,0.063559322,0,empty,CD-0722-2
"G3,B7",3819,4244,2907,1337,2537,1322,0,1322,857,465,1.843010753,682,1359,332,138,136,2,34,2,0.139705882,0,empty,CD-0722-2
"G3,B8",2614,2882,1919,963,1763,921,0,923,653,270,2.418518519,508,1117,322,103,103,0,28,0,0,0,empty,CD-0722-2
"G3,B9",5313,6098,3728,2370,3696,2141,0,2143,1353,790,1.712658228,1283,1000,234,121,118,3,44,1,0.008474576,0,empty,CD-0722-2
"G3,B10",2410,2639,1706,933,1630,914,0,915,538,377,1.427055703,517,243,89,34,34,0,12,0,0,0,empty,CD-0722-2
"G3,B11",5680,6637,3961,2676,4035,2487,0,2494,1397,1097,1.273473108,1501,228,6,4,4,0,4,0,0,0,empty,CD-0722-2
"G3,B12",399254,473317,293231,180086,277647,154393,1,154502,125858,28644,4.393869571,92816,161883,23027,8881,8681,200,1463,7,0.030872019,0,hg38,CD-0722-2
"G3,C1",6793,7497,5042,2455,4428,2329,1,2339,1438,901,1.59600444,1294,1174,255,100,97,3,21,1,0.010309278,0,empty,CD-0722-2
"G3,C2",5349,6045,3745,2300,3606,2042,0,2048,1310,738,1.775067751,1159,1640,497,144,144,0,39,0,0.013888889,0,empty,CD-0722-2
"G3,C3",915837,1097640,667991,429649,636345,380575,3,380878,287297,93581,3.070035584,227628,58972,8850,3572,3520,52,671,2,0.061079545,0,hg38,CD-0722-2
"G3,C4",3264,3728,2340,1388,2272,1186,0,1188,816,372,2.193548387,712,1854,394,134,132,2,39,1,0.053030303,0,empty,CD-0722-2
"G3,C5",4917,5845,3601,2244,3453,1978,0,1982,1339,643,2.082426128,1171,1588,434,175,171,4,47,2,0.233918129,0,empty,CD-0722-2
"G3,C6",4283,4898,3077,1821,3016,1653,0,1653,1088,565,1.925663717,973,1217,259,109,106,3,32,1,0.037735849,0,empty,CD-0722-2
"G3,C7",6057,7086,4314,2772,4208,2491,0,2492,1484,1008,1.472222222,1498,476,44,23,23,0,10,0,0.217391304,0,empty,CD-0722-2
"G3,C8",6259,7133,4614,2519,4292,2380,0,2384,1549,835,1.85508982,1343,2756,602,247,246,1,77,1,0.093495935,0,empty,CD-0722-2
"G3,C9",4289,4991,3146,1845,3022,1695,0,1698,1105,593,1.863406408,999,1322,228,96,95,1,38,1,0.052631579,0,empty,CD-0722-2
"G3,C10",5124,5642,3849,1793,3423,1791,0,1795,1150,645,1.782945736,976,1917,538,137,136,1,45,1,0.132352941,0,empty,CD-0722-2
"G3,C11",4353,4861,3174,1687,2930,1618,0,1621,1008,613,1.644371941,913,1503,276,98,98,0,38,0,0.040816327,0,empty,CD-0722-2
"G3,C12",5693,6289,4123,2166,3935,2100,0,2103,1432,671,2.134128167,1213,1725,494,206,202,4,49,1,0.138613861,0,empty,CD-0722-2
"G3,D1",5306,6158,3786,2372,3689,2172,0,2173,1347,826,1.630750605,1251,527,56,27,25,2,10,1,0.2,0,empty,CD-0722-2
"G3,D2",4686,5159,3470,1689,3078,1589,0,1589,1035,554,1.868231047,881,2837,835,320,319,1,82,1,0.05015674,0,empty,CD-0722-2
"G3,D3",3716,4209,2671,1538,2594,1476,0,1479,970,509,1.905697446,876,1277,288,135,133,2,46,2,0.067669173,0,empty,CD-0722-2
"G3,D4",3218,3665,2292,1373,2262,1260,0,1263,872,391,2.230179028,766,1564,310,125,125,0,37,0,0.016,0,empty,CD-0722-2
"G3,D5",3510,3994,2606,1388,2398,1332,0,1336,840,496,1.693548387,737,1396,335,135,134,1,41,1,0.007462687,0,empty,CD-0722-2
"G3,D6",5705,6347,4047,2300,3947,2335,0,2335,1484,851,1.743830787,1342,1402,360,170,170,0,54,0,0.005882353,0,empty,CD-0722-2
"G3,D7",2997,3338,2214,1124,2005,1063,0,1066,738,328,2.25,562,1909,339,155,151,4,51,3,0.125827815,0,empty,CD-0722-2
"G3,D8",404146,463240,307894,155346,269814,133699,0,133798,108368,25430,4.261423516,76556,125191,22720,8470,8333,137,1577,5,0.027361094,0,hg38,CD-0722-2
"G3,D9",219752,278044,148837,129207,164085,113219,1,113311,80837,32474,2.489283735,70395,2426,282,98,97,1,44,1,0.113402062,0,empty,CD-0722-2
"G3,D10",5219,6008,3747,2261,3524,2065,0,2065,1198,867,1.38177624,1173,1051,248,72,70,2,19,2,0,0,empty,CD-0722-2
"G3,D11",3862,4456,2838,1618,2683,1421,0,1422,938,484,1.938016529,815,2454,665,275,268,7,85,1,0.029850746,0,empty,CD-0722-2
"G3,D12",5232,5972,3848,2124,3522,1915,0,1917,1206,711,1.696202532,1081,2431,524,196,194,2,75,2,0.041237113,0,empty,CD-0722-2
"G3,E1",502895,564082,382003,182079,325584,166444,0,166582,126775,39807,3.184741377,94232,130140,14611,5612,5459,153,1053,5,0.054771936,0,hg38,CD-0722-2
"G3,E2",4423,4942,3048,1894,3037,1746,0,1753,1132,621,1.822866345,1049,1820,479,199,198,1,38,1,0.131313131,0,empty,CD-0722-2
"G3,E3",3084,3387,2266,1121,2141,1179,0,1180,790,390,2.025641026,662,2247,529,209,208,1,58,1,0.149038462,0,empty,CD-0722-2
"G3,E4",4178,4740,3032,1708,2909,1641,0,1641,1046,595,1.757983193,939,2457,570,212,211,1,61,1,0.023696682,0,empty,CD-0722-2
"G3,E5",3742,4170,2776,1394,2556,1347,0,1347,895,452,1.980088496,743,1393,313,117,114,3,38,1,0.00877193,0,empty,CD-0722-2
"G3,E6",6895,7957,5096,2861,4748,2663,0,2663,1750,913,1.916757941,1558,2233,661,281,280,1,80,1,0.05,0,empty,CD-0722-2
"G3,E7",5764,6474,4168,2306,3938,2129,0,2129,1387,742,1.869272237,1241,2877,700,251,250,1,73,1,0.06,0,empty,CD-0722-2
"G3,E8",5079,5704,3856,1848,3330,1741,1,1748,1112,636,1.748427673,931,2084,519,188,187,1,65,1,0.037433155,0,empty,CD-0722-2
"G3,E9",3149,3504,2265,1239,2091,1163,1,1166,765,401,1.907730673,656,2122,307,124,123,1,58,1,0.138211382,0,empty,CD-0722-2
"G3,E10",3675,4164,2647,1517,2419,1319,0,1319,846,473,1.78858351,750,1677,553,207,207,0,41,0,0.048309179,0,empty,CD-0722-2
"G3,E11",4294,4889,3184,1705,2937,1661,0,1661,1008,653,1.543644717,928,1669,382,167,166,1,41,1,0.180722892,0,empty,CD-0722-2
"G3,E12",5443,6078,3796,2282,3812,2174,1,2177,1449,728,1.990384615,1261,1627,237,101,97,4,44,2,0.010309278,0,empty,CD-0722-2
"G3,F1",5647,6257,4108,2149,3720,1995,0,1995,1276,719,1.774687065,1109,2054,558,214,208,6,54,2,0.052884615,0,empty,CD-0722-2
"G3,F2",4696,5338,3525,1813,3268,1747,0,1754,1237,517,2.392649903,1000,2513,503,229,222,7,63,3,0.081081081,0,empty,CD-0722-2
"G3,F3",4018,4604,2920,1684,2804,1517,0,1519,967,552,1.751811594,903,2230,434,186,185,1,64,1,0.167567568,0,empty,CD-0722-2
"G3,F4",6473,7210,4726,2484,4317,2316,0,2322,1589,733,2.167803547,1281,604,100,59,57,2,30,2,0.070175439,0,empty,CD-0722-2
"G3,F5",5211,5706,3800,1906,3487,1782,0,1784,1151,633,1.818325434,996,2267,657,215,215,0,49,0,0.209302326,0,empty,CD-0722-2
"G3,F6",478390,568537,351870,216667,330249,186568,0,186715,143724,42991,3.343118327,111939,208377,28166,11120,10806,314,1780,8,0.060984638,0,hg38,CD-0722-2
"G3,F7",5835,6683,4215,2468,3952,2188,0,2191,1390,801,1.735330836,1284,1023,275,91,91,0,25,0,0.131868132,0,empty,CD-0722-2
"G3,F8",4095,4574,2992,1582,2785,1530,0,1532,1065,467,2.280513919,863,287,30,18,18,0,8,0,0.055555556,0,empty,CD-0722-2
"G3,F9",4219,4806,3184,1622,2885,1537,0,1537,1010,527,1.916508539,848,2920,789,328,325,3,76,1,0.101538462,0,empty,CD-0722-2
"G3,F10",5798,6327,4366,1961,3732,1949,0,1949,1271,678,1.874631268,1023,1688,554,169,169,0,49,0,0.076923077,0,empty,CD-0722-2
"G3,F11",4896,5367,3643,1724,3269,1678,0,1680,1186,494,2.400809717,919,1395,385,136,136,0,37,0,0.205882353,0,empty,CD-0722-2
"G3,F12",4818,5506,3506,2000,3162,1768,0,1768,1166,602,1.936877076,1017,99,26,23,23,0,10,0,0,0,empty,CD-0722-2
"G3,G1",5189,5946,3799,2147,3603,1955,0,1955,1239,716,1.730446927,1127,2852,741,311,309,2,68,1,0.103559871,0,empty,CD-0722-2
"G3,G2",3214,3672,2163,1509,2227,1314,0,1322,818,504,1.623015873,804,459,92,50,50,0,23,0,0.2,0,empty,CD-0722-2
"G3,G3",6004,6533,4358,2175,3978,2185,0,2187,1326,861,1.540069686,1222,2259,757,263,259,4,69,1,0.011583012,0,empty,CD-0722-2
"G3,G4",10648,11964,7611,4353,7273,4378,0,4378,2623,1755,1.494586895,2492,100,16,7,7,0,5,0,0,0,empty,CD-0722-2
"G3,G5",3719,4394,2727,1667,2592,1459,0,1462,921,541,1.702402957,902,1786,333,147,147,0,44,0,0.040816327,0,empty,CD-0722-2
"G3,G6",5248,5835,3808,2027,3531,1888,0,1890,1278,612,2.088235294,1056,111,27,16,16,0,10,0,0,0,empty,CD-0722-2
"G3,G7",4133,4653,3099,1554,2793,1407,1,1408,930,478,1.945606695,812,2693,948,317,317,0,71,0,0.063091483,0,empty,CD-0722-2
"G3,G8",2914,3419,2104,1315,2021,1113,0,1116,720,396,1.818181818,634,1536,315,128,124,4,46,1,0.096774194,0,empty,CD-0722-2
"G3,G9",3650,4103,2607,1496,2460,1301,0,1301,822,479,1.716075157,751,1779,386,175,170,5,59,1,0.070588235,0,empty,CD-0722-2
"G3,G10",4192,4819,2993,1826,2921,1651,0,1651,1039,612,1.697712418,971,2319,595,240,236,4,75,1,0.021186441,0,empty,CD-0722-2
"G3,G11",4109,4616,3081,1535,2803,1530,0,1530,994,536,1.854477612,853,1089,289,122,121,1,36,1,0.20661157,0,empty,CD-0722-2
"G3,G12",3439,3869,2512,1357,2401,1319,0,1319,834,485,1.719587629,753,2324,679,273,270,3,80,2,0.088888889,0,empty,CD-0722-2
"G3,H1",321656,354573,246202,108371,207934,100186,1,100279,80001,20278,3.945211559,56073,27887,7336,2587,2556,31,500,4,0.022300469,0,hg38,CD-0722-2
"G3,H2",56753,59466,43038,16428,34641,15984,1,16007,12803,3204,3.995942572,8605,2708,824,262,260,2,79,2,0.065384615,0,empty,CD-0722-2
"G3,H3",488887,590864,352868,237996,344907,202584,1,202707,160245,42462,3.77384485,124030,119558,17837,6950,6806,144,1263,9,0.056714664,0,hg38,CD-0722-2
"G3,H4",5413,6167,4029,2138,3595,1911,0,1911,1244,667,1.865067466,1095,211,61,23,23,0,13,0,0,0,empty,CD-0722-2
"G3,H5",5823,6525,4254,2271,3891,2092,0,2097,1346,751,1.792276964,1205,1818,561,236,234,2,66,1,0.042735043,0,empty,CD-0722-2
"G3,H6",3365,3984,2345,1639,2276,1333,0,1335,852,483,1.763975155,797,1781,407,153,150,3,55,2,0.066666667,0,empty,CD-0722-2
"G3,H7",3734,4160,2705,1455,2609,1404,0,1407,885,522,1.695402299,819,2002,494,220,216,4,67,2,0.064814815,0,empty,CD-0722-2
"G3,H8",4374,4896,3076,1820,2920,1597,0,1603,1052,551,1.909255898,910,2352,426,203,200,3,63,1,0.04,0,empty,CD-0722-2
"G3,H9",3504,4018,2575,1443,2439,1307,0,1307,849,458,1.85371179,773,894,164,66,61,5,24,2,0.049180328,0,empty,CD-0722-2
"G3,H10",3754,4120,2669,1451,2578,1345,0,1348,944,404,2.336633663,780,1087,207,86,86,0,32,0,0.151162791,0,empty,CD-0722-2
"G3,H11",3989,4863,2683,2180,2928,1932,0,1937,1026,911,1.126234907,1173,50,5,4,3,1,3,1,0,0,empty,CD-0722-2
"G3,H12",3064,3647,2238,1409,2181,1274,0,1276,799,477,1.675052411,745,1100,122,52,49,3,24,2,0.244897959,0,empty,CD-0722-2
"G4,A1",4087,4785,2896,1889,2834,1646,0,1646,1079,567,1.902998236,972,1616,324,115,114,1,40,1,0.026315789,0,empty,CD-0722-2
"G4,A2",6343,7280,4499,2781,4327,2444,0,2446,1534,912,1.682017544,1462,1856,483,199,199,0,58,0,0.08040201,0,empty,CD-0722-2
"G4,A3",720990,876326,527280,349046,502269,298590,1,298828,242616,56212,4.316089091,180703,217803,29988,12076,11793,283,1870,7,0.042398033,0,hg38,CD-0722-2
"G4,A4",6850,7906,5051,2855,4540,2526,0,2527,1687,840,2.008333333,1441,835,199,89,88,1,33,1,0.011363636,0,empty,CD-0722-2
"G4,A5",5504,6186,4089,2097,3694,1946,0,1946,1274,672,1.895833333,1088,2120,555,237,237,0,66,0,0.054852321,0,empty,CD-0722-2
"G4,A6",348482,413142,262187,150955,237766,129769,1,129902,103282,26620,3.879864763,76680,134815,16174,6493,6328,165,1221,7,0.064633375,0,hg38,CD-0722-2
"G4,A7",4800,5430,3560,1870,3276,1776,0,1777,1136,641,1.772230889,1020,1602,356,134,134,0,42,0,0.126865672,0,empty,CD-0722-2
"G4,A8",2454,2965,1810,1155,1784,1035,0,1035,686,349,1.965616046,629,1717,366,197,195,2,55,1,0.148717949,0,empty,CD-0722-2
"G4,A9",4475,5232,3326,1906,3024,1652,0,1656,1103,553,1.994575045,940,2122,569,203,201,2,54,1,0.069651741,0,empty,CD-0722-2
"G4,A10",5578,6228,4251,1977,3682,1930,0,1932,1251,681,1.837004405,1045,404,65,37,37,0,15,0,0,0,empty,CD-0722-2
"G4,A11",3831,4422,2867,1555,2645,1395,0,1401,947,454,2.085903084,794,1755,424,186,185,1,63,1,0.07027027,0,empty,CD-0722-2
"G4,A12",5601,6019,4199,1820,3522,1821,0,1822,1269,553,2.294755877,912,3327,807,337,335,2,101,2,0.053731343,0,empty,CD-0722-2
"G4,B1",5000,5963,3605,2358,3449,1987,0,1990,1195,795,1.503144654,1196,1317,391,155,151,4,48,2,0.039735099,0,empty,CD-0722-2
"G4,B2",515733,589517,365360,224157,343646,191574,1,191698,146015,45683,3.196265569,115185,43408,4782,1889,1833,56,393,4,0.038734315,0,hg38,CD-0722-2
"G4,B3",4217,4878,3001,1877,3003,1681,0,1681,1145,536,2.13619403,1016,1797,418,188,186,2,62,1,0.086021505,0,empty,CD-0722-2
"G4,B4",4893,5890,3478,2412,3542,2128,0,2128,1301,827,1.573155985,1312,1195,286,134,134,0,43,0,0.059701493,0,empty,CD-0722-2
"G4,B5",603566,333592,204991,128601,239636,130859,8,131767,101266,30501,3.320087866,83110,54692,6067,2215,2154,61,510,7,0.06174559,0,hg38,CD-0722-2
"G4,B6",5202,5836,3680,2156,3514,2038,0,2040,1268,772,1.642487047,1186,1545,503,195,195,0,50,0,0.174358974,0,empty,CD-0722-2
"G4,B7",4798,5314,3591,1723,3229,1760,0,1760,1164,596,1.953020134,989,1369,355,135,131,4,33,2,0.20610687,0,empty,CD-0722-2
"G4,B8",3430,3948,2604,1344,2430,1308,0,1308,878,430,2.041860465,756,1062,220,104,102,2,35,1,0,0,empty,CD-0722-2
"G4,B9",7113,8081,5108,2973,4742,2698,0,2698,1761,937,1.879402348,1549,1443,299,125,120,5,60,2,0.016666667,0,empty,CD-0722-2
"G4,B10",3070,3306,2167,1139,2072,1135,0,1137,741,396,1.871212121,652,497,100,42,36,6,10,2,0,0,empty,CD-0722-2
"G4,B11",674923,769220,513542,255678,432377,226989,0,227198,177351,49847,3.557907196,129855,15503,1001,399,377,22,119,3,0.00795756,0,hg38,CD-0722-2
"G4,B12",4319,5021,3142,1879,3031,1653,0,1653,1132,521,2.172744722,989,1612,398,176,176,0,46,0,0.028409091,0,empty,CD-0722-2
"G4,C1",8004,8795,5947,2848,5237,2768,0,2770,1679,1091,1.538955087,1530,1020,219,112,109,3,39,1,0.183486239,0,empty,CD-0722-2
"G4,C2",6602,7780,4752,3028,4573,2656,0,2659,1780,879,2.025028441,1529,2104,546,223,222,1,71,1,0.027027027,0,empty,CD-0722-2
"G4,C3",6737,7737,4997,2740,4648,2524,0,2526,1605,921,1.74267101,1454,1186,371,124,124,0,35,0,0.169354839,0,empty,CD-0722-2
"G4,C4",4193,4824,3152,1672,2910,1560,0,1560,1026,534,1.921348315,891,1706,382,181,181,0,57,0,0.066298343,0,empty,CD-0722-2
"G4,C5",6956,8139,5169,2970,4680,2608,0,2613,1749,864,2.024305556,1460,2295,667,254,245,9,64,2,0.07755102,0,empty,CD-0722-2
"G4,C6",5072,5946,3609,2337,3653,2098,0,2098,1328,770,1.724675325,1294,1881,324,123,122,1,34,1,0.049180328,0,empty,CD-0722-2
"G4,C7",7612,9054,5317,3737,5381,3342,0,3342,1987,1355,1.466420664,2012,401,52,40,40,0,24,0,0.1,0,empty,CD-0722-2
"G4,C8",8332,9524,6140,3384,5713,3221,0,3221,2148,1073,2.001863933,1874,3104,981,362,357,5,109,2,0.053221289,0,empty,CD-0722-2
"G4,C9",11328,13229,8551,4678,7729,4049,0,4050,2756,1294,2.129829985,2336,2083,498,219,219,0,70,0,0.03652968,0,empty,CD-0722-2
"G4,C10",6200,6890,4545,2345,4055,2107,0,2107,1367,740,1.847297297,1196,1812,355,171,169,2,52,2,0.053254438,0,empty,CD-0722-2
"G4,C11",997102,1098171,754373,343798,622175,313572,4,313843,255692,58151,4.397035305,177428,401414,34290,13798,13278,520,2183,10,0.051589095,0,hg38,CD-0722-2
"G4,C12",7481,8242,5572,2670,4955,2620,0,2622,1775,847,2.095631641,1431,2340,492,202,199,3,70,2,0.055276382,0,empty,CD-0722-2
"G4,D1",6786,7747,4889,2858,4785,2801,0,2803,1700,1103,1.541251133,1644,946,187,76,74,2,24,2,0.013513514,0,empty,CD-0722-2
"G4,D2",5662,6316,4214,2102,3780,1975,0,1976,1279,697,1.835007174,1101,3051,1021,398,397,1,89,1,0.040302267,0,empty,CD-0722-2
"G4,D3",845356,990409,643662,346747,567169,308389,0,308695,249492,59203,4.214178336,179590,138079,20083,8032,7856,176,1386,5,0.068864562,0,hg38,CD-0722-2
"G4,D4",3725,4236,2745,1491,2543,1343,0,1345,852,493,1.728194726,774,1059,223,95,94,1,37,1,0.106382979,0,empty,CD-0722-2
"G4,D5",4454,4851,3221,1630,2941,1562,0,1566,1043,523,1.994263862,876,1877,409,172,171,1,62,1,0.046783626,0,empty,CD-0722-2
"G4,D6",7030,8114,4937,3177,4777,2831,0,2833,1713,1120,1.529464286,1675,2369,590,286,284,2,80,1,0.10915493,0,empty,CD-0722-2
"G4,D7",3975,4538,2933,1605,2700,1422,0,1423,1030,393,2.62086514,816,2120,588,236,235,1,68,1,0.123404255,0,empty,CD-0722-2
"G4,D8",4499,5265,3201,2064,3178,1788,0,1790,1154,636,1.814465409,1078,1502,220,118,114,4,57,2,0.01754386,0,empty,CD-0722-2
"G4,D9",2441,2959,1754,1205,1751,987,0,987,622,365,1.704109589,601,2127,669,236,232,4,52,1,0.030172414,0,empty,CD-0722-2
"G4,D10",4594,5469,3273,2196,3261,1875,0,1875,1111,764,1.454188482,1142,1288,198,82,81,1,24,1,0.012345679,0,empty,CD-0722-2
"G4,D11",4933,5565,3616,1949,3335,1781,0,1781,1144,637,1.795918367,1047,3367,1033,319,316,3,94,2,0.098101266,0,empty,CD-0722-2
"G4,D12",6462,7366,4710,2656,4443,2408,0,2411,1567,844,1.856635071,1387,3606,1017,414,410,4,116,1,0.058536585,0,empty,CD-0722-2
"G4,E1",8296,9543,5956,3587,5575,3172,0,3174,2002,1172,1.708191126,1862,2482,425,210,205,5,56,2,0.068292683,0,empty,CD-0722-2
"G4,E2",5465,6468,3975,2493,3802,2086,0,2086,1377,709,1.942172073,1222,2216,473,206,205,1,54,1,0.165853659,0,empty,CD-0722-2
"G4,E3",4041,4557,2968,1589,2654,1420,0,1422,874,548,1.594890511,816,2395,629,260,260,0,66,0,0.119230769,0,empty,CD-0722-2
"G4,E4",5295,5959,3847,2112,3623,1958,0,1961,1276,685,1.862773723,1160,2759,631,263,262,1,88,1,0.038167939,0,empty,CD-0722-2
"G4,E5",6380,7095,4724,2371,4262,2318,0,2323,1508,815,1.850306748,1295,1664,444,165,163,2,50,2,0.018404908,0,empty,CD-0722-2
"G4,E6",8753,9899,6263,3636,5771,3223,0,3227,2086,1141,1.828220859,1829,3390,759,335,330,5,98,2,0.048484848,0,empty,CD-0722-2
"G4,E7",8111,9089,5975,3114,5406,2852,0,2854,1845,1009,1.828543112,1589,3095,547,218,212,6,66,2,0.061320755,0,empty,CD-0722-2
"G4,E8",6298,6792,4592,2200,4009,2016,0,2016,1333,683,1.951683748,1131,3371,778,317,314,3,79,2,0.136942675,0,empty,CD-0722-2
"G4,E9",1481031,1817272,1082815,734457,1018836,615646,4,616099,507032,109067,4.648812198,372188,461770,74747,29213,28660,553,3469,6,0.061723657,0,hg38,CD-0722-2
"G4,E10",4273,4796,3132,1664,2876,1550,0,1550,1032,518,1.992277992,891,1614,431,189,188,1,53,1,0.058510638,0,empty,CD-0722-2
"G4,E11",5375,6099,3990,2109,3640,2005,0,2009,1293,716,1.805865922,1096,1916,339,115,115,0,45,0,0.139130435,0,empty,CD-0722-2
"G4,E12",6168,7055,4494,2561,4295,2391,0,2391,1580,811,1.948212084,1390,2048,544,205,204,1,63,1,0.014705882,0,empty,CD-0722-2
"G4,F1",7077,8007,5189,2818,4788,2626,0,2627,1672,955,1.75078534,1460,2339,486,219,216,3,86,2,0.027777778,0,empty,CD-0722-2
"G4,F2",5352,5833,3897,1936,3497,1830,0,1834,1206,628,1.920382166,1006,3380,772,285,282,3,86,2,0.081560284,0,empty,CD-0722-2
"G4,F3",5303,6036,3929,2107,3617,1906,0,1908,1242,666,1.864864865,1107,3225,853,336,333,3,90,2,0.201201201,0,empty,CD-0722-2
"G4,F4",7996,8502,5848,2654,5188,2676,0,2682,1774,908,1.953744493,1427,1105,248,81,78,3,32,2,0.153846154,0,empty,CD-0722-2
"G4,F5",628766,740901,456743,284158,422037,245263,1,245469,192236,53233,3.611218605,145293,43190,10623,4063,4021,42,840,4,0.060184034,0,hg38,CD-0722-2
"G4,F6",6013,6960,4326,2634,4111,2360,0,2365,1473,892,1.651345291,1382,3006,810,334,323,11,78,2,0.077399381,0,empty,CD-0722-2
"G4,F7",6800,7684,5009,2675,4522,2442,1,2443,1544,899,1.717463849,1401,1153,234,105,99,6,34,2,0.121212121,0,empty,CD-0722-2
"G4,F8",5178,5562,3875,1687,3475,1829,0,1832,1210,622,1.945337621,992,413,40,18,17,1,14,1,0,0,empty,CD-0722-2
"G4,F9",5782,6325,4347,1978,3773,1949,0,1953,1277,676,1.889053254,1041,2994,644,248,247,1,83,1,0.093117409,0,empty,CD-0722-2
"G4,F10",6799,7545,5097,2448,4505,2363,0,2367,1600,767,2.086049544,1297,1860,498,226,224,2,63,1,0.147321429,0,empty,CD-0722-2
"G4,F11",6001,6801,4460,2341,3995,2104,0,2104,1413,691,2.044862518,1208,1790,372,159,156,3,51,2,0.070512821,0,empty,CD-0722-2
"G4,F12",1220657,1452123,887941,564182,814777,474046,2,474423,376618,97805,3.850702929,286716,10578,1236,543,535,8,143,2,0.054205607,0,hg38,CD-0722-2
"G4,G1",6176,7049,4610,2439,4200,2225,0,2225,1448,777,1.863577864,1259,2583,526,266,258,8,84,2,0.019379845,0,empty,CD-0722-2
"G4,G2",4010,4507,2803,1704,2812,1561,0,1564,986,578,1.705882353,947,607,64,46,45,1,37,1,0,0,empty,CD-0722-2
"G4,G3",8156,8986,5911,3075,5295,2885,0,2889,1834,1055,1.738388626,1606,2442,564,214,214,0,78,0,0,0,empty,CD-0722-2
"G4,G4",760047,949281,519659,429622,545892,375008,1,375240,274344,100896,2.719077069,228485,542,42,21,19,2,15,1,0,0,empty,CD-0722-2
"G4,G5",4296,4938,3090,1848,2984,1677,0,1677,1092,585,1.866666667,984,1994,403,187,184,3,60,3,0.005434783,0,empty,CD-0722-2
"G4,G6",6395,7324,4638,2686,4307,2362,0,2363,1605,758,2.117414248,1364,225,40,23,23,0,11,0,0,0,empty,CD-0722-2
"G4,G7",5038,5603,3731,1872,3359,1767,0,1767,1130,637,1.773940345,1020,6874,1261,440,429,11,122,3,0.060606061,0,empty,CD-0722-2
"G4,G8",4000,4311,2875,1436,2675,1385,0,1385,923,462,1.997835498,774,1755,468,201,201,0,68,0,0.024875622,0,empty,CD-0722-2
"G4,G9",4504,4972,3311,1661,2972,1601,0,1606,1090,516,2.112403101,911,2382,613,230,227,3,77,2,0.044052863,0,empty,CD-0722-2
"G4,G10",5680,6587,4142,2445,3984,2254,0,2256,1491,765,1.949019608,1347,2273,653,262,261,1,82,1,0.034482759,0,empty,CD-0722-2
"G4,G11",5366,5952,3965,1987,3618,1910,0,1911,1220,691,1.765557164,1077,1728,485,189,189,0,55,0,0.010582011,0,empty,CD-0722-2
"G4,G12",4773,5425,3437,1988,3261,1807,0,1809,1131,678,1.668141593,1040,2339,604,257,256,1,94,1,0.03515625,0,empty,CD-0722-2
"G4,H1",5081,5612,3685,1927,3353,1821,0,1822,1258,564,2.230496454,1026,1336,238,108,107,1,50,1,0.112149533,0,empty,CD-0722-2
"G4,H2",5440,6108,3997,2111,3650,1993,0,1993,1280,713,1.795231417,1145,2246,602,254,251,3,77,2,0.035856574,0,empty,CD-0722-2
"G4,H3",4804,5591,3600,1991,3296,1845,0,1847,1245,602,2.068106312,1065,1486,183,84,84,0,52,0,0.05952381,0,empty,CD-0722-2
"G4,H4",6889,7733,4984,2749,4488,2380,0,2384,1559,825,1.88969697,1389,125,34,21,21,0,18,0,0.047619048,0,empty,CD-0722-2
"G4,H5",7014,7677,5181,2496,4597,2457,0,2459,1611,848,1.899764151,1333,1870,513,251,248,3,81,2,0.008064516,0,empty,CD-0722-2
"G4,H6",4575,5237,3253,1984,3093,1761,0,1761,1171,590,1.984745763,1028,2320,622,252,250,2,77,1,0.08,0,empty,CD-0722-2
"G4,H7",5167,5916,3801,2115,3558,1913,3,1919,1278,641,1.99375975,1098,2376,732,285,285,0,88,0,0.112280702,0,empty,CD-0722-2
"G4,H8",22062,26815,16160,10655,15777,9048,0,9055,6932,2123,3.265190768,5468,2203,596,217,214,3,61,2,0.079439252,0,empty,CD-0722-2
"G4,H9",4450,5169,3341,1828,2995,1571,0,1573,1070,503,2.127236581,916,1369,363,163,160,3,54,2,0.00625,0,empty,CD-0722-2
"G4,H10",4633,5173,3336,1837,3153,1751,0,1753,1180,573,2.059336824,1014,1929,426,159,155,4,46,2,0.077419355,0,empty,CD-0722-2
"G4,H11",5535,6638,3794,2844,4084,2707,0,2708,1438,1270,1.132283465,1684,72,6,3,3,0,3,0,0,0,empty,CD-0722-2
"G4,H12",4763,5235,3451,1784,3147,1752,0,1753,1145,608,1.883223684,982,2347,235,122,120,2,63,1,0.041666667,0,empty,CD-0722-2
"G5,A1",4308,4775,3089,1686,2896,1615,0,1616,1002,614,1.631921824,891,955,136,46,46,0,31,0,0.02173913,0,empty,CD-0722-2
"G5,A2",6721,7775,4846,2929,4579,2612,0,2616,1619,997,1.623871615,1595,1650,455,168,166,2,46,1,0.072289157,0,empty,CD-0722-2
"G5,A3",4133,4637,3039,1598,2746,1472,0,1476,990,486,2.037037037,827,1060,215,79,79,0,29,0,0.025316456,0,empty,CD-0722-2
"G5,A4",6798,7554,4954,2600,4469,2444,0,2444,1615,829,1.948130277,1417,602,130,52,52,0,16,0,0.134615385,0,empty,CD-0722-2
"G5,A5",510249,617556,365355,252201,358021,216312,1,216468,168142,48326,3.479327898,131645,26899,6632,2373,2356,17,556,4,0.067487267,0,hg38,CD-0722-2
"G5,A6",5486,6449,3944,2505,3909,2259,0,2265,1445,820,1.762195122,1351,2733,654,260,258,2,75,1,0.15503876,0,empty,CD-0722-2
"G5,A7",4411,5018,3137,1881,2917,1640,0,1641,1052,589,1.786078098,898,1359,345,138,136,2,44,1,0.176470588,0,empty,CD-0722-2
"G5,A8",2658,2943,1972,971,1761,924,0,924,591,333,1.774774775,514,1235,368,133,133,0,53,0,0.015037594,0,empty,CD-0722-2
"G5,A9",4624,5416,3419,1997,3284,1844,0,1846,1177,669,1.759342302,1104,1489,317,124,120,4,40,2,0.016666667,0,empty,CD-0722-2
"G5,A10",418630,532761,292057,240704,311190,208568,0,208702,146841,61861,2.373724964,130067,4165,713,237,228,9,64,3,0.153508772,0,hg38,CD-0722-2
"G5,A11",4078,4637,3102,1535,2702,1396,0,1397,954,443,2.153498871,785,1376,355,147,144,3,46,1,0.041666667,0,empty,CD-0722-2
"G5,A12",6416,7263,4741,2522,4200,2216,0,2218,1417,801,1.769038702,1223,4098,829,360,360,0,96,0,0.133333333,0,empty,CD-0722-2
"G5,B1",5120,5712,3754,1958,3340,1816,0,1816,1063,753,1.411686587,1026,1029,149,69,69,0,26,0,0.246376812,0,empty,CD-0722-2
"G5,B2",5047,5652,3444,2208,3391,2015,0,2021,1240,781,1.587708067,1186,481,65,34,32,2,15,1,0.03125,0,empty,CD-0722-2
"G5,B3",272364,371893,171119,200774,220221,167231,0,167332,114941,52391,2.19390735,110084,1356,212,110,110,0,50,0,0.172727273,0,hg38,CD-0722-2
"G5,B4",5112,6118,3648,2470,3714,2224,0,2228,1347,881,1.528944381,1405,1332,330,114,109,5,34,1,0.036697248,0,empty,CD-0722-2
"G5,B5",10889,10540,6075,4465,6704,4008,0,4014,2960,1054,2.808349146,2569,1021,215,96,96,0,31,0,0.010416667,0,empty,CD-0722-2
"G5,B6",5958,6843,4178,2665,4107,2442,0,2443,1527,916,1.667030568,1406,2180,579,220,220,0,51,0,0.122727273,0,empty,CD-0722-2
"G5,B7",4778,5284,3510,1774,3262,1740,0,1740,1195,545,2.19266055,982,1298,318,125,120,5,25,3,0,0,empty,CD-0722-2
"G5,B8",3468,4051,2682,1369,2417,1279,0,1282,866,416,2.081730769,719,973,186,95,93,2,25,2,0.032258065,0,empty,CD-0722-2
"G5,B9",7613,8803,5493,3310,5252,3104,0,3104,1965,1139,1.725197542,1771,1125,265,104,101,3,29,1,0,0,empty,CD-0722-2
"G5,B10",674683,743267,479756,263511,439699,240386,9,240936,189946,50990,3.725161796,139258,46138,5862,2418,2362,56,481,4,0.049110923,0,hg38,CD-0722-2
"G5,B11",8937,10535,6338,4197,6228,3863,0,3863,2256,1607,1.403858121,2288,268,27,16,15,1,12,1,0.066666667,0,empty,CD-0722-2
"G5,B12",4512,5229,3316,1913,3164,1802,0,1802,1239,563,2.20071048,1052,1653,586,197,195,2,48,2,0.076923077,0,empty,CD-0722-2
"G5,C1",8442,9391,6321,3070,5532,2987,0,2989,1935,1054,1.835863378,1676,866,244,116,116,0,22,0,0,0,empty,CD-0722-2
"G5,C2",2049514,2661196,1323707,1337489,1529780,1123485,0,1124136,793077,331059,2.395576015,723708,65481,13430,4766,4699,67,933,4,0.026175782,0,hg38,CD-0722-2
"G5,C3",7204,8231,5360,2871,4873,2626,0,2630,1702,928,1.834051724,1519,721,153,52,51,1,23,1,0,0,empty,CD-0722-2
"G5,C4",4505,4856,3347,1509,2890,1418,0,1420,953,467,2.040685225,784,1637,381,143,140,3,30,2,0.035714286,0,empty,CD-0722-2
"G5,C5",6374,7440,4648,2792,4324,2393,1,2399,1626,773,2.103492885,1398,1453,387,156,156,0,51,0,0.019230769,0,empty,CD-0722-2
"G5,C6",635145,826824,433201,393623,486959,326742,4,326954,247692,79262,3.124977921,210948,13138,6196,2251,2247,4,547,2,0.040053405,0,hg38,CD-0722-2
"G5,C7",8093,9453,5578,3875,5626,3468,1,3475,2073,1402,1.478601997,2093,363,88,39,38,1,14,1,0.026315789,0,empty,CD-0722-2
"G5,C8",8494,9589,6264,3325,5823,3193,0,3195,2055,1140,1.802631579,1814,2953,836,274,273,1,100,1,0.003663004,0,empty,CD-0722-2
"G5,C9",595875,742736,424756,317980,425778,265708,0,265893,213076,52817,4.034231403,164275,3554,706,211,211,0,56,0,0.142180095,0,hg38,CD-0722-2
"G5,C10",6497,7421,4863,2558,4381,2255,0,2255,1479,776,1.905927835,1295,2111,447,199,197,2,51,1,0.091370558,0,empty,CD-0722-2
"G5,C11",5710,6641,4132,2509,3921,2212,0,2216,1422,794,1.79093199,1316,1925,447,166,166,0,55,0,0.024096386,0,empty,CD-0722-2
"G5,C12",8174,9232,6054,3178,5533,3010,0,3011,1964,1047,1.875835721,1724,1576,450,153,152,1,49,1,0.111842105,0,empty,CD-0722-2
"G5,D1",7525,8793,5363,3430,5187,3074,0,3075,1843,1232,1.495941558,1849,1045,163,49,49,0,17,0,0.306122449,0,empty,CD-0722-2
"G5,D2",5951,6675,4461,2214,3956,2067,0,2067,1352,715,1.890909091,1166,2433,735,258,257,1,72,1,0.085603113,0,empty,CD-0722-2
"G5,D3",5245,6007,3766,2241,3655,2073,0,2073,1322,751,1.760319574,1220,1238,170,74,74,0,19,0,0.108108108,0,empty,CD-0722-2
"G5,D4",3898,4646,2849,1797,2827,1553,0,1557,1033,524,1.971374046,965,1005,278,84,84,0,31,0,0.047619048,0,empty,CD-0722-2
"G5,D5",615728,751022,446140,304882,430979,256531,1,256724,200169,56555,3.539368756,155946,51148,10409,3920,3873,47,863,5,0.015750065,0,hg38,CD-0722-2
"G5,D6",7243,8489,5099,3390,4925,2907,0,2909,1715,1194,1.436348409,1732,1724,495,198,193,5,55,2,0.103626943,0,empty,CD-0722-2
"G5,D7",596762,766375,398552,367823,456012,325308,0,325468,209263,116205,1.800808915,205578,2816,824,280,279,1,89,1,0.11827957,0,hg38,CD-0722-2
"G5,D8",841580,1016864,611969,404895,576020,339784,1,340027,278606,61421,4.536005601,205186,142118,24035,9411,9224,187,1520,7,0.055398959,0,hg38,CD-0722-2
"G5,D9",2657,2980,2023,957,1826,988,0,988,694,294,2.360544218,564,1696,366,174,174,0,34,0,0.068965517,0,empty,CD-0722-2
"G5,D10",5379,6271,3807,2464,3796,2222,0,2222,1428,794,1.798488665,1292,762,266,101,100,1,30,1,0.06,0,empty,CD-0722-2
"G5,D11",5573,6262,4153,2109,3763,1997,0,2000,1256,744,1.688172043,1127,3477,937,315,312,3,87,1,0.054487179,0,empty,CD-0722-2
"G5,D12",6755,7728,4898,2830,4601,2541,0,2541,1651,890,1.85505618,1502,2694,615,266,260,6,80,2,0.088461538,0,empty,CD-0722-2
"G5,E1",574129,613647,447711,165936,345967,159173,2,159318,120824,38494,3.138774874,84841,184291,23275,9269,9025,244,1514,8,0.044210526,0,hg38,CD-0722-2
"G5,E2",5903,6719,4200,2519,3990,2294,0,2296,1457,839,1.73659118,1333,1796,464,174,174,0,44,0,0.097701149,0,empty,CD-0722-2
"G5,E3",346115,437936,236633,201303,255956,176273,0,176341,126142,50199,2.512838901,108547,3768,575,243,240,3,78,2,0.133333333,0,hg38,CD-0722-2
"G5,E4",5478,6017,4135,1882,3690,1968,0,1970,1267,703,1.80227596,1047,2175,581,209,207,2,70,1,0.06763285,0,empty,CD-0722-2
"G5,E5",4929,5516,3790,1726,3179,1596,0,1596,1100,496,2.217741935,835,1360,372,121,121,0,37,0,0.099173554,0,empty,CD-0722-2
"G5,E6",9161,10437,6762,3675,6083,3367,0,3367,2232,1135,1.966519824,1888,2899,552,216,215,1,65,1,0.046511628,0,empty,CD-0722-2
"G5,E7",8159,9129,6104,3025,5356,2820,0,2823,1898,925,2.051891892,1592,2495,666,272,267,5,68,2,0.063670412,0,empty,CD-0722-2
"G5,E8",6049,6577,4509,2068,3982,2094,0,2098,1375,723,1.901798064,1118,2508,699,292,292,0,62,0,0.071917808,0,empty,CD-0722-2
"G5,E9",4313,4991,3226,1765,2969,1595,0,1596,1083,513,2.111111111,915,2389,490,205,202,3,66,1,0.04950495,0,empty,CD-0722-2
"G5,E10",4612,5456,3400,2056,3172,1747,0,1749,1207,542,2.226937269,1017,1454,396,128,128,0,39,0,0.125,0,empty,CD-0722-2
"G5,E11",5574,6328,4006,2322,3741,2075,0,2079,1317,762,1.728346457,1195,1995,486,163,158,5,39,3,0.012658228,0,empty,CD-0722-2
"G5,E12",6303,7288,4591,2697,4371,2391,0,2392,1522,870,1.749425287,1439,1500,347,160,159,1,53,1,0.037735849,0,empty,CD-0722-2
"G5,F1",7307,8172,5416,2756,4835,2626,0,2626,1711,915,1.869945355,1445,1956,434,160,159,1,53,1,0.081761006,0,empty,CD-0722-2
"G5,F2",5642,6430,4120,2310,3819,2071,0,2072,1320,752,1.755319149,1201,2531,598,245,242,3,83,1,0.037190083,0,empty,CD-0722-2
"G5,F3",5403,6000,3981,2019,3582,1934,0,1935,1283,652,1.967791411,1100,2170,545,224,223,1,60,1,0.121076233,0,empty,CD-0722-2
"G5,F4",8012,8727,6023,2704,5343,2778,1,2781,1876,905,2.072928177,1553,647,89,45,40,5,17,1,0.05,0,empty,CD-0722-2
"G5,F5",6329,6970,4720,2250,4102,2137,0,2143,1375,768,1.790364583,1188,1699,573,227,225,2,61,2,0.026666667,0,empty,CD-0722-2
"G5,F6",6373,7447,4544,2903,4334,2438,0,2440,1601,839,1.908224076,1449,2464,592,241,238,3,59,2,0.117647059,0,empty,CD-0722-2
"G5,F7",7248,8038,5379,2659,4776,2538,0,2538,1664,874,1.90389016,1415,778,214,108,108,0,33,0,0.009259259,0,empty,CD-0722-2
"G5,F8",5432,6137,3950,2187,3617,1969,0,1973,1356,617,2.197730956,1169,363,39,31,31,0,13,0,0.064516129,0,empty,CD-0722-2
"G5,F9",6054,6545,4570,1975,3995,2053,0,2053,1322,731,1.808481532,1115,3061,827,291,286,5,78,2,0.055944056,0,empty,CD-0722-2
"G5,F10",7115,7907,5370,2537,4757,2430,0,2440,1665,775,2.148387097,1386,1580,450,203,202,1,45,1,0.044554455,0,empty,CD-0722-2
"G5,F11",579373,656068,443510,212558,373321,191992,0,192174,141662,50512,2.804521698,109823,61857,7949,3126,3042,84,653,5,0.048652202,0,hg38,CD-0722-2
"G5,F12",602606,696453,447125,249328,394064,214040,2,214230,159274,54956,2.898209477,126367,4924,637,231,227,4,62,1,0.061674009,0,hg38,CD-0722-2
"G5,G1",6540,7353,4958,2395,4399,2261,0,2261,1522,739,2.059539919,1247,2843,834,276,276,0,84,0,0.039855072,0,empty,CD-0722-2
"G5,G2",4336,4911,3028,1883,2901,1643,0,1644,1018,626,1.626198083,961,476,171,65,64,1,22,1,0.03125,0,empty,CD-0722-2
"G5,G3",7605,8358,5439,2919,4989,2800,0,2805,1663,1142,1.456217163,1576,2525,729,255,255,0,65,0,0.02745098,0,empty,CD-0722-2
"G5,G4",796254,950699,567209,383490,544868,347000,2,347240,260470,86770,3.001843955,203646,236,70,13,13,0,10,0,0.230769231,0,empty,CD-0722-2
"G5,G5",4481,5143,3272,1871,3013,1652,0,1654,1069,585,1.827350427,941,1663,411,160,160,0,43,0,0.08125,0,empty,CD-0722-2
"G5,G6",6520,7324,4701,2623,4365,2367,0,2374,1564,810,1.930864198,1407,131,25,15,15,0,7,0,0,0,empty,CD-0722-2
"G5,G7",6205,6877,4605,2272,4082,2138,0,2138,1431,707,2.024045262,1220,2686,633,253,249,4,60,2,0.100401606,0,empty,CD-0722-2
"G5,G8",82185,95327,61702,33625,53872,29229,0,29264,19788,9476,2.088222879,17108,9887,1413,536,523,13,154,2,0.095602294,0,empty,CD-0722-2
"G5,G9",4506,5381,3279,2102,3252,1831,0,1831,1174,657,1.786910198,1109,2000,531,186,184,2,62,1,0.048913043,0,empty,CD-0722-2
"G5,G10",5689,6387,4317,2070,3897,2156,0,2156,1456,700,2.08,1200,1717,350,173,172,1,49,1,0.034883721,0,empty,CD-0722-2
"G5,G11",5693,6504,4102,2402,3798,2062,0,2062,1331,731,1.820793434,1222,1697,329,122,119,3,30,2,0.369747899,0,empty,CD-0722-2
"G5,G12",4918,5735,3504,2231,3433,1952,0,1953,1290,663,1.945701357,1166,1764,444,188,187,1,63,1,0.037433155,0,empty,CD-0722-2
"G5,H1",555339,665050,400935,264115,383531,224935,0,225056,179330,45726,3.921838779,136671,40572,7182,2696,2648,48,557,3,0.064954683,0,hg38,CD-0722-2
"G5,H2",5386,6269,3971,2298,3780,2099,0,2099,1349,750,1.798666667,1272,2267,608,256,249,7,70,2,0.024096386,0,empty,CD-0722-2
"G5,H3",4829,5534,3496,2038,3319,1843,0,1844,1211,633,1.913112164,1073,1196,251,95,93,2,25,1,0.11827957,0,empty,CD-0722-2
"G5,H4",7062,8031,5135,2896,4741,2598,0,2598,1678,920,1.823913043,1517,106,26,17,17,0,8,0,0,0,empty,CD-0722-2
"G5,H5",7279,8311,5363,2948,4901,2729,0,2734,1826,908,2.011013216,1558,1770,434,192,191,1,57,1,0.104712042,0,empty,CD-0722-2
"G5,H6",4514,5220,3278,1942,3102,1738,0,1738,1186,552,2.148550725,992,1740,430,169,169,0,51,0,0.082840237,0,empty,CD-0722-2
"G5,H7",5413,5954,3937,2017,3573,1920,0,1925,1283,642,1.998442368,1027,1648,310,131,130,1,57,1,0.030769231,0,empty,CD-0722-2
"G5,H8",6243,7198,4457,2741,4217,2411,0,2413,1529,884,1.729638009,1415,1866,410,194,191,3,60,1,0.057591623,0,empty,CD-0722-2
"G5,H9",4600,5219,3355,1864,3038,1588,0,1588,1029,559,1.84078712,917,1225,350,126,126,0,33,0,0.158730159,0,empty,CD-0722-2
"G5,H10",5104,5868,3771,2097,3516,1917,0,1917,1316,601,2.18968386,1079,1207,258,135,135,0,39,0,0.059259259,0,empty,CD-0722-2
"G5,H11",6010,7340,4028,3312,4398,2933,0,2933,1577,1356,1.162979351,1840,27,4,2,2,0,2,0,0.5,0,empty,CD-0722-2
"G5,H12",4798,5657,3412,2245,3298,1888,0,1893,1288,605,2.12892562,1130,1321,229,107,106,1,35,1,0.009433962,0,empty,CD-0722-2
"G6,A1",4001,4608,2888,1720,2727,1526,0,1532,966,566,1.706713781,894,1083,119,68,66,2,27,2,0.03030303,0,empty,CD-0722-2
"G6,A2",5934,6887,4420,2467,4097,2310,0,2311,1396,915,1.52568306,1323,1622,238,109,107,2,34,2,0.028037383,0,empty,CD-0722-2
"G6,A3",451400,513496,338813,174683,297256,157083,3,157217,126532,30685,4.123578296,90457,28540,6275,2098,2075,23,428,3,0.022168675,0,hg38,CD-0722-2
"G6,A4",618340,702085,474202,227883,399524,204083,2,204257,154152,50105,3.076579184,115797,51631,5378,2202,2139,63,485,5,0.055633474,0,hg38,CD-0722-2
"G6,A5",5230,5909,3808,2101,3490,1921,0,1921,1226,695,1.764028777,1100,2270,345,134,128,6,34,1,0.171875,0,empty,CD-0722-2
"G6,A6",4793,5609,3440,2169,3338,1892,0,1892,1229,663,1.853695324,1124,2838,951,363,357,6,92,1,0.100840336,0,empty,CD-0722-2
"G6,A7",4071,4746,2965,1781,2866,1627,0,1628,1029,599,1.717863105,951,1249,322,128,128,0,34,0,0.0625,0,empty,CD-0722-2
"G6,A8",2367,2764,1738,1026,1648,932,0,932,600,332,1.807228916,543,1423,327,154,153,1,44,1,0.039215686,0,empty,CD-0722-2
"G6,A9",4220,4821,3154,1667,2892,1566,0,1568,994,574,1.731707317,877,1586,429,142,142,0,42,0,0.154929577,0,empty,CD-0722-2
"G6,A10",5218,5840,3958,1882,3499,1856,0,1861,1121,740,1.514864865,1001,323,37,19,19,0,11,0,0,0,empty,CD-0722-2
"G6,A11",3658,4032,2804,1228,2389,1237,0,1240,799,441,1.811791383,660,1640,319,126,123,3,42,1,0.06504065,0,empty,CD-0722-2
"G6,A12",5311,6111,3927,2184,3467,1886,0,1888,1221,667,1.830584708,1048,3153,746,296,294,2,83,1,0.088435374,0,empty,CD-0722-2
"G6,B1",4282,4849,3105,1744,2996,1739,0,1742,1022,720,1.419444444,1010,1061,340,152,152,0,37,0,0.039473684,0,empty,CD-0722-2
"G6,B2",5032,5897,3355,2542,3552,2151,0,2154,1381,773,1.786545925,1315,622,127,46,46,0,16,0,0,0,empty,CD-0722-2
"G6,B3",3761,4383,2661,1722,2662,1535,0,1536,986,550,1.792727273,928,1568,296,130,130,0,41,0,0.076923077,0,empty,CD-0722-2
"G6,B4",4249,4998,3077,1921,3035,1767,0,1767,1051,716,1.467877095,1052,1281,220,71,71,0,21,0,0.056338028,0,empty,CD-0722-2
"G6,B5",548192,336390,200479,135911,239642,140671,7,141437,106331,35106,3.028855466,89297,4668,1404,494,489,5,174,2,0.171779141,0,hg38,CD-0722-2
"G6,B6",4900,5620,3504,2116,3401,2039,0,2039,1306,733,1.781718963,1177,1720,415,175,171,4,41,1,0.052631579,0,empty,CD-0722-2
"G6,B7",4525,5069,3379,1690,2995,1662,0,1666,1092,574,1.902439024,927,1206,341,119,118,1,34,1,0.084745763,0,empty,CD-0722-2
"G6,B8",3181,3597,2319,1278,2139,1142,0,1144,795,349,2.277936963,652,1101,211,95,95,0,37,0,0.126315789,0,empty,CD-0722-2
"G6,B9",6213,7218,4442,2776,4296,2512,0,2516,1542,974,1.583162218,1457,1086,224,92,92,0,32,0,0.086956522,0,empty,CD-0722-2
"G6,B10",2909,3258,2038,1220,2004,1125,0,1127,743,384,1.934895833,640,368,73,28,28,0,10,0,0,0,empty,CD-0722-2
"G6,B11",524092,643550,370454,273096,369044,230956,2,231112,181288,49824,3.638567759,141777,1649,615,187,186,1,54,1,0.048387097,0,hg38,CD-0722-2
"G6,B12",3973,4664,2893,1771,2736,1519,0,1519,1021,498,2.050200803,908,1172,242,108,107,1,38,1,0.065420561,0,empty,CD-0722-2
"G6,C1",7738,8695,5757,2938,5126,2718,0,2720,1769,951,1.860147213,1516,534,128,43,42,1,21,1,0,0,empty,CD-0722-2
"G6,C2",6460,7328,4609,2719,4366,2442,0,2445,1576,869,1.813578826,1398,2179,602,229,227,2,61,1,0.092511013,0,empty,CD-0722-2
"G6,C3",6767,7579,5048,2531,4538,2444,0,2444,1601,843,1.899169632,1356,783,197,83,82,1,26,1,0.024390244,0,empty,CD-0722-2
"G6,C4",980904,1127432,739203,388229,646008,346303,2,346545,269922,76623,3.522728163,200203,214937,28568,11099,10879,220,1805,5,0.041823697,0,hg38,CD-0722-2
"G6,C5",6458,7513,4660,2853,4400,2524,0,2527,1598,929,1.720129171,1474,1487,398,147,145,2,42,1,0.110344828,0,empty,CD-0722-2
"G6,C6",5010,5709,3638,2071,3551,1999,0,1999,1275,724,1.761049724,1158,1637,395,126,124,2,41,1,0.137096774,0,empty,CD-0722-2
"G6,C7",1046003,1177921,804753,373168,664472,335794,0,336172,271465,64707,4.195295718,189036,12305,2540,994,989,5,225,3,0.019211325,0,hg38,CD-0722-2
"G6,C8",7983,9239,5769,3470,5524,3160,0,3162,2123,1039,2.043310876,1836,3275,882,363,360,3,92,2,0.122222222,0,empty,CD-0722-2
"G6,C9",5755,6809,4194,2615,4031,2179,0,2183,1461,722,2.023545706,1301,1390,364,169,168,1,39,1,0.148809524,0,empty,CD-0722-2
"G6,C10",6018,6939,4440,2499,4025,2173,0,2175,1373,802,1.711970075,1250,1537,498,207,193,14,42,3,0.14507772,0,empty,CD-0722-2
"G6,C11",5100,5786,3741,2045,3473,1951,0,1951,1256,695,1.807194245,1100,1625,365,133,131,2,42,1,0.045801527,0,empty,CD-0722-2
"G6,C12",7434,8515,5410,3105,5014,2783,0,2787,1786,1001,1.784215784,1607,1889,495,166,164,2,50,1,0.152439024,0,empty,CD-0722-2
"G6,D1",7202,8513,5010,3503,5257,3167,0,3172,2000,1172,1.706484642,1938,985,196,68,67,1,19,1,0.044776119,0,empty,CD-0722-2
"G6,D2",5996,6291,4365,1926,3713,1922,0,1922,1249,673,1.855869242,1022,2480,573,242,242,0,63,0,0.033057851,0,empty,CD-0722-2
"G6,D3",6073,6788,4408,2380,4059,2185,0,2187,1419,768,1.84765625,1256,1131,133,62,56,6,25,2,0.125,0,empty,CD-0722-2
"G6,D4",295348,344008,212719,131289,198685,115353,1,115437,87728,27709,3.166047133,68935,17773,4411,1589,1570,19,370,2,0.012738854,0,hg38,CD-0722-2
"G6,D5",4298,4993,3122,1871,3022,1693,0,1693,1162,531,2.188323917,1014,1848,333,140,138,2,44,2,0.079710145,0,empty,CD-0722-2
"G6,D6",193439,258293,116375,141918,154504,120541,1,120631,67775,52856,1.282257454,78979,2811,790,228,222,6,80,3,0.099099099,0,hg38,CD-0722-2
"G6,D7",3658,4284,2680,1604,2594,1425,0,1426,920,506,1.818181818,852,1850,463,215,210,5,57,2,0.028571429,0,empty,CD-0722-2
"G6,D8",643279,742420,477264,265156,425110,234755,2,234928,189423,45505,4.162685419,136533,51723,8987,3498,3431,67,665,4,0.030894783,0,hg38,CD-0722-2
"G6,D9",277005,307623,214460,93163,178829,84070,1,84153,63719,20434,3.118283253,46868,130754,21617,8351,8201,150,1340,5,0.038044141,0,hg38,CD-0722-2
"G6,D10",4886,5648,3539,2109,3464,1980,0,1980,1278,702,1.820512821,1158,1187,380,155,155,0,35,0,0.116129032,0,empty,CD-0722-2
"G6,D11",4952,5666,3686,1980,3413,1840,0,1843,1218,625,1.9488,1049,2599,683,231,228,3,83,1,0.105263158,0,empty,CD-0722-2
"G6,D12",6252,7366,4581,2785,4328,2419,0,2422,1607,815,1.971779141,1399,3060,732,296,293,3,86,2,0.078498294,0,empty,CD-0722-2
"G6,E1",7584,8597,5403,3194,5121,2930,0,2932,1864,1068,1.745318352,1685,2618,610,275,270,5,69,2,0.081481481,0,empty,CD-0722-2
"G6,E2",5514,6294,4026,2268,3626,2046,0,2046,1303,743,1.753701211,1155,2170,587,221,218,3,59,1,0.036697248,0,empty,CD-0722-2
"G6,E3",3823,4314,2865,1449,2547,1365,0,1367,885,482,1.836099585,747,2495,380,164,160,4,55,2,0.03125,0,empty,CD-0722-2
"G6,E4",4964,5556,3727,1829,3361,1782,0,1782,1185,597,1.984924623,989,1838,388,151,150,1,59,1,0.066666667,0,empty,CD-0722-2
"G6,E5",4586,5181,3523,1658,3067,1585,0,1586,1018,568,1.792253521,864,1312,315,135,132,3,33,1,0.242424242,0,empty,CD-0722-2
"G6,E6",8311,9722,5938,3784,5775,3309,0,3316,2159,1157,1.866032844,1937,2759,508,211,201,10,72,2,0.024875622,0,empty,CD-0722-2
"G6,E7",7005,7825,5164,2661,4621,2405,0,2410,1534,876,1.751141553,1335,2435,457,174,171,3,58,2,0.187134503,0,empty,CD-0722-2
"G6,E8",1189493,1397116,906333,490783,789174,439354,0,439716,363341,76375,4.757328969,251046,114717,14145,5336,5203,133,1177,3,0.034211032,0,hg38,CD-0722-2
"G6,E9",3797,4157,2696,1461,2451,1313,0,1313,845,468,1.805555556,735,2396,456,176,174,2,63,2,0.057471264,0,empty,CD-0722-2
"G6,E10",4272,4726,3189,1537,2832,1482,0,1485,946,539,1.755102041,826,1542,264,118,117,1,41,1,0.094017094,0,empty,CD-0722-2
"G6,E11",5241,6107,3723,2384,3641,2071,0,2073,1276,797,1.601003764,1261,1626,456,157,154,3,38,1,0.045454545,0,empty,CD-0722-2
"G6,E12",6327,7093,4615,2478,4313,2385,0,2385,1605,780,2.057692308,1366,1679,368,179,175,4,46,2,0.051428571,0,empty,CD-0722-2
"G6,F1",6816,7493,5027,2466,4488,2433,0,2436,1533,903,1.697674419,1323,2173,416,182,180,2,55,1,0.116666667,0,empty,CD-0722-2
"G6,F2",5324,5868,3914,1954,3385,1810,0,1812,1129,683,1.653001464,1008,2655,472,196,190,6,62,2,0.105263158,0,empty,CD-0722-2
"G6,F3",4851,5494,3490,2004,3225,1734,0,1736,1112,624,1.782051282,1032,2236,527,248,248,0,73,0,0.02016129,0,empty,CD-0722-2
"G6,F4",7368,8096,5462,2634,4851,2551,0,2556,1667,889,1.875140607,1406,782,205,81,81,0,25,0,0.049382716,0,empty,CD-0722-2
"G6,F5",5952,6594,4371,2223,3958,2077,0,2081,1313,768,1.709635417,1198,2093,586,224,223,1,60,1,0.058295964,0,empty,CD-0722-2
"G6,F6",5839,6567,4207,2360,3932,2253,0,2253,1430,823,1.737545565,1296,2312,659,252,251,1,65,1,0.087649402,0,empty,CD-0722-2
"G6,F7",6968,7675,5157,2518,4556,2414,0,2416,1537,879,1.748577929,1303,1192,222,96,96,0,31,0,0.010416667,0,empty,CD-0722-2
"G6,F8",4666,5490,3384,2106,3259,1801,0,1803,1167,636,1.83490566,1037,221,50,40,39,1,16,1,0.179487179,0,empty,CD-0722-2
"G6,F9",5361,5901,4058,1843,3509,1748,0,1751,1199,552,2.172101449,932,2874,692,300,291,9,81,1,0.068728522,0,empty,CD-0722-2
"G6,F10",7160,7975,5344,2631,4655,2415,0,2417,1563,854,1.830210773,1341,1887,495,171,170,1,52,1,0.047058824,0,empty,CD-0722-2
"G6,F11",5067,5528,3931,1597,3300,1621,0,1622,1074,548,1.959854015,876,1339,269,106,106,0,33,0,0.20754717,0,empty,CD-0722-2
"G6,F12",5666,6399,4119,2280,3777,2022,0,2024,1359,665,2.043609023,1153,171,27,16,16,0,9,0,0.375,0,empty,CD-0722-2
"G6,G1",6383,7304,4742,2562,4274,2309,0,2313,1546,767,2.015645372,1326,3066,912,304,298,6,71,2,0.087248322,0,empty,CD-0722-2
"G6,G2",4012,4586,2764,1822,2741,1552,0,1555,967,588,1.644557823,956,648,107,41,36,5,12,2,0.277777778,0,empty,CD-0722-2
"G6,G3",7594,8554,5505,3049,5057,2809,0,2815,1651,1164,1.41838488,1621,2275,530,193,191,2,59,1,0.010471204,0,empty,CD-0722-2
"G6,G4",13087,15447,9226,6221,9270,5793,0,5800,3440,2360,1.457627119,3484,76,13,13,13,0,8,0,0,0,empty,CD-0722-2
"G6,G5",4411,5008,3221,1787,3151,1776,0,1779,1155,624,1.850961538,1052,1460,231,115,115,0,40,0,0.043478261,0,empty,CD-0722-2
"G6,G6",6179,6749,4572,2177,3971,2081,0,2081,1380,701,1.968616262,1130,214,21,11,10,1,4,1,0.1,0,empty,CD-0722-2
"G6,G7",5162,5860,3910,1950,3412,1760,0,1760,1154,606,1.904290429,962,3016,763,236,232,4,57,2,0.150862069,0,empty,CD-0722-2
"G6,G8",3536,3991,2620,1371,2345,1251,0,1251,795,456,1.743421053,695,1756,412,154,154,0,44,0,0.071428571,0,empty,CD-0722-2
"G6,G9",4320,4885,3146,1739,2883,1566,0,1567,986,581,1.69707401,885,2236,523,208,206,2,56,2,0.101941748,0,empty,CD-0722-2
"G6,G10",5028,5678,3691,1987,3389,1866,0,1867,1198,669,1.790732436,1050,1906,421,175,173,2,54,1,0.057803468,0,empty,CD-0722-2
"G6,G11",4881,5510,3551,1959,3340,1820,0,1822,1182,640,1.846875,1058,1418,267,99,99,0,28,0,0.121212121,0,empty,CD-0722-2
"G6,G12",4484,5167,3197,1970,3137,1755,0,1755,1163,592,1.964527027,1057,2370,595,254,252,2,59,2,0.138888889,0,empty,CD-0722-2
"G6,H1",5282,5829,3896,1933,3415,1780,0,1780,1239,541,2.290203327,1019,921,251,108,107,1,29,1,0.056074766,0,empty,CD-0722-2
"G6,H2",5085,5798,3646,2152,3513,1961,0,1963,1280,683,1.874084919,1161,2032,649,254,251,3,68,1,0.003984064,0,empty,CD-0722-2
"G6,H3",5017,5814,3630,2184,3427,1889,0,1889,1189,700,1.698571429,1097,2111,374,148,146,2,46,1,0.034246575,0,empty,CD-0722-2
"G6,H4",6412,7197,4643,2554,4325,2333,0,2337,1515,822,1.843065693,1328,201,78,32,32,0,12,0,0.0625,0,empty,CD-0722-2
"G6,H5",6975,7940,5013,2927,4684,2600,0,2606,1663,943,1.763520679,1516,2075,440,183,183,0,51,0,0.016393443,0,empty,CD-0722-2
"G6,H6",4891,5560,3548,2012,3300,1823,0,1825,1206,619,1.948303716,1041,2006,439,175,174,1,57,1,0.005747126,0,empty,CD-0722-2
"G6,H7",540157,623137,403346,219791,361280,194130,3,194305,152466,41839,3.644111953,113650,61185,10332,3830,3768,62,771,2,0.030254777,0,hg38,CD-0722-2
"G6,H8",5606,6581,4068,2513,3823,2208,0,2209,1413,796,1.775125628,1287,2340,515,205,200,5,47,1,0.13,0,empty,CD-0722-2
"G6,H9",4386,4722,3326,1396,2815,1447,0,1450,997,453,2.200883002,777,1089,372,158,158,0,43,0,0.012658228,0,empty,CD-0722-2
"G6,H10",4056,4666,3004,1662,2720,1472,0,1472,979,493,1.985801217,849,1304,257,111,110,1,47,1,0.090909091,0,empty,CD-0722-2
"G6,H11",5554,6701,3784,2917,4028,2653,0,2659,1418,1241,1.142626914,1637,23,4,3,1,2,1,1,0,0,empty,CD-0722-2
"G6,H12",4317,4931,3051,1880,2861,1681,0,1681,1105,576,1.918402778,1001,1376,232,85,84,1,29,1,0.166666667,0,empty,CD-0722-2
"G7,A1",4000,4591,2895,1696,2797,1588,0,1591,1014,577,1.757365685,929,1102,205,64,64,0,31,0,0.046875,0,empty,CD-0722-2
"G7,A2",5349,6138,3916,2222,3662,2055,0,2055,1295,760,1.703947368,1112,1745,324,148,148,0,55,0,0.060810811,0,empty,CD-0722-2
"G7,A3",3465,4006,2519,1487,2355,1363,0,1363,876,487,1.798767967,763,1343,230,109,106,3,43,2,0.132075472,0,empty,CD-0722-2
"G7,A4",6642,7618,4769,2849,4488,2456,0,2457,1589,868,1.830645161,1440,862,186,79,78,1,31,1,0.051282051,0,empty,CD-0722-2
"G7,A5",4767,5533,3411,2122,3279,1847,0,1855,1154,701,1.646219686,1128,2010,357,167,163,4,45,2,0.012269939,0,empty,CD-0722-2
"G7,A6",4244,4826,3094,1732,3030,1732,0,1732,1148,584,1.965753425,999,3085,912,325,321,4,99,2,0.043613707,0,empty,CD-0722-2
"G7,A7",3781,4269,2821,1448,2621,1477,0,1483,944,539,1.751391466,784,1075,266,109,106,3,46,1,0.141509434,0,empty,CD-0722-2
"G7,A8",597573,725282,436747,288535,425381,248911,2,249111,220317,28794,7.651489894,150577,347776,51740,20899,20477,422,2846,4,0.073985447,0,hg38,CD-0722-2
"G7,A9",764301,856022,585797,270225,493681,247835,1,248053,203888,44165,4.616506283,138831,65003,10596,4034,3933,101,796,4,0.031019578,0,hg38,CD-0722-2
"G7,A10",236561,267743,179504,88239,156482,81166,1,81233,61951,19282,3.212892853,45841,10796,1951,766,739,27,172,3,0.025710419,0,hg38,CD-0722-2
"G7,A11",3253,3664,2395,1269,2224,1177,0,1177,762,415,1.836144578,674,1309,343,152,151,1,57,1,0.026490066,0,empty,CD-0722-2
"G7,A12",478707,530642,370600,160042,304336,149811,5,149971,118793,31178,3.810154596,82734,82318,14683,5362,5261,101,971,6,0.017107014,0,hg38,CD-0722-2
"G7,B1",4163,4681,3055,1626,2838,1614,0,1614,1042,572,1.821678322,908,1449,417,159,158,1,33,1,0.126582278,0,empty,CD-0722-2
"G7,B2",4560,5215,3136,2079,3140,1933,0,1935,1239,696,1.780172414,1114,605,102,34,33,1,17,1,0.090909091,0,empty,CD-0722-2
"G7,B3",3246,3782,2351,1431,2341,1298,0,1298,835,463,1.803455724,786,1368,405,126,126,0,52,0,0.007936508,0,empty,CD-0722-2
"G7,B4",4018,4582,2822,1760,2716,1597,0,1603,976,627,1.55661882,912,1460,386,164,164,0,40,0,0.091463415,0,empty,CD-0722-2
"G7,B5",580769,337864,189517,148347,242793,146127,13,146935,114086,32849,3.473043319,95823,82982,10849,4119,4020,99,789,4,0.075870647,0,hg38,CD-0722-2
"G7,B6",4320,5256,3034,2222,3179,1876,0,1878,1222,656,1.862804878,1157,1503,374,149,147,2,45,2,0.088435374,0,empty,CD-0722-2
"G7,B7",4156,4748,3090,1658,2862,1522,0,1522,999,523,1.910133843,831,1432,225,90,86,4,33,2,0.046511628,0,empty,CD-0722-2
"G7,B8",2766,3150,2075,1075,1864,971,0,971,639,332,1.924698795,540,947,186,84,84,0,33,0,0,0,empty,CD-0722-2
"G7,B9",6035,6978,4284,2694,4163,2405,0,2405,1517,888,1.708333333,1450,1173,169,92,92,0,37,0,0.043478261,0,empty,CD-0722-2
"G7,B10",2846,3007,2041,966,1853,982,0,983,645,338,1.908284024,510,504,139,55,54,1,22,1,0,0,empty,CD-0722-2
"G7,B11",6665,7952,4677,3275,4741,2916,0,2921,1648,1273,1.294579733,1792,343,86,11,10,1,5,1,0,0,empty,CD-0722-2
"G7,B12",3472,3895,2524,1371,2375,1324,0,1324,896,428,2.093457944,770,1654,443,165,160,5,47,3,0.00625,0,empty,CD-0722-2
"G7,C1",7513,8101,5611,2490,4877,2542,0,2547,1614,933,1.729903537,1348,1129,267,109,109,0,36,0,0,0,empty,CD-0722-2
"G7,C2",655700,811734,465098,346636,471894,291982,1,292173,243595,48578,5.014512742,180623,66409,20140,7498,7444,54,1289,5,0.079930145,0,hg38,CD-0722-2
"G7,C3",6519,7329,4751,2578,4433,2476,0,2480,1580,900,1.755555556,1443,812,132,61,61,0,23,0,0.016393443,0,empty,CD-0722-2
"G7,C4",3656,4078,2717,1361,2500,1357,0,1358,891,467,1.907922912,722,1806,354,137,135,2,45,2,0.037037037,0,empty,CD-0722-2
"G7,C5",7082,8181,5144,3037,4882,2668,0,2668,1754,914,1.919037199,1600,2124,633,233,233,0,67,0,0.064377682,0,empty,CD-0722-2
"G7,C6",5354,5981,3861,2120,3671,2047,0,2047,1380,667,2.068965517,1151,1724,511,204,201,3,49,2,0.049751244,0,empty,CD-0722-2
"G7,C7",6488,7617,4544,3073,4598,2791,0,2795,1703,1092,1.55952381,1661,330,57,25,23,2,13,2,0.043478261,0,empty,CD-0722-2
"G7,C8",7093,7827,5135,2692,4812,2662,0,2663,1726,937,1.842049093,1521,2964,614,288,280,8,97,2,0.103571429,0,empty,CD-0722-2
"G7,C9",4981,5691,3652,2039,3387,1853,0,1853,1239,614,2.017915309,1051,1727,477,159,158,1,50,1,0.063291139,0,empty,CD-0722-2
"G7,C10",5829,6743,4274,2469,3972,2202,0,2205,1394,811,1.718865598,1269,1760,372,169,168,1,57,1,0.017857143,0,empty,CD-0722-2
"G7,C11",5011,5649,3606,2043,3314,1853,0,1853,1163,690,1.685507246,1062,1881,449,154,153,1,47,1,0.078431373,0,empty,CD-0722-2
"G7,C12",479412,543710,359524,184186,312830,163283,2,163435,120419,43016,2.799400223,94686,179514,15041,5956,5699,257,1135,8,0.040357958,0,hg38,CD-0722-2
"G7,D1",6243,7189,4514,2675,4324,2488,0,2488,1562,926,1.686825054,1445,846,152,47,47,0,17,0,0.021276596,0,empty,CD-0722-2
"G7,D2",488561,589118,351040,238078,344595,207037,0,207199,164150,43049,3.813096704,125288,39069,17178,6244,6214,30,1179,3,0.021725137,0,hg38,CD-0722-2
"G7,D3",4236,4841,3073,1768,2853,1617,0,1617,1060,557,1.903052065,875,1775,367,165,164,1,49,1,0.109756098,0,empty,CD-0722-2
"G7,D4",3239,3811,2387,1424,2302,1250,0,1252,804,448,1.794642857,736,1364,394,164,159,5,45,2,0.094339623,0,empty,CD-0722-2
"G7,D5",3745,4505,2731,1774,2652,1444,0,1447,957,490,1.953061224,854,1423,321,144,144,0,42,0,0.083333333,0,empty,CD-0722-2
"G7,D6",706190,846276,510491,335785,486880,285698,3,285933,230753,55180,4.181823124,172181,113886,23953,9271,9164,107,1496,4,0.047904845,0,hg38,CD-0722-2
"G7,D7",3413,3725,2531,1194,2324,1215,0,1218,782,436,1.793577982,660,2021,473,190,183,7,73,2,0.049180328,0,empty,CD-0722-2
"G7,D8",4148,4726,3070,1656,2834,1544,0,1544,1034,510,2.02745098,886,1285,351,161,156,5,47,2,0.012820513,0,empty,CD-0722-2
"G7,D9",2119,2614,1573,1041,1514,843,0,844,559,285,1.961403509,513,1661,645,201,197,4,48,2,0.076142132,0,empty,CD-0722-2
"G7,D10",6127,7219,4404,2815,4367,2571,0,2571,1786,785,2.275159236,1546,868,233,68,66,2,22,2,0,0,empty,CD-0722-2
"G7,D11",4293,4854,3177,1677,2956,1599,0,1599,992,607,1.634266886,890,3345,737,266,263,3,93,2,0.186311787,0,empty,CD-0722-2
"G7,D12",6225,6963,4537,2426,4131,2210,0,2213,1414,799,1.76971214,1227,3542,1039,372,368,4,123,2,0.100543478,0,empty,CD-0722-2
"G7,E1",7111,7977,5176,2801,4889,2779,0,2782,1769,1013,1.746298124,1586,2384,638,242,237,5,70,2,0.11814346,0,empty,CD-0722-2
"G7,E2",5109,5746,3666,2080,3483,1974,0,1976,1237,739,1.673883627,1138,1855,424,187,183,4,40,3,0.076502732,0,empty,CD-0722-2
"G7,E3",3710,4283,2726,1557,2569,1438,0,1442,960,482,1.991701245,799,2023,569,241,240,1,71,1,0.133333333,0,empty,CD-0722-2
"G7,E4",4576,5217,3369,1848,3154,1751,0,1753,1138,615,1.850406504,1013,2519,597,212,209,3,74,1,0.043062201,0,empty,CD-0722-2
"G7,E5",1023422,1122054,804829,317225,639364,300108,2,300391,237253,63138,3.757689506,162161,73008,17074,6130,6071,59,1034,5,0.030802174,0,hg38,CD-0722-2
"G7,E6",7622,8868,5545,3323,5226,2933,0,2935,1891,1044,1.811302682,1734,3799,900,367,361,6,111,2,0.04432133,0,empty,CD-0722-2
"G7,E7",6450,7233,4818,2415,4367,2282,0,2284,1537,747,2.057563588,1316,2755,557,224,224,0,77,0,0.058035714,0,empty,CD-0722-2
"G7,E8",5535,6372,4148,2224,3718,1934,0,1935,1281,654,1.958715596,1090,2282,572,244,238,6,69,2,0.012605042,0,empty,CD-0722-2
"G7,E9",3315,3789,2417,1372,2275,1242,0,1242,803,439,1.829157175,718,2487,724,317,313,4,98,2,0.006389776,0,empty,CD-0722-2
"G7,E10",4278,4815,3144,1671,2952,1560,0,1569,1009,560,1.801785714,926,1375,277,95,94,1,40,1,0.031914894,0,empty,CD-0722-2
"G7,E11",5059,5737,3655,2082,3400,1885,0,1888,1187,701,1.693295292,1070,2255,599,242,238,4,53,2,0.033613445,0,empty,CD-0722-2
"G7,E12",5128,5962,3682,2280,3517,1922,0,1925,1247,678,1.839233038,1151,1793,326,157,157,0,65,0,0.076433121,0,empty,CD-0722-2
"G7,F1",545818,625795,411822,213973,362455,191970,2,192104,142005,50099,2.834487714,111502,59029,15841,6042,5965,77,989,4,0.03503772,0,hg38,CD-0722-2
"G7,F2",4831,5424,3495,1929,3207,1736,0,1737,1171,566,2.068904594,1024,2527,618,264,264,0,73,0,0.079545455,0,empty,CD-0722-2
"G7,F3",4630,5149,3473,1676,3089,1563,0,1563,993,570,1.742105263,889,2350,384,192,190,2,68,2,0.063157895,0,empty,CD-0722-2
"G7,F4",734001,842858,549212,293646,488677,264344,3,264560,202045,62515,3.231944333,153322,32215,3873,1547,1487,60,322,4,0.092131809,0,hg38,CD-0722-2
"G7,F5",502418,559579,381288,178291,322873,163625,1,163767,128468,35299,3.639423213,92116,48333,11475,4102,4049,53,742,3,0.022474685,0,hg38,CD-0722-2
"G7,F6",5952,6684,4423,2261,3880,2161,0,2161,1465,696,2.104885057,1179,3271,879,334,334,0,95,0,0.074850299,0,empty,CD-0722-2
"G7,F7",6637,7265,4877,2388,4383,2348,0,2348,1559,789,1.975918885,1291,1207,209,108,105,3,34,2,0.047619048,0,empty,CD-0722-2
"G7,F8",4476,4967,3354,1613,3018,1595,0,1595,1050,545,1.926605505,864,301,36,27,27,0,18,0,0.037037037,0,empty,CD-0722-2
"G7,F9",4812,5381,3623,1758,3263,1694,0,1694,1140,554,2.057761733,901,2634,609,267,266,1,88,1,0.097744361,0,empty,CD-0722-2
"G7,F10",6163,6884,4557,2327,4263,2236,0,2241,1523,718,2.121169916,1242,1860,421,146,146,0,41,0,0.082191781,0,empty,CD-0722-2
"G7,F11",4579,4924,3405,1519,2996,1518,0,1522,1031,491,2.099796334,821,1668,390,174,173,1,44,1,0.150289017,0,empty,CD-0722-2
"G7,F12",5602,6417,4053,2364,3770,2023,0,2025,1330,695,1.913669065,1187,243,55,26,26,0,10,0,0,0,empty,CD-0722-2
"G7,G1",368699,472114,243286,228828,281552,196199,0,196307,147010,49297,2.98212873,125085,20349,7592,2545,2537,8,625,3,0.022861648,0,hg38,CD-0722-2
"G7,G2",516437,621391,354562,266829,363734,222276,0,222398,182871,39527,4.626483163,137699,37310,7051,2578,2537,41,517,2,0.060701616,0,hg38,CD-0722-2
"G7,G3",7877,8739,5799,2940,5231,2856,0,2860,1764,1096,1.609489051,1538,2608,675,230,227,3,64,2,0.110132159,0,empty,CD-0722-2
"G7,G4",11867,13914,8294,5620,8324,5037,0,5050,3025,2025,1.49382716,2978,144,17,14,14,0,13,0,0.071428571,0,empty,CD-0722-2
"G7,G5",3839,4391,2729,1662,2618,1467,0,1469,958,511,1.874755382,882,1479,365,166,166,0,58,0,0.018072289,0,empty,CD-0722-2
"G7,G6",1185302,1419765,884457,535308,804748,467676,1,468044,389845,78199,4.98529393,275005,14562,2734,1090,1085,5,245,2,0.05437788,0,hg38,CD-0722-2
"G7,G7",4429,4837,3317,1520,2939,1494,0,1494,967,527,1.834914611,821,2286,456,218,217,1,61,1,0.041474654,0,empty,CD-0722-2
"G7,G8",3349,3825,2471,1354,2271,1243,0,1243,828,415,1.995180723,695,1591,344,140,139,1,55,1,0.086330935,0,empty,CD-0722-2
"G7,G9",4216,4701,3067,1634,2824,1538,0,1538,1015,523,1.940726577,898,2567,680,238,236,2,66,2,0.063559322,0,empty,CD-0722-2
"G7,G10",4774,5540,3451,2089,3368,1961,0,1961,1267,694,1.825648415,1160,2290,692,266,262,4,64,2,0.011450382,0,empty,CD-0722-2
"G7,G11",4871,5422,3654,1768,3274,1691,0,1695,1148,547,2.098720293,941,1490,349,141,141,0,51,0,0.106382979,0,empty,CD-0722-2
"G7,G12",4242,4896,3062,1834,3022,1714,0,1714,1174,540,2.174074074,1001,2272,511,229,226,3,81,2,0.03539823,0,empty,CD-0722-2
"G7,H1",909516,1069076,653530,415546,620541,373039,4,373324,296756,76568,3.875718316,221682,34991,11754,4268,4234,34,740,3,0.013226264,0,hg38,CD-0722-2
"G7,H2",4730,5223,3413,1810,3169,1725,0,1727,1098,629,1.745627981,973,2549,664,237,234,3,64,1,0.111111111,0,empty,CD-0722-2
"G7,H3",3841,4338,2685,1653,2640,1504,0,1505,1011,494,2.046558704,879,1543,337,149,147,2,53,1,0.013605442,0,empty,CD-0722-2
"G7,H4",6244,6974,4607,2367,4043,2171,0,2173,1425,748,1.905080214,1225,229,22,12,12,0,9,0,0,0,empty,CD-0722-2
"G7,H5",6719,7925,4741,3184,4642,2634,0,2637,1681,956,1.758368201,1613,1988,517,215,213,2,75,2,0.042253521,0,empty,CD-0722-2
"G7,H6",3587,4164,2538,1626,2524,1491,0,1492,1006,486,2.069958848,884,2104,442,177,172,5,54,2,0.005813953,0,empty,CD-0722-2
"G7,H7",4563,5015,3333,1682,3118,1634,0,1637,1075,562,1.912811388,937,2319,728,296,295,1,92,1,0.061016949,0,empty,CD-0722-2
"G7,H8",4869,5574,3504,2070,3369,1919,0,1919,1219,700,1.741428571,1142,2310,536,213,211,2,66,2,0.075829384,0,empty,CD-0722-2
"G7,H9",3705,4105,2799,1306,2495,1279,0,1281,863,418,2.064593301,710,1394,434,169,168,1,38,1,0.017857143,0,empty,CD-0722-2
"G7,H10",403753,448666,310832,137834,259884,125713,2,125842,98156,27686,3.54532977,70611,41120,8315,2993,2939,54,627,7,0.010888057,0,hg38,CD-0722-2
"G7,H11",4781,5885,3273,2612,3573,2323,0,2325,1335,990,1.348484848,1456,106,8,3,3,0,3,0,0,0,empty,CD-0722-2
"G7,H12",3660,4082,2590,1492,2408,1348,0,1348,915,433,2.113163972,775,1948,485,207,205,2,52,1,0.307317073,0,empty,CD-0722-2
"G8,A1",3588,4218,2563,1655,2505,1463,0,1466,958,508,1.885826772,876,1148,266,137,136,1,45,1,0.066176471,0,empty,CD-0722-2
"G8,A2",5135,5706,3800,1906,3480,1960,0,1960,1254,706,1.776203966,1086,1601,371,177,177,0,47,0,0.016949153,0,empty,CD-0722-2
"G8,A3",3201,3622,2253,1369,2196,1206,0,1206,771,435,1.772413793,744,1076,158,80,80,0,38,0,0.0625,0,empty,CD-0722-2
"G8,A4",5710,6463,4194,2269,3897,2131,0,2134,1373,761,1.804204993,1230,555,124,59,58,1,20,1,0.120689655,0,empty,CD-0722-2
"G8,A5",4520,5078,3237,1841,3055,1672,0,1672,1040,632,1.64556962,960,1838,599,224,223,1,51,1,0.031390135,0,empty,CD-0722-2
"G8,A6",12207,13653,9134,4519,8182,4169,0,4177,3120,1057,2.951750237,2421,2179,620,233,232,1,85,1,0.056034483,0,empty,CD-0722-2
"G8,A7",3265,3706,2257,1449,2204,1272,0,1272,845,427,1.978922717,746,956,222,56,52,4,25,1,0.134615385,0,empty,CD-0722-2
"G8,A8",1943,2328,1390,938,1462,826,0,827,529,298,1.775167785,531,1535,343,134,134,0,43,0,0.298507463,0,empty,CD-0722-2
"G8,A9",3755,4269,2779,1490,2451,1292,0,1296,850,446,1.905829596,708,1533,396,154,150,4,45,3,0.073333333,0,empty,CD-0722-2
"G8,A10",4271,4751,3191,1560,2851,1517,0,1519,953,566,1.683745583,859,302,58,23,23,0,14,0,0.043478261,0,empty,CD-0722-2
"G8,A11",3167,3547,2420,1127,2126,1100,0,1100,717,383,1.872062663,609,1390,345,160,160,0,41,0,0.025,0,empty,CD-0722-2
"G8,A12",4529,5069,3326,1743,3043,1639,0,1639,1058,581,1.820998279,953,2680,534,243,243,0,71,0,0.041152263,0,empty,CD-0722-2
"G8,B1",3826,4312,2765,1547,2629,1468,0,1469,941,528,1.78219697,842,963,150,79,79,0,37,0,0,0,empty,CD-0722-2
"G8,B2",4202,4785,2837,1948,2930,1783,0,1784,1146,638,1.796238245,1096,530,122,44,42,2,17,1,0,0,empty,CD-0722-2
"G8,B3",3295,3823,2359,1464,2374,1363,0,1363,929,434,2.140552995,840,1295,211,105,99,6,41,2,0.050505051,0,empty,CD-0722-2
"G8,B4",16145,18431,12384,6047,10609,5650,0,5654,3874,1780,2.176404494,3163,4132,542,216,211,5,68,2,0.071090047,0,empty,CD-0722-2
"G8,B5",3948,2284,1432,852,1715,949,0,952,609,343,1.775510204,611,1098,158,69,69,0,28,0,0.057971014,0,empty,CD-0722-2
"G8,B6",4295,5132,2995,2137,3095,1855,0,1857,1123,734,1.529972752,1159,1341,334,147,143,4,49,1,0,0,empty,CD-0722-2
"G8,B7",3920,4447,2973,1474,2677,1412,0,1412,946,466,2.030042918,771,1042,282,124,124,0,30,0,0.048387097,0,empty,CD-0722-2
"G8,B8",3115,3555,2361,1194,2163,1194,0,1194,793,401,1.97755611,648,1008,229,105,105,0,36,0,0.019047619,0,empty,CD-0722-2
"G8,B9",5662,6554,4045,2509,3851,2173,0,2176,1323,853,1.550996483,1283,1104,256,84,84,0,44,0,0.011904762,0,empty,CD-0722-2
"G8,B10",2655,2808,1969,839,1723,883,0,887,567,320,1.771875,451,237,42,19,19,0,8,0,0.210526316,0,empty,CD-0722-2
"G8,B11",7227,8393,5135,3258,4928,2958,0,2960,1669,1291,1.292796282,1733,198,22,18,18,0,10,0,0,0,empty,CD-0722-2
"G8,B12",3338,3806,2440,1366,2333,1320,1,1325,863,462,1.867965368,781,1287,173,113,112,1,45,1,0.1875,0,empty,CD-0722-2
"G8,C1",8298,9560,5974,3586,5643,3187,0,3192,1616,1576,1.025380711,1915,1378,205,118,115,3,63,2,0.043478261,0,empty,CD-0722-2
"G8,C2",556087,655068,410740,244328,372857,208976,1,209146,164172,44974,3.650375773,124404,137482,20028,7930,7758,172,1318,8,0.068703274,0,hg38,CD-0722-2
"G8,C3",5976,6661,4322,2339,3990,2147,0,2151,1365,786,1.736641221,1229,823,158,62,61,1,21,1,0.180327869,0,empty,CD-0722-2
"G8,C4",3677,3937,2703,1234,2411,1208,0,1210,801,409,1.958435208,667,1501,463,163,162,1,45,1,0.049382716,0,empty,CD-0722-2
"G8,C5",4983,5564,3811,1753,3279,1695,0,1695,1091,604,1.806291391,902,1204,270,125,123,2,39,1,0.008130081,0,empty,CD-0722-2
"G8,C6",5337,6056,3879,2177,3598,2031,0,2037,1338,699,1.91416309,1163,1363,316,127,127,0,34,0,0.007874016,0,empty,CD-0722-2
"G8,C7",6370,7648,4449,3199,4587,2816,0,2824,1695,1129,1.501328609,1764,367,66,29,29,0,7,0,0,0,empty,CD-0722-2
"G8,C8",6442,7353,4694,2659,4412,2492,0,2493,1656,837,1.978494624,1412,2310,488,186,185,1,73,1,0.043243243,0,empty,CD-0722-2
"G8,C9",4570,5248,3269,1979,3170,1768,0,1768,1139,629,1.810810811,1068,1250,179,67,65,2,29,2,0.076923077,0,empty,CD-0722-2
"G8,C10",5508,6196,4082,2114,3612,1869,0,1870,1222,648,1.885802469,1046,1720,327,115,115,0,35,0,0.086956522,0,empty,CD-0722-2
"G8,C11",4601,5187,3297,1890,3164,1747,1,1750,1136,614,1.850162866,1017,1491,386,181,180,1,42,1,0.083333333,0,empty,CD-0722-2
"G8,C12",6579,7301,4861,2440,4470,2411,0,2414,1644,770,2.135064935,1372,1767,560,177,176,1,49,1,0.159090909,0,empty,CD-0722-2
"G8,D1",5985,6914,4241,2673,4075,2420,0,2423,1505,918,1.639433551,1436,1204,188,73,73,0,22,0,0.136986301,0,empty,CD-0722-2
"G8,D2",5057,5400,3861,1539,3245,1621,0,1623,1026,597,1.718592965,840,2052,672,273,272,1,77,1,0.040441176,0,empty,CD-0722-2
"G8,D3",4217,4835,3026,1809,2838,1602,0,1606,1057,549,1.925318761,951,1029,201,98,96,2,36,2,0.270833333,0,empty,CD-0722-2
"G8,D4",3235,3695,2342,1353,2201,1242,0,1242,787,455,1.72967033,710,963,170,57,56,1,23,1,0.053571429,0,empty,CD-0722-2
"G8,D5",3818,4303,2773,1530,2614,1434,0,1434,945,489,1.932515337,845,1280,348,131,128,3,32,2,0.2890625,0,empty,CD-0722-2
"G8,D6",6200,6910,4465,2445,4096,2384,0,2384,1451,933,1.555198285,1322,1506,392,143,141,2,36,1,0,0,empty,CD-0722-2
"G8,D7",422091,489974,312664,177310,281196,154490,1,154646,121504,33142,3.66616378,90400,154508,15892,6284,6103,181,1206,7,0.073078814,0,hg38,CD-0722-2
"G8,D8",3834,4300,2799,1501,2611,1449,0,1449,911,538,1.69330855,850,1140,326,112,109,3,38,1,0,0,empty,CD-0722-2
"G8,D9",2074,2325,1572,753,1357,711,0,711,430,281,1.53024911,383,1011,369,139,138,1,35,1,0.15942029,0,empty,CD-0722-2
"G8,D10",541995,677991,385008,292983,388978,238714,2,238880,188229,50651,3.716195139,150478,59921,8874,3646,3553,93,696,3,0.05150577,0,hg38,CD-0722-2
"G8,D11",4421,4926,3215,1711,2969,1591,0,1591,1034,557,1.856373429,883,2432,533,232,229,3,93,2,0.017467249,0,empty,CD-0722-2
"G8,D12",5333,6153,3868,2285,3646,2014,0,2016,1349,667,2.022488756,1150,2173,616,247,245,2,78,1,0.110204082,0,empty,CD-0722-2
"G8,E1",6551,7372,4836,2536,4428,2463,1,2468,1449,1019,1.421982336,1387,1848,451,148,147,1,49,1,0.013605442,0,empty,CD-0722-2
"G8,E2",4781,5574,3414,2160,3285,1899,0,1904,1193,711,1.677918425,1122,1773,486,199,198,1,61,1,0.005050505,0,empty,CD-0722-2
"G8,E3",3413,3962,2563,1399,2338,1238,0,1240,780,460,1.695652174,742,1678,479,181,180,1,53,1,0.083333333,0,empty,CD-0722-2
"G8,E4",516294,604766,387940,216826,346025,186977,1,187137,144776,42361,3.417671915,110292,112837,13826,5490,5344,146,1058,5,0.055389222,0,hg38,CD-0722-2
"G8,E5",3986,4430,2950,1480,2712,1402,0,1406,923,483,1.910973085,787,1251,257,108,106,2,31,2,0.08490566,0,empty,CD-0722-2
"G8,E6",8118,9389,5962,3427,5442,3036,0,3036,2010,1026,1.959064327,1731,2910,739,260,253,7,74,3,0.023715415,0,empty,CD-0722-2
"G8,E7",708734,780324,542107,238217,443278,220296,0,220500,178514,41986,4.251750584,122445,70881,10973,4268,4199,69,877,5,0.020719219,0,hg38,CD-0722-2
"G8,E8",514444,576198,393371,182827,329144,165547,1,165708,124241,41467,2.99614151,92813,114929,11497,4538,4373,165,917,4,0.045735193,0,hg38,CD-0722-2
"G8,E9",3363,4017,2490,1527,2383,1311,0,1312,868,444,1.954954955,780,1799,452,194,191,3,63,2,0.041884817,0,empty,CD-0722-2
"G8,E10",3764,4332,2748,1584,2583,1404,0,1405,935,470,1.989361702,797,2550,586,229,225,4,55,1,0.057777778,0,empty,CD-0722-2
"G8,E11",4613,5100,3416,1684,3122,1717,1,1719,1094,625,1.7504,952,1614,297,118,111,7,47,2,0,0,empty,CD-0722-2
"G8,E12",4835,5819,3497,2322,3472,1946,0,1950,1219,731,1.667578659,1188,1334,263,124,121,3,42,1,0.107438017,0,empty,CD-0722-2
"G8,F1",5996,6608,4373,2235,3974,2130,0,2134,1403,731,1.919288646,1197,1846,448,194,194,0,67,0,0.046391753,0,empty,CD-0722-2
"G8,F2",4280,4839,3024,1815,2907,1543,0,1543,1000,543,1.841620626,890,1964,629,253,252,1,62,1,0.035714286,0,empty,CD-0722-2
"G8,F3",4356,5102,3192,1910,3004,1612,0,1612,1059,553,1.915009042,949,2071,430,187,183,4,59,2,0.120218579,0,empty,CD-0722-2
"G8,F4",606588,683811,460606,223205,394602,200852,11,201048,155680,45368,3.431493564,114469,23020,3134,1075,1047,28,241,2,0.049665712,0,hg38,CD-0722-2
"G8,F5",5288,5744,3919,1825,3536,1860,1,1865,1226,639,1.918622848,1027,1584,252,118,118,0,51,0,0,0,empty,CD-0722-2
"G8,F6",5122,5916,3769,2147,3534,1975,0,1976,1214,762,1.593175853,1152,1913,466,164,164,0,52,0,0.073170732,0,empty,CD-0722-2
"G8,F7",5784,6388,4304,2084,3806,2035,0,2041,1380,661,2.08774584,1095,873,145,82,82,0,32,0,0.024390244,0,empty,CD-0722-2
"G8,F8",4325,4924,3127,1797,3009,1662,0,1662,1126,536,2.100746269,966,432,117,48,41,7,14,1,0.024390244,0,empty,CD-0722-2
"G8,F9",4836,5283,3606,1677,3234,1712,0,1712,1119,593,1.887015177,951,2464,545,242,240,2,71,1,0.020833333,0,empty,CD-0722-2
"G8,F10",6015,6857,4509,2348,3988,2063,0,2066,1306,760,1.718421053,1170,1674,622,252,250,2,57,1,0.12,0,empty,CD-0722-2
"G8,F11",4421,4886,3334,1552,2920,1500,0,1502,1042,460,2.265217391,838,1134,181,62,61,1,29,1,0,0,empty,CD-0722-2
"G8,F12",12573,14448,9464,4984,8225,4343,0,4345,3116,1229,2.53539463,2478,946,78,29,29,0,11,0,0,0,empty,CD-0722-2
"G8,G1",5661,6332,4261,2071,3673,1867,0,1871,1160,711,1.631504923,1011,2443,588,224,224,0,67,0,0.049107143,0,empty,CD-0722-2
"G8,G2",4104,4556,2893,1663,2809,1619,0,1621,998,623,1.601926164,927,406,68,46,45,1,28,1,0,0,empty,CD-0722-2
"G8,G3",6173,6813,4485,2328,4094,2260,0,2261,1362,899,1.515016685,1207,1779,518,209,202,7,54,2,0.123762376,0,empty,CD-0722-2
"G8,G4",11353,13235,8137,5098,7835,4710,0,4711,2870,1841,1.558935361,2770,89,12,8,8,0,7,0,0,0,empty,CD-0722-2
"G8,G5",3545,4070,2619,1451,2450,1318,0,1324,870,454,1.916299559,768,1380,313,120,116,4,42,1,0.068965517,0,empty,CD-0722-2
"G8,G6",700829,822012,522814,299198,466616,260016,0,260279,203911,56368,3.617495742,151791,7206,1309,543,543,0,121,0,0.077348066,0,hg38,CD-0722-2
"G8,G7",4115,4648,3093,1555,2747,1402,0,1402,923,479,1.926931106,806,1886,527,149,148,1,45,1,0.135135135,0,empty,CD-0722-2
"G8,G8",425851,507742,310996,196746,293732,167046,2,167154,128519,38635,3.326491523,101591,99833,12558,4928,4774,154,928,4,0.047130289,0,hg38,CD-0722-2
"G8,G9",3829,4247,2833,1414,2599,1415,0,1418,903,515,1.753398058,798,1633,378,172,171,1,53,1,0.210526316,0,empty,CD-0722-2
"G8,G10",4292,4997,3190,1807,3005,1665,0,1665,1136,529,2.147448015,918,1589,358,121,119,2,41,1,0.12605042,0,empty,CD-0722-2
"G8,G11",4596,5048,3396,1652,3024,1596,0,1603,1066,537,1.985102421,888,1478,348,156,154,2,44,2,0.019480519,0,empty,CD-0722-2
"G8,G12",4130,4836,2980,1856,2880,1594,0,1594,1042,552,1.887681159,968,2359,441,172,170,2,68,2,0.141176471,0,empty,CD-0722-2
"G8,H1",4233,4768,3128,1640,2770,1432,0,1432,939,493,1.904665314,837,1178,320,120,119,1,42,1,0.067226891,0,empty,CD-0722-2
"G8,H2",4502,5085,3257,1828,2997,1617,0,1619,1061,558,1.901433692,924,2413,599,235,232,3,69,1,0.081896552,0,empty,CD-0722-2
"G8,H3",2417789,3009150,1710304,1298846,1675599,1060985,3,1061746,882903,178843,4.936748992,662246,244380,52819,20264,20035,229,2789,10,0.05700025,0,hg38,CD-0722-2
"G8,H4",10213,11631,7637,3994,6694,3500,0,3502,2474,1028,2.406614786,1951,128,20,13,13,0,9,0,0.307692308,0,empty,CD-0722-2
"G8,H5",6308,7193,4607,2586,4307,2369,0,2369,1512,857,1.764294049,1391,1510,467,195,194,1,66,1,0.036082474,0,empty,CD-0722-2
"G8,H6",3741,4167,2737,1430,2453,1384,0,1385,898,487,1.843942505,764,1582,368,129,124,5,44,1,0.064516129,0,empty,CD-0722-2
"G8,H7",4268,4953,3133,1820,3052,1743,0,1743,1112,631,1.762282092,1032,1245,326,155,155,0,69,0,0.103225806,0,empty,CD-0722-2
"G8,H8",471230,550685,352926,197759,312810,169261,1,169414,127539,41875,3.045707463,99942,108838,10118,4065,3870,195,849,4,0.070284238,0,hg38,CD-0722-2
"G8,H9",3588,3918,2688,1230,2370,1209,0,1211,818,393,2.081424936,677,1128,274,124,124,0,35,0,0.048387097,0,empty,CD-0722-2
"G8,H10",23142,27195,17317,9878,15512,8334,0,8348,6452,1896,3.402953586,4860,7470,1249,458,449,9,146,2,0.066815145,0,empty,CD-0722-2
"G8,H11",4765,5710,3260,2450,3378,2221,0,2221,1207,1014,1.190335306,1324,42,5,3,3,0,2,0,0.333333333,0,empty,CD-0722-2
"G8,H12",3516,3807,2500,1307,2276,1260,0,1260,808,452,1.787610619,705,1051,250,78,75,3,26,2,0.24,0,empty,CD-0722-2
"G9,A1",3603,4196,2563,1633,2529,1452,0,1458,922,536,1.720149254,867,1173,256,127,127,0,48,0,0.047244094,0,empty,CD-0722-2
"G9,A2",433556,501523,322370,179153,288228,158797,1,158969,126112,32857,3.838207992,92095,123171,19266,8967,8802,165,1497,6,0.054987503,0,hg38,CD-0722-2
"G9,A3",3344,3802,2465,1337,2295,1276,0,1280,812,468,1.735042735,716,1241,358,163,163,0,56,0,0.116564417,0,empty,CD-0722-2
"G9,A4",2103744,2523253,1546480,976773,1400802,839303,4,839895,687511,152384,4.511700703,496673,89440,16590,7014,6900,114,1352,4,0.041884058,0,hg38,CD-0722-2
"G9,A5",4730,5374,3420,1954,3213,1742,0,1743,1088,655,1.661068702,1042,1995,477,172,172,0,58,0,0.081395349,0,empty,CD-0722-2
"G9,A6",15425,17580,11259,6321,10412,5789,0,5794,4478,1316,3.402735562,3319,2915,595,280,276,4,89,2,0.057971014,0,empty,CD-0722-2
"G9,A7",3494,3940,2478,1462,2388,1344,0,1344,878,466,1.884120172,775,1352,261,115,113,2,47,2,0.053097345,0,empty,CD-0722-2
"G9,A8",2226,2585,1663,922,1484,812,0,815,529,286,1.84965035,448,1952,408,190,189,1,83,1,0.047619048,0,empty,CD-0722-2
"G9,A9",3798,4264,2867,1397,2509,1335,0,1335,854,481,1.775467775,734,1759,355,158,157,1,57,1,0.031847134,0,empty,CD-0722-2
"G9,A10",4282,4921,3218,1703,2913,1594,0,1595,1065,530,2.009433962,889,469,65,43,41,2,26,2,0.073170732,0,empty,CD-0722-2
"G9,A11",1247285,1486374,920282,566092,843574,488044,1,488387,391648,96739,4.048501638,289102,301317,51759,21261,20957,304,2874,7,0.056830653,0,hg38,CD-0722-2
"G9,A12",4793,5188,3570,1618,3088,1604,0,1606,1068,538,1.985130112,876,3183,863,373,369,4,121,1,0.08401084,0,empty,CD-0722-2
"G9,B1",4014,4647,2960,1687,2797,1602,0,1605,965,640,1.5078125,932,1316,374,135,131,4,56,1,0,0,empty,CD-0722-2
"G9,B2",4207,4756,2841,1915,2901,1733,0,1735,1089,646,1.685758514,1011,605,93,43,41,2,24,1,0,0,empty,CD-0722-2
"G9,B3",809771,965213,607144,358069,555732,310632,2,310880,254106,56774,4.47574594,184190,197620,32685,14529,14288,241,2196,9,0.069918813,0,hg38,CD-0722-2
"G9,B4",3782,4276,2733,1543,2527,1482,0,1482,941,541,1.739371534,832,1350,414,214,213,1,54,1,0.107981221,0,empty,CD-0722-2
"G9,B5",7744,6698,4219,2479,4475,2484,0,2494,1857,637,2.91522763,1544,939,194,94,94,0,37,0,0.180851064,0,empty,CD-0722-2
"G9,B6",4646,5260,3334,1926,3115,1784,1,1787,1113,674,1.651335312,1015,1333,483,208,208,0,55,0,0.043269231,0,empty,CD-0722-2
"G9,B7",586995,706269,428207,278062,406175,238605,0,238768,209016,29752,7.025275612,142000,102210,22797,9068,8941,127,1543,8,0.037579689,0,hg38,CD-0722-2
"G9,B8",2983,3320,2200,1120,2064,1110,0,1110,695,415,1.674698795,638,1171,256,137,134,3,62,2,0,0,empty,CD-0722-2
"G9,B9",5915,6657,4283,2374,4041,2278,0,2278,1415,863,1.6396292,1302,1211,321,145,142,3,52,3,0.161971831,0,empty,CD-0722-2
"G9,B10",2762,3053,1920,1133,1877,1028,0,1028,641,387,1.656330749,614,528,122,60,58,2,17,2,0.172413793,0,empty,CD-0722-2
"G9,B11",7060,8228,5042,3186,4851,2847,0,2850,1601,1249,1.28182546,1712,384,58,31,30,1,21,1,0.1,0,empty,CD-0722-2
"G9,B12",3437,4073,2473,1600,2472,1382,0,1384,911,473,1.926004228,839,1780,396,157,155,2,50,1,0.193548387,0,empty,CD-0722-2
"G9,C1",7064,7925,5355,2570,4676,2479,0,2479,1549,930,1.665591398,1362,840,247,108,107,1,35,1,0.018691589,0,empty,CD-0722-2
"G9,C2",5872,6791,4197,2594,4128,2381,0,2381,1522,859,1.771827707,1408,2566,604,280,279,1,86,1,0.075268817,0,empty,CD-0722-2
"G9,C3",662265,808758,483048,325710,464732,275120,3,275327,207886,67441,3.082486914,168059,26597,4211,1695,1669,26,390,3,0.014979029,0,hg38,CD-0722-2
"G9,C4",3638,3945,2767,1178,2428,1241,0,1241,831,410,2.026829268,682,1438,259,127,126,1,54,1,0,0,empty,CD-0722-2
"G9,C5",5358,6101,3952,2149,3611,2005,0,2005,1328,677,1.961595273,1139,1501,300,154,153,1,51,1,0.019607843,0,empty,CD-0722-2
"G9,C6",4574,5142,3292,1850,3175,1764,0,1764,1158,606,1.910891089,1042,1635,431,200,198,2,62,2,0.080808081,0,empty,CD-0722-2
"G9,C7",6514,7702,4595,3107,4611,2782,0,2788,1642,1146,1.432809773,1667,456,97,55,55,0,26,0,0.018181818,0,empty,CD-0722-2
"G9,C8",6858,7720,5117,2603,4627,2522,0,2527,1697,830,2.044578313,1424,3081,734,318,314,4,104,2,0.152866242,0,empty,CD-0722-2
"G9,C9",500071,589954,372569,217385,339738,187397,2,187590,142265,45325,3.13877551,111813,56198,4882,2135,2038,97,509,5,0.054465162,0,hg38,CD-0722-2
"G9,C10",494635,620199,338171,282028,359954,247073,1,247250,172759,74491,2.319192923,151333,4823,778,297,288,9,94,3,0.204861111,0,hg38,CD-0722-2
"G9,C11",4598,5109,3329,1780,3109,1681,0,1683,1089,594,1.833333333,947,1919,500,254,253,1,72,1,0.079051383,0,empty,CD-0722-2
"G9,C12",6255,7077,4586,2491,4343,2364,0,2367,1587,780,2.034615385,1377,2144,545,243,238,5,84,3,0.058823529,0,empty,CD-0722-2
"G9,D1",5920,6622,4244,2378,3995,2269,0,2269,1355,914,1.48249453,1290,847,143,80,79,1,30,1,0.215189873,0,empty,CD-0722-2
"G9,D2",5155,5748,3859,1889,3410,1805,0,1805,1232,573,2.15008726,993,2576,716,329,322,7,108,2,0.01863354,0,empty,CD-0722-2
"G9,D3",4434,5119,3130,1989,2992,1689,0,1693,1128,565,1.996460177,1014,1465,343,166,160,6,53,2,0.075,0,empty,CD-0722-2
"G9,D4",611044,721960,454971,266989,412414,231647,0,231798,191199,40599,4.709450972,136450,33895,3707,1528,1487,41,428,4,0.039004707,0,hg38,CD-0722-2
"G9,D5",3924,4526,2852,1674,2676,1457,0,1457,955,502,1.902390438,853,1795,470,201,200,1,74,1,0.09,0,empty,CD-0722-2
"G9,D6",6301,7205,4492,2713,4336,2569,0,2570,1562,1008,1.549603175,1522,2128,528,251,251,0,75,0,0.103585657,0,empty,CD-0722-2
"G9,D7",322919,360929,245723,115206,208369,105016,1,105144,82370,22774,3.616843769,59718,46469,8485,3403,3340,63,666,4,0.040419162,0,hg38,CD-0722-2
"G9,D8",3910,4467,2866,1601,2657,1428,0,1433,948,485,1.954639175,816,1462,417,220,218,2,75,1,0.123853211,0,empty,CD-0722-2
"G9,D9",1925,2143,1418,725,1333,708,0,708,491,217,2.262672811,392,1131,242,108,108,0,44,0,0.055555556,0,empty,CD-0722-2
"G9,D10",3856,4372,2731,1641,2639,1477,1,1478,914,564,1.620567376,868,1030,175,77,73,4,33,1,0.01369863,0,empty,CD-0722-2
"G9,D11",4049,4530,3102,1428,2796,1449,0,1451,966,485,1.991752577,786,2670,665,315,311,4,97,2,0.096463023,0,empty,CD-0722-2
"G9,D12",5751,6652,4156,2496,3914,2124,0,2124,1346,778,1.730077121,1233,3037,770,398,393,5,146,2,0.058524173,0,empty,CD-0722-2
"G9,E1",6777,7803,4938,2865,4589,2576,0,2581,1573,1008,1.560515873,1495,2162,534,248,247,1,84,1,0.036437247,0,empty,CD-0722-2
"G9,E2",876540,982304,666977,315327,562911,290070,2,290342,239035,51307,4.658915937,164925,106335,13688,5981,5836,145,1104,7,0.025017135,0,hg38,CD-0722-2
"G9,E3",412859,481139,311294,169845,278425,148705,2,148839,129624,19215,6.745979703,86342,114170,22052,9599,9463,136,1564,4,0.043643665,0,hg38,CD-0722-2
"G9,E4",4718,5316,3341,1975,3183,1739,0,1745,1084,661,1.639939486,1038,2716,691,285,280,5,101,2,0.053571429,0,empty,CD-0722-2
"G9,E5",3901,4381,2946,1435,2641,1358,0,1360,873,487,1.792607803,722,1202,330,150,150,0,53,0,0.013333333,0,empty,CD-0722-2
"G9,E6",477838,556031,354613,201418,316637,173637,1,173775,145605,28170,5.168796592,102013,177389,20415,8613,8372,241,1580,8,0.065695174,0,hg38,CD-0722-2
"G9,E7",1140295,1323346,835414,487932,749070,434449,3,434795,355035,79760,4.451291374,252778,162173,23286,9806,9555,251,1876,6,0.03840921,0,hg38,CD-0722-2
"G9,E8",661789,763123,497776,265347,435121,234574,2,234781,190243,44538,4.271476043,134468,116195,16921,7247,7089,158,1539,5,0.037663986,0,hg38,CD-0722-2
"G9,E9",3339,3926,2405,1521,2266,1249,0,1251,841,410,2.051219512,752,2624,508,256,252,4,93,1,0.087301587,0,empty,CD-0722-2
"G9,E10",3898,4483,2957,1526,2633,1406,0,1409,908,501,1.81237525,787,1907,520,234,234,0,77,0,0.072649573,0,empty,CD-0722-2
"G9,E11",4511,4960,3333,1627,3043,1633,0,1634,1041,593,1.755480607,924,1774,474,158,156,2,61,1,0.051282051,0,empty,CD-0722-2
"G9,E12",594400,737549,423081,314468,426406,260872,3,261035,209375,51660,4.052942315,162430,65510,11758,5188,5110,78,1029,4,0.059295499,0,hg38,CD-0722-2
"G9,F1",6231,7070,4517,2553,4209,2317,0,2321,1438,883,1.628539071,1382,2070,388,208,208,0,72,0,0.120192308,0,empty,CD-0722-2
"G9,F2",5128,6090,3634,2456,3582,2032,0,2032,1343,689,1.949201742,1231,2872,682,297,293,4,84,2,0.085324232,0,empty,CD-0722-2
"G9,F3",4351,4982,3185,1797,3013,1583,0,1583,1038,545,1.904587156,915,2498,479,245,241,4,82,1,0.132780083,0,empty,CD-0722-2
"G9,F4",665288,775402,487539,287863,448501,255616,6,255824,201668,54156,3.723834847,150461,36231,4738,1985,1932,53,461,3,0.036231884,0,hg38,CD-0722-2
"G9,F5",555472,645360,414193,231167,367687,203913,2,204082,157569,46513,3.387633565,118884,85553,16150,6760,6637,123,1217,6,0.054090704,0,hg38,CD-0722-2
"G9,F6",4984,5873,3614,2259,3555,2033,0,2033,1240,793,1.563682219,1219,3412,832,372,366,6,94,2,0.090163934,0,empty,CD-0722-2
"G9,F7",6244,7264,4527,2737,4289,2390,0,2392,1547,845,1.830769231,1421,1576,349,156,156,0,49,0,0.012820513,0,empty,CD-0722-2
"G9,F8",4889,5410,3600,1810,3229,1731,0,1732,1200,532,2.255639098,978,488,64,41,40,1,28,1,0.05,0,empty,CD-0722-2
"G9,F9",4963,5422,3700,1722,3345,1727,0,1729,1131,598,1.891304348,946,3263,857,362,351,11,100,2,0.065527066,0,empty,CD-0722-2
"G9,F10",5858,6409,4436,1973,3875,2032,0,2032,1363,669,2.037369208,1098,1658,342,162,162,0,58,0,0.067901235,0,empty,CD-0722-2
"G9,F11",307048,364129,216530,147599,213014,129929,1,130048,111325,18723,5.945895423,77757,15411,6231,2478,2465,13,546,4,0.040162272,0,hg38,CD-0722-2
"G9,F12",5128,5743,3773,1970,3360,1809,0,1809,1191,618,1.927184466,996,226,48,30,29,1,16,1,0,0,empty,CD-0722-2
"G9,G1",5580,6301,4173,2128,3751,1954,0,1956,1329,627,2.119617225,1114,2850,715,343,341,2,106,2,0.061583578,0,empty,CD-0722-2
"G9,G2",3646,4039,2550,1489,2505,1407,0,1411,870,541,1.608133087,821,612,112,56,55,1,40,1,0.072727273,0,empty,CD-0722-2
"G9,G3",7270,7980,5219,2761,4735,2641,0,2643,1638,1005,1.629850746,1447,2033,507,223,221,2,69,1,0.140271493,0,empty,CD-0722-2
"G9,G4",11634,13755,8095,5660,8155,5048,0,5053,2953,2100,1.406190476,3017,196,26,20,20,0,12,0,0,0,empty,CD-0722-2
"G9,G5",3724,4480,2733,1747,2732,1532,0,1533,956,577,1.656845754,934,2109,510,235,233,2,71,2,0.068669528,0,empty,CD-0722-2
"G9,G6",5743,6357,4286,2071,3842,2066,0,2066,1327,739,1.795669824,1148,220,52,24,22,2,11,1,0,0,empty,CD-0722-2
"G9,G7",4308,4881,3262,1619,2972,1560,0,1561,981,580,1.69137931,848,2330,704,283,283,0,76,0,0.074204947,0,empty,CD-0722-2
"G9,G8",3200,3737,2335,1402,2219,1229,0,1229,793,436,1.818807339,734,1590,431,214,214,0,74,0,0.112149533,0,empty,CD-0722-2
"G9,G9",3978,4645,2922,1723,2720,1471,0,1473,970,503,1.928429423,857,2316,734,286,283,3,98,2,0.067137809,0,empty,CD-0722-2
"G9,G10",4669,5149,3428,1721,3090,1689,0,1692,1087,605,1.796694215,956,2437,671,298,297,1,98,1,0.121212121,0,empty,CD-0722-2
"G9,G11",4500,5206,3352,1854,3132,1713,0,1719,1094,625,1.7504,1006,1520,274,163,160,3,55,1,0.10625,0,empty,CD-0722-2
"G9,G12",3946,4804,2847,1957,2925,1670,0,1672,1046,626,1.670926518,1026,2755,541,259,259,0,110,0,0.061776062,0,empty,CD-0722-2
"G9,H1",4259,4837,3048,1789,2832,1494,0,1495,1011,484,2.088842975,877,1670,315,148,146,2,61,1,0.109589041,0,empty,CD-0722-2
"G9,H2",4664,5334,3431,1903,3235,1796,0,1796,1176,620,1.896774194,1037,2524,568,243,241,2,74,1,0.149377593,0,empty,CD-0722-2
"G9,H3",509526,587169,385044,202125,337036,179241,1,179381,144416,34965,4.13030173,104099,19119,5747,2337,2320,17,499,3,0.035344828,0,hg38,CD-0722-2
"G9,H4",5768,6515,4225,2290,3852,2072,0,2072,1386,686,2.020408163,1197,246,59,33,33,0,20,0,0.121212121,0,empty,CD-0722-2
"G9,H5",6176,7234,4462,2772,4219,2418,0,2419,1537,882,1.742630385,1407,2162,563,297,295,2,99,1,0.023728814,0,empty,CD-0722-2
"G9,H6",3788,4219,2666,1553,2544,1453,0,1453,942,511,1.843444227,844,2070,533,263,260,3,75,1,0.088461538,0,empty,CD-0722-2
"G9,H7",4516,4940,3257,1683,3004,1576,1,1580,1037,543,1.909760589,883,2303,571,249,245,4,99,2,0.195918367,0,empty,CD-0722-2
"G9,H8",4866,5442,3561,1881,3284,1841,0,1841,1247,594,2.099326599,1038,2129,395,180,179,1,67,1,0.089385475,0,empty,CD-0722-2
"G9,H9",3631,3894,2741,1153,2319,1171,0,1172,816,356,2.292134831,618,1186,188,91,90,1,39,1,0.111111111,0,empty,CD-0722-2
"G9,H10",388445,438260,299402,138858,251446,122123,0,122222,92621,29601,3.128982129,69468,98266,17711,7379,7272,107,1251,5,0.047167217,0,hg38,CD-0722-2
"G9,H11",4731,5658,3239,2419,3466,2266,0,2267,1279,988,1.294534413,1391,104,29,24,23,1,11,1,0,0,empty,CD-0722-2
"G9,H12",3728,4390,2638,1752,2598,1503,0,1503,976,527,1.85199241,908,1545,309,156,152,4,67,2,0.164473684,0,empty,CD-0722-2
"G10,A1",3348,3937,2382,1555,2403,1386,0,1386,897,489,1.834355828,833,1147,297,96,95,1,27,1,0.021052632,0,empty,CD-0722-2
"G10,A2",5015,5626,3696,1930,3280,1779,0,1783,1097,686,1.599125364,972,1524,306,138,133,5,55,2,0.022556391,0,empty,CD-0722-2
"G10,A3",3264,3697,2387,1310,2207,1248,0,1248,811,437,1.85583524,716,1280,273,85,85,0,29,0,0.105882353,0,empty,CD-0722-2
"G10,A4",6015,6814,4436,2378,4032,2198,0,2203,1410,793,1.778058008,1252,737,113,62,62,0,30,0,0.096774194,0,empty,CD-0722-2
"G10,A5",4451,5018,3250,1768,2996,1632,0,1638,1029,609,1.689655172,931,1587,480,190,188,2,45,1,0.154255319,0,empty,CD-0722-2
"G10,A6",467687,562904,343403,219501,326630,196788,1,196928,132469,64459,2.055089282,116773,55999,10078,3810,3728,82,712,4,0.029506438,0,hg38,CD-0722-2
"G10,A7",3375,3900,2454,1446,2340,1349,0,1350,842,508,1.657480315,781,1539,240,95,93,2,39,2,0.021505376,0,empty,CD-0722-2
"G10,A8",2084,2509,1488,1021,1484,869,0,872,566,306,1.849673203,538,1617,349,158,157,1,59,1,0.108280255,0,empty,CD-0722-2
"G10,A9",3567,3994,2675,1319,2360,1245,0,1245,787,458,1.718340611,680,1868,481,189,184,5,64,2,0.054347826,0,empty,CD-0722-2
"G10,A10",4015,4590,3022,1568,2683,1405,0,1412,906,506,1.790513834,795,432,103,42,42,0,18,0,0.047619048,0,empty,CD-0722-2
"G10,A11",425618,484801,318206,166595,277073,147142,0,147258,114901,32357,3.55103996,84332,88408,13590,4986,4877,109,911,3,0.040393685,0,hg38,CD-0722-2
"G10,A12",4644,5227,3420,1807,3002,1585,0,1585,1010,575,1.756521739,912,3294,578,251,248,3,72,1,0.096774194,0,empty,CD-0722-2
"G10,B1",3786,4407,2668,1739,2660,1536,0,1536,937,599,1.56427379,930,1387,357,147,146,1,33,1,0.198630137,0,empty,CD-0722-2
"G10,B2",4224,4860,2862,1998,2880,1707,0,1707,1053,654,1.610091743,1053,744,149,86,85,1,18,1,0.011764706,0,empty,CD-0722-2
"G10,B3",428283,509438,313463,195975,293769,167001,2,167145,132275,34870,3.793375394,100848,168465,23476,9163,8936,227,1480,6,0.030774396,0,hg38,CD-0722-2
"G10,B4",3436,3993,2413,1580,2393,1394,0,1395,877,518,1.693050193,825,1378,313,118,117,1,38,1,0.025641026,0,empty,CD-0722-2
"G10,B5",4012,2379,1414,965,1726,965,0,971,641,330,1.942424242,609,912,223,94,93,1,32,1,0.139784946,0,empty,CD-0722-2
"G10,B6",4118,4701,2957,1744,2786,1602,0,1607,980,627,1.562998405,940,1661,390,155,153,2,53,1,0.071895425,0,empty,CD-0722-2
"G10,B7",3970,4453,2932,1521,2643,1431,0,1433,932,501,1.860279441,799,1171,339,120,118,2,34,1,0.177966102,0,empty,CD-0722-2
"G10,B8",3018,3431,2317,1114,2066,1110,0,1111,753,358,2.103351955,597,1225,325,119,118,1,43,1,0.186440678,0,empty,CD-0722-2
"G10,B9",561760,667320,412172,255148,379578,216539,0,216693,172252,44441,3.875970388,129139,68791,11983,4504,4416,88,833,3,0.076086957,0,hg38,CD-0722-2
"G10,B10",2548,2709,1831,878,1686,875,0,877,580,297,1.952861953,474,435,92,46,46,0,15,0,0,0,empty,CD-0722-2
"G10,B11",6950,8201,4942,3259,4807,2895,0,2897,1679,1218,1.378489327,1746,362,25,20,20,0,14,0,0.05,0,empty,CD-0722-2
"G10,B12",372811,441990,268477,173513,257552,148594,0,148704,114719,33985,3.375577461,89893,139103,22165,8583,8390,193,1361,5,0.042312277,0,hg38,CD-0722-2
"G10,C1",7128,7859,5373,2486,4585,2366,0,2367,1547,820,1.886585366,1303,875,194,87,86,1,22,1,0.127906977,0,empty,CD-0722-2
"G10,C2",594759,712529,431534,280995,406849,239842,0,240027,199698,40329,4.951722086,144574,97378,19473,7386,7296,90,1360,6,0.051398026,0,hg38,CD-0722-2
"G10,C3",5838,6554,4251,2303,3895,2115,0,2118,1391,727,1.913342503,1211,915,163,64,62,2,30,1,0.048387097,0,empty,CD-0722-2
"G10,C4",3548,3930,2700,1230,2358,1214,0,1215,820,395,2.075949367,675,1788,534,219,219,0,54,0,0.02283105,0,empty,CD-0722-2
"G10,C5",5154,5767,3777,1990,3382,1823,0,1823,1198,625,1.9168,1029,1768,499,187,186,1,62,1,0.021505376,0,empty,CD-0722-2
"G10,C6",4253,4970,3029,1941,2943,1664,0,1667,1056,611,1.728314239,983,1671,381,147,147,0,56,0,0.292517007,0,empty,CD-0722-2
"G10,C7",6102,7412,4225,3187,4414,2720,0,2722,1599,1123,1.423864648,1736,465,19,7,7,0,6,0,0,0,empty,CD-0722-2
"G10,C8",6577,7475,4716,2759,4402,2487,0,2487,1592,895,1.77877095,1451,2798,562,228,227,1,83,1,0.04845815,0,empty,CD-0722-2
"G10,C9",5509,6211,4105,2106,3684,1961,0,1963,1311,652,2.010736196,1119,2943,443,174,166,8,52,2,0.108433735,0,empty,CD-0722-2
"G10,C10",5292,6071,3860,2211,3607,1967,0,1971,1258,713,1.764375877,1174,2012,503,215,212,3,58,1,0.061320755,0,empty,CD-0722-2
"G10,C11",4368,4985,3219,1766,2972,1643,0,1643,1028,615,1.671544715,951,1850,443,198,197,1,59,1,0.096446701,0,empty,CD-0722-2
"G10,C12",6197,6715,4466,2249,4033,2163,0,2169,1414,755,1.872847682,1184,2080,560,214,213,1,55,1,0.093896714,0,empty,CD-0722-2
"G10,D1",5901,6794,4159,2635,3998,2282,1,2286,1398,888,1.574324324,1373,869,128,43,42,1,16,1,0.285714286,0,empty,CD-0722-2
"G10,D2",4971,5797,3750,2047,3473,1860,0,1864,1183,681,1.737151248,1090,2466,564,261,260,1,89,1,0.003846154,0,empty,CD-0722-2
"G10,D3",4140,4648,3053,1595,2755,1519,0,1521,1002,519,1.930635838,829,1277,259,115,112,3,45,2,0.017857143,0,empty,CD-0722-2
"G10,D4",3143,3612,2318,1294,2200,1166,0,1166,789,377,2.092838196,701,1473,415,154,151,3,49,2,0.006622517,0,empty,CD-0722-2
"G10,D5",3740,4270,2724,1546,2572,1411,0,1413,951,462,2.058441558,828,1595,349,153,149,4,55,2,0.046979866,0,empty,CD-0722-2
"G10,D6",5688,6662,4039,2623,3932,2288,0,2289,1412,877,1.610034208,1375,1822,446,163,161,2,51,2,0.049689441,0,empty,CD-0722-2
"G10,D7",389565,434013,298103,135910,249001,124932,1,125043,95845,29198,3.282587848,69636,126760,26396,9445,9313,132,1429,6,0.039944164,0,hg38,CD-0722-2
"G10,D8",6484,7277,4864,2413,4233,2167,0,2170,1502,668,2.248502994,1233,2162,350,139,138,1,55,1,0.050724638,0,empty,CD-0722-2
"G10,D9",1937,2094,1493,601,1260,619,0,619,412,207,1.990338164,305,1284,227,93,91,2,29,1,0.10989011,0,empty,CD-0722-2
"G10,D10",3858,4272,2799,1473,2592,1414,0,1414,923,491,1.879837067,794,1116,138,73,71,2,33,2,0.211267606,0,empty,CD-0722-2
"G10,D11",4319,4712,3211,1501,2781,1434,0,1436,941,495,1.901010101,781,2907,901,378,374,4,102,2,0.080213904,0,empty,CD-0722-2
"G10,D12",5455,6202,4024,2178,3685,1957,0,1961,1238,723,1.71230982,1132,4216,1070,417,415,2,112,1,0.065060241,0,empty,CD-0722-2
"G10,E1",6720,7375,4966,2409,4295,2379,0,2384,1518,866,1.752886836,1255,2489,547,210,207,3,63,2,0.09178744,0,empty,CD-0722-2
"G10,E2",4808,5517,3367,2150,3232,1806,1,1810,1099,711,1.545710267,1084,2255,704,224,222,2,56,1,0.027027027,0,empty,CD-0722-2
"G10,E3",3205,3747,2338,1409,2174,1165,0,1169,740,429,1.724941725,676,2462,680,228,222,6,57,2,0.081081081,0,empty,CD-0722-2
"G10,E4",4642,5294,3359,1935,3077,1676,0,1678,1062,616,1.724025974,973,2331,420,191,182,9,67,2,0.06043956,0,empty,CD-0722-2
"G10,E5",4226,4663,3177,1486,2722,1355,0,1359,915,444,2.060810811,747,1217,257,107,105,2,42,2,0,0,empty,CD-0722-2
"G10,E6",585741,671803,441759,230044,378330,201887,1,202044,147727,54317,2.719719425,116050,98556,8785,3533,3422,111,777,4,0.034774985,0,hg38,CD-0722-2
"G10,E7",6650,7511,4939,2572,4451,2391,1,2395,1535,860,1.784883721,1360,2982,790,347,337,10,87,2,0.080118694,0,empty,CD-0722-2
"G10,E8",5070,5550,3762,1788,3380,1790,0,1790,1129,661,1.708018154,992,2633,453,208,207,1,85,1,0.024154589,0,empty,CD-0722-2
"G10,E9",3248,3641,2397,1244,2181,1213,0,1213,775,438,1.769406393,660,3014,744,314,309,5,74,2,0.042071197,0,empty,CD-0722-2
"G10,E10",3781,4198,2709,1489,2542,1400,0,1402,969,433,2.237875289,794,1751,418,148,148,0,53,0,0.02027027,0,empty,CD-0722-2
"G10,E11",4299,4876,3132,1744,2976,1628,0,1629,1046,583,1.794168096,926,1913,447,196,195,1,68,1,0.030769231,0,empty,CD-0722-2
"G10,E12",484428,542444,369510,172934,312138,158716,3,158862,125908,32954,3.820719791,90241,18700,2843,1048,1016,32,272,2,0.017716535,0,hg38,CD-0722-2
"G10,F1",6057,6626,4389,2237,4014,2193,0,2193,1434,759,1.889328063,1255,2607,616,220,220,0,61,0,0.068181818,0,empty,CD-0722-2
"G10,F2",4553,5225,3184,2041,3057,1699,0,1699,1076,623,1.727126806,1003,2686,681,276,276,0,77,0,0.072463768,0,empty,CD-0722-2
"G10,F3",4293,4923,3148,1775,2872,1557,0,1557,974,583,1.670668954,900,2837,643,260,256,4,71,2,0.10546875,0,empty,CD-0722-2
"G10,F4",6930,7642,5133,2509,4492,2303,0,2305,1531,774,1.978036176,1252,724,133,51,51,0,30,0,0.039215686,0,empty,CD-0722-2
"G10,F5",5578,6236,4106,2130,3674,1921,0,1925,1261,664,1.899096386,1083,1983,488,218,211,7,65,2,0.028436019,0,empty,CD-0722-2
"G10,F6",4980,5605,3680,1925,3323,1823,0,1823,1169,654,1.787461774,1035,2977,600,215,212,3,57,2,0.25,0,empty,CD-0722-2
"G10,F7",5677,6516,4175,2341,3960,2223,0,2228,1493,735,2.031292517,1265,1070,250,119,119,0,33,0,0,0,empty,CD-0722-2
"G10,F8",4222,4702,3195,1507,2793,1501,0,1501,971,530,1.832075472,809,384,83,40,34,6,19,2,0.205882353,0,empty,CD-0722-2
"G10,F9",4669,5163,3491,1672,3095,1619,0,1626,1064,562,1.893238434,886,2619,591,242,242,0,77,0,0.045454545,0,empty,CD-0722-2
"G10,F10",6134,6974,4573,2401,4191,2198,0,2200,1458,742,1.964959569,1273,1805,452,225,225,0,61,0,0.111111111,0,empty,CD-0722-2
"G10,F11",4280,4768,3181,1587,2854,1437,0,1438,971,467,2.079229122,809,1554,313,140,139,1,48,1,0.021582734,0,empty,CD-0722-2
"G10,F12",5011,5820,3676,2144,3368,1838,0,1840,1192,648,1.839506173,1076,240,24,12,12,0,8,0,0.166666667,0,empty,CD-0722-2
"G10,G1",5464,5965,4045,1920,3564,1857,0,1858,1197,661,1.810892587,1033,3623,920,264,262,2,68,2,0.041984733,0,empty,CD-0722-2
"G10,G2",3418,3777,2401,1376,2246,1215,0,1217,822,395,2.081012658,687,642,202,95,92,3,27,1,0.163043478,0,empty,CD-0722-2
"G10,G3",6360,6913,4632,2281,4154,2330,0,2330,1402,928,1.510775862,1260,2183,603,256,254,2,72,2,0.015748031,0,empty,CD-0722-2
"G10,G4",11252,13101,7816,5285,7763,4683,0,4684,2793,1891,1.476996298,2844,123,23,16,15,1,12,1,0,0,empty,CD-0722-2
"G10,G5",3584,3976,2651,1325,2339,1313,0,1314,846,468,1.807692308,710,1742,269,106,104,2,44,1,0.009615385,0,empty,CD-0722-2
"G10,G6",579633,647965,442304,205661,368018,188969,1,189152,153750,35402,4.342974973,105368,2466,381,133,127,6,42,2,0,0,hg38,CD-0722-2
"G10,G7",4065,4598,3044,1554,2757,1445,0,1445,947,498,1.901606426,796,2519,560,157,155,2,53,1,0.083870968,0,empty,CD-0722-2
"G10,G8",1187396,1424637,871081,553556,807732,475328,3,475714,387938,87776,4.419636347,285891,363857,58763,23033,22513,520,3006,10,0.053124861,0,hg38,CD-0722-2
"G10,G9",3553,4273,2576,1697,2543,1401,0,1401,887,514,1.725680934,872,2755,674,254,252,2,86,2,0.01984127,0,empty,CD-0722-2
"G10,G10",4478,5032,3280,1752,3072,1693,0,1693,1066,627,1.70015949,969,2222,658,253,248,5,76,1,0.048387097,0,empty,CD-0722-2
"G10,G11",4456,4920,3309,1611,2890,1548,0,1549,983,566,1.736749117,834,1630,553,207,203,4,48,1,0.167487685,0,empty,CD-0722-2
"G10,G12",3841,4447,2728,1719,2582,1482,0,1486,950,536,1.77238806,886,2317,474,188,186,2,68,1,0.032258065,0,empty,CD-0722-2
"G10,H1",3889,4405,2820,1585,2587,1359,0,1361,894,467,1.914346895,796,1334,365,161,159,2,55,2,0.006289308,0,empty,CD-0722-2
"G10,H2",6449,7668,4826,2842,4418,2362,0,2366,1606,760,2.113157895,1437,2141,464,214,209,5,60,2,0.162679426,0,empty,CD-0722-2
"G10,H3",3744,4235,2684,1551,2458,1337,0,1339,867,472,1.836864407,786,1513,324,136,135,1,57,1,0.111111111,0,empty,CD-0722-2
"G10,H4",5410,6145,3967,2178,3646,2006,0,2010,1277,733,1.742155525,1177,183,25,14,13,1,10,1,0.153846154,0,empty,CD-0722-2
"G10,H5",6102,6986,4362,2624,3976,2243,0,2246,1461,785,1.861146497,1315,1742,506,211,208,3,65,2,0.057692308,0,empty,CD-0722-2
"G10,H6",3516,4178,2495,1683,2407,1366,0,1372,916,456,2.00877193,824,2030,560,198,197,1,55,1,0.040609137,0,empty,CD-0722-2
"G10,H7",4092,4566,3018,1548,2776,1447,0,1447,907,540,1.67962963,818,1866,494,206,205,1,77,1,0.146341463,0,empty,CD-0722-2
"G10,H8",4905,5555,3501,2054,3257,1869,0,1871,1189,682,1.74340176,1086,2408,700,228,225,3,70,1,0.093333333,0,empty,CD-0722-2
"G10,H9",592898,673712,451569,222143,382246,196474,0,196644,149910,46734,3.207728848,111782,153300,18414,7322,7154,168,1317,6,0.053536483,0,hg38,CD-0722-2
"G10,H10",3275,3798,2393,1405,2319,1247,0,1247,838,409,2.048899756,749,1471,274,102,101,1,40,1,0.00990099,0,empty,CD-0722-2
"G10,H11",4580,5514,3083,2431,3250,2102,0,2103,1134,969,1.170278638,1284,85,26,3,3,0,3,0,0.666666667,0,empty,CD-0722-2
"G10,H12",3337,3744,2466,1278,2234,1223,0,1223,817,406,2.012315271,677,1489,293,124,122,2,42,2,0.229508197,0,empty,CD-0722-2
"G11,A1",1748973,2182400,1246895,935505,1242918,777214,3,777814,642214,135600,4.736091445,481851,407344,69585,27186,26785,401,3348,12,0.063879037,0,hg38,CD-0722-2
"G11,A2",7181,8096,5175,2921,4756,2694,0,2697,1648,1049,1.571020019,1517,2457,439,198,184,14,76,2,0.076086957,0,empty,CD-0722-2
"G11,A3",3780,4084,2731,1353,2449,1365,0,1365,935,430,2.174418605,736,1510,314,155,154,1,46,1,0.071428571,0,empty,CD-0722-2
"G11,A4",6162,6871,4557,2314,4091,2245,0,2247,1450,797,1.819322459,1252,729,169,86,86,0,33,0,0.046511628,0,empty,CD-0722-2
"G11,A5",4892,5485,3609,1876,3259,1751,0,1754,1159,595,1.94789916,988,1989,346,120,114,6,43,2,0.061403509,0,empty,CD-0722-2
"G11,A6",4442,5236,3274,1962,3134,1837,0,1837,1194,643,1.856920684,1044,2702,553,247,239,8,83,2,0.066945607,0,empty,CD-0722-2
"G11,A7",4012,4434,2878,1556,2655,1503,0,1503,980,523,1.873804971,831,1280,277,137,137,0,54,0,0.051094891,0,empty,CD-0722-2
"G11,A8",2229,2733,1609,1124,1675,973,0,975,651,324,2.009259259,597,2001,435,198,195,3,60,2,0.046153846,0,empty,CD-0722-2
"G11,A9",573665,657662,435221,222441,374741,198963,2,199137,158233,40904,3.868399179,112971,177625,23583,9567,9367,200,1520,5,0.070460126,0,hg38,CD-0722-2
"G11,A10",4739,5162,3573,1589,3114,1611,0,1614,1020,594,1.717171717,848,570,185,54,54,0,20,0,0.018518519,0,empty,CD-0722-2
"G11,A11",3485,4015,2593,1422,2442,1302,0,1302,874,428,2.042056075,764,1475,183,87,87,0,46,0,0.08045977,0,empty,CD-0722-2
"G11,A12",4907,5431,3679,1752,3184,1698,0,1700,1109,591,1.876480541,905,3919,1031,408,404,4,103,2,0.027227723,0,empty,CD-0722-2
"G11,B1",4263,5039,3027,2012,2913,1689,0,1689,1094,595,1.838655462,985,1228,401,144,141,3,46,2,0.070921986,0,empty,CD-0722-2
"G11,B2",4585,5320,3082,2238,3146,1871,0,1871,1167,704,1.657670455,1134,713,150,58,58,0,20,0,0.034482759,0,empty,CD-0722-2
"G11,B3",3812,4344,2701,1643,2604,1461,1,1462,991,471,2.10403397,858,2074,449,188,186,2,67,1,0.091397849,0,empty,CD-0722-2
"G11,B4",4123,4858,2957,1901,2923,1738,0,1738,1077,661,1.62934947,1009,1177,152,83,83,0,41,0,0.108433735,0,empty,CD-0722-2
"G11,B5",4202,2545,1493,1052,1808,1019,0,1025,699,326,2.144171779,662,1206,226,78,78,0,37,0,0.243589744,0,empty,CD-0722-2
"G11,B6",4723,5495,3373,2122,3241,1849,0,1851,1131,720,1.570833333,1083,1578,251,117,116,1,45,1,0.017241379,0,empty,CD-0722-2
"G11,B7",4405,5108,3249,1859,3132,1741,0,1741,1128,613,1.840130506,1021,1582,197,92,89,3,44,1,0.06741573,0,empty,CD-0722-2
"G11,B8",3191,3695,2339,1356,2208,1245,0,1247,815,432,1.886574074,718,1149,179,99,96,3,47,2,0.041666667,0,empty,CD-0722-2
"G11,B9",362390,447289,249406,197883,260117,174567,0,174674,122166,52508,2.326616896,106892,1941,438,168,160,8,74,2,0.0125,0,hg38,CD-0722-2
"G11,B10",2666,3108,1932,1176,1996,1119,0,1119,707,412,1.716019417,692,589,121,48,47,1,17,1,0.021276596,0,empty,CD-0722-2
"G11,B11",594655,695766,437581,258185,392910,220722,2,220882,174678,46204,3.780581768,129924,18414,2227,935,913,22,214,3,0.08652793,0,hg38,CD-0722-2
"G11,B12",3678,4270,2653,1617,2558,1477,1,1480,972,508,1.913385827,848,2033,438,210,208,2,61,1,0.004807692,0,empty,CD-0722-2
"G11,C1",13584,15313,10419,4894,8704,4510,0,4515,3085,1430,2.157342657,2500,2106,448,184,184,0,57,0,0.027173913,0,empty,CD-0722-2
"G11,C2",6272,7284,4409,2875,4263,2481,1,2487,1648,839,1.964243147,1458,2482,712,309,306,3,81,2,0.140522876,0,empty,CD-0722-2
"G11,C3",510837,581487,391982,189505,333711,169739,1,169886,129086,40800,3.163872549,97277,9384,1337,594,576,18,174,2,0.036458333,0,hg38,CD-0722-2
"G11,C4",3889,4428,2840,1588,2678,1404,0,1406,896,510,1.756862745,809,1582,265,117,115,2,53,1,0.2,0,empty,CD-0722-2
"G11,C5",5661,6401,4143,2258,3843,2070,0,2072,1395,677,2.0605613,1185,1764,497,203,201,2,58,2,0.07960199,0,empty,CD-0722-2
"G11,C6",5064,5864,3712,2152,3486,1919,1,1922,1211,711,1.70323488,1109,1453,269,120,116,4,44,3,0.060344828,0,empty,CD-0722-2
"G11,C7",6855,8038,4867,3171,4829,2924,0,2925,1791,1134,1.579365079,1742,710,133,58,57,1,23,1,0.01754386,0,empty,CD-0722-2
"G11,C8",7184,8073,5278,2795,4810,2621,3,2628,1749,879,1.989761092,1473,3277,588,284,275,9,110,2,0.054545455,0,empty,CD-0722-2
"G11,C9",5031,5896,3665,2231,3484,1988,0,1988,1290,698,1.848137536,1201,1379,184,89,86,3,43,2,0.046511628,0,empty,CD-0722-2
"G11,C10",5781,6552,4243,2309,3937,2177,0,2182,1431,751,1.905459387,1244,2012,297,135,130,5,56,2,0.053846154,0,empty,CD-0722-2
"G11,C11",4938,5647,3552,2095,3385,1853,0,1853,1156,697,1.658536585,1119,2155,526,259,257,2,76,1,0.140077821,0,empty,CD-0722-2
"G11,C12",7014,7834,5188,2646,4623,2462,0,2468,1595,873,1.827033219,1395,2455,698,249,244,5,66,2,0.094262295,0,empty,CD-0722-2
"G11,D1",6390,7311,4460,2851,4449,2622,0,2625,1575,1050,1.5,1575,1157,109,40,40,0,30,0,0.075,0,empty,CD-0722-2
"G11,D2",6258,6940,4695,2245,4049,2080,0,2082,1406,676,2.079881657,1149,3197,780,294,294,0,97,0,0.074829932,0,empty,CD-0722-2
"G11,D3",4437,5273,3188,2085,3201,1840,0,1847,1239,608,2.037828947,1149,1230,204,96,95,1,46,1,0.357894737,0,empty,CD-0722-2
"G11,D4",3485,3948,2537,1411,2354,1309,0,1309,847,462,1.833333333,716,1185,311,145,145,0,49,0,0.020689655,0,empty,CD-0722-2
"G11,D5",458126,529504,340641,188863,306527,171894,1,172010,134480,37530,3.58326672,99792,42623,14691,5696,5659,37,893,7,0.015550451,0,hg38,CD-0722-2
"G11,D6",6581,7597,4592,3005,4364,2608,0,2611,1569,1042,1.505758157,1539,1954,386,186,181,5,59,2,0.044198895,0,empty,CD-0722-2
"G11,D7",3664,4121,2690,1431,2430,1285,0,1287,824,463,1.779697624,741,2374,618,234,233,1,83,1,0.064377682,0,empty,CD-0722-2
"G11,D8",4001,4525,2956,1569,2747,1508,0,1510,972,538,1.80669145,847,1269,298,139,138,1,57,1,0.036231884,0,empty,CD-0722-2
"G11,D9",2213,2449,1668,781,1470,728,0,728,414,314,1.318471338,406,2121,630,232,227,5,62,1,0.123348018,0,empty,CD-0722-2
"G11,D10",4559,5393,3282,2111,3276,1839,0,1841,1171,670,1.747761194,1130,1281,254,90,88,2,32,1,0.011363636,0,empty,CD-0722-2
"G11,D11",4854,5504,3604,1900,3272,1708,0,1708,1100,608,1.809210526,969,2675,801,372,362,10,115,2,0.071823204,0,empty,CD-0722-2
"G11,D12",6320,7277,4664,2613,4344,2402,0,2402,1565,837,1.869772999,1407,4278,1171,439,436,3,142,3,0.073394495,0,empty,CD-0722-2
"G11,E1",1205544,1416091,883221,532870,799391,459999,2,460422,367640,92782,3.962406501,271082,337060,48344,18997,18598,399,2698,9,0.063716529,0,hg38,CD-0722-2
"G11,E2",5020,5821,3631,2190,3414,1908,0,1908,1233,675,1.826666667,1115,1994,524,223,222,1,61,1,0.099099099,0,empty,CD-0722-2
"G11,E3",3424,4170,2499,1671,2412,1344,0,1347,897,450,1.993333333,811,2431,500,222,221,1,75,1,0.095022624,0,empty,CD-0722-2
"G11,E4",569211,737144,386843,350301,422275,273868,4,274077,221766,52311,4.239376039,176645,357734,47086,18633,18170,463,2521,9,0.087451844,0,hg38,CD-0722-2
"G11,E5",4383,4802,3267,1535,2857,1477,0,1478,995,483,2.060041408,817,1224,228,100,97,3,36,2,0.051546392,0,empty,CD-0722-2
"G11,E6",7890,8878,5707,3171,5276,2948,0,2951,1888,1063,1.776105362,1713,3694,911,433,432,1,115,1,0.043981481,0,empty,CD-0722-2
"G11,E7",6848,7587,5046,2541,4580,2416,0,2423,1585,838,1.891408115,1375,3620,778,331,328,3,89,2,0.015243902,0,empty,CD-0722-2
"G11,E8",5451,6036,4129,1907,3597,1794,0,1800,1181,619,1.907915994,988,2906,810,341,340,1,98,1,0.164705882,0,empty,CD-0722-2
"G11,E9",3601,4207,2610,1597,2490,1408,0,1408,956,452,2.115044248,836,2875,770,261,261,0,76,0,0.099616858,0,empty,CD-0722-2
"G11,E10",3914,4300,2899,1401,2596,1341,0,1341,857,484,1.770661157,758,1967,435,221,220,1,58,1,0.081818182,0,empty,CD-0722-2
"G11,E11",4947,5620,3638,1982,3411,1906,0,1906,1163,743,1.565275908,1086,2589,714,240,236,4,63,2,0.033898305,0,empty,CD-0722-2
"G11,E12",5477,6211,3972,2239,3772,2041,0,2043,1384,659,2.100151745,1177,2107,321,135,131,4,59,3,0.053435115,0,empty,CD-0722-2
"G11,F1",6493,7185,4759,2426,4249,2319,0,2324,1432,892,1.605381166,1253,2425,697,310,301,9,88,2,0.016611296,0,empty,CD-0722-2
"G11,F2",5381,6161,3891,2270,3738,2045,0,2048,1339,709,1.888575458,1210,3185,720,307,304,3,99,2,0.105263158,0,empty,CD-0722-2
"G11,F3",4810,5441,3570,1871,3143,1687,0,1692,1086,606,1.792079208,945,2472,600,247,246,1,80,1,0.142276423,0,empty,CD-0722-2
"G11,F4",7207,8210,5296,2914,4881,2650,0,2651,1707,944,1.808262712,1517,1005,150,83,81,2,43,2,0.037037037,0,empty,CD-0722-2
"G11,F5",5578,5986,4156,1830,3668,1860,0,1862,1213,649,1.869029276,1012,2684,840,313,313,0,89,0,0.169329073,0,empty,CD-0722-2
"G11,F6",5477,6342,3940,2402,3682,2038,0,2038,1298,740,1.754054054,1197,2721,538,224,215,9,66,2,0.055813953,0,empty,CD-0722-2
"G11,F7",6046,7018,4425,2593,4242,2345,0,2346,1474,872,1.690366972,1360,1166,230,115,111,4,36,2,0.09009009,0,empty,CD-0722-2
"G11,F8",4651,5273,3388,1885,3181,1701,0,1702,1126,576,1.954861111,1027,489,61,38,36,2,22,2,0.111111111,0,empty,CD-0722-2
"G11,F9",5049,5648,3788,1860,3436,1800,0,1802,1166,636,1.833333333,1045,3012,564,246,245,1,95,1,0.040816327,0,empty,CD-0722-2
"G11,F10",6229,6839,4676,2163,4040,2108,0,2112,1370,742,1.846361186,1107,2590,688,266,262,4,76,1,0.080152672,0,empty,CD-0722-2
"G11,F11",4956,5407,3728,1679,3262,1640,0,1640,1084,556,1.949640288,889,1946,196,90,90,0,34,0,0.044444444,0,empty,CD-0722-2
"G11,F12",5494,6105,3942,2163,3691,2014,0,2015,1272,743,1.711978466,1166,367,70,34,33,1,22,1,0,0,empty,CD-0722-2
"G11,G1",5935,6724,4453,2271,4018,2112,0,2113,1340,773,1.733505821,1204,3261,663,266,262,4,107,2,0.064885496,0,empty,CD-0722-2
"G11,G2",3688,4146,2602,1544,2463,1363,0,1363,857,506,1.693675889,771,760,100,61,58,3,33,3,0.086206897,0,empty,CD-0722-2
"G11,G3",6708,7301,4846,2455,4388,2449,1,2450,1410,1040,1.355769231,1309,2785,693,285,284,1,75,1,0.102112676,0,empty,CD-0722-2
"G11,G4",12440,14758,8796,5962,8662,5309,1,5317,3229,2088,1.546455939,3194,234,55,24,24,0,14,0,0,0,empty,CD-0722-2
"G11,G5",3958,4569,2857,1712,2730,1498,0,1500,967,533,1.814258912,882,1991,330,182,178,4,66,2,0.06741573,0,empty,CD-0722-2
"G11,G6",5868,6612,4313,2299,4028,2181,1,2182,1424,758,1.878627968,1242,152,15,11,11,0,8,0,0,0,empty,CD-0722-2
"G11,G7",4593,5193,3317,1876,3098,1602,0,1606,1086,520,2.088461538,936,2676,660,232,232,0,59,0,0.176724138,0,empty,CD-0722-2
"G11,G8",3370,3934,2520,1414,2355,1261,0,1261,835,426,1.960093897,726,1719,443,150,150,0,56,0,0.06,0,empty,CD-0722-2
"G11,G9",4218,4850,3136,1714,2815,1542,0,1542,1032,510,2.023529412,864,2313,552,223,221,2,68,2,0.067873303,0,empty,CD-0722-2
"G11,G10",477124,559648,352573,207075,322651,180449,0,180585,145385,35200,4.130255682,105863,205502,37526,14786,14571,215,2107,10,0.067462769,0,hg38,CD-0722-2
"G11,G11",4994,5489,3764,1725,3314,1723,0,1723,1104,619,1.783521809,977,1773,369,171,170,1,57,1,0.164705882,0,empty,CD-0722-2
"G11,G12",4188,4813,2970,1843,2871,1625,0,1628,1029,599,1.717863105,943,2484,708,274,267,7,96,2,0.052434457,0,empty,CD-0722-2
"G11,H1",383468,418502,296899,121603,242070,113747,1,113842,90372,23470,3.850532595,63073,24760,5449,1968,1946,22,413,3,0.032374101,0,hg38,CD-0722-2
"G11,H2",4862,5789,3503,2286,3392,1918,0,1923,1258,665,1.891729323,1171,2421,469,224,219,5,80,3,0.03196347,0,empty,CD-0722-2
"G11,H3",4048,4595,2854,1741,2722,1479,0,1479,978,501,1.952095808,858,1836,370,200,200,0,59,0,0.14,0,empty,CD-0722-2
"G11,H4",5853,6713,4284,2429,3963,2192,0,2193,1420,773,1.836998706,1260,202,37,18,18,0,15,0,0,0,empty,CD-0722-2
"G11,H5",6565,7339,4774,2565,4319,2360,0,2361,1567,794,1.973551637,1322,2226,528,211,210,1,79,1,0.157142857,0,empty,CD-0722-2
"G11,H6",4178,4903,3061,1842,2970,1707,0,1711,1094,617,1.773095624,1026,2190,364,136,135,1,62,1,0.081481481,0,empty,CD-0722-2
"G11,H7",4705,5240,3433,1807,3179,1709,0,1710,1124,586,1.918088737,957,2415,651,317,313,4,95,3,0.083067093,0,empty,CD-0722-2
"G11,H8",654528,801610,473373,328237,452143,267729,1,267908,211300,56608,3.732687959,164067,152937,21215,8825,8661,164,1539,5,0.058422815,0,hg38,CD-0722-2
"G11,H9",3922,4399,2932,1467,2653,1400,0,1400,919,481,1.910602911,790,1412,211,107,104,3,42,2,0.019230769,0,empty,CD-0722-2
"G11,H10",558468,646655,418702,227953,366526,198616,0,198787,154075,44712,3.445942924,115666,142669,18822,7345,7160,185,1362,6,0.049162011,0,hg38,CD-0722-2
"G11,H11",5098,6239,3462,2777,3706,2511,0,2511,1391,1120,1.241964286,1539,78,9,6,6,0,5,0,0,0,empty,CD-0722-2
"G11,H12",457496,527637,341283,186354,303753,162772,1,162905,125500,37405,3.355166422,95637,157606,18252,7178,6980,198,1293,6,0.053151862,0,hg38,CD-0722-2
"G12,A1",4055,4800,2950,1850,2832,1625,0,1625,1023,602,1.699335548,920,972,210,62,61,1,21,1,0.114754098,0,empty,CD-0722-2
"G12,A2",6433,7328,4716,2612,4351,2453,0,2456,1566,890,1.759550562,1399,1607,428,167,166,1,43,1,0.054216867,0,empty,CD-0722-2
"G12,A3",3936,4535,2879,1656,2740,1525,0,1526,1012,514,1.968871595,858,1201,268,100,98,2,34,1,0.112244898,0,empty,CD-0722-2
"G12,A4",6717,7586,4939,2647,4606,2569,0,2569,1670,899,1.857619577,1496,864,118,69,67,2,21,1,0.089552239,0,empty,CD-0722-2
"G12,A5",5414,6148,3959,2189,3621,1964,0,1964,1294,670,1.931343284,1133,2510,612,245,241,4,48,2,0.095435685,0,empty,CD-0722-2
"G12,A6",5063,6025,3785,2240,3620,2071,0,2071,1347,724,1.860497238,1218,2722,688,266,263,3,91,2,0.049429658,0,empty,CD-0722-2
"G12,A7",4119,4559,3076,1483,2781,1551,0,1551,964,587,1.642248722,842,1598,380,166,164,2,49,1,0.365853659,0,empty,CD-0722-2
"G12,A8",2543,3046,1865,1181,1804,1048,0,1048,672,376,1.787234043,617,2085,543,182,180,2,50,1,0.016666667,0,empty,CD-0722-2
"G12,A9",660583,754393,507868,246525,426373,217852,0,218062,170949,47113,3.628488952,123073,80558,10765,4132,4021,111,821,6,0.065157921,0,hg38,CD-0722-2
"G12,A10",5511,6343,4156,2187,3699,2047,0,2051,1311,740,1.771621622,1134,392,93,41,40,1,10,1,0,0,empty,CD-0722-2
"G12,A11",3899,4474,2845,1629,2656,1410,0,1412,933,479,1.947807933,821,1717,395,162,161,1,39,1,0.217391304,0,empty,CD-0722-2
"G12,A12",5836,6405,4345,2060,3720,1958,0,1961,1342,619,2.168012924,1065,3466,842,320,319,1,85,1,0.047021944,0,empty,CD-0722-2
"G12,B1",4595,5261,3337,1924,3172,1756,0,1759,1141,618,1.846278317,1053,1391,283,111,111,0,29,0,0.108108108,0,empty,CD-0722-2
"G12,B2",4975,5536,3304,2232,3322,1963,0,1963,1245,718,1.733983287,1178,564,102,40,40,0,14,0,0.1,0,empty,CD-0722-2
"G12,B3",4112,4963,2996,1967,2906,1625,0,1627,1087,540,2.012962963,971,1231,223,77,75,2,37,1,0.013333333,0,empty,CD-0722-2
"G12,B4",4457,5373,3131,2242,3258,1975,0,1975,1255,720,1.743055556,1238,1037,306,92,92,0,28,0,0.163043478,0,empty,CD-0722-2
"G12,B5",5300,3404,2041,1363,2390,1300,0,1323,855,468,1.826923077,877,829,126,55,54,1,20,1,0.092592593,0,empty,CD-0722-2
"G12,B6",5278,6061,3788,2273,3670,2187,0,2190,1338,852,1.570422535,1292,1809,414,194,192,2,47,2,0.036458333,0,empty,CD-0722-2
"G12,B7",4791,5516,3534,1982,3302,1850,0,1851,1215,636,1.910377358,1101,1702,313,114,114,0,32,0,0.122807018,0,empty,CD-0722-2
"G12,B8",3540,4024,2626,1398,2404,1256,0,1261,821,440,1.865909091,707,1359,382,141,138,3,35,2,0.028985507,0,empty,CD-0722-2
"G12,B9",6636,7617,4851,2766,4641,2664,0,2666,1728,938,1.842217484,1538,1151,301,121,119,2,45,2,0,0,empty,CD-0722-2
"G12,B10",3144,3610,2322,1288,2206,1190,1,1196,738,458,1.611353712,696,399,56,29,29,0,13,0,0.103448276,0,empty,CD-0722-2
"G12,B11",8231,9523,5872,3651,5560,3296,0,3298,1935,1363,1.419662509,1962,249,27,17,16,1,11,1,0.0625,0,empty,CD-0722-2
"G12,B12",4308,4885,3201,1684,2948,1574,0,1574,1068,506,2.110671937,896,1576,408,159,156,3,46,1,0.096153846,0,empty,CD-0722-2
"G12,C1",8308,9431,6218,3213,5531,2932,0,2934,1811,1123,1.612644702,1657,1046,465,183,182,1,38,1,0.093406593,0,empty,CD-0722-2
"G12,C2",6574,7562,4644,2918,4435,2542,0,2542,1731,811,2.134401973,1508,2268,567,214,213,1,61,1,0.070422535,0,empty,CD-0722-2
"G12,C3",7071,7921,5239,2682,4781,2648,0,2648,1668,980,1.702040816,1505,792,165,91,90,1,20,1,0,0,empty,CD-0722-2
"G12,C4",4238,4766,3130,1636,2946,1556,0,1558,1048,510,2.054901961,894,2061,535,206,205,1,42,1,0.034146341,0,empty,CD-0722-2
"G12,C5",7058,8161,5207,2954,4650,2432,0,2443,1658,785,2.112101911,1405,1732,251,108,101,7,37,2,0.118811881,0,empty,CD-0722-2
"G12,C6",5137,5952,3815,2137,3644,2024,0,2026,1282,744,1.72311828,1177,1726,329,134,128,6,40,2,0.046875,0,empty,CD-0722-2
"G12,C7",7722,8947,5404,3543,5337,3221,0,3230,1917,1313,1.460015232,1934,628,167,63,63,0,14,0,0.349206349,0,empty,CD-0722-2
"G12,C8",8422,9794,6072,3722,5745,3216,0,3216,2106,1110,1.897297297,1921,2471,572,235,234,1,84,1,0.051282051,0,empty,CD-0722-2
"G12,C9",5530,6417,4011,2406,3781,2100,0,2100,1335,765,1.745098039,1218,1574,167,77,74,3,25,1,0,0,empty,CD-0722-2
"G12,C10",6225,6836,4535,2301,4114,2142,0,2144,1410,734,1.920980926,1212,1754,363,169,167,2,52,2,0.005988024,0,empty,CD-0722-2
"G12,C11",5395,6012,3917,2095,3552,1891,0,1892,1253,639,1.960876369,1076,1931,549,215,212,3,51,1,0.08490566,0,empty,CD-0722-2
"G12,C12",7171,8139,5249,2890,4943,2663,0,2663,1722,941,1.829968119,1519,1944,497,185,180,5,56,2,0.044444444,0,empty,CD-0722-2
"G12,D1",6884,7994,4854,3140,4765,2807,0,2810,1670,1140,1.464912281,1657,789,73,40,40,0,12,0,0,0,empty,CD-0722-2
"G12,D2",5643,6366,4181,2185,3812,2018,0,2023,1306,717,1.821478382,1178,3026,1002,351,346,5,82,2,0.020231214,0,empty,CD-0722-2
"G12,D3",5304,5790,3755,2035,3421,1882,0,1882,1246,636,1.959119497,1071,1465,326,126,123,3,38,1,0.146341463,0,empty,CD-0722-2
"G12,D4",557774,651933,419297,232636,372470,201272,1,201451,155519,45932,3.385853,117825,132843,18331,7543,7394,149,1242,4,0.068028131,0,hg38,CD-0722-2
"G12,D5",4559,5245,3366,1879,3126,1722,0,1722,1145,577,1.98440208,997,1368,214,96,94,2,33,1,0.106382979,0,empty,CD-0722-2
"G12,D6",412923,441516,323189,118327,253735,113113,1,113222,85371,27851,3.065275933,60971,32606,6324,2317,2279,38,476,2,0.019306713,0,hg38,CD-0722-2
"G12,D7",4007,4569,2963,1606,2767,1484,0,1484,1047,437,2.395881007,853,1867,356,134,130,4,55,2,0.030769231,0,empty,CD-0722-2
"G12,D8",4568,5198,3353,1845,3070,1626,1,1631,1073,558,1.922939068,931,1272,367,165,164,1,44,1,0.06097561,0,empty,CD-0722-2
"G12,D9",2579,2784,1905,879,1732,933,0,934,626,308,2.032467532,511,1707,358,142,142,0,41,0,0.007042254,0,empty,CD-0722-2
"G12,D10",4935,5655,3664,1991,3333,1815,0,1816,1140,676,1.686390533,1028,938,252,115,113,2,30,1,0,0,empty,CD-0722-2
"G12,D11",5029,5402,3646,1756,3241,1707,0,1711,1111,600,1.851666667,934,2526,626,256,253,3,60,2,0.067193676,0,empty,CD-0722-2
"G12,D12",6834,7873,4979,2894,4635,2627,0,2629,1744,885,1.970621469,1505,3338,990,367,359,8,94,2,0.069637883,0,empty,CD-0722-2
"G12,E1",8076,9396,5882,3514,5469,3060,0,3062,1895,1167,1.623821765,1768,2061,645,244,241,3,65,2,0.033195021,0,empty,CD-0722-2
"G12,E2",5436,6207,3894,2313,3804,2130,0,2133,1351,782,1.727621483,1290,1895,364,139,134,5,39,1,0.014925373,0,empty,CD-0722-2
"G12,E3",3677,4233,2787,1446,2580,1376,0,1376,880,496,1.774193548,791,1918,386,147,145,2,48,2,0.027586207,0,empty,CD-0722-2
"G12,E4",5066,5757,3635,2122,3450,1915,0,1917,1294,623,2.077046549,1136,2084,527,198,195,3,62,1,0.2,0,empty,CD-0722-2
"G12,E5",4677,5257,3486,1771,3146,1633,0,1638,1097,541,2.027726433,936,1241,276,127,126,1,34,1,0,0,empty,CD-0722-2
"G12,E6",8793,10264,6366,3898,6063,3452,0,3457,2202,1255,1.754581673,2084,3428,785,278,275,3,69,3,0.043636364,0,empty,CD-0722-2
"G12,E7",7727,8825,5730,3095,5214,2854,0,2857,1854,1003,1.848454636,1655,2826,564,209,208,1,77,1,0.100961538,0,empty,CD-0722-2
"G12,E8",6060,6913,4487,2426,4035,2127,0,2130,1378,752,1.832446809,1214,2509,791,319,314,5,55,2,0.152866242,0,empty,CD-0722-2
"G12,E9",709459,863691,497981,365710,498854,325876,1,326107,242941,83166,2.921157685,196300,3865,1110,437,435,2,116,1,0.204597701,0,hg38,CD-0722-2
"G12,E10",4466,5067,3369,1698,2980,1570,0,1570,1050,520,2.019230769,876,1442,398,165,165,0,42,0,0.060606061,0,empty,CD-0722-2
"G12,E11",5320,5911,4018,1893,3542,1927,0,1927,1251,676,1.850591716,1045,2074,475,175,173,2,50,1,0.023121387,0,empty,CD-0722-2
"G12,E12",1948286,2391327,1400771,990556,1342474,822214,2,822893,645722,177171,3.644625813,508643,325168,48814,19427,18982,445,2772,9,0.041249605,0,hg38,CD-0722-2
"G12,F1",7137,7987,5219,2768,4628,2490,0,2490,1590,900,1.766666667,1373,2137,418,184,184,0,55,0,0.097826087,0,empty,CD-0722-2
"G12,F2",5236,6019,3780,2239,3619,1988,0,1988,1282,706,1.815864023,1197,3276,646,238,235,3,66,2,0.042553191,0,empty,CD-0722-2
"G12,F3",5174,5966,3730,2236,3550,1911,0,1916,1299,617,2.10534846,1156,2592,569,265,261,4,68,2,0.191570881,0,empty,CD-0722-2
"G12,F4",7625,8300,5676,2624,4991,2568,2,2571,1639,932,1.758583691,1399,722,174,65,64,1,26,1,0.015625,0,empty,CD-0722-2
"G12,F5",5976,6778,4384,2394,4024,2122,0,2124,1329,795,1.671698113,1279,2084,465,208,206,2,61,1,0.058252427,0,empty,CD-0722-2
"G12,F6",6355,7487,4532,2955,4394,2517,0,2520,1618,902,1.793791574,1520,2485,593,233,231,2,59,1,0.073593074,0,empty,CD-0722-2
"G12,F7",7005,7927,5026,2901,4637,2567,0,2574,1712,862,1.986078886,1469,1253,356,133,130,3,31,1,0.053846154,0,empty,CD-0722-2
"G12,F8",5339,6233,3884,2349,3693,2066,0,2066,1303,763,1.707732634,1210,264,69,37,37,0,13,0,0,0,empty,CD-0722-2
"G12,F9",5787,6625,4352,2273,3921,2133,0,2136,1409,727,1.938101788,1223,3375,821,275,269,6,74,2,0.05204461,0,empty,CD-0722-2
"G12,F10",6871,7676,5171,2505,4541,2396,0,2402,1622,780,2.079487179,1305,2151,645,283,280,3,69,3,0.114285714,0,empty,CD-0722-2
"G12,F11",5630,6151,4270,1881,3721,1938,1,1939,1313,626,2.097444089,1029,1642,433,183,183,0,45,0,0.071038251,0,empty,CD-0722-2
"G12,F12",6178,6976,4547,2429,4029,2135,0,2137,1373,764,1.797120419,1202,176,26,11,11,0,7,0,0.363636364,0,empty,CD-0722-2
"G12,G1",6155,7074,4543,2531,4200,2244,0,2244,1462,782,1.869565217,1303,2846,739,286,284,2,73,1,0.098591549,0,empty,CD-0722-2
"G12,G2",3984,4655,2786,1869,2788,1627,0,1627,1088,539,2.018552876,968,469,90,46,46,0,19,0,0.173913043,0,empty,CD-0722-2
"G12,G3",7667,8239,5682,2557,4782,2546,0,2546,1521,1025,1.483902439,1343,2346,637,257,257,0,75,0,0.023346304,0,empty,CD-0722-2
"G12,G4",13793,15931,9776,6155,9461,5743,0,5751,3489,2262,1.542440318,3360,106,41,16,16,0,8,0,0.0625,0,empty,CD-0722-2
"G12,G5",4421,4970,3209,1761,2950,1661,0,1663,1085,578,1.87716263,927,1406,347,148,145,3,48,1,0.15862069,0,empty,CD-0722-2
"G12,G6",6255,7081,4667,2414,4194,2252,0,2255,1489,766,1.94386423,1219,144,45,17,17,0,6,0,0,0,empty,CD-0722-2
"G12,G7",5205,5866,3955,1911,3419,1770,0,1772,1133,639,1.773082942,955,2728,589,208,203,5,61,2,0.054187192,0,empty,CD-0722-2
"G12,G8",3990,4555,2873,1682,2668,1423,1,1424,942,482,1.954356846,821,1811,419,152,149,3,48,2,0.140939597,0,empty,CD-0722-2
"G12,G9",4558,5084,3359,1725,3080,1707,0,1708,1080,628,1.719745223,982,2611,714,283,282,1,68,1,0.117021277,0,empty,CD-0722-2
"G12,G10",5327,6079,3921,2158,3736,2106,0,2107,1389,718,1.93454039,1224,2053,689,250,250,0,66,0,0.184,0,empty,CD-0722-2
"G12,G11",5306,5982,3905,2077,3586,1912,0,1912,1303,609,2.139573071,1090,1745,513,190,189,1,42,1,0.079365079,0,empty,CD-0722-2
"G12,G12",4470,5210,3153,2057,3138,1790,0,1790,1123,667,1.683658171,1045,2092,519,202,202,0,70,0,0.034653465,0,empty,CD-0722-2
"G12,H1",5325,6025,3881,2144,3547,1940,0,1940,1292,648,1.99382716,1136,1084,295,131,131,0,37,0,0.053435115,0,empty,CD-0722-2
"G12,H2",563985,626281,434014,192267,357901,174579,3,174743,137078,37665,3.639399973,98388,34653,7841,2873,2840,33,587,2,0.024295775,0,hg38,CD-0722-2
"G12,H3",4703,5202,3363,1839,3098,1685,0,1685,1101,584,1.885273973,973,1580,297,128,127,1,38,1,0.094488189,0,empty,CD-0722-2
"G12,H4",6582,7614,4897,2717,4519,2402,0,2404,1594,810,1.967901235,1424,176,79,42,42,0,15,0,0,0,empty,CD-0722-2
"G12,H5",7502,8554,5405,3149,5072,2832,0,2832,1878,954,1.968553459,1642,2380,716,274,274,0,75,0,0.04379562,0,empty,CD-0722-2
"G12,H6",4410,4965,3158,1807,2925,1612,0,1614,1101,513,2.14619883,911,2100,589,227,225,2,59,2,0.151111111,0,empty,CD-0722-2
"G12,H7",5376,5953,3935,2018,3604,1949,0,1950,1288,662,1.945619335,1091,1836,367,174,170,4,65,2,0.182352941,0,empty,CD-0722-2
"G12,H8",15345,17859,11123,6736,10529,6348,0,6354,4475,1879,2.38158595,3665,2426,599,223,215,8,57,2,0.051162791,0,empty,CD-0722-2
"G12,H9",4721,5164,3501,1663,3013,1550,2,1553,1034,519,1.992292871,872,1013,224,90,90,0,30,0,0.133333333,0,empty,CD-0722-2
"G12,H10",1094589,1035210,934436,100774,552959,134562,2,134813,110602,24211,4.568254099,50612,3400,987,405,398,7,172,2,0.090452261,0,hg38,CD-0722-2
"G12,H11",5682,6860,3846,3014,4167,2768,0,2772,1582,1190,1.329411765,1754,44,3,3,3,0,2,0,0,0,empty,CD-0722-2
"G12,H12",4332,4904,3108,1796,2996,1666,0,1669,1083,586,1.848122867,973,1319,260,119,119,0,37,0,0.117647059,0,empty,CD-0722-2
"H1,A1",4841,5599,3512,2087,3282,1887,0,1887,1200,687,1.746724891,1073,1384,240,109,106,3,39,2,0,0,empty,CD-0722-2
"H1,A2",7737,8821,5543,3278,5158,2924,0,2927,1754,1173,1.495311168,1708,1696,540,228,228,0,65,0,0.087719298,0,empty,CD-0722-2
"H1,A3",380307,413689,296515,117174,236606,107973,1,108092,81684,26408,3.09315359,59603,14258,2279,844,822,22,214,3,0.076642336,0,hg38,CD-0722-2
"H1,A4",6669,7754,4816,2938,4603,2595,1,2598,1692,906,1.867549669,1527,895,238,112,110,2,33,1,0,0,empty,CD-0722-2
"H1,A5",656615,812343,461469,350874,472342,297690,1,297868,223464,74404,3.003386915,186166,83550,15601,5948,5872,76,1201,5,0.03780654,0,hg38,CD-0722-2
"H1,A6",396875,469930,300561,169369,268520,147143,0,147251,114791,32460,3.536383241,85962,18987,3286,1286,1270,16,352,2,0.021259843,0,hg38,CD-0722-2
"H1,A7",2310123,2758986,1712292,1046694,1529907,899513,4,900283,707510,192773,3.670171653,534896,386667,65409,25552,25111,441,3299,11,0.063677273,0,hg38,CD-0722-2
"H1,A8",2965,3392,2183,1209,2019,1068,0,1068,742,326,2.27607362,598,2182,557,203,200,3,59,3,0.115,0,empty,CD-0722-2
"H1,A9",580885,685158,435106,250052,389118,211643,1,211792,166895,44897,3.717286233,125020,157342,21776,8389,8227,162,1294,8,0.057979823,0,hg38,CD-0722-2
"H1,A10",7288,8202,5446,2756,4853,2569,0,2574,1574,1000,1.574,1427,453,63,42,42,0,23,0,0.023809524,0,empty,CD-0722-2
"H1,A11",4313,4670,3269,1401,2867,1502,0,1502,1031,471,2.18895966,784,1664,383,141,141,0,55,0,0.070921986,0,empty,CD-0722-2
"H1,A12",6863,7693,5116,2577,4544,2407,0,2409,1513,896,1.688616071,1342,2723,631,256,250,6,93,2,0.012,0,empty,CD-0722-2
"H1,B1",5512,6485,3979,2506,3829,2212,0,2212,1418,794,1.785894207,1318,1539,268,104,100,4,41,1,0.05,0,empty,CD-0722-2
"H1,B2",490944,558483,339549,218934,325414,183698,0,183839,145315,38524,3.772064168,111810,28575,4354,1734,1711,23,351,2,0.055523086,0,hg38,CD-0722-2
"H1,B3",4678,5528,3401,2127,3234,1822,0,1822,1229,593,2.072512648,1066,1741,333,133,130,3,45,2,0.084615385,0,empty,CD-0722-2
"H1,B4",5958,6893,4222,2671,4186,2503,0,2506,1509,997,1.513540622,1523,1320,268,140,139,1,53,1,0.143884892,0,empty,CD-0722-2
"H1,B5",472432,259333,160887,98446,184915,98279,5,98973,73008,25965,2.811785095,62562,142603,13683,5234,5060,174,978,6,0.05,0,hg38,CD-0722-2
"H1,B6",7333,8943,5021,3922,5244,3308,0,3313,1845,1468,1.256811989,2077,1713,347,143,141,2,37,2,0.19858156,0,empty,CD-0722-2
"H1,B7",4939,5604,3584,2020,3299,1804,0,1804,1196,608,1.967105263,1010,1235,294,143,142,1,50,1,0.267605634,0,empty,CD-0722-2
"H1,B8",4041,4435,2989,1446,2662,1388,0,1392,928,464,2,759,1120,272,148,145,3,53,2,0.131034483,0,empty,CD-0722-2
"H1,B9",377891,477644,254417,223227,277656,194106,0,194212,144628,49584,2.916828009,120706,1910,718,194,190,4,66,1,0.068421053,0,hg38,CD-0722-2
"H1,B10",3469,3868,2438,1430,2345,1286,0,1290,793,497,1.595573441,754,448,80,39,38,1,13,1,0.236842105,0,empty,CD-0722-2
"H1,B11",12813,15409,8977,6432,9170,5665,0,5668,3446,2222,1.550855086,3525,332,96,39,38,1,17,1,0,0,empty,CD-0722-2
"H1,B12",5005,5841,3714,2127,3447,1869,0,1871,1222,649,1.882896764,1090,1610,530,221,220,1,56,1,0.090909091,0,empty,CD-0722-2
"H1,C1",8649,9625,6475,3150,5741,3114,0,3115,1929,1186,1.626475548,1715,1224,162,71,71,0,32,0,0.042253521,0,empty,CD-0722-2
"H1,C2",7313,8282,5288,2994,4839,2692,0,2696,1717,979,1.753830439,1539,2231,678,243,242,1,63,1,0.165289256,0,empty,CD-0722-2
"H1,C3",819363,1044675,581525,463150,592975,376472,0,376725,293266,83459,3.513893049,237246,19447,5116,1775,1766,9,395,3,0.076443941,0,hg38,CD-0722-2
"H1,C4",5143,5865,3744,2121,3462,1866,0,1869,1169,700,1.67,1050,1744,445,152,149,3,46,2,0.194630872,0,empty,CD-0722-2
"H1,C5",6769,7776,5108,2668,4646,2526,0,2535,1630,905,1.801104972,1431,2036,449,184,181,3,59,2,0.044198895,0,empty,CD-0722-2
"H1,C6",6101,6947,4442,2505,4246,2335,0,2344,1498,846,1.770685579,1377,2236,475,184,178,6,53,1,0.056179775,0,empty,CD-0722-2
"H1,C7",9010,11162,6209,4953,6588,4158,0,4160,2323,1837,1.264561786,2633,487,50,25,25,0,9,0,0,0,empty,CD-0722-2
"H1,C8",758747,892665,563864,328801,508141,291625,2,291869,231407,60462,3.827313023,170885,111782,22925,9102,8965,137,1453,6,0.050976018,0,hg38,CD-0722-2
"H1,C9",6366,7259,4621,2638,4399,2371,0,2375,1513,862,1.755220418,1406,1392,182,90,90,0,37,0,0.066666667,0,empty,CD-0722-2
"H1,C10",6990,7691,5068,2623,4617,2503,0,2503,1610,893,1.802911534,1382,2476,570,192,188,4,61,1,0.058510638,0,empty,CD-0722-2
"H1,C11",586406,709270,424928,284342,406267,238655,2,238852,189267,49585,3.817021277,144628,193452,27304,10484,10280,204,1703,11,0.074708171,0,hg38,CD-0722-2
"H1,C12",8709,9976,6269,3707,5912,3230,1,3236,2102,1134,1.85361552,1933,2091,510,230,227,3,63,3,0.04845815,0,empty,CD-0722-2
"H1,D1",9051,10762,6347,4415,6358,3908,0,3910,2264,1646,1.37545565,2377,1393,290,121,120,1,34,1,0.05,0,empty,CD-0722-2
"H1,D2",5653,6486,4300,2186,3782,1936,0,1937,1253,684,1.831871345,1066,3393,858,291,289,2,98,1,0.034602076,0,empty,CD-0722-2
"H1,D3",5869,6678,4365,2313,3939,2181,0,2181,1483,698,2.124641834,1243,1309,280,153,152,1,55,1,0.046052632,0,empty,CD-0722-2
"H1,D4",4815,5447,3606,1841,3272,1764,0,1769,1176,593,1.983136594,970,1597,322,121,118,3,43,2,0.347457627,0,empty,CD-0722-2
"H1,D5",5452,6508,3874,2634,3919,2273,0,2273,1539,734,2.096730245,1423,1552,214,102,102,0,45,0,0.205882353,0,empty,CD-0722-2
"H1,D6",8376,9930,5900,4030,5799,3512,0,3521,2133,1388,1.536743516,2181,1777,388,155,151,4,50,2,0.026490066,0,empty,CD-0722-2
"H1,D7",4202,4576,3197,1379,2797,1407,0,1410,951,459,2.071895425,769,2236,622,260,259,1,82,1,0.046332046,0,empty,CD-0722-2
"H1,D8",5447,6330,3937,2393,3744,2167,0,2169,1390,779,1.784338896,1275,1387,298,136,129,7,56,2,0.131782946,0,empty,CD-0722-2
"H1,D9",3610,4341,2640,1701,2572,1430,0,1432,965,467,2.066381156,868,1420,310,89,86,3,20,2,0.081395349,0,empty,CD-0722-2
"H1,D10",4856,5521,3458,2063,3308,1901,0,1901,1186,715,1.658741259,1102,1056,249,116,116,0,40,0,0.017241379,0,empty,CD-0722-2
"H1,D11",1319455,1551106,980168,570938,870436,497539,3,497951,408632,89319,4.57497285,292818,109470,13221,4905,4811,94,1178,4,0.025358553,0,hg38,CD-0722-2
"H1,D12",2064233,2506283,1497232,1009051,1391052,844137,6,844812,682444,162368,4.20306957,512740,325759,54218,20921,20559,362,2909,9,0.059390048,0,hg38,CD-0722-2
"H1,E1",9645,10769,7040,3729,6339,3495,0,3495,2114,1381,1.530774801,1990,2316,403,201,195,6,66,2,0.123076923,0,empty,CD-0722-2
"H1,E2",6145,7106,4332,2774,4260,2459,0,2461,1529,932,1.64055794,1474,1717,404,150,147,3,50,2,0.102040816,0,empty,CD-0722-2
"H1,E3",4155,4939,3046,1893,3018,1699,0,1703,1097,606,1.810231023,1027,1945,552,239,238,1,73,1,0.067226891,0,empty,CD-0722-2
"H1,E4",6126,6785,4360,2425,4105,2272,0,2277,1481,796,1.860552764,1307,2122,466,198,196,2,77,1,0.081632653,0,empty,CD-0722-2
"H1,E5",4778,5376,3557,1819,3236,1728,0,1733,1121,612,1.831699346,975,1091,236,115,114,1,43,1,0.061403509,0,empty,CD-0722-2
"H1,E6",9849,11207,7087,4120,6693,3798,0,3798,2402,1396,1.720630372,2143,3370,846,387,383,4,111,3,0.177545692,0,empty,CD-0722-2
"H1,E7",15465,16887,11694,5193,9581,4713,1,4721,3325,1396,2.381805158,2565,8952,1693,652,644,8,159,2,0.071428571,0,empty,CD-0722-2
"H1,E8",6562,7325,4981,2344,4331,2268,0,2268,1494,774,1.930232558,1246,2604,690,253,249,4,80,2,0.020080321,0,empty,CD-0722-2
"H1,E9",907710,1127052,642933,484119,647560,411844,3,412128,296958,115170,2.578431883,255889,145557,21108,8525,8373,152,1491,9,0.059715753,0,hg38,CD-0722-2
"H1,E10",4840,5415,3555,1860,3186,1724,0,1727,1126,601,1.873544093,963,1428,305,145,141,4,40,1,0.056737589,0,empty,CD-0722-2
"H1,E11",5955,6618,4322,2296,4022,2259,0,2266,1403,863,1.625724218,1265,2065,601,255,255,0,73,0,0.105882353,0,empty,CD-0722-2
"H1,E12",6987,7870,5121,2749,4689,2596,0,2598,1661,937,1.772678762,1477,1846,500,193,192,1,62,1,0.098958333,0,empty,CD-0722-2
"H1,F1",7601,8797,5621,3176,5153,2836,0,2841,1803,1038,1.73699422,1618,2410,391,167,166,1,69,1,0.048192771,0,empty,CD-0722-2
"H1,F2",46646,52433,36544,15889,30049,14625,0,14640,10753,3887,2.766400823,8009,3375,939,388,386,2,99,2,0.031088083,0,empty,CD-0722-2
"H1,F3",12240,14309,9005,5304,8285,4771,0,4785,3225,1560,2.067307692,2786,3265,506,254,252,2,97,2,0.051587302,0,empty,CD-0722-2
"H1,F4",8023,8957,5912,3045,5399,2865,1,2870,1885,985,1.913705584,1651,860,145,95,94,1,42,1,0.191489362,0,empty,CD-0722-2
"H1,F5",6039,6660,4535,2125,4080,2136,0,2136,1358,778,1.745501285,1193,2079,268,134,133,1,60,1,0.067669173,0,empty,CD-0722-2
"H1,F6",752542,932075,538495,393580,526647,322180,2,322410,256855,65555,3.918160323,199947,97510,14598,5748,5648,100,1177,3,0.020892351,0,hg38,CD-0722-2
"H1,F7",7316,8294,5396,2898,4944,2726,0,2730,1805,925,1.951351351,1563,998,159,74,73,1,28,1,0.123287671,0,empty,CD-0722-2
"H1,F8",5670,6516,4190,2326,3823,2059,0,2059,1311,748,1.752673797,1170,508,94,44,43,1,31,1,0.023255814,0,empty,CD-0722-2
"H1,F9",6525,7479,4901,2578,4388,2277,0,2278,1500,778,1.928020566,1325,3487,649,317,315,2,96,1,0.06984127,0,empty,CD-0722-2
"H1,F10",7704,8613,5801,2812,5118,2734,0,2738,1796,942,1.906581741,1501,1134,244,121,120,1,44,1,0.108333333,0,empty,CD-0722-2
"H1,F11",6841,7331,5114,2217,4454,2259,1,2262,1546,716,2.159217877,1245,1783,358,152,150,2,48,2,0.053333333,0,empty,CD-0722-2
"H1,F12",6532,7502,4765,2737,4424,2413,0,2416,1576,840,1.876190476,1422,405,55,28,27,1,15,1,0.296296296,0,empty,CD-0722-2
"H1,G1",6623,7648,4969,2679,4519,2369,0,2372,1593,779,2.044929397,1353,3328,783,328,324,4,101,2,0.092592593,0,empty,CD-0722-2
"H1,G2",4328,4882,2978,1904,2895,1686,0,1688,1043,645,1.617054264,1005,682,134,60,60,0,35,0,0.116666667,0,empty,CD-0722-2
"H1,G3",7889,8597,5677,2920,5226,2919,0,2926,1702,1224,1.390522876,1629,2479,488,219,218,1,70,1,0.013761468,0,empty,CD-0722-2
"H1,G4",1725148,2192931,1150060,1042871,1258290,879610,2,880207,552162,328045,1.683189806,559244,1812,158,61,56,5,25,1,0.267857143,0,empty,CD-0722-2
"H1,G5",4559,5162,3319,1843,3122,1692,0,1692,1142,550,2.076363636,984,2028,563,236,229,7,69,2,0.152838428,0,empty,CD-0722-2
"H1,G6",6803,7514,5092,2422,4450,2384,0,2387,1574,813,1.93603936,1255,191,65,42,42,0,18,0,0,0,empty,CD-0722-2
"H1,G7",5605,6282,4180,2102,3611,1862,0,1862,1195,667,1.791604198,1040,2912,666,272,270,2,78,1,0.092592593,0,empty,CD-0722-2
"H1,G8",3952,4560,2899,1661,2707,1439,0,1441,920,521,1.765834933,838,1750,294,167,164,3,62,2,0.048780488,0,empty,CD-0722-2
"H1,G9",4860,5413,3536,1877,3288,1760,0,1763,1138,625,1.8208,1029,2375,477,206,204,2,75,2,0.107843137,0,empty,CD-0722-2
"H1,G10",6399,7397,4652,2745,4406,2544,0,2544,1624,920,1.765217391,1470,2522,623,241,239,2,95,1,0.054393305,0,empty,CD-0722-2
"H1,G11",5876,6567,4385,2182,3904,2027,0,2029,1395,634,2.200315457,1142,1433,449,180,180,0,49,0,0.038888889,0,empty,CD-0722-2
"H1,G12",5553,6379,3905,2474,3866,2213,0,2217,1449,768,1.88671875,1335,2708,532,232,231,1,91,1,0.064935065,0,empty,CD-0722-2
"H1,H1",6093,6852,4496,2356,4104,2233,0,2236,1398,838,1.668257757,1268,1380,206,136,135,1,54,1,0.096296296,0,empty,CD-0722-2
"H1,H2",9557,11209,7076,4133,6591,3561,0,3565,2527,1038,2.434489403,2088,2300,683,301,298,3,86,1,0.053691275,0,empty,CD-0722-2
"H1,H3",716850,881023,514550,366473,498332,299634,3,299877,240321,59556,4.035210558,184903,81495,11892,4532,4436,96,916,5,0.055229937,0,hg38,CD-0722-2
"H1,H4",611048,778186,416504,361682,443601,290450,1,290639,217564,73075,2.977269928,189364,7257,1090,466,458,8,122,2,0.170305677,0,hg38,CD-0722-2
"H1,H5",7260,8451,5178,3273,4980,2820,0,2824,1862,962,1.935550936,1664,2252,755,287,285,2,95,1,0.129824561,0,empty,CD-0722-2
"H1,H6",5686,6463,4071,2392,3857,2231,0,2231,1493,738,2.02303523,1301,2308,419,233,229,4,70,2,0.026200873,0,empty,CD-0722-2
"H1,H7",5841,6514,4335,2179,3933,2071,0,2073,1407,666,2.112612613,1153,2355,576,280,280,0,103,0,0.146428571,0,empty,CD-0722-2
"H1,H8",21929,26540,15616,10924,15653,9435,0,9439,6441,2998,2.148432288,5760,2626,552,256,254,2,82,2,0.066929134,0,empty,CD-0722-2
"H1,H9",711976,816087,540337,275750,458451,238472,3,238691,186154,52537,3.543293298,137779,104829,12604,5142,4986,156,971,6,0.045527477,0,hg38,CD-0722-2
"H1,H10",10334,12180,7537,4643,6996,3831,0,3836,2639,1197,2.204678363,2305,2434,351,167,166,1,68,1,0.072289157,0,empty,CD-0722-2
"H1,H11",7963,9707,5401,4306,5817,3924,0,3928,2071,1857,1.115239634,2411,59,13,7,7,0,5,0,0,0,empty,CD-0722-2
"H1,H12",5411,6299,3883,2416,3737,2164,0,2164,1404,760,1.847368421,1274,1593,326,129,123,6,45,3,0.032520325,0,empty,CD-0722-2
"H2,A1",5036,6055,3644,2411,3595,2102,0,2104,1310,794,1.649874055,1240,1475,371,148,148,0,43,0,0.243243243,0,empty,CD-0722-2
"H2,A2",8033,9410,5888,3522,5502,3087,0,3088,1898,1190,1.594957983,1764,2228,681,302,302,0,56,0,0.195364238,0,empty,CD-0722-2
"H2,A3",4549,5258,3252,2006,3237,1878,0,1881,1242,639,1.943661972,1134,1374,362,152,152,0,46,0,0.006578947,0,empty,CD-0722-2
"H2,A4",6486,7344,4842,2502,4431,2363,0,2363,1491,872,1.709862385,1334,802,149,54,53,1,25,1,0.226415094,0,empty,CD-0722-2
"H2,A5",6613,7527,4710,2817,4470,2484,0,2486,1567,919,1.705114255,1454,2581,557,242,238,4,55,2,0.008403361,0,empty,CD-0722-2
"H2,A6",14656,16645,11019,5626,10127,5456,0,5460,3925,1535,2.557003257,3109,3059,918,400,395,5,102,2,0.078481013,0,empty,CD-0722-2
"H2,A7",5014,5771,3620,2151,3552,2076,0,2079,1319,760,1.735526316,1202,1460,313,127,127,0,45,0,0.102362205,0,empty,CD-0722-2
"H2,A8",361618,461958,254414,207544,273458,180467,3,180589,123931,56658,2.187352183,113072,43990,14122,5231,5181,50,930,2,0.033391237,0,hg38,CD-0722-2
"H2,A9",5548,6444,4075,2369,3892,2097,0,2097,1340,757,1.77014531,1231,2232,526,219,219,0,64,0,0.04109589,0,empty,CD-0722-2
"H2,A10",628691,600348,537034,63314,336054,89645,0,89787,66880,22907,2.919631554,32668,1113,315,123,123,0,66,0,0.008130081,0,hg38,CD-0722-2
"H2,A11",4666,5249,3545,1704,3025,1552,0,1555,999,556,1.79676259,830,2398,511,218,217,1,65,1,0.069124424,0,empty,CD-0722-2
"H2,A12",7263,7961,5286,2675,4747,2607,0,2608,1689,919,1.837867247,1450,4822,1170,467,456,11,114,2,0.11622807,0,empty,CD-0722-2
"H2,B1",5321,6077,3840,2237,3673,2109,0,2113,1332,781,1.705505762,1189,1631,507,200,200,0,51,0,0.12,0,empty,CD-0722-2
"H2,B2",5181,6113,3491,2622,3685,2249,1,2250,1397,853,1.637749121,1387,797,193,52,51,1,25,1,0.039215686,0,empty,CD-0722-2
"H2,B3",4889,5690,3566,2124,3488,1962,0,1965,1296,669,1.937219731,1202,1874,324,163,155,8,70,2,0.038709677,0,empty,CD-0722-2
"H2,B4",6175,7388,4372,3016,4523,2731,0,2735,1710,1025,1.668292683,1659,1300,397,159,157,2,49,2,0.178343949,0,empty,CD-0722-2
"H2,B5",5332,3183,1949,1234,2278,1278,2,1289,855,434,1.970046083,798,1061,169,87,87,0,37,0,0.126436782,0,empty,CD-0722-2
"H2,B6",6542,7375,4567,2808,4491,2687,0,2687,1601,1086,1.474217311,1578,1964,641,260,253,7,53,3,0.110671937,0,empty,CD-0722-2
"H2,B7",5003,5786,3771,2015,3457,1838,0,1840,1150,690,1.666666667,1042,1338,267,113,110,3,36,1,0.054545455,0,empty,CD-0722-2
"H2,B8",4199,4801,3155,1646,2877,1569,0,1569,1018,551,1.847549909,848,1320,249,125,125,0,56,0,0.064,0,empty,CD-0722-2
"H2,B9",8410,9516,6065,3451,5722,3308,0,3313,2063,1250,1.6504,1896,1483,353,181,176,5,66,1,0.073863636,0,empty,CD-0722-2
"H2,B10",3764,4073,2667,1406,2581,1396,0,1398,846,552,1.532608696,819,875,274,82,81,1,18,1,0.012345679,0,empty,CD-0722-2
"H2,B11",15308,17437,11367,6070,10310,5741,0,5747,3344,2403,1.391593841,3284,397,84,51,51,0,20,0,0.019607843,0,empty,CD-0722-2
"H2,B12",4943,5692,3652,2040,3511,1941,0,1945,1306,639,2.043818466,1156,2395,528,237,233,4,71,1,0.068669528,0,empty,CD-0722-2
"H2,C1",8849,9621,6687,2934,5720,2959,0,2960,1849,1111,1.664266427,1596,1286,241,110,110,0,41,0,0.027272727,0,empty,CD-0722-2
"H2,C2",7616,8951,5459,3492,5276,3066,0,3078,1935,1143,1.692913386,1824,2565,581,231,230,1,67,1,0.008695652,0,empty,CD-0722-2
"H2,C3",7554,8514,5571,2943,5229,2884,0,2887,1827,1060,1.723584906,1613,790,190,76,76,0,28,0,0.092105263,0,empty,CD-0722-2
"H2,C4",5287,5852,3891,1961,3483,1821,0,1822,1165,657,1.773211568,994,1636,291,120,118,2,39,1,0.076271186,0,empty,CD-0722-2
"H2,C5",6983,7881,5075,2806,4743,2624,0,2626,1659,967,1.715615305,1489,1944,402,170,167,3,58,2,0.077844311,0,empty,CD-0722-2
"H2,C6",7418,8567,5339,3228,5168,2952,0,2954,1954,1000,1.954,1730,2125,628,232,231,1,56,1,0.012987013,0,empty,CD-0722-2
"H2,C7",8782,10458,6166,4292,6226,3799,0,3801,2258,1543,1.46338302,2279,578,183,47,46,1,14,1,0,0,empty,CD-0722-2
"H2,C8",9512,10689,6999,3690,6502,3616,0,3622,2318,1304,1.777607362,2043,3636,867,322,316,6,103,2,0.136075949,0,empty,CD-0722-2
"H2,C9",7064,8059,5236,2823,4806,2547,0,2551,1567,984,1.592479675,1467,2244,368,161,159,2,47,1,0.094339623,0,empty,CD-0722-2
"H2,C10",1910216,2127309,1468537,658772,1183892,611585,2,612174,488836,123338,3.963385169,342210,244554,30240,11937,11676,261,1933,8,0.029804728,0,hg38,CD-0722-2
"H2,C11",5820,6520,4174,2346,4021,2247,0,2247,1478,769,1.921976593,1278,2417,573,239,232,7,66,2,0.030172414,0,empty,CD-0722-2
"H2,C12",8958,10047,6601,3446,6011,3147,0,3151,2074,1077,1.925719591,1790,2396,454,165,159,6,63,2,0.056603774,0,empty,CD-0722-2
"H2,D1",9005,10681,6320,4361,6352,3923,0,3930,2273,1657,1.371756186,2350,1133,303,116,116,0,35,0,0.017241379,0,empty,CD-0722-2
"H2,D2",537883,608604,410366,198238,353931,181383,2,181538,138036,43502,3.17309549,102892,155138,21849,8119,7921,198,1354,5,0.062618356,0,hg38,CD-0722-2
"H2,D3",6088,6845,4494,2351,4174,2293,0,2293,1552,741,2.094466937,1282,1289,216,111,111,0,45,0,0.162162162,0,empty,CD-0722-2
"H2,D4",340443,317681,305333,12348,183128,28421,0,28518,19809,8709,2.274543576,5726,6058,1095,435,431,4,207,2,0.020881671,0,empty,CD-0722-2
"H2,D5",5117,5964,3668,2296,3694,2087,0,2088,1382,706,1.957507082,1253,2008,500,154,153,1,48,1,0.058823529,0,empty,CD-0722-2
"H2,D6",8544,9570,5943,3627,5809,3528,0,3528,2090,1438,1.45340751,2071,1778,571,209,208,1,63,1,0.033653846,0,empty,CD-0722-2
"H2,D7",4524,5044,3431,1613,2952,1523,1,1524,995,529,1.880907372,830,2442,617,240,239,1,73,1,0.146443515,0,empty,CD-0722-2
"H2,D8",5193,5888,3799,2089,3472,1869,0,1869,1185,684,1.73245614,1077,1697,433,164,163,1,56,1,0.226993865,0,empty,CD-0722-2
"H2,D9",3029,3474,2199,1275,2119,1130,0,1130,715,415,1.722891566,685,1985,256,114,102,12,42,2,0.049019608,0,empty,CD-0722-2
"H2,D10",662457,807833,479092,328741,468671,280958,1,281176,221058,60118,3.677068432,171754,5102,800,242,236,6,84,2,0.06779661,0,hg38,CD-0722-2
"H2,D11",6104,7004,4501,2503,4199,2277,1,2280,1462,818,1.787286064,1288,3880,837,323,323,0,93,0,0.018575851,0,empty,CD-0722-2
"H2,D12",23201,25533,15722,9811,14877,8609,0,8619,6468,2151,3.006973501,5068,14273,2372,902,881,21,206,2,0.080590238,0,empty,CD-0722-2
"H2,E1",10094,11570,7366,4204,6947,3921,0,3921,2401,1520,1.579605263,2284,2681,373,185,185,0,69,0,0.145945946,0,empty,CD-0722-2
"H2,E2",6473,7436,4658,2778,4415,2433,0,2436,1557,879,1.771331058,1426,2227,431,218,217,1,73,1,0.023041475,0,empty,CD-0722-2
"H2,E3",4333,4901,3138,1763,2978,1639,0,1639,1089,550,1.98,951,2263,762,265,264,1,78,1,0.049242424,0,empty,CD-0722-2
"H2,E4",865024,1051588,628208,423380,601156,355327,3,355593,294284,61309,4.800013049,215494,167903,29353,11854,11660,194,1865,6,0.056861063,0,hg38,CD-0722-2
"H2,E5",5008,5638,3731,1907,3406,1803,0,1809,1170,639,1.830985915,1063,1417,385,183,182,1,49,1,0.208791209,0,empty,CD-0722-2
"H2,E6",611736,674638,473185,201453,384595,183979,2,184141,134129,50012,2.681936335,101729,63418,7869,3136,3057,79,661,5,0.037945698,0,hg38,CD-0722-2
"H2,E7",906428,1029565,697537,332028,582843,302539,2,302771,240180,62591,3.837292902,169036,209176,34922,13693,13459,234,1949,8,0.044728435,0,hg38,CD-0722-2
"H2,E8",7011,7813,5286,2527,4662,2424,0,2425,1619,806,2.008684864,1341,2550,544,202,199,3,52,1,0.095477387,0,empty,CD-0722-2
"H2,E9",593757,731021,426074,304947,423929,255072,2,255264,198899,56365,3.528767852,157569,174013,24952,9891,9667,224,1675,9,0.050481018,0,hg38,CD-0722-2
"H2,E10",4641,5240,3414,1826,3172,1708,0,1708,1108,600,1.846666667,1007,2169,555,236,230,6,67,2,0.1,0,empty,CD-0722-2
"H2,E11",6412,7257,4761,2496,4295,2405,0,2413,1534,879,1.74516496,1342,2328,569,225,224,1,63,1,0.098214286,0,empty,CD-0722-2
"H2,E12",7307,8300,5282,3018,5021,2799,0,2806,1862,944,1.972457627,1610,2146,421,203,196,7,58,3,0.173469388,0,empty,CD-0722-2
"H2,F1",8090,8915,5797,3118,5239,2833,0,2838,1816,1022,1.776908023,1613,3199,865,333,333,0,85,0,0.036036036,0,empty,CD-0722-2
"H2,F2",6371,7107,4604,2503,4290,2298,1,2302,1444,858,1.682983683,1309,3139,487,214,213,1,83,1,0.084507042,0,empty,CD-0722-2
"H2,F3",6074,6959,4429,2530,4125,2264,0,2266,1449,817,1.773561812,1304,2938,563,230,226,4,71,3,0.14159292,0,empty,CD-0722-2
"H2,F4",8223,9113,6089,3024,5491,2938,0,2939,1942,997,1.947843531,1638,834,127,36,36,0,24,0,0.027777778,0,empty,CD-0722-2
"H2,F5",6525,7080,4915,2165,4212,2126,0,2130,1420,710,2,1154,2275,512,256,249,7,77,1,0.048192771,0,empty,CD-0722-2
"H2,F6",7409,8740,5333,3407,5212,3029,0,3031,1876,1155,1.624242424,1820,2862,599,221,221,0,77,0,0.045248869,0,empty,CD-0722-2
"H2,F7",7415,8253,5403,2850,5063,2806,0,2806,1775,1031,1.721629486,1603,1275,359,118,116,2,35,1,0.043103448,0,empty,CD-0722-2
"H2,F8",5754,6739,4232,2507,4018,2192,0,2197,1488,709,2.098730606,1235,425,78,50,50,0,23,0,0,0,empty,CD-0722-2
"H2,F9",6737,7505,5103,2402,4577,2398,0,2398,1587,811,1.956843403,1322,3783,882,336,328,8,98,2,0.067073171,0,empty,CD-0722-2
"H2,F10",7329,8103,5535,2568,4861,2527,0,2528,1641,887,1.85005637,1377,2360,497,238,237,1,59,1,0.05907173,0,empty,CD-0722-2
"H2,F11",7069,7820,5370,2450,4711,2405,0,2408,1620,788,2.055837563,1316,2309,529,212,210,2,60,1,0.071428571,0,empty,CD-0722-2
"H2,F12",7095,7915,5131,2784,4699,2554,0,2556,1672,884,1.891402715,1443,259,44,32,32,0,11,0,0.0625,0,empty,CD-0722-2
"H2,G1",13796,15931,10489,5442,9251,4723,0,4736,3146,1590,1.978616352,2674,43958,4791,1930,1899,31,391,3,0.110584518,0,empty,CD-0722-2
"H2,G2",4364,5087,3026,2061,3100,1804,0,1809,1123,686,1.637026239,1084,633,102,50,50,0,29,0,0.02,0,empty,CD-0722-2
"H2,G3",8944,9945,6483,3462,5897,3287,0,3288,1890,1398,1.35193133,1797,2717,861,346,344,2,69,1,0.084302326,0,empty,CD-0722-2
"H2,G4",15662,18077,11029,7048,10833,6651,0,6655,4064,2591,1.568506368,3902,161,35,10,10,0,7,0,0,0,empty,CD-0722-2
"H2,G5",4760,5615,3468,2147,3370,1915,0,1917,1228,689,1.782293179,1148,2075,543,207,200,7,57,3,0.105,0,empty,CD-0722-2
"H2,G6",7087,7999,5299,2700,4728,2561,0,2561,1705,856,1.99182243,1371,135,19,12,12,0,7,0,0,0,empty,CD-0722-2
"H2,G7",5795,6568,4319,2249,3881,1969,0,1970,1285,685,1.875912409,1111,2684,694,262,259,3,67,2,0.158301158,0,empty,CD-0722-2
"H2,G8",4204,4875,3115,1760,2907,1615,0,1619,1039,580,1.79137931,958,2302,537,216,215,1,76,1,0.106976744,0,empty,CD-0722-2
"H2,G9",5015,5948,3673,2275,3556,1972,0,1973,1253,720,1.740277778,1170,3388,1055,393,392,1,100,1,0.102040816,0,empty,CD-0722-2
"H2,G10",6553,7400,4779,2621,4492,2494,0,2495,1585,910,1.741758242,1447,2760,688,305,303,2,98,1,0.052805281,0,empty,CD-0722-2
"H2,G11",6272,6871,4709,2162,4139,2155,0,2155,1440,715,2.013986014,1149,1583,310,130,129,1,49,1,0.124031008,0,empty,CD-0722-2
"H2,G12",1643033,2020183,1191467,828716,1163884,709729,5,710283,564503,145780,3.872293867,435942,358751,59130,23181,22785,396,3017,9,0.057098969,0,hg38,CD-0722-2
"H2,H1",6063,6958,4407,2551,4118,2266,0,2266,1446,820,1.763414634,1284,1602,329,118,115,3,45,2,0.008695652,0,empty,CD-0722-2
"H2,H2",6182,7100,4441,2659,4273,2383,0,2383,1604,779,2.059050064,1362,2542,434,171,169,2,67,2,0.065088757,0,empty,CD-0722-2
"H2,H3",5692,6427,4124,2303,3921,2191,0,2191,1464,727,2.013755158,1277,1766,298,150,147,3,59,2,0.156462585,0,empty,CD-0722-2
"H2,H4",7706,8817,5614,3203,5149,2818,0,2821,1825,996,1.832329317,1615,256,60,36,36,0,19,0,0.055555556,0,empty,CD-0722-2
"H2,H5",768739,917721,564398,353323,526372,299891,1,300139,229166,70973,3.228918039,181657,111206,16132,6208,6063,145,1123,9,0.041563582,0,hg38,CD-0722-2
"H2,H6",266997,349009,182399,166610,206165,138509,0,138600,112843,25757,4.381061459,90222,6804,2788,937,927,10,255,2,0.025889968,0,hg38,CD-0722-2
"H2,H7",6047,6748,4498,2250,4092,2226,0,2226,1443,783,1.842911877,1239,2808,730,306,304,2,89,1,0.095394737,0,empty,CD-0722-2
"H2,H8",15458,18453,11205,7248,10987,6379,0,6382,4543,1839,2.470364328,3807,2582,578,252,248,4,66,2,0.080645161,0,empty,CD-0722-2
"H2,H9",5576,6360,4128,2232,3692,1904,0,1909,1278,631,2.025356577,1098,1717,371,136,134,2,48,1,0.037313433,0,empty,CD-0722-2
"H2,H10",4821,5382,3597,1785,3231,1705,0,1705,1088,617,1.763371151,963,1600,238,119,116,3,47,1,0.060344828,0,empty,CD-0722-2
"H2,H11",8077,9584,5424,4160,5813,3865,0,3866,2103,1763,1.192853091,2333,135,78,23,23,0,7,0,0,0,empty,CD-0722-2
"H2,H12",5847,6662,4194,2468,3971,2290,0,2292,1493,799,1.868585732,1322,2220,452,176,169,7,61,1,0.041420118,0,empty,CD-0722-2
"H3,A1",4099,4687,2915,1772,2792,1594,1,1600,969,631,1.535657686,943,1884,495,202,202,0,54,0,0.094059406,0,empty,CD-0722-2
"H3,A2",9320,10564,7071,3493,6193,3339,0,3344,2183,1161,1.880275624,1845,2636,647,241,238,3,58,1,0.050420168,0,empty,CD-0722-2
"H3,A3",3524,3848,2542,1306,2346,1275,0,1275,826,449,1.839643653,684,1261,360,152,151,1,53,1,0.105960265,0,empty,CD-0722-2
"H3,A4",1096765,1227164,840504,386660,693272,356317,2,356634,299814,56820,5.27655755,199887,22453,4206,1516,1484,32,319,4,0.004716981,0,hg38,CD-0722-2
"H3,A5",5170,5647,3856,1791,3460,1884,0,1885,1247,638,1.954545455,1030,2434,675,270,270,0,66,0,0.1,0,empty,CD-0722-2
"H3,A6",4681,5591,3476,2115,3397,2003,0,2005,1258,747,1.684069612,1171,2790,574,270,265,5,100,2,0.079245283,0,empty,CD-0722-2
"H3,A7",4038,4760,2900,1860,2857,1655,0,1659,1067,592,1.802364865,1010,1405,321,161,159,2,54,2,0.056603774,0,empty,CD-0722-2
"H3,A8",2359,2627,1773,854,1625,884,0,886,605,281,2.153024911,488,2574,453,223,221,2,88,1,0.049773756,0,empty,CD-0722-2
"H3,A9",6528,7349,4989,2360,4412,2323,0,2323,1586,737,2.151967436,1266,1829,383,163,162,1,61,1,0.055555556,0,empty,CD-0722-2
"H3,A10",79531,81645,63083,18562,48365,24208,0,24228,15980,8248,1.937439379,10572,651,130,42,41,1,14,1,0.146341463,0,empty,CD-0722-2
"H3,A11",3617,4176,2645,1531,2557,1351,0,1352,832,520,1.6,835,2117,330,151,151,0,49,0,0.072847682,0,empty,CD-0722-2
"H3,A12",5352,5932,3987,1945,3498,1811,0,1815,1193,622,1.918006431,1024,13440,1543,631,607,24,161,3,0.037891269,0,empty,CD-0722-2
"H3,B1",4537,5174,3133,2041,3055,1722,0,1722,1115,607,1.836902801,1054,1144,255,104,103,1,41,1,0.106796117,0,empty,CD-0722-2
"H3,B2",4844,5505,3164,2341,3298,2016,0,2017,1279,738,1.733062331,1211,593,107,49,49,0,23,0,0.102040816,0,empty,CD-0722-2
"H3,B3",3952,4440,2889,1551,2709,1497,0,1497,994,503,1.976143141,823,1768,211,97,94,3,52,2,0.074468085,0,empty,CD-0722-2
"H3,B4",534124,624775,397070,227705,361108,198984,1,199160,154586,44574,3.46807556,116881,123317,16703,6511,6347,164,1117,4,0.046005987,0,hg38,CD-0722-2
"H3,B5",4458,2487,1565,922,1783,1010,0,1019,659,360,1.830555556,620,1405,426,157,156,1,40,1,0.128205128,0,empty,CD-0722-2
"H3,B6",4924,5744,3481,2263,3492,2048,0,2048,1266,782,1.618925831,1227,1700,294,120,116,4,41,2,0.112068966,0,empty,CD-0722-2
"H3,B7",4506,5048,3427,1621,3042,1612,0,1616,1094,522,2.095785441,891,1066,246,113,112,1,45,1,0.044642857,0,empty,CD-0722-2
"H3,B8",3384,3993,2497,1496,2307,1238,0,1240,830,410,2.024390244,732,1111,238,92,91,1,44,1,0.021978022,0,empty,CD-0722-2
"H3,B9",6322,6978,4461,2517,4283,2406,0,2406,1430,976,1.465163934,1407,1448,336,152,148,4,50,2,0.040540541,0,empty,CD-0722-2
"H3,B10",2974,3255,2056,1199,2042,1103,0,1104,676,428,1.579439252,632,552,89,41,41,0,22,0,0,0,empty,CD-0722-2
"H3,B11",496718,542837,388734,154103,308672,141271,2,141424,108761,32663,3.32979212,76978,43974,3773,1647,1585,62,368,4,0.079495268,0,hg38,CD-0722-2
"H3,B12",4067,4638,3025,1613,2802,1498,0,1498,946,552,1.713768116,835,7654,735,316,312,4,97,2,0.038461538,0,empty,CD-0722-2
"H3,C1",7895,8884,5814,3070,5142,2756,0,2758,1697,1061,1.599434496,1565,980,163,87,87,0,31,0,0.195402299,0,empty,CD-0722-2
"H3,C2",6231,7154,4540,2614,4214,2363,3,2367,1570,797,1.969887077,1369,2606,704,241,241,0,68,0,0.199170124,0,empty,CD-0722-2
"H3,C3",6332,7395,4671,2724,4409,2442,0,2442,1513,929,1.628632939,1398,1351,236,101,100,1,35,1,0.02,0,empty,CD-0722-2
"H3,C4",4014,4449,3005,1444,2644,1361,0,1363,876,487,1.798767967,744,1588,294,110,108,2,49,2,0.12962963,0,empty,CD-0722-2
"H3,C5",5721,6355,4184,2171,3822,2090,0,2094,1375,719,1.912378303,1172,1589,301,119,117,2,46,1,0.017094017,0,empty,CD-0722-2
"H3,C6",8324,10179,5661,4518,6175,4021,0,4029,2441,1588,1.537153652,2472,1382,398,150,149,1,44,1,0.080536913,0,empty,CD-0722-2
"H3,C7",513622,580221,394508,185713,334344,167660,2,167791,132650,35141,3.774792977,95381,9758,1770,692,678,14,165,2,0.042772861,0,hg38,CD-0722-2
"H3,C8",1233557,1444531,935094,509437,818284,452222,0,452609,372921,79688,4.679763578,261537,170714,27996,11013,10828,185,1824,6,0.05615072,0,hg38,CD-0722-2
"H3,C9",5198,5879,3843,2036,3485,1879,1,1880,1221,659,1.852807284,1030,1667,234,111,109,2,37,1,0.04587156,0,empty,CD-0722-2
"H3,C10",5856,6585,4281,2304,3988,2186,1,2191,1406,785,1.791082803,1237,2009,550,224,224,0,66,0,0.053571429,0,empty,CD-0722-2
"H3,C11",4964,5771,3584,2187,3514,1963,0,1966,1252,714,1.753501401,1200,2528,451,181,173,8,52,2,0,0,empty,CD-0722-2
"H3,C12",7120,8215,5275,2940,4842,2630,0,2634,1819,815,2.23190184,1503,7987,804,358,345,13,86,2,0.072463768,0,empty,CD-0722-2
"H3,D1",6734,7984,4833,3151,4618,2724,0,2724,1672,1052,1.589353612,1599,1136,256,90,86,4,27,1,0.011627907,0,empty,CD-0722-2
"H3,D2",5208,5832,3895,1937,3531,1869,0,1869,1263,606,2.084158416,1076,2780,575,287,287,0,98,0,0.052264808,0,empty,CD-0722-2
"H3,D3",4871,5623,3515,2108,3347,1900,0,1900,1237,663,1.865761689,1136,1283,268,122,121,1,41,1,0.20661157,0,empty,CD-0722-2
"H3,D4",4294,4882,3130,1752,2879,1579,0,1579,1063,516,2.060077519,919,1691,441,160,159,1,46,1,0.106918239,0,empty,CD-0722-2
"H3,D5",1122801,1354032,823500,530532,776802,455635,1,455924,356525,99399,3.586806708,274423,75736,17027,6663,6591,72,1293,5,0.045213169,0,hg38,CD-0722-2
"H3,D6",6752,7966,4660,3306,4779,2956,0,2956,1740,1216,1.430921053,1803,2210,358,155,147,8,56,2,0.095238095,0,empty,CD-0722-2
"H3,D7",3393,3875,2482,1393,2305,1224,0,1224,789,435,1.813793103,740,2217,577,234,222,12,79,2,0.103603604,0,empty,CD-0722-2
"H3,D8",4981,5651,3669,1982,3374,1756,0,1759,1084,675,1.605925926,1021,1472,416,194,194,0,64,0,0.046391753,0,empty,CD-0722-2
"H3,D9",2405,2663,1820,843,1619,855,0,856,558,298,1.872483221,470,1875,357,141,141,0,44,0,0.141843972,0,empty,CD-0722-2
"H3,D10",1790647,2407623,1095746,1311877,1421918,1110439,4,1111112,592793,518319,1.143683716,732147,5679,2320,535,532,3,169,2,0.291353383,0,hg38,CD-0722-2
"H3,D11",4621,5236,3457,1779,3192,1703,0,1704,1129,575,1.963478261,1014,4276,845,353,349,4,104,2,0.048710602,0,empty,CD-0722-2
"H3,D12",6091,6993,4566,2427,4108,2279,0,2279,1419,860,1.65,1258,9598,1200,486,471,15,154,3,0.067940552,0,empty,CD-0722-2
"H3,E1",7607,8892,5293,3599,5277,3013,0,3016,1808,1208,1.496688742,1878,2857,736,296,295,1,88,1,0.047457627,0,empty,CD-0722-2
"H3,E2",5272,5984,3711,2273,3592,2055,0,2064,1277,787,1.622617535,1224,1823,348,161,161,0,62,0,0.01242236,0,empty,CD-0722-2
"H3,E3",3688,4054,2665,1389,2473,1321,0,1324,873,451,1.935698448,768,2469,766,255,255,0,70,0,0.231372549,0,empty,CD-0722-2
"H3,E4",4861,5399,3628,1771,3192,1719,0,1720,1111,609,1.824302135,950,2905,786,326,324,2,98,1,0.114197531,0,empty,CD-0722-2
"H3,E5",4256,4650,3199,1451,2927,1510,0,1510,1004,506,1.984189723,842,1366,250,112,106,6,49,1,0.047169811,0,empty,CD-0722-2
"H3,E6",8495,9677,6238,3439,5759,3263,1,3275,2007,1268,1.582807571,1863,3473,817,330,328,2,95,1,0.042682927,0,empty,CD-0722-2
"H3,E7",7040,7953,5216,2737,4822,2592,0,2592,1692,900,1.88,1478,3066,745,330,326,4,94,2,0.088957055,0,empty,CD-0722-2
"H3,E8",387104,482200,264665,217535,284199,192500,0,192648,145953,46695,3.12566656,118765,8816,3357,1176,1172,4,347,1,0.015358362,0,hg38,CD-0722-2
"H3,E9",3910,4404,2873,1531,2604,1457,0,1457,952,505,1.885148515,813,2761,601,281,275,6,98,1,0.185454545,0,empty,CD-0722-2
"H3,E10",4101,4631,3022,1609,2778,1458,0,1458,950,508,1.87007874,865,1732,388,174,169,5,51,2,0.153846154,0,empty,CD-0722-2
"H3,E11",1188720,1389721,881538,508183,795671,446191,6,446554,355999,90555,3.931301419,261972,312913,51246,19734,19347,387,2600,9,0.070346824,0,hg38,CD-0722-2
"H3,E12",5604,6651,3963,2688,3954,2251,0,2253,1510,743,2.03230148,1384,3910,473,231,229,2,75,2,0.091703057,0,empty,CD-0722-2
"H3,F1",846936,985692,636337,349355,562554,312022,0,312264,257742,54522,4.72730274,179607,248599,32027,12513,12191,322,2049,6,0.041998195,0,hg38,CD-0722-2
"H3,F2",5018,5554,3556,1998,3438,1870,1,1873,1184,689,1.718432511,1089,2807,768,316,316,0,78,0,0.056962025,0,empty,CD-0722-2
"H3,F3",4921,5343,3531,1812,3198,1684,0,1684,1076,608,1.769736842,972,2863,892,357,353,4,96,2,0.087818697,0,empty,CD-0722-2
"H3,F4",7051,7877,5204,2673,4779,2546,0,2551,1693,858,1.973193473,1479,807,173,75,75,0,41,0,0.013333333,0,empty,CD-0722-2
"H3,F5",5609,6130,4146,1984,3675,1923,0,1923,1255,668,1.878742515,1052,2296,448,200,198,2,80,2,0.055555556,0,empty,CD-0722-2
"H3,F6",5920,6854,4229,2625,4118,2363,0,2365,1476,889,1.660292463,1422,3240,853,335,327,8,90,2,0.021406728,0,empty,CD-0722-2
"H3,F7",6321,7225,4671,2554,4302,2286,0,2289,1438,851,1.689776733,1308,913,204,91,91,0,31,0,0.065934066,0,empty,CD-0722-2
"H3,F8",4930,5635,3647,1988,3376,1820,0,1822,1200,622,1.92926045,1074,433,64,40,38,2,20,2,0.052631579,0,empty,CD-0722-2
"H3,F9",5327,6076,3948,2128,3737,1985,0,1985,1313,672,1.953869048,1120,2951,806,335,328,7,103,2,0.137195122,0,empty,CD-0722-2
"H3,F10",6723,7391,4966,2425,4358,2320,0,2320,1511,809,1.867737948,1311,1782,476,208,206,2,55,1,0.116504854,0,empty,CD-0722-2
"H3,F11",5309,5917,3994,1923,3497,1813,0,1813,1244,569,2.18629174,996,2375,327,152,150,2,54,1,0.046666667,0,empty,CD-0722-2
"H3,F12",5959,6724,4222,2502,3916,2121,0,2126,1355,771,1.757457847,1236,656,61,33,32,1,19,1,0,0,empty,CD-0722-2
"H3,G1",590407,680051,444674,235377,391935,208989,3,209188,162366,46822,3.467728845,120588,198860,26532,9812,9610,202,1603,7,0.043080125,0,hg38,CD-0722-2
"H3,G2",3579,4093,2516,1577,2534,1437,0,1438,909,529,1.718336484,830,657,108,65,64,1,39,1,0,0,empty,CD-0722-2
"H3,G3",7293,8019,5392,2627,4864,2701,0,2703,1596,1107,1.441734417,1447,2479,819,317,314,3,69,1,0.124203822,0,empty,CD-0722-2
"H3,G4",834525,977233,619440,357793,556843,312748,0,312993,246241,66752,3.688893217,183275,2529,391,146,143,3,39,2,0.041958042,0,hg38,CD-0722-2
"H3,G5",1140098,1346833,849656,497177,762322,428015,4,428385,332001,96384,3.444565488,253409,225532,26986,10797,10527,270,1878,8,0.04892182,0,hg38,CD-0722-2
"H3,G6",5748,6483,4231,2252,3888,2114,0,2115,1415,700,2.021428571,1202,142,21,15,15,0,9,0,0,0,empty,CD-0722-2
"H3,G7",4697,5303,3589,1714,3179,1672,0,1672,1085,587,1.848381601,894,2762,579,207,205,2,54,1,0.034146341,0,empty,CD-0722-2
"H3,G8",490113,563718,366749,196969,325552,171306,3,171485,126632,44853,2.823267117,100972,135457,17672,6942,6774,168,1154,5,0.056096841,0,hg38,CD-0722-2
"H3,G9",4024,4605,3019,1586,2771,1530,0,1532,1023,509,2.009823183,876,2345,606,286,285,1,78,1,0.084210526,0,empty,CD-0722-2
"H3,G10",5355,6086,3932,2154,3610,1974,0,1975,1251,724,1.727900552,1122,2641,567,258,251,7,85,3,0.111553785,0,empty,CD-0722-2
"H3,G11",5044,5561,3650,1911,3350,1836,0,1837,1200,637,1.883830455,1048,1551,348,139,139,0,51,0,0.230215827,0,empty,CD-0722-2
"H3,G12",4550,5169,3332,1837,3107,1763,0,1763,1141,622,1.834405145,994,8222,962,400,391,9,129,3,0.012787724,0,empty,CD-0722-2
"H3,H1",4540,5048,3344,1704,3073,1641,0,1641,1103,538,2.050185874,919,1385,206,64,64,0,37,0,0.078125,0,empty,CD-0722-2
"H3,H2",6883,7821,4951,2870,4638,2617,0,2617,1796,821,2.187576127,1481,2102,525,195,190,5,75,2,0.010526316,0,empty,CD-0722-2
"H3,H3",4256,4994,3061,1933,2947,1645,0,1645,1070,575,1.860869565,965,1703,400,143,141,2,61,1,0.021276596,0,empty,CD-0722-2
"H3,H4",6190,7133,4476,2657,4196,2251,0,2251,1422,829,1.715319662,1326,237,26,21,21,0,17,0,0.047619048,0,empty,CD-0722-2
"H3,H5",993474,1055623,758240,297383,596338,282789,4,283045,225998,57047,3.961610602,153111,216579,59081,18773,18523,250,2491,8,0.02553582,0,hg38,CD-0722-2
"H3,H6",4184,4715,3085,1630,2818,1568,0,1568,1037,531,1.952919021,849,2013,387,161,160,1,51,1,0.0125,0,empty,CD-0722-2
"H3,H7",5018,5631,3690,1941,3426,1806,2,1808,1214,594,2.043771044,1057,2091,424,215,214,1,83,1,0.144859813,0,empty,CD-0722-2
"H3,H8",5492,6418,3950,2468,3847,2162,0,2166,1408,758,1.857519789,1276,2842,614,219,218,1,68,1,0.018348624,0,empty,CD-0722-2
"H3,H9",518172,631399,364849,266550,364174,237408,0,237567,184005,53562,3.435364624,141075,14557,2044,776,757,19,233,2,0.121532365,0,hg38,CD-0722-2
"H3,H10",4456,5177,3196,1981,3120,1715,0,1717,1161,556,2.088129496,1029,1526,250,108,105,3,62,1,0.047619048,0,empty,CD-0722-2
"H3,H11",5687,6810,3811,2999,4100,2749,0,2752,1479,1273,1.161822467,1729,117,32,18,18,0,10,0,0.055555556,0,empty,CD-0722-2
"H3,H12",502417,579346,372915,206431,335448,179640,1,179803,137456,42347,3.245944223,106117,97358,12654,5033,4899,134,937,4,0.067156563,0,hg38,CD-0722-2
"H4,A1",5143,5864,3674,2190,3618,2087,0,2091,1407,684,2.057017544,1222,725,124,62,61,1,21,1,0.016393443,0,empty,CD-0722-2
"H4,A2",7779,8752,5624,3128,5166,2865,0,2869,1730,1139,1.518876207,1681,1222,274,127,124,3,39,1,0.040322581,0,empty,CD-0722-2
"H4,A3",620937,789937,437723,352214,457332,289969,3,290154,220394,69760,3.159317661,183981,7486,2563,1065,1063,2,300,1,0.039510818,0,hg38,CD-0722-2
"H4,A4",6723,7749,5018,2731,4590,2515,0,2517,1624,893,1.818589026,1379,711,193,90,89,1,27,1,0.011235955,0,empty,CD-0722-2
"H4,A5",6109,6910,4442,2468,4229,2297,0,2298,1471,827,1.778718259,1299,1215,217,94,93,1,38,1,0.043010753,0,empty,CD-0722-2
"H4,A6",15568,17280,11449,5831,10168,5412,0,5418,3778,1640,2.303658537,3100,2646,635,285,283,2,92,2,0.014134276,0,empty,CD-0722-2
"H4,A7",4795,5658,3485,2173,3431,1956,0,1957,1199,758,1.581794195,1143,855,223,80,79,1,24,1,0.101265823,0,empty,CD-0722-2
"H4,A8",3229,3766,2398,1368,2247,1257,0,1257,823,434,1.896313364,743,1568,454,181,180,1,55,1,0,0,empty,CD-0722-2
"H4,A9",6565,7248,4905,2343,4354,2265,0,2266,1550,716,2.164804469,1234,1341,562,201,201,0,46,0,0.104477612,0,empty,CD-0722-2
"H4,A10",456565,537025,342398,194627,309844,170696,1,170826,131023,39803,3.291787051,100365,23369,2241,922,892,30,234,3,0.044843049,0,hg38,CD-0722-2
"H4,A11",478745,555101,362440,192661,318868,168849,0,168994,131319,37675,3.485573988,97799,51309,6928,2803,2713,90,593,4,0.074824917,0,hg38,CD-0722-2
"H4,A12",7398,8375,5476,2899,4901,2649,0,2650,1718,932,1.843347639,1548,3038,806,342,341,1,74,1,0.108504399,0,empty,CD-0722-2
"H4,B1",5495,6425,3961,2464,3852,2192,0,2196,1411,785,1.797452229,1313,809,185,84,84,0,35,0,0.119047619,0,empty,CD-0722-2
"H4,B2",5830,6659,3931,2728,4044,2489,0,2491,1653,838,1.972553699,1495,428,158,65,64,1,22,1,0.0625,0,empty,CD-0722-2
"H4,B3",5868,6765,4332,2433,4101,2247,0,2247,1547,700,2.21,1269,1009,158,91,91,0,40,0,0.043956044,0,empty,CD-0722-2
"H4,B4",6187,7415,4363,3052,4451,2733,0,2733,1695,1038,1.632947977,1664,906,220,90,89,1,37,1,0.011235955,0,empty,CD-0722-2
"H4,B5",485060,242595,160885,81710,175364,85480,11,86309,68614,17695,3.87759254,52855,16030,2745,977,957,20,224,2,0.028213166,0,hg38,CD-0722-2
"H4,B6",6455,7797,4573,3224,4656,2794,0,2799,1687,1112,1.517086331,1725,1298,262,109,109,0,38,0,0.027522936,0,empty,CD-0722-2
"H4,B7",1341095,1601135,1017557,583578,904843,512267,2,512663,412963,99700,4.142056169,301071,101663,13456,5243,5116,127,1085,5,0.034988272,0,hg38,CD-0722-2
"H4,B8",4193,4711,3112,1599,2844,1519,0,1521,1036,485,2.136082474,837,650,144,78,78,0,29,0,0.025641026,0,empty,CD-0722-2
"H4,B9",1037292,1242796,773130,469666,702624,405078,0,405423,337160,68263,4.939132473,239687,65990,10399,4052,3994,58,864,5,0.063595393,0,hg38,CD-0722-2
"H4,B10",3703,4192,2676,1516,2611,1420,0,1422,920,502,1.832669323,849,318,60,30,29,1,18,1,0,0,empty,CD-0722-2
"H4,B11",755761,888837,557045,331792,500179,281297,0,281578,230884,50694,4.554464039,165758,18678,2821,1150,1125,25,263,5,0.087111111,0,hg38,CD-0722-2
"H4,B12",4974,5577,3634,1943,3489,1945,0,1947,1286,661,1.945537065,1112,1174,265,107,107,0,34,0,0.158878505,0,empty,CD-0722-2
"H4,C1",8792,9872,6486,3386,5840,3189,0,3198,2029,1169,1.735671514,1808,797,249,105,105,0,32,0,0.076190476,0,empty,CD-0722-2
"H4,C2",7582,8604,5431,3173,5081,2940,0,2944,1886,1058,1.782608696,1725,1142,303,145,144,1,53,1,0.034722222,0,empty,CD-0722-2
"H4,C3",7810,8928,5651,3277,5266,2872,0,2878,1906,972,1.96090535,1636,710,145,60,59,1,18,1,0.203389831,0,empty,CD-0722-2
"H4,C4",5135,5591,3843,1748,3476,1781,0,1782,1199,583,2.056603774,970,1130,292,106,105,1,37,1,0.133333333,0,empty,CD-0722-2
"H4,C5",7774,8983,5707,3276,5328,2962,0,2969,2023,946,2.138477801,1718,1534,361,156,151,5,54,1,0.112582781,0,empty,CD-0722-2
"H4,C6",6302,7230,4512,2718,4365,2421,0,2421,1528,893,1.711086226,1426,1062,231,88,88,0,35,0,0.147727273,0,empty,CD-0722-2
"H4,C7",9506,11558,6633,4925,6905,4341,0,4342,2561,1781,1.437956204,2684,337,99,34,34,0,15,0,0,0,empty,CD-0722-2
"H4,C8",9789,10991,7234,3757,6581,3669,0,3678,2325,1353,1.718403548,2133,2291,454,195,189,6,73,2,0.17989418,0,empty,CD-0722-2
"H4,C9",9428,11201,6964,4237,6660,3760,0,3764,2506,1258,1.992050874,2259,1656,232,91,89,2,28,1,0.123595506,0,empty,CD-0722-2
"H4,C10",7049,7858,5210,2648,4761,2538,0,2540,1653,887,1.863585118,1450,1205,188,98,97,1,36,1,0.164948454,0,empty,CD-0722-2
"H4,C11",5700,6481,4250,2231,4001,2191,0,2194,1446,748,1.93315508,1280,1478,278,122,119,3,38,2,0.042016807,0,empty,CD-0722-2
"H4,C12",9216,10435,6757,3678,6236,3321,0,3324,2171,1153,1.882914137,1940,1251,303,128,126,2,49,2,0.023809524,0,empty,CD-0722-2
"H4,D1",8350,10027,5831,4196,5960,3644,0,3646,2193,1453,1.509291122,2250,524,108,28,27,1,15,1,0.074074074,0,empty,CD-0722-2
"H4,D2",779438,946045,551723,394322,550456,347165,1,347422,228664,118758,1.925461864,209598,56362,12048,4613,4546,67,886,2,0.021557413,0,hg38,CD-0722-2
"H4,D3",500161,628922,336113,292809,369927,252892,1,253093,189505,63588,2.980200667,157478,40365,21907,7788,7772,16,1367,2,0.011837365,0,hg38,CD-0722-2
"H4,D4",4687,5454,3480,1974,3304,1825,0,1825,1207,618,1.953074434,1075,879,237,116,116,0,39,0,0.034482759,0,empty,CD-0722-2
"H4,D5",5257,5975,3873,2102,3589,1907,0,1907,1313,594,2.21043771,1098,1179,321,85,77,8,43,2,0.012987013,0,empty,CD-0722-2
"H4,D6",8246,9672,5783,3889,5818,3519,1,3526,2128,1398,1.522174535,2106,1673,362,148,148,0,49,0,0.081081081,0,empty,CD-0722-2
"H4,D7",4730,5289,3493,1796,3266,1724,0,1724,1199,525,2.283809524,973,1662,408,163,157,6,52,2,0.101910828,0,empty,CD-0722-2
"H4,D8",1170972,1363811,876858,486953,775094,436058,4,436412,352465,83947,4.19866106,255883,52505,8324,3367,3302,65,692,3,0.025136281,0,hg38,CD-0722-2
"H4,D9",4347,4921,3253,1668,2947,1536,0,1539,1029,510,2.017647059,869,1375,223,93,92,1,37,1,0.086956522,0,empty,CD-0722-2
"H4,D10",4889,5668,3441,2227,3449,2004,0,2005,1304,701,1.860199715,1198,724,113,46,46,0,24,0,0.130434783,0,empty,CD-0722-2
"H4,D11",5999,6780,4449,2331,4046,2138,0,2140,1394,746,1.868632708,1229,1927,451,192,188,4,64,2,0.04787234,0,empty,CD-0722-2
"H4,D12",694335,873148,489700,383448,502794,319392,1,319604,249246,70358,3.542539583,199876,22847,9643,3630,3615,15,787,3,0.063070539,0,hg38,CD-0722-2
"H4,E1",652378,733332,490369,242963,417893,221729,1,221928,177138,44790,3.954855995,125417,55640,7081,2954,2873,81,648,3,0.026453185,0,hg38,CD-0722-2
"H4,E2",6700,7597,4791,2806,4509,2557,0,2561,1593,968,1.645661157,1479,1426,228,104,99,5,40,2,0.090909091,0,empty,CD-0722-2
"H4,E3",4367,5009,3228,1781,3017,1634,0,1635,1090,545,2,951,1323,421,176,176,0,54,0,0.045454545,0,empty,CD-0722-2
"H4,E4",594548,703670,440687,262983,404612,227906,2,228089,167048,61041,2.736652414,136452,50617,10093,3876,3815,61,790,5,0.033027523,0,hg38,CD-0722-2
"H4,E5",7019,8119,5251,2868,4801,2673,0,2673,1757,916,1.918122271,1528,1239,356,156,154,2,43,1,0.012987013,0,empty,CD-0722-2
"H4,E6",10918,12506,8075,4431,7434,4130,0,4134,2609,1525,1.710819672,2397,2635,600,237,230,7,74,2,0.069565217,0,empty,CD-0722-2
"H4,E7",9743,10961,7150,3811,6493,3477,0,3481,2262,1219,1.85561936,1966,2391,678,302,295,7,83,2,0.044067797,0,empty,CD-0722-2
"H4,E8",6873,7692,5217,2475,4586,2410,0,2411,1572,839,1.873659118,1308,2133,385,176,170,6,59,2,0.041176471,0,empty,CD-0722-2
"H4,E9",5361,6144,3885,2259,3591,1985,0,1986,1344,642,2.093457944,1139,1797,428,186,186,0,65,0,0.166666667,0,empty,CD-0722-2
"H4,E10",4861,5523,3503,2020,3344,1806,0,1813,1154,659,1.751138088,1097,1044,339,113,112,1,34,1,0,0,empty,CD-0722-2
"H4,E11",6243,7072,4544,2528,4223,2272,0,2278,1440,838,1.718377088,1329,1687,407,172,171,1,48,1,0.116959064,0,empty,CD-0722-2
"H4,E12",7572,8800,5453,3347,5361,3020,0,3020,1932,1088,1.775735294,1783,1273,331,157,157,0,58,0,0.101910828,0,empty,CD-0722-2
"H4,F1",7945,8826,5848,2978,5338,2910,0,2919,1908,1011,1.887240356,1650,1607,329,109,108,1,45,1,0.046296296,0,empty,CD-0722-2
"H4,F2",6069,6731,4484,2247,4126,2218,0,2220,1406,814,1.727272727,1264,2052,489,201,194,7,51,1,0.128865979,0,empty,CD-0722-2
"H4,F3",684572,825323,496434,328889,473756,276942,6,277169,219225,57944,3.783394312,167879,99704,17356,7117,7001,116,1310,4,0.051135552,0,hg38,CD-0722-2
"H4,F4",8664,9657,6457,3200,5814,3066,0,3070,2018,1052,1.918250951,1722,666,114,52,52,0,26,0,0.057692308,0,empty,CD-0722-2
"H4,F5",13704,15180,10556,4624,8801,4232,0,4238,3010,1228,2.451140065,2386,1532,298,148,146,2,51,1,0.219178082,0,empty,CD-0722-2
"H4,F6",7842,9273,5671,3602,5369,3125,0,3127,1962,1165,1.684120172,1843,1397,339,150,149,1,47,1,0.040268456,0,empty,CD-0722-2
"H4,F7",634368,789748,438794,350954,465334,318280,1,318437,228497,89940,2.540549255,194749,839,186,53,52,1,28,1,0.038461538,0,empty,CD-0722-2
"H4,F8",6222,7289,4550,2739,4338,2373,0,2373,1568,805,1.947826087,1393,357,88,36,36,0,14,0,0,0,empty,CD-0722-2
"H4,F9",6969,7987,5160,2827,4739,2598,0,2598,1780,818,2.17603912,1487,2042,470,191,190,1,58,1,0.147368421,0,empty,CD-0722-2
"H4,F10",7296,8230,5600,2630,4944,2577,0,2577,1691,886,1.908577878,1429,1280,362,105,104,1,34,1,0.028846154,0,empty,CD-0722-2
"H4,F11",7096,7898,5365,2533,4640,2377,0,2379,1568,811,1.933415536,1323,1293,274,92,92,0,30,0,0.206521739,0,empty,CD-0722-2
"H4,F12",6994,7986,5198,2788,4742,2575,0,2579,1658,921,1.800217155,1488,148,24,14,14,0,10,0,0.071428571,0,empty,CD-0722-2
"H4,G1",6813,7719,4985,2734,4530,2406,0,2410,1581,829,1.907117008,1360,2298,458,175,170,5,54,2,0.135294118,0,empty,CD-0722-2
"H4,G2",624615,745939,438667,307272,432773,261090,0,261278,205864,55414,3.715017866,159409,26059,6416,2420,2403,17,485,2,0.021223471,0,hg38,CD-0722-2
"H4,G3",7975,8917,5779,3138,5395,3034,0,3034,1730,1304,1.326687117,1680,1607,344,140,132,8,39,2,0.143939394,0,empty,CD-0722-2
"H4,G4",15548,18186,10837,7349,10920,6663,0,6668,4211,2457,1.713878714,3999,114,16,12,12,0,9,0,0.166666667,0,empty,CD-0722-2
"H4,G5",526114,593453,405536,187917,339892,168452,1,168620,137827,30793,4.475919852,96097,21539,5459,2113,2093,20,485,2,0.01242236,0,hg38,CD-0722-2
"H4,G6",6595,7317,4983,2334,4462,2381,0,2381,1575,806,1.954094293,1288,196,56,30,30,0,11,0,0,0,empty,CD-0722-2
"H4,G7",5853,6528,4385,2143,3879,2037,0,2037,1322,715,1.848951049,1137,3403,783,294,294,0,80,0,0.085034014,0,empty,CD-0722-2
"H4,G8",4387,5004,3236,1768,3028,1663,0,1663,1072,591,1.813874788,965,1142,341,152,150,2,56,2,0.066666667,0,empty,CD-0722-2
"H4,G9",5190,5876,3869,2007,3494,1905,0,1905,1230,675,1.822222222,1066,1906,439,193,191,2,59,2,0.19895288,0,empty,CD-0722-2
"H4,G10",6704,7466,4888,2578,4553,2518,0,2519,1640,879,1.865756542,1423,1656,396,173,171,2,55,2,0.023391813,0,empty,CD-0722-2
"H4,G11",6527,7384,4919,2465,4393,2288,0,2290,1456,834,1.745803357,1294,952,221,90,89,1,34,1,0.179775281,0,empty,CD-0722-2
"H4,G12",5507,6694,4040,2654,4035,2337,0,2347,1502,845,1.777514793,1432,1904,707,263,259,4,76,1,0.05019305,0,empty,CD-0722-2
"H4,H1",6805,7815,4908,2907,4734,2590,0,2590,1777,813,2.185731857,1530,1004,202,75,73,2,34,1,0.054794521,0,empty,CD-0722-2
"H4,H2",6184,7047,4398,2649,4254,2403,0,2405,1550,855,1.812865497,1408,2032,486,194,193,1,63,1,0.21761658,0,empty,CD-0722-2
"H4,H3",5621,6440,4048,2392,3927,2214,0,2216,1459,757,1.927344782,1361,1016,178,96,95,1,48,1,0,0,empty,CD-0722-2
"H4,H4",735915,871944,546465,325479,493277,276661,2,276930,214614,62316,3.443963027,165339,2206,377,152,146,6,51,2,0.061643836,0,hg38,CD-0722-2
"H4,H5",7918,9036,5633,3403,5339,3015,0,3017,1990,1027,1.937682571,1791,1718,530,205,203,2,67,2,0.049261084,0,empty,CD-0722-2
"H4,H6",5711,6608,4138,2470,3914,2226,0,2226,1513,713,2.122019635,1304,1504,506,174,174,0,45,0,0.011494253,0,empty,CD-0722-2
"H4,H7",616015,736452,449184,287268,427151,246499,3,246717,197348,49369,3.99740728,148287,127035,21443,8821,8668,153,1504,7,0.039801569,0,hg38,CD-0722-2
"H4,H8",6930,7920,5024,2896,4680,2662,0,2663,1692,971,1.742533471,1508,1816,525,212,211,1,65,1,0.052132701,0,empty,CD-0722-2
"H4,H9",5392,6165,4032,2133,3654,1906,0,1910,1305,605,2.157024793,1098,857,165,65,63,2,24,2,0.031746032,0,empty,CD-0722-2
"H4,H10",5423,6141,3910,2231,3733,2098,0,2098,1438,660,2.178787879,1216,1347,353,129,127,2,47,2,0,0,empty,CD-0722-2
"H4,H11",7630,9192,5107,4085,5443,3642,0,3644,1924,1720,1.118604651,2254,69,6,5,5,0,4,0,0,0,empty,CD-0722-2
"H4,H12",3398433,4154142,2432304,1721838,2279952,1435126,10,1436307,1178193,258114,4.564622609,882215,415119,60051,24693,24274,419,3253,11,0.075718876,0,hg38,CD-0722-2
"H5,A1",4009,4686,2919,1767,2762,1601,1,1606,1024,582,1.759450172,939,944,309,109,108,1,25,1,0.157407407,0,empty,CD-0722-2
"H5,A2",5946,6545,4363,2182,3908,2197,0,2198,1345,853,1.576787808,1213,1941,560,214,213,1,49,1,0.070422535,0,empty,CD-0722-2
"H5,A3",3486,3910,2585,1325,2345,1237,0,1237,788,449,1.755011136,711,1409,251,131,131,0,39,0,0.061068702,0,empty,CD-0722-2
"H5,A4",6042,6904,4482,2422,4121,2247,0,2249,1402,847,1.655253837,1316,810,150,72,71,1,27,1,0.042253521,0,empty,CD-0722-2
"H5,A5",4976,5859,3627,2232,3480,1927,0,1927,1245,682,1.825513196,1135,2219,519,173,171,2,42,2,0.111111111,0,empty,CD-0722-2
"H5,A6",4576,5525,3351,2174,3226,1804,0,1808,1154,654,1.764525994,1080,2888,768,304,300,4,75,1,0.066666667,0,empty,CD-0722-2
"H5,A7",3766,4499,2676,1823,2622,1516,1,1523,969,554,1.749097473,873,1182,284,133,125,8,45,2,0.072,0,empty,CD-0722-2
"H5,A8",2434,2872,1783,1089,1642,918,0,918,596,322,1.850931677,532,1679,328,149,147,2,53,1,0,0,empty,CD-0722-2
"H5,A9",4432,5165,3289,1876,3062,1699,0,1699,1093,606,1.803630363,981,2011,516,223,223,0,55,0,0.071748879,0,empty,CD-0722-2
"H5,A10",5577,6417,4193,2224,3885,2084,0,2084,1283,801,1.601747815,1200,212,33,16,15,1,10,1,0,0,empty,CD-0722-2
"H5,A11",3432,3863,2579,1284,2293,1178,0,1182,774,408,1.897058824,652,1346,315,116,116,0,38,0,0.103448276,0,empty,CD-0722-2
"H5,A12",481424,531084,374312,156772,302726,143136,1,143267,105307,37960,2.774157007,79035,573993,50161,20057,19255,802,2660,12,0.05338873,0,hg38,CD-0722-2
"H5,B1",4559,5224,3344,1880,3124,1762,0,1762,1074,688,1.561046512,1018,1892,460,184,183,1,40,1,0,0,empty,CD-0722-2
"H5,B2",411351,467083,289424,177659,275383,152152,1,152262,117013,35249,3.319611904,92037,34882,3756,1625,1574,51,352,4,0.052096569,0,hg38,CD-0722-2
"H5,B3",3839,4444,2797,1647,2634,1518,0,1518,1003,515,1.947572816,873,2060,531,179,176,3,53,2,0.0625,0,empty,CD-0722-2
"H5,B4",4493,5312,3213,2099,3170,1896,0,1896,1096,800,1.37,1085,1304,276,128,126,2,38,1,0.087301587,0,empty,CD-0722-2
"H5,B5",4187,2575,1524,1051,1863,1088,0,1099,719,380,1.892105263,703,1297,180,95,94,1,27,1,0.053191489,0,empty,CD-0722-2
"H5,B6",5096,5941,3650,2291,3591,2149,0,2157,1315,842,1.56175772,1261,1910,550,217,212,5,56,1,0.127358491,0,empty,CD-0722-2
"H5,B7",4331,4892,3220,1672,2914,1548,0,1550,1046,504,2.075396825,859,1380,431,167,167,0,37,0,0.101796407,0,empty,CD-0722-2
"H5,B8",3102,3342,2307,1035,2073,1050,0,1050,703,347,2.025936599,562,1289,258,111,108,3,38,2,0.046296296,0,empty,CD-0722-2
"H5,B9",6489,7442,4592,2850,4507,2666,0,2666,1675,991,1.690211907,1558,965,235,73,72,1,38,1,0.041666667,0,empty,CD-0722-2
"H5,B10",2993,3336,2080,1256,2051,1146,0,1147,764,383,1.994778068,663,412,56,32,32,0,12,0,0,0,empty,CD-0722-2
"H5,B11",7343,8342,5196,3146,4991,2944,0,2946,1668,1278,1.305164319,1730,219,22,14,14,0,9,0,0,0,empty,CD-0722-2
"H5,B12",3942,4458,2839,1619,2705,1504,0,1508,968,540,1.792592593,871,1747,368,151,148,3,36,2,0.202702703,0,empty,CD-0722-2
"H5,C1",7442,8361,5583,2778,5014,2642,0,2642,1658,984,1.68495935,1482,858,172,70,68,2,25,2,0.102941176,0,empty,CD-0722-2
"H5,C2",7425,8380,5330,3050,4995,2901,0,2904,1912,992,1.927419355,1670,2049,667,264,264,0,66,0,0.053030303,0,empty,CD-0722-2
"H5,C3",6469,7089,4796,2293,4192,2253,0,2259,1392,867,1.605536332,1213,778,224,99,97,2,26,1,0,0,empty,CD-0722-2
"H5,C4",4105,4601,3054,1547,2877,1557,0,1557,994,563,1.765541741,930,1736,318,134,131,3,39,2,0.030534351,0,empty,CD-0722-2
"H5,C5",6029,6691,4508,2183,3967,2096,0,2096,1350,746,1.809651475,1183,1681,411,129,125,4,49,2,0.072,0,empty,CD-0722-2
"H5,C6",5269,5965,3820,2145,3669,2060,0,2061,1316,745,1.766442953,1172,2003,767,300,298,2,64,2,0.003355705,0,empty,CD-0722-2
"H5,C7",7383,8466,5190,3276,5141,3106,0,3113,1790,1323,1.352985639,1859,562,142,47,47,0,12,0,0.340425532,0,empty,CD-0722-2
"H5,C8",7763,8851,5720,3131,5424,3026,0,3031,1950,1081,1.803885291,1722,2876,625,283,279,4,100,2,0.168458781,0,empty,CD-0722-2
"H5,C9",5354,6270,3980,2290,3678,2032,0,2034,1312,722,1.817174515,1186,1710,288,112,111,1,31,1,0.18018018,0,empty,CD-0722-2
"H5,C10",5831,6516,4338,2178,3854,2063,0,2068,1291,777,1.661518662,1148,2028,439,159,158,1,58,1,0.196202532,0,empty,CD-0722-2
"H5,C11",4754,5472,3471,2001,3345,1868,0,1870,1215,655,1.854961832,1071,1945,373,170,168,2,60,2,0.053571429,0,empty,CD-0722-2
"H5,C12",7307,8160,5440,2720,4835,2576,0,2577,1704,873,1.951890034,1415,2141,532,219,212,7,47,2,0.04245283,0,empty,CD-0722-2
"H5,D1",7407,8259,5196,3063,4868,2845,0,2845,1660,1185,1.400843882,1631,744,218,91,91,0,30,0,0,0,empty,CD-0722-2
"H5,D2",5171,5987,3887,2100,3574,1909,0,1912,1234,678,1.820058997,1102,3387,1077,355,350,5,95,1,0.122857143,0,empty,CD-0722-2
"H5,D3",4808,5339,3498,1841,3198,1727,0,1727,1113,614,1.812703583,972,1388,123,73,72,1,43,1,0.069444444,0,empty,CD-0722-2
"H5,D4",3752,4441,2776,1665,2609,1442,0,1442,960,482,1.991701245,838,1801,379,140,136,4,48,1,0.051470588,0,empty,CD-0722-2
"H5,D5",3900,4673,2834,1839,2750,1520,0,1520,960,560,1.714285714,898,1646,370,152,151,1,49,1,0.006622517,0,empty,CD-0722-2
"H5,D6",6556,7524,4609,2915,4511,2709,0,2713,1609,1104,1.457427536,1575,1759,369,128,123,5,46,2,0.040650407,0,empty,CD-0722-2
"H5,D7",3589,4076,2648,1428,2513,1342,0,1344,852,492,1.731707317,762,2408,643,232,230,2,62,1,0.113043478,0,empty,CD-0722-2
"H5,D8",4426,5051,3197,1854,2935,1579,0,1579,1055,524,2.013358779,893,1799,630,197,197,0,59,0,0.07106599,0,empty,CD-0722-2
"H5,D9",2291,2735,1721,1014,1588,852,0,853,539,314,1.71656051,510,1940,345,132,132,0,40,0,0.007575758,0,empty,CD-0722-2
"H5,D10",4759,5584,3403,2181,3305,1886,0,1886,1237,649,1.906009245,1127,1084,238,100,99,1,24,1,0.101010101,0,empty,CD-0722-2
"H5,D11",4880,5540,3583,1957,3358,1834,0,1834,1201,633,1.897314376,1084,3103,730,310,308,2,93,1,0.074675325,0,empty,CD-0722-2
"H5,D12",824807,997021,597084,399937,576213,368535,1,368733,279888,88845,3.150295458,216690,23462,1702,609,578,31,214,3,0.034602076,0,hg38,CD-0722-2
"H5,E1",7967,8851,5735,3116,5235,2900,0,2902,1806,1096,1.647810219,1668,3057,746,303,297,6,62,2,0.04040404,0,empty,CD-0722-2
"H5,E2",5386,6308,3902,2406,3649,2054,0,2056,1296,760,1.705263158,1215,1855,394,155,152,3,44,2,0.177631579,0,empty,CD-0722-2
"H5,E3",3677,4256,2694,1562,2547,1405,0,1405,910,495,1.838383838,798,2297,679,263,263,0,66,0,0.034220532,0,empty,CD-0722-2
"H5,E4",5108,5817,3748,2069,3515,1928,0,1932,1223,709,1.724964739,1082,2554,560,235,232,3,81,2,0.090517241,0,empty,CD-0722-2
"H5,E5",4259,4854,3167,1687,2933,1551,0,1556,1008,548,1.839416058,896,1518,309,117,117,0,42,0,0.051282051,0,empty,CD-0722-2
"H5,E6",7846,9150,5718,3432,5455,3110,0,3116,2065,1051,1.964795433,1888,3909,825,343,336,7,97,2,0.0625,0,empty,CD-0722-2
"H5,E7",7091,8130,5271,2859,4816,2624,0,2630,1755,875,2.005714286,1525,2725,593,225,218,7,70,3,0.128440367,0,empty,CD-0722-2
"H5,E8",5742,6491,4306,2185,3915,2064,0,2068,1402,666,2.105105105,1206,3014,625,238,238,0,64,0,0.088235294,0,empty,CD-0722-2
"H5,E9",3733,4193,2645,1548,2512,1351,0,1351,922,429,2.149184149,800,2219,497,204,202,2,59,1,0.158415842,0,empty,CD-0722-2
"H5,E10",467365,516798,359388,157410,300095,147785,3,147952,116948,31004,3.772029416,82223,45044,10496,4020,3957,63,716,4,0.018448319,0,hg38,CD-0722-2
"H5,E11",702815,840250,515923,324327,486784,282807,0,283060,221964,61096,3.633036533,167625,111438,23018,8601,8501,100,1479,7,0.063992471,0,hg38,CD-0722-2
"H5,E12",5567,6538,4048,2490,3842,2146,0,2146,1411,735,1.919727891,1240,2189,547,205,204,1,47,1,0.166666667,0,empty,CD-0722-2
"H5,F1",6792,7405,4828,2577,4444,2427,0,2430,1533,897,1.7090301,1388,2094,539,230,226,4,63,2,0.044247788,0,empty,CD-0722-2
"H5,F2",4990,5630,3645,1985,3312,1784,0,1785,1138,647,1.758887172,1011,2624,687,272,270,2,90,2,0.044444444,0,empty,CD-0722-2
"H5,F3",4548,5312,3283,2029,3214,1799,0,1801,1151,650,1.770769231,1080,3368,875,333,330,3,97,1,0.106060606,0,empty,CD-0722-2
"H5,F4",707043,829105,518172,310933,482725,274769,8,274999,214898,60101,3.575614382,162297,33187,5983,2166,2123,43,472,5,0.049929345,0,hg38,CD-0722-2
"H5,F5",5552,6090,4044,2046,3594,1819,0,1819,1182,637,1.855572998,1029,2505,404,167,161,6,63,2,0.068322981,0,empty,CD-0722-2
"H5,F6",5843,6798,4189,2609,4015,2320,0,2323,1463,860,1.701162791,1377,2914,651,258,252,6,64,3,0.067460317,0,empty,CD-0722-2
"H5,F7",6259,7068,4588,2480,4227,2284,0,2286,1503,783,1.91954023,1283,1281,266,122,119,3,31,3,0.117647059,0,empty,CD-0722-2
"H5,F8",750797,909912,547188,362724,523449,308065,0,308341,246160,62181,3.958765539,185239,32580,5376,2120,2076,44,432,2,0.104046243,0,hg38,CD-0722-2
"H5,F9",351540,431748,240984,190764,255819,166392,0,166501,137052,29449,4.653876193,103373,12482,4741,1640,1620,20,417,2,0.035185185,0,hg38,CD-0722-2
"H5,F10",6307,6904,4717,2187,4216,2192,0,2194,1442,752,1.917553191,1222,1990,519,171,171,0,56,0,0.087719298,0,empty,CD-0722-2
"H5,F11",5475,6166,4058,2108,3585,1885,0,1888,1221,667,1.830584708,1082,2032,527,176,175,1,45,1,0.16,0,empty,CD-0722-2
"H5,F12",5745,6772,4187,2585,3924,2190,0,2191,1454,737,1.972862958,1294,145,25,14,14,0,8,0,0.142857143,0,empty,CD-0722-2
"H5,G1",5868,6676,4330,2346,4005,2117,0,2117,1417,700,2.024285714,1215,3370,695,256,250,6,83,3,0.084,0,empty,CD-0722-2
"H5,G2",3756,4287,2630,1657,2517,1420,0,1423,911,512,1.779296875,821,541,130,53,53,0,24,0,0.037735849,0,empty,CD-0722-2
"H5,G3",7206,8131,5287,2844,4826,2744,0,2747,1621,1126,1.439609236,1507,2400,559,209,207,2,68,1,0.198067633,0,empty,CD-0722-2
"H5,G4",12211,14358,8636,5722,8618,5343,1,5344,3220,2124,1.516007533,3143,107,14,11,11,0,10,0,0.090909091,0,empty,CD-0722-2
"H5,G5",4092,4706,2950,1756,2835,1574,0,1578,982,596,1.647651007,945,1700,309,138,135,3,59,2,0.066666667,0,empty,CD-0722-2
"H5,G6",5733,6515,4331,2184,3854,2062,0,2062,1319,743,1.775235532,1152,206,39,20,20,0,11,0,0,0,empty,CD-0722-2
"H5,G7",7352,7914,5412,2502,4630,2366,0,2366,1702,664,2.563253012,1244,2835,841,319,319,0,78,0,0.068965517,0,empty,CD-0722-2
"H5,G8",3753,4257,2795,1462,2604,1395,0,1395,851,544,1.564338235,795,2213,603,248,248,0,74,0,0.016129032,0,empty,CD-0722-2
"H5,G9",4286,4817,3134,1683,2852,1573,0,1573,1021,552,1.849637681,925,2898,530,238,237,1,82,1,0.021097046,0,empty,CD-0722-2
"H5,G10",5202,5903,3779,2124,3603,2034,0,2034,1352,682,1.982404692,1180,3209,843,327,327,0,84,0,0.036697248,0,empty,CD-0722-2
"H5,G11",5043,5661,3821,1840,3338,1728,0,1729,1151,578,1.991349481,950,1400,316,121,120,1,34,1,0.208333333,0,empty,CD-0722-2
"H5,G12",4188,4680,3080,1600,2956,1642,0,1642,1032,610,1.691803279,967,2678,737,272,266,6,67,2,0.063909774,0,empty,CD-0722-2
"H5,H1",510164,603451,367637,235814,350601,201601,5,201750,178615,23135,7.720553274,121861,68924,11128,4025,3959,66,905,4,0.021722657,0,hg38,CD-0722-2
"H5,H2",4986,5966,3640,2326,3541,1971,0,1971,1259,712,1.768258427,1200,2459,508,207,206,1,65,1,0.072815534,0,empty,CD-0722-2
"H5,H3",4314,4916,3146,1770,2963,1652,0,1652,1088,564,1.929078014,963,1542,332,152,152,0,54,0,0.052631579,0,empty,CD-0722-2
"H5,H4",6032,6853,4374,2479,3978,2101,0,2104,1363,741,1.839406208,1214,300,84,39,39,0,13,0,0.205128205,0,empty,CD-0722-2
"H5,H5",716056,848020,528902,319118,484383,275511,1,275717,202778,72939,2.780103922,164599,95093,14944,5568,5459,109,1061,5,0.034988093,0,hg38,CD-0722-2
"H5,H6",4414,5044,3211,1833,2994,1704,0,1704,1154,550,2.098181818,984,2191,449,192,187,5,49,2,0.048128342,0,empty,CD-0722-2
"H5,H7",4969,5603,3696,1907,3380,1813,0,1817,1184,633,1.870458136,1029,2569,534,194,194,0,69,0,0.046391753,0,empty,CD-0722-2
"H5,H8",5290,6011,3879,2132,3581,1957,0,1960,1231,729,1.68861454,1125,1997,392,191,190,1,63,1,0.084210526,0,empty,CD-0722-2
"H5,H9",3937,4367,2966,1401,2565,1289,0,1292,849,443,1.916478555,706,1192,285,135,129,6,41,1,0.15503876,0,empty,CD-0722-2
"H5,H10",3856,4590,2735,1855,2704,1483,0,1483,1008,475,2.122105263,927,1254,240,101,99,2,35,1,0.04040404,0,empty,CD-0722-2
"H5,H11",5561,6776,3733,3043,4106,2762,0,2762,1486,1276,1.164576803,1768,17,1,1,1,0,1,0,0,0,empty,CD-0722-2
"H5,H12",4171,4758,3017,1741,2841,1635,0,1635,1059,576,1.838541667,931,1264,364,115,113,2,38,2,0.026548673,0,empty,CD-0722-2
"H6,A1",4792,5324,3354,1970,3235,1851,0,1853,1209,644,1.877329193,1075,1904,404,186,179,7,60,2,0.156424581,0,empty,CD-0722-2
"H6,A2",6853,7687,4918,2769,4590,2618,0,2619,1631,988,1.650809717,1475,2014,406,166,165,1,60,1,0.139393939,0,empty,CD-0722-2
"H6,A3",4261,4882,3072,1810,2943,1605,0,1605,1038,567,1.830687831,922,2116,471,202,202,0,58,0,0.01980198,0,empty,CD-0722-2
"H6,A4",6721,7594,4892,2702,4624,2524,0,2525,1610,915,1.759562842,1473,1016,198,77,77,0,27,0,0.038961039,0,empty,CD-0722-2
"H6,A5",487431,558966,365659,193307,322942,172687,2,172821,134051,38770,3.457596079,100596,172321,18727,7298,7112,186,1295,9,0.068053993,0,hg38,CD-0722-2
"H6,A6",5452,6562,3900,2662,3942,2314,0,2316,1503,813,1.848708487,1431,3133,772,306,302,4,98,2,0.056291391,0,empty,CD-0722-2
"H6,A7",4666,5471,3309,2162,3228,1860,0,1860,1189,671,1.771982116,1118,1074,215,110,110,0,43,0,0.236363636,0,empty,CD-0722-2
"H6,A8",2650,3189,1936,1253,1880,1029,0,1031,682,349,1.954154728,635,2149,400,185,181,4,69,1,0.005524862,0,empty,CD-0722-2
"H6,A9",1487476,1764825,1108509,656316,989521,565608,2,566036,458286,107750,4.253234339,333087,251072,37341,14364,14053,311,2266,10,0.051946204,0,hg38,CD-0722-2
"H6,A10",5889,6431,4380,2051,3934,2101,0,2102,1277,825,1.547878788,1167,312,37,25,24,1,14,1,0,0,empty,CD-0722-2
"H6,A11",4317,4728,3269,1459,2786,1373,0,1373,914,459,1.991285403,716,1811,454,176,176,0,55,0,0.193181818,0,empty,CD-0722-2
"H6,A12",6112,6858,4610,2248,4061,2134,0,2135,1409,726,1.94077135,1174,4094,1019,374,368,6,104,2,0.122282609,0,empty,CD-0722-2
"H6,B1",5149,5836,3723,2113,3424,1880,0,1880,1172,708,1.655367232,1048,1241,302,106,105,1,43,1,0.00952381,0,empty,CD-0722-2
"H6,B2",5143,6050,3491,2559,3649,2221,0,2221,1385,836,1.656698565,1358,514,79,34,34,0,19,0,0.176470588,0,empty,CD-0722-2
"H6,B3",4518,5166,3273,1893,3091,1718,0,1718,1168,550,2.123636364,989,1510,365,167,166,1,69,1,0.084337349,0,empty,CD-0722-2
"H6,B4",5269,6285,3722,2563,3799,2255,0,2257,1416,841,1.683709869,1343,1557,397,134,133,1,46,1,0.067669173,0,empty,CD-0722-2
"H6,B5",638276,368748,223068,145680,262531,148406,10,149241,117683,31558,3.729101971,93422,44696,7649,2774,2730,44,562,4,0.031868132,0,hg38,CD-0722-2
"H6,B6",483224,597337,342800,254537,344089,212846,0,213022,164174,48848,3.360915493,131001,38169,12646,4796,4774,22,959,2,0.050691244,0,hg38,CD-0722-2
"H6,B7",5213,5792,3906,1886,3417,1859,1,1860,1184,676,1.75147929,981,1429,271,99,98,1,37,1,0.030612245,0,empty,CD-0722-2
"H6,B8",3627,4206,2714,1492,2495,1334,0,1334,896,438,2.0456621,741,1509,267,127,126,1,36,1,0.119047619,0,empty,CD-0722-2
"H6,B9",7737,8918,5436,3482,5388,3117,1,3122,2050,1072,1.912313433,1873,1359,324,140,138,2,54,2,0.217391304,0,empty,CD-0722-2
"H6,B10",3575,3707,2376,1331,2287,1252,0,1256,804,452,1.778761062,732,504,64,31,31,0,13,0,0,0,empty,CD-0722-2
"H6,B11",8810,10045,6227,3818,5966,3688,1,3696,2027,1669,1.2144997,2116,271,47,20,19,1,16,1,0,0,empty,CD-0722-2
"H6,B12",4679,5284,3407,1877,3313,1847,0,1847,1195,652,1.832822086,1096,1695,401,176,170,6,57,2,0.076470588,0,empty,CD-0722-2
"H6,C1",8586,9334,6371,2963,5529,2910,0,2913,1755,1158,1.515544041,1644,1246,273,127,127,0,38,0,0.062992126,0,empty,CD-0722-2
"H6,C2",6970,7803,4990,2813,4697,2653,0,2654,1704,950,1.793684211,1542,2260,472,191,190,1,72,1,0.021052632,0,empty,CD-0722-2
"H6,C3",7466,8248,5514,2734,5104,2763,0,2766,1781,985,1.808121827,1517,1087,311,113,112,1,30,1,0.214285714,0,empty,CD-0722-2
"H6,C4",4888,5362,3696,1666,3310,1714,0,1718,1127,591,1.906937394,970,2212,541,212,208,4,54,2,0.125,0,empty,CD-0722-2
"H6,C5",6715,7410,4883,2527,4443,2345,0,2350,1529,821,1.862362972,1311,2063,387,184,183,1,59,1,0.098360656,0,empty,CD-0722-2
"H6,C6",5656,6392,4182,2210,3955,2161,0,2166,1441,725,1.987586207,1230,1744,504,207,204,3,56,1,0.068627451,0,empty,CD-0722-2
"H6,C7",8200,9959,5646,4313,5970,3707,0,3711,2165,1546,1.400388098,2356,485,58,23,23,0,12,0,0.347826087,0,empty,CD-0722-2
"H6,C8",8911,10359,6565,3794,6218,3474,0,3487,2268,1219,1.860541427,2047,3195,805,344,340,4,96,2,0.044117647,0,empty,CD-0722-2
"H6,C9",615199,748685,445699,302986,430222,255593,0,255794,203647,52147,3.905248624,155964,103641,19724,7502,7375,127,1228,5,0.096271186,0,hg38,CD-0722-2
"H6,C10",6465,7685,4600,3085,4525,2539,0,2542,1599,943,1.695652174,1573,2096,477,214,210,4,62,2,0.066666667,0,empty,CD-0722-2
"H6,C11",5533,6288,4037,2251,3753,2057,0,2057,1357,700,1.938571429,1192,2014,462,207,207,0,56,0,0.072463768,0,empty,CD-0722-2
"H6,C12",8038,9056,5814,3242,5430,2907,1,2913,1924,989,1.945399393,1695,2398,647,260,260,0,74,0,0.011538462,0,empty,CD-0722-2
"H6,D1",1210849,1401056,905698,495358,793402,435623,2,435936,352930,83006,4.251861311,255200,69334,9321,3653,3525,128,729,6,0.043404255,0,hg38,CD-0722-2
"H6,D2",408076,510389,282215,228174,304290,206964,3,207102,125536,81566,1.539072653,127818,4081,1259,450,446,4,128,2,0.183856502,0,hg38,CD-0722-2
"H6,D3",5840,6659,4291,2368,4007,2252,0,2252,1521,731,2.080711354,1317,1472,315,141,141,0,54,0,0.04964539,0,empty,CD-0722-2
"H6,D4",4235,4813,3123,1690,2880,1527,0,1530,983,547,1.797074954,857,1644,447,170,170,0,45,0,0.029411765,0,empty,CD-0722-2
"H6,D5",4712,5343,3537,1806,3187,1717,0,1720,1061,659,1.610015175,967,2369,563,231,230,1,65,1,0.108695652,0,empty,CD-0722-2
"H6,D6",7753,9038,5430,3608,5346,3229,0,3229,1976,1253,1.577015164,1940,2591,576,234,233,1,69,1,0.107296137,0,empty,CD-0722-2
"H6,D7",4191,4651,3145,1506,2827,1468,0,1468,1017,451,2.254988914,826,1927,494,227,225,2,70,2,0.111111111,0,empty,CD-0722-2
"H6,D8",5188,6010,3743,2267,3651,2030,0,2031,1319,712,1.85252809,1191,2039,361,114,109,5,52,1,0.018348624,0,empty,CD-0722-2
"H6,D9",2906,3052,2127,925,1859,971,0,971,618,353,1.750708215,516,1891,381,129,128,1,44,1,0.03125,0,empty,CD-0722-2
"H6,D10",4869,5643,3455,2188,3414,1943,0,1945,1260,685,1.839416058,1212,1040,245,81,81,0,34,0,0.074074074,0,empty,CD-0722-2
"H6,D11",5506,5954,4023,1931,3645,1993,0,1993,1318,675,1.952592593,1090,2815,558,244,242,2,79,1,0.136363636,0,empty,CD-0722-2
"H6,D12",6978,7877,5130,2747,4687,2574,1,2580,1707,873,1.95532646,1402,3332,882,342,339,3,115,1,0.005899705,0,empty,CD-0722-2
"H6,E1",411486,515180,276810,238370,301082,202399,0,202532,155068,47464,3.267065565,128251,8062,2276,834,823,11,272,2,0.014580802,0,hg38,CD-0722-2
"H6,E2",6235,7002,4530,2472,4243,2300,0,2306,1474,832,1.771634615,1323,1872,387,172,172,0,58,0,0.197674419,0,empty,CD-0722-2
"H6,E3",4332,4888,3118,1770,2964,1611,0,1614,1024,590,1.73559322,954,2947,849,339,336,3,94,2,0.023809524,0,empty,CD-0722-2
"H6,E4",5657,6729,4048,2681,3924,2192,0,2192,1448,744,1.946236559,1301,2384,387,196,195,1,81,1,0.035897436,0,empty,CD-0722-2
"H6,E5",4935,5357,3705,1652,3242,1629,0,1629,1046,583,1.794168096,883,1502,415,160,159,1,51,1,0.012578616,0,empty,CD-0722-2
"H6,E6",9590,11056,6930,4126,6501,3655,0,3655,2263,1392,1.625718391,2167,3833,959,361,360,1,105,1,0.1,0,empty,CD-0722-2
"H6,E7",8466,9292,6170,3122,5649,2983,0,2992,1999,993,2.013091641,1739,3080,805,330,328,2,103,1,0.088414634,0,empty,CD-0722-2
"H6,E8",6581,7496,4868,2628,4421,2308,0,2309,1542,767,2.010430248,1322,3067,541,215,209,6,81,3,0.014354067,0,empty,CD-0722-2
"H6,E9",4812,5433,3542,1891,3293,1752,0,1757,1165,592,1.967905405,1032,2783,616,232,228,4,80,2,0.061403509,0,empty,CD-0722-2
"H6,E10",4667,5366,3454,1912,3151,1679,0,1683,1061,622,1.705787781,964,1561,348,153,152,1,56,1,0.026315789,0,empty,CD-0722-2
"H6,E11",5661,6278,4082,2196,3744,2047,0,2048,1293,755,1.712582781,1105,2269,478,210,205,5,58,2,0.097560976,0,empty,CD-0722-2
"H6,E12",6781,7757,4872,2885,4767,2735,0,2736,1783,953,1.870933893,1624,1928,566,197,193,4,58,2,0.062176166,0,empty,CD-0722-2
"H6,F1",570630,657553,420058,237495,377235,208653,0,208818,162909,45909,3.548519898,122329,127711,18995,7041,6883,158,1238,6,0.041261078,0,hg38,CD-0722-2
"H6,F2",5731,6424,4099,2325,3898,2108,0,2109,1391,718,1.937325905,1240,3200,609,274,270,4,100,2,0.040740741,0,empty,CD-0722-2
"H6,F3",5356,5874,3920,1954,3542,1858,1,1864,1205,659,1.828528073,1039,3120,780,327,323,4,94,1,0.086687307,0,empty,CD-0722-2
"H6,F4",8134,9126,5876,3250,5539,2972,0,2974,1893,1081,1.751156337,1740,785,121,59,58,1,35,1,0.017241379,0,empty,CD-0722-2
"H6,F5",1062601,1166354,815991,350363,657155,325489,0,325823,250740,75083,3.339504282,180810,94726,19628,6940,6842,98,1201,5,0.0239696,0,hg38,CD-0722-2
"H6,F6",663745,812807,477115,335692,464239,276913,3,277125,223515,53610,4.16927812,170415,152494,29690,11263,11079,184,1778,5,0.045581731,0,hg38,CD-0722-2
"H6,F7",7318,8368,5252,3116,5007,2837,0,2840,1837,1003,1.831505484,1673,1087,277,90,90,0,33,0,0.011111111,0,empty,CD-0722-2
"H6,F8",6035,6869,4414,2455,4080,2251,0,2257,1491,766,1.946475196,1270,371,96,58,58,0,26,0,0,0,empty,CD-0722-2
"H6,F9",6268,6931,4706,2225,4161,2210,0,2210,1488,722,2.060941828,1220,3629,865,348,347,1,92,1,0.080691643,0,empty,CD-0722-2
"H6,F10",643521,745241,474466,270775,427354,239696,1,239882,192811,47071,4.096173865,139681,135546,25751,9440,9284,156,1438,6,0.03339078,0,hg38,CD-0722-2
"H6,F11",6093,6785,4540,2245,4104,2131,1,2137,1393,744,1.872311828,1201,1711,337,134,133,1,54,1,0.112781955,0,empty,CD-0722-2
"H6,F12",6725,7578,4862,2716,4388,2334,0,2336,1525,811,1.880394575,1334,335,64,31,31,0,18,0,0,0,empty,CD-0722-2
"H6,G1",6473,7174,4792,2382,4312,2208,0,2212,1476,736,2.005434783,1210,3166,814,336,335,1,84,1,0.104477612,0,empty,CD-0722-2
"H6,G2",440987,593199,278449,314750,353084,267938,2,268077,210256,57821,3.636325902,174195,3425,332,134,128,6,67,2,0.0546875,0,hg38,CD-0722-2
"H6,G3",9571,10667,7113,3554,6344,3396,0,3401,2079,1322,1.572617247,1849,2461,703,287,287,0,66,0,0.010452962,0,empty,CD-0722-2
"H6,G4",14137,16364,9915,6449,9718,5910,0,5917,3531,2386,1.479882649,3492,193,13,10,10,0,7,0,0,0,empty,CD-0722-2
"H6,G5",4879,5306,3506,1800,3203,1760,0,1764,1236,528,2.340909091,983,2038,468,211,203,8,64,2,0.083743842,0,empty,CD-0722-2
"H6,G6",6742,7529,5037,2492,4447,2360,0,2363,1584,779,2.033376123,1275,248,23,16,16,0,7,0,0,0,empty,CD-0722-2
"H6,G7",5310,5843,3969,1874,3616,1815,0,1820,1147,673,1.704309064,1003,2888,678,262,259,3,71,2,0.092664093,0,empty,CD-0722-2
"H6,G8",3902,4427,2877,1550,2680,1469,0,1472,992,480,2.066666667,849,2197,527,230,225,5,67,2,0.124444444,0,empty,CD-0722-2
"H6,G9",4666,5426,3416,2010,3229,1767,0,1769,1121,648,1.729938272,1032,3166,860,275,273,2,83,2,0.058608059,0,empty,CD-0722-2
"H6,G10",5933,6845,4338,2507,4084,2267,0,2271,1451,820,1.769512195,1329,2681,699,268,259,9,80,2,0.127413127,0,empty,CD-0722-2
"H6,G11",5755,6496,4270,2226,3896,2111,0,2116,1375,741,1.85560054,1190,1565,379,150,148,2,54,1,0,0,empty,CD-0722-2
"H6,G12",5206,6004,3743,2261,3579,1978,0,1980,1323,657,2.01369863,1190,2535,775,287,285,2,96,1,0.052631579,0,empty,CD-0722-2
"H6,H1",5646,6293,4116,2177,3830,2064,0,2068,1379,689,2.001451379,1215,1373,428,193,190,3,57,2,0.105263158,0,empty,CD-0722-2
"H6,H2",761475,939063,544641,394422,538552,326030,2,326289,267615,58674,4.561049187,201659,169377,31998,11928,11742,186,1902,9,0.048203032,0,hg38,CD-0722-2
"H6,H3",5505,6446,3965,2481,3774,2138,0,2141,1447,694,2.085014409,1283,1948,441,173,171,2,58,2,0.070175439,0,empty,CD-0722-2
"H6,H4",7166,7797,5091,2706,4728,2519,0,2519,1666,853,1.953106682,1432,229,65,39,39,0,25,0,0,0,empty,CD-0722-2
"H6,H5",7641,8534,5502,3032,5062,2860,0,2862,1826,1036,1.762548263,1605,1918,354,168,167,1,66,1,0.035928144,0,empty,CD-0722-2
"H6,H6",4966,5800,3482,2318,3460,2003,0,2005,1330,675,1.97037037,1185,2478,616,241,241,0,81,0,0.070539419,0,empty,CD-0722-2
"H6,H7",5535,6259,4052,2207,3775,2012,0,2014,1326,688,1.927325581,1156,2328,544,213,205,8,77,2,0.068292683,0,empty,CD-0722-2
"H6,H8",572000,692637,415851,276786,395637,231484,0,231689,185323,46366,3.996958979,140967,152622,21475,8607,8415,192,1524,7,0.066428996,0,hg38,CD-0722-2
"H6,H9",829867,979065,615106,363959,553733,311176,2,311427,256621,54806,4.682352297,183253,160264,23444,9130,8935,195,1528,7,0.057526581,0,hg38,CD-0722-2
"H6,H10",4919,5605,3558,2047,3353,1875,1,1876,1262,614,2.055374593,1111,1597,183,104,102,2,50,2,0.156862745,0,empty,CD-0722-2
"H6,H11",674002,793617,495141,298476,453893,257055,10,257254,200787,56467,3.555829068,152966,5756,1006,372,358,14,86,3,0.067039106,0,hg38,CD-0722-2
"H6,H12",4850,5726,3378,2348,3401,2002,0,2003,1311,692,1.894508671,1213,1218,310,123,122,1,53,1,0.008196721,0,empty,CD-0722-2
"H7,A1",502491,584782,375742,209040,338345,185262,5,185403,144656,40747,3.550101848,108521,39636,6748,2509,2457,52,500,3,0.024013024,0,hg38,CD-0722-2
"H7,A2",6487,7301,4703,2598,4318,2480,1,2487,1534,953,1.609653725,1423,1387,285,125,123,2,45,2,0.089430894,0,empty,CD-0722-2
"H7,A3",3701,4068,2745,1323,2445,1282,0,1284,834,450,1.853333333,699,1437,258,91,90,1,33,1,0.022222222,0,empty,CD-0722-2
"H7,A4",835275,1004010,613082,390928,568283,332964,2,333273,265295,67978,3.902659684,198382,49050,9100,3586,3545,41,685,3,0.060648801,0,hg38,CD-0722-2
"H7,A5",5408,6101,3935,2166,3558,1858,0,1863,1218,645,1.888372093,1034,2145,487,189,188,1,58,1,0.143617021,0,empty,CD-0722-2
"H7,A6",432650,546935,311751,235184,315753,195199,1,195354,151465,43889,3.451092529,120573,115377,22088,8481,8347,134,1369,7,0.064334491,0,hg38,CD-0722-2
"H7,A7",539273,671548,372447,299101,391367,263410,1,263576,166932,96644,1.727287778,161186,3297,674,221,214,7,72,2,0.121495327,0,hg38,CD-0722-2
"H7,A8",2494,2837,1827,1010,1708,957,0,957,630,327,1.926605505,558,1981,491,180,178,2,50,1,0.157303371,0,empty,CD-0722-2
"H7,A9",4751,5323,3537,1786,3134,1649,0,1649,1050,599,1.752921536,890,1710,287,118,117,1,41,1,0.051282051,0,empty,CD-0722-2
"H7,A10",5633,6253,4278,1975,3753,1968,0,1970,1194,776,1.538659794,1087,396,31,17,15,2,11,1,0.066666667,0,empty,CD-0722-2
"H7,A11",3936,4533,2928,1605,2578,1386,0,1389,892,497,1.794768612,768,1449,377,161,160,1,42,1,0.1,0,empty,CD-0722-2
"H7,A12",5607,5960,4214,1746,3480,1749,0,1756,1128,628,1.796178344,936,3345,1058,363,358,5,97,2,0.047486034,0,empty,CD-0722-2
"H7,B1",4712,5220,3457,1763,3136,1740,0,1742,1071,671,1.596125186,951,902,170,88,84,4,29,1,0.261904762,0,empty,CD-0722-2
"H7,B2",585275,692748,401129,291619,404196,244555,1,244742,191869,52873,3.628865394,151189,95433,10417,4257,4163,94,805,4,0.089118424,0,hg38,CD-0722-2
"H7,B3",3989,4657,2887,1770,2847,1621,0,1621,1009,612,1.64869281,983,1316,281,112,110,2,34,2,0.036363636,0,empty,CD-0722-2
"H7,B4",4761,5810,3323,2487,3470,2091,0,2093,1292,801,1.61298377,1302,997,153,77,76,1,33,1,0.078947368,0,empty,CD-0722-2
"H7,B5",5901,4029,2596,1433,2761,1524,0,1531,1036,495,2.092929293,950,1190,159,74,74,0,28,0,0.162162162,0,empty,CD-0722-2
"H7,B6",5135,6010,3729,2281,3609,2121,0,2121,1328,793,1.674653216,1238,1278,312,143,133,10,35,2,0.203007519,0,empty,CD-0722-2
"H7,B7",4595,5023,3456,1567,3042,1570,0,1572,1045,527,1.982922201,841,1262,313,149,148,1,44,1,0.087837838,0,empty,CD-0722-2
"H7,B8",3688,4241,2752,1489,2486,1308,0,1314,891,423,2.106382979,777,860,198,71,70,1,32,1,0.014285714,0,empty,CD-0722-2
"H7,B9",6786,7649,4821,2828,4567,2714,1,2718,1726,992,1.739919355,1583,1085,196,63,59,4,29,2,0.152542373,0,empty,CD-0722-2
"H7,B10",3081,3461,2245,1216,2156,1155,1,1158,709,449,1.579064588,673,297,26,14,14,0,5,0,0,0,empty,CD-0722-2
"H7,B11",1032254,1133021,803364,329657,632441,300952,2,301254,236676,64578,3.6649633,165622,6129,1241,433,429,4,98,4,0.004662005,0,hg38,CD-0722-2
"H7,B12",4170,4701,3027,1674,2812,1579,0,1579,1015,564,1.79964539,894,1743,378,163,160,3,52,1,0.05625,0,empty,CD-0722-2
"H7,C1",8309,9265,6198,3067,5433,2911,0,2914,1877,1037,1.81002893,1648,945,184,58,57,1,19,1,0.192982456,0,empty,CD-0722-2
"H7,C2",607168,695370,460115,235255,396819,205835,0,205999,157588,48411,3.255210593,118277,114318,16539,6175,6034,141,1156,4,0.031819688,0,hg38,CD-0722-2
"H7,C3",7245,8120,5457,2663,4815,2607,0,2613,1709,904,1.890486726,1404,893,164,57,57,0,19,0,0.105263158,0,empty,CD-0722-2
"H7,C4",4290,4910,3242,1668,2970,1569,0,1572,1019,553,1.842676311,893,1675,521,161,161,0,42,0,0.00621118,0,empty,CD-0722-2
"H7,C5",8939,10308,6518,3790,6143,3412,0,3418,2484,934,2.659528908,2027,1427,342,166,164,2,51,1,0.006097561,0,empty,CD-0722-2
"H7,C6",5266,5919,3809,2110,3566,1978,0,1980,1289,691,1.865412446,1141,1374,264,121,121,0,44,0,0.016528926,0,empty,CD-0722-2
"H7,C7",7608,9280,5437,3843,5448,3384,0,3384,1939,1445,1.341868512,2046,425,25,19,18,1,7,1,0,0,empty,CD-0722-2
"H7,C8",8322,9248,6140,3108,5499,3028,0,3028,1958,1070,1.829906542,1721,3326,792,300,298,2,106,1,0.05033557,0,empty,CD-0722-2
"H7,C9",5562,6342,4008,2334,3785,2044,0,2044,1333,711,1.874824191,1198,1519,273,105,103,2,26,1,0.116504854,0,empty,CD-0722-2
"H7,C10",6108,6957,4526,2431,4068,2176,0,2178,1378,800,1.7225,1269,1778,402,158,158,0,42,0,0.03164557,0,empty,CD-0722-2
"H7,C11",5181,6028,3717,2311,3599,2026,0,2026,1315,711,1.849507736,1196,1869,627,257,257,0,53,0,0.097276265,0,empty,CD-0722-2
"H7,C12",7826,8655,5684,2971,5205,2716,0,2719,1801,918,1.961873638,1539,1891,500,227,225,2,59,1,0.111111111,0,empty,CD-0722-2
"H7,D1",7066,8423,5038,3385,5078,3047,0,3048,1779,1269,1.401891253,1853,596,142,58,55,3,22,2,0.036363636,0,empty,CD-0722-2
"H7,D2",502365,599704,365381,234323,347188,205611,0,205748,159484,46264,3.447259208,122237,43301,15455,5569,5546,23,1123,3,0.025784349,0,hg38,CD-0722-2
"H7,D3",5155,5961,3679,2282,3526,1993,0,1994,1315,679,1.936671576,1182,1144,273,105,103,2,35,1,0.126213592,0,empty,CD-0722-2
"H7,D4",3965,4638,2906,1732,2752,1485,0,1485,981,504,1.946428571,882,1000,234,114,112,2,39,2,0.035714286,0,empty,CD-0722-2
"H7,D5",4468,5077,3242,1835,3080,1713,0,1717,1170,547,2.138939671,989,1352,273,119,118,1,38,1,0,0,empty,CD-0722-2
"H7,D6",1354652,1527508,983846,543662,867005,493792,1,494160,417254,76906,5.425506462,287411,150878,46676,17742,17596,146,2306,6,0.013639464,0,hg38,CD-0722-2
"H7,D7",3778,4219,2813,1406,2528,1341,0,1341,916,425,2.155294118,744,1885,319,137,137,0,53,0,0.160583942,0,empty,CD-0722-2
"H7,D8",4486,4938,3326,1612,2913,1539,0,1539,997,542,1.839483395,855,1010,225,121,118,3,43,2,0.144067797,0,empty,CD-0722-2
"H7,D9",2321,2691,1710,981,1633,851,0,853,575,278,2.068345324,479,1573,320,114,113,1,36,1,0.061946903,0,empty,CD-0722-2
"H7,D10",5594,6658,3973,2685,3991,2318,0,2319,1505,814,1.848894349,1457,960,193,80,80,0,31,0,0.0375,0,empty,CD-0722-2
"H7,D11",5280,6222,3878,2344,3726,2052,0,2054,1341,713,1.880785414,1204,2611,579,232,229,3,69,1,0.109170306,0,empty,CD-0722-2
"H7,D12",6623,7654,4798,2856,4410,2418,0,2419,1592,827,1.92503023,1325,3802,1072,436,430,6,106,2,0.065116279,0,empty,CD-0722-2
"H7,E1",8019,9056,5767,3289,5394,3035,0,3038,1895,1143,1.65791776,1739,2565,633,271,263,8,83,2,0.144486692,0,empty,CD-0722-2
"H7,E2",5653,6477,4179,2298,3877,2246,0,2247,1399,848,1.649764151,1274,1414,239,89,89,0,37,0,0.056179775,0,empty,CD-0722-2
"H7,E3",4362,4857,3228,1629,2850,1496,0,1497,1024,473,2.164904863,854,2046,580,223,222,1,60,1,0,0,empty,CD-0722-2
"H7,E4",5311,5899,3930,1969,3537,1902,0,1904,1226,678,1.808259587,1087,1960,402,181,179,2,67,1,0.044692737,0,empty,CD-0722-2
"H7,E5",4507,5016,3384,1632,3047,1626,0,1627,1063,564,1.884751773,894,1238,346,136,136,0,46,0,0,0,empty,CD-0722-2
"H7,E6",8454,9749,6253,3496,5784,3203,0,3208,2052,1156,1.775086505,1874,3027,636,280,278,2,107,1,0.035971223,0,empty,CD-0722-2
"H7,E7",8245,9445,6024,3421,5679,3156,0,3156,2072,1084,1.911439114,1900,2325,445,199,195,4,75,2,0.041025641,0,empty,CD-0722-2
"H7,E8",5958,6670,4463,2207,3955,2056,0,2061,1314,747,1.759036145,1152,2339,628,259,256,3,69,1,0.10546875,0,empty,CD-0722-2
"H7,E9",4019,4612,2888,1724,2696,1501,1,1504,952,552,1.724637681,878,2069,549,248,247,1,76,1,0.052631579,0,empty,CD-0722-2
"H7,E10",4860,5458,3574,1884,3346,1791,0,1794,1177,617,1.907617504,1026,1844,414,147,146,1,42,1,0.109589041,0,empty,CD-0722-2
"H7,E11",5575,6219,4144,2075,3705,2024,0,2024,1269,755,1.680794702,1087,1589,412,164,163,1,47,1,0.079754601,0,empty,CD-0722-2
"H7,E12",5796,6366,4258,2108,3757,2036,0,2036,1309,727,1.800550206,1149,1766,498,178,176,2,50,2,0.102272727,0,empty,CD-0722-2
"H7,F1",6927,7777,5010,2767,4678,2588,0,2588,1659,929,1.785791173,1517,1772,401,175,174,1,59,1,0.091954023,0,empty,CD-0722-2
"H7,F2",5228,5760,3846,1914,3368,1809,0,1812,1177,635,1.853543307,989,2879,709,277,276,1,59,1,0.06884058,0,empty,CD-0722-2
"H7,F3",5101,5755,3666,2089,3479,1919,0,1921,1275,646,1.973684211,1113,2642,792,277,275,2,75,1,0.061818182,0,empty,CD-0722-2
"H7,F4",7897,8553,5900,2653,5110,2628,0,2630,1733,897,1.931995541,1405,579,128,72,72,0,27,0,0.111111111,0,empty,CD-0722-2
"H7,F5",425247,481147,321032,160115,279335,144257,0,144395,85017,59378,1.43179292,86576,81283,15448,5851,5751,100,1107,5,0.104329682,0,hg38,CD-0722-2
"H7,F6",6952,8117,5024,3093,4649,2621,1,2624,1551,1073,1.445479963,1528,2897,737,266,263,3,60,2,0.022813688,0,empty,CD-0722-2
"H7,F7",6865,7765,5028,2737,4567,2477,0,2477,1616,861,1.87688734,1395,1078,247,102,102,0,32,0,0.058823529,0,empty,CD-0722-2
"H7,F8",4774,5786,3479,2307,3436,1951,0,1952,1244,708,1.757062147,1206,282,13,11,11,0,9,0,0.181818182,0,empty,CD-0722-2
"H7,F9",5451,6240,4172,2068,3744,1987,0,1991,1333,658,2.025835866,1120,2416,592,256,248,8,71,1,0.028225806,0,empty,CD-0722-2
"H7,F10",6736,7540,5090,2450,4435,2343,0,2345,1549,796,1.945979899,1258,1450,241,116,114,2,40,2,0.035087719,0,empty,CD-0722-2
"H7,F11",5814,6508,4255,2253,3820,2028,0,2030,1330,700,1.9,1188,2224,419,174,167,7,57,2,0.053892216,0,empty,CD-0722-2
"H7,F12",6326,7179,4620,2559,4153,2259,0,2259,1480,779,1.89987163,1332,103,12,8,7,1,6,1,0.142857143,0,empty,CD-0722-2
"H7,G1",6351,7099,4653,2446,4231,2263,0,2267,1500,767,1.955671447,1262,2128,482,221,215,6,72,2,0.055813953,0,empty,CD-0722-2
"H7,G2",4099,4547,2944,1603,2649,1556,0,1556,990,566,1.749116608,879,658,55,33,33,0,23,0,0.03030303,0,empty,CD-0722-2
"H7,G3",8243,9142,5933,3209,5399,3015,0,3017,1782,1235,1.44291498,1641,2042,465,195,195,0,58,0,0.076923077,0,empty,CD-0722-2
"H7,G4",616333,678019,478928,199091,386096,183940,2,184116,143557,40559,3.539461032,101503,837,240,68,67,1,21,1,0,0,empty,CD-0722-2
"H7,G5",4312,5075,3128,1947,2946,1631,0,1631,1045,586,1.783276451,954,1902,460,243,241,2,66,2,0.12033195,0,empty,CD-0722-2
"H7,G6",6254,7061,4604,2457,4181,2249,1,2251,1459,792,1.842171717,1259,215,49,22,22,0,10,0,0,0,empty,CD-0722-2
"H7,G7",5049,5650,3786,1864,3376,1769,0,1772,1161,611,1.900163666,971,2084,494,189,188,1,50,1,0.085106383,0,empty,CD-0722-2
"H7,G8",3798,4364,2756,1608,2578,1426,0,1436,879,557,1.578096948,850,1781,442,167,164,3,41,1,0.006097561,0,empty,CD-0722-2
"H7,G9",4662,5332,3425,1907,3179,1685,2,1693,1115,578,1.929065744,957,2683,697,264,263,1,68,1,0.030418251,0,empty,CD-0722-2
"H7,G10",5698,6420,4182,2238,3771,2136,0,2136,1337,799,1.673341677,1210,1783,392,156,150,6,58,1,0.033333333,0,empty,CD-0722-2
"H7,G11",5313,6148,3922,2226,3624,1974,0,1974,1297,677,1.915805022,1120,1486,444,173,173,0,49,0,0.092485549,0,empty,CD-0722-2
"H7,G12",4609,5472,3299,2173,3311,1938,0,1938,1273,665,1.914285714,1188,2102,438,183,182,1,70,1,0.104395604,0,empty,CD-0722-2
"H7,H1",4802,5393,3461,1932,3300,1782,0,1787,1194,593,2.013490725,1052,1180,284,105,104,1,34,1,0.144230769,0,empty,CD-0722-2
"H7,H2",1112223,1192930,868119,324811,672830,310281,1,310538,238943,71595,3.337425798,166931,148787,22831,8732,8510,222,1434,4,0.033842538,0,hg38,CD-0722-2
"H7,H3",4570,5270,3346,1924,3131,1745,1,1746,1124,622,1.807073955,1041,1377,281,101,97,4,34,2,0.082474227,0,empty,CD-0722-2
"H7,H4",6633,7489,4847,2642,4355,2323,0,2324,1567,757,2.07001321,1334,184,24,16,16,0,10,0,0.375,0,empty,CD-0722-2
"H7,H5",6759,7555,4927,2628,4533,2582,0,2584,1668,916,1.820960699,1460,2171,526,227,215,12,66,2,0.134883721,0,empty,CD-0722-2
"H7,H6",4505,5096,3328,1768,3022,1693,0,1695,1156,539,2.14471243,961,1915,402,151,150,1,48,1,0.02,0,empty,CD-0722-2
"H7,H7",5245,6039,3816,2223,3573,1900,1,1905,1250,655,1.908396947,1136,1814,424,150,149,1,47,1,0.046979866,0,empty,CD-0722-2
"H7,H8",5917,6950,4264,2686,4009,2308,0,2310,1426,884,1.613122172,1359,2486,642,249,248,1,70,1,0.197580645,0,empty,CD-0722-2
"H7,H9",4935,5516,3643,1873,3389,1735,0,1741,1166,575,2.027826087,1046,1073,319,134,134,0,35,0,0.029850746,0,empty,CD-0722-2
"H7,H10",583414,703272,418309,284963,400922,239322,2,239512,194912,44600,4.370224215,145525,83352,15115,5818,5703,115,1016,4,0.042784499,0,hg38,CD-0722-2
"H7,H11",5835,7118,3899,3219,4286,2859,0,2862,1511,1351,1.118430792,1782,40,8,6,6,0,3,0,0,0,empty,CD-0722-2
"H7,H12",4587,5286,3255,2031,3126,1789,0,1793,1090,703,1.550497866,1069,1204,288,101,100,1,37,1,0.19,0,empty,CD-0722-2
"H8,A1",569539,669222,423087,246135,385357,213000,2,213176,175020,38156,4.586958801,125703,94916,11955,4719,4583,136,840,5,0.051058259,0,hg38,CD-0722-2
"H8,A2",4840,5421,3547,1874,3282,1830,0,1834,1124,710,1.583098592,1062,1353,227,95,92,3,35,1,0.130434783,0,empty,CD-0722-2
"H8,A3",3179,3463,2316,1147,2093,1117,0,1124,761,363,2.096418733,639,1053,289,117,113,4,28,1,0.194690265,0,empty,CD-0722-2
"H8,A4",5558,6001,4095,1906,3619,1938,0,1940,1242,698,1.779369628,1080,640,158,63,63,0,31,0,0.380952381,0,empty,CD-0722-2
"H8,A5",4345,4948,3141,1807,2982,1594,0,1595,1000,595,1.680672269,932,2049,522,214,211,3,51,1,0.090047393,0,empty,CD-0722-2
"H8,A6",8120,9366,5931,3435,5501,3065,0,3067,2203,864,2.549768519,1768,1907,356,145,142,3,50,1,0.070422535,0,empty,CD-0722-2
"H8,A7",3329,3976,2459,1517,2355,1340,0,1345,872,473,1.843551797,779,1021,273,123,121,2,35,2,0.008264463,0,empty,CD-0722-2
"H8,A8",1918,2233,1396,837,1328,748,0,748,478,270,1.77037037,438,1348,327,126,123,3,37,1,0.170731707,0,empty,CD-0722-2
"H8,A9",3590,4213,2678,1535,2553,1389,0,1389,931,458,2.032751092,823,1878,392,148,145,3,47,1,0.034482759,0,empty,CD-0722-2
"H8,A10",262048,300055,199625,100430,173258,88105,1,88185,67034,21151,3.169306416,50479,34815,3427,1375,1348,27,322,5,0.020029674,0,hg38,CD-0722-2
"H8,A11",3112,3439,2248,1191,2041,1113,0,1113,756,357,2.117647059,628,1052,352,149,147,2,45,1,0.12244898,0,empty,CD-0722-2
"H8,A12",4237,4812,3144,1668,2857,1527,0,1527,989,538,1.838289963,880,2085,328,159,158,1,63,1,0.132911392,0,empty,CD-0722-2
"H8,B1",3748,4139,2676,1463,2463,1392,0,1394,917,477,1.922431866,789,958,181,90,90,0,33,0,0.066666667,0,empty,CD-0722-2
"H8,B2",4166,4557,2891,1666,2750,1619,0,1622,1048,574,1.825783972,890,542,126,44,41,3,16,1,0.024390244,0,empty,CD-0722-2
"H8,B3",3092,3484,2237,1247,2088,1123,0,1123,732,391,1.872122762,635,1522,293,93,93,0,29,0,0.064516129,0,empty,CD-0722-2
"H8,B4",5065,5925,3704,2221,3485,1988,0,1990,1246,744,1.674731183,1179,1026,215,103,103,0,37,0,0.058252427,0,empty,CD-0722-2
"H8,B5",414420,237938,147348,90590,169053,90817,9,91363,69821,21542,3.24115681,57388,56464,8993,3238,3178,60,586,7,0.062932662,0,hg38,CD-0722-2
"H8,B6",403366,493755,290068,203687,284547,171096,1,171225,133063,38162,3.486793145,104315,33614,9837,3848,3824,24,768,4,0.083943515,0,hg38,CD-0722-2
"H8,B7",3820,4330,2858,1472,2611,1387,0,1387,925,462,2.002164502,764,898,223,82,82,0,28,0,0,0,empty,CD-0722-2
"H8,B8",2920,3349,2135,1214,1979,1077,0,1078,714,364,1.961538462,630,881,227,96,96,0,36,0,0.15625,0,empty,CD-0722-2
"H8,B9",5330,6295,3840,2455,3792,2166,0,2170,1311,859,1.526193248,1277,928,174,93,93,0,39,0,0.010752688,0,empty,CD-0722-2
"H8,B10",2520,2862,1766,1096,1698,953,0,955,595,360,1.652777778,577,289,21,11,10,1,5,1,0,0,empty,CD-0722-2
"H8,B11",6169,7147,4402,2745,4241,2572,0,2574,1468,1106,1.327305606,1488,187,23,17,17,0,12,0,0,0,empty,CD-0722-2
"H8,B12",3369,3812,2421,1391,2263,1241,0,1241,888,353,2.515580737,706,1071,212,99,97,2,31,2,0.082474227,0,empty,CD-0722-2
"H8,C1",487606,602803,329620,273183,349671,243385,0,243564,180799,62765,2.880570382,147629,1698,413,135,135,0,39,0,0.037037037,0,hg38,CD-0722-2
"H8,C2",5371,6127,3892,2235,3668,2081,0,2082,1368,714,1.915966387,1195,1408,358,164,156,8,52,2,0.006410256,0,empty,CD-0722-2
"H8,C3",5641,6343,4107,2236,3824,2142,0,2145,1392,753,1.848605578,1224,729,176,77,76,1,25,1,0.184210526,0,empty,CD-0722-2
"H8,C4",3386,3623,2580,1043,2178,1078,0,1078,714,364,1.961538462,566,1249,318,113,110,3,38,1,0.018181818,0,empty,CD-0722-2
"H8,C5",4893,5540,3566,1974,3278,1806,0,1806,1217,589,2.066213922,1024,1120,203,90,90,0,35,0,0.088888889,0,empty,CD-0722-2
"H8,C6",4563,5066,3329,1737,3096,1668,0,1668,1094,574,1.905923345,916,1344,286,123,121,2,44,1,0.157024793,0,empty,CD-0722-2
"H8,C7",5916,6984,4194,2790,4082,2422,0,2422,1421,1001,1.41958042,1420,513,101,43,43,0,15,0,0,0,empty,CD-0722-2
"H8,C8",6376,7099,4631,2468,4305,2375,0,2375,1463,912,1.604166667,1356,2491,662,267,265,2,76,1,0.120754717,0,empty,CD-0722-2
"H8,C9",338010,437041,227772,209269,253854,178325,0,178435,131201,47234,2.777681331,112220,1669,272,95,92,3,36,1,0.119565217,0,empty,CD-0722-2
"H8,C10",5010,5705,3620,2085,3417,1858,0,1860,1239,621,1.995169082,1062,1253,242,121,115,6,41,1,0.043478261,0,empty,CD-0722-2
"H8,C11",616489,738968,448951,290017,422334,244014,1,244208,191228,52980,3.609437524,147614,76408,12411,4625,4511,114,875,5,0.068055863,0,hg38,CD-0722-2
"H8,C12",6181,6989,4599,2390,4267,2306,0,2309,1529,780,1.96025641,1308,1419,309,105,103,2,35,1,0.009708738,0,empty,CD-0722-2
"H8,D1",5683,6605,4120,2485,3924,2288,0,2288,1366,922,1.481561822,1337,1115,166,59,59,0,23,0,0.016949153,0,empty,CD-0722-2
"H8,D2",4756,5404,3512,1892,3158,1639,0,1641,1045,596,1.753355705,929,1987,535,222,220,2,58,1,0.068181818,0,empty,CD-0722-2
"H8,D3",3985,4647,2851,1796,2822,1633,0,1634,1017,617,1.648298217,982,1357,423,180,175,5,47,3,0.108571429,0,empty,CD-0722-2
"H8,D4",3086,3629,2207,1422,2187,1219,0,1219,778,441,1.764172336,747,1202,304,122,121,1,30,1,0.016528926,0,empty,CD-0722-2
"H8,D5",3533,4017,2577,1440,2434,1328,0,1330,884,446,1.98206278,757,1088,345,119,118,1,48,1,0.016949153,0,empty,CD-0722-2
"H8,D6",5884,6790,4075,2715,4002,2397,0,2401,1494,907,1.647188534,1412,1557,503,172,171,1,51,1,0.076023392,0,empty,CD-0722-2
"H8,D7",3207,3686,2317,1369,2171,1148,0,1155,784,371,2.113207547,683,1407,236,113,110,3,45,1,0.018181818,0,empty,CD-0722-2
"H8,D8",1031482,1219991,753627,466364,695290,402177,1,402454,330074,72380,4.560292899,241641,107161,14317,5420,5324,96,1094,6,0.033809166,0,hg38,CD-0722-2
"H8,D9",1797,1979,1299,680,1255,675,0,675,436,239,1.824267782,384,1087,142,64,64,0,31,0,0,0,empty,CD-0722-2
"H8,D10",4298,4904,3097,1807,2981,1719,0,1723,1107,616,1.797077922,983,854,70,47,45,2,21,1,0,0,empty,CD-0722-2
"H8,D11",4128,4708,3040,1668,2806,1507,0,1508,936,572,1.636363636,872,1881,627,293,293,0,63,0,0.09556314,0,empty,CD-0722-2
"H8,D12",5118,5847,3729,2118,3435,1889,0,1896,1233,663,1.859728507,1067,2756,670,258,257,1,78,1,0.105058366,0,empty,CD-0722-2
"H8,E1",6228,6926,4495,2431,4165,2325,0,2327,1449,878,1.650341686,1327,2115,441,161,156,5,45,2,0.128205128,0,empty,CD-0722-2
"H8,E2",4589,5347,3304,2043,3191,1798,1,1802,1144,658,1.738601824,1086,1457,382,114,111,3,39,2,0.09009009,0,empty,CD-0722-2
"H8,E3",354337,410236,268680,141556,237599,125166,0,125253,94138,31115,3.0254861,72559,114106,14688,5755,5630,125,984,4,0.053285968,0,hg38,CD-0722-2
"H8,E4",4250,4773,3131,1642,2840,1600,0,1601,1089,512,2.126953125,893,1871,421,163,163,0,66,0,0.006134969,0,empty,CD-0722-2
"H8,E5",3935,4429,2935,1494,2592,1335,0,1338,880,458,1.92139738,743,1257,289,112,112,0,36,0,0,0,empty,CD-0722-2
"H8,E6",8317,9424,6090,3334,5598,3110,0,3113,2148,965,2.225906736,1796,2976,876,330,326,4,82,2,0.088957055,0,empty,CD-0722-2
"H8,E7",439523,510785,324778,186007,290910,162193,0,162339,129484,32855,3.941074418,94678,285946,37352,14795,14403,392,2203,8,0.07026314,0,hg38,CD-0722-2
"H8,E8",7015,7785,5303,2482,4587,2466,0,2467,1723,744,2.315860215,1342,2058,526,207,199,8,60,3,0.090452261,0,empty,CD-0722-2
"H8,E9",3150,3495,2308,1187,2056,1128,0,1131,762,369,2.06504065,620,1845,402,159,159,0,69,0,0.06918239,0,empty,CD-0722-2
"H8,E10",522157,648288,370509,277779,374842,230798,1,230926,185288,45638,4.059950042,142912,45629,10110,3847,3786,61,851,4,0.018753302,0,hg38,CD-0722-2
"H8,E11",4435,4895,3352,1543,2902,1522,0,1524,990,534,1.853932584,860,2141,611,190,189,1,44,1,0.021164021,0,empty,CD-0722-2
"H8,E12",4484,5335,3271,2064,3220,1816,0,1816,1146,670,1.710447761,1109,1528,205,99,99,0,36,0,0.060606061,0,empty,CD-0722-2
"H8,F1",5696,6372,4116,2256,3781,2061,0,2066,1325,741,1.788124157,1189,2035,408,176,173,3,54,2,0.115606936,0,empty,CD-0722-2
"H8,F2",4254,4831,3069,1762,2894,1570,0,1571,1030,541,1.903881701,910,2224,608,194,190,4,54,1,0.089473684,0,empty,CD-0722-2
"H8,F3",4004,4416,2889,1527,2677,1453,0,1453,980,473,2.071881607,845,2240,611,236,233,3,48,2,0.038626609,0,empty,CD-0722-2
"H8,F4",6358,6986,4620,2366,4155,2204,0,2208,1420,788,1.802030457,1206,726,175,88,88,0,26,0,0.045454545,0,empty,CD-0722-2
"H8,F5",4962,5349,3680,1669,3213,1619,0,1620,1020,600,1.7,906,1847,347,144,143,1,54,1,0.020979021,0,empty,CD-0722-2
"H8,F6",4805,5635,3463,2172,3315,1902,0,1906,1218,688,1.770348837,1148,1944,419,180,175,5,60,2,0.051428571,0,empty,CD-0722-2
"H8,F7",728396,870763,536546,334217,497930,281885,3,282104,229310,52794,4.343486002,169236,73589,9822,4091,4010,81,768,4,0.091521197,0,hg38,CD-0722-2
"H8,F8",4084,4637,3040,1597,2793,1502,0,1505,1019,486,2.096707819,823,221,43,31,30,1,18,1,0,0,empty,CD-0722-2
"H8,F9",4625,5012,3429,1583,2978,1542,0,1542,1040,502,2.071713147,799,2204,510,231,226,5,73,1,0.119469027,0,empty,CD-0722-2
"H8,F10",5648,6333,4221,2112,3820,1993,0,1995,1323,672,1.96875,1100,1139,168,75,75,0,32,0,0.266666667,0,empty,CD-0722-2
"H8,F11",4167,4577,3104,1473,2753,1415,0,1417,954,463,2.060475162,796,1162,254,112,111,1,31,1,0.126126126,0,empty,CD-0722-2
"H8,F12",1102410,1293127,800659,492468,728220,434759,4,435137,337068,98069,3.437049424,256538,12284,1231,486,464,22,128,2,0.004310345,0,hg38,CD-0722-2
"H8,G1",659568,801501,476431,325070,460075,276809,1,277015,221240,55775,3.966651726,166930,59601,16799,6038,5985,53,1042,5,0.059983292,0,hg38,CD-0722-2
"H8,G2",4087,4786,2818,1968,2800,1668,0,1668,1032,636,1.622641509,1000,651,159,72,69,3,28,2,0.028985507,0,empty,CD-0722-2
"H8,G3",5827,6549,4141,2408,3908,2173,0,2175,1308,867,1.508650519,1233,1990,586,220,218,2,65,2,0.091743119,0,empty,CD-0722-2
"H8,G4",10806,12706,7498,5208,7510,4615,0,4620,2763,1857,1.487883683,2830,126,33,25,25,0,12,0,0.36,0,empty,CD-0722-2
"H8,G5",3437,3832,2500,1332,2336,1298,0,1300,818,482,1.697095436,746,1181,260,128,127,1,44,1,0.133858268,0,empty,CD-0722-2
"H8,G6",5231,6035,3864,2171,3561,1889,0,1889,1249,640,1.9515625,1104,167,60,19,19,0,10,0,0,0,empty,CD-0722-2
"H8,G7",3951,4281,2964,1317,2686,1379,0,1381,886,495,1.78989899,764,1662,296,118,116,2,36,1,0.112068966,0,empty,CD-0722-2
"H8,G8",3247,3494,2253,1241,2152,1166,0,1170,794,376,2.111702128,659,1357,217,109,106,3,42,1,0.103773585,0,empty,CD-0722-2
"H8,G9",3620,4192,2581,1611,2450,1341,0,1343,889,454,1.95814978,772,1676,358,166,166,0,65,0,0.060240964,0,empty,CD-0722-2
"H8,G10",4390,4931,3263,1668,2955,1607,0,1607,1030,577,1.785095321,921,1477,495,215,215,0,65,0,0.023255814,0,empty,CD-0722-2
"H8,G11",4299,4853,3112,1741,2871,1513,0,1513,991,522,1.898467433,893,1146,222,103,101,2,39,2,0.00990099,0,empty,CD-0722-2
"H8,G12",3706,4265,2668,1597,2649,1487,0,1487,960,527,1.821631879,846,1877,479,198,198,0,70,0,0.075757576,0,empty,CD-0722-2
"H8,H1",403560,455436,304329,151107,263121,137138,1,137268,111233,26035,4.272440945,78585,34997,5280,2186,2141,45,476,3,0.02568893,0,hg38,CD-0722-2
"H8,H2",4204,4866,3031,1835,2936,1617,0,1617,1046,571,1.831873905,1000,2486,395,175,171,4,57,2,0.070175439,0,empty,CD-0722-2
"H8,H3",3598,4046,2614,1432,2475,1381,0,1383,911,472,1.930084746,805,1220,273,119,117,2,38,2,0.179487179,0,empty,CD-0722-2
"H8,H4",5503,6447,4003,2444,3727,2077,0,2081,1333,748,1.782085561,1233,177,14,13,13,0,8,0,0.307692308,0,empty,CD-0722-2
"H8,H5",5911,6881,4187,2694,4065,2322,0,2323,1495,828,1.805555556,1400,1498,454,151,147,4,56,2,0.020408163,0,empty,CD-0722-2
"H8,H6",3357,3973,2440,1533,2391,1392,0,1392,906,486,1.864197531,827,1512,430,187,185,2,57,2,0.005405405,0,empty,CD-0722-2
"H8,H7",3986,4383,2914,1469,2730,1447,0,1447,996,451,2.208425721,805,1949,490,174,169,5,70,2,0.017751479,0,empty,CD-0722-2
"H8,H8",4553,5250,3257,1993,3091,1788,0,1788,1164,624,1.865384615,1072,2065,488,238,234,4,56,2,0.08974359,0,empty,CD-0722-2
"H8,H9",3505,3776,2653,1123,2302,1194,0,1194,830,364,2.28021978,635,864,164,76,75,1,29,1,0.066666667,0,empty,CD-0722-2
"H8,H10",483339,563418,361724,201694,319930,172770,1,172923,133454,39469,3.381235907,101519,103999,10831,4488,4357,131,911,4,0.057149415,0,hg38,CD-0722-2
"H8,H11",1445245,1685345,1068797,616548,950769,536303,3,536704,419381,117323,3.574584694,317085,11922,1636,672,660,12,141,4,0.06969697,0,hg38,CD-0722-2
"H8,H12",3411,3890,2445,1445,2351,1350,0,1352,892,460,1.939130435,786,1140,181,94,91,3,41,1,0.043956044,0,empty,CD-0722-2
"H9,A1",3645,4165,2646,1519,2607,1498,0,1498,986,512,1.92578125,890,1158,300,126,126,0,36,0,0,0,empty,CD-0722-2
"H9,A2",5439,6136,3965,2171,3679,2040,0,2043,1274,769,1.656697009,1165,1417,289,104,99,5,46,1,0.04040404,0,empty,CD-0722-2
"H9,A3",3269,3615,2385,1230,2211,1221,0,1221,845,376,2.247340426,663,1234,214,92,87,5,33,2,0.091954023,0,empty,CD-0722-2
"H9,A4",6084,6832,4342,2490,4129,2318,0,2318,1496,822,1.819951338,1363,971,228,88,84,4,23,1,0.035714286,0,empty,CD-0722-2
"H9,A5",4563,4970,3335,1635,2978,1574,0,1574,1013,561,1.8057041,874,1947,352,159,159,0,52,0,0.113207547,0,empty,CD-0722-2
"H9,A6",5530,6274,3858,2416,3957,2304,0,2305,1491,814,1.831695332,1331,3190,789,343,337,6,95,3,0.041543027,0,empty,CD-0722-2
"H9,A7",3542,4120,2578,1542,2533,1431,0,1433,908,525,1.72952381,840,1204,257,118,117,1,43,1,0.153846154,0,empty,CD-0722-2
"H9,A8",325997,397740,240562,157178,231869,133661,0,133760,105889,27871,3.799253705,81090,21753,4635,1800,1789,11,455,2,0.040804919,0,hg38,CD-0722-2
"H9,A9",4869,5616,3555,2061,3450,1989,0,1989,1397,592,2.359797297,1158,1446,313,132,131,1,41,1,0,0,empty,CD-0722-2
"H9,A10",359023,417128,270058,147070,241909,129325,0,129436,98694,30742,3.210396201,75508,27969,2804,1166,1129,37,279,3,0.038972542,0,hg38,CD-0722-2
"H9,A11",3489,3823,2604,1219,2309,1164,0,1169,769,400,1.9225,610,1917,558,207,204,3,56,2,0.073529412,0,empty,CD-0722-2
"H9,A12",4763,5384,3445,1939,3154,1707,0,1708,1153,555,2.077477477,975,7964,1215,452,447,5,113,3,0.089485459,0,empty,CD-0722-2
"H9,B1",4194,5035,2979,2056,2957,1702,0,1704,1073,631,1.700475436,1027,1661,324,105,104,1,41,1,0.086538462,0,empty,CD-0722-2
"H9,B2",4447,5184,3002,2182,3056,1815,0,1820,1145,675,1.696296296,1095,667,108,39,38,1,17,1,0.263157895,0,empty,CD-0722-2
"H9,B3",432760,555215,299951,255264,325376,212057,0,212171,168284,43887,3.834484016,135246,4852,1067,344,340,4,128,1,0.070588235,0,hg38,CD-0722-2
"H9,B4",919702,1104397,667980,436417,635467,371682,5,372033,302898,69135,4.381254068,224528,219011,31650,12545,12264,281,1988,8,0.054957599,0,hg38,CD-0722-2
"H9,B5",4348,2489,1599,890,1827,985,0,988,643,345,1.863768116,607,974,113,57,55,2,18,1,0,0,empty,CD-0722-2
"H9,B6",4538,5182,3221,1961,3177,1857,0,1859,1177,682,1.725806452,1090,1657,446,150,148,2,43,1,0.013513514,0,empty,CD-0722-2
"H9,B7",4212,4923,3061,1862,2879,1547,0,1549,1003,546,1.836996337,936,1158,330,130,127,3,36,1,0.094488189,0,empty,CD-0722-2
"H9,B8",329408,408067,227521,180546,238284,160577,0,160697,109396,51301,2.132434066,96585,11595,916,336,324,12,93,2,0.308641975,0,hg38,CD-0722-2
"H9,B9",6542,7647,4737,2910,4610,2644,0,2644,1739,905,1.921546961,1570,1164,136,67,67,0,39,0,0.014925373,0,empty,CD-0722-2
"H9,B10",2692,2978,1914,1064,1841,968,0,972,599,373,1.605898123,583,444,60,27,26,1,17,1,0,0,empty,CD-0722-2
"H9,B11",6602,7482,4729,2753,4450,2624,0,2625,1459,1166,1.251286449,1485,139,19,15,15,0,12,0,0.066666667,0,empty,CD-0722-2
"H9,B12",3630,4173,2603,1570,2537,1411,0,1411,958,453,2.114790287,824,3387,540,251,231,20,64,3,0.103896104,0,empty,CD-0722-2
"H9,C1",7409,8110,5559,2551,4856,2590,0,2593,1633,960,1.701041667,1421,942,246,110,110,0,37,0,0.009090909,0,empty,CD-0722-2
"H9,C2",626678,745139,462632,282507,426335,242252,1,242451,184523,57928,3.185385306,144550,80365,15508,6024,5945,79,1205,3,0.032296047,0,hg38,CD-0722-2
"H9,C3",6166,6839,4568,2271,4187,2261,0,2265,1418,847,1.674144038,1238,808,187,79,78,1,26,1,0,0,empty,CD-0722-2
"H9,C4",3651,3978,2772,1206,2458,1240,0,1242,792,450,1.76,657,1488,304,129,129,0,44,0,0.07751938,0,empty,CD-0722-2
"H9,C5",5318,6007,3896,2111,3562,1923,0,1923,1324,599,2.210350584,1093,1342,182,76,75,1,41,1,0.053333333,0,empty,CD-0722-2
"H9,C6",4940,5740,3517,2223,3519,1975,0,1976,1379,597,2.309882747,1198,1297,274,133,131,2,41,1,0.061068702,0,empty,CD-0722-2
"H9,C7",6873,8359,4858,3501,4962,3026,0,3026,1796,1230,1.460162602,1809,393,108,45,45,0,18,0,0.2,0,empty,CD-0722-2
"H9,C8",7045,8035,5102,2933,4819,2657,0,2659,1720,939,1.831735889,1562,3229,770,306,301,5,94,2,0.07641196,0,empty,CD-0722-2
"H9,C9",4848,5636,3562,2074,3319,1833,0,1835,1196,639,1.871674491,1086,1467,270,139,138,1,48,1,0.15942029,0,empty,CD-0722-2
"H9,C10",5534,6285,4110,2175,3691,1979,0,1981,1320,661,1.996974281,1120,2137,409,158,155,3,49,1,0.012903226,0,empty,CD-0722-2
"H9,C11",4954,5424,3537,1887,3377,1820,0,1828,1154,674,1.712166172,1049,2215,499,186,183,3,55,1,0.12568306,0,empty,CD-0722-2
"H9,C12",6268,7117,4574,2543,4312,2337,0,2341,1532,809,1.893695921,1369,4434,688,269,266,3,62,2,0.078947368,0,empty,CD-0722-2
"H9,D1",6791,8133,4738,3395,4919,2988,0,2988,1870,1118,1.672629696,1870,1126,241,96,95,1,23,1,0.421052632,0,empty,CD-0722-2
"H9,D2",4975,5413,3690,1723,3351,1743,0,1743,1097,646,1.698142415,934,2261,594,250,250,0,68,0,0.104,0,empty,CD-0722-2
"H9,D3",4405,5028,3190,1838,2972,1663,0,1665,1105,560,1.973214286,927,1219,178,90,88,2,50,1,0.068181818,0,empty,CD-0722-2
"H9,D4",3257,3969,2385,1584,2371,1329,0,1331,910,421,2.16152019,815,1206,207,91,90,1,28,1,0.111111111,0,empty,CD-0722-2
"H9,D5",508222,609943,373020,236923,351551,200132,2,200292,160490,39802,4.032209437,120905,90504,14077,5391,5281,110,1027,8,0.036546109,0,hg38,CD-0722-2
"H9,D6",6511,7507,4685,2822,4488,2672,0,2672,1630,1042,1.564299424,1508,2055,496,191,188,3,49,2,0.164893617,0,empty,CD-0722-2
"H9,D7",3578,3890,2568,1322,2318,1203,0,1203,814,389,2.092544987,667,2129,429,209,208,1,67,1,0.052884615,0,empty,CD-0722-2
"H9,D8",578204,694207,416133,278074,398773,234170,0,234361,208574,25787,8.088339086,142225,114458,21368,8465,8335,130,1374,5,0.04655069,0,hg38,CD-0722-2
"H9,D9",1899,2145,1382,763,1293,681,0,682,439,243,1.806584362,374,1337,387,151,149,2,39,1,0.026845638,0,empty,CD-0722-2
"H9,D10",4794,5593,3414,2179,3321,1907,0,1909,1271,638,1.992163009,1137,918,173,44,43,1,15,1,0.186046512,0,empty,CD-0722-2
"H9,D11",4397,4888,3188,1700,2986,1629,0,1631,1056,575,1.836521739,916,3391,800,318,315,3,78,2,0.044444444,0,empty,CD-0722-2
"H9,D12",6173,6894,4486,2408,4076,2237,0,2238,1426,812,1.756157635,1258,6120,898,377,368,9,124,2,0.005434783,0,empty,CD-0722-2
"H9,E1",6790,7555,4897,2658,4517,2446,0,2451,1497,954,1.56918239,1391,2524,510,204,203,1,65,1,0.18226601,0,empty,CD-0722-2
"H9,E2",5190,5617,3734,1883,3443,1910,3,1916,1237,679,1.82179676,1062,2054,349,136,132,4,39,2,0.037878788,0,empty,CD-0722-2
"H9,E3",3254,3534,2431,1103,2190,1140,0,1144,733,411,1.783454988,627,1608,428,152,151,1,65,1,0.039735099,0,empty,CD-0722-2
"H9,E4",4692,5433,3458,1975,3242,1753,0,1753,1119,634,1.764984227,1020,2741,505,227,219,8,65,2,0.205479452,0,empty,CD-0722-2
"H9,E5",4228,4819,3115,1704,2855,1546,0,1546,994,552,1.800724638,865,1567,359,128,124,4,41,2,0.258064516,0,empty,CD-0722-2
"H9,E6",7620,8568,5690,2878,5081,2793,0,2793,1799,994,1.809859155,1533,3178,592,268,263,5,89,1,0.030418251,0,empty,CD-0722-2
"H9,E7",6713,7559,4961,2598,4512,2392,0,2392,1582,810,1.95308642,1297,3126,861,327,319,8,89,2,0.07523511,0,empty,CD-0722-2
"H9,E8",5511,6346,4089,2257,3826,2065,0,2067,1287,780,1.65,1209,3173,802,331,328,3,83,2,0.073170732,0,empty,CD-0722-2
"H9,E9",3523,4265,2613,1652,2534,1428,0,1428,940,488,1.926229508,883,2805,617,261,259,2,69,1,0.16988417,0,empty,CD-0722-2
"H9,E10",578103,688534,424356,264178,395513,224465,2,224637,180566,44071,4.097161399,134920,102774,20199,7713,7599,114,1341,3,0.033030662,0,hg38,CD-0722-2
"H9,E11",4601,5327,3371,1956,3191,1788,0,1792,1132,660,1.715151515,1017,2188,548,195,189,6,55,2,0.116402116,0,empty,CD-0722-2
"H9,E12",5038,5784,3761,2023,3553,1940,0,1949,1246,703,1.772403983,1134,2433,337,157,157,0,54,0,0.01910828,0,empty,CD-0722-2
"H9,F1",6070,6959,4421,2538,4131,2216,0,2219,1407,812,1.732758621,1282,2017,462,199,199,0,59,0,0.010050251,0,empty,CD-0722-2
"H9,F2",4645,5107,3409,1698,3124,1687,0,1687,1126,561,2.007130125,933,2790,685,282,278,4,73,2,0.017985612,0,empty,CD-0722-2
"H9,F3",4314,4878,3233,1645,2996,1633,0,1637,1083,554,1.954873646,916,2401,662,285,282,3,91,1,0.024822695,0,empty,CD-0722-2
"H9,F4",6658,7441,4894,2547,4466,2308,1,2311,1498,813,1.842558426,1323,818,158,67,67,0,27,0,0,0,empty,CD-0722-2
"H9,F5",5768,6259,4401,1858,3706,1931,0,1931,1261,670,1.882089552,992,2355,518,212,211,1,61,1,0.17535545,0,empty,CD-0722-2
"H9,F6",5315,6101,3833,2268,3616,2037,0,2037,1246,791,1.575221239,1224,3055,691,271,268,3,74,1,0.063432836,0,empty,CD-0722-2
"H9,F7",6333,7170,4556,2614,4276,2342,0,2342,1572,770,2.041558442,1377,1035,163,70,69,1,33,1,0.028985507,0,empty,CD-0722-2
"H9,F8",4528,5151,3466,1685,3075,1658,0,1660,1089,571,1.907180385,902,320,97,53,53,0,19,0,0,0,empty,CD-0722-2
"H9,F9",531285,672297,362886,309411,394029,275521,2,275708,198547,77161,2.57315224,168864,7784,1461,488,480,8,125,3,0.125,0,hg38,CD-0722-2
"H9,F10",6174,6881,4582,2299,4146,2169,0,2169,1373,796,1.724874372,1210,1635,293,128,128,0,43,0,0.046875,0,empty,CD-0722-2
"H9,F11",4875,5356,3667,1689,3170,1582,0,1582,1017,565,1.8,861,2370,527,206,203,3,58,2,0.049261084,0,empty,CD-0722-2
"H9,F12",5329,6090,3880,2210,3711,2022,1,2030,1296,734,1.765667575,1194,381,30,18,17,1,14,1,0.117647059,0,empty,CD-0722-2
"H9,G1",9910,12035,6982,5053,7138,4365,1,4378,2190,2188,1.000914077,2560,4534,1141,323,319,4,128,2,0.087774295,0,empty,CD-0722-2
"H9,G2",487753,519816,377100,142716,298203,135471,0,135619,101758,33861,3.005168188,73827,7759,1299,489,479,10,127,4,0.014613779,0,hg38,CD-0722-2
"H9,G3",6542,7444,4866,2578,4360,2415,0,2425,1391,1034,1.345261122,1326,2197,660,264,263,1,73,1,0.045627376,0,empty,CD-0722-2
"H9,G4",12099,14356,8278,6078,8527,5288,0,5291,3203,2088,1.534003831,3210,135,23,15,15,0,9,0,0,0,empty,CD-0722-2
"H9,G5",609653,747824,436243,311581,427416,260115,3,260284,220454,39830,5.534873211,159043,143901,24688,9800,9630,170,1650,7,0.064797508,0,hg38,CD-0722-2
"H9,G6",5889,6679,4262,2417,4026,2201,0,2201,1463,738,1.982384824,1298,167,40,27,27,0,10,0,0.037037037,0,empty,CD-0722-2
"H9,G7",4401,4868,3233,1635,2927,1540,0,1545,1006,539,1.866419295,844,2325,491,211,210,1,61,1,0.085714286,0,empty,CD-0722-2
"H9,G8",3227,3843,2351,1492,2328,1281,0,1281,861,420,2.05,773,1513,348,157,155,2,51,2,0.006451613,0,empty,CD-0722-2
"H9,G9",3775,4398,2753,1645,2641,1427,1,1428,914,514,1.778210117,848,2078,373,164,163,1,66,1,0.024539877,0,empty,CD-0722-2
"H9,G10",614365,728567,452103,276464,419238,241313,1,241533,184856,56677,3.261569949,143486,122401,20251,8038,7909,129,1292,6,0.048552282,0,hg38,CD-0722-2
"H9,G11",4656,5326,3472,1854,3160,1739,0,1742,1120,622,1.800643087,967,1283,225,98,97,1,45,1,0.06185567,0,empty,CD-0722-2
"H9,G12",4150,4650,3010,1640,2866,1601,0,1603,1074,529,2.030245747,932,4129,522,270,267,3,85,2,0.082397004,0,empty,CD-0722-2
"H9,H1",462485,560701,327743,232958,325160,197116,1,197280,155116,42164,3.678872972,121173,72194,12490,4806,4733,73,898,5,0.032748785,0,hg38,CD-0722-2
"H9,H2",4790,5267,3420,1847,3118,1682,0,1686,1090,596,1.82885906,955,2139,465,211,205,6,83,1,0.043902439,0,empty,CD-0722-2
"H9,H3",3960,4663,2881,1782,2786,1571,0,1573,1028,545,1.886238532,924,1521,270,129,126,3,60,2,0.007936508,0,empty,CD-0722-2
"H9,H4",6138,6885,4486,2399,4010,2189,0,2191,1465,726,2.017906336,1271,175,29,17,17,0,12,0,0.235294118,0,empty,CD-0722-2
"H9,H5",6544,7431,4753,2678,4340,2418,0,2419,1560,859,1.816065192,1390,1651,364,156,155,1,58,1,0.070967742,0,empty,CD-0722-2
"H9,H6",3924,4237,2829,1408,2534,1419,0,1419,941,478,1.968619247,769,1877,543,199,195,4,59,1,0.184615385,0,empty,CD-0722-2
"H9,H7",4422,5019,3276,1743,3054,1619,0,1622,1043,579,1.801381693,918,2100,536,248,247,1,84,1,0.04048583,0,empty,CD-0722-2
"H9,H8",1182779,1397519,868398,529121,786505,452073,3,452448,381121,71327,5.343292161,269278,127928,15654,6233,6094,139,1374,8,0.033967837,0,hg38,CD-0722-2
"H9,H9",3861,4316,2904,1412,2577,1359,0,1362,965,397,2.430730479,747,1314,297,118,114,4,38,2,0.043859649,0,empty,CD-0722-2
"H9,H10",3737,4246,2650,1596,2550,1388,0,1388,929,459,2.023965142,805,1550,437,186,185,1,51,1,0.037837838,0,empty,CD-0722-2
"H9,H11",4754,5517,3220,2297,3345,2147,0,2148,1170,978,1.196319018,1307,36,6,5,5,0,3,0,0,0,empty,CD-0722-2
"H9,H12",3552,4049,2574,1475,2441,1396,0,1396,912,484,1.884297521,816,2820,238,125,120,5,45,2,0,0,empty,CD-0722-2
"H10,A1",3591,4037,2553,1484,2517,1418,0,1420,935,485,1.927835052,818,1362,341,124,123,1,40,1,0.06504065,0,empty,CD-0722-2
"H10,A2",5372,6023,3894,2129,3590,2040,0,2043,1275,768,1.66015625,1143,1283,302,103,101,2,36,1,0.138613861,0,empty,CD-0722-2
"H10,A3",3506,4067,2492,1575,2353,1305,0,1305,821,484,1.696280992,773,1322,383,136,134,2,44,1,0.029850746,0,empty,CD-0722-2
"H10,A4",5705,6438,4190,2248,3888,2139,0,2146,1365,781,1.747759283,1234,986,225,88,84,4,29,2,0.05952381,0,empty,CD-0722-2
"H10,A5",4623,5175,3425,1750,3154,1709,0,1712,1061,651,1.629800307,1005,2435,574,178,175,3,50,2,0.051428571,0,empty,CD-0722-2
"H10,A6",4286,5111,3060,2051,3103,1809,0,1809,1194,615,1.941463415,1099,2299,646,245,242,3,88,1,0.066115702,0,empty,CD-0722-2
"H10,A7",3546,4032,2560,1472,2481,1427,0,1427,884,543,1.627992634,818,1186,265,105,102,3,35,2,0.009803922,0,empty,CD-0722-2
"H10,A8",2132,2426,1610,816,1421,783,0,783,524,259,2.023166023,432,1906,418,203,203,0,79,0,0.044334975,0,empty,CD-0722-2
"H10,A9",3793,4360,2716,1644,2600,1419,0,1419,893,526,1.697718631,854,1742,410,147,145,2,49,1,0.151724138,0,empty,CD-0722-2
"H10,A10",4442,4832,3376,1456,2991,1565,0,1565,945,620,1.524193548,825,436,77,35,35,0,19,0,0.028571429,0,empty,CD-0722-2
"H10,A11",3507,3930,2632,1298,2353,1222,0,1222,783,439,1.783599089,673,1495,315,144,143,1,53,1,0.097902098,0,empty,CD-0722-2
"H10,A12",4622,5030,3499,1531,3032,1571,0,1572,1012,560,1.807142857,847,3764,1088,408,407,1,86,1,0.024570025,0,empty,CD-0722-2
"H10,B1",4064,4499,2950,1549,2746,1549,0,1549,959,590,1.625423729,865,1320,343,133,132,1,44,1,0,0,empty,CD-0722-2
"H10,B2",4269,4923,2944,1979,2900,1716,0,1717,1108,609,1.819376026,1019,599,134,61,60,1,23,1,0.083333333,0,empty,CD-0722-2
"H10,B3",457559,574765,315948,258817,337362,226589,1,226721,174206,52515,3.317261735,140061,17498,10092,3575,3561,14,607,2,0.01628756,0,hg38,CD-0722-2
"H10,B4",3801,4399,2691,1708,2620,1567,0,1567,965,602,1.602990033,940,1390,189,99,98,1,32,1,0.387755102,0,empty,CD-0722-2
"H10,B5",547054,303773,189857,113916,218274,116659,9,117372,89628,27744,3.230536332,73661,74961,8217,2945,2847,98,672,5,0.053038286,0,hg38,CD-0722-2
"H10,B6",4523,5208,3156,2052,3140,1901,0,1901,1139,762,1.494750656,1153,2052,523,170,169,1,51,1,0.01183432,0,empty,CD-0722-2
"H10,B7",3989,4615,2923,1692,2692,1475,0,1475,966,509,1.8978389,833,1252,331,142,142,0,47,0,0,0,empty,CD-0722-2
"H10,B8",2923,3366,2150,1216,2008,1055,0,1055,677,378,1.791005291,619,1194,244,96,94,2,38,1,0.053191489,0,empty,CD-0722-2
"H10,B9",5858,6741,4198,2543,3989,2285,0,2285,1461,824,1.773058252,1354,1284,303,139,138,1,66,1,0.028985507,0,empty,CD-0722-2
"H10,B10",2719,3138,1977,1161,1908,1033,0,1036,701,335,2.092537313,637,488,61,41,37,4,23,1,0,0,empty,CD-0722-2
"H10,B11",6652,7659,4663,2996,4664,2829,0,2829,1485,1344,1.104910714,1683,326,124,29,29,0,14,0,0,0,empty,CD-0722-2
"H10,B12",3397,3878,2416,1462,2321,1276,0,1276,872,404,2.158415842,746,1528,304,150,149,1,49,1,0.013422819,0,empty,CD-0722-2
"H10,C1",6888,7757,5143,2614,4542,2413,0,2413,1539,874,1.760869565,1353,1208,254,103,102,1,28,1,0.049019608,0,empty,CD-0722-2
"H10,C2",744415,899777,543613,356164,508830,296001,0,296226,240219,56007,4.289088864,178529,115368,23160,8648,8517,131,1486,5,0.056592697,0,hg38,CD-0722-2
"H10,C3",6004,6724,4459,2265,4032,2188,0,2189,1391,798,1.743107769,1244,1146,210,83,82,1,28,1,0.06097561,0,empty,CD-0722-2
"H10,C4",3559,4011,2601,1410,2430,1285,0,1285,869,416,2.088942308,737,1426,371,150,149,1,43,1,0,0,empty,CD-0722-2
"H10,C5",6165,7166,4532,2634,4291,2367,0,2369,1629,740,2.201351351,1384,1544,289,147,146,1,53,1,0.191780822,0,empty,CD-0722-2
"H10,C6",5525,6324,4072,2252,3859,2169,0,2169,1476,693,2.12987013,1221,1456,407,156,156,0,43,0,0.16025641,0,empty,CD-0722-2
"H10,C7",6415,7843,4485,3358,4631,2889,0,2891,1743,1148,1.518292683,1783,599,166,82,81,1,21,1,0.012345679,0,empty,CD-0722-2
"H10,C8",7077,8136,5068,3068,4764,2640,0,2641,1695,946,1.791754757,1572,3266,790,296,293,3,124,1,0.051194539,0,empty,CD-0722-2
"H10,C9",6185,6910,4661,2249,4198,2224,0,2228,1470,758,1.939313984,1234,2143,329,117,111,6,40,2,0.009009009,0,empty,CD-0722-2
"H10,C10",607080,715122,445355,269767,407550,233313,0,233512,181433,52079,3.483803452,137697,112901,18023,6843,6717,126,1276,6,0.039005508,0,hg38,CD-0722-2
"H10,C11",4513,5131,3192,1939,3119,1766,0,1767,1096,671,1.63338301,1049,1932,453,175,172,3,61,2,0.01744186,0,empty,CD-0722-2
"H10,C12",1107177,1296095,842182,453913,728620,402978,4,403320,336212,67108,5.010013709,233129,174208,25964,10332,10117,215,1662,8,0.068795097,0,hg38,CD-0722-2
"H10,D1",6259,7303,4362,2941,4268,2507,0,2511,1542,969,1.591331269,1518,773,119,65,65,0,32,0,0.107692308,0,empty,CD-0722-2
"H10,D2",4836,5432,3612,1820,3214,1684,0,1690,1102,588,1.87414966,945,2774,771,336,331,5,103,2,0.096676737,0,empty,CD-0722-2
"H10,D3",4097,4731,2881,1850,2806,1601,0,1601,1014,587,1.727427598,980,1276,181,97,97,0,52,0,0.072164948,0,empty,CD-0722-2
"H10,D4",3280,3788,2425,1363,2243,1260,0,1260,812,448,1.8125,699,885,210,112,112,0,41,0,0.098214286,0,empty,CD-0722-2
"H10,D5",3760,4187,2739,1448,2587,1375,0,1375,901,474,1.900843882,746,2337,483,192,191,1,66,1,0.062827225,0,empty,CD-0722-2
"H10,D6",486753,573967,356754,217213,330668,184428,1,184600,146355,38245,3.826774742,110606,109373,17364,6580,6479,101,1249,6,0.042753511,0,hg38,CD-0722-2
"H10,D7",3651,3923,2721,1202,2385,1196,0,1196,817,379,2.155672823,661,2130,417,200,200,0,77,0,0.02,0,empty,CD-0722-2
"H10,D8",37878,45196,29637,15559,25757,13510,0,13513,10905,2608,4.181365031,7730,4571,952,361,354,7,104,2,0.04519774,0,empty,CD-0722-2
"H10,D9",2029,2308,1510,798,1370,741,0,741,461,280,1.646428571,414,1675,471,178,177,1,39,1,0.186440678,0,empty,CD-0722-2
"H10,D10",501859,610434,360242,250192,352167,209537,0,209686,166701,42985,3.878120275,128678,80438,11671,4729,4633,96,914,3,0.053960717,0,hg38,CD-0722-2
"H10,D11",4246,4809,3141,1668,2857,1501,0,1503,972,531,1.830508475,820,2459,690,259,258,1,86,1,0.089147287,0,empty,CD-0722-2
"H10,D12",808423,892034,635951,256083,505386,239132,1,239335,189908,49427,3.842191515,128625,561780,66822,25243,24653,590,3031,10,0.051352777,0,hg38,CD-0722-2
"H10,E1",7156,8024,5227,2797,4709,2570,1,2576,1607,969,1.658410733,1450,2399,467,215,214,1,61,1,0.079439252,0,empty,CD-0722-2
"H10,E2",4731,5573,3413,2160,3327,1907,0,1907,1222,685,1.783941606,1155,2178,434,199,199,0,66,0,0.060301508,0,empty,CD-0722-2
"H10,E3",3374,3751,2509,1242,2302,1207,0,1207,830,377,2.201591512,662,1870,415,190,190,0,67,0,0.057894737,0,empty,CD-0722-2
"H10,E4",4537,5168,3401,1767,3045,1648,0,1648,1075,573,1.87609075,897,2886,654,245,244,1,70,1,0.102459016,0,empty,CD-0722-2
"H10,E5",4052,4555,3073,1482,2697,1433,0,1433,961,472,2.036016949,809,1228,251,118,114,4,39,2,0.00877193,0,empty,CD-0722-2
"H10,E6",7570,8473,5586,2887,5000,2746,0,2746,1780,966,1.842650104,1515,3733,979,360,357,3,103,2,0.120448179,0,empty,CD-0722-2
"H10,E7",6616,7211,4892,2319,4330,2255,0,2258,1456,802,1.815461347,1282,2811,716,299,299,0,106,0,0.086956522,0,empty,CD-0722-2
"H10,E8",5100,5632,3850,1782,3395,1721,0,1728,1106,622,1.778135048,944,2828,574,241,240,1,82,1,0.033333333,0,empty,CD-0722-2
"H10,E9",396463,469171,295012,174159,269803,148534,2,148692,113690,35002,3.248100109,88258,142535,24597,9336,9191,145,1459,7,0.055489065,0,hg38,CD-0722-2
"H10,E10",4063,4604,3021,1583,2736,1488,1,1490,992,498,1.991967871,843,2116,646,263,263,0,80,0,0.072243346,0,empty,CD-0722-2
"H10,E11",4583,5203,3326,1877,3177,1755,0,1755,1155,600,1.925,1040,1983,517,179,178,1,58,1,0.06741573,0,empty,CD-0722-2
"H10,E12",5230,6314,3754,2560,3679,2101,0,2103,1349,754,1.789124668,1315,2396,555,220,218,2,63,2,0.068807339,0,empty,CD-0722-2
"H10,F1",5892,6537,4259,2278,3963,2193,0,2197,1393,804,1.732587065,1276,2231,663,263,261,2,86,2,0.019157088,0,empty,CD-0722-2
"H10,F2",4752,5275,3442,1833,3143,1704,0,1709,1104,605,1.824793388,977,3355,747,346,341,5,87,2,0.038123167,0,empty,CD-0722-2
"H10,F3",494776,576730,367750,208980,332824,179616,3,179766,138851,40915,3.393645362,106208,328766,51389,20389,19952,437,2580,9,0.054180032,0,hg38,CD-0722-2
"H10,F4",6718,7499,4984,2515,4595,2431,0,2435,1580,855,1.847953216,1412,890,172,81,80,1,34,1,0.025,0,empty,CD-0722-2
"H10,F5",5289,6016,3870,2146,3618,1945,0,1945,1289,656,1.964939024,1120,2075,506,193,192,1,63,1,0.119791667,0,empty,CD-0722-2
"H10,F6",5111,5985,3525,2460,3466,2024,0,2026,1260,766,1.644908616,1229,2606,552,230,227,3,69,1,0.04845815,0,empty,CD-0722-2
"H10,F7",6015,6830,4460,2370,4163,2338,0,2342,1573,769,2.045513654,1316,1028,232,114,110,4,38,1,0.154545455,0,empty,CD-0722-2
"H10,F8",4291,4995,3214,1781,2939,1599,0,1600,1078,522,2.0651341,866,324,54,38,37,1,20,1,0.054054054,0,empty,CD-0722-2
"H10,F9",4930,5406,3703,1703,3234,1692,0,1693,1118,575,1.944347826,911,3157,501,244,239,5,89,2,0.108786611,0,empty,CD-0722-2
"H10,F10",5932,6491,4392,2099,3829,1990,0,1992,1311,681,1.925110132,1112,1737,446,180,179,1,57,1,0.106145251,0,empty,CD-0722-2
"H10,F11",4749,5250,3578,1672,3068,1539,0,1541,1007,534,1.88576779,839,1828,378,138,136,2,57,1,0.036764706,0,empty,CD-0722-2
"H10,F12",5312,5961,3875,2086,3501,1872,0,1879,1170,709,1.650211566,1093,299,63,40,38,2,19,2,0,0,empty,CD-0722-2
"H10,G1",5620,6231,4283,1948,3802,1945,0,1946,1252,694,1.804034582,1077,2895,699,314,311,3,111,1,0.144694534,0,empty,CD-0722-2
"H10,G2",928323,1104836,643589,461247,637856,385651,0,385887,302832,83055,3.646162182,237763,50605,8585,3302,3256,46,666,4,0.067874693,0,hg38,CD-0722-2
"H10,G3",6344,6756,4671,2085,4059,2224,0,2230,1339,891,1.502805836,1134,2864,773,325,309,16,94,2,0.029126214,0,empty,CD-0722-2
"H10,G4",11992,13308,8356,4952,8294,4931,0,4936,3026,1910,1.584293194,2833,204,41,19,19,0,10,0,0,0,empty,CD-0722-2
"H10,G5",3823,4306,2749,1557,2565,1387,0,1387,951,436,2.181192661,749,2185,412,152,150,2,58,2,0.093333333,0,empty,CD-0722-2
"H10,G6",5454,6187,4056,2131,3646,1932,0,1934,1277,657,1.943683409,1113,296,68,26,24,2,10,2,0,0,empty,CD-0722-2
"H10,G7",4121,4614,3085,1529,2785,1448,0,1450,916,534,1.715355805,819,2649,795,304,303,1,61,1,0.151815182,0,empty,CD-0722-2
"H10,G8",3066,3411,2173,1238,2065,1137,0,1137,703,434,1.619815668,671,1947,422,153,153,0,52,0,0.078431373,0,empty,CD-0722-2
"H10,G9",484221,583101,346433,236668,337331,202034,0,202176,171692,30484,5.632200499,123090,107144,24694,9148,9039,109,1477,5,0.057971014,0,hg38,CD-0722-2
"H10,G10",4597,5385,3342,2043,3217,1813,0,1819,1219,600,2.031666667,1041,1928,491,209,207,2,83,2,0.062801932,0,empty,CD-0722-2
"H10,G11",4559,5168,3338,1830,3115,1620,0,1620,1046,574,1.822299652,948,1633,430,190,190,0,52,0,0.105263158,0,empty,CD-0722-2
"H10,G12",3791,4529,2747,1782,2776,1581,0,1583,1014,569,1.782073814,923,2500,618,240,239,1,75,1,0.058577406,0,empty,CD-0722-2
"H10,H1",4229,4812,3111,1701,2876,1491,0,1491,1054,437,2.411899314,900,1324,229,86,85,1,39,1,0.035294118,0,empty,CD-0722-2
"H10,H2",4293,4868,3052,1816,3033,1757,0,1757,1102,655,1.682442748,1042,2145,428,182,179,3,75,2,0.100558659,0,empty,CD-0722-2
"H10,H3",3850,4509,2720,1789,2629,1443,0,1444,984,460,2.139130435,891,1726,397,140,137,3,56,2,0.02919708,0,empty,CD-0722-2
"H10,H4",5468,6093,3965,2128,3617,1972,0,1972,1304,668,1.952095808,1146,209,30,20,20,0,10,0,0.1,0,empty,CD-0722-2
"H10,H5",6313,7072,4529,2543,4086,2273,0,2278,1452,826,1.757869249,1270,1709,400,178,175,3,65,2,0.08,0,empty,CD-0722-2
"H10,H6",3677,4094,2669,1425,2462,1368,0,1368,938,430,2.181395349,753,2273,667,252,248,4,86,2,0.108870968,0,empty,CD-0722-2
"H10,H7",845792,944504,633745,310759,543812,283901,4,284161,239471,44690,5.358491833,162779,86827,12976,4750,4645,105,944,3,0.017868676,0,hg38,CD-0722-2
"H10,H8",9526,10831,7018,3813,6495,3572,0,3574,2559,1015,2.521182266,2077,2136,453,221,221,0,79,0,0.135746606,0,empty,CD-0722-2
"H10,H9",3657,3992,2754,1238,2387,1244,0,1244,852,392,2.173469388,663,1163,268,102,101,1,39,1,0.128712871,0,empty,CD-0722-2
"H10,H10",3470,3759,2528,1231,2275,1221,0,1221,811,410,1.97804878,688,1540,231,85,83,2,36,2,0.024096386,0,empty,CD-0722-2
"H10,H11",4984,6026,3421,2605,3605,2355,0,2355,1254,1101,1.138964578,1445,80,42,21,21,0,8,0,0,0,empty,CD-0722-2
"H10,H12",3635,4055,2662,1393,2405,1353,0,1353,883,470,1.878723404,721,1485,297,121,120,1,56,1,0,0,empty,CD-0722-2
"H11,A1",4131,4601,2928,1673,2869,1617,0,1617,1080,537,2.011173184,949,1087,159,92,92,0,33,0,0.043478261,0,empty,CD-0722-2
"H11,A2",550573,638268,409762,228506,367514,201752,0,201942,161365,40577,3.976760234,117021,77944,10922,4371,4295,76,902,4,0.05355064,0,hg38,CD-0722-2
"H11,A3",508569,594110,377947,216163,345256,188488,0,188660,147566,41094,3.59093785,111472,54445,6415,2475,2418,57,541,4,0.061621175,0,hg38,CD-0722-2
"H11,A4",6175,6930,4492,2438,4236,2287,0,2293,1488,805,1.848447205,1325,580,126,56,56,0,14,0,0.321428571,0,empty,CD-0722-2
"H11,A5",5521,6077,3988,2089,3692,1952,0,1956,1229,727,1.690508941,1122,1918,497,198,196,2,49,1,0.153061224,0,empty,CD-0722-2
"H11,A6",5163,6171,3699,2472,3686,2135,0,2135,1411,724,1.948895028,1287,2329,537,250,245,5,70,2,0.020408163,0,empty,CD-0722-2
"H11,A7",4094,4736,3031,1705,2865,1607,0,1607,1042,565,1.844247788,884,1197,299,111,110,1,32,1,0.172727273,0,empty,CD-0722-2
"H11,A8",2924,3376,2156,1220,2050,1108,0,1109,732,377,1.941644562,642,1601,431,160,159,1,61,1,0.06918239,0,empty,CD-0722-2
"H11,A9",4863,5560,3627,1933,3412,1825,0,1835,1180,655,1.801526718,1027,1351,272,101,98,3,35,1,0.040816327,0,empty,CD-0722-2
"H11,A10",6168,6750,4699,2051,4078,2108,1,2114,1281,833,1.537815126,1123,370,50,33,33,0,15,0,0.03030303,0,empty,CD-0722-2
"H11,A11",4115,4796,3032,1764,2859,1528,0,1529,1089,440,2.475,892,1290,386,122,116,6,37,2,0.155172414,0,empty,CD-0722-2
"H11,A12",6411,7296,4792,2504,4234,2221,0,2222,1474,748,1.970588235,1245,2833,630,235,231,4,75,2,0.051948052,0,empty,CD-0722-2
"H11,B1",4823,5771,3422,2349,3385,2005,0,2007,1286,721,1.783633842,1169,1092,244,109,108,1,31,1,0.037037037,0,empty,CD-0722-2
"H11,B2",5074,5977,3368,2609,3564,2166,0,2167,1386,781,1.774647887,1366,556,85,28,28,0,13,0,0.178571429,0,empty,CD-0722-2
"H11,B3",4230,4859,3055,1804,3017,1698,0,1703,1082,621,1.742351047,1043,1251,274,128,125,3,37,1,0.088,0,empty,CD-0722-2
"H11,B4",5276,6255,3685,2570,3765,2308,0,2311,1482,829,1.787696019,1413,978,163,75,74,1,26,1,0.135135135,0,empty,CD-0722-2
"H11,B5",532422,307140,178711,128429,221454,128071,6,128782,99387,29395,3.381085219,83226,64939,11092,4000,3932,68,803,5,0.069430315,0,hg38,CD-0722-2
"H11,B6",5418,6271,3857,2414,3757,2173,0,2177,1415,762,1.856955381,1273,1203,303,93,92,1,33,1,0.010869565,0,empty,CD-0722-2
"H11,B7",658418,779867,489828,290039,452039,254615,3,254828,200969,53859,3.731391225,149635,66478,10954,4029,3961,68,798,3,0.044180762,0,hg38,CD-0722-2
"H11,B8",3748,4202,2783,1419,2519,1352,0,1354,846,508,1.665354331,761,1408,338,138,133,5,42,2,0.105263158,0,empty,CD-0722-2
"H11,B9",1411557,1583773,1078578,505195,894766,460444,1,460774,353161,107613,3.281768931,261913,65483,9185,3606,3534,72,700,2,0.026315789,0,hg38,CD-0722-2
"H11,B10",3340,3593,2335,1258,2231,1239,0,1239,828,411,2.01459854,689,408,107,48,48,0,13,0,0.333333333,0,empty,CD-0722-2
"H11,B11",8453,9986,5921,4065,5905,3599,0,3600,1969,1631,1.207234825,2203,321,72,33,33,0,12,0,0,0,empty,CD-0722-2
"H11,B12",604322,742899,435589,307310,436123,259673,0,259835,204379,55456,3.685426284,160909,124900,25013,9482,9338,144,1517,4,0.050224888,0,hg38,CD-0722-2
"H11,C1",15469,17215,11893,5322,9942,5096,0,5098,3491,1607,2.172370877,2741,2974,551,208,208,0,56,0,0.086538462,0,empty,CD-0722-2
"H11,C2",6517,7651,4790,2861,4563,2653,0,2655,1688,967,1.745604964,1522,1572,453,170,170,0,51,0,0.005882353,0,empty,CD-0722-2
"H11,C3",6878,7642,5090,2552,4536,2376,0,2381,1537,844,1.821090047,1308,826,144,74,71,3,22,1,0.056338028,0,empty,CD-0722-2
"H11,C4",4550,5188,3339,1849,3123,1652,0,1654,1048,606,1.729372937,967,1488,473,158,156,2,56,2,0.032051282,0,empty,CD-0722-2
"H11,C5",6325,7348,4621,2727,4340,2434,0,2434,1622,812,1.997536946,1385,1414,320,104,103,1,41,1,0.077669903,0,empty,CD-0722-2
"H11,C6",5302,6025,3898,2127,3682,2020,0,2020,1319,701,1.881597718,1144,1221,291,124,121,3,37,2,0.099173554,0,empty,CD-0722-2
"H11,C7",7875,9506,5454,4052,5599,3499,0,3506,2130,1376,1.547965116,2118,525,100,59,59,0,17,0,0.322033898,0,empty,CD-0722-2
"H11,C8",9144,10153,6698,3455,6172,3405,0,3406,2228,1178,1.891341256,1862,2880,676,276,267,9,91,2,0.048689139,0,empty,CD-0722-2
"H11,C9",6222,7237,4629,2608,4362,2369,0,2376,1555,821,1.894031669,1385,1933,433,156,156,0,40,0,0.070512821,0,empty,CD-0722-2
"H11,C10",5768,6555,4319,2236,3928,2098,0,2099,1382,717,1.927475593,1175,1659,236,89,87,2,37,1,0.034482759,0,empty,CD-0722-2
"H11,C11",464432,522979,351226,171753,306003,157157,1,157334,121810,35524,3.428949443,90284,38771,8924,3118,3075,43,600,2,0.029918699,0,hg38,CD-0722-2
"H11,C12",7658,8490,5715,2775,5124,2682,0,2688,1795,893,2.010078387,1496,1636,340,150,148,2,44,1,0.027027027,0,empty,CD-0722-2
"H11,D1",7115,8253,4981,3272,4939,2879,0,2886,1682,1204,1.397009967,1723,750,182,56,56,0,18,0,0.017857143,0,empty,CD-0722-2
"H11,D2",5769,6268,4318,1950,3873,1957,0,1959,1292,667,1.937031484,1095,2395,620,273,270,3,77,1,0.114814815,0,empty,CD-0722-2
"H11,D3",5240,6161,3726,2435,3672,2106,0,2106,1374,732,1.87704918,1277,1310,225,103,103,0,40,0,0.019417476,0,empty,CD-0722-2
"H11,D4",4801,5526,3553,1973,3350,1808,0,1812,1266,546,2.318681319,1018,1232,226,102,100,2,40,1,0.02,0,empty,CD-0722-2
"H11,D5",4502,5104,3358,1746,3126,1693,0,1696,1057,639,1.654147105,986,1528,349,138,137,1,42,1,0.01459854,0,empty,CD-0722-2
"H11,D6",7184,8390,5067,3323,4972,2995,0,2995,1791,1204,1.487541528,1763,1210,228,116,116,0,48,0,0.094827586,0,empty,CD-0722-2
"H11,D7",3931,4477,2911,1566,2731,1423,0,1423,957,466,2.053648069,842,1835,378,178,170,8,60,2,0.164705882,0,empty,CD-0722-2
"H11,D8",4806,5288,3530,1758,3194,1685,0,1686,1090,596,1.82885906,942,1231,330,139,137,2,49,1,0.072992701,0,empty,CD-0722-2
"H11,D9",2608,2882,1942,940,1775,949,0,949,640,309,2.071197411,532,1622,533,180,175,5,36,2,0,0,empty,CD-0722-2
"H11,D10",4447,5090,3202,1888,3146,1801,0,1802,1174,628,1.869426752,1064,755,158,59,58,1,29,1,0.034482759,0,empty,CD-0722-2
"H11,D11",6099,6872,4393,2479,4133,2301,0,2303,1503,800,1.87875,1304,2154,620,255,255,0,82,0,0.035294118,0,empty,CD-0722-2
"H11,D12",6313,7218,4720,2498,4348,2355,0,2358,1576,782,2.015345269,1315,3721,829,339,334,5,99,2,0.104790419,0,empty,CD-0722-2
"H11,E1",8696,9852,6276,3576,5779,3209,0,3214,1933,1281,1.508977361,1805,2252,521,179,174,5,54,1,0.137931034,0,empty,CD-0722-2
"H11,E2",6613,7783,4763,3020,4630,2618,0,2618,1711,907,1.886438809,1568,1801,370,158,153,5,52,2,0,0,empty,CD-0722-2
"H11,E3",3753,4202,2795,1407,2590,1375,0,1379,903,476,1.897058824,793,1918,442,188,185,3,60,2,0.086486486,0,empty,CD-0722-2
"H11,E4",5051,5562,3621,1941,3414,1859,0,1864,1223,641,1.907956318,1081,2331,524,223,219,4,78,2,0.228310502,0,empty,CD-0722-2
"H11,E5",4406,5024,3348,1676,3045,1611,0,1612,1085,527,2.058823529,913,1025,237,91,90,1,30,1,0.055555556,0,empty,CD-0722-2
"H11,E6",8993,9952,6621,3331,5974,3338,0,3343,2143,1200,1.785833333,1872,2926,678,262,258,4,84,1,0.046511628,0,empty,CD-0722-2
"H11,E7",8663,9752,6248,3504,5838,3198,0,3199,2090,1109,1.884580703,1855,2846,719,251,249,2,74,1,0.100401606,0,empty,CD-0722-2
"H11,E8",5907,6442,4465,1977,3903,2005,0,2005,1319,686,1.922740525,1087,2468,604,250,248,2,83,2,0.040322581,0,empty,CD-0722-2
"H11,E9",4353,5093,3150,1943,3068,1717,0,1718,1128,590,1.911864407,1026,1611,448,175,172,3,48,2,0.046511628,0,empty,CD-0722-2
"H11,E10",4239,4941,2988,1953,2896,1610,0,1610,1081,529,2.043478261,969,1124,253,96,96,0,43,0,0.208333333,0,empty,CD-0722-2
"H11,E11",5383,5896,3956,1940,3601,1976,0,1976,1274,702,1.814814815,1069,1406,352,149,149,0,40,0,0.026845638,0,empty,CD-0722-2
"H11,E12",623953,775335,442622,332713,454144,284847,1,285043,219337,65706,3.338157855,176906,69140,14442,5743,5632,111,1034,4,0.08149858,0,hg38,CD-0722-2
"H11,F1",582684,668140,435313,232827,386785,208373,3,208559,164085,44474,3.68945901,120162,102345,12606,4980,4864,116,945,7,0.056537829,0,hg38,CD-0722-2
"H11,F2",5485,6208,3965,2243,3649,1982,0,1984,1283,701,1.830242511,1125,2234,470,196,193,3,59,2,0.062176166,0,empty,CD-0722-2
"H11,F3",5053,5789,3725,2064,3437,1887,0,1888,1315,573,2.294938918,1070,1972,460,218,212,6,63,1,0.198113208,0,empty,CD-0722-2
"H11,F4",7406,8132,5522,2610,4885,2585,0,2590,1752,838,2.090692124,1388,757,158,56,56,0,27,0,0.035714286,0,empty,CD-0722-2
"H11,F5",551787,637327,412254,225073,367189,198890,2,199076,142926,56150,2.545431879,116862,117885,15346,5896,5749,147,1049,3,0.064880849,0,hg38,CD-0722-2
"H11,F6",6560,7665,4751,2914,4548,2660,0,2662,1641,1021,1.607247796,1560,2144,540,199,195,4,49,2,0.092307692,0,empty,CD-0722-2
"H11,F7",6298,7190,4632,2558,4529,2501,0,2501,1678,823,2.038882139,1494,995,225,93,92,1,26,1,0.173913043,0,empty,CD-0722-2
"H11,F8",505062,553937,397730,156207,320971,147938,0,148050,111414,36636,3.041107108,79532,18568,2191,822,787,35,202,2,0.053367217,0,hg38,CD-0722-2
"H11,F9",5865,6572,4418,2154,3995,2033,0,2033,1334,699,1.908440629,1137,2367,443,209,205,4,75,2,0.029268293,0,empty,CD-0722-2
"H11,F10",6665,7377,5036,2341,4484,2343,0,2343,1509,834,1.809352518,1277,1741,471,154,152,2,40,1,0.138157895,0,empty,CD-0722-2
"H11,F11",5956,6755,4424,2331,4082,2137,0,2137,1434,703,2.039829303,1206,1928,487,166,164,2,46,2,0.213414634,0,empty,CD-0722-2
"H11,F12",6079,6840,4453,2387,4049,2181,0,2181,1421,760,1.869736842,1229,203,25,17,17,0,8,0,0,0,empty,CD-0722-2
"H11,G1",5986,6619,4439,2180,3931,2071,0,2076,1342,734,1.828337875,1121,2444,609,234,232,2,62,1,0.129310345,0,empty,CD-0722-2
"H11,G2",4068,4734,2727,2007,2813,1665,0,1667,1091,576,1.894097222,1053,535,92,51,51,0,21,0,0,0,empty,CD-0722-2
"H11,G3",8019,8727,5873,2854,5256,2866,0,2866,1739,1127,1.543034605,1545,1732,409,161,159,2,58,1,0.056603774,0,empty,CD-0722-2
"H11,G4",13293,15607,9369,6238,9361,5752,0,5756,3566,2190,1.628310502,3423,99,15,10,10,0,9,0,0,0,empty,CD-0722-2
"H11,G5",4193,4759,3118,1641,2927,1611,0,1612,1050,562,1.868327402,923,1384,325,134,133,1,46,1,0.135338346,0,empty,CD-0722-2
"H11,G6",6307,7026,4640,2386,4153,2214,0,2218,1484,734,2.021798365,1234,110,25,18,17,1,12,1,0,0,empty,CD-0722-2
"H11,G7",652266,755474,492269,263205,438366,232336,0,232535,189688,42847,4.427101081,133092,82745,18114,6692,6611,81,1213,5,0.049765542,0,hg38,CD-0722-2
"H11,G8",3681,4213,2646,1567,2490,1350,0,1350,904,446,2.02690583,782,1468,259,109,109,0,48,0,0.055045872,0,empty,CD-0722-2
"H11,G9",4244,4907,3048,1859,3008,1698,0,1698,1093,605,1.80661157,1037,1969,545,232,231,1,61,1,0.086580087,0,empty,CD-0722-2
"H11,G10",518266,645105,365692,279413,381153,242283,0,242468,189981,52487,3.619581992,150131,39887,18422,6815,6801,14,1156,3,0.035288928,0,hg38,CD-0722-2
"H11,G11",5598,6418,4164,2254,3931,2128,0,2132,1374,758,1.812664908,1265,1628,721,220,220,0,49,0,0.045454545,0,empty,CD-0722-2
"H11,G12",4765,5522,3420,2102,3341,1897,0,1898,1296,602,2.15282392,1089,1947,294,156,155,1,53,1,0.064516129,0,empty,CD-0722-2
"H11,H1",5694,6495,4193,2302,3997,2161,0,2161,1479,682,2.168621701,1275,1429,392,159,159,0,47,0,0.012578616,0,empty,CD-0722-2
"H11,H2",5380,6246,3931,2315,3753,2095,0,2102,1367,735,1.859863946,1263,2083,441,185,183,2,52,2,0.081967213,0,empty,CD-0722-2
"H11,H3",4831,5551,3473,2078,3391,1850,0,1853,1213,640,1.8953125,1122,1596,343,136,130,6,41,2,0.069230769,0,empty,CD-0722-2
"H11,H4",6650,7855,4785,3070,4616,2572,0,2572,1718,854,2.011709602,1546,117,30,21,21,0,16,0,0,0,empty,CD-0722-2
"H11,H5",6697,7606,4852,2754,4578,2584,0,2587,1741,846,2.057919622,1472,1439,336,169,169,0,64,0,0.088757396,0,empty,CD-0722-2
"H11,H6",4647,5390,3384,2006,3238,1821,0,1823,1163,660,1.762121212,1060,1772,452,205,203,2,75,1,0.024630542,0,empty,CD-0722-2
"H11,H7",573739,660961,430114,230847,384675,204783,4,204937,159178,45759,3.478616229,119332,101704,14932,5675,5553,122,1063,6,0.053844769,0,hg38,CD-0722-2
"H11,H8",6146,6943,4399,2544,4123,2304,0,2306,1467,839,1.748510131,1351,2224,472,207,207,0,75,0,0.033816425,0,empty,CD-0722-2
"H11,H9",4521,4912,3449,1463,2946,1511,1,1514,1038,476,2.180672269,793,911,198,95,95,0,28,0,0.042105263,0,empty,CD-0722-2
"H11,H10",4634,5273,3343,1930,3167,1763,0,1766,1163,603,1.928689884,1042,1544,317,139,138,1,56,1,0.137681159,0,empty,CD-0722-2
"H11,H11",6463,7605,4319,3286,4623,3105,0,3108,1610,1498,1.074766355,1866,104,34,12,12,0,4,0,0,0,empty,CD-0722-2
"H11,H12",619148,731963,453273,278690,424391,241971,2,242123,199071,43052,4.623966366,144376,85205,13308,5125,5032,93,998,5,0.047098569,0,hg38,CD-0722-2
"H12,A1",3186,3679,2280,1399,2545,1436,0,1436,924,512,1.8046875,861,1281,220,107,105,2,37,2,0.047619048,0,empty,CD-0722-2
"H12,A2",5431,6286,4009,2277,4244,2475,0,2475,1523,952,1.599789916,1406,1467,357,115,114,1,46,1,0.131578947,0,empty,CD-0722-2
"H12,A3",2926,3431,2120,1311,2331,1310,0,1311,853,458,1.862445415,782,957,288,134,132,2,37,2,0.121212121,0,empty,CD-0722-2
"H12,A4",4553,5205,3385,1820,3576,1994,0,1994,1270,724,1.754143646,1140,821,112,57,57,0,26,0,0.01754386,0,empty,CD-0722-2
"H12,A5",4340,4877,3110,1767,3344,1783,0,1785,1122,663,1.692307692,1049,2083,488,216,213,3,56,1,0.079812207,0,empty,CD-0722-2
"H12,A6",251521,303101,185714,117387,204703,117896,1,117974,91679,26295,3.48655638,70436,72197,13794,5151,5078,73,892,4,0.02658527,0,hg38,CD-0722-2
"H12,A7",3050,3558,2213,1345,2469,1418,0,1418,876,542,1.616236162,834,1456,335,129,125,4,35,1,0.352,0,empty,CD-0722-2
"H12,A8",1895,2246,1376,870,1524,846,0,846,569,277,2.054151625,490,1423,257,113,112,1,42,1,0.107142857,0,empty,CD-0722-2
"H12,A9",3600,4119,2696,1423,2784,1516,0,1516,984,532,1.84962406,869,1427,214,103,101,2,52,1,0.089108911,0,empty,CD-0722-2
"H12,A10",213743,271672,146414,125258,186098,127577,0,127651,95698,31953,2.994961349,79176,661,105,49,48,1,21,1,0,0,empty,CD-0722-2
"H12,A11",3111,3445,2384,1061,2422,1292,0,1293,835,458,1.823144105,699,1583,283,117,116,1,43,1,0.00862069,0,empty,CD-0722-2
"H12,A12",467943,518488,359548,158940,342294,167977,0,168129,133369,34760,3.836852704,93577,151970,25960,9650,9438,212,1506,5,0.026170799,0,hg38,CD-0722-2
"H12,B1",3683,4320,2676,1644,2979,1731,0,1734,1071,663,1.615384615,1028,1079,257,90,90,0,26,0,0.066666667,0,empty,CD-0722-2
"H12,B2",3461,3930,2384,1546,2776,1686,0,1686,1059,627,1.688995215,1010,617,215,87,87,0,24,0,0.022988506,0,empty,CD-0722-2
"H12,B3",3245,3890,2340,1550,2696,1505,0,1505,960,545,1.76146789,932,1180,248,125,125,0,45,0,0.032,0,empty,CD-0722-2
"H12,B4",3958,4653,2757,1896,3234,1933,0,1938,1213,725,1.673103448,1174,1081,244,91,91,0,36,0,0,0,empty,CD-0722-2
"H12,B5",3612,2137,1341,796,1694,947,0,948,627,321,1.953271028,579,932,175,95,95,0,35,0,0.126315789,0,empty,CD-0722-2
"H12,B6",4193,4987,2967,2020,3448,2066,0,2067,1231,836,1.472488038,1263,1517,307,116,114,2,32,2,0.043859649,0,empty,CD-0722-2
"H12,B7",3529,3978,2654,1324,2751,1488,0,1494,969,525,1.845714286,787,777,69,43,40,3,18,1,0.15,0,empty,CD-0722-2
"H12,B8",838470,1023552,605416,418136,687226,424127,0,424371,341949,82422,4.148758827,256200,51484,11804,4130,4070,60,925,4,0.014742015,0,hg38,CD-0722-2
"H12,B9",5464,6267,3982,2285,4294,2455,0,2455,1533,922,1.662689805,1382,954,101,58,56,2,33,2,0.160714286,0,empty,CD-0722-2
"H12,B10",2444,2795,1744,1051,1975,1093,0,1096,687,409,1.679706601,665,536,59,32,31,1,15,1,0,0,empty,CD-0722-2
"H12,B11",7273,8615,5160,3455,5927,3644,0,3648,2048,1600,1.28,2177,269,49,25,24,1,14,1,0,0,empty,CD-0722-2
"H12,B12",3479,4016,2530,1486,2781,1527,0,1527,1053,474,2.221518987,904,1575,295,142,141,1,45,1,0.127659574,0,empty,CD-0722-2
"H12,C1",874560,1028239,639700,388539,682472,403843,1,404134,293554,110580,2.654675348,239281,27802,3863,1505,1477,28,333,4,0.045362221,0,hg38,CD-0722-2
"H12,C2",5059,5852,3623,2229,3948,2309,0,2311,1455,856,1.699766355,1322,1966,366,192,186,6,61,2,0.064516129,0,empty,CD-0722-2
"H12,C3",5025,5774,3672,2102,3959,2171,0,2171,1355,816,1.660539216,1238,1128,259,116,116,0,33,0,0.025862069,0,empty,CD-0722-2
"H12,C4",772290,895552,595090,300462,596683,315885,1,316099,256347,59752,4.290182755,180407,123975,17963,7216,7087,129,1326,5,0.040355581,0,hg38,CD-0722-2
"H12,C5",4710,5321,3522,1799,3691,1997,0,2003,1268,735,1.725170068,1121,1629,284,103,101,2,46,1,0.237623762,0,empty,CD-0722-2
"H12,C6",4047,4578,2939,1639,3242,1843,0,1846,1153,693,1.663780664,1076,1500,375,137,137,0,41,0,0,0,empty,CD-0722-2
"H12,C7",6407,7606,4503,3103,5244,3278,0,3278,1874,1404,1.334757835,1980,442,58,34,33,1,14,1,0.03030303,0,empty,CD-0722-2
"H12,C8",6468,7323,4817,2506,5109,2839,0,2841,1857,984,1.887195122,1587,2731,858,330,330,0,87,0,0.127272727,0,empty,CD-0722-2
"H12,C9",4470,5249,3308,1941,3638,1993,0,1995,1249,746,1.674262735,1195,1329,203,80,79,1,39,1,0.037974684,0,empty,CD-0722-2
"H12,C10",4630,5177,3398,1779,3596,1908,0,1908,1201,707,1.698727016,1101,1887,393,133,130,3,36,2,0.007692308,0,empty,CD-0722-2
"H12,C11",683844,797705,510404,287301,535104,293204,1,293424,242242,51182,4.732952991,172967,87704,15934,6064,5969,95,1139,3,0.029318144,0,hg38,CD-0722-2
"H12,C12",526607,630014,383590,246424,419247,243333,3,243512,190705,52807,3.611358343,146515,72437,10111,4062,3988,74,779,5,0.070210632,0,hg38,CD-0722-2
"H12,D1",5751,7106,3977,3129,4759,2896,0,2900,1762,1138,1.548330404,1829,792,233,72,70,2,23,1,0,0,empty,CD-0722-2
"H12,D2",3826,4211,2915,1296,2951,1546,0,1546,997,549,1.816029144,814,2147,517,245,243,2,85,2,0.037037037,0,empty,CD-0722-2
"H12,D3",4031,4488,2892,1596,3080,1767,0,1768,1192,576,2.069444444,980,949,212,106,102,4,37,3,0.215686275,0,empty,CD-0722-2
"H12,D4",3038,3520,2237,1283,2394,1297,0,1300,853,447,1.908277405,773,1195,368,174,170,4,38,2,0.117647059,0,empty,CD-0722-2
"H12,D5",3353,4025,2412,1613,2789,1595,0,1595,1050,545,1.926605505,986,1396,262,131,130,1,43,1,0.192307692,0,empty,CD-0722-2
"H12,D6",5597,6365,3848,2517,4437,2674,1,2680,1611,1069,1.507015903,1593,1451,285,139,134,5,43,2,0.149253731,0,empty,CD-0722-2
"H12,D7",474897,579066,344930,234136,386154,228988,1,229148,173223,55925,3.097416182,139666,27962,9526,3484,3456,28,767,3,0.033275463,0,hg38,CD-0722-2
"H12,D8",3559,4046,2613,1433,2740,1504,0,1504,942,562,1.676156584,855,1342,322,157,156,1,55,1,0.006410256,0,empty,CD-0722-2
"H12,D9",2078,2362,1493,869,1633,918,0,919,576,343,1.679300292,529,1086,344,150,149,1,38,1,0.127516779,0,empty,CD-0722-2
"H12,D10",3345,3752,2394,1358,2615,1452,0,1452,888,564,1.574468085,822,832,161,62,62,0,30,0,0.177419355,0,empty,CD-0722-2
"H12,D11",377947,431763,284809,146954,290024,151823,1,151907,116611,35296,3.303802131,87122,118083,20012,7786,7632,154,1284,5,0.041535639,0,hg38,CD-0722-2
"H12,D12",477261,546466,361580,184886,362418,188323,0,188468,147374,41094,3.586265635,108649,170502,20866,8271,8024,247,1401,6,0.078389831,0,hg38,CD-0722-2
"H12,E1",7654,8771,5618,3153,5731,3237,0,3247,1957,1290,1.517054264,1897,2268,444,197,196,1,58,1,0.086734694,0,empty,CD-0722-2
"H12,E2",375518,432065,281379,150686,291686,156185,0,156307,122382,33925,3.60742815,90682,89493,12001,4558,4456,102,839,8,0.053635548,0,hg38,CD-0722-2
"H12,E3",2951,3393,2130,1263,2359,1290,0,1290,854,436,1.958715596,759,1648,515,216,213,3,64,2,0.051643192,0,empty,CD-0722-2
"H12,E4",4114,4835,3090,1745,3261,1767,0,1767,1149,618,1.859223301,1005,2192,564,226,226,0,73,0,0.053097345,0,empty,CD-0722-2
"H12,E5",3376,3707,2536,1171,2518,1273,0,1275,831,444,1.871621622,680,1277,226,110,109,1,41,1,0.04587156,0,empty,CD-0722-2
"H12,E6",7049,8204,5026,3178,5593,3204,0,3208,2064,1144,1.804195804,1904,3105,761,334,330,4,96,3,0.009090909,0,empty,CD-0722-2
"H12,E7",6509,7308,4828,2480,5061,2691,0,2695,1750,945,1.851851852,1551,2385,624,226,224,2,78,2,0.102678571,0,empty,CD-0722-2
"H12,E8",4419,4724,3347,1377,3300,1687,0,1688,1094,594,1.841750842,857,1890,392,167,166,1,56,1,0.078313253,0,empty,CD-0722-2
"H12,E9",3515,3997,2578,1419,2773,1511,0,1511,1004,507,1.980276134,855,2473,719,278,274,4,72,2,0.051094891,0,empty,CD-0722-2
"H12,E10",3378,3930,2479,1451,2567,1359,0,1359,886,473,1.873150106,803,1546,336,131,131,0,49,0,0.083969466,0,empty,CD-0722-2
"H12,E11",4857,5327,3501,1826,3535,2026,0,2030,1305,725,1.8,1139,1887,444,160,158,2,56,2,0.246835443,0,empty,CD-0722-2
"H12,E12",4709,5429,3421,2008,3695,2061,0,2063,1346,717,1.877266388,1174,1476,257,118,118,0,54,0,0.059322034,0,empty,CD-0722-2
"H12,F1",5149,5682,3762,1920,3933,2113,0,2113,1387,726,1.91046832,1165,1913,342,150,145,5,53,2,0.124137931,0,empty,CD-0722-2
"H12,F2",4110,4702,2952,1750,3261,1843,0,1843,1210,633,1.911532385,1111,2231,506,191,189,2,60,1,0,0,empty,CD-0722-2
"H12,F3",4147,4754,3053,1701,3213,1727,0,1727,1105,622,1.776527331,1010,2335,464,191,189,2,67,1,0.063492063,0,empty,CD-0722-2
"H12,F4",5577,6165,4105,2060,4251,2226,1,2228,1440,788,1.827411168,1236,588,61,45,42,3,28,2,0.023809524,0,empty,CD-0722-2
"H12,F5",4684,5182,3514,1668,3682,1925,0,1926,1217,709,1.716502116,1086,1979,495,181,180,1,68,1,0.061111111,0,empty,CD-0722-2
"H12,F6",5232,6072,3731,2341,4095,2396,0,2396,1505,891,1.689113356,1411,2186,681,252,252,0,56,0,0.067460317,0,empty,CD-0722-2
"H12,F7",5161,5876,3840,2036,4038,2183,0,2188,1435,753,1.905710491,1276,1131,227,83,83,0,30,0,0.240963855,0,empty,CD-0722-2
"H12,F8",465113,547261,343736,203525,368165,208317,0,208448,168468,39980,4.213806903,123108,8185,1348,560,551,9,125,5,0.099818512,0,hg38,CD-0722-2
"H12,F9",4512,4973,3363,1610,3511,1781,0,1782,1161,621,1.869565217,994,2596,626,255,254,1,86,1,0.031496063,0,empty,CD-0722-2
"H12,F10",505526,588143,379113,209030,393102,211311,0,211481,158773,52708,3.012313121,124061,116386,14640,5537,5394,143,1008,6,0.057285873,0,hg38,CD-0722-2
"H12,F11",4702,5262,3513,1749,3558,1840,0,1841,1214,627,1.936204147,1020,1343,234,103,100,3,42,1,0.08,0,empty,CD-0722-2
"H12,F12",4721,5499,3397,2102,3747,2135,0,2135,1396,739,1.889039242,1248,181,22,18,17,1,10,1,0.294117647,0,empty,CD-0722-2
"H12,G1",4539,5006,3326,1680,3457,1781,0,1781,1115,666,1.674174174,996,2988,637,223,221,2,67,1,0.081447964,0,empty,CD-0722-2
"H12,G2",2927,3376,2043,1333,2303,1368,0,1369,894,475,1.882105263,800,562,103,62,61,1,32,1,0.032786885,0,empty,CD-0722-2
"H12,G3",544726,637782,410952,226830,423705,227789,1,227979,182792,45187,4.045234249,133279,241354,38184,15037,14779,258,2224,5,0.054739834,0,hg38,CD-0722-2
"H12,G4",592798,694000,442757,251243,459851,250130,1,250303,207522,42781,4.850798252,147467,2901,332,135,134,1,44,1,0.044776119,0,hg38,CD-0722-2
"H12,G5",3134,3705,2287,1418,2551,1417,0,1419,915,504,1.81547619,841,1583,352,124,122,2,47,2,0.057377049,0,empty,CD-0722-2
"H12,G6",4709,5275,3470,1805,3628,1980,0,1982,1307,675,1.936296296,1114,172,51,20,20,0,14,0,0,0,empty,CD-0722-2
"H12,G7",3875,4596,2871,1725,3099,1666,0,1672,1070,602,1.777408638,1008,2463,653,235,234,1,66,1,0.047008547,0,empty,CD-0722-2
"H12,G8",2873,3157,2091,1066,2218,1186,0,1186,815,371,2.196765499,656,1591,381,167,167,0,49,0,0.107784431,0,empty,CD-0722-2
"H12,G9",3568,4044,2631,1413,2687,1396,0,1401,908,493,1.84178499,784,1959,511,210,209,1,70,1,0.052631579,0,empty,CD-0722-2
"H12,G10",4519,5312,3267,2045,3594,2075,0,2077,1249,828,1.508454106,1210,1631,319,151,146,5,58,2,0.006849315,0,empty,CD-0722-2
"H12,G11",4172,4778,2981,1797,3225,1757,0,1758,1114,644,1.729813665,1051,1432,350,147,145,2,51,2,0.082758621,0,empty,CD-0722-2
"H12,G12",3487,3921,2532,1389,2745,1555,0,1555,981,574,1.709059233,866,2348,602,266,263,3,88,2,0.072243346,0,empty,CD-0722-2
"H12,H1",4067,4559,2986,1573,3173,1705,0,1709,1098,611,1.79705401,995,1183,222,120,119,1,40,1,0.168067227,0,empty,CD-0722-2
"H12,H2",4540,5144,3364,1780,3558,1936,0,1937,1291,646,1.998452012,1100,2061,404,178,176,2,68,1,0.045454545,0,empty,CD-0722-2
"H12,H3",3659,4118,2629,1489,2816,1559,0,1559,1014,545,1.860550459,860,1665,437,162,158,4,52,2,0.183544304,0,empty,CD-0722-2
"H12,H4",5166,6093,3796,2297,4068,2236,0,2239,1441,798,1.805764411,1335,139,30,20,20,0,12,0,0.05,0,empty,CD-0722-2
"H12,H5",5402,6204,3948,2256,4254,2375,0,2377,1552,825,1.881212121,1377,1830,347,167,167,0,60,0,0.119760479,0,empty,CD-0722-2
"H12,H6",4092,4711,2997,1714,3224,1761,0,1762,1195,567,2.107583774,1034,1915,549,204,204,0,66,0,0.058823529,0,empty,CD-0722-2
"H12,H7",3895,4387,2819,1568,3036,1608,0,1610,1060,550,1.927272727,946,1639,330,162,161,1,66,1,0.068322981,0,empty,CD-0722-2
"H12,H8",478441,582884,347295,235589,390512,230219,0,230363,190278,40085,4.746862916,140773,83485,12343,4872,4795,77,1060,4,0.053806048,0,hg38,CD-0722-2
"H12,H9",3838,4306,2930,1376,2987,1579,0,1581,1079,502,2.14940239,882,1175,418,167,166,1,32,1,0.126506024,0,empty,CD-0722-2
"H12,H10",3859,4318,2829,1489,2928,1564,0,1565,1087,478,2.274058577,923,1441,170,95,92,3,37,2,0.043478261,0,empty,CD-0722-2
"H12,H11",5125,6266,3460,2806,4417,3019,0,3019,1612,1407,1.145700071,1876,98,29,15,15,0,8,0,0,0,empty,CD-0722-2
"H12,H12",3928,4440,2837,1603,3002,1691,0,1693,1132,561,2.017825312,983,993,189,107,107,0,54,0,0.102803738,0,empty,CD-0722-2
"A1,A1",7001,7784,5145,2639,4131,2177,0,2177,1379,798,1.728070175,1227,1290,334,138,137,1,36,1,0.072992701,0,empty,CD-0722-4
"A1,A2",9875,10773,7283,3490,5560,2749,22,2775,1699,1076,1.578996283,1575,2380,564,211,211,0,50,0,0.033175355,0,empty,CD-0722-4
"A1,A3",6600,7245,4852,2393,3700,1798,0,1798,1204,594,2.026936027,976,1709,526,198,193,5,40,2,0.010362694,0,empty,CD-0722-4
"A1,A4",963060,1077704,726911,350793,526713,270058,12,270315,213406,56909,3.749951677,154314,24382,4614,1702,1676,26,350,3,0.01372315,0,hg38,CD-0722-4
"A1,A5",1158463,1340525,869359,471166,652093,355914,1,356263,292526,63737,4.589579051,206271,211751,27383,10835,10628,207,1698,7,0.054102371,0,hg38,CD-0722-4
"A1,A6",7780,8735,5828,2907,4485,2321,1,2325,1463,862,1.697215777,1256,3146,877,348,347,1,81,1,0.057636888,0,empty,CD-0722-4
"A1,A7",6996,7924,5081,2843,4073,2139,0,2145,1360,785,1.732484076,1273,1567,450,174,173,1,40,1,0.023121387,0,empty,CD-0722-4
"A1,A8",4158,4674,3134,1540,2441,1200,3,1203,822,381,2.157480315,669,2130,398,174,166,8,49,1,0,0,empty,CD-0722-4
"A1,A9",8325,9154,6201,2953,4857,2488,0,2490,1706,784,2.176020408,1398,1980,549,159,158,1,42,1,0.14556962,0,empty,CD-0722-4
"A1,A10",8479,9394,6477,2917,4928,2423,0,2426,1515,911,1.663007684,1384,287,40,20,20,0,8,0,0,0,empty,CD-0722-4
"A1,A11",6112,6756,4572,2184,3586,1713,0,1713,1092,621,1.758454106,991,1656,357,162,159,3,37,2,0.062893082,0,empty,CD-0722-4
"A1,A12",8489,8961,6400,2561,4648,2174,0,2176,1396,780,1.78974359,1166,3471,978,383,382,1,83,1,0.12565445,0,empty,CD-0722-4
"A1,B1",7878,8451,5830,2621,4359,2169,1,2174,1389,785,1.769426752,1192,1821,561,215,215,0,52,0,0.106976744,0,empty,CD-0722-4
"A1,B2",8628,9066,5929,3137,4734,2470,12,2484,1581,903,1.750830565,1423,582,97,41,40,1,14,1,0.075,0,empty,CD-0722-4
"A1,B3",6097,6704,4487,2217,3549,1763,0,1763,1149,614,1.871335505,1031,1759,392,166,162,4,35,3,0.080246914,0,empty,CD-0722-4
"A1,B4",6912,7961,5012,2949,4082,2201,0,2201,1349,852,1.583333333,1298,1452,218,98,94,4,26,2,0.117021277,0,empty,CD-0722-4
"A1,B5",7334,4370,2859,1511,2932,1501,0,1514,1001,513,1.951267057,941,964,251,91,91,0,22,0,0.010989011,0,empty,CD-0722-4
"A1,B6",8637,9569,6217,3352,4891,2571,0,2576,1599,977,1.636642784,1479,1937,383,163,159,4,43,1,0.006289308,0,empty,CD-0722-4
"A1,B7",7692,8439,5846,2593,4446,2113,0,2114,1340,774,1.73126615,1166,1184,268,126,125,1,31,1,0.04,0,empty,CD-0722-4
"A1,B8",5483,5786,4307,1479,3102,1416,0,1416,912,504,1.80952381,725,1442,351,160,159,1,36,1,0.13836478,0,empty,CD-0722-4
"A1,B9",10403,11535,7584,3951,5909,3050,8,3059,1856,1203,1.542809643,1752,1068,323,130,128,2,30,1,0.0703125,0,empty,CD-0722-4
"A1,B10",5345,5756,3923,1833,3128,1566,0,1570,973,597,1.629815745,867,463,85,39,39,0,16,0,0.051282051,0,empty,CD-0722-4
"A1,B11",11332,12487,8271,4216,6483,3509,11,3520,1962,1558,1.259306804,1989,186,24,10,10,0,5,0,0,0,empty,CD-0722-4
"A1,B12",6401,7229,4773,2456,3754,1910,0,1910,1254,656,1.911585366,1055,1966,530,222,221,1,55,1,0.022624434,0,empty,CD-0722-4
"A1,C1",1072443,1193317,808849,384468,578616,295874,2,296139,232563,63576,3.658031333,167562,93351,12934,5280,5165,115,887,6,0.047821878,0,hg38,CD-0722-4
"A1,C2",11313,12593,8253,4340,6496,3376,0,3377,2111,1266,1.667456556,1928,2564,755,222,220,2,53,1,0.013636364,0,empty,CD-0722-4
"A1,C3",11352,12261,8458,3803,6499,3150,0,3152,1997,1155,1.729004329,1769,824,140,46,44,2,19,1,0.022727273,0,empty,CD-0722-4
"A1,C4",7135,7709,5371,2338,4031,1917,0,1918,1272,646,1.969040248,1076,1805,639,240,239,1,55,1,0.020920502,0,empty,CD-0722-4
"A1,C5",10021,11187,7443,3744,5793,2923,0,2928,1932,996,1.939759036,1647,1855,401,160,160,0,40,0,0,0,empty,CD-0722-4
"A1,C6",9146,9719,6715,3004,5327,2615,0,2621,1735,886,1.958239278,1475,2564,547,216,213,3,49,2,0.03286385,0,empty,CD-0722-4
"A1,C7",12297,13978,8669,5309,7175,4026,0,4036,2471,1565,1.578913738,2386,514,127,55,55,0,13,0,0.072727273,0,empty,CD-0722-4
"A1,C8",12548,13705,9219,4486,7088,3474,0,3480,2250,1230,1.829268293,1980,3736,804,305,297,8,75,2,0.127946128,0,empty,CD-0722-4
"A1,C9",8807,9768,6594,3174,5038,2453,0,2458,1579,879,1.796359499,1346,1660,430,171,170,1,40,1,0.058823529,0,empty,CD-0722-4
"A1,C10",10565,11444,7919,3525,5871,2774,0,2777,1809,968,1.868801653,1518,2327,628,271,269,2,71,2,0.059479554,0,empty,CD-0722-4
"A1,C11",9479,10313,6931,3382,5312,2612,0,2616,1702,914,1.86214442,1482,2721,705,277,268,9,61,2,0.052238806,0,empty,CD-0722-4
"A1,C12",834433,912677,636660,276017,443180,212511,1,212728,164779,47949,3.436547165,119096,103511,13696,5161,5028,133,1011,5,0.044152745,0,hg38,CD-0722-4
"A1,D1",11571,12991,8439,4552,6760,3527,0,3531,2186,1345,1.62527881,2056,1063,218,65,65,0,19,0,0,0,empty,CD-0722-4
"A1,D2",9698,10410,7430,2980,5556,2600,0,2604,1666,938,1.776119403,1394,3555,1070,362,362,0,82,0,0.041436464,0,empty,CD-0722-4
"A1,D3",7995,8715,5831,2884,4607,2373,1,2377,1517,860,1.763953488,1307,1444,302,124,124,0,30,0,0.048387097,0,empty,CD-0722-4
"A1,D4",6085,6797,4559,2238,3605,1828,1,1831,1148,683,1.680819912,1055,1576,302,113,112,1,27,1,0.205357143,0,empty,CD-0722-4
"A1,D5",7257,7653,5454,2199,4004,1891,0,1892,1243,649,1.915254237,1020,2119,553,197,193,4,53,2,0.046632124,0,empty,CD-0722-4
"A1,D6",11233,12295,7855,4440,6455,3474,0,3478,2114,1364,1.549853372,2068,2162,405,182,176,6,53,2,0.085227273,0,empty,CD-0722-4
"A1,D7",6444,6990,4891,2099,3641,1686,11,1699,1077,622,1.731511254,955,2423,495,200,193,7,56,2,0.051813472,0,empty,CD-0722-4
"A1,D8",994989,1200518,718607,481911,589372,345162,14,345444,269957,75487,3.576205174,211954,64498,14667,5629,5579,50,959,3,0.061659796,0,hg38,CD-0722-4
"A1,D9",4283,4496,3229,1267,2365,1103,0,1106,736,370,1.989189189,572,1481,297,132,132,0,31,0,0.060606061,0,empty,CD-0722-4
"A1,D10",7547,8576,5552,3024,4442,2340,0,2344,1404,940,1.493617021,1357,944,210,86,83,3,22,2,0.325301205,0,empty,CD-0722-4
"A1,D11",8093,8521,6020,2501,4429,2096,1,2107,1329,778,1.708226221,1145,2709,719,293,291,2,74,2,0.013745704,0,empty,CD-0722-4
"A1,D12",10885,12119,8100,4019,6316,3183,1,3195,1985,1210,1.640495868,1845,4224,1232,473,470,3,95,2,0.044680851,0,empty,CD-0722-4
"A1,E1",13275,14808,9810,4998,7639,3955,4,3961,2468,1493,1.653047555,2204,2701,527,225,224,1,62,1,0.075892857,0,empty,CD-0722-4
"A1,E2",9575,10571,7118,3453,5472,2717,0,2721,1704,1017,1.675516224,1561,2302,590,204,201,3,40,1,0.169154229,0,empty,CD-0722-4
"A1,E3",615796,703119,458222,244897,351397,188194,2,188365,152537,35828,4.257480183,109033,121321,23697,8979,8842,137,1320,5,0.030083691,0,hg38,CD-0722-4
"A1,E4",8728,9464,6586,2878,4946,2460,0,2464,1575,889,1.771653543,1316,2766,666,272,268,4,64,2,0.097014925,0,empty,CD-0722-4
"A1,E5",8019,8513,6184,2329,4440,2029,0,2029,1336,693,1.927849928,1070,1110,363,160,159,1,38,1,0.125786164,0,empty,CD-0722-4
"A1,E6",14443,15925,10546,5379,8314,4327,10,4341,2647,1694,1.56257379,2502,3622,921,345,343,2,81,1,0.040816327,0,empty,CD-0722-4
"A1,E7",21761,23881,16819,7062,12063,5601,0,5606,4093,1513,2.705221414,3073,6220,1265,506,501,5,132,2,0.035928144,0,empty,CD-0722-4
"A1,E8",11230,11768,8619,3149,6105,2734,0,2734,1769,965,1.833160622,1411,3920,857,329,325,4,82,1,0.021538462,0,empty,CD-0722-4
"A1,E9",6019,6620,4550,2070,3456,1678,0,1678,1123,555,2.023423423,938,2512,656,254,254,0,65,0,0.047244094,0,empty,CD-0722-4
"A1,E10",7832,8392,5751,2641,4385,2140,0,2142,1414,728,1.942307692,1185,1863,562,212,211,1,46,1,0.028436019,0,empty,CD-0722-4
"A1,E11",8742,9672,6416,3256,5150,2595,0,2595,1619,976,1.658811475,1520,2069,574,226,226,0,46,0,0.07079646,0,empty,CD-0722-4
"A1,E12",9271,10412,6822,3590,5317,2644,8,2653,1687,966,1.746376812,1559,1930,493,211,210,1,50,1,0.104761905,0,empty,CD-0722-4
"A1,F1",11564,12487,8562,3925,6434,3149,0,3161,1983,1178,1.68336163,1693,2040,548,212,209,3,53,2,0.090909091,0,empty,CD-0722-4
"A1,F2",28550,30691,22187,8504,15094,6655,0,6660,4687,1973,2.375570198,3598,5394,1215,445,443,2,109,2,0.047404063,0,empty,CD-0722-4
"A1,F3",11857,13238,8839,4399,6700,3405,0,3410,2275,1135,2.004405286,1945,3395,774,295,293,2,79,1,0.105802048,0,empty,CD-0722-4
"A1,F4",13044,13972,9675,4297,7394,3475,0,3479,2234,1245,1.79437751,1912,664,76,36,34,2,12,2,0.147058824,0,empty,CD-0722-4
"A1,F5",994264,1102740,746855,355885,533935,270910,8,271156,210915,60241,3.501186899,154409,145732,19000,7406,7212,194,1221,6,0.061425402,0,hg38,CD-0722-4
"A1,F6",10123,11119,7410,3709,5860,3011,1,3019,1878,1141,1.645924628,1762,3913,771,321,316,5,78,2,0.129746835,0,empty,CD-0722-4
"A1,F7",11693,12714,8873,3841,6723,3235,0,3240,2127,1113,1.911051213,1743,1247,327,126,125,1,38,1,0.024,0,empty,CD-0722-4
"A1,F8",8020,8709,6044,2665,4583,2129,1,2131,1392,739,1.883626522,1197,199,107,40,40,0,6,0,0,0,empty,CD-0722-4
"A1,F9",8737,9258,6597,2661,4948,2289,0,2290,1518,772,1.966321244,1251,3454,806,302,301,1,72,1,0.142857143,0,empty,CD-0722-4
"A1,F10",11705,12596,8750,3846,6476,2993,1,2999,1915,1084,1.766605166,1654,1905,415,148,141,7,45,2,0.021276596,0,empty,CD-0722-4
"A1,F11",8610,9159,6533,2626,4730,2212,0,2220,1438,782,1.83887468,1190,1534,262,111,110,1,33,1,0.109090909,0,empty,CD-0722-4
"A1,F12",9710,10328,7195,3133,5464,2616,0,2617,1690,927,1.823085221,1459,282,77,40,40,0,9,0,0,0,empty,CD-0722-4
"A1,G1",11048,11748,8225,3523,6158,2913,0,2923,1904,1019,1.868498528,1567,2652,554,214,207,7,61,1,0.096618357,0,empty,CD-0722-4
"A1,G2",6401,7200,4481,2719,3674,1930,14,1947,1166,781,1.492957746,1153,539,194,64,63,1,18,1,0.111111111,0,empty,CD-0722-4
"A1,G3",13614,14616,10100,4516,7522,3711,6,3726,2351,1375,1.709818182,2057,2512,713,261,259,2,72,2,0.05019305,0,empty,CD-0722-4
"A1,G4",21293,23908,15284,8624,12250,6827,0,6836,4140,2696,1.535608309,3939,49,6,4,4,0,4,0,0,0,empty,CD-0722-4
"A1,G5",507876,604908,358282,246626,308717,192458,1,192562,154154,38408,4.013590919,115697,12934,4851,1627,1617,10,328,3,0.005565863,0,hg38,CD-0722-4
"A1,G6",10546,11538,7900,3638,5940,2849,7,2862,1918,944,2.031779661,1594,143,31,13,13,0,9,0,0,0,empty,CD-0722-4
"A1,G7",8660,9362,6599,2763,4953,2273,1,2274,1508,766,1.968668407,1212,3293,910,345,344,1,75,1,0.069767442,0,empty,CD-0722-4
"A1,G8",5984,6301,4308,1993,3354,1564,0,1564,970,594,1.632996633,899,1917,506,181,180,1,50,1,0.2,0,empty,CD-0722-4
"A1,G9",7667,8368,5708,2660,4393,2159,0,2159,1368,791,1.729456384,1200,2654,731,268,266,2,66,1,0.033834586,0,empty,CD-0722-4
"A1,G10",8962,9889,6624,3265,5019,2464,0,2470,1611,859,1.875436554,1380,3101,605,231,229,2,72,2,0.013100437,0,empty,CD-0722-4
"A1,G11",9002,9917,6841,3076,5162,2393,2,2401,1554,847,1.834710744,1339,2032,613,244,239,5,48,3,0.016736402,0,empty,CD-0722-4
"A1,G12",7783,8871,5732,3139,4568,2370,0,2373,1508,865,1.743352601,1406,2421,524,182,180,2,46,1,0.144444444,0,empty,CD-0722-4
"A1,H1",7561,8095,5719,2376,4276,2079,0,2081,1334,747,1.785809906,1124,1385,234,111,111,0,32,0,0.072072072,0,empty,CD-0722-4
"A1,H2",8947,9938,6573,3365,5009,2553,4,2557,1671,886,1.886004515,1422,2927,603,263,257,6,70,2,0.089494163,0,empty,CD-0722-4
"A1,H3",7022,7764,5138,2626,3981,1960,0,1964,1266,698,1.813753582,1135,1143,310,110,109,1,40,1,0.009174312,0,empty,CD-0722-4
"A1,H4",10883,12165,8042,4123,6268,3115,1,3118,2026,1092,1.855311355,1807,110,22,14,13,1,6,1,0,0,empty,CD-0722-4
"A1,H5",11915,13073,8914,4159,6670,3234,0,3237,2074,1163,1.783319003,1771,2311,460,177,175,2,48,2,0.16,0,empty,CD-0722-4
"A1,H6",6432,6929,4754,2175,3693,1875,0,1883,1223,660,1.853030303,1068,1715,483,202,199,3,49,2,0.155778894,0,empty,CD-0722-4
"A1,H7",8365,8937,6296,2641,4693,2171,0,2172,1434,738,1.943089431,1186,1703,348,145,144,1,42,1,0.138888889,0,empty,CD-0722-4
"A1,H8",8960,9701,6632,3069,5133,2645,0,2647,1717,930,1.846236559,1506,2556,392,165,156,9,56,3,0.019230769,0,empty,CD-0722-4
"A1,H9",6838,7314,5203,2111,3747,1701,0,1701,1140,561,2.032085561,929,1245,265,122,120,2,44,1,0.066666667,0,empty,CD-0722-4
"A1,H10",21024,23368,15882,7486,11182,5343,22,5369,3867,1502,2.574567244,3059,2951,635,227,226,1,45,1,0.084070796,0,empty,CD-0722-4
"A1,H11",8709,10177,6137,4040,5142,3088,1,3091,1708,1383,1.234996385,1806,21,1,1,1,0,1,0,0,0,empty,CD-0722-4
"A1,H12",6542,6888,4800,2088,3586,1821,0,1824,1134,690,1.643478261,993,1234,242,97,95,2,32,1,0.136842105,0,empty,CD-0722-4
"A2,A1",3307435,3918650,2427522,1491128,1859681,1092342,4,1093252,871941,221311,3.939890019,655979,223832,40521,15073,14863,210,2131,8,0.068828635,0,hg38,CD-0722-4
"A2,A2",10491,11551,7857,3694,5940,2948,0,2950,1860,1090,1.706422018,1623,2375,667,274,273,1,65,1,0.06959707,0,empty,CD-0722-4
"A2,A3",6706,7119,4974,2145,3666,1788,12,1806,1191,615,1.936585366,964,1448,183,86,86,0,33,0,0,0,empty,CD-0722-4
"A2,A4",12182,13168,9266,3902,6798,3309,0,3315,2120,1195,1.774058577,1833,809,144,66,65,1,25,1,0.030769231,0,empty,CD-0722-4
"A2,A5",140393,191869,83128,108741,100136,76827,2,76888,49460,27428,1.803266735,52372,3811,1066,334,333,1,83,1,0.126126126,0,empty,CD-0722-4
"A2,A6",8193,9188,6241,2947,4758,2399,0,2399,1587,812,1.954433498,1318,3984,990,351,346,5,82,2,0.072254335,0,empty,CD-0722-4
"A2,A7",7256,7936,5372,2564,4143,2108,1,2111,1401,710,1.973239437,1174,1514,368,111,111,0,34,0,0.072072072,0,empty,CD-0722-4
"A2,A8",4323,4968,3224,1744,2642,1314,0,1322,854,468,1.824786325,765,2237,481,207,205,2,51,1,0.073170732,0,empty,CD-0722-4
"A2,A9",9092,10381,6858,3523,5331,2696,0,2698,1841,857,2.148191365,1559,2245,525,189,188,1,55,1,0.143617021,0,empty,CD-0722-4
"A2,A10",11309,12446,8487,3959,6295,3146,5,3152,1993,1159,1.71958585,1727,439,83,40,40,0,12,0,0.175,0,empty,CD-0722-4
"A2,A11",6431,6893,4956,1937,3654,1692,0,1694,1125,569,1.9771529,905,1936,471,205,203,2,52,2,0.073891626,0,empty,CD-0722-4
"A2,A12",9532,10189,7228,2961,5271,2487,0,2488,1704,784,2.173469388,1364,4270,1045,389,386,3,88,1,0.095854922,0,empty,CD-0722-4
"A2,B1",7809,8806,5769,3037,4451,2270,0,2272,1479,793,1.865069357,1258,1177,260,90,89,1,26,1,0.011235955,0,empty,CD-0722-4
"A2,B2",8686,9458,5993,3465,4905,2594,3,2601,1636,965,1.695336788,1539,794,109,51,51,0,14,0,0.215686275,0,empty,CD-0722-4
"A2,B3",1046449,1193661,796225,397436,582353,299230,2,299506,229823,69683,3.298121493,172453,140857,14048,5507,5372,135,991,9,0.057520477,0,hg38,CD-0722-4
"A2,B4",239016,305040,157639,147401,158640,112586,0,112670,70899,41771,1.697325896,71305,2673,991,295,292,3,70,2,0.27739726,0,hg38,CD-0722-4
"A2,B5",986526,631229,371642,259587,403985,232994,10,234195,187918,46277,4.060721309,148652,91804,16169,6225,6117,108,1100,4,0.076671571,0,hg38,CD-0722-4
"A2,B6",8579,9413,6189,3224,4913,2565,8,2574,1661,913,1.819277108,1469,1983,411,206,205,1,65,1,0.126829268,0,empty,CD-0722-4
"A2,B7",8647,9473,6513,2960,4991,2465,5,2473,1640,833,1.968787515,1360,1847,428,141,141,0,36,0,0.028368794,0,empty,CD-0722-4
"A2,B8",6098,6847,4608,2239,3568,1696,0,1700,1129,571,1.977232925,981,1539,318,148,145,3,30,2,0.096551724,0,empty,CD-0722-4
"A2,B9",10857,12187,7942,4245,6304,3238,1,3240,2007,1233,1.627737226,1911,1127,188,81,79,2,23,2,0.189873418,0,empty,CD-0722-4
"A2,B10",770577,833661,550066,283595,430884,220151,7,220638,165709,54929,3.016785305,129156,49939,4395,1705,1645,60,347,5,0.057142857,0,hg38,CD-0722-4
"A2,B11",16101,17650,11864,5786,8984,4761,6,4770,2809,1961,1.432432432,2645,462,75,34,34,0,10,0,0.058823529,0,empty,CD-0722-4
"A2,B12",7526,8111,5601,2510,4136,2020,0,2024,1314,710,1.850704225,1098,2490,610,264,260,4,54,2,0.111538462,0,empty,CD-0722-4
"A2,C1",14709,15471,11220,4251,8044,3789,15,3809,2372,1437,1.6506611,1991,1693,462,182,180,2,50,2,0.011111111,0,empty,CD-0722-4
"A2,C2",12031,13056,8884,4172,6769,3342,1,3345,2178,1167,1.866323907,1844,2663,708,284,279,5,67,2,0,0,empty,CD-0722-4
"A2,C3",12923,13929,9370,4559,7214,3581,0,3584,2204,1380,1.597101449,2035,896,175,71,71,0,24,0,0,0,empty,CD-0722-4
"A2,C4",7403,7946,5655,2291,4177,1954,2,1958,1266,692,1.829479769,1021,2290,455,156,151,5,52,1,0.006622517,0,empty,CD-0722-4
"A2,C5",10966,11928,7992,3936,6255,3134,0,3135,2087,1048,1.991412214,1795,2153,495,204,203,1,57,1,0.128078818,0,empty,CD-0722-4
"A2,C6",10732,11743,7929,3814,6123,3064,1,3071,1986,1085,1.830414747,1768,1716,377,155,154,1,45,1,0.032467532,0,empty,CD-0722-4
"A2,C7",12983,14937,9235,5702,7511,4206,1,4207,2478,1729,1.433198381,2463,584,119,42,42,0,15,0,0,0,empty,CD-0722-4
"A2,C8",13473,14793,10041,4752,7670,3886,0,3893,2574,1319,1.951478393,2192,3807,874,287,279,8,74,2,0.096774194,0,empty,CD-0722-4
"A2,C9",954658,1123088,706121,416967,550249,302259,7,302525,235881,66644,3.539418402,182141,117046,9830,3926,3770,156,756,7,0.055702918,0,hg38,CD-0722-4
"A2,C10",11351,12404,8442,3962,6346,3139,3,3146,2027,1119,1.811438785,1799,2629,387,167,164,3,53,2,0.024390244,0,empty,CD-0722-4
"A2,C11",9822,10800,7329,3471,5697,2792,0,2793,1841,952,1.933823529,1592,2598,540,224,220,4,60,2,0.045454545,0,empty,CD-0722-4
"A2,C12",13384,14546,9980,4566,7605,3653,0,3662,2406,1256,1.915605096,2039,2350,594,244,243,1,62,1,0.012345679,0,empty,CD-0722-4
"A2,D1",975499,1131214,715270,415944,554958,310208,6,310492,255458,55034,4.641821419,182912,96752,12009,4807,4712,95,876,4,0.036290323,0,hg38,CD-0722-4
"A2,D2",10402,11189,7898,3291,5785,2670,17,2692,1725,967,1.783867632,1464,4130,1049,411,396,15,94,3,0.04040404,0,empty,CD-0722-4
"A2,D3",8624,9712,6258,3454,5047,2625,0,2625,1754,871,2.013777268,1527,1899,437,189,187,2,45,1,0.010695187,0,empty,CD-0722-4
"A2,D4",6737,7444,5100,2344,3841,1857,10,1867,1217,650,1.872307692,1018,1802,390,160,156,4,46,2,0.115384615,0,empty,CD-0722-4
"A2,D5",7556,8153,5619,2534,4280,2053,0,2054,1358,696,1.951149425,1145,2301,545,227,227,0,58,0,0.0969163,0,empty,CD-0722-4
"A2,D6",11707,13171,8277,4894,6824,3742,15,3762,2201,1561,1.409993594,2238,1755,476,182,182,0,47,0,0.093406593,0,empty,CD-0722-4
"A2,D7",6464,6957,4839,2118,3606,1685,0,1687,1126,561,2.007130125,946,2147,637,239,239,0,58,0,0.10041841,0,empty,CD-0722-4
"A2,D8",8062,9315,5831,3484,4753,2438,0,2438,1549,889,1.742407199,1481,1519,464,211,209,2,49,1,0.14354067,0,empty,CD-0722-4
"A2,D9",4133,4499,3047,1452,2331,1094,4,1103,729,374,1.949197861,629,1840,376,147,143,4,33,1,0.111888112,0,empty,CD-0722-4
"A2,D10",864531,1000794,647115,353679,491071,259033,3,259297,197419,61878,3.190455412,154198,111315,13597,5655,5552,103,862,7,0.06898415,0,hg38,CD-0722-4
"A2,D11",8810,9506,6524,2982,5010,2424,0,2426,1508,918,1.642701525,1398,2733,822,319,310,9,77,3,0.04516129,0,empty,CD-0722-4
"A2,D12",11763,12655,8778,3877,6468,3105,0,3109,2034,1075,1.892093023,1697,5052,1500,608,604,4,125,2,0.069536424,0,empty,CD-0722-4
"A2,E1",921215,1003875,719466,284409,488437,225051,1,225350,172828,52522,3.290582994,122839,130414,13367,5175,5044,131,960,7,0.051546392,0,hg38,CD-0722-4
"A2,E2",10493,11681,7706,3975,5929,3010,0,3012,1929,1083,1.781163435,1753,2620,579,253,251,2,53,2,0.06374502,0,empty,CD-0722-4
"A2,E3",7080,8043,5338,2705,4018,2002,0,2003,1312,691,1.89869754,1115,2933,842,352,349,3,76,2,0.128939828,0,empty,CD-0722-4
"A2,E4",9339,10339,6856,3483,5439,2733,0,2733,1707,1026,1.66374269,1573,3000,642,278,274,4,77,2,0.051094891,0,empty,CD-0722-4
"A2,E5",8560,9397,6575,2822,4831,2302,12,2315,1513,802,1.886533666,1257,1781,453,133,130,3,38,1,0.038461538,0,empty,CD-0722-4
"A2,E6",14390,15796,10581,5215,8163,4106,0,4111,2673,1438,1.858831711,2365,3903,869,380,373,7,92,2,0.123324397,0,empty,CD-0722-4
"A2,E7",15888,17262,11983,5279,8767,4087,0,4091,2714,1377,1.970951344,2201,6284,1055,438,429,9,116,2,0.079254079,0,empty,CD-0722-4
"A2,E8",10843,11853,8212,3641,6174,2936,0,2940,1980,960,2.0625,1645,2625,390,181,180,1,50,1,0.061111111,0,empty,CD-0722-4
"A2,E9",6405,6798,4919,1879,3519,1679,0,1679,1129,550,2.052727273,904,3207,919,308,307,1,64,1,0.133550489,0,empty,CD-0722-4
"A2,E10",7859,8612,5895,2717,4491,2178,6,2184,1432,752,1.904255319,1218,2157,576,191,190,1,43,1,0.078947368,0,empty,CD-0722-4
"A2,E11",9333,10128,7070,3058,5453,2659,0,2664,1710,954,1.79245283,1485,3057,823,273,273,0,68,0,0.080586081,0,empty,CD-0722-4
"A2,E12",10050,11208,7279,3929,5851,2975,0,2984,1904,1080,1.762962963,1733,3072,728,286,284,2,67,1,0.165492958,0,empty,CD-0722-4
"A2,F1",11991,12791,8909,3882,6597,3142,0,3143,1951,1192,1.636744966,1662,2617,775,307,306,1,69,1,0.071895425,0,empty,CD-0722-4
"A2,F2",9240,9961,6880,3081,5170,2444,0,2451,1597,854,1.870023419,1307,2939,677,253,253,0,71,0,0.118577075,0,empty,CD-0722-4
"A2,F3",9172,9802,6812,2990,5163,2487,3,2492,1616,876,1.844748858,1374,3648,775,367,360,7,67,2,0.025,0,empty,CD-0722-4
"A2,F4",13552,14500,10298,4202,7566,3502,0,3511,2318,1193,1.943000838,1908,764,189,67,67,0,20,0,0,0,empty,CD-0722-4
"A2,F5",11024,11834,8313,3521,6048,2810,1,2815,1811,1004,1.803784861,1548,2934,743,292,291,1,73,1,0.027491409,0,empty,CD-0722-4
"A2,F6",10372,11500,7551,3949,6031,3129,1,3130,2053,1077,1.906220984,1762,3758,766,350,346,4,102,2,0.043352601,0,empty,CD-0722-4
"A2,F7",12148,13461,8906,4555,7024,3545,20,3567,2324,1243,1.869670153,1999,1507,443,161,161,0,33,0,0,0,empty,CD-0722-4
"A2,F8",9061,10155,6802,3353,5243,2533,27,2560,1672,888,1.882882883,1413,347,70,34,33,1,15,1,0.060606061,0,empty,CD-0722-4
"A2,F9",9418,9967,7193,2774,5344,2485,0,2487,1640,847,1.936245573,1326,4125,746,278,274,4,68,1,0.058394161,0,empty,CD-0722-4
"A2,F10",12908,13704,9873,3831,6927,3198,0,3204,2106,1098,1.918032787,1657,2584,632,244,242,2,44,1,0.078512397,0,empty,CD-0722-4
"A2,F11",9229,9862,7047,2815,5219,2436,0,2436,1586,850,1.865882353,1343,2218,584,185,185,0,46,0,0,0,empty,CD-0722-4
"A2,F12",10280,11109,7692,3417,5804,2776,17,2798,1841,957,1.923719958,1498,236,51,26,25,1,8,1,0,0,empty,CD-0722-4
"A2,G1",15555,16684,12020,4664,8488,3915,1,3921,2619,1302,2.011520737,2035,6118,1264,434,428,6,105,3,0.081775701,0,empty,CD-0722-4
"A2,G2",6440,7223,4612,2611,3772,2001,0,2011,1204,807,1.491945477,1183,484,151,57,57,0,13,0,0,0,empty,CD-0722-4
"A2,G3",13211,14193,9644,4549,7288,3634,0,3640,2256,1384,1.630057803,2007,2872,729,293,292,1,61,1,0.078767123,0,empty,CD-0722-4
"A2,G4",22262,25201,15855,9346,12850,7128,0,7143,4303,2840,1.515140845,4242,131,11,8,8,0,7,0,0,0,empty,CD-0722-4
"A2,G5",7908,8657,5902,2755,4465,2128,29,2161,1418,743,1.908479139,1190,1624,312,169,169,0,43,0,0.076923077,0,empty,CD-0722-4
"A2,G6",11400,12342,8673,3669,6277,2981,0,2982,1984,998,1.987975952,1583,212,45,17,17,0,7,0,0.058823529,0,empty,CD-0722-4
"A2,G7",9120,9875,6845,3030,5192,2436,0,2437,1686,751,2.245006658,1374,3417,839,346,344,2,83,1,0.031976744,0,empty,CD-0722-4
"A2,G8",6548,7184,4906,2278,3836,1858,0,1863,1202,661,1.818456884,1036,2067,540,227,224,3,64,2,0.035714286,0,empty,CD-0722-4
"A2,G9",929583,1112597,676346,436251,545051,310724,12,310999,246698,64301,3.836612183,189493,248184,47186,18246,17995,251,2397,9,0.076910253,0,hg38,CD-0722-4
"A2,G10",9476,10607,7048,3559,5426,2756,0,2757,1803,954,1.889937107,1529,3209,745,318,318,0,77,0,0.059748428,0,empty,CD-0722-4
"A2,G11",972795,1073320,753587,319733,519733,248519,6,248783,189701,59082,3.210808707,138225,57446,4576,1714,1649,65,390,6,0.026682838,0,hg38,CD-0722-4
"A2,G12",8110,9165,6012,3153,4759,2427,0,2429,1574,855,1.840935673,1410,2863,1070,397,395,2,66,1,0.060759494,0,empty,CD-0722-4
"A2,H1",8045,8745,6019,2726,4599,2155,10,2167,1417,750,1.889333333,1182,1982,522,169,162,7,38,2,0.037037037,0,empty,CD-0722-4
"A2,H2",9343,10452,6942,3510,5318,2647,13,2663,1774,889,1.995500562,1510,2662,769,303,300,3,70,2,0.12,0,empty,CD-0722-4
"A2,H3",7552,8242,5402,2840,4161,2061,8,2073,1317,756,1.742063492,1206,1868,407,140,140,0,40,0,0.121428571,0,empty,CD-0722-4
"A2,H4",13279,14562,10090,4472,7482,3709,10,3727,2550,1177,2.166525064,2043,143,16,7,6,1,6,1,0.166666667,0,empty,CD-0722-4
"A2,H5",12236,13275,9091,4184,6864,3370,0,3370,2130,1240,1.717741935,1894,3538,648,272,271,1,68,1,0.025830258,0,empty,CD-0722-4
"A2,H6",7435,8151,5390,2761,4181,2135,6,2143,1399,744,1.880376344,1223,2411,528,220,218,2,60,1,0.009174312,0,empty,CD-0722-4
"A2,H7",8443,8908,6216,2692,4690,2216,0,2220,1437,783,1.835249042,1218,2139,434,192,189,3,49,2,0.105820106,0,empty,CD-0722-4
"A2,H8",9888,10886,7238,3648,5464,2737,0,2737,1719,1018,1.688605108,1495,2411,583,265,256,9,65,2,0.09375,0,empty,CD-0722-4
"A2,H9",7626,8223,5703,2520,4236,1973,0,1976,1316,660,1.993939394,1084,1546,421,168,168,0,33,0,0.107142857,0,empty,CD-0722-4
"A2,H10",6657,7184,4926,2258,3695,1725,0,1727,1105,622,1.776527331,960,1313,199,90,90,0,28,0,0.188888889,0,empty,CD-0722-4
"A2,H11",9043,10355,6272,4083,5338,3182,23,3211,1763,1448,1.217541436,1923,89,61,16,16,0,2,0,0.9375,0,empty,CD-0722-4
"A2,H12",7095,7891,5095,2796,4061,2082,0,2087,1400,687,2.037845706,1204,1340,339,164,163,1,31,1,0.190184049,0,empty,CD-0722-4
"A3,A1",9251,10288,6757,3531,5344,2761,3,2767,1760,1007,1.747765641,1576,1776,241,118,117,1,29,1,0.068376068,0,empty,CD-0722-4
"A3,A2",17630,19451,13288,6163,9837,4875,4,4884,3074,1810,1.698342541,2745,2869,678,249,247,2,65,2,0.271255061,0,empty,CD-0722-4
"A3,A3",8098,8683,6025,2658,4539,2209,19,2234,1443,791,1.824273072,1225,1249,269,113,113,0,45,0,0,0,empty,CD-0722-4
"A3,A4",13633,15030,10236,4794,7641,3787,2,3791,2372,1419,1.671599718,2088,898,276,100,98,2,32,2,0.091836735,0,empty,CD-0722-4
"A3,A5",12528,13456,9438,4018,6930,3337,0,3337,2099,1238,1.695476575,1828,2409,492,218,214,4,52,1,0.186915888,0,empty,CD-0722-4
"A3,A6",10168,11774,7434,4340,6097,3180,3,3183,2025,1158,1.748704663,1883,3487,805,351,349,2,96,1,0.025787966,0,empty,CD-0722-4
"A3,A7",1138920,1344131,837048,507083,653124,367818,2,368155,319006,49149,6.490589839,219840,152746,27964,11189,11031,158,1641,3,0.050222101,0,hg38,CD-0722-4
"A3,A8",5655,6147,4245,1902,3176,1521,0,1528,1007,521,1.932821497,837,2555,435,182,180,2,60,1,0.044444444,0,empty,CD-0722-4
"A3,A9",9607,10684,7375,3309,5558,2677,0,2683,1788,895,1.997765363,1473,1935,472,152,151,1,45,1,0.158940397,0,empty,CD-0722-4
"A3,A10",12117,13116,9314,3802,6724,3223,0,3223,1922,1301,1.477325135,1770,363,30,16,15,1,9,1,0,0,empty,CD-0722-4
"A3,A11",8366,9066,6404,2662,4707,2194,5,2201,1443,758,1.903693931,1177,1722,360,148,143,5,38,1,0.146853147,0,empty,CD-0722-4
"A3,A12",12675,13584,9510,4074,6889,3317,0,3325,2153,1172,1.837030717,1833,4142,1049,456,452,4,104,2,0.079646018,0,empty,CD-0722-4
"A3,B1",9652,11006,6952,4054,5534,2894,0,2896,1768,1128,1.567375887,1722,1586,321,127,125,2,29,1,0.04,0,empty,CD-0722-4
"A3,B2",10430,11424,7227,4197,5899,3242,11,3265,1988,1277,1.556773688,1919,502,85,49,47,2,9,1,0,0,empty,CD-0722-4
"A3,B3",8363,9332,6145,3187,4746,2415,2,2419,1511,908,1.664096916,1372,1529,259,102,101,1,41,1,0.089108911,0,empty,CD-0722-4
"A3,B4",9648,11123,6930,4193,5914,3245,2,3248,2022,1226,1.649265905,1968,1473,298,113,110,3,31,1,0.009090909,0,empty,CD-0722-4
"A3,B5",951346,501133,351394,149739,320052,137620,12,138895,100970,37925,2.662359921,83376,1845,460,123,122,1,37,1,0.008196721,0,hg38,CD-0722-4
"A3,B6",11643,13005,8455,4550,6626,3486,1,3493,2115,1378,1.534833091,2023,2510,495,167,167,0,49,0,0.137724551,0,empty,CD-0722-4
"A3,B7",9854,10710,7462,3248,5496,2664,0,2668,1723,945,1.823280423,1456,1625,310,126,121,5,40,2,0.041322314,0,empty,CD-0722-4
"A3,B8",7410,8263,5674,2589,4352,2091,0,2095,1371,724,1.893646409,1178,1257,257,120,118,2,29,2,0.084745763,0,empty,CD-0722-4
"A3,B9",27757,30615,21064,9551,15214,7372,0,7377,5079,2298,2.210182768,4152,1666,359,119,118,1,37,1,0.093220339,0,empty,CD-0722-4
"A3,B10",547752,634402,359682,274720,333075,217178,10,217559,155648,61911,2.514060506,132730,1062,202,61,61,0,28,0,0.016393443,0,empty,CD-0722-4
"A3,B11",15853,17764,11305,6459,9127,5033,18,5067,2810,2257,1.245015507,2991,274,21,5,5,0,4,0,0,0,empty,CD-0722-4
"A3,B12",8881,9837,6504,3333,5128,2610,2,2612,1712,900,1.902222222,1562,1701,247,118,117,1,44,1,0.068376068,0,empty,CD-0722-4
"A3,C1",961886,1155314,669626,485688,571879,368179,2,368445,239879,128566,1.865804334,224560,1867,491,139,138,1,47,1,0.065217391,0,hg38,CD-0722-4
"A3,C2",13547,14617,10046,4571,7478,3738,1,3741,2318,1423,1.628952916,2056,2066,727,286,277,9,66,2,0.072202166,0,empty,CD-0722-4
"A3,C3",13739,15272,10338,4934,7915,3915,0,3922,2483,1439,1.725503822,2207,853,136,52,51,1,21,1,0.058823529,0,empty,CD-0722-4
"A3,C4",9356,10002,7039,2963,5240,2433,0,2433,1568,865,1.812716763,1297,2011,478,205,204,1,60,1,0.12254902,0,empty,CD-0722-4
"A3,C5",13604,15215,10215,5000,7872,3959,5,3968,2628,1340,1.96119403,2283,1697,404,186,184,2,50,2,0.054347826,0,empty,CD-0722-4
"A3,C6",11144,12147,8133,4014,6383,3247,0,3248,2114,1134,1.864197531,1803,1752,478,196,195,1,54,1,0.061538462,0,empty,CD-0722-4
"A3,C7",1619559,2033126,1159494,873632,980861,619449,2,619937,481666,138271,3.483492562,387678,3826,1386,560,558,2,132,2,0.096774194,0,hg38,CD-0722-4
"A3,C8",16637,18159,12431,5728,9269,4602,0,4605,2991,1614,1.853159851,2556,3390,976,344,338,6,87,3,0.079881657,0,empty,CD-0722-4
"A3,C9",12050,13311,9069,4242,6910,3341,0,3351,2228,1123,1.983971505,1889,1631,354,155,155,0,40,0,0.167741935,0,empty,CD-0722-4
"A3,C10",834776,883214,661893,221321,429299,180174,1,180388,140788,39600,3.555252525,95622,55399,12470,4888,4809,79,730,4,0.030359742,0,hg38,CD-0722-4
"A3,C11",1172066,1383419,855032,528387,671738,381197,0,381537,299310,82227,3.640045241,230168,153704,20407,8251,8110,141,1263,6,0.111837238,0,hg38,CD-0722-4
"A3,C12",16356,18090,12198,5892,9221,4540,3,4551,2994,1557,1.922928709,2577,2254,607,232,228,4,48,2,0.114035088,0,empty,CD-0722-4
"A3,D1",14541,16445,10504,5941,8374,4484,3,4496,2654,1842,1.44082519,2592,716,151,50,50,0,14,0,0.02,0,empty,CD-0722-4
"A3,D2",11280,12271,8614,3657,6342,2968,0,2969,1904,1065,1.787793427,1620,3051,980,374,374,0,101,0,0.037433155,0,empty,CD-0722-4
"A3,D3",1120891,1249780,850599,399181,608818,312066,1,312366,245588,66778,3.677678277,177571,37682,8331,3096,3068,28,566,3,0.016949153,0,hg38,CD-0722-4
"A3,D4",8131,9300,6008,3292,4822,2442,16,2462,1612,850,1.896470588,1457,1422,269,104,103,1,33,1,0.019417476,0,empty,CD-0722-4
"A3,D5",9207,10229,6909,3320,5239,2608,0,2612,1663,949,1.752370917,1473,1767,403,161,157,4,44,1,0.095541401,0,empty,CD-0722-4
"A3,D6",14286,15520,10232,5288,7970,4281,1,4291,2554,1737,1.47035118,2395,1792,479,180,180,0,58,0,0.027777778,0,empty,CD-0722-4
"A3,D7",7959,8570,6011,2559,4495,2135,0,2135,1403,732,1.916666667,1182,1946,439,179,179,0,45,0,0.027932961,0,empty,CD-0722-4
"A3,D8",9831,10620,7395,3225,5561,2742,0,2743,1736,1007,1.723932473,1544,1490,456,214,214,0,49,0,0.060747664,0,empty,CD-0722-4
"A3,D9",5504,6285,4040,2245,3238,1576,0,1576,1014,562,1.804270463,926,1927,420,175,173,2,44,2,0.086705202,0,empty,CD-0722-4
"A3,D10",12060,13877,8724,5153,7087,3822,1,3823,2219,1604,1.383416459,2315,1255,367,122,122,0,29,0,0.081967213,0,empty,CD-0722-4
"A3,D11",10873,11925,8090,3835,6145,3019,0,3026,1963,1063,1.846660395,1710,3002,868,308,308,0,70,0,0.103896104,0,empty,CD-0722-4
"A3,D12",4323220,5014851,3222145,1792706,2283819,1310884,12,1312099,1046496,265603,3.940075978,773392,565980,97682,38280,37664,616,3866,14,0.065526763,0,hg38,CD-0722-4
"A3,E1",1072712,1158378,833189,325189,558528,263063,4,263369,197858,65511,3.020225611,144803,50044,8802,3393,3346,47,616,5,0.019426181,0,hg38,CD-0722-4
"A3,E2",11543,12846,8442,4404,6622,3394,0,3399,2118,1281,1.653395785,1958,1825,491,204,203,1,52,1,0.172413793,0,empty,CD-0722-4
"A3,E3",7652,8437,5801,2636,4443,2085,0,2089,1310,779,1.681643132,1145,3167,881,310,308,2,71,1,0.165584416,0,empty,CD-0722-4
"A3,E4",10950,12385,8149,4236,6322,3144,1,3156,1996,1160,1.720689655,1790,3106,934,399,396,3,87,2,0.101010101,0,empty,CD-0722-4
"A3,E5",9670,10672,7236,3436,5460,2583,15,2603,1676,927,1.80798274,1457,1421,296,146,142,4,42,1,0.056338028,0,empty,CD-0722-4
"A3,E6",17701,19828,12936,6892,10055,5159,17,5194,3345,1849,1.809085992,2982,3850,890,344,338,6,80,2,0.082840237,0,empty,CD-0722-4
"A3,E7",17058,18532,12856,5676,9521,4493,13,4509,2907,1602,1.814606742,2511,3366,980,387,387,0,105,0,0.059431525,0,empty,CD-0722-4
"A3,E8",12829,13737,9814,3923,7153,3312,2,3328,2113,1215,1.73909465,1817,3202,748,262,260,2,81,2,0.05,0,empty,CD-0722-4
"A3,E9",8182,8968,6097,2871,4774,2381,0,2381,1471,910,1.616483516,1371,2734,757,269,269,0,60,0,0.014869888,0,empty,CD-0722-4
"A3,E10",9113,9785,6838,2947,5167,2389,11,2405,1572,833,1.887154862,1333,2527,518,171,165,6,44,2,0.060606061,0,empty,CD-0722-4
"A3,E11",11986,12802,8692,4110,6696,3373,4,3380,2201,1179,1.866836302,1876,2349,624,248,248,0,46,0,0.25,0,empty,CD-0722-4
"A3,E12",1161665,1349429,862896,486533,657781,357173,11,357514,288293,69221,4.164819925,213914,129391,15848,6162,6014,148,1043,4,0.067675424,0,hg38,CD-0722-4
"A3,F1",14273,15333,10638,4695,7931,3883,13,3900,2394,1506,1.589641434,2117,2367,383,166,165,1,47,1,0.078787879,0,empty,CD-0722-4
"A3,F2",11456,12284,8518,3766,6328,3007,28,3041,1882,1159,1.623813632,1709,3108,629,277,272,5,80,2,0.150735294,0,empty,CD-0722-4
"A3,F3",15972,17289,11970,5319,8778,4226,3,4231,2942,1289,2.282389449,2306,4177,911,364,359,5,80,2,0.105849582,0,empty,CD-0722-4
"A3,F4",16382,17248,12114,5134,8974,4232,23,4265,2726,1539,1.771280052,2356,821,164,61,61,0,20,0,0.295081967,0,empty,CD-0722-4
"A3,F5",12629,13591,9480,4111,7065,3323,4,3337,2108,1229,1.715215622,1845,2514,441,191,183,8,59,2,0.081967213,0,empty,CD-0722-4
"A3,F6",14349,15996,10360,5636,8224,4304,0,4307,2748,1559,1.762668377,2513,3338,566,223,219,4,76,2,0.03196347,0,empty,CD-0722-4
"A3,F7",970461,1030758,771832,258926,506394,213492,1,213756,171676,42080,4.079752852,114166,25698,6465,2307,2273,34,438,3,0.01891773,0,hg38,CD-0722-4
"A3,F8",10945,12280,8174,4106,6309,3118,1,3122,2053,1069,1.920486436,1819,230,46,24,23,1,8,1,0,0,empty,CD-0722-4
"A3,F9",12000,12796,9052,3744,6678,3162,0,3166,2159,1007,2.143992056,1744,3121,991,353,352,1,82,1,0.051136364,0,empty,CD-0722-4
"A3,F10",14522,15971,10957,5014,8182,3990,7,4001,2608,1393,1.872218234,2263,2120,588,267,261,6,69,2,0.007662835,0,empty,CD-0722-4
"A3,F11",11601,12751,8824,3927,6423,3031,0,3031,2032,999,2.034034034,1640,1826,219,98,96,2,30,2,0.041666667,0,empty,CD-0722-4
"A3,F12",12585,13897,9178,4719,7286,3637,0,3641,2390,1251,1.910471623,2119,326,93,38,38,0,9,0,0,0,empty,CD-0722-4
"A3,G1",13285,14499,9971,4528,7559,3580,0,3580,2406,1174,2.049403748,1983,3023,810,336,336,0,76,0,0.18452381,0,empty,CD-0722-4
"A3,G2",7783,8267,5585,2682,4279,2187,0,2188,1350,838,1.61097852,1234,522,167,70,70,0,16,0,0.2,0,empty,CD-0722-4
"A3,G3",21294,23502,15561,7941,11818,6255,0,6265,3926,2339,1.678495083,3445,2908,747,266,265,1,72,1,0.041509434,0,empty,CD-0722-4
"A3,G4",27069,30518,19432,11086,15523,8506,22,8538,5015,3523,1.423502697,4981,138,10,7,7,0,6,0,0.428571429,0,empty,CD-0722-4
"A3,G5",8964,10088,6596,3492,5266,2669,0,2670,1781,889,2.003374578,1589,1881,469,197,192,5,48,1,0.151041667,0,empty,CD-0722-4
"A3,G6",1074520,1160869,852303,308566,557073,242675,3,242943,185244,57699,3.210523579,130908,18335,2133,852,821,31,173,3,0.063337393,0,hg38,CD-0722-4
"A3,G7",10920,11678,8297,3381,6169,2931,0,2936,1952,984,1.983739837,1597,2842,839,342,340,2,82,2,0.055882353,0,empty,CD-0722-4
"A3,G8",7831,8623,5702,2921,4643,2283,0,2285,1474,811,1.817509248,1368,2031,502,199,196,3,59,2,0.056122449,0,empty,CD-0722-4
"A3,G9",988360,1230273,694570,535703,604499,375868,4,376184,294028,82156,3.578898681,236238,29897,13368,4932,4917,15,986,2,0.030913158,0,hg38,CD-0722-4
"A3,G10",12228,13895,9078,4817,7146,3706,1,3709,2345,1364,1.719208211,2164,3656,1285,473,465,8,86,2,0.055913978,0,empty,CD-0722-4
"A3,G11",11098,12073,8312,3761,6301,2986,0,2987,1978,1009,1.960356789,1642,1429,286,121,118,3,38,1,0.06779661,0,empty,CD-0722-4
"A3,G12",9146,10187,6687,3500,5395,2764,1,2768,1715,1053,1.628679962,1609,2667,832,322,320,2,75,2,0.05,0,empty,CD-0722-4
"A3,H1",10791,11965,7965,4000,6154,3089,0,3089,1985,1104,1.798007246,1775,1736,319,117,114,3,40,1,0.070175439,0,empty,CD-0722-4
"A3,H2",1727020,2044419,1275344,769075,977339,550283,1,550774,437153,113621,3.847466577,331055,203717,35041,13269,13010,259,1841,10,0.045196003,0,hg38,CD-0722-4
"A3,H3",9603,10770,6992,3778,5603,2861,0,2863,1854,1009,1.837462834,1672,1694,283,146,145,1,43,1,0.089655172,0,empty,CD-0722-4
"A3,H4",13689,15178,10233,4945,7713,3788,30,3822,2516,1306,1.926493109,2148,166,24,15,13,2,6,1,0,0,empty,CD-0722-4
"A3,H5",1331424,1552387,994522,557865,743750,399886,35,400253,299142,101111,2.958550504,239569,118747,22084,8758,8609,149,1368,4,0.065977465,0,hg38,CD-0722-4
"A3,H6",9767,10872,7029,3843,5589,2844,0,2849,1869,980,1.907142857,1662,2237,601,265,262,3,65,1,0.072519084,0,empty,CD-0722-4
"A3,H7",10655,11397,7925,3472,6019,2950,0,2952,1880,1072,1.753731343,1605,2302,612,231,229,2,51,2,0.113537118,0,empty,CD-0722-4
"A3,H8",12616,14109,9190,4919,7146,3678,8,3688,2298,1390,1.65323741,2086,2586,485,236,227,9,71,2,0.13215859,0,empty,CD-0722-4
"A3,H9",10807,11885,8200,3685,6060,2956,0,2961,2004,957,2.094043887,1679,1249,379,165,161,4,36,2,0.049689441,0,empty,CD-0722-4
"A3,H10",8020,8629,5945,2684,4426,2170,0,2172,1432,740,1.935135135,1185,1312,288,123,122,1,28,1,0.254098361,0,empty,CD-0722-4
"A3,H11",11745,13176,8244,4932,6881,4128,0,4130,2193,1937,1.132163139,2405,34,3,3,2,1,2,1,0,0,empty,CD-0722-4
"A3,H12",9556,10523,6832,3691,5382,2788,17,2810,1785,1025,1.741463415,1593,1483,257,110,110,0,42,0,0.018181818,0,empty,CD-0722-4
"A4,A1",1093179,1316342,782984,533358,646203,403401,2,403723,288701,115022,2.509963311,243514,63310,17471,6397,6332,65,987,4,0.027163613,0,hg38,CD-0722-4
"A4,A2",9761,10715,7185,3530,5537,2794,0,2794,1723,1071,1.608776844,1581,2568,615,202,201,1,59,1,0.059701493,0,empty,CD-0722-4
"A4,A3",12406,13465,9217,4248,6847,3278,3,3282,2421,861,2.81184669,1868,2629,756,305,305,0,94,0,0.036065574,0,empty,CD-0722-4
"A4,A4",12234,13346,9175,4171,6769,3351,0,3354,2150,1204,1.785714286,1802,1140,197,102,101,1,32,1,0.00990099,0,empty,CD-0722-4
"A4,A5",9420,10289,6902,3387,5319,2555,0,2558,1668,890,1.874157303,1500,3580,764,317,315,2,84,1,0.015873016,0,empty,CD-0722-4
"A4,A6",709858,814454,532976,281478,395621,206921,10,207121,161513,45608,3.541330468,120997,216361,19149,7546,7293,253,1241,7,0.054161525,0,hg38,CD-0722-4
"A4,A7",6824,7667,4976,2691,3952,2028,0,2033,1319,714,1.847338936,1184,1866,345,148,144,4,38,2,0.006944444,0,empty,CD-0722-4
"A4,A8",2169353,2477790,1641232,836558,1180061,618735,9,619273,531969,87304,6.093294694,358780,163831,22236,8292,8120,172,1502,4,0.019704433,0,hg38,CD-0722-4
"A4,A9",7603,8367,5687,2680,4349,2184,0,2184,1360,824,1.650485437,1205,2694,671,280,279,1,72,1,0.053763441,0,empty,CD-0722-4
"A4,A10",110528,153491,68060,85431,82394,63697,3,63740,46835,16905,2.770482106,42916,663,200,63,62,1,21,1,0.258064516,0,empty,CD-0722-4
"A4,A11",12769,14437,9326,5111,7154,3765,0,3773,2465,1308,1.884556575,2162,2252,550,220,213,7,51,2,0.051643192,0,empty,CD-0722-4
"A4,A12",8079,8861,6064,2797,4546,2141,1,2146,1373,773,1.776196636,1224,4245,1087,437,435,2,115,2,0.07816092,0,empty,CD-0722-4
"A4,B1",7759,8650,5810,2840,4520,2238,22,2262,1397,865,1.615028902,1319,1361,360,144,144,0,38,0,0.236111111,0,empty,CD-0722-4
"A4,B2",9607,10512,6602,3910,5347,2894,0,2899,1805,1094,1.649908592,1702,1037,216,69,63,6,16,2,0.333333333,0,empty,CD-0722-4
"A4,B3",1058271,1233778,788380,445398,597713,324256,2,324580,256328,68252,3.755611557,192662,171888,25973,10157,9951,206,1516,6,0.050949653,0,hg38,CD-0722-4
"A4,B4",6334,7089,4635,2454,3752,1966,0,1967,1214,753,1.612217795,1160,1573,335,100,97,3,35,2,0,0,empty,CD-0722-4
"A4,B5",7585,4675,2927,1748,3026,1656,0,1676,1084,592,1.831081081,1033,1377,334,93,92,1,25,1,0.119565217,0,empty,CD-0722-4
"A4,B6",8285,9135,5981,3154,4775,2454,0,2455,1530,925,1.654054054,1439,2317,592,257,252,5,64,1,0.031746032,0,empty,CD-0722-4
"A4,B7",1068909,1175423,833240,342183,565868,267699,1,267979,205751,62228,3.306405477,148164,129639,13259,4960,4816,144,914,6,0.055440199,0,hg38,CD-0722-4
"A4,B8",5713,6250,4366,1884,3209,1472,1,1473,1009,464,2.174568966,770,2071,382,179,172,7,50,2,0.023255814,0,empty,CD-0722-4
"A4,B9",10686,11608,7820,3788,5942,2982,0,2984,1924,1060,1.81509434,1661,1880,524,175,173,2,47,2,0.057803468,0,empty,CD-0722-4
"A4,B10",5334,5817,3897,1920,3105,1532,0,1534,976,558,1.749103943,874,706,125,73,69,4,27,1,0.144927536,0,empty,CD-0722-4
"A4,B11",11082,12263,7935,4328,6419,3505,1,3515,1941,1574,1.233163914,2064,294,31,20,20,0,12,0,0.05,0,empty,CD-0722-4
"A4,B12",6431,6856,4718,2138,3690,1807,0,1811,1237,574,2.155052265,1037,2551,611,272,266,6,73,2,0.063909774,0,empty,CD-0722-4
"A4,C1",14573,15355,11129,4226,7908,3681,0,3689,2290,1399,1.636883488,1971,1783,404,158,157,1,48,1,0.127388535,0,empty,CD-0722-4
"A4,C2",11399,12248,8382,3866,6207,3119,1,3124,2030,1094,1.855575868,1758,2364,618,240,238,2,69,1,0.050420168,0,empty,CD-0722-4
"A4,C3",13312,15148,9831,5317,7679,3891,0,3898,2688,1210,2.221487603,2267,1396,445,170,166,4,39,1,0.012048193,0,empty,CD-0722-4
"A4,C4",6960,7298,5257,2041,3770,1722,5,1728,1147,581,1.974182444,905,2619,644,256,255,1,73,1,0.145098039,0,empty,CD-0722-4
"A4,C5",13726,15484,10149,5335,8085,4108,0,4116,2851,1265,2.253754941,2379,2225,491,207,202,5,59,1,0.004950495,0,empty,CD-0722-4
"A4,C6",8461,9151,6256,2895,4827,2403,0,2405,1511,894,1.6901566,1325,1772,407,158,157,1,56,1,0.006369427,0,empty,CD-0722-4
"A4,C7",11942,13606,8656,4950,6932,3795,1,3798,2286,1512,1.511904762,2220,662,140,57,55,2,15,1,0.127272727,0,empty,CD-0722-4
"A4,C8",12724,13797,9510,4287,7029,3458,0,3464,2270,1194,1.901172529,1873,3656,868,362,356,6,98,2,0.087078652,0,empty,CD-0722-4
"A4,C9",10641,11928,7941,3987,6118,3079,0,3083,2013,1070,1.881308411,1779,2574,569,220,214,6,64,2,0.028037383,0,empty,CD-0722-4
"A4,C10",11070,12040,8343,3697,6049,2883,6,2891,1854,1037,1.787849566,1644,3097,842,361,359,2,86,2,0.119777159,0,empty,CD-0722-4
"A4,C11",9345,10379,6842,3537,5224,2627,0,2629,1652,977,1.690890481,1534,2652,583,263,262,1,65,1,0.091603053,0,empty,CD-0722-4
"A4,C12",12429,13512,9257,4255,6956,3303,0,3314,2162,1152,1.876736111,1848,3113,768,306,300,6,83,2,0.023333333,0,empty,CD-0722-4
"A4,D1",11272,12379,8326,4053,6400,3356,0,3362,2084,1278,1.630672926,1839,1221,195,74,73,1,21,1,0,0,empty,CD-0722-4
"A4,D2",9873,10684,7462,3222,5590,2630,0,2630,1711,919,1.861806311,1449,3828,1001,405,402,3,110,2,0.037313433,0,empty,CD-0722-4
"A4,D3",8320,8971,6157,2814,4638,2292,10,2308,1504,804,1.870646766,1300,1811,375,155,154,1,42,1,0.025974026,0,empty,CD-0722-4
"A4,D4",7407,8099,5589,2510,4239,2098,0,2098,1450,648,2.237654321,1183,1597,293,135,134,1,53,1,0.171641791,0,empty,CD-0722-4
"A4,D5",7128,7726,5280,2446,3945,1876,0,1880,1208,672,1.797619048,1067,2184,463,206,203,3,59,2,0.049261084,0,empty,CD-0722-4
"A4,D6",1894913,2183153,1394979,788174,1033880,574789,25,575404,452485,122919,3.681164019,340720,314623,59789,22790,22469,321,2717,8,0.046998086,0,hg38,CD-0722-4
"A4,D7",6376,6816,4733,2083,3564,1644,7,1656,1084,572,1.895104895,949,2476,677,255,254,1,64,1,0.023622047,0,empty,CD-0722-4
"A4,D8",9157,9881,6863,3018,5051,2402,3,2410,1568,842,1.862232779,1360,2383,565,217,217,0,59,0,0.050691244,0,empty,CD-0722-4
"A4,D9",3787,3946,2848,1098,2107,983,0,985,648,337,1.922848665,538,1750,167,84,83,1,32,1,0.156626506,0,empty,CD-0722-4
"A4,D10",9742,11015,7285,3730,5680,2895,0,2901,1915,986,1.942190669,1666,1157,184,94,92,2,27,2,0.195652174,0,empty,CD-0722-4
"A4,D11",8187,9025,6120,2905,4669,2299,0,2299,1524,775,1.966451613,1282,3217,839,333,332,1,86,1,0.072289157,0,empty,CD-0722-4
"A4,D12",11032,12004,8208,3796,6178,3016,17,3033,1952,1081,1.80573543,1696,4952,1528,576,573,3,133,2,0.132635253,0,empty,CD-0722-4
"A4,E1",12816,13655,9456,4199,7044,3521,0,3523,2242,1281,1.75019516,1896,3351,813,371,369,2,104,2,0.124661247,0,empty,CD-0722-4
"A4,E2",14286,15340,10974,4366,7628,3495,0,3504,2166,1338,1.618834081,1920,3283,873,337,335,2,65,2,0.217910448,0,empty,CD-0722-4
"A4,E3",8873,9552,6373,3179,4988,2558,14,2575,1789,786,2.276081425,1456,3589,878,344,343,1,106,1,0.113702624,0,empty,CD-0722-4
"A4,E4",1168183,1421480,833325,588155,685651,427349,3,427644,292905,134739,2.173869481,260779,67395,24909,9095,9030,65,1305,4,0.027353267,0,hg38,CD-0722-4
"A4,E5",11315,12675,8519,4156,6418,3219,0,3221,2042,1179,1.731976251,1798,1964,626,242,238,4,62,2,0.037815126,0,empty,CD-0722-4
"A4,E6",15614,17397,11592,5805,8736,4468,6,4475,2790,1685,1.65578635,2598,5798,1528,620,615,5,141,2,0.12195122,0,empty,CD-0722-4
"A4,E7",12316,13349,9358,3991,6907,3256,0,3262,2177,1085,2.006451613,1774,3850,887,383,377,6,107,3,0.127320955,0,empty,CD-0722-4
"A4,E8",2854659,3216077,2204837,1011240,1479287,780301,10,781168,618129,163039,3.791295334,437248,514434,63527,24068,23459,609,3032,12,0.043394859,0,hg38,CD-0722-4
"A4,E9",6373,6967,4790,2177,3523,1719,23,1742,1160,582,1.993127148,972,3421,767,341,340,1,99,1,0.055882353,0,empty,CD-0722-4
"A4,E10",8356,9075,6252,2823,4627,2183,0,2183,1404,779,1.802310655,1223,2100,504,191,189,2,56,2,0.021164021,0,empty,CD-0722-4
"A4,E11",305350,365893,204464,161429,187749,127177,0,127264,87596,39668,2.208228295,76939,10402,3999,1366,1364,2,307,2,0.015395894,0,hg38,CD-0722-4
"A4,E12",8917,10077,6553,3524,5193,2599,1,2604,1615,989,1.632962588,1528,2407,549,212,209,3,61,2,0.181818182,0,empty,CD-0722-4
"A4,F1",908312,1015804,678796,337008,490807,253188,5,253458,197075,56383,3.495291134,145579,79427,7336,2774,2691,83,617,7,0.023411371,0,hg38,CD-0722-4
"A4,F2",953997,1108667,693680,414987,540028,303062,2,303320,241140,62180,3.878095851,181695,242694,38315,14962,14648,314,2114,8,0.037684326,0,hg38,CD-0722-4
"A4,F3",8581,9209,6400,2809,4896,2295,0,2301,1512,789,1.91634981,1295,4220,1019,400,398,2,115,2,0.050251256,0,empty,CD-0722-4
"A4,F4",13487,14523,10164,4359,7551,3514,1,3518,2357,1161,2.030146425,1986,1498,266,116,116,0,40,0,0.155172414,0,empty,CD-0722-4
"A4,F5",10846,11848,8084,3764,6169,2840,19,2861,1810,1051,1.722169363,1643,3557,923,355,349,6,88,2,0.114613181,0,empty,CD-0722-4
"A4,F6",9960,10944,7225,3719,5598,2869,0,2869,1837,1032,1.78003876,1617,4567,901,409,408,1,121,1,0.066176471,0,empty,CD-0722-4
"A4,F7",11529,12428,8536,3892,6523,3190,12,3204,2100,1104,1.902173913,1764,1491,440,194,191,3,48,2,0.036649215,0,empty,CD-0722-4
"A4,F8",8523,9183,6356,2827,4731,2282,0,2282,1482,800,1.8525,1298,347,42,23,21,2,15,2,0.047619048,0,empty,CD-0722-4
"A4,F9",9004,9671,6887,2784,4976,2380,0,2384,1616,768,2.104166667,1307,3080,731,283,275,8,94,2,0.061818182,0,empty,CD-0722-4
"A4,F10",12210,13302,9336,3966,6765,3137,15,3152,2062,1090,1.891743119,1689,2429,421,195,194,1,60,1,0.082474227,0,empty,CD-0722-4
"A4,F11",8463,8733,6490,2243,4575,2034,0,2034,1332,702,1.897435897,1058,2376,557,186,185,1,45,1,0.124324324,0,empty,CD-0722-4
"A4,F12",9734,10832,7267,3565,5586,2749,0,2756,1798,958,1.876826722,1554,432,101,39,39,0,17,0,0.41025641,0,empty,CD-0722-4
"A4,G1",27558,31069,21253,9816,15447,7831,1,7842,5587,2255,2.477605322,4340,3944,1085,393,389,4,116,2,0.161953728,0,empty,CD-0722-4
"A4,G2",6810,7601,4826,2775,3725,1927,11,1942,1219,723,1.686030429,1103,613,126,63,63,0,24,0,0.015873016,0,empty,CD-0722-4
"A4,G3",14402,15798,10638,5160,7946,3970,0,3974,2472,1502,1.645805593,2227,5616,1146,437,421,16,99,2,0.111638955,0,empty,CD-0722-4
"A4,G4",21441,24325,15284,9041,12209,6908,1,6919,4111,2808,1.464031339,4035,132,16,12,12,0,9,0,0.083333333,0,empty,CD-0722-4
"A4,G5",7326,8018,5367,2651,4187,2064,0,2066,1324,742,1.784366577,1180,2303,318,117,115,2,35,1,0.034782609,0,empty,CD-0722-4
"A4,G6",10698,11940,8222,3718,5961,2836,0,2838,1923,915,2.101639344,1557,326,66,35,33,2,12,2,0.333333333,0,empty,CD-0722-4
"A4,G7",869854,970350,649854,320496,470714,239732,2,239988,198548,41440,4.791216216,137194,377482,120378,42407,42117,290,4223,14,0.030177838,0,hg38,CD-0722-4
"A4,G8",5997,6451,4452,1999,3353,1589,0,1591,1021,570,1.79122807,863,2106,563,249,247,2,74,1,0.068825911,0,empty,CD-0722-4
"A4,G9",7548,8418,5567,2851,4287,2095,0,2098,1307,791,1.652338812,1199,3283,669,271,269,2,99,1,0.078066914,0,empty,CD-0722-4
"A4,G10",9071,10009,6702,3307,5091,2537,20,2558,1654,904,1.829646018,1461,3351,851,343,339,4,96,2,0.079646018,0,empty,CD-0722-4
"A4,G11",9320,10143,7037,3106,5062,2391,15,2409,1628,781,2.084507042,1299,1917,392,189,189,0,60,0,0.084656085,0,empty,CD-0722-4
"A4,G12",8336,9279,6036,3243,4975,2482,26,2511,1639,872,1.879587156,1487,2754,729,300,297,3,66,1,0.033670034,0,empty,CD-0722-4
"A4,H1",7453,8065,5648,2417,4208,2004,0,2010,1337,673,1.986627043,1074,2067,475,231,226,5,64,1,0.053097345,0,empty,CD-0722-4
"A4,H2",13603,15062,10106,4956,7539,3877,18,3899,2613,1286,2.031881804,2177,2927,703,253,253,0,78,0,0.035573123,0,empty,CD-0722-4
"A4,H3",6967,7655,5074,2581,3875,1910,0,1912,1213,699,1.735336195,1118,2295,558,189,189,0,50,0,0.100529101,0,empty,CD-0722-4
"A4,H4",11151,11968,8248,3720,6122,3005,0,3007,1894,1113,1.701707098,1657,241,57,28,27,1,10,1,0,0,empty,CD-0722-4
"A4,H5",11764,12987,8566,4421,6678,3356,0,3360,2150,1210,1.776859504,1954,3010,824,314,302,12,76,2,0.062913907,0,empty,CD-0722-4
"A4,H6",6691,7415,4994,2421,3776,1949,0,1949,1248,701,1.780313837,1122,3122,803,327,323,4,86,1,0.055727554,0,empty,CD-0722-4
"A4,H7",8045,8614,5975,2639,4514,2148,1,2151,1411,740,1.906756757,1190,2625,731,237,230,7,64,2,0.034782609,0,empty,CD-0722-4
"A4,H8",1529716,1783018,1100054,682964,855964,510621,3,511051,366351,144700,2.531796821,301991,71402,14989,5745,5692,53,959,3,0.028636683,0,hg38,CD-0722-4
"A4,H9",1249859,1444245,927093,517152,691461,390451,10,390776,282022,108754,2.593210365,229091,19480,6466,2370,2353,17,501,3,0.01359966,0,hg38,CD-0722-4
"A4,H10",6655,7084,4959,2125,3624,1744,7,1754,1149,605,1.899173554,972,1905,272,121,118,3,36,1,0.186440678,0,empty,CD-0722-4
"A4,H11",8025,9541,5492,4049,4898,3020,2,3027,1687,1340,1.258955224,1870,107,19,10,9,1,4,1,0,0,empty,CD-0722-4
"A4,H12",815291,928682,604020,324662,454453,242760,1,242975,189880,53095,3.576231284,142842,90108,9068,3524,3459,65,771,8,0.028620989,0,hg38,CD-0722-4
"A5,A1",7294,7845,5289,2556,4081,2059,0,2059,1312,747,1.756358768,1125,1136,191,76,76,0,25,0,0.052631579,0,empty,CD-0722-4
"A5,A2",1874591,2152182,1396982,755200,1029110,564842,9,565376,445677,119699,3.723314313,330452,85222,19858,7960,7887,73,1381,7,0.050589578,0,hg38,CD-0722-4
"A5,A3",7637,8020,5658,2362,4272,2010,4,2016,1336,680,1.964705882,1093,1883,434,188,187,1,48,1,0.069518717,0,empty,CD-0722-4
"A5,A4",11392,12583,8367,4216,6539,3243,0,3247,2106,1141,1.845749343,1848,764,141,72,69,3,15,1,0,0,empty,CD-0722-4
"A5,A5",9745,10552,7248,3304,5513,2649,0,2651,1735,916,1.894104803,1483,2737,594,283,281,2,72,1,0.078291815,0,empty,CD-0722-4
"A5,A6",7891,8987,5768,3219,4841,2545,0,2548,1614,934,1.728051392,1501,3442,954,411,406,5,104,2,0.07635468,0,empty,CD-0722-4
"A5,A7",7195,8168,5204,2964,4176,2188,0,2190,1331,859,1.549476135,1265,947,315,121,121,0,37,0,0,0,empty,CD-0722-4
"A5,A8",4305,4912,3281,1631,2615,1303,0,1303,849,454,1.870044053,740,2210,627,221,219,2,60,2,0.00456621,0,empty,CD-0722-4
"A5,A9",879283,1020517,649521,370996,507471,283652,1,283930,206067,77863,2.646533013,168304,222234,24152,9555,9301,254,1447,10,0.060853672,0,hg38,CD-0722-4
"A5,A10",9142,9507,7092,2415,4981,2327,0,2327,1525,802,1.901496259,1178,423,106,56,55,1,20,1,0.254545455,0,empty,CD-0722-4
"A5,A11",6241,6550,4779,1771,3457,1541,0,1544,1019,525,1.940952381,838,1354,339,123,120,3,44,2,0.016666667,0,empty,CD-0722-4
"A5,A12",9624,10396,7094,3302,5449,2625,0,2629,1718,911,1.885839737,1467,4330,777,330,328,2,95,1,0.082317073,0,empty,CD-0722-4
"A5,B1",1072946,1229832,800638,429194,599425,322635,7,322926,263415,59511,4.426324545,187107,110480,13372,5303,5193,110,1043,4,0.03061814,0,hg38,CD-0722-4
"A5,B2",8429,9173,5779,3394,4778,2491,25,2519,1604,915,1.753005464,1544,620,155,79,79,0,21,0,0,0,empty,CD-0722-4
"A5,B3",6252,6933,4512,2421,3617,1825,0,1825,1200,625,1.92,1055,1625,326,139,137,2,48,1,0.072992701,0,empty,CD-0722-4
"A5,B4",7081,8158,5153,3005,4376,2375,0,2376,1457,919,1.585418934,1425,2132,610,208,202,6,38,2,0.202970297,0,empty,CD-0722-4
"A5,B5",2834903,1697887,1058192,639695,1061521,589525,19,592682,460716,131966,3.491171969,374037,113733,16551,6279,6158,121,1147,5,0.052776876,0,hg38,CD-0722-4
"A5,B6",1651712,1865300,1232316,632984,904811,480395,6,480787,372585,108202,3.443420639,277692,310373,42937,17701,17417,284,2424,9,0.046850778,0,hg38,CD-0722-4
"A5,B7",813794,970142,577363,392779,486777,308313,3,308509,217982,90527,2.407922498,182468,5115,683,245,243,2,63,1,0.032921811,0,hg38,CD-0722-4
"A5,B8",5666,6406,4291,2115,3419,1674,0,1677,1103,574,1.921602787,955,1663,336,143,142,1,52,1,0.098591549,0,empty,CD-0722-4
"A5,B9",10587,11641,7761,3880,6006,3052,18,3072,1949,1123,1.735529831,1737,1235,239,93,92,1,32,1,0,0,empty,CD-0722-4
"A5,B10",5544,5935,4055,1880,3279,1680,0,1680,1078,602,1.790697674,955,555,61,39,38,1,15,1,0.105263158,0,empty,CD-0722-4
"A5,B11",16020,18172,11575,6597,9425,5080,15,5095,3190,1905,1.674540682,3047,371,140,57,57,0,12,0,0,0,empty,CD-0722-4
"A5,B12",11178,12291,8303,3988,6519,3176,4,3186,2180,1006,2.166998012,1851,4018,957,368,364,4,87,3,0.041208791,0,empty,CD-0722-4
"A5,C1",1015447,968206,857285,110921,461540,132612,0,132885,101803,31082,3.275304034,54180,2930,934,264,253,11,74,2,0.023715415,0,hg38,CD-0722-4
"A5,C2",16875,18812,12451,6361,9595,4850,9,4872,3184,1688,1.886255924,2857,2957,846,317,315,2,83,1,0.126984127,0,empty,CD-0722-4
"A5,C3",11985,13399,8724,4675,6968,3524,1,3527,2203,1324,1.663897281,2025,1100,216,78,71,7,27,2,0.098591549,0,empty,CD-0722-4
"A5,C4",7330,7927,5471,2456,4289,2062,0,2070,1342,728,1.843406593,1148,2433,417,186,186,0,50,0,0.188172043,0,empty,CD-0722-4
"A5,C5",12961,14279,9677,4602,7334,3543,37,3587,2387,1200,1.989166667,2001,1991,547,184,183,1,38,1,0.245901639,0,empty,CD-0722-4
"A5,C6",8747,9425,6542,2883,5010,2478,0,2484,1557,927,1.67961165,1328,2299,634,235,229,6,61,3,0.139737991,0,empty,CD-0722-4
"A5,C7",11929,13573,8720,4853,7100,3906,3,3913,2265,1648,1.374393204,2251,446,75,48,47,1,12,1,0.042553191,0,empty,CD-0722-4
"A5,C8",798133,886167,604563,281604,441393,220881,12,221083,171580,49503,3.466052562,124598,111362,15132,5477,5371,106,1094,7,0.035933718,0,hg38,CD-0722-4
"A5,C9",867149,996789,647232,349557,490438,259445,2,259670,202962,56708,3.579071736,153047,124659,18723,7411,7270,141,1172,4,0.070288858,0,hg38,CD-0722-4
"A5,C10",970610,1081186,737866,343320,526687,263081,0,263325,201132,62193,3.233997395,149355,184038,21937,8704,8514,190,1363,6,0.049800329,0,hg38,CD-0722-4
"A5,C11",9355,10156,6919,3237,5381,2635,1,2639,1641,998,1.644288577,1537,2397,707,297,295,2,72,1,0.033898305,0,empty,CD-0722-4
"A5,C12",1091942,1285331,798920,486411,624065,352879,3,353230,273363,79867,3.422727785,212494,31581,8271,3055,3027,28,686,2,0.032705649,0,hg38,CD-0722-4
"A5,D1",11279,12403,8213,4190,6436,3360,0,3362,2058,1304,1.578220859,1917,887,125,55,54,1,11,1,0.333333333,0,empty,CD-0722-4
"A5,D2",9772,10662,7387,3275,5645,2703,0,2703,1753,950,1.845263158,1488,3287,975,369,366,3,91,1,0.087431694,0,empty,CD-0722-4
"A5,D3",8300,9140,6095,3045,4800,2434,12,2448,1580,868,1.820276498,1339,1837,365,157,157,0,48,0,0.012738854,0,empty,CD-0722-4
"A5,D4",6882,7801,5045,2756,4104,2088,1,2094,1403,691,2.030390738,1222,2123,565,253,249,4,55,1,0,0,empty,CD-0722-4
"A5,D5",6998,7763,5272,2491,4143,2042,0,2046,1333,713,1.869565217,1139,2292,548,216,212,4,48,1,0.117924528,0,empty,CD-0722-4
"A5,D6",910818,1026129,681612,344517,501112,260705,0,260947,206086,54861,3.756511912,151318,122196,18460,7346,7193,153,1161,6,0.048797442,0,hg38,CD-0722-4
"A5,D7",6381,6901,4676,2225,3628,1697,2,1701,1094,607,1.802306425,970,2269,354,163,162,1,57,1,0.191358025,0,empty,CD-0722-4
"A5,D8",7726,8508,5682,2826,4469,2287,0,2287,1442,845,1.706508876,1290,1539,324,149,148,1,43,1,0.114864865,0,empty,CD-0722-4
"A5,D9",5577,6047,4097,1950,3176,1444,0,1449,961,488,1.969262295,828,1595,211,106,106,0,38,0,0.047169811,0,empty,CD-0722-4
"A5,D10",8830,9834,6486,3348,5178,2652,0,2654,1755,899,1.952169077,1563,1352,236,116,110,6,24,2,0.181818182,0,empty,CD-0722-4
"A5,D11",8496,8965,6392,2573,4705,2228,29,2257,1474,783,1.882503193,1186,4681,1035,415,405,10,97,2,0.059259259,0,empty,CD-0722-4
"A5,D12",11269,12595,8367,4228,6421,3168,0,3170,2064,1106,1.866184448,1771,4547,1096,439,437,2,104,1,0.080091533,0,empty,CD-0722-4
"A5,E1",13962,14976,10337,4639,7711,3791,0,3795,2327,1468,1.585149864,2101,3154,603,250,249,1,79,1,0.036144578,0,empty,CD-0722-4
"A5,E2",9918,10977,7273,3704,5697,2870,1,2871,1769,1102,1.605263158,1635,2919,508,181,176,5,48,3,0.107954545,0,empty,CD-0722-4
"A5,E3",6625,7086,5052,2034,3744,1803,0,1805,1156,649,1.781201849,945,2618,687,258,257,1,78,1,0.046692607,0,empty,CD-0722-4
"A5,E4",9112,10023,6733,3290,5215,2502,8,2511,1643,868,1.892857143,1406,3688,700,355,353,2,91,1,0.062322946,0,empty,CD-0722-4
"A5,E5",8187,8777,6103,2674,4667,2207,1,2208,1460,748,1.951871658,1207,1813,348,155,150,5,42,2,0.073333333,0,empty,CD-0722-4
"A5,E6",14625,15757,10807,4950,8122,4059,5,4069,2607,1462,1.783173735,2269,4081,1036,447,437,10,112,2,0.09382151,0,empty,CD-0722-4
"A5,E7",12533,13604,9394,4210,7132,3374,0,3376,2153,1223,1.760425184,1906,3230,667,287,285,2,88,2,0.098245614,0,empty,CD-0722-4
"A5,E8",1938647,2110209,1507970,602239,1010822,482661,8,483168,375656,107512,3.494084381,265288,186499,36092,13860,13696,164,1894,6,0.026358061,0,hg38,CD-0722-4
"A5,E9",6336,7195,4627,2568,3742,1854,1,1855,1234,621,1.987117552,1079,3407,806,328,321,7,75,3,0.043613707,0,empty,CD-0722-4
"A5,E10",7757,8568,5710,2858,4451,2170,1,2171,1403,768,1.826822917,1251,2069,640,266,259,7,53,2,0.007722008,0,empty,CD-0722-4
"A5,E11",9169,9808,6774,3034,5164,2530,0,2532,1619,913,1.773274918,1385,2622,530,242,232,10,64,2,0.00862069,0,empty,CD-0722-4
"A5,E12",1061591,1143870,813310,330560,559883,269492,5,269731,210082,59649,3.521970192,147599,47042,10606,4369,4306,63,766,2,0.011147236,0,hg38,CD-0722-4
"A5,F1",11488,12573,8357,4216,6698,3346,1,3352,2080,1272,1.635220126,1948,2893,712,275,269,6,60,2,0.063197026,0,empty,CD-0722-4
"A5,F2",9362,9954,6948,3006,5329,2635,0,2637,1664,973,1.710174717,1463,3535,963,349,345,4,82,1,0.049275362,0,empty,CD-0722-4
"A5,F3",8790,9598,6470,3128,5092,2461,22,2485,1679,806,2.083126551,1411,3414,780,305,303,2,77,1,0.135313531,0,empty,CD-0722-4
"A5,F4",12907,13657,9733,3924,7237,3372,1,3378,2229,1149,1.939947781,1806,848,124,47,46,1,22,1,0.065217391,0,empty,CD-0722-4
"A5,F5",10682,11230,8096,3134,5854,2675,1,2676,1719,957,1.796238245,1414,1831,398,173,167,6,66,2,0.041916168,0,empty,CD-0722-4
"A5,F6",10757,11942,7794,4148,6198,3166,1,3173,2026,1147,1.766346992,1824,4155,813,333,323,10,92,2,0.080495356,0,empty,CD-0722-4
"A5,F7",11476,11817,8562,3255,6496,3128,0,3133,2079,1054,1.972485769,1660,1283,322,146,143,3,48,2,0,0,empty,CD-0722-4
"A5,F8",10393,11904,7650,4254,6105,3042,2,3045,2064,981,2.103975535,1818,299,64,20,19,1,10,1,0.052631579,0,empty,CD-0722-4
"A5,F9",9680,10370,7406,2964,5361,2546,0,2547,1737,810,2.144444444,1360,3911,957,386,383,3,106,2,0.041775457,0,empty,CD-0722-4
"A5,F10",12051,12983,9029,3954,6860,3315,0,3315,2110,1205,1.751037344,1840,2141,531,230,226,4,67,2,0.061946903,0,empty,CD-0722-4
"A5,F11",9231,9575,7054,2521,4949,2096,13,2113,1408,705,1.997163121,1100,1806,412,190,189,1,44,1,0.015873016,0,empty,CD-0722-4
"A5,F12",10436,11405,7728,3677,5897,2898,0,2901,1923,978,1.966257669,1655,380,19,16,16,0,9,0,0,0,empty,CD-0722-4
"A5,G1",11326,12216,8653,3563,6506,3017,3,3032,1946,1086,1.791896869,1673,3960,1045,378,373,5,90,2,0.048257373,0,empty,CD-0722-4
"A5,G2",6556,7201,4638,2563,3714,1942,1,1943,1212,731,1.658002736,1134,387,137,51,51,0,17,0,0,0,empty,CD-0722-4
"A5,G3",12339,13616,9169,4447,7047,3484,17,3505,2154,1351,1.594374537,1939,2285,574,245,243,2,79,1,0.016460905,0,empty,CD-0722-4
"A5,G4",21594,24636,15527,9109,12787,7102,14,7126,4334,2792,1.552292264,4278,172,15,10,9,1,9,1,0,0,empty,CD-0722-4
"A5,G5",7528,8200,5565,2635,4327,2143,0,2143,1409,734,1.919618529,1219,1554,409,173,172,1,48,1,0.029069767,0,empty,CD-0722-4
"A5,G6",11199,11907,8578,3329,6167,2826,41,2869,1937,932,2.07832618,1570,196,38,12,12,0,6,0,0.083333333,0,empty,CD-0722-4
"A5,G7",10329,11341,7591,3750,5779,2752,0,2753,1943,810,2.398765432,1539,3966,785,331,329,2,94,2,0.042553191,0,empty,CD-0722-4
"A5,G8",6474,6757,4722,2035,3582,1742,5,1747,1110,637,1.742543171,983,3493,491,224,221,3,65,2,0.122171946,0,empty,CD-0722-4
"A5,G9",7552,8148,5657,2491,4372,2085,0,2085,1365,720,1.895833333,1186,2298,501,207,198,9,74,2,0.04040404,0,empty,CD-0722-4
"A5,G10",9046,9676,6678,2998,5189,2590,0,2591,1673,918,1.822440087,1400,2852,713,237,237,0,77,0,0.042194093,0,empty,CD-0722-4
"A5,G11",9319,10230,7079,3151,5254,2492,1,2495,1612,883,1.825594564,1333,1955,579,245,240,5,69,2,0.045833333,0,empty,CD-0722-4
"A5,G12",7812,8448,5710,2738,4456,2233,0,2240,1378,862,1.598607889,1263,1962,351,169,168,1,54,1,0.095238095,0,empty,CD-0722-4
"A5,H1",8184,8880,6078,2802,4695,2206,12,2218,1434,784,1.829081633,1267,1683,360,142,135,7,42,1,0.103703704,0,empty,CD-0722-4
"A5,H2",10031,11270,7325,3945,5879,2945,32,2985,2013,972,2.070987654,1805,2780,555,226,219,7,69,2,0.02739726,0,empty,CD-0722-4
"A5,H3",7731,8520,5760,2760,4499,2272,0,2277,1490,787,1.893265565,1293,2004,523,173,171,2,45,1,0.076023392,0,empty,CD-0722-4
"A5,H4",938789,1057829,703621,354208,515781,267806,14,268039,214668,53371,4.022184332,155491,7727,1592,661,659,2,130,1,0.030349014,0,hg38,CD-0722-4
"A5,H5",2151660,2455760,1587105,868655,1171302,651624,3,652194,536386,115808,4.631683476,387324,173572,28625,11355,11159,196,1709,8,0.026704902,0,hg38,CD-0722-4
"A5,H6",7055,7476,5087,2389,3899,1986,5,1996,1336,660,2.024242424,1122,2156,608,254,253,1,74,1,0.04743083,0,empty,CD-0722-4
"A5,H7",8566,8813,6534,2279,4748,2125,17,2143,1407,736,1.911684783,1134,2609,560,228,227,1,56,1,0.140969163,0,empty,CD-0722-4
"A5,H8",9983,10811,7201,3610,5641,2918,3,2922,1852,1070,1.730841121,1697,3246,599,261,254,7,73,3,0.039370079,0,empty,CD-0722-4
"A5,H9",7288,7990,5599,2391,4191,1965,0,1968,1305,663,1.968325792,1106,1258,228,105,103,2,30,1,0.067961165,0,empty,CD-0722-4
"A5,H10",6352,6921,4726,2195,3555,1724,7,1740,1162,578,2.010380623,929,1485,352,146,146,0,32,0,0,0,empty,CD-0722-4
"A5,H11",8503,9787,5875,3912,5092,3029,0,3034,1619,1415,1.144169611,1825,58,3,3,3,0,3,0,0,0,empty,CD-0722-4
"A5,H12",6913,7625,4927,2698,4007,2073,0,2077,1361,716,1.900837989,1260,1529,341,141,140,1,47,1,0.014285714,0,empty,CD-0722-4
"A6,A1",7189,7905,5210,2695,4156,2139,1,2140,1322,818,1.616136919,1201,1257,185,79,73,6,30,1,0.054794521,0,empty,CD-0722-4
"A6,A2",10454,11815,7823,3992,5900,2974,0,2977,1891,1086,1.741252302,1667,2083,665,222,219,3,55,1,0.100456621,0,empty,CD-0722-4
"A6,A3",650304,795798,444679,351119,392316,259873,1,260055,187873,72182,2.602768003,159611,8367,776,316,304,12,62,2,0.302631579,0,hg38,CD-0722-4
"A6,A4",1821951,2067340,1409488,657852,964922,497451,3,497916,402855,95061,4.237857797,280767,77075,6440,2637,2543,94,568,5,0.043649233,0,hg38,CD-0722-4
"A6,A5",376387,449824,267244,182580,230825,140958,15,141089,102730,38359,2.678119868,86517,3979,1183,380,380,0,93,0,0.028947368,0,hg38,CD-0722-4
"A6,A6",15285,17105,11273,5832,8598,4422,0,4422,3100,1322,2.344931921,2506,2983,780,312,312,0,84,0,0.092948718,0,empty,CD-0722-4
"A6,A7",7181,7987,5295,2692,4126,2095,0,2096,1378,718,1.919220056,1171,1801,428,150,147,3,36,1,0.006802721,0,empty,CD-0722-4
"A6,A8",4503,4923,3413,1510,2563,1272,15,1287,859,428,2.007009346,705,1956,464,188,181,7,60,2,0.005524862,0,empty,CD-0722-4
"A6,A9",7227,7688,5540,2148,3945,1833,0,1833,1183,650,1.82,933,2195,468,180,178,2,61,2,0.073033708,0,empty,CD-0722-4
"A6,A10",686616,834891,495658,339233,411011,248694,2,248879,202770,46109,4.397623024,150779,2580,739,313,313,0,96,0,0.054313099,0,hg38,CD-0722-4
"A6,A11",6187,6830,4615,2215,3455,1640,0,1643,1106,537,2.059590317,914,1458,414,174,174,0,41,0,0.057471264,0,empty,CD-0722-4
"A6,A12",8915,9826,6743,3083,4920,2347,0,2347,1462,885,1.651977401,1310,4454,1107,446,441,5,99,2,0.095238095,0,empty,CD-0722-4
"A6,B1",7711,8712,5682,3030,4464,2275,8,2287,1432,855,1.674853801,1369,1236,201,78,78,0,33,0,0.012820513,0,empty,CD-0722-4
"A6,B2",8968,9866,6144,3722,5104,2806,0,2811,1720,1091,1.576535289,1688,914,274,100,100,0,16,0,0.09,0,empty,CD-0722-4
"A6,B3",6409,7115,4748,2367,3717,1805,0,1805,1171,634,1.847003155,1046,1366,271,111,110,1,34,1,0.018181818,0,empty,CD-0722-4
"A6,B4",7226,8372,5218,3154,4336,2348,12,2363,1489,874,1.703661327,1444,1511,326,138,138,0,38,0,0.166666667,0,empty,CD-0722-4
"A6,B5",14824,12673,8057,4616,7168,3818,0,3833,2756,1077,2.558960074,2352,985,167,58,56,2,24,1,0.071428571,0,empty,CD-0722-4
"A6,B6",1095287,1285275,787979,497296,628323,375298,9,375568,227947,147621,1.544136674,226865,39320,8338,3094,3047,47,593,3,0.102723991,0,hg38,CD-0722-4
"A6,B7",8122,9019,6027,2992,4683,2285,0,2289,1516,773,1.961190168,1330,1166,267,130,129,1,35,1,0.03875969,0,empty,CD-0722-4
"A6,B8",5583,6266,4091,2175,3193,1543,0,1550,981,569,1.724077329,925,1280,284,105,105,0,27,0,0,0,empty,CD-0722-4
"A6,B9",10575,11429,7768,3661,5897,2980,1,2986,1879,1107,1.697380307,1689,971,223,110,110,0,37,0,0.045454545,0,empty,CD-0722-4
"A6,B10",158794,188544,98121,90423,101830,71602,1,71729,45736,25993,1.759550648,44846,617,267,72,72,0,15,0,0.083333333,0,empty,CD-0722-4
"A6,B11",12468,13753,8752,5001,7006,3908,0,3908,2166,1742,1.243398393,2318,228,31,19,19,0,7,0,0,0,empty,CD-0722-4
"A6,B12",6873,7465,5111,2354,3827,1837,0,1840,1217,623,1.953451043,986,1697,553,200,199,1,55,1,0.015075377,0,empty,CD-0722-4
"A6,C1",14737,15730,11058,4672,8102,3901,55,3968,2444,1524,1.603674541,2183,1345,277,115,112,3,28,1,0.035714286,0,empty,CD-0722-4
"A6,C2",847743,902757,667341,235416,432539,188584,1,188759,143941,44818,3.211678344,102000,35934,9724,3676,3644,32,623,3,0.018660812,0,hg38,CD-0722-4
"A6,C3",11905,13062,8888,4174,6908,3366,0,3370,2111,1259,1.676727562,1880,1163,220,95,95,0,27,0,0.042105263,0,empty,CD-0722-4
"A6,C4",7053,7659,5259,2400,3940,1816,0,1819,1190,629,1.891891892,1017,2135,567,235,234,1,52,1,0.051282051,0,empty,CD-0722-4
"A6,C5",13126,14274,9911,4363,7164,3411,4,3422,2323,1099,2.113739763,1894,2314,510,203,201,2,61,1,0.084577114,0,empty,CD-0722-4
"A6,C6",9434,10098,6907,3191,5260,2526,18,2550,1659,891,1.861952862,1444,1855,383,155,154,1,40,1,0.194805195,0,empty,CD-0722-4
"A6,C7",12024,13674,8605,5069,6992,3920,1,3925,2314,1611,1.436374922,2293,365,110,51,50,1,16,1,0.38,0,empty,CD-0722-4
"A6,C8",13139,14422,9705,4717,7425,3648,0,3652,2410,1242,1.94041868,2059,3093,553,236,234,2,68,1,0.051282051,0,empty,CD-0722-4
"A6,C9",796839,919976,599287,320689,446126,232544,2,232752,180057,52695,3.416965557,137591,113037,13766,5269,5106,163,894,6,0.064825695,0,hg38,CD-0722-4
"A6,C10",11500,12475,8684,3791,6337,2968,7,2980,1934,1046,1.848948375,1670,2364,387,176,174,2,43,1,0,0,empty,CD-0722-4
"A6,C11",9620,10823,7026,3797,5507,2735,0,2739,1690,1049,1.611058151,1623,2208,692,252,250,2,64,2,0.04,0,empty,CD-0722-4
"A6,C12",964665,1083046,727049,355997,517275,261021,5,261325,205970,55355,3.720892422,150922,113844,15769,6099,5965,134,1001,6,0.051299246,0,hg38,CD-0722-4
"A6,D1",11748,13319,8465,4854,6878,3783,0,3783,2199,1584,1.388257576,2205,787,119,46,40,6,20,2,0,0,empty,CD-0722-4
"A6,D2",9864,10591,7487,3104,5545,2602,0,2606,1704,902,1.889135255,1404,2819,697,265,262,3,76,1,0.06870229,0,empty,CD-0722-4
"A6,D3",9963,11028,7486,3542,5608,2714,1,2717,1830,887,2.06313416,1522,1765,340,159,156,3,43,1,0.064102564,0,empty,CD-0722-4
"A6,D4",758532,854166,579484,274682,415609,208841,5,209032,161524,47508,3.399932643,119573,89189,9291,3722,3602,120,702,6,0.03525819,0,hg38,CD-0722-4
"A6,D5",7439,8264,5526,2738,4204,2012,23,2037,1330,707,1.881188119,1151,1767,346,143,141,2,32,2,0.078014184,0,empty,CD-0722-4
"A6,D6",12011,13290,8677,4613,6768,3573,3,3577,2178,1399,1.556826305,2080,3615,502,248,243,5,65,2,0.094650206,0,empty,CD-0722-4
"A6,D7",6650,7167,4959,2208,3743,1763,0,1769,1141,628,1.816878981,991,2398,616,262,256,6,76,2,0.015625,0,empty,CD-0722-4
"A6,D8",7510,8300,5559,2741,4304,2144,0,2150,1418,732,1.93715847,1227,1377,418,152,152,0,39,0,0.092105263,0,empty,CD-0722-4
"A6,D9",4338,4703,3169,1534,2409,1179,0,1181,773,408,1.894607843,666,2130,590,222,220,2,59,2,0.140909091,0,empty,CD-0722-4
"A6,D10",8016,8953,5742,3211,4626,2364,0,2367,1521,846,1.79787234,1432,1256,395,142,142,0,33,0,0.049295775,0,empty,CD-0722-4
"A6,D11",8514,9441,6340,3101,4870,2356,0,2357,1518,839,1.809296782,1375,2930,735,298,298,0,74,0,0.053691275,0,empty,CD-0722-4
"A6,D12",11310,12599,8391,4208,6382,3168,2,3173,1983,1190,1.666386555,1800,3605,758,336,331,5,93,2,0.045317221,0,empty,CD-0722-4
"A6,E1",13550,14539,9970,4569,7387,3702,0,3704,2334,1370,1.703649635,2070,2856,560,249,244,5,64,3,0.094262295,0,empty,CD-0722-4
"A6,E2",10417,11150,7762,3388,5751,2878,0,2879,1806,1073,1.683131407,1629,2040,360,153,151,2,46,2,0.205298013,0,empty,CD-0722-4
"A6,E3",1005590,1139765,779372,360393,548317,272732,4,273036,218634,54402,4.018859601,153366,303048,58879,23146,22789,357,2642,8,0.072403352,0,hg38,CD-0722-4
"A6,E4",8906,9864,6509,3355,5035,2565,0,2567,1625,942,1.725053079,1494,2809,815,322,319,3,95,1,0.031347962,0,empty,CD-0722-4
"A6,E5",8447,9184,6436,2748,4730,2197,24,2229,1402,827,1.69528416,1238,1247,336,124,124,0,33,0,0.032258065,0,empty,CD-0722-4
"A6,E6",855443,936868,664846,272022,447245,205534,9,205753,157127,48626,3.231337145,113215,136743,18882,7424,7287,137,1193,6,0.030876904,0,hg38,CD-0722-4
"A6,E7",910045,1035339,676634,358705,497543,266145,7,266372,211014,55358,3.811806785,154099,134567,22517,8879,8758,121,1368,6,0.064284083,0,hg38,CD-0722-4
"A6,E8",11132,11771,8629,3142,6078,2722,0,2724,1814,910,1.993406593,1418,2893,553,250,247,3,82,2,0.012145749,0,empty,CD-0722-4
"A6,E9",662290,778262,484473,293789,379772,212274,0,212430,162786,49644,3.279066957,127053,154680,23764,9556,9351,205,1506,4,0.061169928,0,hg38,CD-0722-4
"A6,E10",8205,8768,6161,2607,4574,2193,2,2195,1413,782,1.806905371,1206,1813,399,170,166,4,51,1,0.13253012,0,empty,CD-0722-4
"A6,E11",9672,10652,7277,3375,5388,2709,0,2711,1710,1001,1.708291708,1487,2033,562,247,243,4,58,1,0.086419753,0,empty,CD-0722-4
"A6,E12",873641,967856,639443,328413,475567,268440,11,268680,216928,51752,4.191683413,150319,35795,18392,6920,6900,20,1020,5,0.015217391,0,hg38,CD-0722-4
"A6,F1",12113,13302,8922,4380,6807,3310,1,3313,2106,1207,1.744821872,1878,2238,673,219,219,0,60,0,0.054794521,0,empty,CD-0722-4
"A6,F2",9345,10072,6811,3261,5262,2560,11,2574,1628,946,1.720930233,1476,3345,908,295,294,1,69,1,0.068027211,0,empty,CD-0722-4
"A6,F3",9109,9858,6750,3108,5108,2534,3,2539,1618,921,1.756786102,1454,3161,569,242,239,3,70,1,0.041841004,0,empty,CD-0722-4
"A6,F4",13699,14828,10444,4384,7503,3477,4,3486,2231,1255,1.777689243,1892,763,140,69,69,0,15,0,0,0,empty,CD-0722-4
"A6,F5",886370,968170,677034,291136,465114,223734,1,223950,165801,58149,2.851313006,126766,95138,12209,4982,4910,72,856,6,0.068431772,0,hg38,CD-0722-4
"A6,F6",10091,11169,7455,3714,5844,3098,0,3098,1909,1189,1.605550883,1836,3551,972,442,438,4,101,2,0.073059361,0,empty,CD-0722-4
"A6,F7",12632,13936,9271,4665,7086,3483,3,3498,2259,1239,1.823244552,2002,1338,356,134,134,0,43,0,0.007462687,0,empty,CD-0722-4
"A6,F8",8219,9018,6212,2806,4653,2253,1,2261,1478,783,1.88761175,1239,372,22,15,15,0,13,0,0,0,empty,CD-0722-4
"A6,F9",9237,10025,7003,3022,5110,2412,0,2419,1644,775,2.121290323,1290,3883,865,386,378,8,81,2,0.084656085,0,empty,CD-0722-4
"A6,F10",13370,14391,10102,4289,7262,3329,24,3362,2244,1118,2.007155635,1832,1969,536,209,208,1,51,1,0.110576923,0,empty,CD-0722-4
"A6,F11",8654,9341,6504,2837,4714,2165,28,2196,1489,707,2.106082037,1171,2063,481,209,207,2,47,1,0.038647343,0,empty,CD-0722-4
"A6,F12",10105,10852,7401,3451,5549,2654,0,2658,1723,935,1.842780749,1508,310,47,14,14,0,7,0,0.071428571,0,empty,CD-0722-4
"A6,G1",925002,1112944,642577,470367,546137,355992,1,356266,245074,111192,2.204061443,214490,5806,871,267,255,12,73,2,0.125490196,0,hg38,CD-0722-4
"A6,G2",6705,7312,4673,2639,3790,1981,0,1981,1279,702,1.821937322,1145,401,118,38,38,0,12,0,0.157894737,0,empty,CD-0722-4
"A6,G3",14063,14900,10505,4395,7696,3756,0,3767,2404,1363,1.76375642,1997,3781,750,346,343,3,85,2,0.023323615,0,empty,CD-0722-4
"A6,G4",1162042,1270782,894213,376569,606592,289233,3,289575,214418,75157,2.852934524,162303,2137,332,111,108,3,20,1,0.092592593,0,hg38,CD-0722-4
"A6,G5",7566,8358,5507,2851,4286,2133,0,2136,1317,819,1.608058608,1251,1860,334,145,144,1,41,1,0.256944444,0,empty,CD-0722-4
"A6,G6",11480,12399,8585,3814,6243,3096,0,3097,2075,1022,2.030332681,1677,163,32,19,19,0,9,0,0.052631579,0,empty,CD-0722-4
"A6,G7",9132,9765,6979,2786,5058,2278,0,2278,1492,786,1.89821883,1231,3112,901,341,335,6,94,1,0.03880597,0,empty,CD-0722-4
"A6,G8",6247,6576,4723,1853,3519,1673,0,1676,1075,601,1.788685524,926,1724,430,167,166,1,50,1,0.036144578,0,empty,CD-0722-4
"A6,G9",7978,8590,5955,2635,4344,2096,0,2098,1321,777,1.7001287,1143,2399,430,229,227,2,68,1,0.035242291,0,empty,CD-0722-4
"A6,G10",9388,10279,7024,3255,5259,2578,0,2582,1629,953,1.70933893,1455,2620,585,237,235,2,76,2,0.038297872,0,empty,CD-0722-4
"A6,G11",9363,10083,7070,3013,5224,2477,0,2480,1614,866,1.863741339,1378,1718,473,203,202,1,50,1,0.014851485,0,empty,CD-0722-4
"A6,G12",7871,8798,5613,3185,4514,2327,0,2329,1502,827,1.816203144,1396,2073,460,202,201,1,47,1,0.019900498,0,empty,CD-0722-4
"A6,H1",7557,8097,5558,2539,4248,2094,0,2095,1366,729,1.873799726,1192,1421,302,118,116,2,38,2,0.163793103,0,empty,CD-0722-4
"A6,H2",9173,9886,6784,3102,5109,2504,2,2506,1586,920,1.723913043,1412,2578,504,210,209,1,70,1,0.028708134,0,empty,CD-0722-4
"A6,H3",7110,7863,5132,2731,4048,1962,19,1986,1267,719,1.76216968,1151,1561,319,124,124,0,44,0,0,0,empty,CD-0722-4
"A6,H4",11650,12802,8776,4026,6374,3037,11,3053,1963,1090,1.800917431,1690,306,53,31,31,0,10,0,0.032258065,0,empty,CD-0722-4
"A6,H5",12697,13715,9416,4299,6977,3473,1,3480,2222,1258,1.766295707,1989,2013,528,210,209,1,58,1,0.071770335,0,empty,CD-0722-4
"A6,H6",1600301,1899471,1192323,707148,903596,511409,7,511829,427473,84356,5.06748779,303455,284051,42391,16814,16470,344,2338,10,0.074013358,0,hg38,CD-0722-4
"A6,H7",9155,9834,6686,3148,5078,2445,16,2465,1630,835,1.952095808,1365,2055,650,226,226,0,50,0,0.159292035,0,empty,CD-0722-4
"A6,H8",18318,20240,13580,6660,10332,5316,0,5323,3729,1594,2.339397742,3054,2684,548,232,230,2,61,1,0.117391304,0,empty,CD-0722-4
"A6,H9",7516,7877,5603,2274,4067,1889,8,1897,1326,571,2.322241681,1009,1347,405,142,137,5,42,2,0.109489051,0,empty,CD-0722-4
"A6,H10",7391,8169,5530,2639,4073,2009,25,2036,1373,663,2.070889894,1154,874,222,91,89,2,32,1,0.033707865,0,empty,CD-0722-4
"A6,H11",8934,10076,6248,3828,5229,3130,0,3133,1789,1344,1.33110119,1806,32,4,4,4,0,2,0,0,0,empty,CD-0722-4
"A6,H12",6613,7230,4714,2516,3645,1897,0,1898,1259,639,1.970266041,1094,1402,220,110,109,1,25,1,0.137614679,0,empty,CD-0722-4
"A7,A1",7553,8247,5393,2854,4327,2336,0,2342,1505,837,1.798088411,1355,1672,420,154,153,1,39,1,0.065359477,0,empty,CD-0722-4
"A7,A2",10510,11468,7584,3884,5958,2949,9,2963,1877,1086,1.728360958,1705,2471,648,243,239,4,59,2,0.012552301,0,empty,CD-0722-4
"A7,A3",6810,7697,5012,2685,3943,2005,0,2009,1270,739,1.718538566,1169,1341,321,140,140,0,39,0,0.021428571,0,empty,CD-0722-4
"A7,A4",11768,13000,8844,4156,6671,3319,0,3326,2143,1183,1.811496196,1839,950,232,113,112,1,34,1,0.035714286,0,empty,CD-0722-4
"A7,A5",1202947,1310355,929870,380485,639549,298789,1,299066,248670,50396,4.934320184,165318,357503,34694,13868,13464,404,1990,10,0.0557041,0,hg38,CD-0722-4
"A7,A6",15084,16587,11443,5144,8659,4252,2,4259,2941,1318,2.231411229,2399,3866,1159,468,467,1,115,1,0.070663812,0,empty,CD-0722-4
"A7,A7",7276,8040,5296,2744,4095,2117,0,2125,1347,778,1.731362468,1184,1618,290,130,129,1,45,1,0.139534884,0,empty,CD-0722-4
"A7,A8",4547,5131,3460,1671,2632,1302,13,1317,858,459,1.869281046,718,2228,400,197,195,2,55,1,0.184615385,0,empty,CD-0722-4
"A7,A9",578155,708700,403595,305105,353901,230944,3,231146,172088,59058,2.913881269,139564,5173,681,264,255,9,84,2,0.08627451,0,hg38,CD-0722-4
"A7,A10",8641,9271,6574,2697,4811,2313,1,2317,1447,870,1.663218391,1232,570,83,40,40,0,16,0,0,0,empty,CD-0722-4
"A7,A11",6757,7392,5115,2277,3820,1756,12,1768,1188,580,2.048275862,951,1231,250,95,90,5,34,2,0.011111111,0,empty,CD-0722-4
"A7,A12",3602761,4030716,2724617,1306099,1840233,987310,15,988300,797628,190672,4.183246622,561899,814404,123803,48313,47406,907,4441,11,0.04294815,0,hg38,CD-0722-4
"A7,B1",8000,8749,5751,2998,4564,2289,28,2324,1470,854,1.721311475,1303,1672,314,140,139,1,44,1,0.028776978,0,empty,CD-0722-4
"A7,B2",8070,9013,5375,3638,4740,2617,0,2619,1627,992,1.640120968,1635,515,64,37,33,4,17,2,0.121212121,0,empty,CD-0722-4
"A7,B3",6576,7086,4724,2362,3750,1899,0,1902,1262,640,1.971875,1087,1691,411,171,169,2,58,2,0.035502959,0,empty,CD-0722-4
"A7,B4",7473,8461,5442,3019,4356,2331,0,2331,1507,824,1.828883495,1332,1907,402,137,133,4,42,1,0.052631579,0,empty,CD-0722-4
"A7,B5",9954,6427,4021,2406,4055,2201,13,2223,1517,706,2.148725212,1343,1533,365,158,153,5,39,1,0.071895425,0,empty,CD-0722-4
"A7,B6",8718,9828,6245,3583,5053,2705,1,2712,1631,1081,1.508788159,1617,1900,362,167,162,5,52,3,0.055555556,0,empty,CD-0722-4
"A7,B7",23030,25975,17167,8808,13253,7143,1,7146,4602,2544,1.808962264,4018,1191,183,89,88,1,29,1,0.034090909,0,empty,CD-0722-4
"A7,B8",6012,6538,4570,1968,3473,1667,10,1677,1147,530,2.164150943,961,1316,269,113,106,7,39,1,0.028301887,0,empty,CD-0722-4
"A7,B9",12011,13561,8689,4872,6773,3509,0,3511,2224,1287,1.728049728,2039,1274,260,100,98,2,35,2,0.102040816,0,empty,CD-0722-4
"A7,B10",5646,5840,3978,1862,3275,1635,6,1647,1087,560,1.941071429,911,742,199,77,77,0,25,0,0.051948052,0,empty,CD-0722-4
"A7,B11",12256,13609,8864,4745,6972,3734,8,3742,2093,1649,1.269254093,2167,494,129,66,66,0,19,0,0.090909091,0,empty,CD-0722-4
"A7,B12",6948,7611,5085,2526,4018,1988,0,1988,1281,707,1.811881188,1147,1938,403,186,186,0,57,0,0.129032258,0,empty,CD-0722-4
"A7,C1",14931,15731,11216,4515,8149,3910,3,3914,2482,1432,1.733240223,2041,1523,452,199,199,0,51,0,0.090452261,0,empty,CD-0722-4
"A7,C2",11739,12888,8593,4295,6664,3413,0,3413,2169,1244,1.743569132,1987,2459,747,336,335,1,72,1,0.074626866,0,empty,CD-0722-4
"A7,C3",11755,12912,8665,4247,6797,3422,1,3425,2163,1262,1.713946117,1941,1050,154,65,62,3,24,1,0.129032258,0,empty,CD-0722-4
"A7,C4",7736,8274,5900,2374,4204,1890,0,1893,1255,638,1.967084639,1037,2244,526,208,207,1,62,1,0.072463768,0,empty,CD-0722-4
"A7,C5",1077589,1240963,800244,440719,606851,328314,3,328558,256815,71743,3.57965237,192437,123379,17784,7265,7099,166,1194,9,0.054937315,0,hg38,CD-0722-4
"A7,C6",8862,9848,6475,3373,5161,2617,11,2629,1663,966,1.721532091,1533,1941,424,141,140,1,42,1,0.028571429,0,empty,CD-0722-4
"A7,C7",11891,13392,8575,4817,6995,3851,1,3860,2337,1523,1.534471438,2238,569,106,29,29,0,13,0,0.068965517,0,empty,CD-0722-4
"A7,C8",1075868,1251009,790642,460367,611630,344306,2,344622,273105,71517,3.818742397,201087,104313,29697,11454,11384,70,1737,4,0.059293746,0,hg38,CD-0722-4
"A7,C9",9241,10405,6962,3443,5530,2788,0,2790,1845,945,1.952380952,1583,1874,271,122,118,4,42,1,0.127118644,0,empty,CD-0722-4
"A7,C10",950288,1071790,718901,352889,520540,267378,4,267657,215155,52502,4.098034361,152537,237035,36981,14812,14510,302,2025,5,0.065265334,0,hg38,CD-0722-4
"A7,C11",9352,10395,6877,3518,5504,2757,1,2760,1782,978,1.82208589,1595,2164,454,215,214,1,60,1,0.060747664,0,empty,CD-0722-4
"A7,C12",13217,14467,9782,4685,7501,3658,0,3661,2369,1292,1.833591331,2074,2673,580,236,227,9,70,2,0.158590308,0,empty,CD-0722-4
"A7,D1",11696,13253,8343,4910,6822,3625,1,3633,2193,1440,1.522916667,2140,1004,170,80,76,4,17,1,0.013157895,0,empty,CD-0722-4
"A7,D2",9909,10840,7497,3343,5555,2562,28,2592,1659,933,1.778135048,1435,3678,1124,460,454,6,100,3,0.046255507,0,empty,CD-0722-4
"A7,D3",8393,9409,6185,3224,4944,2510,0,2518,1622,896,1.810267857,1418,1586,311,144,143,1,42,1,0.097902098,0,empty,CD-0722-4
"A7,D4",7464,8119,5474,2645,4270,2109,0,2111,1369,742,1.845013477,1234,1604,391,132,129,3,47,2,0.023255814,0,empty,CD-0722-4
"A7,D5",7647,8540,5763,2777,4399,2176,6,2186,1411,775,1.820645161,1242,1853,355,142,141,1,45,1,0.007092199,0,empty,CD-0722-4
"A7,D6",11788,12846,8504,4342,6683,3539,0,3546,2100,1446,1.452282158,2019,1919,497,209,209,0,59,0,0.062200957,0,empty,CD-0722-4
"A7,D7",6228,6758,4726,2032,3532,1639,0,1639,1113,526,2.115969582,896,2254,484,210,208,2,52,1,0.076923077,0,empty,CD-0722-4
"A7,D8",8054,8801,5990,2811,4637,2260,0,2262,1410,852,1.654929577,1299,1281,271,129,119,10,34,2,0.117647059,0,empty,CD-0722-4
"A7,D9",4455,4894,3304,1590,2583,1229,0,1232,826,406,2.034482759,712,1702,440,179,178,1,47,1,0.06741573,0,empty,CD-0722-4
"A7,D10",8347,9317,6131,3186,4828,2400,0,2408,1525,883,1.727066818,1371,2357,186,93,92,1,29,1,0.119565217,0,empty,CD-0722-4
"A7,D11",644494,778604,444716,333888,387510,256193,5,256387,179855,76532,2.350062719,152787,8803,1994,570,567,3,155,2,0.044091711,0,hg38,CD-0722-4
"A7,D12",13144,14504,9725,4779,7599,3901,1,3911,2571,1340,1.918656716,2215,5120,1447,599,592,7,155,2,0.08277027,0,empty,CD-0722-4
"A7,E1",14855,16171,10973,5198,8345,4188,0,4193,2605,1588,1.640428212,2318,3868,1054,378,371,7,88,2,0.078167116,0,empty,CD-0722-4
"A7,E2",9790,11054,7200,3854,5760,2905,9,2919,1853,1066,1.738273921,1730,1598,288,142,140,2,45,1,0.114285714,0,empty,CD-0722-4
"A7,E3",6748,7630,5101,2529,3982,1949,27,1976,1294,682,1.897360704,1122,2441,609,243,239,4,63,2,0.058577406,0,empty,CD-0722-4
"A7,E4",9053,9704,6667,3037,5042,2467,46,2513,1619,894,1.810961969,1359,2991,602,249,243,6,74,2,0.004115226,0,empty,CD-0722-4
"A7,E5",8097,8871,6262,2609,4517,2106,1,2111,1361,750,1.814666667,1157,1433,340,126,122,4,42,2,0.032786885,0,empty,CD-0722-4
"A7,E6",14346,15674,10616,5058,8137,4049,5,4066,2560,1506,1.699867198,2292,3728,908,384,380,4,113,2,0.018421053,0,empty,CD-0722-4
"A7,E7",779503,872287,587883,284404,424389,212652,0,212873,161687,51186,3.158812957,123055,165971,23504,9180,9000,180,1360,4,0.049,0,hg38,CD-0722-4
"A7,E8",10824,11862,8243,3619,6094,2837,0,2842,1899,943,2.01378579,1559,3294,698,258,255,3,76,2,0.019607843,0,empty,CD-0722-4
"A7,E9",6390,6869,4776,2093,3584,1724,0,1726,1108,618,1.792880259,959,2992,711,285,280,5,69,1,0.15,0,empty,CD-0722-4
"A7,E10",8011,8645,6185,2460,4441,2047,1,2048,1337,711,1.88045007,1089,2142,415,183,180,3,54,2,0.088888889,0,empty,CD-0722-4
"A7,E11",9450,10425,7051,3374,5409,2729,13,2744,1729,1015,1.703448276,1544,2280,544,234,232,2,58,2,0.107758621,0,empty,CD-0722-4
"A7,E12",9962,11014,7520,3494,5618,2722,0,2725,1754,971,1.80638517,1563,2023,502,169,167,2,55,2,0.131736527,0,empty,CD-0722-4
"A7,F1",31956,34165,24173,9992,16987,7829,14,7850,5520,2330,2.369098712,4362,6171,1651,614,604,10,147,2,0.023178808,0,empty,CD-0722-4
"A7,F2",9486,10352,7030,3322,5310,2576,4,2580,1700,880,1.931818182,1471,3442,968,330,325,5,79,3,0.073846154,0,empty,CD-0722-4
"A7,F3",9138,10328,6807,3521,5391,2688,19,2708,1813,895,2.025698324,1609,2973,669,278,274,4,93,1,0.062043796,0,empty,CD-0722-4
"A7,F4",14062,14923,10318,4605,8029,3907,0,3917,2607,1310,1.990076336,2191,838,163,78,78,0,28,0,0.102564103,0,empty,CD-0722-4
"A7,F5",11272,12112,8541,3571,6224,2934,0,2937,1935,1002,1.931137725,1588,2625,429,183,181,2,52,1,0.099447514,0,empty,CD-0722-4
"A7,F6",11571,12610,8515,4095,6505,3284,0,3286,2181,1105,1.973755656,1859,4083,864,363,360,3,106,2,0.113888889,0,empty,CD-0722-4
"A7,F7",12267,13788,9160,4628,7188,3567,3,3578,2287,1291,1.771494965,2092,1391,342,138,137,1,45,1,0.065693431,0,empty,CD-0722-4
"A7,F8",8414,9240,6312,2928,4879,2401,5,2406,1588,818,1.941320293,1363,308,44,30,29,1,19,1,0.068965517,0,empty,CD-0722-4
"A7,F9",9229,9993,7017,2976,5241,2490,0,2494,1648,846,1.947990544,1375,3100,643,254,253,1,82,1,0.015810277,0,empty,CD-0722-4
"A7,F10",12083,13122,9140,3982,6748,3172,0,3176,2082,1094,1.903107861,1764,2505,613,264,262,2,69,1,0.083969466,0,empty,CD-0722-4
"A7,F11",8979,9401,6744,2657,5034,2303,0,2314,1525,789,1.932826362,1252,2202,318,190,187,3,52,2,0.042780749,0,empty,CD-0722-4
"A7,F12",1003047,1204612,721955,482657,579274,339012,2,339261,268374,70887,3.785941005,207899,11586,2072,805,788,17,178,3,0.043147208,0,hg38,CD-0722-4
"A7,G1",11893,12980,9033,3947,6649,3203,1,3207,2040,1167,1.748071979,1740,2722,571,241,235,6,70,2,0.089361702,0,empty,CD-0722-4
"A7,G2",6417,6924,4574,2350,3598,1827,33,1862,1244,618,2.012944984,1051,485,122,56,55,1,13,1,0.036363636,0,empty,CD-0722-4
"A7,G3",12625,13739,9443,4296,7030,3539,9,3554,2119,1435,1.476655052,1917,2647,678,285,283,2,60,2,0.272084806,0,empty,CD-0722-4
"A7,G4",1103545,1215131,850048,365083,586646,284685,2,284979,212868,72111,2.951949079,159213,1776,214,98,94,4,26,2,0,0,empty,CD-0722-4
"A7,G5",7391,8306,5391,2915,4255,2174,0,2176,1375,801,1.716604245,1270,1634,330,144,142,2,53,1,0.014084507,0,empty,CD-0722-4
"A7,G6",11032,11931,8183,3748,6296,3024,1,3026,2006,1020,1.966666667,1710,418,34,16,16,0,7,0,0,0,empty,CD-0722-4
"A7,G7",9064,9792,6868,2924,5087,2345,4,2354,1561,793,1.968474149,1255,2734,774,297,293,4,80,2,0.013651877,0,empty,CD-0722-4
"A7,G8",6421,6965,4793,2172,3810,1883,0,1885,1190,695,1.712230216,1065,2047,412,153,151,2,61,2,0.052980132,0,empty,CD-0722-4
"A7,G9",740758,845804,551521,294283,416385,221139,10,221387,168173,53214,3.160314955,129872,126095,20435,8081,7931,150,1215,5,0.053713277,0,hg38,CD-0722-4
"A7,G10",9328,10398,6934,3464,5522,2840,0,2841,1803,1038,1.73699422,1604,2579,620,253,252,1,72,1,0.099206349,0,empty,CD-0722-4
"A7,G11",9271,9800,6932,2868,5077,2324,9,2336,1573,763,2.061598952,1238,1710,368,141,140,1,43,1,0.035714286,0,empty,CD-0722-4
"A7,G12",7506,8694,5472,3222,4483,2314,0,2314,1480,834,1.774580336,1353,2001,384,172,171,1,46,1,0.140350877,0,empty,CD-0722-4
"A7,H1",8213,8992,6128,2864,4660,2223,9,2234,1503,731,2.056087551,1234,1652,436,185,182,3,46,2,0.016483516,0,empty,CD-0722-4
"A7,H2",817109,1008108,542083,466025,502056,347584,2,347840,238980,108860,2.195296711,214653,9809,1321,475,467,8,110,2,0.12633833,0,hg38,CD-0722-4
"A7,H3",7904,8733,5629,3104,4601,2317,20,2339,1571,768,2.045572917,1341,1994,451,162,161,1,48,1,0.198757764,0,empty,CD-0722-4
"A7,H4",11435,12491,8490,4001,6465,3157,5,3166,2105,1061,1.98397738,1822,143,17,9,9,0,7,0,0,0,empty,CD-0722-4
"A7,H5",3759300,4431777,2797981,1633796,2024975,1175987,9,1177064,974154,202910,4.800916663,700437,265038,59727,23082,22833,249,2876,5,0.051504402,0,hg38,CD-0722-4
"A7,H6",7033,7650,5087,2563,3952,2010,0,2014,1301,713,1.824684432,1129,2033,528,225,223,2,69,2,0.080717489,0,empty,CD-0722-4
"A7,H7",899022,997484,684915,312569,490071,241651,3,241935,183845,58090,3.164830436,136889,155468,25606,9714,9565,149,1451,8,0.060010455,0,hg38,CD-0722-4
"A7,H8",9950,11174,7442,3732,5621,2937,0,2940,1853,1087,1.704691812,1637,2996,557,263,254,9,101,2,0.05511811,0,empty,CD-0722-4
"A7,H9",8726,9491,6625,2866,4893,2372,0,2373,1593,780,2.042307692,1264,1545,549,230,224,6,47,1,0.183035714,0,empty,CD-0722-4
"A7,H10",7492,8078,5562,2516,4091,1994,0,1996,1329,667,1.992503748,1095,1431,366,146,146,0,42,0,0.006849315,0,empty,CD-0722-4
"A7,H11",8794,10358,5961,4397,5394,3377,0,3381,1846,1535,1.202605863,2108,120,54,15,15,0,2,0,0.333333333,0,empty,CD-0722-4
"A7,H12",1717551,1964797,1270261,694536,951211,516687,11,517116,399568,117548,3.399190118,306624,340860,38682,15256,14800,456,2110,9,0.060675676,0,hg38,CD-0722-4
"A8,A1",6600,7316,4870,2446,3869,2032,19,2053,1311,742,1.766846361,1182,1448,474,173,171,2,40,1,0.122807018,0,empty,CD-0722-4
"A8,A2",9314,10251,6893,3358,5404,2742,1,2751,1732,1019,1.699705594,1513,1810,426,162,158,4,42,2,0.088607595,0,empty,CD-0722-4
"A8,A3",5952,6737,4243,2494,3581,1841,0,1844,1240,604,2.052980132,1093,1191,234,116,110,6,36,2,0.172727273,0,empty,CD-0722-4
"A8,A4",11301,12514,8470,4044,6479,3259,0,3260,2059,1201,1.714404663,1802,911,149,58,55,3,16,1,0,0,empty,CD-0722-4
"A8,A5",9320,9915,6863,3052,5251,2539,11,2554,1642,912,1.800438596,1414,3913,773,299,297,2,69,1,0.067340067,0,empty,CD-0722-4
"A8,A6",678013,795287,512210,283077,396532,210533,0,210708,163164,47544,3.4318526,124282,206147,27443,10793,10536,257,1598,9,0.067008352,0,hg38,CD-0722-4
"A8,A7",6393,7100,4739,2361,3698,1839,0,1840,1150,690,1.666666667,1037,1517,398,118,118,0,35,0,0,0,empty,CD-0722-4
"A8,A8",4071,4637,3013,1624,2387,1192,14,1208,832,376,2.212765957,698,2238,559,202,200,2,54,2,0.155,0,empty,CD-0722-4
"A8,A9",6533,7512,4909,2603,3880,1834,15,1852,1209,643,1.880248834,1091,1963,461,215,210,5,56,2,0.033333333,0,empty,CD-0722-4
"A8,A10",7512,7993,5755,2238,4196,1992,0,1992,1268,724,1.751381215,1053,491,155,45,45,0,15,0,0.177777778,0,empty,CD-0722-4
"A8,A11",5727,6321,4406,1915,3365,1583,1,1586,1049,537,1.953445065,845,1696,452,171,166,5,46,1,0.012048193,0,empty,CD-0722-4
"A8,A12",8245,9284,6177,3107,4796,2363,0,2367,1532,835,1.834730539,1372,4047,715,317,311,6,79,2,0.045016077,0,empty,CD-0722-4
"A8,B1",7241,7972,5360,2612,4196,2134,0,2137,1369,768,1.782552083,1229,1507,381,138,136,2,37,1,0.044117647,0,empty,CD-0722-4
"A8,B2",8014,8644,5563,3081,4579,2401,1,2403,1521,882,1.724489796,1383,694,109,42,42,0,16,0,0,0,empty,CD-0722-4
"A8,B3",5639,6199,4195,2004,3390,1713,0,1713,1073,640,1.6765625,972,1877,392,138,137,1,46,1,0.04379562,0,empty,CD-0722-4
"A8,B4",12173,13634,8916,4718,7087,3740,0,3743,2539,1204,2.108803987,2198,1752,217,106,104,2,34,1,0.230769231,0,empty,CD-0722-4
"A8,B5",7065,4236,2679,1557,2805,1496,1,1507,959,548,1.75,937,1381,236,76,76,0,34,0,0,0,empty,CD-0722-4
"A8,B6",8066,8885,5808,3077,4753,2581,3,2588,1560,1028,1.517509728,1511,2482,667,253,252,1,51,1,0.146825397,0,empty,CD-0722-4
"A8,B7",7710,8668,5738,2930,4634,2328,0,2333,1498,835,1.794011976,1340,1890,422,163,163,0,40,0,0.012269939,0,empty,CD-0722-4
"A8,B8",6308,6975,4593,2382,3618,1817,8,1826,1189,637,1.866562009,1054,1348,234,112,110,2,29,2,0.036363636,0,empty,CD-0722-4
"A8,B9",9720,10919,7079,3840,5740,2950,0,2950,1825,1125,1.622222222,1732,1130,340,148,146,2,38,2,0.02739726,0,empty,CD-0722-4
"A8,B10",4887,5395,3625,1770,2900,1382,10,1396,890,506,1.758893281,815,441,119,45,45,0,15,0,0.355555556,0,empty,CD-0722-4
"A8,B11",11364,12545,8251,4294,6422,3393,22,3416,1951,1465,1.331740614,1918,296,15,11,11,0,10,0,0.090909091,0,empty,CD-0722-4
"A8,B12",6225,6920,4610,2310,3607,1833,6,1841,1194,647,1.845440495,1038,2108,487,199,195,4,43,1,0.025641026,0,empty,CD-0722-4
"A8,C1",13623,14436,10188,4248,7739,3592,0,3595,2324,1271,1.828481511,1936,1317,400,147,146,1,39,1,0.109589041,0,empty,CD-0722-4
"A8,C2",10696,11649,7880,3769,6063,3018,0,3020,1989,1031,1.929194956,1663,2423,739,302,298,4,60,2,0.05704698,0,empty,CD-0722-4
"A8,C3",11098,12127,8361,3766,6454,3103,1,3111,1949,1162,1.677280551,1736,1193,306,75,74,1,22,1,0.040540541,0,empty,CD-0722-4
"A8,C4",6839,7277,5188,2089,3869,1744,6,1752,1130,622,1.816720257,987,1891,373,163,161,2,53,1,0.031055901,0,empty,CD-0722-4
"A8,C5",932543,1135759,663064,472695,566603,340641,1,340922,270303,70619,3.827624294,211426,23773,9876,3738,3731,7,744,3,0.045296167,0,hg38,CD-0722-4
"A8,C6",8068,8792,6004,2788,4784,2384,1,2389,1588,801,1.982521848,1338,1905,400,151,148,3,43,1,0,0,empty,CD-0722-4
"A8,C7",11148,12855,8024,4831,6723,3714,0,3715,2173,1542,1.40920882,2206,263,43,21,21,0,7,0,0,0,empty,CD-0722-4
"A8,C8",11798,13216,8729,4487,6963,3523,1,3536,2331,1205,1.934439834,2013,3740,834,339,337,2,95,2,0.023738872,0,empty,CD-0722-4
"A8,C9",8490,9385,6272,3113,4870,2359,0,2372,1520,852,1.784037559,1329,1897,296,129,128,1,42,1,0.0234375,0,empty,CD-0722-4
"A8,C10",10084,10798,7571,3227,5570,2675,0,2682,1739,943,1.844114528,1422,2070,377,159,158,1,48,1,0.139240506,0,empty,CD-0722-4
"A8,C11",8656,9747,6378,3369,5203,2568,0,2573,1627,946,1.71987315,1515,1762,434,202,201,1,67,1,0.044776119,0,empty,CD-0722-4
"A8,C12",15791,17333,11701,5632,9064,4630,8,4645,3001,1644,1.825425791,2640,2317,590,225,224,1,49,1,0.053571429,0,empty,CD-0722-4
"A8,D1",12086,13499,8770,4729,7139,3709,0,3714,2318,1396,1.660458453,2167,1196,180,69,67,2,23,1,0.164179104,0,empty,CD-0722-4
"A8,D2",847142,930639,656888,273751,461933,218574,55,218831,173518,45313,3.829320504,120565,222399,32568,12753,12503,250,1881,10,0.038470767,0,hg38,CD-0722-4
"A8,D3",7687,8311,5735,2576,4402,2218,0,2219,1499,720,2.081944444,1192,1358,351,145,140,5,38,2,0.057142857,0,empty,CD-0722-4
"A8,D4",5800,6502,4303,2199,3517,1739,0,1747,1129,618,1.826860841,1032,1792,412,161,156,5,37,2,0.038461538,0,empty,CD-0722-4
"A8,D5",6810,7687,5045,2642,4034,2069,0,2072,1296,776,1.670103093,1202,1828,388,150,146,4,39,2,0.02739726,0,empty,CD-0722-4
"A8,D6",10844,12072,7820,4252,6364,3396,0,3399,2028,1371,1.479212254,1983,2296,404,175,174,1,47,1,0.212643678,0,empty,CD-0722-4
"A8,D7",6208,6660,4612,2048,3409,1568,0,1568,1025,543,1.887661142,890,2319,489,195,188,7,54,2,0.207446809,0,empty,CD-0722-4
"A8,D8",7110,7759,5159,2600,4152,2005,0,2007,1260,747,1.686746988,1203,1317,344,120,117,3,29,2,0.051282051,0,empty,CD-0722-4
"A8,D9",3628,3933,2712,1221,2092,1000,5,1006,697,309,2.25566343,540,1782,539,200,199,1,40,1,0.095477387,0,empty,CD-0722-4
"A8,D10",7381,8246,5370,2876,4379,2221,0,2222,1399,823,1.699878493,1319,1157,227,70,69,1,19,1,0.101449275,0,empty,CD-0722-4
"A8,D11",8247,8838,6345,2493,4671,2167,0,2169,1385,784,1.766581633,1193,3063,657,268,266,2,65,2,0.030075188,0,empty,CD-0722-4
"A8,D12",10063,11046,7503,3543,5745,2833,1,2834,1814,1020,1.778431373,1513,3197,975,357,354,3,101,3,0.014124294,0,empty,CD-0722-4
"A8,E1",12482,13751,9060,4691,7180,3774,0,3776,2372,1404,1.689458689,2188,2751,495,226,224,2,54,2,0.084821429,0,empty,CD-0722-4
"A8,E2",9333,10105,6726,3379,5243,2622,4,2627,1680,947,1.774023231,1482,2317,539,237,237,0,54,0,0.042194093,0,empty,CD-0722-4
"A8,E3",6337,7136,4840,2296,3711,1773,1,1776,1184,592,2,981,2293,744,282,277,5,77,2,0.0433213,0,empty,CD-0722-4
"A8,E4",8065,9043,5837,3206,4842,2456,2,2462,1559,903,1.726467331,1468,2543,567,245,239,6,62,2,0.079497908,0,empty,CD-0722-4
"A8,E5",1142195,1328591,846474,482117,651560,363351,0,363678,314523,49155,6.398596277,212649,84511,15747,6258,6174,84,1114,4,0.040492387,0,hg38,CD-0722-4
"A8,E6",13335,14611,9821,4790,7539,3731,0,3733,2393,1340,1.785820896,2132,4763,1042,405,398,7,99,2,0.072864322,0,empty,CD-0722-4
"A8,E7",12211,13160,9132,4028,6805,3242,0,3247,2147,1100,1.951818182,1754,3062,785,272,270,2,76,2,0.133333333,0,empty,CD-0722-4
"A8,E8",11012,11844,8442,3402,6273,2898,0,2903,1911,992,1.92641129,1573,3680,926,356,347,9,75,2,0.043227666,0,empty,CD-0722-4
"A8,E9",836642,974669,618649,356020,485660,267026,2,267280,215228,52052,4.134865135,158798,149977,19736,7476,7314,162,1281,11,0.036231884,0,hg38,CD-0722-4
"A8,E10",739716,797807,574519,223288,394369,180747,10,180951,140241,40710,3.444878408,99683,49879,7310,2692,2638,54,592,4,0.014783927,0,hg38,CD-0722-4
"A8,E11",8735,9393,6529,2864,4931,2437,0,2441,1571,870,1.805747126,1302,2146,446,150,149,1,40,1,0.073825503,0,empty,CD-0722-4
"A8,E12",8742,9557,6466,3091,5039,2415,18,2436,1479,957,1.545454545,1393,1821,489,208,207,1,49,1,0.082125604,0,empty,CD-0722-4
"A8,F1",11415,12446,8478,3968,6486,3141,14,3162,1994,1168,1.707191781,1836,2612,477,220,218,2,69,1,0.068807339,0,empty,CD-0722-4
"A8,F2",8534,9344,6253,3091,4836,2318,0,2324,1472,852,1.727699531,1332,2878,840,296,294,2,77,2,0.047619048,0,empty,CD-0722-4
"A8,F3",8171,8701,6113,2588,4684,2231,0,2234,1467,767,1.912646675,1222,2684,637,271,266,5,67,2,0.127819549,0,empty,CD-0722-4
"A8,F4",12742,13727,9461,4266,7298,3505,0,3508,2328,1180,1.972881356,1956,526,146,49,49,0,17,0,0.040816327,0,empty,CD-0722-4
"A8,F5",10742,11488,7993,3495,5969,2822,18,2840,1870,970,1.927835052,1601,2586,538,212,211,1,47,1,0.151658768,0,empty,CD-0722-4
"A8,F6",9318,10169,6962,3207,5317,2680,20,2701,1783,918,1.942265795,1508,4124,1100,374,369,5,84,2,0.089430894,0,empty,CD-0722-4
"A8,F7",1214960,1432923,890240,542683,713909,409809,4,410209,334191,76018,4.396208793,242730,84243,9080,3650,3528,122,731,6,0.018707483,0,hg38,CD-0722-4
"A8,F8",7873,8795,5962,2833,4547,2169,17,2189,1434,755,1.899337748,1216,246,22,12,12,0,10,0,0.166666667,0,empty,CD-0722-4
"A8,F9",8810,9590,6598,2992,5113,2427,0,2435,1625,810,2.00617284,1372,3362,762,295,295,0,73,0,0.06440678,0,empty,CD-0722-4
"A8,F10",1197303,1374826,889875,484951,673754,364556,6,364890,297781,67109,4.437273689,211005,123935,23560,8654,8531,123,1418,5,0.049114992,0,hg38,CD-0722-4
"A8,F11",8113,8723,6227,2496,4620,2095,10,2108,1368,740,1.848648649,1173,1762,331,127,127,0,33,0,0.039370079,0,empty,CD-0722-4
"A8,F12",9415,10308,7073,3235,5282,2551,0,2554,1655,899,1.840934372,1448,335,114,39,39,0,8,0,0,0,empty,CD-0722-4
"A8,G1",10769,11466,8170,3296,6071,2837,0,2838,1828,1010,1.80990099,1544,3048,727,287,286,1,64,1,0.08041958,0,empty,CD-0722-4
"A8,G2",11029,12499,7671,4828,6376,3646,6,3653,2317,1336,1.734281437,2099,531,98,41,41,0,12,0,0.024390244,0,empty,CD-0722-4
"A8,G3",10995,11279,8190,3089,6029,2906,14,2922,1770,1152,1.536458333,1512,2378,621,244,241,3,65,2,0.082987552,0,empty,CD-0722-4
"A8,G4",1098739,1200907,849866,351041,587349,282081,0,282354,221248,61106,3.620724642,156260,901,173,65,65,0,18,0,0,0,empty,CD-0722-4
"A8,G5",6913,7469,5039,2430,3991,1964,10,1974,1224,750,1.632,1141,1950,523,205,198,7,51,1,0.035353535,0,empty,CD-0722-4
"A8,G6",10618,11561,8065,3496,5912,2825,0,2827,1867,960,1.944791667,1548,194,21,9,9,0,4,0,0,0,empty,CD-0722-4
"A8,G7",8686,9186,6613,2573,4943,2205,54,2260,1508,752,2.005319149,1232,3302,734,305,303,2,68,2,0.0330033,0,empty,CD-0722-4
"A8,G8",5781,6254,4191,2063,3328,1615,3,1619,1088,531,2.048964218,915,1896,535,221,220,1,58,1,0.104545455,0,empty,CD-0722-4
"A8,G9",12056,13919,8559,5360,7156,4020,1,4024,2724,1300,2.095384615,2374,2972,536,199,194,5,56,2,0.030927835,0,empty,CD-0722-4
"A8,G10",1454107,1556683,1127600,429083,764654,360057,1,360404,290862,69542,4.182537172,196377,82333,12167,4386,4312,74,868,4,0.027597403,0,hg38,CD-0722-4
"A8,G11",9174,10007,6975,3032,5260,2468,0,2470,1654,816,2.026960784,1420,2109,474,207,207,0,57,0,0,0,empty,CD-0722-4
"A8,G12",7135,7707,5272,2435,4105,2056,0,2058,1295,763,1.697247706,1171,2584,566,206,202,4,52,3,0.133663366,0,empty,CD-0722-4
"A8,H1",6766,7339,5063,2276,3971,1883,13,1898,1214,684,1.774853801,1077,1068,203,98,96,2,29,2,0.114583333,0,empty,CD-0722-4
"A8,H2",8837,9609,6432,3177,5080,2551,12,2566,1677,889,1.886389201,1440,2664,662,260,257,3,53,2,0.054474708,0,empty,CD-0722-4
"A8,H3",6861,7447,5045,2402,3967,1944,0,1952,1255,697,1.800573888,1116,2000,485,208,206,2,38,1,0.072815534,0,empty,CD-0722-4
"A8,H4",10613,11579,7874,3705,6071,3031,0,3035,1919,1116,1.71953405,1695,196,5,3,3,0,3,0,0,0,empty,CD-0722-4
"A8,H5",13267,14552,9614,4938,7493,3820,4,3829,2496,1333,1.872468117,2175,2894,756,286,280,6,52,2,0.05,0,empty,CD-0722-4
"A8,H6",6570,7283,4799,2484,3728,1869,0,1869,1201,668,1.797904192,1063,2270,461,209,209,0,56,0,0.062200957,0,empty,CD-0722-4
"A8,H7",7685,8141,5665,2476,4429,2092,0,2098,1348,750,1.797333333,1198,2184,423,177,170,7,47,2,0.047058824,0,empty,CD-0722-4
"A8,H8",16612,18873,12230,6643,9814,5062,0,5070,3654,1416,2.580508475,3036,3170,778,359,356,3,89,2,0.025280899,0,empty,CD-0722-4
"A8,H9",6810,7512,5114,2398,3881,1836,2,1838,1188,650,1.827692308,1074,1572,434,167,164,3,35,1,0.079268293,0,empty,CD-0722-4
"A8,H10",14544,16250,11006,5244,8146,4029,0,4037,2972,1065,2.790610329,2280,3471,550,188,185,3,54,1,0.151351351,0,empty,CD-0722-4
"A8,H11",7977,8898,5597,3301,4738,2769,3,2772,1488,1284,1.158878505,1657,43,32,13,13,0,2,0,0,0,empty,CD-0722-4
"A8,H12",6082,6653,4452,2201,3487,1772,0,1775,1137,638,1.782131661,1016,1452,341,146,145,1,37,1,0.137931034,0,empty,CD-0722-4
"A9,A1",6688,7280,4922,2358,3794,1923,0,1929,1234,695,1.775539568,1104,1239,288,124,122,2,35,1,0.098360656,0,empty,CD-0722-4
"A9,A2",10119,10640,7414,3226,5597,2821,0,2823,1795,1028,1.746108949,1499,2078,591,210,205,5,42,2,0.024390244,0,empty,CD-0722-4
"A9,A3",6516,7000,4882,2118,3593,1716,0,1716,1090,626,1.741214058,940,1220,213,84,84,0,27,0,0.047619048,0,empty,CD-0722-4
"A9,A4",12174,13282,9014,4268,6628,3181,33,3217,2069,1148,1.802264808,1769,1157,283,96,95,1,19,1,0.189473684,0,empty,CD-0722-4
"A9,A5",2626366,2992618,1936325,1056293,1416972,798315,5,799000,661622,137378,4.816069531,467765,295416,41604,16643,16273,370,2322,9,0.021385116,0,hg38,CD-0722-4
"A9,A6",1474358,1753198,1105989,647209,845148,468847,21,469276,385510,83766,4.602225247,278093,357888,63218,24683,24296,387,2957,8,0.069311821,0,hg38,CD-0722-4
"A9,A7",6955,8053,5105,2948,4146,2219,0,2219,1353,866,1.562355658,1336,1669,323,116,115,1,38,1,0.008695652,0,empty,CD-0722-4
"A9,A8",1431929,1705167,1061386,643781,831741,475290,11,475670,380816,94854,4.014759525,283160,251553,44958,17550,17294,256,2420,9,0.04186423,0,hg38,CD-0722-4
"A9,A9",6939,7800,5151,2649,3994,1945,0,1945,1228,717,1.712691771,1109,2141,563,172,171,1,52,1,0.035087719,0,empty,CD-0722-4
"A9,A10",7643,7984,5831,2153,4153,1972,0,1972,1272,700,1.817142857,1010,408,155,37,35,2,11,1,0,0,empty,CD-0722-4
"A9,A11",6417,6937,4932,2005,3695,1712,0,1715,1165,550,2.118181818,914,2091,549,205,205,0,54,0,0.053658537,0,empty,CD-0722-4
"A9,A12",8898,9605,6759,2846,4902,2320,1,2323,1496,827,1.808948005,1290,3481,940,368,367,1,90,1,0.065395095,0,empty,CD-0722-4
"A9,B1",7830,8610,5843,2767,4433,2192,6,2205,1376,829,1.659831122,1249,1335,317,148,148,0,44,0,0.060810811,0,empty,CD-0722-4
"A9,B2",8899,9757,6104,3653,5031,2655,18,2678,1646,1032,1.59496124,1599,650,82,35,35,0,11,0,0.314285714,0,empty,CD-0722-4
"A9,B3",6377,7243,4717,2526,3767,1946,10,1956,1224,732,1.672131148,1178,1272,349,141,136,5,35,1,0.110294118,0,empty,CD-0722-4
"A9,B4",6917,7884,5043,2841,4082,2132,1,2135,1350,785,1.719745223,1263,1382,459,155,155,0,40,0,0.122580645,0,empty,CD-0722-4
"A9,B5",9310,6788,4282,2506,4173,2241,0,2255,1593,662,2.406344411,1382,1093,172,57,57,0,23,0,0.052631579,0,empty,CD-0722-4
"A9,B6",8148,9459,5945,3514,4773,2512,0,2514,1548,966,1.602484472,1486,1846,341,124,122,2,40,2,0,0,empty,CD-0722-4
"A9,B7",8263,8991,6298,2693,4654,2234,0,2235,1463,772,1.89507772,1244,1454,361,135,127,8,40,1,0,0,empty,CD-0722-4
"A9,B8",464604,507254,359100,148154,249403,116791,3,116916,94452,22464,4.204594017,64624,22708,5347,1931,1887,44,386,3,0.009009009,0,hg38,CD-0722-4
"A9,B9",10529,11468,7532,3936,6022,3158,0,3168,1986,1182,1.680203046,1830,1199,354,99,96,3,29,2,0.239583333,0,empty,CD-0722-4
"A9,B10",719938,774130,504980,269150,404333,210454,10,211048,169292,41756,4.054315547,124277,39460,5609,2271,2223,48,434,3,0.058479532,0,hg38,CD-0722-4
"A9,B11",11623,13014,8332,4682,6630,3582,13,3599,2051,1548,1.324935401,2079,255,22,14,14,0,5,0,0,0,empty,CD-0722-4
"A9,B12",6545,7058,4829,2229,3763,1805,0,1805,1142,663,1.722473605,1028,1751,469,203,203,0,46,0,0.197044335,0,empty,CD-0722-4
"A9,C1",40376,42198,32787,9411,20379,7845,5,7863,4540,3323,1.36623533,4094,1366,260,115,114,1,34,1,0.052631579,0,empty,CD-0722-4
"A9,C2",11630,12860,8415,4445,6614,3400,0,3404,2147,1257,1.708035004,2019,2426,653,268,267,1,78,1,0.003745318,0,empty,CD-0722-4
"A9,C3",11722,12385,8739,3646,6608,3163,0,3166,2019,1147,1.760244115,1728,1084,261,94,93,1,20,1,0,0,empty,CD-0722-4
"A9,C4",7287,7912,5487,2425,4088,1904,25,1930,1265,665,1.902255639,1059,1682,506,220,219,1,49,1,0.127853881,0,empty,CD-0722-4
"A9,C5",10168,11173,7626,3547,5806,2879,24,2906,1785,1121,1.592328278,1638,1727,439,172,168,4,41,1,0.232142857,0,empty,CD-0722-4
"A9,C6",9287,9892,6889,3003,5248,2538,2,2542,1602,940,1.704255319,1405,1759,401,172,171,1,55,1,0.081871345,0,empty,CD-0722-4
"A9,C7",11780,13494,8350,5144,6891,3866,0,3868,2223,1645,1.351367781,2288,374,136,63,62,1,20,1,0,0,empty,CD-0722-4
"A9,C8",12850,14212,9522,4690,7213,3621,0,3626,2342,1284,1.823987539,2045,3196,1076,336,330,6,73,2,0.042424242,0,empty,CD-0722-4
"A9,C9",9172,10168,6771,3397,5305,2655,0,2655,1715,940,1.824468085,1600,1990,337,155,154,1,51,1,0.149350649,0,empty,CD-0722-4
"A9,C10",10647,11868,7929,3939,6149,3147,0,3147,2005,1142,1.755691769,1792,1857,408,181,180,1,45,1,0.011111111,0,empty,CD-0722-4
"A9,C11",834555,917389,622285,295104,450304,230077,4,230281,185948,44333,4.194347326,131745,56347,9110,3370,3289,81,651,7,0.028276072,0,hg38,CD-0722-4
"A9,C12",1056238,1179982,807222,372760,564085,277230,1,277571,213113,64458,3.306230414,156875,43067,13391,5181,5148,33,884,5,0.035742036,0,hg38,CD-0722-4
"A9,D1",11092,12097,7989,4108,6376,3259,0,3264,1950,1314,1.484018265,1880,879,123,62,62,0,22,0,0.032258065,0,empty,CD-0722-4
"A9,D2",9976,10656,7453,3203,5473,2529,0,2529,1631,898,1.816258352,1352,2905,753,348,339,9,73,2,0.026548673,0,empty,CD-0722-4
"A9,D3",8177,8972,5977,2995,4726,2417,0,2419,1577,842,1.872921615,1357,1746,412,133,133,0,47,0,0.142857143,0,empty,CD-0722-4
"A9,D4",6055,6872,4576,2296,3588,1737,6,1745,1100,645,1.705426357,1010,1182,242,115,113,2,33,2,0.14159292,0,empty,CD-0722-4
"A9,D5",7011,7714,5244,2470,3978,1929,0,1929,1233,696,1.771551724,1066,1720,297,124,123,1,35,1,0.032520325,0,empty,CD-0722-4
"A9,D6",11838,12973,8499,4474,6605,3478,0,3485,2182,1303,1.674597084,2010,2190,557,227,225,2,64,2,0.062222222,0,empty,CD-0722-4
"A9,D7",6237,6633,4730,1903,3450,1579,0,1579,975,604,1.614238411,836,2430,525,204,195,9,63,2,0.066666667,0,empty,CD-0722-4
"A9,D8",7681,8310,5685,2625,4176,1974,0,1974,1219,755,1.614569536,1067,1582,478,160,155,5,44,1,0.032258065,0,empty,CD-0722-4
"A9,D9",5065,5681,3764,1917,2936,1454,13,1467,1003,464,2.161637931,855,1420,366,144,142,2,35,1,0.070422535,0,empty,CD-0722-4
"A9,D10",7555,8393,5573,2820,4361,2239,8,2251,1423,828,1.718599034,1295,1352,188,82,80,2,22,2,0.0125,0,empty,CD-0722-4
"A9,D11",7826,8428,5857,2571,4502,2173,0,2174,1439,735,1.957823129,1193,2796,1008,410,409,1,74,1,0.009779951,0,empty,CD-0722-4
"A9,D12",11078,12260,8272,3988,6272,3064,0,3065,1994,1071,1.861811391,1733,4055,1220,471,467,4,130,2,0.08137045,0,empty,CD-0722-4
"A9,E1",13152,14524,9674,4850,7501,3723,0,3728,2317,1411,1.642097803,2199,2647,508,202,200,2,61,2,0.06,0,empty,CD-0722-4
"A9,E2",9704,10571,7117,3454,5492,2764,6,2772,1703,1069,1.593077643,1542,2499,559,204,200,4,43,2,0.07,0,empty,CD-0722-4
"A9,E3",6526,7083,4941,2142,3683,1695,14,1710,1134,576,1.96875,920,2534,652,298,294,4,69,2,0.12244898,0,empty,CD-0722-4
"A9,E4",8955,10060,6732,3328,5205,2501,0,2502,1557,945,1.647619048,1454,3269,683,304,303,1,67,1,0.105610561,0,empty,CD-0722-4
"A9,E5",8047,8737,6158,2579,4556,2080,0,2082,1345,737,1.824966079,1176,1320,264,117,117,0,38,0,0,0,empty,CD-0722-4
"A9,E6",13918,14948,10322,4626,7689,3884,0,3888,2449,1439,1.701876303,2152,4466,1159,515,510,5,132,3,0.009803922,0,empty,CD-0722-4
"A9,E7",13878,14994,10577,4417,7689,3657,0,3663,2439,1224,1.992647059,1961,3640,729,300,292,8,81,2,0.061643836,0,empty,CD-0722-4
"A9,E8",10551,11292,8100,3192,5898,2627,43,2676,1726,950,1.816842105,1475,3107,710,319,311,8,74,3,0.1414791,0,empty,CD-0722-4
"A9,E9",782593,928076,571112,356964,451630,257748,1,257945,209347,48598,4.307728713,153838,245068,28929,11783,11523,260,1903,8,0.043217912,0,hg38,CD-0722-4
"A9,E10",784729,952336,541058,411278,467365,304485,1,304726,219531,85195,2.576806151,185595,3547,720,247,242,5,68,2,0.08677686,0,hg38,CD-0722-4
"A9,E11",9032,9744,6698,3046,4946,2429,0,2435,1557,878,1.773348519,1307,1822,515,195,193,2,44,1,0.098445596,0,empty,CD-0722-4
"A9,E12",9286,10176,6900,3276,5297,2591,0,2594,1601,993,1.612286002,1487,1702,410,184,182,2,55,2,0.087912088,0,empty,CD-0722-4
"A9,F1",11769,12581,8682,3899,6432,3139,0,3147,2030,1117,1.81736795,1686,2337,504,221,219,2,72,2,0.063926941,0,empty,CD-0722-4
"A9,F2",8942,9530,6565,2965,4901,2331,0,2333,1491,842,1.770783848,1265,2657,632,324,320,4,80,1,0.10625,0,empty,CD-0722-4
"A9,F3",8667,9568,6457,3111,4971,2453,4,2459,1620,839,1.930870083,1398,3198,808,305,303,2,76,2,0.066006601,0,empty,CD-0722-4
"A9,F4",13113,13922,9889,4033,7296,3331,0,3334,2126,1208,1.759933775,1766,681,226,80,79,1,26,1,0.075949367,0,empty,CD-0722-4
"A9,F5",11234,12040,8350,3690,6167,2927,0,2929,1937,992,1.952620968,1608,2844,780,285,283,2,61,1,0.16254417,0,empty,CD-0722-4
"A9,F6",10165,11497,7442,4055,5871,3006,0,3010,1894,1116,1.697132616,1783,3810,878,360,345,15,94,2,0.086956522,0,empty,CD-0722-4
"A9,F7",12023,13319,8895,4424,7029,3510,13,3526,2284,1242,1.838969404,2043,1306,283,136,131,5,47,2,0.015267176,0,empty,CD-0722-4
"A9,F8",8040,8628,5998,2630,4472,2119,0,2124,1414,710,1.991549296,1142,335,78,42,41,1,15,1,0,0,empty,CD-0722-4
"A9,F9",9023,9927,6830,3097,5149,2405,16,2425,1676,749,2.2376502,1344,2988,843,323,315,8,85,2,0.00952381,0,empty,CD-0722-4
"A9,F10",12051,13013,9177,3836,6673,3041,25,3069,2069,1000,2.069,1671,1974,359,167,165,2,49,1,0.103030303,0,empty,CD-0722-4
"A9,F11",8831,9540,6623,2917,4938,2336,0,2343,1539,804,1.914179104,1301,1935,382,167,164,3,34,2,0.134146341,0,empty,CD-0722-4
"A9,F12",10108,11071,7350,3721,5606,2788,0,2790,1810,980,1.846938776,1566,266,42,16,16,0,7,0,0,0,empty,CD-0722-4
"A9,G1",31147,33621,24376,9245,16472,7241,0,7258,4891,2367,2.066328686,3942,9667,1660,657,642,15,120,2,0.193146417,0,empty,CD-0722-4
"A9,G2",6584,7022,4668,2354,3543,1781,0,1781,1092,689,1.58490566,1009,427,114,32,30,2,15,1,0.033333333,0,empty,CD-0722-4
"A9,G3",12173,13156,9057,4099,6629,3238,1,3242,2050,1192,1.719798658,1746,2379,543,213,209,4,47,2,0.043062201,0,empty,CD-0722-4
"A9,G4",21281,23518,15485,8033,11999,6544,16,6568,4113,2455,1.675356415,3669,118,14,7,7,0,3,0,0.571428571,0,empty,CD-0722-4
"A9,G5",7328,7972,5384,2588,4151,2042,18,2064,1338,726,1.842975207,1171,1916,425,164,158,6,52,2,0.050632911,0,empty,CD-0722-4
"A9,G6",11472,12553,8597,3956,6555,3190,0,3194,2025,1169,1.732249786,1776,242,99,26,26,0,4,0,0,0,empty,CD-0722-4
"A9,G7",9183,10222,6980,3242,5283,2529,20,2552,1669,883,1.890147225,1459,2804,609,267,266,1,85,1,0.112781955,0,empty,CD-0722-4
"A9,G8",6281,6826,4621,2205,3679,1800,1,1804,1173,631,1.858954041,1060,2136,415,181,179,2,49,2,0.117318436,0,empty,CD-0722-4
"A9,G9",8018,8678,5884,2794,4490,2116,20,2141,1403,738,1.901084011,1235,2785,703,255,253,2,83,1,0.051383399,0,empty,CD-0722-4
"A9,G10",8993,10119,6816,3303,5138,2540,0,2542,1665,877,1.898517674,1397,2662,602,233,232,1,71,1,0.094827586,0,empty,CD-0722-4
"A9,G11",9377,10281,7113,3168,5374,2551,2,2557,1664,893,1.863381859,1443,1366,360,154,154,0,44,0,0.012987013,0,empty,CD-0722-4
"A9,G12",8467,9668,6134,3534,5026,2661,1,2662,1732,930,1.862365591,1559,2514,475,191,187,4,48,2,0.122994652,0,empty,CD-0722-4
"A9,H1",7558,8305,5696,2609,4234,1989,12,2005,1368,637,2.147566719,1080,1403,291,100,100,0,30,0,0.06,0,empty,CD-0722-4
"A9,H2",12481,13915,9378,4537,7076,3522,1,3525,2389,1136,2.102992958,2048,2959,727,259,254,5,55,1,0.066929134,0,empty,CD-0722-4
"A9,H3",845224,1017560,589684,427876,502121,311442,2,311713,250978,60735,4.132345435,191681,8558,1742,522,512,10,127,3,0.025390625,0,hg38,CD-0722-4
"A9,H4",11117,12186,8148,4038,6242,3088,0,3088,1926,1162,1.657487091,1803,231,49,22,22,0,3,0,0.227272727,0,empty,CD-0722-4
"A9,H5",12187,13110,9054,4056,6628,3250,0,3255,2137,1118,1.911449016,1839,2009,442,182,181,1,50,1,0.016574586,0,empty,CD-0722-4
"A9,H6",7154,8053,5275,2778,4085,2125,0,2130,1423,707,2.012729844,1216,2399,569,199,193,6,58,2,0.051813472,0,empty,CD-0722-4
"A9,H7",8275,8956,6166,2790,4599,2209,1,2214,1389,825,1.683636364,1207,2292,679,241,241,0,51,0,0.020746888,0,empty,CD-0722-4
"A9,H8",20070,23004,14769,8235,11720,6215,11,6232,4563,1669,2.733972439,3632,2311,457,238,227,11,65,3,0.154185022,0,empty,CD-0722-4
"A9,H9",1053286,1176963,798403,378560,566571,285431,4,285725,223258,62467,3.57401508,162953,129668,14003,5641,5485,156,990,7,0.059981768,0,hg38,CD-0722-4
"A9,H10",6559,7341,4797,2544,3760,1813,13,1826,1168,658,1.775075988,1059,1988,520,205,205,0,41,0,0.185365854,0,empty,CD-0722-4
"A9,H11",8287,9289,5859,3430,4798,2838,0,2840,1546,1294,1.194744977,1632,47,1,1,1,0,1,0,0,0,empty,CD-0722-4
"A9,H12",6651,7362,4835,2527,3727,1922,1,1925,1177,748,1.573529412,1091,1647,360,140,140,0,35,0,0.035714286,0,empty,CD-0722-4
"A10,A1",6691,7415,4787,2628,3715,1956,0,1957,1230,727,1.691884457,1155,1660,390,158,156,2,37,1,0.25,0,empty,CD-0722-4
"A10,A2",9345,10132,6912,3220,5230,2595,7,2604,1657,947,1.749736008,1459,1930,355,171,171,0,57,0,0.128654971,0,empty,CD-0722-4
"A10,A3",6371,6909,4732,2177,3553,1774,0,1774,1105,669,1.651718984,991,1422,343,156,153,3,44,1,0.052287582,0,empty,CD-0722-4
"A10,A4",11271,12451,8443,4008,6297,3056,5,3071,1929,1142,1.689141856,1722,793,216,75,75,0,20,0,0.28,0,empty,CD-0722-4
"A10,A5",8727,9652,6445,3207,5101,2559,0,2559,1702,857,1.985997666,1449,2574,466,192,192,0,52,0,0.078125,0,empty,CD-0722-4
"A10,A6",9603,10401,7281,3120,5430,2659,1,2662,1745,917,1.902944384,1468,3142,982,332,330,2,67,2,0.148484848,0,empty,CD-0722-4
"A10,A7",6368,6925,4726,2199,3684,1828,0,1833,1121,712,1.574438202,1006,1657,464,205,205,0,47,0,0.053658537,0,empty,CD-0722-4
"A10,A8",4108,4486,3027,1459,2357,1157,0,1158,777,381,2.039370079,669,1539,362,179,179,0,52,0,0.055865922,0,empty,CD-0722-4
"A10,A9",1551064,1808275,1151358,656917,880717,490012,46,490424,398465,91959,4.333072347,289008,243763,35281,13758,13519,239,2014,11,0.060655374,0,hg38,CD-0722-4
"A10,A10",7497,8075,5691,2384,4211,2000,0,2002,1220,782,1.560102302,1140,518,117,42,41,1,14,1,0.170731707,0,empty,CD-0722-4
"A10,A11",5975,6405,4493,1912,3302,1471,9,1480,1014,466,2.175965665,808,2091,601,223,218,5,45,2,0.064220183,0,empty,CD-0722-4
"A10,A12",7748,8249,5836,2413,4122,1904,0,1912,1238,674,1.836795252,1022,4203,1155,421,418,3,84,1,0.086124402,0,empty,CD-0722-4
"A10,B1",7213,7860,5373,2487,4096,2029,22,2052,1280,772,1.658031088,1179,1643,471,154,152,2,38,2,0.078947368,0,empty,CD-0722-4
"A10,B2",2746619,3122653,1849029,1273624,1520349,907214,1,907917,730852,177065,4.127591562,559101,112754,16527,6279,6152,127,1132,6,0.071196359,0,hg38,CD-0722-4
"A10,B3",5660,6532,4142,2390,3354,1720,0,1724,1141,583,1.957118353,1023,1524,370,141,137,4,36,1,0,0,empty,CD-0722-4
"A10,B4",6704,7664,4861,2803,3992,2131,0,2131,1371,760,1.803947368,1263,1651,492,180,180,0,42,0,0.055555556,0,empty,CD-0722-4
"A10,B5",9625,6966,4568,2398,4216,2205,0,2213,1506,707,2.130127298,1279,1383,221,80,79,1,29,1,0.265822785,0,empty,CD-0722-4
"A10,B6",7670,8196,5548,2648,4295,2211,0,2213,1371,842,1.628266033,1245,1749,381,149,148,1,44,1,0.033783784,0,empty,CD-0722-4
"A10,B7",7671,8381,5871,2510,4379,2068,0,2072,1369,703,1.947368421,1142,1548,445,185,183,2,39,1,0.092896175,0,empty,CD-0722-4
"A10,B8",413821,449364,326263,123101,223096,98254,4,98360,74169,24191,3.065974949,53884,19256,3895,1421,1395,26,275,4,0.017921147,0,empty,CD-0722-4
"A10,B9",854246,971866,635984,335882,474187,250657,5,250914,196919,53995,3.646985832,145950,87272,11048,4247,4157,90,752,5,0.06567236,0,hg38,CD-0722-4
"A10,B10",710001,780858,498945,281913,412076,221220,12,221769,159437,62332,2.557867548,132661,9440,4291,1592,1588,4,288,1,0.055415617,0,hg38,CD-0722-4
"A10,B11",10425,11499,7426,4073,6050,3257,0,3260,1816,1444,1.257617729,1944,188,38,23,23,0,7,0,0,0,empty,CD-0722-4
"A10,B12",6155,6840,4486,2354,3583,1737,12,1750,1152,598,1.926421405,992,1939,302,148,146,2,46,1,0.082191781,0,empty,CD-0722-4
"A10,C1",13574,14597,10295,4302,7586,3606,0,3614,2303,1311,1.756674294,1969,1473,399,125,121,4,42,2,0.049586777,0,empty,CD-0722-4
"A10,C2",10732,11773,7924,3849,6098,3098,0,3104,1946,1158,1.680483592,1718,2549,693,251,251,0,66,0,0.027888446,0,empty,CD-0722-4
"A10,C3",13023,14089,9927,4162,7599,3707,0,3718,2482,1236,2.008090615,2056,1134,314,110,110,0,32,0,0.009090909,0,empty,CD-0722-4
"A10,C4",6564,7128,4973,2155,3739,1792,0,1797,1178,619,1.903069467,999,1968,550,220,217,3,47,2,0.032258065,0,empty,CD-0722-4
"A10,C5",9779,10569,7295,3274,5444,2562,0,2564,1664,900,1.848888889,1416,1651,351,158,151,7,40,2,0.105960265,0,empty,CD-0722-4
"A10,C6",8657,9301,6417,2884,4844,2389,21,2412,1549,863,1.794901506,1321,1851,454,153,150,3,37,2,0.02,0,empty,CD-0722-4
"A10,C7",11631,13266,8333,4933,6874,3781,0,3783,2321,1462,1.5875513,2228,286,38,19,19,0,10,0,0,0,empty,CD-0722-4
"A10,C8",12162,13231,8894,4337,6824,3443,0,3445,2283,1162,1.964716007,1954,3123,686,268,257,11,81,2,0.007782101,0,empty,CD-0722-4
"A10,C9",9703,10705,7445,3260,5446,2656,0,2658,1779,879,2.023890785,1452,2811,778,274,270,4,61,2,0.062962963,0,empty,CD-0722-4
"A10,C10",10169,11135,7564,3571,5755,2818,0,2818,1789,1029,1.738581147,1604,2235,610,229,226,3,57,2,0.053097345,0,empty,CD-0722-4
"A10,C11",8820,9425,6493,2932,4912,2344,0,2351,1553,798,1.946115288,1318,2370,567,237,233,4,52,1,0.154506438,0,empty,CD-0722-4
"A10,C12",11630,12415,8726,3689,6412,2950,1,2958,1959,999,1.960960961,1610,2613,804,320,317,3,71,2,0.082018927,0,empty,CD-0722-4
"A10,D1",10733,12079,7885,4194,6115,3169,6,3180,1913,1267,1.509865825,1807,1040,113,38,38,0,8,0,0,0,empty,CD-0722-4
"A10,D2",10000,10855,7562,3293,5525,2526,32,2561,1631,930,1.753763441,1399,3032,951,351,348,3,74,2,0.043103448,0,empty,CD-0722-4
"A10,D3",7703,8339,5804,2535,4385,2099,0,2105,1356,749,1.810413885,1160,1535,293,119,117,2,43,1,0.025641026,0,empty,CD-0722-4
"A10,D4",5926,6719,4438,2281,3501,1770,0,1770,1101,669,1.64573991,1037,1530,474,174,173,1,35,1,0.092485549,0,empty,CD-0722-4
"A10,D5",866096,1032502,622845,409657,511901,303530,10,303777,236587,67190,3.521163864,183472,35971,12548,4422,4398,24,876,2,0.066393815,0,hg38,CD-0722-4
"A10,D6",11085,11927,8126,3801,6239,3242,0,3246,2029,1217,1.667214462,1812,1747,446,174,172,2,45,2,0.127906977,0,empty,CD-0722-4
"A10,D7",5805,5989,4319,1670,3218,1443,1,1446,978,468,2.08974359,794,2363,537,193,192,1,59,1,0.041666667,0,empty,CD-0722-4
"A10,D8",14656,16037,11190,4847,7910,3698,0,3706,2679,1027,2.608568647,2023,3656,818,303,303,0,72,0,0.122112211,0,empty,CD-0722-4
"A10,D9",3578,3868,2666,1202,2046,961,0,961,626,335,1.868656716,547,1679,255,112,111,1,31,1,0.045045045,0,empty,CD-0722-4
"A10,D10",8273,9319,6158,3161,4764,2407,1,2408,1577,831,1.897713598,1395,1243,219,87,87,0,17,0,0.057471264,0,empty,CD-0722-4
"A10,D11",8031,8879,5991,2888,4519,2198,0,2198,1451,747,1.942436412,1228,2864,876,330,329,1,73,1,0.14893617,0,empty,CD-0722-4
"A10,D12",1420803,1667753,1041241,626512,800724,454613,2,454988,392102,62886,6.235123875,270637,147977,26345,9905,9754,151,1654,6,0.049620668,0,hg38,CD-0722-4
"A10,E1",12172,13241,9059,4182,6854,3331,0,3335,2054,1281,1.603434817,1864,3099,660,253,249,4,69,1,0.136546185,0,empty,CD-0722-4
"A10,E2",9320,10136,6823,3313,5230,2563,0,2565,1570,995,1.577889447,1438,2443,432,197,193,4,50,1,0.062176166,0,empty,CD-0722-4
"A10,E3",6185,6797,4684,2113,3570,1695,0,1700,1095,605,1.809917355,949,2439,713,235,231,4,65,2,0.008658009,0,empty,CD-0722-4
"A10,E4",8570,9298,6229,3069,4941,2502,0,2504,1559,945,1.64973545,1464,3519,805,279,277,2,59,1,0.277978339,0,empty,CD-0722-4
"A10,E5",8312,8954,6387,2567,4645,2048,86,2140,1334,806,1.655086849,1109,1484,345,148,146,2,41,1,0.04109589,0,empty,CD-0722-4
"A10,E6",12990,14047,9728,4319,7192,3518,0,3522,2256,1266,1.781990521,1924,3030,683,254,244,10,74,2,0.008196721,0,empty,CD-0722-4
"A10,E7",12621,13612,9450,4162,7055,3352,0,3362,2175,1187,1.832350463,1846,4012,917,364,362,2,88,2,0.074585635,0,empty,CD-0722-4
"A10,E8",10000,10832,7633,3199,5612,2555,1,2567,1652,915,1.805464481,1403,3155,717,258,254,4,78,2,0.031496063,0,empty,CD-0722-4
"A10,E9",5506,5924,4061,1863,3183,1596,0,1599,1045,554,1.886281588,890,2410,550,210,210,0,54,0,0.085714286,0,empty,CD-0722-4
"A10,E10",7290,7997,5375,2622,4168,2001,0,2003,1285,718,1.789693593,1142,2010,598,184,184,0,48,0,0.233695652,0,empty,CD-0722-4
"A10,E11",647781,686684,507325,179359,345408,148575,1,148761,118058,30703,3.845161711,80052,57264,15339,5743,5700,43,882,7,0.021052632,0,hg38,CD-0722-4
"A10,E12",8859,9570,6590,2980,5018,2411,1,2415,1513,902,1.677383592,1370,2880,518,174,168,6,52,2,0.017857143,0,empty,CD-0722-4
"A10,F1",10993,11798,8074,3724,6229,3026,0,3036,1915,1121,1.708296164,1726,2440,619,280,277,3,60,1,0.046931408,0,empty,CD-0722-4
"A10,F2",978511,1132882,711752,421130,559965,314051,13,314372,249689,64683,3.860195105,187454,230598,38598,15090,14855,235,2014,8,0.055065634,0,hg38,CD-0722-4
"A10,F3",8302,9114,6173,2941,4829,2387,0,2387,1557,830,1.875903614,1372,2936,741,313,311,2,83,1,0.003215434,0,empty,CD-0722-4
"A10,F4",12808,13547,9574,3973,7077,3341,0,3346,2124,1222,1.738134206,1835,681,142,51,51,0,15,0,0.137254902,0,empty,CD-0722-4
"A10,F5",10110,10582,7456,3126,5602,2539,19,2562,1690,872,1.938073394,1382,2387,452,191,190,1,49,1,0.078947368,0,empty,CD-0722-4
"A10,F6",9231,10236,6863,3373,5260,2648,0,2649,1704,945,1.803174603,1513,3366,717,292,289,3,100,1,0.041522491,0,empty,CD-0722-4
"A10,F7",11258,12339,8404,3935,6459,3158,0,3160,1999,1161,1.721791559,1806,1300,254,123,121,2,35,2,0.024793388,0,empty,CD-0722-4
"A10,F8",7541,8179,5714,2465,4350,2099,1,2102,1356,746,1.81769437,1150,343,28,14,14,0,9,0,0,0,empty,CD-0722-4
"A10,F9",8982,9695,6854,2841,5070,2365,0,2370,1628,742,2.194070081,1306,3662,642,270,270,0,70,0,0.014814815,0,empty,CD-0722-4
"A10,F10",11462,12374,8697,3677,6478,3040,0,3046,2000,1046,1.912045889,1696,2399,433,197,194,3,51,2,0.072164948,0,empty,CD-0722-4
"A10,F11",7988,8360,6061,2299,4351,1964,1,1972,1286,686,1.874635569,1049,1989,389,153,152,1,37,1,0.032894737,0,empty,CD-0722-4
"A10,F12",1101474,1270225,802558,467667,610469,337137,2,337436,270224,67212,4.020472535,200618,14216,2442,974,959,15,204,3,0.087591241,0,hg38,CD-0722-4
"A10,G1",10773,11593,8108,3485,5945,2797,3,2803,1766,1037,1.702989392,1512,2741,719,285,283,2,65,1,0.106007067,0,empty,CD-0722-4
"A10,G2",6762,7578,4659,2919,3882,2105,0,2110,1304,806,1.617866005,1268,609,127,49,49,0,17,0,0.020408163,0,empty,CD-0722-4
"A10,G3",11427,12428,8472,3956,6483,3228,0,3230,1984,1246,1.592295345,1803,3133,822,333,332,1,66,1,0.114457831,0,empty,CD-0722-4
"A10,G4",19966,22138,14456,7682,11534,6319,2,6327,3715,2612,1.422281776,3652,63,21,16,16,0,7,0,0,0,empty,CD-0722-4
"A10,G5",7238,7913,5219,2694,4076,2014,0,2022,1251,771,1.622568093,1172,1958,499,199,190,9,46,2,0.068421053,0,empty,CD-0722-4
"A10,G6",10374,11190,7995,3195,5757,2810,7,2818,1840,978,1.881390593,1523,264,56,28,28,0,9,0,0,0,empty,CD-0722-4
"A10,G7",7875,8408,5762,2646,4431,2109,0,2111,1331,780,1.706410256,1151,2778,445,202,200,2,61,1,0.105,0,empty,CD-0722-4
"A10,G8",6298,6811,4539,2272,3637,1810,14,1827,1192,635,1.877165354,1068,3108,731,234,233,1,56,1,0.034334764,0,empty,CD-0722-4
"A10,G9",10016,11097,7293,3804,5619,2897,12,2913,1771,1142,1.550788091,1636,2920,723,290,284,6,80,1,0.024647887,0,empty,CD-0722-4
"A10,G10",13231,14469,10093,4376,7428,3637,1,3648,2442,1206,2.024875622,1996,4104,849,375,375,0,106,0,0.034666667,0,empty,CD-0722-4
"A10,G11",8554,9317,6437,2880,4791,2257,22,2279,1531,748,2.046791444,1264,1504,429,167,162,5,43,2,0.086419753,0,empty,CD-0722-4
"A10,G12",7112,7729,5184,2545,3975,2013,0,2013,1311,702,1.867521368,1089,2299,539,228,219,9,54,2,0.132420091,0,empty,CD-0722-4
"A10,H1",764954,871842,560907,310935,431126,233680,2,233891,181747,52144,3.48548251,137798,120331,17329,6701,6554,147,1162,6,0.044095209,0,hg38,CD-0722-4
"A10,H2",8531,9243,6294,2949,4760,2284,0,2287,1450,837,1.732377539,1297,2225,479,214,209,5,61,2,0.019138756,0,empty,CD-0722-4
"A10,H3",6791,7278,5014,2264,3868,1865,0,1865,1216,649,1.873651772,1058,2070,426,162,158,4,41,3,0.037974684,0,empty,CD-0722-4
"A10,H4",10360,11312,7703,3609,5901,2885,0,2887,1851,1036,1.786679537,1630,300,84,13,13,0,7,0,0,0,empty,CD-0722-4
"A10,H5",11541,12546,8525,4021,6523,3263,1,3266,2158,1108,1.94765343,1818,2346,710,257,255,2,49,2,0.02745098,0,empty,CD-0722-4
"A10,H6",6567,7235,4829,2406,3744,1904,0,1904,1256,648,1.938271605,1090,2615,688,248,247,1,65,1,0.145748988,0,empty,CD-0722-4
"A10,H7",8064,8901,5841,3060,4684,2353,1,2358,1574,784,2.007653061,1343,2504,537,188,185,3,58,2,0,0,empty,CD-0722-4
"A10,H8",8817,9704,6529,3175,4936,2529,0,2535,1573,962,1.635135135,1437,2976,893,327,326,1,88,1,0.058282209,0,empty,CD-0722-4
"A10,H9",6675,7134,5015,2119,3671,1715,6,1722,1164,558,2.086021505,944,1080,340,141,141,0,35,0,0.014184397,0,empty,CD-0722-4
"A10,H10",5903,6656,4411,2245,3463,1731,0,1733,1141,592,1.927364865,1023,1432,255,99,98,1,34,1,0.132653061,0,empty,CD-0722-4
"A10,H11",7920,8983,5530,3453,4705,2789,0,2791,1518,1273,1.192458759,1654,10,2,0,0,0,0,0,0,0,empty,CD-0722-4
"A10,H12",6458,7097,4615,2482,3500,1779,0,1779,1155,624,1.850961538,1009,1818,338,159,158,1,38,1,0.025316456,0,empty,CD-0722-4
"A11,A1",7525,8185,5300,2885,4367,2319,0,2320,1382,938,1.473347548,1339,1347,315,126,126,0,27,0,0.150793651,0,empty,CD-0722-4
"A11,A2",970119,1092890,728675,364215,528558,279272,2,279559,226456,53103,4.264467168,157284,146949,16533,6657,6515,142,1186,4,0.063699156,0,hg38,CD-0722-4
"A11,A3",7056,7489,5164,2325,4004,1987,0,1988,1246,742,1.679245283,1089,1986,351,150,148,2,37,2,0.040540541,0,empty,CD-0722-4
"A11,A4",12118,13405,9015,4390,6812,3372,0,3375,2145,1230,1.743902439,1892,839,164,70,70,0,21,0,0.228571429,0,empty,CD-0722-4
"A11,A5",462165,555937,315824,240113,279400,175235,9,175402,135517,39885,3.397693368,109594,12921,2142,670,658,12,206,2,0.075987842,0,hg38,CD-0722-4
"A11,A6",13701,15815,10075,5740,8249,4430,10,4445,3059,1386,2.207070707,2614,2929,791,324,320,4,78,2,0.059375,0,empty,CD-0722-4
"A11,A7",34262,40313,24264,16049,20240,12394,0,12401,8952,3449,2.595534938,7268,1482,242,96,95,1,37,1,0,0,empty,CD-0722-4
"A11,A8",5566,6046,3987,2059,3154,1587,0,1589,1011,578,1.749134948,903,2536,633,203,200,3,56,2,0.035,0,empty,CD-0722-4
"A11,A9",348228,347595,284609,62986,175042,70344,1,70440,49072,21368,2.296518158,30544,22484,8775,3181,3166,15,639,4,0.019898926,0,empty,CD-0722-4
"A11,A10",483084,525547,378282,147265,260126,119016,0,119131,90927,28204,3.223904411,65685,6242,922,361,347,14,89,3,0.025936599,0,hg38,CD-0722-4
"A11,A11",6469,6769,4929,1840,3626,1631,0,1636,1110,526,2.11026616,870,2294,531,228,224,4,52,1,0.0625,0,empty,CD-0722-4
"A11,A12",656429,701321,512271,189050,340170,150759,2,150937,117296,33641,3.486697779,81463,98044,23013,8655,8560,95,1222,5,0.025350467,0,hg38,CD-0722-4
"A11,B1",7837,8379,5922,2457,4385,2086,12,2098,1296,802,1.6159601,1095,1372,356,133,129,4,36,2,0,0,empty,CD-0722-4
"A11,B2",9780,10523,6832,3691,5496,2903,17,2924,1801,1123,1.603739982,1664,759,104,38,37,1,10,1,0.081081081,0,empty,CD-0722-4
"A11,B3",6659,7269,4926,2343,3793,1878,0,1878,1213,665,1.82406015,1028,1433,263,103,98,5,34,2,0.06122449,0,empty,CD-0722-4
"A11,B4",7403,8043,5338,2705,4202,2170,0,2180,1381,799,1.728410513,1247,1265,291,123,122,1,35,1,0.016393443,0,empty,CD-0722-4
"A11,B5",8324,5165,3277,1888,3317,1714,1,1728,1087,641,1.695787832,1111,951,242,116,116,0,42,0,0.043103448,0,empty,CD-0722-4
"A11,B6",8585,9681,6230,3451,5004,2618,0,2622,1618,1004,1.611553785,1509,1546,307,117,110,7,44,1,0.036363636,0,empty,CD-0722-4
"A11,B7",1253916,1420379,958537,461842,687602,355274,3,355645,278203,77442,3.592404638,202499,59011,7172,2717,2652,65,617,5,0.020739065,0,hg38,CD-0722-4
"A11,B8",1592969,1848075,1181131,666944,893415,508644,8,509078,402687,106391,3.784972413,296119,90010,10937,4294,4165,129,860,6,0.032653061,0,hg38,CD-0722-4
"A11,B9",11349,12653,8315,4338,6604,3505,2,3508,2174,1334,1.629685157,2036,1017,132,64,64,0,28,0,0.015625,0,empty,CD-0722-4
"A11,B10",5778,6431,4113,2318,3348,1712,0,1717,1113,604,1.842715232,993,656,161,67,67,0,17,0,0.134328358,0,empty,CD-0722-4
"A11,B11",715485,850399,493155,357244,415091,269196,0,269421,201020,68401,2.938845923,160102,470,40,22,22,0,9,0,0.181818182,0,empty,CD-0722-4
"A11,B12",7191,7855,5357,2498,4156,2057,0,2057,1368,689,1.985486212,1135,1976,505,203,202,1,47,1,0.02970297,0,empty,CD-0722-4
"A11,C1",1164183,1268051,885525,382526,607920,298480,2,298754,235507,63247,3.723607444,164706,70437,13170,5167,5098,69,928,3,0.039819537,0,hg38,CD-0722-4
"A11,C2",12710,14209,9117,5092,7196,3759,0,3762,2383,1379,1.728063814,2219,2417,615,263,260,3,61,2,0.065384615,0,empty,CD-0722-4
"A11,C3",12868,13919,9542,4377,7381,3600,28,3632,2284,1348,1.694362018,2090,871,174,73,66,7,15,2,0.045454545,0,empty,CD-0722-4
"A11,C4",7772,8480,5800,2680,4355,1966,23,1993,1273,720,1.768055556,1096,2605,468,217,212,5,51,2,0.018867925,0,empty,CD-0722-4
"A11,C5",1166016,1396714,842971,553743,682121,396514,3,396849,315370,81479,3.870567876,242934,147957,23009,8942,8774,168,1398,6,0.045247322,0,hg38,CD-0722-4
"A11,C6",9277,10283,6772,3511,5307,2601,3,2609,1699,910,1.867032967,1485,1583,358,148,144,4,39,1,0.125,0,empty,CD-0722-4
"A11,C7",12475,14423,8996,5427,7402,4147,0,4149,2557,1592,1.606155779,2451,826,237,67,66,1,15,1,0.015151515,0,empty,CD-0722-4
"A11,C8",13681,14980,10178,4802,7736,3819,0,3826,2422,1404,1.725071225,2173,3497,852,321,320,1,86,1,0.1125,0,empty,CD-0722-4
"A11,C9",9687,10193,7157,3036,5392,2602,0,2604,1746,858,2.034965035,1408,1970,409,165,164,1,40,1,0.146341463,0,empty,CD-0722-4
"A11,C10",11683,13134,8693,4441,6588,3278,17,3301,2163,1138,1.900702988,1846,2597,603,268,264,4,69,2,0.049242424,0,empty,CD-0722-4
"A11,C11",9919,10793,7123,3670,5766,2935,1,2938,1877,1061,1.769085768,1737,1915,524,222,221,1,62,1,0.031674208,0,empty,CD-0722-4
"A11,C12",955310,1150761,680471,470290,559822,333754,3,334089,264165,69924,3.777887421,205771,23649,9102,3446,3430,16,726,2,0.03148688,0,hg38,CD-0722-4
"A11,D1",11562,12981,8327,4654,6671,3607,7,3614,2231,1383,1.613159798,2134,1116,308,125,125,0,16,0,0.328,0,empty,CD-0722-4
"A11,D2",12197,12926,9303,3623,6764,3107,0,3111,2010,1101,1.825613079,1627,3481,767,298,294,4,91,2,0.054421769,0,empty,CD-0722-4
"A11,D3",8757,9558,6431,3127,4917,2471,15,2487,1633,854,1.912177986,1464,2199,610,244,242,2,57,1,0.115702479,0,empty,CD-0722-4
"A11,D4",6529,7167,4858,2309,3770,1853,0,1855,1194,661,1.806354009,1053,1557,441,160,160,0,38,0,0.0125,0,empty,CD-0722-4
"A11,D5",7421,8092,5516,2576,4273,2106,3,2111,1331,780,1.706410256,1174,1643,308,127,126,1,34,1,0.103174603,0,empty,CD-0722-4
"A11,D6",12172,13346,8739,4607,6986,3793,1,3802,2268,1534,1.478487614,2219,2197,640,227,225,2,48,2,0.093333333,0,empty,CD-0722-4
"A11,D7",6496,7084,4954,2130,3687,1727,0,1727,1175,552,2.128623188,948,2516,599,225,210,15,52,2,0.057142857,0,empty,CD-0722-4
"A11,D8",7886,8617,5787,2830,4464,2161,0,2163,1350,813,1.660516605,1234,1310,339,124,124,0,31,0,0.024193548,0,empty,CD-0722-4
"A11,D9",4415,4633,3308,1325,2422,1112,7,1122,774,348,2.224137931,602,1657,385,157,157,0,41,0,0.012738854,0,empty,CD-0722-4
"A11,D10",7961,8722,5927,2795,4488,2267,0,2267,1369,898,1.524498886,1279,1123,261,92,92,0,28,0,0.043478261,0,empty,CD-0722-4
"A11,D11",15174,17576,10807,6769,8986,5051,0,5051,3255,1796,1.812360802,2993,2968,743,251,249,2,66,2,0.096385542,0,empty,CD-0722-4
"A11,D12",1082448,1244653,803391,441262,602130,324516,2,324850,259150,65700,3.944444444,191067,338647,57137,21910,21535,375,2606,10,0.050383097,0,hg38,CD-0722-4
"A11,E1",14088,15780,10288,5492,8207,4179,11,4196,2658,1538,1.728218466,2410,2482,465,197,189,8,68,2,0.111111111,0,empty,CD-0722-4
"A11,E2",9938,11012,7312,3700,5791,2958,0,2961,1871,1090,1.716513761,1664,2118,468,177,176,1,52,1,0.039772727,0,empty,CD-0722-4
"A11,E3",7835,8688,5964,2724,4545,2214,1,2223,1402,821,1.707673569,1254,3049,819,335,330,5,73,1,0.087878788,0,empty,CD-0722-4
"A11,E4",722932,880616,494251,386365,436707,290262,1,290421,209342,81079,2.581950937,178022,6501,1007,334,330,4,96,3,0.103030303,0,hg38,CD-0722-4
"A11,E5",8520,9067,6454,2613,4724,2188,2,2193,1432,761,1.88173456,1171,1283,403,149,148,1,35,1,0.094594595,0,empty,CD-0722-4
"A11,E6",14432,15757,10637,5120,8106,4104,0,4108,2531,1577,1.6049461,2365,4207,1373,537,532,5,98,1,0.112781955,0,empty,CD-0722-4
"A11,E7",13332,14194,9963,4231,7536,3599,0,3601,2319,1282,1.808892356,2016,3212,790,284,284,0,90,0,0.045774648,0,empty,CD-0722-4
"A11,E8",11030,11741,8514,3227,6160,2846,18,2873,1924,949,2.02739726,1483,3018,748,289,284,5,70,2,0.01056338,0,empty,CD-0722-4
"A11,E9",6224,6889,4606,2283,3573,1779,0,1779,1174,605,1.940495868,996,2413,579,238,233,5,64,2,0.064377682,0,empty,CD-0722-4
"A11,E10",8304,8953,6306,2647,4654,2194,0,2196,1423,773,1.84087969,1216,2198,676,229,228,1,44,1,0.026315789,0,empty,CD-0722-4
"A11,E11",9729,10471,7235,3236,5493,2742,4,2747,1746,1001,1.744255744,1533,2349,324,124,113,11,41,2,0.017699115,0,empty,CD-0722-4
"A11,E12",9999,10876,7493,3383,5654,2753,0,2757,1710,1047,1.633237822,1564,2069,516,193,186,7,51,2,0.107526882,0,empty,CD-0722-4
"A11,F1",12412,13287,8965,4322,6991,3489,1,3497,2180,1317,1.655277145,1969,2883,648,252,251,1,61,1,0.027888446,0,empty,CD-0722-4
"A11,F2",9332,9924,6811,3113,5324,2573,2,2582,1614,968,1.667355372,1506,3287,717,263,259,4,66,1,0.127413127,0,empty,CD-0722-4
"A11,F3",9368,10148,6956,3192,5233,2416,16,2437,1584,853,1.856975381,1382,3023,629,259,251,8,75,4,0.131474104,0,empty,CD-0722-4
"A11,F4",13980,14827,10318,4509,7899,3843,0,3846,2440,1406,1.73541963,2171,772,140,51,49,2,12,1,0.06122449,0,empty,CD-0722-4
"A11,F5",11353,11749,8359,3390,6185,2896,0,2896,1881,1015,1.85320197,1560,2340,578,235,233,2,62,1,0.137339056,0,empty,CD-0722-4
"A11,F6",10814,11928,7976,3952,6086,3117,12,3131,2052,1079,1.90176089,1782,3703,792,339,338,1,87,1,0.118343195,0,empty,CD-0722-4
"A11,F7",12648,13883,9495,4388,7335,3683,0,3684,2311,1373,1.683175528,2057,1108,218,67,65,2,21,1,0.107692308,0,empty,CD-0722-4
"A11,F8",10133,11082,7584,3498,5681,2805,0,2810,1848,962,1.920997921,1527,391,122,47,47,0,16,0,0,0,empty,CD-0722-4
"A11,F9",9829,10689,7456,3233,5532,2629,0,2633,1755,878,1.998861048,1462,3422,788,277,274,3,76,1,0.098540146,0,empty,CD-0722-4
"A11,F10",12333,13401,9320,4081,7007,3278,6,3291,2108,1183,1.781910397,1833,2277,681,267,263,4,65,2,0.022813688,0,empty,CD-0722-4
"A11,F11",8958,9840,6830,3010,5074,2461,1,2464,1618,846,1.912529551,1369,1853,232,101,101,0,25,0,0.366336634,0,empty,CD-0722-4
"A11,F12",13635,15038,9959,5079,7638,3796,11,3807,2607,1200,2.1725,2162,293,57,29,29,0,11,0,0.068965517,0,empty,CD-0722-4
"A11,G1",11461,12191,8529,3662,6453,3087,1,3091,1966,1125,1.747555556,1720,2686,662,238,237,1,68,1,0.021097046,0,empty,CD-0722-4
"A11,G2",6894,7683,4811,2872,3918,2068,0,2072,1318,754,1.74801061,1220,555,147,47,47,0,15,0,0,0,empty,CD-0722-4
"A11,G3",13097,13945,9579,4366,7305,3681,0,3683,2261,1422,1.590014065,1962,2617,616,214,210,4,61,2,0.080952381,0,empty,CD-0722-4
"A11,G4",1638449,1896726,1223014,673712,900157,500762,1,501302,390847,110455,3.538517948,291905,1477,213,97,94,3,26,2,0.031914894,0,empty,CD-0722-4
"A11,G5",7981,8847,5854,2993,4557,2305,0,2309,1485,824,1.802184466,1344,2649,485,169,160,9,39,2,0.11875,0,empty,CD-0722-4
"A11,G6",11865,13042,8950,4092,6640,3217,4,3222,2137,1085,1.969585253,1758,189,63,37,37,0,8,0,0,0,empty,CD-0722-4
"A11,G7",9414,10238,7195,3043,5357,2459,0,2462,1635,827,1.977025393,1341,3140,888,303,299,4,95,2,0.100334448,0,empty,CD-0722-4
"A11,G8",6495,7014,4838,2176,3584,1600,25,1629,1113,516,2.156976744,896,2541,732,267,263,4,57,1,0.091254753,0,empty,CD-0722-4
"A11,G9",8316,9202,6273,2929,4675,2272,1,2279,1448,831,1.742478941,1304,2533,459,194,190,4,68,2,0.042105263,0,empty,CD-0722-4
"A11,G10",9446,10592,7080,3512,5551,2810,0,2810,1759,1051,1.673644148,1654,2438,557,225,225,0,65,0,0.057777778,0,empty,CD-0722-4
"A11,G11",1974515,2256466,1471100,785366,1078511,584274,6,584887,471353,113534,4.151646203,338093,36677,17867,6560,6535,25,1165,3,0.040703902,0,hg38,CD-0722-4
"A11,G12",7856,8488,5841,2647,4474,2272,0,2275,1451,824,1.76092233,1264,2602,708,258,256,2,63,2,0.01953125,0,empty,CD-0722-4
"A11,H1",7949,8593,5941,2652,4431,2077,1,2084,1319,765,1.724183007,1158,1231,309,130,130,0,33,0,0.276923077,0,empty,CD-0722-4
"A11,H2",9506,10146,7022,3124,5275,2505,16,2525,1569,956,1.641213389,1412,2815,833,343,342,1,69,1,0.105263158,0,empty,CD-0722-4
"A11,H3",7690,8283,5623,2660,4305,2167,0,2167,1427,740,1.928378378,1178,1481,280,114,111,3,32,2,0.018018018,0,empty,CD-0722-4
"A11,H4",11752,12917,8560,4357,6495,3178,0,3180,2045,1135,1.801762115,1801,196,11,6,4,2,3,1,0,0,empty,CD-0722-4
"A11,H5",12600,13338,9209,4129,6886,3407,11,3421,2240,1181,1.896697714,1912,2647,601,301,300,1,67,1,0.14,0,empty,CD-0722-4
"A11,H6",744718,858212,548133,310079,420389,227609,19,227844,167215,60629,2.758003596,135367,200764,21775,8691,8416,275,1333,6,0.068441065,0,hg38,CD-0722-4
"A11,H7",8997,9678,6656,3022,5006,2396,7,2412,1570,842,1.864608076,1336,1982,637,248,248,0,51,0,0.084677419,0,empty,CD-0722-4
"A11,H8",9480,10183,6944,3239,5452,2771,0,2775,1849,926,1.996760259,1541,2835,722,285,283,2,81,1,0.077738516,0,empty,CD-0722-4
"A11,H9",7806,8332,5968,2364,4254,1902,8,1914,1249,665,1.878195489,1040,1403,422,164,164,0,40,0,0.201219512,0,empty,CD-0722-4
"A11,H10",7569,8356,5585,2771,4388,2174,0,2184,1490,694,2.146974063,1258,1777,336,167,167,0,38,0,0.077844311,0,empty,CD-0722-4
"A11,H11",954227,857361,828350,29011,390099,49134,1,49330,35481,13849,2.561990035,13206,3780,203,98,93,5,32,2,0.043010753,0,empty,CD-0722-4
"A11,H12",1121595,1311848,825513,486335,638204,358949,2,359314,291282,68032,4.281543979,212296,148643,23043,8854,8736,118,1565,8,0.025641026,0,hg38,CD-0722-4
"A12,A1",6499,7166,4800,2366,3799,1901,0,1903,1188,715,1.661538462,1091,1685,333,159,155,4,41,1,0.103225806,0,empty,CD-0722-4
"A12,A2",9987,10846,7428,3418,5783,2918,0,2920,1763,1157,1.523768366,1661,2453,468,185,179,6,59,1,0.100558659,0,empty,CD-0722-4
"A12,A3",6591,7284,4767,2517,3745,1847,0,1851,1274,577,2.20797227,1041,1442,351,140,140,0,36,0,0.021428571,0,empty,CD-0722-4
"A12,A4",11393,12663,8410,4253,6481,3226,0,3231,2121,1110,1.910810811,1876,1167,244,123,122,1,36,1,0.024590164,0,empty,CD-0722-4
"A12,A5",731339,811305,556213,255092,399361,197471,2,197662,147387,50275,2.931616111,112381,167602,19482,7809,7601,208,1231,8,0.071437969,0,hg38,CD-0722-4
"A12,A6",8133,8929,5918,3011,4815,2456,6,2462,1592,870,1.829885057,1401,3674,979,437,431,6,115,2,0.067285383,0,empty,CD-0722-4
"A12,A7",6972,7788,5072,2716,4046,2054,0,2055,1318,737,1.788331072,1212,1897,356,141,139,2,42,1,0.043165468,0,empty,CD-0722-4
"A12,A8",4508,5057,3440,1617,2658,1331,0,1331,879,452,1.944690265,786,2581,581,233,231,2,66,2,0.151515152,0,empty,CD-0722-4
"A12,A9",7236,7829,5450,2379,4052,1991,0,1993,1258,735,1.711564626,1120,2535,481,196,190,6,61,2,0.094736842,0,empty,CD-0722-4
"A12,A10",8934,9600,6799,2801,4941,2322,0,2325,1474,851,1.732079906,1242,464,80,42,41,1,11,1,0,0,empty,CD-0722-4
"A12,A11",6290,6766,4723,2043,3603,1663,20,1683,1093,590,1.852542373,939,1948,486,182,181,1,45,1,0.016574586,0,empty,CD-0722-4
"A12,A12",8767,9352,6692,2660,4813,2265,0,2266,1487,779,1.90885751,1219,4218,1091,449,441,8,108,2,0.099773243,0,empty,CD-0722-4
"A12,B1",7406,8298,5448,2850,4322,2231,0,2234,1438,796,1.806532663,1254,1434,410,171,170,1,54,1,0.088235294,0,empty,CD-0722-4
"A12,B2",7957,9189,5580,3609,4660,2551,0,2553,1548,1005,1.540298507,1554,730,148,74,74,0,20,0,0.081081081,0,empty,CD-0722-4
"A12,B3",6285,6902,4644,2258,3630,1853,1,1857,1188,669,1.775784753,1065,1834,418,178,177,1,48,1,0.005649718,0,empty,CD-0722-4
"A12,B4",7171,8046,5244,2802,4180,2199,0,2199,1324,875,1.513142857,1261,1342,221,94,94,0,35,0,0.063829787,0,empty,CD-0722-4
"A12,B5",7344,4635,2891,1744,3021,1575,15,1611,1052,559,1.881932021,1024,1334,206,97,97,0,37,0,0.030927835,0,empty,CD-0722-4
"A12,B6",8507,9386,6216,3170,4820,2541,0,2541,1547,994,1.556338028,1387,1979,415,168,167,1,59,1,0.119760479,0,empty,CD-0722-4
"A12,B7",7738,8702,5922,2780,4542,2233,17,2252,1501,751,1.998668442,1231,1325,308,133,133,0,34,0,0.165413534,0,empty,CD-0722-4
"A12,B8",5644,6165,4323,1842,3219,1536,0,1536,1023,513,1.994152047,808,1623,437,143,140,3,46,2,0.092857143,0,empty,CD-0722-4
"A12,B9",10788,11699,7873,3826,6109,3157,0,3158,1940,1218,1.592775041,1762,1148,312,138,136,2,50,1,0.139705882,0,empty,CD-0722-4
"A12,B10",5339,5876,3950,1926,3194,1566,0,1566,983,583,1.686106346,905,887,247,96,96,0,15,0,0,0,empty,CD-0722-4
"A12,B11",11659,13126,8440,4686,6738,3696,0,3702,2058,1644,1.251824818,2120,295,69,25,24,1,9,1,0,0,empty,CD-0722-4
"A12,B12",6704,7450,5009,2441,4001,2023,0,2026,1232,794,1.55163728,1147,2176,406,182,180,2,59,1,0.066666667,0,empty,CD-0722-4
"A12,C1",23038,25670,16642,9028,13324,7460,0,7465,3998,3467,1.15315835,4315,1384,408,160,156,4,46,2,0.025641026,0,empty,CD-0722-4
"A12,C2",1132233,1327807,828564,499243,639279,359979,11,360379,278694,81685,3.411813674,214913,316637,61109,23439,23092,347,2697,10,0.059284601,0,hg38,CD-0722-4
"A12,C3",11706,12712,8578,4134,6653,3281,12,3301,2028,1273,1.593087196,1902,1138,270,67,66,1,22,1,0.015151515,0,empty,CD-0722-4
"A12,C4",7122,7711,5363,2348,4118,1948,0,1948,1249,699,1.78683834,1100,2480,722,263,261,2,64,2,0.114942529,0,empty,CD-0722-4
"A12,C5",10505,11260,7909,3351,5859,2853,0,2853,1847,1006,1.835984095,1557,2158,583,214,211,3,54,3,0.028436019,0,empty,CD-0722-4
"A12,C6",8451,9197,6238,2959,4914,2449,1,2450,1518,932,1.628755365,1340,1921,502,168,167,1,47,1,0.107784431,0,empty,CD-0722-4
"A12,C7",13581,15509,9921,5588,7787,4222,0,4226,2579,1647,1.565877353,2445,827,132,37,34,3,15,1,0,0,empty,CD-0722-4
"A12,C8",13379,14923,9954,4969,7683,3954,11,3975,2564,1411,1.817150957,2256,3199,840,356,352,4,100,1,0.105113636,0,empty,CD-0722-4
"A12,C9",8844,10000,6634,3366,5251,2654,0,2662,1755,907,1.934950386,1536,2020,402,150,150,0,36,0,0.033333333,0,empty,CD-0722-4
"A12,C10",10495,11163,7898,3265,5780,2763,5,2770,1776,994,1.786720322,1521,2626,378,170,166,4,57,2,0.036144578,0,empty,CD-0722-4
"A12,C11",9528,10683,6946,3737,5528,2781,0,2783,1824,959,1.90198123,1616,2444,624,241,241,0,67,0,0.058091286,0,empty,CD-0722-4
"A12,C12",964836,1104820,713184,391636,533772,287471,5,287752,233376,54376,4.291893482,169064,132386,21728,8645,8477,168,1264,6,0.045652943,0,hg38,CD-0722-4
"A12,D1",11099,12409,7983,4426,6426,3389,0,3391,2071,1320,1.568939394,1949,1032,206,69,69,0,22,0,0.217391304,0,empty,CD-0722-4
"A12,D2",9583,10341,7192,3149,5342,2513,2,2522,1626,896,1.814732143,1384,3339,929,338,338,0,83,0,0.121301775,0,empty,CD-0722-4
"A12,D3",8392,9171,6195,2976,4775,2401,0,2402,1503,899,1.67185762,1364,1727,272,128,121,7,36,2,0.314049587,0,empty,CD-0722-4
"A12,D4",8114,9212,6010,3202,4760,2348,0,2350,1591,759,2.096179183,1366,1804,429,164,151,13,44,1,0.125827815,0,empty,CD-0722-4
"A12,D5",7303,8157,5464,2693,4225,2055,0,2064,1324,740,1.789189189,1174,1729,485,191,188,3,51,2,0.015957447,0,empty,CD-0722-4
"A12,D6",11167,12144,8055,4089,6232,3241,0,3245,1932,1313,1.471439452,1860,2119,624,305,302,3,67,1,0.139072848,0,empty,CD-0722-4
"A12,D7",6481,6946,4930,2016,3580,1630,23,1655,1091,564,1.934397163,897,2306,632,269,268,1,62,1,0.041044776,0,empty,CD-0722-4
"A12,D8",7706,8664,5656,3008,4366,2154,3,2160,1362,798,1.706766917,1248,1486,409,151,151,0,43,0,0.052980132,0,empty,CD-0722-4
"A12,D9",4406,4770,3381,1389,2475,1118,0,1119,747,372,2.008064516,587,1703,308,133,132,1,40,1,0.022727273,0,empty,CD-0722-4
"A12,D10",7592,8537,5573,2964,4294,2205,12,2220,1333,887,1.502818489,1250,1225,241,113,112,1,32,1,0.008928571,0,empty,CD-0722-4
"A12,D11",8299,8898,6173,2725,4676,2250,1,2253,1390,863,1.610660487,1259,3197,866,344,342,2,87,1,0.084795322,0,empty,CD-0722-4
"A12,D12",10665,11880,7863,4017,6023,2989,16,3011,1893,1118,1.693202147,1738,3995,966,387,386,1,123,1,0.005181347,0,empty,CD-0722-4
"A12,E1",13708,14692,10100,4592,7613,3731,6,3743,2330,1413,1.648973815,2042,3167,669,293,290,3,82,2,0.079310345,0,empty,CD-0722-4
"A12,E2",878997,1028604,645991,382613,504796,277666,0,277911,225281,52630,4.280467414,166361,190516,31523,12890,12692,198,1876,9,0.063189411,0,hg38,CD-0722-4
"A12,E3",6378,7127,4849,2278,3665,1838,0,1841,1177,664,1.772590361,1001,2108,484,212,210,2,53,2,0.076190476,0,empty,CD-0722-4
"A12,E4",8860,9790,6677,3113,5075,2543,0,2548,1615,933,1.730975348,1428,3250,825,292,291,1,93,1,0.041237113,0,empty,CD-0722-4
"A12,E5",8220,8929,6347,2582,4555,2055,22,2082,1366,716,1.907821229,1159,1755,369,114,112,2,37,2,0.107142857,0,empty,CD-0722-4
"A12,E6",13917,15260,10256,5004,7823,3999,0,4003,2603,1400,1.859285714,2263,3847,939,352,347,5,81,2,0.181556196,0,empty,CD-0722-4
"A12,E7",12569,13668,9305,4363,6992,3389,0,3395,2165,1230,1.760162602,1918,3482,869,360,356,4,99,2,0.042134831,0,empty,CD-0722-4
"A12,E8",10221,11130,7719,3411,5674,2612,14,2628,1723,905,1.903867403,1421,3262,859,337,335,2,80,1,0.080597015,0,empty,CD-0722-4
"A12,E9",6553,7096,4849,2247,3671,1813,3,1822,1186,636,1.864779874,990,3193,815,340,338,2,83,1,0.121301775,0,empty,CD-0722-4
"A12,E10",7508,8417,5604,2813,4281,2069,5,2074,1344,730,1.84109589,1164,2380,663,243,242,1,55,1,0.012396694,0,empty,CD-0722-4
"A12,E11",991889,1144484,738324,406160,560492,299084,1,299368,248196,51172,4.850230595,175531,210177,38570,15152,14929,223,2104,8,0.077567151,0,hg38,CD-0722-4
"A12,E12",1041036,1259062,745862,513200,615497,360775,2,361072,287254,73818,3.891381506,223004,152870,22759,9233,9060,173,1506,7,0.058719647,0,hg38,CD-0722-4
"A12,F1",11535,12682,8515,4167,6562,3264,0,3267,2090,1177,1.775700935,1873,2527,652,281,281,0,88,0,0.106761566,0,empty,CD-0722-4
"A12,F2",8962,9488,6661,2827,4926,2370,0,2371,1514,857,1.766627771,1280,3303,773,293,287,6,83,2,0.114982578,0,empty,CD-0722-4
"A12,F3",8760,9628,6441,3187,5027,2412,0,2424,1560,864,1.805555556,1416,3179,701,285,280,5,98,2,0.135714286,0,empty,CD-0722-4
"A12,F4",1313908,1505977,972900,533077,732748,402492,11,402913,320671,82242,3.899114808,235426,14674,2011,657,646,11,184,3,0.013931889,0,hg38,CD-0722-4
"A12,F5",11013,11851,8245,3606,6070,2838,3,2843,1823,1020,1.787254902,1554,2498,524,241,240,1,71,1,0.033333333,0,empty,CD-0722-4
"A12,F6",3070703,3550032,2284432,1265600,1658359,928728,7,929507,740627,188880,3.921150995,549787,599232,86897,34032,33300,732,3798,13,0.05018018,0,hg38,CD-0722-4
"A12,F7",11828,12848,8858,3990,6624,3250,0,3259,2118,1141,1.856266433,1751,1224,251,126,126,0,41,0,0.023809524,0,empty,CD-0722-4
"A12,F8",8321,9119,6255,2864,4638,2251,0,2252,1452,800,1.815,1214,488,117,53,53,0,24,0,0,0,empty,CD-0722-4
"A12,F9",9303,10122,7074,3048,5223,2491,1,2498,1615,883,1.828992072,1347,3576,862,343,341,2,95,1,0.093841642,0,empty,CD-0722-4
"A12,F10",11767,12635,8818,3817,6584,3080,14,3098,2072,1026,2.019493177,1735,2217,388,166,165,1,46,1,0.157575758,0,empty,CD-0722-4
"A12,F11",8944,9592,6722,2870,4906,2289,0,2289,1486,803,1.850560399,1250,1755,376,146,143,3,46,2,0.146853147,0,empty,CD-0722-4
"A12,F12",9848,10780,7281,3499,5586,2727,5,2737,1793,944,1.899364407,1580,210,18,11,10,1,9,1,0.1,0,empty,CD-0722-4
"A12,G1",10824,11595,8210,3385,6162,2931,0,2936,1890,1046,1.806883365,1601,4129,834,330,327,3,95,1,0.088685015,0,empty,CD-0722-4
"A12,G2",6643,7215,4646,2569,3656,1945,1,1946,1225,721,1.699029126,1156,552,140,56,56,0,20,0,0.071428571,0,empty,CD-0722-4
"A12,G3",12021,12637,8825,3812,6723,3387,0,3388,2059,1329,1.549285177,1810,3054,655,294,288,6,72,2,0.027777778,0,empty,CD-0722-4
"A12,G4",2282021,2818348,1533613,1284735,1378488,968420,2,969098,679167,289931,2.342512529,590134,121,29,14,14,0,7,0,0.214285714,0,empty,CD-0722-4
"A12,G5",7245,7946,5294,2652,4094,2043,0,2048,1358,690,1.968115942,1172,2043,491,235,233,2,53,1,0.111587983,0,empty,CD-0722-4
"A12,G6",10728,11855,7984,3871,6006,2922,0,2925,1961,964,2.034232365,1685,234,18,13,13,0,11,0,0.076923077,0,empty,CD-0722-4
"A12,G7",1172173,1328180,886909,441271,644737,333910,4,334235,266731,67504,3.951336217,191244,297932,54875,21360,20980,380,2477,10,0.058436606,0,hg38,CD-0722-4
"A12,G8",6173,6575,4560,2015,3440,1663,0,1663,1048,615,1.704065041,922,2608,612,240,236,4,93,2,0.046610169,0,empty,CD-0722-4
"A12,G9",859338,953265,659548,293717,462004,225769,1,226028,179061,46967,3.812485362,127801,60838,10076,3811,3719,92,781,8,0.021780048,0,hg38,CD-0722-4
"A12,G10",9143,10122,6803,3319,5290,2685,1,2688,1754,934,1.877944325,1505,3033,798,336,330,6,92,2,0.024242424,0,empty,CD-0722-4
"A12,G11",9029,9979,6871,3108,5147,2440,0,2441,1615,826,1.955205811,1356,2052,533,206,203,3,45,1,0.068965517,0,empty,CD-0722-4
"A12,G12",7339,7941,5411,2530,4178,2105,0,2108,1351,757,1.784676354,1181,2239,722,235,230,5,61,3,0.139130435,0,empty,CD-0722-4
"A12,H1",7928,8365,5827,2538,4448,2090,16,2109,1388,721,1.925104022,1195,1665,476,183,182,1,50,1,0.071428571,0,empty,CD-0722-4
"A12,H2",8877,9813,6435,3378,4948,2395,14,2410,1548,862,1.795823666,1388,3130,719,267,266,1,72,1,0.131578947,0,empty,CD-0722-4
"A12,H3",1986271,2285155,1456000,829155,1089927,600795,18,601307,501941,99366,5.051436105,357980,271428,34961,11784,11474,310,1823,9,0.067892627,0,hg38,CD-0722-4
"A12,H4",11012,11794,8166,3628,6190,3007,0,3007,1871,1136,1.647007042,1675,220,25,18,18,0,10,0,0,0,empty,CD-0722-4
"A12,H5",13092,14391,9666,4725,7289,3689,0,3702,2446,1256,1.947452229,2050,2742,554,219,218,1,64,1,0.110091743,0,empty,CD-0722-4
"A12,H6",7427,8231,5302,2929,4258,2204,0,2204,1441,763,1.888597641,1305,2762,555,219,214,5,63,2,0.098130841,0,empty,CD-0722-4
"A12,H7",8677,9423,6498,2925,4961,2377,0,2381,1533,848,1.807783019,1345,2182,579,194,193,1,51,1,0.062176166,0,empty,CD-0722-4
"A12,H8",9481,10433,6904,3529,5446,2812,0,2814,1784,1030,1.732038835,1603,3079,605,239,236,3,79,2,0.055084746,0,empty,CD-0722-4
"A12,H9",7318,8045,5595,2450,4013,1848,0,1849,1196,653,1.831546708,1032,1001,214,100,100,0,35,0,0.04,0,empty,CD-0722-4
"A12,H10",8071,9284,5900,3384,4666,2476,8,2486,1559,927,1.681769148,1463,2006,397,161,158,3,43,2,0.101265823,0,empty,CD-0722-4
"A12,H11",8509,9794,5836,3958,5253,3233,1,3234,1817,1417,1.282286521,1979,84,0,0,0,0,0,0,0,0,empty,CD-0722-4
"A12,H12",6666,7552,4739,2813,3829,2012,0,2017,1273,744,1.711021505,1199,1626,256,123,120,3,32,2,0.108333333,0,empty,CD-0722-4
"B1,A1",6829,7524,4993,2531,3923,2033,0,2035,1319,716,1.842178771,1137,1712,396,132,130,2,26,1,0.169230769,0,empty,CD-0722-4
"B1,A2",9879,10798,7327,3471,5501,2738,0,2738,1764,974,1.811088296,1504,2035,512,222,218,4,47,2,0.059633028,0,empty,CD-0722-4
"B1,A3",6828,7231,5082,2149,3802,1793,4,1799,1146,653,1.754977029,994,2007,454,214,214,0,54,0,0.126168224,0,empty,CD-0722-4
"B1,A4",11151,12135,8437,3698,6273,3084,0,3086,1952,1134,1.721340388,1647,827,293,116,116,0,22,0,0.077586207,0,empty,CD-0722-4
"B1,A5",11596,12347,8742,3605,6472,3050,0,3052,2012,1040,1.934615385,1657,7953,881,369,361,8,83,2,0.099722992,0,empty,CD-0722-4
"B1,A6",7435,8292,5519,2773,4432,2315,0,2317,1461,856,1.706775701,1339,3762,810,348,342,6,100,2,0.043859649,0,empty,CD-0722-4
"B1,A7",6848,7612,4934,2678,3939,2078,8,2090,1351,739,1.828146143,1207,1673,410,123,123,0,32,0,0.105691057,0,empty,CD-0722-4
"B1,A8",4815,5556,3525,2031,2794,1436,0,1436,945,491,1.924643585,833,2363,534,224,219,5,50,2,0.095890411,0,empty,CD-0722-4
"B1,A9",1174394,1413164,832503,580661,697131,448310,2,448630,341614,107016,3.192176871,263517,38325,2125,709,651,58,152,3,0.168970814,0,hg38,CD-0722-4
"B1,A10",8798,9456,6681,2775,4840,2376,0,2377,1485,892,1.664798206,1322,415,42,24,24,0,9,0,0,0,empty,CD-0722-4
"B1,A11",5955,6645,4486,2159,3456,1642,0,1644,1069,575,1.859130435,944,1461,198,90,88,2,36,2,0.068181818,0,empty,CD-0722-4
"B1,A12",8398,8775,6273,2502,4582,2164,0,2164,1395,769,1.814044213,1133,4488,1142,419,417,2,99,2,0.067146283,0,empty,CD-0722-4
"B1,B1",7808,8682,5812,2870,4501,2239,11,2250,1467,783,1.873563218,1320,2218,659,241,236,5,47,2,0.080508475,0,empty,CD-0722-4
"B1,B2",1629135,1667880,1246548,421332,794420,342564,3,342940,274826,68114,4.034794609,183426,21221,2389,831,797,34,173,3,0.035131744,0,hg38,CD-0722-4
"B1,B3",6337,6919,4712,2207,3493,1722,12,1734,1069,665,1.607518797,981,1848,458,178,177,1,39,1,0.169491525,0,empty,CD-0722-4
"B1,B4",6754,7960,4930,3030,4112,2236,0,2239,1396,843,1.65599051,1330,1427,484,187,185,2,39,1,0.016216216,0,empty,CD-0722-4
"B1,B5",7350,4666,2966,1700,3010,1501,18,1533,979,554,1.767148014,950,1096,351,134,132,2,28,2,0.196969697,0,empty,CD-0722-4
"B1,B6",914128,1070952,672635,398317,518542,289074,3,289315,234768,54547,4.303958055,170664,156069,24145,9154,8986,168,1467,6,0.069107501,0,hg38,CD-0722-4
"B1,B7",7811,8950,5926,3024,4650,2326,2,2333,1519,814,1.866093366,1298,1302,322,101,92,9,30,2,0.054347826,0,empty,CD-0722-4
"B1,B8",5757,6212,4407,1805,3197,1543,0,1543,1026,517,1.984526112,826,1361,423,167,165,2,36,1,0.024242424,0,empty,CD-0722-4
"B1,B9",10209,11271,7357,3914,5826,2991,0,3000,1865,1135,1.643171806,1776,1094,171,81,79,2,30,1,0.063291139,0,empty,CD-0722-4
"B1,B10",5308,5828,3849,1979,3090,1509,4,1520,974,546,1.783882784,861,417,96,14,14,0,9,0,0,0,empty,CD-0722-4
"B1,B11",11430,12845,8265,4580,6505,3554,0,3558,1946,1612,1.20719603,2070,129,9,6,6,0,3,0,0,0,empty,CD-0722-4
"B1,B12",6729,7793,4939,2854,4005,2074,0,2080,1314,766,1.7154047,1238,1865,453,182,182,0,49,0,0.054945055,0,empty,CD-0722-4
"B1,C1",15260,16239,11484,4755,8326,3997,0,3998,2514,1484,1.694070081,2178,1247,262,113,113,0,29,0,0,0,empty,CD-0722-4
"B1,C2",11189,12112,8119,3993,6305,3267,0,3269,2090,1179,1.772688719,1862,2778,780,290,285,5,63,2,0.122807018,0,empty,CD-0722-4
"B1,C3",11391,12406,8420,3986,6497,3206,4,3214,2029,1185,1.712236287,1815,1186,333,114,112,2,26,2,0.017857143,0,empty,CD-0722-4
"B1,C4",6790,7502,5121,2381,4016,1916,0,1916,1210,706,1.71388102,1095,2008,441,152,152,0,48,0,0.013157895,0,empty,CD-0722-4
"B1,C5",10091,10949,7467,3482,5742,2865,0,2865,1866,999,1.867867868,1611,1513,287,101,100,1,33,1,0.06,0,empty,CD-0722-4
"B1,C6",8774,9748,6460,3288,5078,2562,1,2563,1680,883,1.902604757,1448,2397,651,234,233,1,43,1,0.201716738,0,empty,CD-0722-4
"B1,C7",11914,13509,8488,5021,6939,3833,0,3834,2314,1520,1.522368421,2302,645,113,30,30,0,7,0,0,0,empty,CD-0722-4
"B1,C8",13058,14652,9648,5004,7508,3857,0,3866,2480,1386,1.789321789,2265,3744,1298,470,467,3,82,3,0.098501071,0,empty,CD-0722-4
"B1,C9",8758,9838,6436,3402,5121,2595,0,2597,1688,909,1.856985699,1496,1645,357,146,145,1,40,1,0.131034483,0,empty,CD-0722-4
"B1,C10",10095,10952,7676,3276,5662,2681,0,2690,1739,951,1.828601472,1440,2365,539,205,204,1,44,1,0.107843137,0,empty,CD-0722-4
"B1,C11",9427,10528,6846,3682,5358,2631,0,2634,1701,933,1.823151125,1539,2680,607,263,260,3,68,1,0.05,0,empty,CD-0722-4
"B1,C12",760472,913571,519465,394106,449576,294198,3,294411,180074,114337,1.574940745,178913,3074,985,291,289,2,73,2,0.038062284,0,hg38,CD-0722-4
"B1,D1",11763,13532,8531,5001,6977,3761,0,3761,2329,1432,1.626396648,2235,767,202,58,58,0,17,0,0.172413793,0,empty,CD-0722-4
"B1,D2",796425,857639,612480,245159,416204,196856,2,197030,157800,39230,4.022431812,106685,302347,44673,17033,16672,361,2102,6,0.026391555,0,hg38,CD-0722-4
"B1,D3",8520,9352,6332,3020,4867,2436,1,2442,1578,864,1.826388889,1388,2233,461,130,130,0,35,0,0.138461538,0,empty,CD-0722-4
"B1,D4",6349,7079,4831,2248,3667,1804,2,1806,1189,617,1.927066451,1025,1707,387,157,155,2,33,1,0.161290323,0,empty,CD-0722-4
"B1,D5",6919,7623,5167,2456,4050,1942,0,1945,1208,737,1.639077341,1094,2008,357,130,129,1,33,1,0,0,empty,CD-0722-4
"B1,D6",11027,12481,8060,4421,6458,3439,1,3444,2114,1330,1.589473684,2015,1874,477,177,171,6,51,2,0.093567251,0,empty,CD-0722-4
"B1,D7",6388,6956,4862,2094,3607,1656,5,1661,1120,541,2.070240296,923,2740,582,233,231,2,48,1,0.051948052,0,empty,CD-0722-4
"B1,D8",7864,8442,5781,2661,4420,2154,5,2161,1380,781,1.766965429,1220,1479,357,168,165,3,41,2,0.090909091,0,empty,CD-0722-4
"B1,D9",3854,4084,2856,1228,2135,986,0,986,634,352,1.801136364,535,1686,500,187,187,0,42,0,0.155080214,0,empty,CD-0722-4
"B1,D10",7761,8601,5745,2856,4404,2278,3,2287,1450,837,1.732377539,1333,1029,196,78,78,0,27,0,0,0,empty,CD-0722-4
"B1,D11",8412,8918,6318,2600,4527,2146,0,2149,1368,781,1.751600512,1118,3191,887,326,324,2,67,2,0.052469136,0,empty,CD-0722-4
"B1,D12",10996,12089,8179,3910,6274,3203,1,3204,2030,1174,1.729131175,1851,4317,1017,395,386,9,95,2,0.044041451,0,empty,CD-0722-4
"B1,E1",13319,14694,9808,4886,7518,3761,0,3764,2384,1380,1.727536232,2153,2789,751,308,304,4,78,2,0.171052632,0,empty,CD-0722-4
"B1,E2",9478,10065,7062,3003,5201,2616,1,2621,1636,985,1.660913706,1433,2246,503,189,188,1,43,1,0.074468085,0,empty,CD-0722-4
"B1,E3",6640,7286,5004,2282,3851,1830,13,1848,1167,681,1.713656388,1074,2868,894,298,294,4,68,2,0.030612245,0,empty,CD-0722-4
"B1,E4",8562,9305,6318,2987,4798,2312,0,2314,1434,880,1.629545455,1310,2508,434,192,191,1,51,1,0.062827225,0,empty,CD-0722-4
"B1,E5",7932,8701,6015,2686,4376,2046,0,2050,1299,751,1.729693742,1138,1723,330,163,162,1,34,1,0.333333333,0,empty,CD-0722-4
"B1,E6",13704,15016,10118,4898,7754,3938,4,3948,2520,1428,1.764705882,2233,4179,977,378,375,3,88,2,0.093333333,0,empty,CD-0722-4
"B1,E7",15056,16306,11236,5070,8363,3961,0,3962,2629,1333,1.972243061,2160,5778,1371,521,521,0,110,0,0.107485605,0,empty,CD-0722-4
"B1,E8",10733,11209,8145,3064,5853,2663,0,2670,1720,950,1.810526316,1430,3851,1128,425,420,5,86,1,0.030952381,0,empty,CD-0722-4
"B1,E9",5996,6740,4479,2261,3490,1705,8,1719,1140,579,1.968911917,1009,2941,702,275,273,2,71,1,0.065934066,0,empty,CD-0722-4
"B1,E10",7567,8296,5725,2571,4317,2050,0,2055,1319,736,1.792119565,1155,1869,471,210,204,6,55,2,0.039215686,0,empty,CD-0722-4
"B1,E11",9216,9921,6765,3156,5209,2620,0,2624,1631,993,1.642497482,1509,1977,645,243,239,4,44,2,0.058577406,0,empty,CD-0722-4
"B1,E12",8912,9851,6620,3231,5078,2440,0,2444,1556,888,1.752252252,1416,2227,504,203,198,5,52,2,0.272727273,0,empty,CD-0722-4
"B1,F1",12243,13364,9036,4328,6890,3388,0,3391,2086,1305,1.598467433,1944,3655,779,313,308,5,93,2,0.061688312,0,empty,CD-0722-4
"B1,F2",11332,12122,8440,3682,6140,2898,0,2901,1881,1020,1.844117647,1567,4508,1020,384,380,4,83,2,0.078947368,0,empty,CD-0722-4
"B1,F3",11672,13176,8612,4564,6622,3385,0,3389,2276,1113,2.04492363,1949,3651,864,320,311,9,69,3,0.073954984,0,empty,CD-0722-4
"B1,F4",1343113,1516464,1011567,504897,735250,388216,10,388648,304961,83687,3.644066581,222232,37572,4194,1576,1544,32,357,4,0.041450777,0,hg38,CD-0722-4
"B1,F5",10358,11144,7761,3383,5914,2796,1,2802,1781,1021,1.744368266,1562,3492,923,317,314,3,77,1,0.031847134,0,empty,CD-0722-4
"B1,F6",10355,11514,7627,3887,5898,2995,0,3002,1929,1073,1.797763281,1729,3763,946,361,359,2,76,2,0.075208914,0,empty,CD-0722-4
"B1,F7",11403,12480,8330,4150,6528,3157,0,3164,2047,1117,1.832587287,1803,1225,259,105,103,2,31,1,0.097087379,0,empty,CD-0722-4
"B1,F8",8296,9159,6163,2996,4768,2316,11,2327,1487,840,1.770238095,1355,144,27,18,18,0,7,0,0,0,empty,CD-0722-4
"B1,F9",9048,9647,6981,2666,5000,2239,11,2251,1453,798,1.820802005,1194,3408,757,263,259,4,77,2,0.015444015,0,empty,CD-0722-4
"B1,F10",11787,12828,8915,3913,6651,3180,2,3182,2114,1068,1.979400749,1743,1995,368,139,137,2,33,1,0.051094891,0,empty,CD-0722-4
"B1,F11",8676,9450,6553,2897,4801,2227,0,2228,1455,773,1.882276843,1210,1950,478,182,182,0,38,0,0.181318681,0,empty,CD-0722-4
"B1,F12",10064,11149,7453,3696,5660,2795,14,2811,1839,972,1.891975309,1571,139,19,5,5,0,3,0,0,0,empty,CD-0722-4
"B1,G1",10698,11621,8160,3461,6032,2858,0,2862,1883,979,1.923391216,1548,3335,779,311,309,2,81,2,0.093851133,0,empty,CD-0722-4
"B1,G2",6246,6584,4426,2158,3428,1741,0,1741,1079,662,1.629909366,957,210,75,15,14,1,4,1,0,0,empty,CD-0722-4
"B1,G3",12428,13236,9081,4155,6683,3328,29,3357,2047,1310,1.56259542,1847,2827,800,274,273,1,56,1,0.172161172,0,empty,CD-0722-4
"B1,G4",22331,25335,16244,9091,12732,7046,1,7052,4224,2828,1.493635078,4000,38,3,3,3,0,2,0,0.333333333,0,empty,CD-0722-4
"B1,G5",7417,8424,5444,2980,4345,2167,25,2194,1484,710,2.090140845,1264,1930,424,165,162,3,38,2,0.290123457,0,empty,CD-0722-4
"B1,G6",10403,11173,7928,3245,5717,2745,0,2749,1753,996,1.760040161,1471,64,12,9,8,1,4,1,0,0,empty,CD-0722-4
"B1,G7",8914,9581,6840,2741,5035,2256,0,2262,1460,802,1.820448878,1233,3737,1022,352,343,9,94,2,0.023323615,0,empty,CD-0722-4
"B1,G8",748332,815191,574451,240740,396674,188874,1,189038,138306,50732,2.72620831,106625,35315,6539,2378,2349,29,478,2,0.017879949,0,hg38,CD-0722-4
"B1,G9",7911,8653,5987,2666,4423,2130,0,2134,1346,788,1.708121827,1196,2687,611,275,275,0,67,0,0.032727273,0,empty,CD-0722-4
"B1,G10",9157,10054,6693,3361,5198,2643,6,2649,1610,1039,1.549566891,1526,3057,750,333,325,8,84,2,0.147692308,0,empty,CD-0722-4
"B1,G11",558417,649485,395146,254339,322353,192287,0,192448,158269,34179,4.630591884,114738,9412,4206,1600,1598,2,379,1,0.01689612,0,hg38,CD-0722-4
"B1,G12",7746,8642,5678,2964,4446,2214,0,2221,1433,788,1.818527919,1276,2496,542,203,202,1,43,1,0.069306931,0,empty,CD-0722-4
"B1,H1",7520,8091,5549,2542,4210,2034,0,2039,1330,709,1.875881523,1115,1463,538,182,176,6,39,1,0.096590909,0,empty,CD-0722-4
"B1,H2",8939,9928,6659,3269,5101,2531,1,2539,1626,913,1.78094195,1447,3417,810,355,355,0,79,0,0.112676056,0,empty,CD-0722-4
"B1,H3",7068,7695,5146,2549,4024,1979,10,1991,1314,677,1.940915805,1148,1679,303,104,103,1,37,1,0.145631068,0,empty,CD-0722-4
"B1,H4",10759,11526,8003,3523,5832,2792,1,2798,1736,1062,1.634651601,1508,200,17,8,8,0,4,0,0,0,empty,CD-0722-4
"B1,H5",1082281,1149510,847313,302197,552229,249842,3,250167,201677,48490,4.159146216,134107,6505,1946,547,546,1,139,1,0.029304029,0,hg38,CD-0722-4
"B1,H6",6549,7179,4715,2464,3750,1893,0,1895,1239,656,1.888719512,1119,2536,765,253,252,1,58,1,0.047619048,0,empty,CD-0722-4
"B1,H7",8630,9384,6405,2979,5060,2497,2,2502,1656,846,1.957446809,1429,2186,599,235,233,2,47,2,0.111587983,0,empty,CD-0722-4
"B1,H8",9016,10091,6510,3581,5182,2698,0,2702,1763,939,1.877529286,1570,2507,409,132,131,1,51,1,0.007633588,0,empty,CD-0722-4
"B1,H9",6905,7331,5213,2118,3759,1735,0,1735,1145,590,1.940677966,951,1595,416,175,174,1,38,1,0.097701149,0,empty,CD-0722-4
"B1,H10",10200,10926,7760,3166,5387,2536,22,2566,1785,781,2.28553137,1369,2156,551,218,215,3,33,1,0.055813953,0,empty,CD-0722-4
"B1,H11",8730,10106,6165,3941,5155,3132,1,3135,1722,1413,1.218683652,1907,25,6,4,4,0,1,0,0,0,empty,CD-0722-4
"B1,H12",6578,7245,4870,2375,3688,1912,0,1913,1227,686,1.788629738,1070,1406,366,170,169,1,34,1,0.023668639,0,empty,CD-0722-4
"B2,A1",7686,8662,5648,3014,4565,2384,0,2386,1502,884,1.699095023,1413,1776,374,169,169,0,35,0,0.100591716,0,empty,CD-0722-4
"B2,A2",10876,12319,7983,4336,6338,3261,1,3277,2081,1196,1.739966555,1873,2136,505,226,226,0,59,0,0.026548673,0,empty,CD-0722-4
"B2,A3",6573,6988,4845,2143,3725,1800,0,1803,1192,611,1.950900164,1000,1401,270,100,100,0,35,0,0.18,0,empty,CD-0722-4
"B2,A4",12084,13168,9053,4115,6844,3338,0,3344,2168,1176,1.843537415,1833,769,190,71,70,1,24,1,0.085714286,0,empty,CD-0722-4
"B2,A5",992342,1117980,742669,375311,545420,284956,10,285218,230643,54575,4.226165827,164175,224525,28891,11412,11149,263,1682,6,0.069512961,0,hg38,CD-0722-4
"B2,A6",24184,27500,18020,9480,13969,7198,0,7201,4998,2203,2.268724467,4143,3770,970,370,364,6,82,2,0.151098901,0,empty,CD-0722-4
"B2,A7",7670,8450,5702,2748,4288,2171,6,2182,1399,783,1.786717752,1189,1197,257,92,92,0,35,0,0.086956522,0,empty,CD-0722-4
"B2,A8",4654,5119,3453,1666,2733,1376,0,1377,856,521,1.642994242,802,1679,441,155,154,1,52,1,0.064935065,0,empty,CD-0722-4
"B2,A9",7866,8654,5856,2798,4546,2261,0,2264,1482,782,1.895140665,1265,2129,388,164,162,2,50,1,0.061728395,0,empty,CD-0722-4
"B2,A10",13053,14376,9842,4534,7170,3552,18,3579,2351,1228,1.914495114,1962,404,72,45,45,0,15,0,0.022222222,0,empty,CD-0722-4
"B2,A11",6930,7557,5284,2273,3862,1787,15,1802,1154,648,1.780864198,985,1800,409,179,171,8,41,2,0.011695906,0,empty,CD-0722-4
"B2,A12",9575,10222,7302,2920,5209,2431,0,2432,1601,831,1.926594465,1310,3409,716,282,274,8,76,2,0.054744526,0,empty,CD-0722-4
"B2,B1",7864,8325,5910,2415,4384,2196,0,2196,1343,853,1.574443142,1141,1431,412,116,111,5,32,2,0.045045045,0,empty,CD-0722-4
"B2,B2",8589,9419,5849,3570,4911,2650,16,2669,1677,992,1.690524194,1584,608,122,42,41,1,15,1,0.341463415,0,empty,CD-0722-4
"B2,B3",6461,6988,4729,2259,3612,1779,0,1784,1193,591,2.018612521,962,1680,318,124,124,0,40,0,0.072580645,0,empty,CD-0722-4
"B2,B4",7793,8753,5676,3077,4514,2413,0,2416,1492,924,1.614718615,1365,1469,322,138,136,2,44,1,0.088235294,0,empty,CD-0722-4
"B2,B5",7938,4853,3240,1613,3211,1680,0,1689,1097,592,1.853040541,1019,1035,268,100,96,4,25,2,0,0,empty,CD-0722-4
"B2,B6",9031,10153,6497,3656,5271,2791,0,2793,1701,1092,1.557692308,1625,1945,504,182,182,0,38,0,0.076923077,0,empty,CD-0722-4
"B2,B7",8539,9050,6375,2675,4771,2303,14,2319,1516,803,1.887920299,1278,1383,448,142,142,0,42,0,0,0,empty,CD-0722-4
"B2,B8",6107,6549,4568,1981,3340,1541,0,1541,1032,509,2.027504912,806,1916,398,161,161,0,54,0,0.074534161,0,empty,CD-0722-4
"B2,B9",1826418,2069710,1372496,697214,979822,517704,2,518143,412482,105661,3.903824495,300523,105949,16009,6033,5909,124,1040,6,0.050770012,0,hg38,CD-0722-4
"B2,B10",5740,6120,4255,1865,3349,1617,0,1622,1035,587,1.763202726,938,591,79,31,31,0,11,0,0,0,empty,CD-0722-4
"B2,B11",16265,17961,11946,6015,9025,4731,0,4736,2714,2022,1.34223541,2742,378,142,54,54,0,11,0,0.333333333,0,empty,CD-0722-4
"B2,B12",7873,8722,5873,2849,4527,2265,0,2265,1381,884,1.562217195,1274,2513,555,221,215,6,63,2,0.079069767,0,empty,CD-0722-4
"B2,C1",14902,15471,11489,3982,8064,3729,3,3738,2377,1361,1.746509919,1923,1688,346,172,171,1,47,1,0.058479532,0,empty,CD-0722-4
"B2,C2",12131,13260,8915,4345,6734,3338,0,3346,2110,1236,1.707119741,1888,2865,621,272,271,1,69,1,0.062730627,0,empty,CD-0722-4
"B2,C3",12059,13308,8929,4379,6967,3335,1,3343,2070,1273,1.626080126,1884,1004,250,77,77,0,26,0,0.012987013,0,empty,CD-0722-4
"B2,C4",7621,8161,5679,2482,4320,2017,2,2023,1372,651,2.107526882,1115,2282,534,183,182,1,49,1,0.093406593,0,empty,CD-0722-4
"B2,C5",11013,12167,8294,3873,6365,3180,0,3181,2124,1057,2.009460738,1817,1964,451,187,187,0,52,0,0.13368984,0,empty,CD-0722-4
"B2,C6",9236,10100,6903,3197,5369,2678,2,2683,1756,927,1.894282632,1456,1741,452,166,164,2,48,1,0.067073171,0,empty,CD-0722-4
"B2,C7",12419,14297,8888,5409,7231,4026,0,4031,2426,1605,1.51152648,2426,386,23,8,8,0,4,0,0,0,empty,CD-0722-4
"B2,C8",13607,14692,10132,4560,7551,3786,0,3801,2417,1384,1.746387283,2064,3349,725,252,247,5,74,2,0.056680162,0,empty,CD-0722-4
"B2,C9",9955,11150,7415,3735,5763,2881,0,2884,1839,1045,1.759808612,1664,1746,359,146,146,0,45,0,0.034246575,0,empty,CD-0722-4
"B2,C10",913150,1023030,685109,337921,496156,255757,1,256017,206705,49312,4.191778877,146670,161453,22207,8674,8481,193,1402,6,0.046220965,0,hg38,CD-0722-4
"B2,C11",9712,10545,7274,3271,5529,2684,1,2691,1644,1047,1.570200573,1512,2655,583,186,186,0,58,0,0.139784946,0,empty,CD-0722-4
"B2,C12",13826,15130,10178,4952,7778,3780,26,3809,2555,1254,2.037480064,2181,2589,594,264,262,2,62,2,0.011450382,0,empty,CD-0722-4
"B2,D1",12148,13936,8730,5206,7053,3809,0,3811,2253,1558,1.446084724,2267,1303,594,182,181,1,26,1,0.066298343,0,empty,CD-0722-4
"B2,D2",9886,10793,7542,3251,5642,2644,0,2647,1752,895,1.957541899,1457,2590,739,244,243,1,59,1,0.193415638,0,empty,CD-0722-4
"B2,D3",9526,10853,7075,3778,5535,2803,0,2805,1838,967,1.900723888,1629,1946,418,140,131,9,40,1,0.091603053,0,empty,CD-0722-4
"B2,D4",6800,7774,4964,2810,4004,2073,1,2080,1356,724,1.872928177,1218,1463,378,144,143,1,42,1,0.055944056,0,empty,CD-0722-4
"B2,D5",8018,8945,5862,3083,4575,2260,0,2260,1497,763,1.961992136,1312,1789,394,181,180,1,41,1,0.233333333,0,empty,CD-0722-4
"B2,D6",12080,13493,8569,4924,6781,3634,0,3641,2227,1414,1.574964639,2125,1885,484,197,197,0,56,0,0.07106599,0,empty,CD-0722-4
"B2,D7",6497,6753,4913,1840,3582,1689,0,1689,1108,581,1.907056799,891,2398,538,186,185,1,59,1,0.032432432,0,empty,CD-0722-4
"B2,D8",7998,9029,5900,3129,4782,2380,6,2386,1554,832,1.867788462,1425,1643,563,237,235,2,52,2,0.029787234,0,empty,CD-0722-4
"B2,D9",4751,5165,3554,1611,2670,1316,0,1318,859,459,1.871459695,721,1241,233,94,88,6,27,2,0.147727273,0,empty,CD-0722-4
"B2,D10",8073,8918,5924,2994,4511,2225,0,2230,1439,791,1.819216182,1303,986,174,73,73,0,22,0,0.068493151,0,empty,CD-0722-4
"B2,D11",9066,9535,6910,2625,5052,2372,0,2372,1504,868,1.732718894,1268,2834,900,379,376,3,87,2,0.143617021,0,empty,CD-0722-4
"B2,D12",1113891,1279808,835439,444369,616895,330032,1,330289,245269,85020,2.884838861,192988,209938,19976,7607,7364,243,1301,9,0.04359044,0,hg38,CD-0722-4
"B2,E1",14364,15501,10629,4872,8135,4019,0,4023,2493,1530,1.629411765,2253,2855,457,211,210,1,67,1,0.09047619,0,empty,CD-0722-4
"B2,E2",10147,11330,7381,3949,5938,3042,0,3045,1902,1143,1.664041995,1768,2339,625,225,224,1,68,1,0.013392857,0,empty,CD-0722-4
"B2,E3",6823,7399,5186,2213,3935,1886,0,1890,1228,662,1.854984894,1028,2473,881,322,319,3,69,2,0.12539185,0,empty,CD-0722-4
"B2,E4",9684,10496,7270,3226,5449,2655,5,2672,1761,911,1.933040615,1473,3021,706,291,280,11,81,2,0.057142857,0,empty,CD-0722-4
"B2,E5",8194,8620,6267,2353,4497,2052,0,2052,1325,727,1.822558459,1058,1458,416,127,127,0,34,0,0.015748031,0,empty,CD-0722-4
"B2,E6",14898,16430,11157,5273,8332,4185,16,4207,2667,1540,1.731818182,2367,3130,829,288,284,4,83,1,0.028169014,0,empty,CD-0722-4
"B2,E7",1471749,1685398,1096283,589115,811172,446901,2,447289,333332,113957,2.925068227,260324,140517,25683,9733,9591,142,1491,8,0.04890001,0,hg38,CD-0722-4
"B2,E8",11031,12062,8312,3750,6211,2893,0,2897,1892,1005,1.882587065,1609,2983,726,311,304,7,74,2,0.055921053,0,empty,CD-0722-4
"B2,E9",6739,7421,5021,2400,3820,1885,0,1888,1269,619,2.050080775,1058,2962,603,264,262,2,62,1,0.129770992,0,empty,CD-0722-4
"B2,E10",8227,8637,6072,2565,4544,2132,0,2132,1420,712,1.994382022,1179,1848,416,190,189,1,42,1,0.074074074,0,empty,CD-0722-4
"B2,E11",9566,10624,7084,3540,5488,2762,1,2777,1762,1015,1.735960591,1570,2475,562,238,236,2,66,1,0.050847458,0,empty,CD-0722-4
"B2,E12",2551073,2881360,1910866,970494,1367502,730507,24,731184,569758,161426,3.529530559,426429,305387,39437,15341,14989,352,2143,10,0.044099006,0,hg38,CD-0722-4
"B2,F1",12247,12951,9096,3855,6771,3322,6,3334,2086,1248,1.671474359,1798,2705,617,255,251,4,61,2,0.007968127,0,empty,CD-0722-4
"B2,F2",9651,10254,7168,3086,5268,2533,19,2558,1668,890,1.874157303,1395,2905,722,262,256,6,72,2,0.078125,0,empty,CD-0722-4
"B2,F3",9229,10037,6834,3203,5250,2560,0,2562,1693,869,1.948216341,1460,3412,703,332,328,4,83,2,0.125,0,empty,CD-0722-4
"B2,F4",13730,14551,10378,4173,7550,3522,0,3531,2387,1144,2.086538462,1897,470,57,31,31,0,18,0,0.096774194,0,empty,CD-0722-4
"B2,F5",11206,12088,8379,3709,6231,2928,6,2937,1923,1014,1.896449704,1645,2673,681,262,259,3,61,2,0.104247104,0,empty,CD-0722-4
"B2,F6",11200,12327,8271,4056,6342,3229,1,3234,2085,1149,1.81462141,1842,3494,618,255,252,3,84,2,0.075396825,0,empty,CD-0722-4
"B2,F7",12274,13343,9184,4159,6906,3368,20,3390,2191,1199,1.82735613,1890,1309,303,134,134,0,43,0,0.007462687,0,empty,CD-0722-4
"B2,F8",9605,10405,7032,3373,5319,2555,0,2557,1681,876,1.918949772,1425,450,44,28,26,2,14,2,0,0,empty,CD-0722-4
"B2,F9",9861,10720,7437,3283,5695,2748,0,2753,1876,877,2.139110604,1506,3607,636,282,280,2,74,1,0.014285714,0,empty,CD-0722-4
"B2,F10",12726,13844,9588,4256,7157,3414,0,3414,2167,1247,1.73777065,1902,2419,643,258,257,1,75,1,0.120622568,0,empty,CD-0722-4
"B2,F11",9508,10161,7289,2872,5195,2365,0,2365,1598,767,2.083441982,1263,1737,363,146,142,4,32,2,0.077464789,0,empty,CD-0722-4
"B2,F12",10551,11271,7810,3461,5812,2799,3,2807,1793,1014,1.768244576,1583,306,39,23,23,0,9,0,0.043478261,0,empty,CD-0722-4
"B2,G1",1092448,1264744,799646,465098,616645,356665,4,356973,288033,68940,4.178024369,205912,430131,58575,23404,22840,564,2862,10,0.071278459,0,hg38,CD-0722-4
"B2,G2",6678,7305,4657,2648,3731,1921,0,1921,1244,677,1.837518464,1128,531,79,25,25,0,13,0,0,0,empty,CD-0722-4
"B2,G3",728359,683656,575457,108199,355711,163406,10,163559,103542,60017,1.72521119,56041,6109,2308,544,540,4,171,2,0.02962963,0,hg38,CD-0722-4
"B2,G4",21546,24463,15487,8976,12513,6970,0,6972,4182,2790,1.498924731,4138,91,11,7,6,1,2,1,0,0,empty,CD-0722-4
"B2,G5",7766,8634,5816,2818,4441,2222,0,2222,1449,773,1.874514877,1258,1980,669,258,257,1,48,1,0.085603113,0,empty,CD-0722-4
"B2,G6",11571,12798,8659,4139,6528,3208,6,3214,2131,1083,1.967682364,1875,238,36,25,25,0,10,0,0.04,0,empty,CD-0722-4
"B2,G7",9115,10060,6889,3171,5245,2505,2,2509,1655,854,1.93793911,1417,2942,887,362,359,3,72,2,0.114206128,0,empty,CD-0722-4
"B2,G8",1072276,1255742,783713,472029,607393,340121,2,340420,281410,59010,4.768852737,204292,161882,22466,8973,8786,187,1482,7,0.041201912,0,hg38,CD-0722-4
"B2,G9",834907,998593,593924,404669,491111,306766,1,306995,226382,80613,2.808256733,184170,98683,45271,16364,16308,56,2050,5,0.031518273,0,hg38,CD-0722-4
"B2,G10",9445,10260,6992,3268,5431,2759,0,2768,1754,1014,1.729783037,1533,2701,698,291,291,0,80,0,0.058419244,0,empty,CD-0722-4
"B2,G11",9625,10455,7217,3238,5434,2629,0,2632,1755,877,2.001140251,1474,1650,526,225,224,1,49,1,0.058035714,0,empty,CD-0722-4
"B2,G12",7844,9150,5684,3466,4717,2489,0,2497,1565,932,1.679184549,1484,2888,709,240,237,3,61,1,0.021097046,0,empty,CD-0722-4
"B2,H1",8144,9061,6078,2983,4672,2216,0,2220,1398,822,1.700729927,1267,1907,404,182,175,7,43,1,0.057142857,0,empty,CD-0722-4
"B2,H2",9386,10280,6872,3408,5290,2646,0,2650,1711,939,1.822151225,1503,2622,541,200,198,2,67,2,0.01010101,0,empty,CD-0722-4
"B2,H3",7808,8535,5842,2693,4496,2244,1,2248,1432,816,1.754901961,1241,1814,518,199,194,5,48,1,0.195876289,0,empty,CD-0722-4
"B2,H4",11793,12854,8607,4247,6596,3226,5,3234,2150,1084,1.983394834,1866,257,19,12,12,0,9,0,0.083333333,0,empty,CD-0722-4
"B2,H5",12541,13980,9364,4616,7134,3531,0,3539,2340,1199,1.951626355,1983,2816,724,300,294,6,74,1,0.088435374,0,empty,CD-0722-4
"B2,H6",7790,8726,5599,3127,4517,2272,0,2273,1472,801,1.837702871,1338,2149,446,190,187,3,55,2,0.13368984,0,empty,CD-0722-4
"B2,H7",8842,9686,6605,3081,4891,2399,10,2409,1635,774,2.112403101,1361,2126,629,234,230,4,56,2,0.156521739,0,empty,CD-0722-4
"B2,H8",10147,11316,7422,3894,5776,2951,0,2953,1847,1106,1.669981917,1680,2783,644,274,272,2,70,2,0.058823529,0,empty,CD-0722-4
"B2,H9",7745,8304,5837,2467,4245,1962,10,1972,1307,665,1.965413534,1080,1397,317,124,124,0,33,0,0.040322581,0,empty,CD-0722-4
"B2,H10",6795,7741,5018,2723,3910,1890,0,1892,1275,617,2.066450567,1130,1805,492,176,173,3,47,1,0.028901734,0,empty,CD-0722-4
"B2,H11",9129,10381,6322,4059,5317,3180,0,3186,1769,1417,1.248412138,1902,124,17,6,6,0,1,0,1,0,empty,CD-0722-4
"B2,H12",893813,1012582,666854,345728,496058,262841,3,263121,212090,51031,4.156101193,153151,23301,4172,1524,1493,31,361,3,0.010046885,0,hg38,CD-0722-4
"B3,A1",7462,8231,5457,2774,4372,2213,0,2213,1403,810,1.732098765,1284,2250,726,225,215,10,46,2,0.11627907,0,empty,CD-0722-4
"B3,A2",709791,792874,534508,258366,387536,199109,1,199299,157198,42101,3.73383055,112471,159416,28108,11264,11112,152,1645,3,0.031767459,0,hg38,CD-0722-4
"B3,A3",6646,7109,4792,2317,3764,1884,0,1886,1227,659,1.861911988,1044,1625,303,135,135,0,49,0,0.066666667,0,empty,CD-0722-4
"B3,A4",11409,12252,8503,3749,6467,3138,1,3142,1941,1201,1.616153206,1737,883,174,58,58,0,20,0,0,0,empty,CD-0722-4
"B3,A5",9726,10294,7264,3030,5534,2647,0,2650,1705,945,1.804232804,1441,2900,851,300,291,9,72,3,0.075601375,0,empty,CD-0722-4
"B3,A6",869027,998000,657024,340976,497493,272153,21,272410,183282,89128,2.056390809,159240,90901,5835,2343,2224,119,536,7,0.063399281,0,hg38,CD-0722-4
"B3,A7",7412,8186,5481,2705,4255,2201,0,2203,1435,768,1.868489583,1229,1729,336,121,121,0,29,0,0.024793388,0,empty,CD-0722-4
"B3,A8",4722,4878,3494,1384,2710,1277,0,1277,893,384,2.325520833,680,2737,642,259,257,2,72,1,0.031128405,0,empty,CD-0722-4
"B3,A9",7496,8218,5652,2566,4341,2095,1,2096,1369,727,1.883081155,1191,2176,489,185,181,4,54,2,0.149171271,0,empty,CD-0722-4
"B3,A10",717939,835597,538003,297594,410878,222411,22,222582,182556,40026,4.560935392,129853,40422,5978,2273,2242,31,463,2,0.072702944,0,hg38,CD-0722-4
"B3,A11",6285,6648,4826,1822,3562,1676,16,1694,1159,535,2.16635514,886,2345,635,235,233,2,51,1,0.107296137,0,empty,CD-0722-4
"B3,A12",9582,9944,7160,2784,5181,2450,0,2451,1657,794,2.086901763,1284,4481,1303,479,476,3,114,1,0.075630252,0,empty,CD-0722-4
"B3,B1",7589,8374,5436,2938,4446,2287,0,2287,1438,849,1.693757362,1359,1467,475,182,182,0,43,0,0.10989011,0,empty,CD-0722-4
"B3,B2",507363,612322,337087,275235,309225,208064,22,208215,158654,49561,3.201186417,127282,2691,418,126,123,3,29,2,0.308943089,0,hg38,CD-0722-4
"B3,B3",7136,8021,5250,2771,4167,2080,2,2084,1401,683,2.05124451,1217,1886,435,165,162,3,48,1,0.018518519,0,empty,CD-0722-4
"B3,B4",805881,942825,593582,349243,466373,266220,1,266412,197609,68803,2.8720986,157125,12504,4706,1681,1672,9,320,3,0.057416268,0,hg38,CD-0722-4
"B3,B5",7893,4945,3131,1814,3171,1620,1,1632,1083,549,1.972677596,979,1094,373,151,150,1,41,1,0.006666667,0,empty,CD-0722-4
"B3,B6",8452,9245,6175,3070,4935,2541,3,2549,1596,953,1.674711438,1434,2010,508,199,198,1,54,1,0.106060606,0,empty,CD-0722-4
"B3,B7",8285,8997,6185,2812,4765,2326,0,2329,1491,838,1.779236277,1288,1437,296,137,135,2,40,2,0.081481481,0,empty,CD-0722-4
"B3,B8",550035,593174,430867,162307,290204,129631,1,129789,96848,32941,2.940044322,69554,38033,6415,2404,2362,42,468,3,0.040643522,0,hg38,CD-0722-4
"B3,B9",17020,18867,13041,5826,9318,4482,1,4492,3132,1360,2.302941176,2444,2017,311,141,136,5,42,2,0.036764706,0,empty,CD-0722-4
"B3,B10",5657,6009,4156,1853,3264,1594,0,1599,1024,575,1.780869565,892,617,154,69,68,1,25,1,0.029411765,0,empty,CD-0722-4
"B3,B11",15391,17842,10814,7028,9144,5498,0,5504,3007,2497,1.204245094,3276,278,42,21,20,1,11,1,0,0,empty,CD-0722-4
"B3,B12",6891,7720,5187,2533,4057,1990,0,1992,1307,685,1.908029197,1122,2144,553,209,209,0,51,0,0.028708134,0,empty,CD-0722-4
"B3,C1",15265,16113,11290,4823,8440,4067,1,4072,2600,1472,1.766304348,2215,1509,298,131,129,2,42,1,0,0,empty,CD-0722-4
"B3,C2",11222,12385,8146,4239,6424,3307,3,3316,2130,1186,1.795952782,1908,2671,925,332,330,2,66,1,0.115151515,0,empty,CD-0722-4
"B3,C3",11631,12510,8745,3765,6663,3251,1,3255,2137,1118,1.911449016,1779,1447,184,71,70,1,23,1,0.114285714,0,empty,CD-0722-4
"B3,C4",7596,8035,5646,2389,4293,2000,0,2000,1357,643,2.110419907,1079,2527,688,277,277,0,55,0,0.032490975,0,empty,CD-0722-4
"B3,C5",10631,11757,7791,3966,6156,3138,7,3149,1999,1150,1.73826087,1846,1920,559,207,204,3,52,2,0.12745098,0,empty,CD-0722-4
"B3,C6",10299,11371,7561,3810,5995,3060,0,3067,2128,939,2.266240682,1713,1800,550,240,239,1,60,1,0.029288703,0,empty,CD-0722-4
"B3,C7",11598,13579,8220,5359,7032,3902,1,3904,2316,1588,1.458438287,2394,439,164,55,55,0,14,0,0.309090909,0,empty,CD-0722-4
"B3,C8",12813,14165,9331,4834,7474,3804,0,3810,2543,1267,2.007103394,2203,3918,866,326,324,2,89,1,0.037037037,0,empty,CD-0722-4
"B3,C9",9399,10181,6908,3273,5329,2664,23,2687,1728,959,1.801876955,1506,1592,328,123,123,0,43,0,0.016260163,0,empty,CD-0722-4
"B3,C10",10591,11586,7811,3775,6036,2987,0,2992,1947,1045,1.863157895,1690,2703,648,225,221,4,60,2,0.081447964,0,empty,CD-0722-4
"B3,C11",9804,10917,7179,3738,5660,2845,0,2851,1737,1114,1.559245961,1675,2192,438,185,184,1,53,1,0.005434783,0,empty,CD-0722-4
"B3,C12",12925,14391,9546,4845,7368,3595,8,3608,2423,1185,2.044725738,2081,2399,602,217,213,4,56,1,0.145539906,0,empty,CD-0722-4
"B3,D1",11488,12786,8378,4408,6607,3520,19,3539,2163,1376,1.571947674,2031,936,135,58,58,0,16,0,0.120689655,0,empty,CD-0722-4
"B3,D2",10121,10926,7806,3120,5787,2649,0,2653,1690,963,1.754932503,1424,3219,1119,356,354,2,88,2,0.011299435,0,empty,CD-0722-4
"B3,D3",8378,9307,6057,3250,4824,2514,1,2517,1617,900,1.796666667,1501,1502,434,143,143,0,36,0,0.132867133,0,empty,CD-0722-4
"B3,D4",8324,9190,6150,3040,4839,2423,21,2448,1712,736,2.326086957,1404,1690,443,181,178,3,40,1,0.140449438,0,empty,CD-0722-4
"B3,D5",7399,8026,5401,2625,4179,2102,1,2105,1406,699,2.011444921,1210,1920,362,134,132,2,32,1,0.28030303,0,empty,CD-0722-4
"B3,D6",11428,12441,8234,4207,6476,3418,18,3440,2090,1350,1.548148148,1959,2063,495,200,197,3,51,1,0.076142132,0,empty,CD-0722-4
"B3,D7",6390,6770,4694,2076,3550,1678,0,1687,1103,584,1.88869863,929,2153,512,150,150,0,42,0,0.12,0,empty,CD-0722-4
"B3,D8",8391,9167,6151,3016,4785,2383,0,2388,1567,821,1.90864799,1323,1644,371,165,161,4,36,1,0.031055901,0,empty,CD-0722-4
"B3,D9",4267,4584,3140,1444,2453,1153,0,1156,763,393,1.941475827,678,1865,374,116,116,0,38,0,0.112068966,0,empty,CD-0722-4
"B3,D10",910275,1097855,649165,448690,536311,317109,1,317360,257373,59987,4.290479604,195647,33575,8346,3216,3186,30,650,6,0.06873823,0,hg38,CD-0722-4
"B3,D11",8743,9317,6521,2796,4924,2362,0,2365,1525,840,1.81547619,1286,3586,1119,409,407,2,82,2,0.076167076,0,empty,CD-0722-4
"B3,D12",12137,13324,9021,4303,6864,3368,0,3368,2193,1175,1.866382979,1939,4904,1125,476,472,4,115,2,0.099576271,0,empty,CD-0722-4
"B3,E1",13627,14867,10016,4851,7784,3935,0,3938,2541,1397,1.818897638,2260,4229,1129,435,430,5,90,1,0.146511628,0,empty,CD-0722-4
"B3,E2",9869,10835,7145,3690,5516,2814,0,2817,1817,1000,1.817,1618,2335,487,195,194,1,54,1,0.201030928,0,empty,CD-0722-4
"B3,E3",6920,7512,5294,2218,3855,1875,0,1877,1240,637,1.946624804,1007,3536,1167,461,457,4,91,2,0.067833698,0,empty,CD-0722-4
"B3,E4",9405,10472,6780,3692,5454,2777,0,2778,1833,945,1.93968254,1633,3197,765,282,273,9,83,2,0.091575092,0,empty,CD-0722-4
"B3,E5",8495,9257,6396,2861,4742,2172,4,2182,1441,741,1.944669366,1212,2244,625,201,196,5,45,2,0.086734694,0,empty,CD-0722-4
"B3,E6",536029,642914,367636,275278,319407,204837,12,204999,160380,44619,3.594432865,125147,17886,8315,3017,3009,8,661,3,0.013625789,0,hg38,CD-0722-4
"B3,E7",14038,15259,10407,4852,7874,3775,0,3777,2529,1248,2.026442308,2127,3744,826,294,294,0,83,0,0.098639456,0,empty,CD-0722-4
"B3,E8",11229,12033,8433,3600,6234,2924,0,2926,1889,1037,1.821600771,1595,3529,673,268,257,11,72,2,0.003891051,0,empty,CD-0722-4
"B3,E9",6555,6999,4758,2241,3652,1783,0,1783,1202,581,2.068846816,993,3077,683,304,304,0,68,0,0.065789474,0,empty,CD-0722-4
"B3,E10",7981,8856,5912,2944,4556,2188,0,2194,1448,746,1.941018767,1233,2495,616,217,216,1,51,1,0.009259259,0,empty,CD-0722-4
"B3,E11",9179,9806,6756,3050,5119,2494,0,2499,1603,896,1.7890625,1379,2073,634,249,248,1,62,1,0.254032258,0,empty,CD-0722-4
"B3,E12",9717,10864,7125,3739,5647,2779,1,2782,1851,931,1.988184748,1608,2216,288,146,143,3,47,1,0.104895105,0,empty,CD-0722-4
"B3,F1",11666,12442,8762,3680,6398,3037,0,3040,2001,1039,1.925890279,1652,2903,635,198,197,1,63,1,0.060913706,0,empty,CD-0722-4
"B3,F2",8710,9171,6466,2705,4860,2279,1,2280,1516,764,1.984293194,1253,3308,824,320,314,6,75,2,0.054140127,0,empty,CD-0722-4
"B3,F3",17943,20096,13701,6395,9992,4853,12,4877,3543,1334,2.655922039,2772,4961,1265,514,509,5,126,2,0.04518664,0,empty,CD-0722-4
"B3,F4",13667,14875,10296,4579,7633,3575,4,3583,2347,1236,1.898867314,1989,864,136,40,40,0,25,0,0.225,0,empty,CD-0722-4
"B3,F5",10977,11529,8269,3260,5980,2748,22,2773,1797,976,1.841188525,1464,2796,542,234,231,3,72,2,0.134199134,0,empty,CD-0722-4
"B3,F6",2909318,3464932,2100090,1364842,1646780,981965,6,982787,762960,219827,3.470729255,598257,426317,85768,32856,32461,395,3646,12,0.048057669,0,hg38,CD-0722-4
"B3,F7",12119,13352,8927,4425,7117,3504,0,3507,2334,1173,1.989769821,1986,1294,280,119,119,0,36,0,0.008403361,0,empty,CD-0722-4
"B3,F8",9795,10312,7271,3041,5376,2587,1,2592,1731,861,2.010452962,1440,559,86,37,37,0,14,0,0.027027027,0,empty,CD-0722-4
"B3,F9",862419,914991,678151,236840,446006,197634,2,197799,159672,38127,4.18789834,105961,74137,13763,5214,5156,58,898,5,0.021722265,0,hg38,CD-0722-4
"B3,F10",1118136,1239294,854328,384966,599721,298027,1,298336,224845,73491,3.059490278,168046,174684,25406,9475,9257,218,1454,8,0.041806201,0,hg38,CD-0722-4
"B3,F11",8986,9647,6851,2796,5076,2347,8,2359,1523,836,1.821770335,1305,1920,470,175,173,2,34,1,0.046242775,0,empty,CD-0722-4
"B3,F12",10694,11437,7609,3828,6101,3054,0,3054,1995,1059,1.883852691,1751,356,66,35,34,1,10,1,0.088235294,0,empty,CD-0722-4
"B3,G1",2375895,2760162,1740838,1019324,1320395,760334,5,760997,638808,122189,5.228031983,449508,84456,14546,5291,5217,74,1206,6,0.027218708,0,hg38,CD-0722-4
"B3,G2",6252,6666,4464,2202,3564,1842,0,1842,1142,700,1.631428571,1061,537,155,65,64,1,20,1,0.078125,0,empty,CD-0722-4
"B3,G3",14798,15810,10848,4962,8047,4137,6,4147,2558,1589,1.609817495,2220,2801,801,245,243,2,62,1,0.032921811,0,empty,CD-0722-4
"B3,G4",21664,23962,15527,8435,12252,6673,0,6677,4068,2609,1.559218091,3791,113,10,9,9,0,5,0,0.111111111,0,empty,CD-0722-4
"B3,G5",7273,7860,5372,2488,4118,2041,0,2042,1321,721,1.832177531,1121,2238,499,179,177,2,50,1,0.118644068,0,empty,CD-0722-4
"B3,G6",1183155,1325526,897991,427535,638385,324510,16,324860,254349,70511,3.607224405,184618,12210,1750,712,702,10,150,2,0.061253561,0,hg38,CD-0722-4
"B3,G7",977192,1118731,733640,385091,548351,290803,17,291041,229201,61840,3.70635511,168945,207415,30200,11779,11543,236,1799,8,0.048860781,0,hg38,CD-0722-4
"B3,G8",6937,7642,5147,2495,3927,1909,0,1914,1291,623,2.07223114,1094,2416,504,236,233,3,73,2,0.055793991,0,empty,CD-0722-4
"B3,G9",917435,1100431,668369,432062,538717,310386,2,310651,247528,63123,3.921359885,190181,66916,17847,6364,6310,54,1246,4,0.024722662,0,hg38,CD-0722-4
"B3,G10",9618,10715,7040,3675,5570,2817,0,2819,1820,999,1.821821822,1638,4419,1307,448,442,6,97,3,0.027149321,0,empty,CD-0722-4
"B3,G11",8993,9668,6748,2920,5078,2389,0,2392,1556,836,1.861244019,1275,1844,558,207,207,0,44,0,0.062801932,0,empty,CD-0722-4
"B3,G12",7401,8066,5498,2568,4321,2122,0,2122,1333,789,1.689480355,1184,2977,883,341,334,7,72,1,0.098802395,0,empty,CD-0722-4
"B3,H1",8236,8872,6025,2847,4624,2227,0,2230,1464,766,1.911227154,1255,1923,465,196,192,4,42,2,0.015625,0,empty,CD-0722-4
"B3,H2",9189,10066,6728,3338,5320,2696,1,2698,1750,948,1.845991561,1562,2874,747,310,310,0,83,0,0.112903226,0,empty,CD-0722-4
"B3,H3",7314,8091,5370,2721,4202,2147,0,2150,1397,753,1.855245684,1235,1738,500,196,192,4,55,2,0.020833333,0,empty,CD-0722-4
"B3,H4",11616,12519,8576,3943,6402,3038,15,3056,2011,1045,1.924401914,1683,225,99,48,48,0,11,0,0,0,empty,CD-0722-4
"B3,H5",12494,13397,9001,4396,7009,3508,0,3518,2368,1150,2.059130435,1983,2199,691,292,288,4,61,1,0.097222222,0,empty,CD-0722-4
"B3,H6",8136,9262,5856,3406,4842,2615,18,2636,1742,894,1.948545861,1530,2451,480,194,192,2,53,2,0.015625,0,empty,CD-0722-4
"B3,H7",8212,8815,6022,2793,4645,2224,1,2225,1437,788,1.823604061,1229,2521,521,213,212,1,48,1,0.089622642,0,empty,CD-0722-4
"B3,H8",875352,1013961,642255,371706,494866,273828,4,274045,219792,54253,4.051241406,161786,179066,16907,6861,6660,201,1299,5,0.032732733,0,hg38,CD-0722-4
"B3,H9",7256,7677,5529,2148,4028,1899,1,1903,1256,647,1.941267388,1015,1687,482,193,188,5,45,2,0.122340426,0,empty,CD-0722-4
"B3,H10",6395,7023,4624,2399,3679,1827,9,1840,1251,589,2.123938879,1065,1688,458,158,158,0,43,0,0.03164557,0,empty,CD-0722-4
"B3,H11",8165,9509,5716,3793,4870,2906,2,2912,1606,1306,1.229709035,1749,78,11,11,11,0,3,0,0,0,empty,CD-0722-4
"B3,H12",7141,7995,5237,2758,4019,2069,0,2069,1411,658,2.1443769,1199,1911,484,170,169,1,39,1,0.035502959,0,empty,CD-0722-4
"B4,A1",7906,8943,5680,3263,4634,2445,0,2449,1587,862,1.841067285,1419,2135,358,129,126,3,34,1,0.126984127,0,empty,CD-0722-4
"B4,A2",11410,12308,8508,3800,6283,3081,1,3086,1976,1110,1.78018018,1674,2680,810,324,318,6,67,2,0.106918239,0,empty,CD-0722-4
"B4,A3",12226,13347,9042,4305,6841,3323,21,3348,2384,964,2.473029046,1901,2876,800,308,305,3,78,3,0.06557377,0,empty,CD-0722-4
"B4,A4",12462,13475,9315,4160,6953,3342,17,3362,2224,1138,1.9543058,1902,1516,401,162,162,0,36,0,0.141975309,0,empty,CD-0722-4
"B4,A5",10544,11284,7802,3482,5894,2886,0,2891,1903,988,1.92611336,1572,3544,640,235,234,1,72,1,0.106837607,0,empty,CD-0722-4
"B4,A6",8949,10052,6511,3541,5173,2663,0,2666,1755,911,1.926454446,1561,3684,794,340,334,6,104,5,0.056886228,0,empty,CD-0722-4
"B4,A7",2308287,2625372,1746546,878826,1238337,667611,6,668245,537282,130963,4.102548048,384476,304628,44724,17438,17098,340,2333,7,0.049537958,0,hg38,CD-0722-4
"B4,A8",5173,5884,3850,2034,3154,1614,0,1615,1164,451,2.580931264,975,3342,851,269,264,5,68,2,0.011363636,0,empty,CD-0722-4
"B4,A9",8314,9075,6234,2841,4670,2263,0,2269,1529,740,2.066216216,1239,2726,516,229,224,5,74,3,0.084821429,0,empty,CD-0722-4
"B4,A10",9605,10036,7224,2812,5239,2539,24,2564,1650,914,1.805251641,1352,627,112,49,49,0,24,0,0.06122449,0,empty,CD-0722-4
"B4,A11",739607,834272,565321,268951,406479,203655,3,203884,157644,46240,3.409256055,116363,131827,17755,6682,6516,166,1035,5,0.089165132,0,hg38,CD-0722-4
"B4,A12",9973,10736,7472,3264,5534,2672,0,2674,1766,908,1.944933921,1489,8640,1750,635,626,9,132,2,0.102236422,0,empty,CD-0722-4
"B4,B1",8408,9225,6222,3003,4786,2464,3,2471,1562,909,1.718371837,1406,1383,334,141,141,0,37,0,0.09929078,0,empty,CD-0722-4
"B4,B2",9597,10212,6684,3528,5301,2815,2,2829,1734,1095,1.583561644,1613,663,114,46,45,1,18,1,0.022222222,0,empty,CD-0722-4
"B4,B3",1795850,2112291,1316097,796194,1019545,588630,2,589137,436434,152703,2.858057798,353047,152287,28476,10448,10341,107,1631,5,0.033845856,0,hg38,CD-0722-4
"B4,B4",7935,9129,5742,3387,4830,2555,0,2555,1632,923,1.768147346,1546,2119,535,172,172,0,47,0,0.023255814,0,empty,CD-0722-4
"B4,B5",8323,5156,3265,1891,3396,1819,0,1834,1227,607,2.021416804,1158,1362,301,105,104,1,31,1,0.125,0,empty,CD-0722-4
"B4,B6",9469,10508,6841,3667,5366,2827,0,2830,1809,1021,1.77179236,1656,2211,602,225,219,6,63,2,0.059360731,0,empty,CD-0722-4
"B4,B7",1438648,1679982,1075299,604683,805387,441418,4,441769,353461,88308,4.002593197,259265,134014,23155,8797,8603,194,1297,6,0.068813205,0,hg38,CD-0722-4
"B4,B8",6517,6994,4898,2096,3673,1757,0,1759,1226,533,2.300187617,945,1923,471,175,174,1,51,1,0.017241379,0,empty,CD-0722-4
"B4,B9",1434152,1647366,1088221,559145,776373,415917,14,416382,340630,75752,4.496646953,240972,135936,15766,6245,6084,161,1044,5,0.068869165,0,hg38,CD-0722-4
"B4,B10",6116,6717,4473,2244,3726,1839,0,1842,1178,664,1.774096386,1054,693,171,86,86,0,26,0,0.011627907,0,empty,CD-0722-4
"B4,B11",13518,15129,9795,5334,7662,4187,0,4193,2357,1836,1.283769063,2423,430,87,40,40,0,11,0,0,0,empty,CD-0722-4
"B4,B12",8012,8850,5826,3024,4700,2329,13,2346,1531,815,1.878527607,1367,3905,861,328,323,5,79,2,0.157894737,0,empty,CD-0722-4
"B4,C1",14836,16035,11261,4774,8161,3835,3,3843,2466,1377,1.790849673,2106,1768,413,157,156,1,37,1,0.032051282,0,empty,CD-0722-4
"B4,C2",12297,13263,8940,4323,6750,3426,0,3431,2250,1181,1.905165114,1875,2435,561,241,240,1,73,1,0.045833333,0,empty,CD-0722-4
"B4,C3",2510957,2952678,1841724,1110954,1390079,802065,3,802841,656526,146315,4.487072412,482458,119022,16651,6545,6421,124,1107,4,0.046254477,0,hg38,CD-0722-4
"B4,C4",8021,8774,6071,2703,4519,2140,1,2143,1401,742,1.888140162,1210,2268,573,235,232,3,67,3,0.077586207,0,empty,CD-0722-4
"B4,C5",11425,12497,8441,4056,6459,3207,0,3212,2125,1087,1.954921803,1800,1845,328,133,131,2,48,1,0.015267176,0,empty,CD-0722-4
"B4,C6",9687,10678,7155,3523,5579,2806,0,2812,1851,961,1.926118626,1543,1929,502,209,206,3,62,1,0.048543689,0,empty,CD-0722-4
"B4,C7",12748,14268,9279,4989,7321,3906,11,3922,2399,1523,1.575180565,2251,541,140,51,50,1,14,1,0,0,empty,CD-0722-4
"B4,C8",1357446,1596945,983802,613143,777255,455678,5,456104,344238,111866,3.077235264,272763,191937,33449,13002,12812,190,1759,5,0.0897596,0,hg38,CD-0722-4
"B4,C9",11858,13143,8877,4266,6656,3314,1,3319,2275,1044,2.179118774,1852,3649,687,266,264,2,66,2,0.068181818,0,empty,CD-0722-4
"B4,C10",11417,12570,8645,3925,6373,3060,0,3064,2022,1042,1.94049904,1679,3013,684,298,292,6,68,2,0.123287671,0,empty,CD-0722-4
"B4,C11",915671,1023302,694156,329146,496242,250686,1,250925,189649,61276,3.09499641,144501,107675,9916,3804,3669,135,704,6,0.035704552,0,hg38,CD-0722-4
"B4,C12",1145333,1235250,890016,345234,585227,270636,5,270961,218241,52720,4.139624431,147354,24173,5770,2039,2002,37,412,3,0.036463536,0,hg38,CD-0722-4
"B4,D1",12242,13659,8594,5065,6958,3766,2,3771,2347,1424,1.648174157,2237,1288,315,73,73,0,19,0,0.01369863,0,empty,CD-0722-4
"B4,D2",9964,10946,7560,3386,5592,2584,0,2584,1676,908,1.845814978,1407,3460,950,356,355,1,102,1,0.042253521,0,empty,CD-0722-4
"B4,D3",9145,10046,6727,3319,5274,2663,6,2671,1790,881,2.031782066,1490,2174,452,153,150,3,41,2,0.16,0,empty,CD-0722-4
"B4,D4",7766,8761,5694,3067,4570,2381,0,2384,1551,833,1.861944778,1398,1679,515,158,156,2,42,1,0.038461538,0,empty,CD-0722-4
"B4,D5",7762,8852,5720,3132,4430,2253,0,2255,1449,806,1.797766749,1280,1916,521,188,188,0,46,0,0.085106383,0,empty,CD-0722-4
"B4,D6",12099,13002,8849,4153,6636,3418,12,3433,2103,1330,1.581203008,1905,2831,657,281,278,3,69,2,0.125899281,0,empty,CD-0722-4
"B4,D7",6980,7246,5039,2207,3838,1814,10,1824,1280,544,2.352941176,1003,2779,622,249,246,3,66,1,0.081300813,0,empty,CD-0722-4
"B4,D8",10377,11261,7832,3429,5772,2713,0,2715,1856,859,2.160651921,1518,2331,876,351,347,4,74,2,0.126801153,0,empty,CD-0722-4
"B4,D9",4376,4850,3172,1678,2529,1256,0,1256,804,452,1.778761062,730,1963,624,221,221,0,62,0,0.031674208,0,empty,CD-0722-4
"B4,D10",8179,9081,6033,3048,4726,2411,0,2412,1526,886,1.72234763,1377,1152,233,109,108,1,37,1,0.083333333,0,empty,CD-0722-4
"B4,D11",8929,9743,6659,3084,5095,2423,9,2438,1574,864,1.821759259,1427,3487,967,386,382,4,86,2,0.057591623,0,empty,CD-0722-4
"B4,D12",11792,13001,8841,4160,6788,3378,0,3382,2233,1149,1.943429069,1911,7128,1591,642,635,7,160,2,0.036220472,0,empty,CD-0722-4
"B4,E1",891715,990632,658751,331881,479338,252903,0,253172,195661,57511,3.402149154,144604,117339,19518,7545,7445,100,1249,6,0.0402955,0,hg38,CD-0722-4
"B4,E2",813863,884246,631786,252460,428389,198267,2,198471,148346,50125,2.959521197,110209,101762,8276,3213,3100,113,650,6,0.056451613,0,hg38,CD-0722-4
"B4,E3",687895,768628,530190,238438,374212,183187,18,183382,140127,43255,3.239556121,104314,358575,41479,15887,15380,507,1946,13,0.054551365,0,hg38,CD-0722-4
"B4,E4",1092559,1292561,805377,487184,620594,346106,1,346446,277387,69059,4.016666908,209282,194756,31608,12188,11962,226,1840,7,0.049072062,0,hg38,CD-0722-4
"B4,E5",10956,12135,8184,3951,6293,3139,1,3141,2064,1077,1.91643454,1817,1820,497,187,187,0,47,0,0.010695187,0,empty,CD-0722-4
"B4,E6",16613,18515,12267,6248,9385,4632,0,4637,2873,1764,1.628684807,2622,5170,1305,530,524,6,138,2,0.053435115,0,empty,CD-0722-4
"B4,E7",14110,15389,10619,4770,8009,3808,1,3814,2549,1265,2.015019763,2139,4132,1111,417,406,11,113,2,0.071428571,0,empty,CD-0722-4
"B4,E8",11483,12348,8825,3523,6433,2992,0,2994,2016,978,2.061349693,1623,4364,923,333,329,4,97,3,0.075987842,0,empty,CD-0722-4
"B4,E9",7040,7798,5242,2556,4016,1973,0,1975,1276,699,1.82546495,1133,2971,725,267,262,5,89,2,0.026717557,0,empty,CD-0722-4
"B4,E10",9015,9719,6650,3069,5028,2496,0,2496,1650,846,1.95035461,1369,1984,391,150,147,3,43,1,0.068027211,0,empty,CD-0722-4
"B4,E11",9872,10547,7330,3217,5424,2643,0,2646,1672,974,1.716632444,1462,3194,736,295,294,1,78,1,0.010204082,0,empty,CD-0722-4
"B4,E12",10606,11517,7771,3746,6028,3042,0,3042,1952,1090,1.790825688,1746,2826,539,242,232,10,71,2,0.060344828,0,empty,CD-0722-4
"B4,F1",12597,13548,9275,4273,6925,3344,0,3349,2073,1276,1.62460815,1879,3558,969,384,380,4,97,2,0.094736842,0,empty,CD-0722-4
"B4,F2",11208,12529,8201,4328,6558,3278,2,3285,2229,1056,2.110795455,1922,3794,796,307,305,2,91,1,0.029508197,0,empty,CD-0722-4
"B4,F3",9922,10597,7353,3244,5511,2637,0,2639,1723,916,1.881004367,1472,3421,661,264,259,5,82,1,0.1003861,0,empty,CD-0722-4
"B4,F4",2240659,2560769,1707705,853064,1203341,648477,11,649134,542763,106371,5.102546747,372234,91528,15697,6149,6059,90,1047,4,0.060901139,0,hg38,CD-0722-4
"B4,F5",11071,11509,8230,3279,5941,2694,42,2744,1792,952,1.882352941,1482,3159,830,332,325,7,86,2,0.110769231,0,empty,CD-0722-4
"B4,F6",13011,14429,9455,4974,7402,3791,3,3795,2540,1255,2.023904382,2168,4481,1011,422,422,0,127,0,0.061611374,0,empty,CD-0722-4
"B4,F7",2533772,2943401,1923854,1019547,1386488,762393,4,763034,633901,129133,4.908900126,442089,67292,12743,5127,5051,76,897,4,0.048109285,0,hg38,CD-0722-4
"B4,F8",3552227,4119095,2644458,1474637,1910189,1094342,13,1095355,927169,168186,5.512759683,641126,23981,3730,1443,1413,30,311,2,0.054493984,0,hg38,CD-0722-4
"B4,F9",9984,10856,7502,3354,5628,2681,0,2683,1797,886,2.028216704,1477,3213,736,309,307,2,80,1,0.042345277,0,empty,CD-0722-4
"B4,F10",12776,13853,9690,4163,7187,3445,0,3449,2219,1230,1.804065041,1928,2695,780,284,281,3,67,2,0.060498221,0,empty,CD-0722-4
"B4,F11",9530,10508,7202,3306,5340,2516,1,2522,1607,915,1.756284153,1441,2166,438,166,162,4,44,1,0.092592593,0,empty,CD-0722-4
"B4,F12",10809,11625,7988,3637,5957,2903,2,2906,1868,1038,1.799614644,1613,705,156,55,55,0,14,0,0,0,empty,CD-0722-4
"B4,G1",18492,20635,13979,6656,10467,5167,2,5180,3512,1668,2.105515588,2914,3498,964,411,410,1,102,1,0.034146341,0,empty,CD-0722-4
"B4,G2",6686,7477,4638,2839,3761,1969,0,1969,1241,728,1.70467033,1178,680,238,89,88,1,20,1,0,0,empty,CD-0722-4
"B4,G3",18580,20266,14001,6265,10190,4980,0,4991,3246,1745,1.86017192,2774,8778,1990,692,681,11,125,3,0.092511013,0,empty,CD-0722-4
"B4,G4",23368,26282,16788,9494,13393,7395,0,7404,4556,2848,1.599719101,4354,96,15,11,11,0,7,0,0,0,empty,CD-0722-4
"B4,G5",7684,8479,5677,2802,4403,2186,0,2188,1452,736,1.972826087,1285,1661,509,208,207,1,54,1,0,0,empty,CD-0722-4
"B4,G6",11146,12279,8361,3918,6254,3072,0,3074,2082,992,2.098790323,1708,429,99,49,49,0,12,0,0,0,empty,CD-0722-4
"B4,G7",9748,10269,7404,2865,5468,2534,0,2536,1673,863,1.938586327,1353,8832,2024,761,747,14,170,3,0.123159304,0,empty,CD-0722-4
"B4,G8",6664,7521,4846,2675,3973,1981,1,1984,1304,680,1.917647059,1171,1768,377,170,169,1,57,1,0.106508876,0,empty,CD-0722-4
"B4,G9",8257,9182,6192,2990,4806,2283,1,2289,1527,762,2.003937008,1292,3813,831,335,330,5,110,1,0.063636364,0,empty,CD-0722-4
"B4,G10",10391,11142,7868,3274,5828,2837,0,2839,1844,995,1.853266332,1535,3377,825,359,355,4,88,2,0.050704225,0,empty,CD-0722-4
"B4,G11",9897,10638,7542,3096,5628,2634,1,2636,1772,864,2.050925926,1428,1985,374,154,151,3,46,2,0.119205298,0,empty,CD-0722-4
"B4,G12",7800,8603,5676,2927,4444,2270,0,2275,1463,812,1.801724138,1315,4339,725,278,269,9,64,3,0.026022305,0,empty,CD-0722-4
"B4,H1",9058,9817,6609,3208,5189,2509,0,2509,1706,803,2.124533001,1469,2038,372,115,106,9,40,2,0.094339623,0,empty,CD-0722-4
"B4,H2",9416,10443,7025,3418,5372,2637,1,2641,1654,987,1.675785208,1526,3344,669,277,274,3,61,2,0.065693431,0,empty,CD-0722-4
"B4,H3",8305,9344,6090,3254,4713,2358,0,2361,1536,825,1.861818182,1366,2028,478,192,189,3,51,2,0.021164021,0,empty,CD-0722-4
"B4,H4",11473,12231,8637,3594,6245,3027,0,3030,1966,1064,1.847744361,1611,205,53,21,21,0,10,0,0,0,empty,CD-0722-4
"B4,H5",12721,13672,9489,4183,6913,3428,0,3433,2186,1247,1.753007217,1862,2587,737,304,304,0,73,0,0.023026316,0,empty,CD-0722-4
"B4,H6",7738,9188,5567,3621,4629,2459,0,2462,1544,918,1.681917211,1480,2713,496,234,229,5,72,2,0.03930131,0,empty,CD-0722-4
"B4,H7",9317,10075,6839,3236,5379,2632,0,2632,1715,917,1.870229008,1464,2440,698,268,263,5,62,2,0.038022814,0,empty,CD-0722-4
"B4,H8",11315,12645,8404,4241,6548,3374,8,3387,2168,1219,1.778506973,1937,3011,775,305,300,5,80,3,0.083333333,0,empty,CD-0722-4
"B4,H9",7754,8573,5969,2604,4457,2055,1,2061,1366,695,1.965467626,1166,1574,351,144,142,2,36,1,0.021126761,0,empty,CD-0722-4
"B4,H10",6898,7309,5221,2088,3770,1797,0,1799,1184,615,1.925203252,984,1761,285,91,91,0,32,0,0.087912088,0,empty,CD-0722-4
"B4,H11",9386,10772,6478,4294,5496,3301,17,3324,1819,1505,1.208637874,2016,162,87,36,36,0,5,0,0,0,empty,CD-0722-4
"B4,H12",7669,8556,5507,3049,4370,2238,0,2238,1500,738,2.032520325,1310,3386,599,224,214,10,49,2,0.102803738,0,empty,CD-0722-4
"B5,A1",910026,1025222,695198,330024,503890,252635,1,252904,193252,59652,3.239656675,144162,66223,9063,3419,3347,72,660,7,0.044218703,0,hg38,CD-0722-4
"B5,A2",10435,11365,7700,3665,5872,2959,0,2962,1887,1075,1.755348837,1627,2775,710,286,281,5,60,2,0.128113879,0,empty,CD-0722-4
"B5,A3",7724,8461,5637,2824,4328,2163,1,2168,1464,704,2.079545455,1215,1517,228,112,111,1,38,1,0.036036036,0,empty,CD-0722-4
"B5,A4",11146,12105,8464,3641,6187,2975,0,2980,1903,1077,1.766945218,1623,1039,318,121,121,0,29,0,0.024793388,0,empty,CD-0722-4
"B5,A5",743319,834322,549627,284695,411975,218515,4,218755,178642,40113,4.45346895,126031,193603,33405,12953,12765,188,1878,13,0.052095574,0,hg38,CD-0722-4
"B5,A6",10926,12263,8058,4205,6404,3272,6,3280,2251,1029,2.187560739,1907,3106,795,314,310,4,90,1,0.135483871,0,empty,CD-0722-4
"B5,A7",6918,7743,5215,2528,3982,2050,1,2051,1323,728,1.817307692,1113,1571,494,150,150,0,39,0,0.153333333,0,empty,CD-0722-4
"B5,A8",4441,4868,3280,1588,2557,1275,0,1276,875,401,2.182044888,711,2050,598,236,236,0,63,0,0.080508475,0,empty,CD-0722-4
"B5,A9",8046,8761,6011,2750,4541,2244,0,2244,1485,759,1.956521739,1244,1997,416,214,212,2,56,1,0.051886792,0,empty,CD-0722-4
"B5,A10",9110,9905,7085,2820,4943,2364,0,2370,1482,888,1.668918919,1223,300,54,30,29,1,11,1,0,0,empty,CD-0722-4
"B5,A11",6902,7137,5167,1970,3770,1664,23,1690,1127,563,2.001776199,871,1502,312,165,165,0,41,0,0.03030303,0,empty,CD-0722-4
"B5,A12",9093,9972,6899,3073,5090,2401,0,2405,1551,854,1.816159251,1343,3269,834,353,352,1,105,1,0.048295455,0,empty,CD-0722-4
"B5,B1",7511,8413,5507,2906,4389,2301,6,2309,1433,876,1.635844749,1343,1737,284,105,105,0,35,0,0,0,empty,CD-0722-4
"B5,B2",8516,9168,5926,3242,4768,2504,0,2513,1521,992,1.533266129,1463,710,251,78,76,2,20,1,0.144736842,0,empty,CD-0722-4
"B5,B3",6530,7129,4653,2476,3731,1856,10,1868,1156,712,1.623595506,1106,1562,313,130,128,2,40,1,0.1015625,0,empty,CD-0722-4
"B5,B4",7230,8239,5420,2819,4224,2224,3,2229,1345,884,1.521493213,1259,2154,448,185,184,1,36,1,0.168478261,0,empty,CD-0722-4
"B5,B5",8523,5318,3334,1984,3432,1788,7,1807,1180,627,1.881977671,1112,1369,282,141,141,0,29,0,0.219858156,0,empty,CD-0722-4
"B5,B6",8619,9692,6256,3436,5001,2651,3,2655,1620,1035,1.565217391,1550,2314,448,176,175,1,61,1,0.108571429,0,empty,CD-0722-4
"B5,B7",8472,9231,6356,2875,4869,2322,0,2322,1533,789,1.942965779,1295,1678,394,175,175,0,42,0,0.017142857,0,empty,CD-0722-4
"B5,B8",668550,748870,505083,243787,367466,187035,2,187212,153954,33258,4.629081725,106511,97155,11974,4726,4610,116,929,7,0.030802603,0,hg38,CD-0722-4
"B5,B9",10879,11989,7920,4069,6182,3276,0,3278,2089,1189,1.756938604,1883,1029,295,106,106,0,30,0,0.311320755,0,empty,CD-0722-4
"B5,B10",5284,5967,3804,2163,3227,1634,0,1635,999,636,1.570754717,983,779,196,68,66,2,18,1,0.03030303,0,empty,CD-0722-4
"B5,B11",11652,13094,8397,4697,6674,3608,0,3610,2075,1535,1.351791531,2110,346,93,49,49,0,15,0,0.102040816,0,empty,CD-0722-4
"B5,B12",888575,1040999,655232,385767,511692,279698,1,279946,220978,58968,3.747422331,167283,182992,26996,10322,10121,201,1569,8,0.058591048,0,hg38,CD-0722-4
"B5,C1",14557,15265,11058,4207,7971,3778,13,3795,2444,1351,1.809030348,1982,1723,348,174,173,1,50,1,0.057803468,0,empty,CD-0722-4
"B5,C2",25427,28309,19122,9187,13759,6898,0,6907,4627,2280,2.029385965,3860,2811,973,379,379,0,88,0,0.01055409,0,empty,CD-0722-4
"B5,C3",985476,1076221,754259,321962,523335,255987,2,256239,200979,55260,3.636970684,143135,30420,4253,1707,1673,34,326,6,0.037059175,0,hg38,CD-0722-4
"B5,C4",7111,7731,5396,2335,4101,1913,2,1918,1219,699,1.743919886,1092,2576,688,313,311,2,59,1,0.073954984,0,empty,CD-0722-4
"B5,C5",10302,11384,7706,3678,5792,2903,8,2915,1883,1032,1.824612403,1617,1848,433,182,182,0,56,0,0.164835165,0,empty,CD-0722-4
"B5,C6",11474,13066,8376,4690,6770,3434,44,3490,2391,1099,2.175614195,2053,2129,513,247,244,3,58,1,0.094262295,0,empty,CD-0722-4
"B5,C7",12402,14346,9008,5338,7290,4022,0,4022,2364,1658,1.425814234,2414,448,77,32,31,1,12,1,0.032258065,0,empty,CD-0722-4
"B5,C8",13228,14585,9661,4924,7397,3775,0,3776,2539,1237,2.052546483,2171,2975,614,250,246,4,76,2,0.036585366,0,empty,CD-0722-4
"B5,C9",9135,10132,6772,3360,5239,2600,0,2600,1685,915,1.841530055,1470,2100,431,170,168,2,51,1,0.142857143,0,empty,CD-0722-4
"B5,C10",10974,12028,8244,3784,6234,3123,0,3126,2017,1109,1.818755636,1743,2834,526,193,192,1,60,1,0.072916667,0,empty,CD-0722-4
"B5,C11",9505,10132,7127,3005,5312,2542,0,2548,1643,905,1.815469613,1388,2338,450,191,180,11,53,2,0.083333333,0,empty,CD-0722-4
"B5,C12",13358,14078,9897,4181,7446,3552,1,3554,2337,1217,1.920295809,1934,1832,464,183,182,1,61,1,0.032967033,0,empty,CD-0722-4
"B5,D1",11580,12961,8345,4616,6611,3476,0,3478,2175,1303,1.669224866,2028,986,166,64,61,3,16,2,0.180327869,0,empty,CD-0722-4
"B5,D2",9936,10681,7594,3087,5514,2531,0,2533,1594,939,1.697550586,1363,2785,643,277,273,4,84,2,0.032967033,0,empty,CD-0722-4
"B5,D3",8627,9914,6375,3539,4963,2467,0,2473,1596,877,1.819840365,1431,1859,259,100,100,0,33,0,0.03,0,empty,CD-0722-4
"B5,D4",6495,6994,4772,2222,3703,1864,0,1865,1194,671,1.779433681,1006,2287,532,184,184,0,48,0,0.016304348,0,empty,CD-0722-4
"B5,D5",7047,7473,5285,2188,3928,1859,1,1864,1206,658,1.832826748,1010,1912,435,171,169,2,40,1,0.00591716,0,empty,CD-0722-4
"B5,D6",11754,13195,8340,4855,6744,3607,0,3616,2196,1420,1.546478873,2134,1915,491,186,185,1,48,1,0.086486486,0,empty,CD-0722-4
"B5,D7",6712,7359,4999,2360,3692,1692,0,1692,1162,530,2.19245283,965,2521,771,308,304,4,62,3,0.032894737,0,empty,CD-0722-4
"B5,D8",7627,8219,5674,2545,4242,2030,0,2039,1333,706,1.888101983,1157,1336,291,148,148,0,40,0,0,0,empty,CD-0722-4
"B5,D9",4327,4723,3281,1442,2429,1128,6,1136,774,362,2.138121547,628,1865,476,190,189,1,54,1,0.052910053,0,empty,CD-0722-4
"B5,D10",12458,14261,8993,5268,7340,3901,0,3903,2782,1121,2.481712756,2351,1221,185,85,84,1,32,1,0.011904762,0,empty,CD-0722-4
"B5,D11",8337,9052,6165,2887,4804,2285,18,2303,1479,824,1.794902913,1313,3143,837,328,325,3,70,2,0.132307692,0,empty,CD-0722-4
"B5,D12",11283,12043,8445,3598,6234,3016,0,3018,1922,1096,1.753649635,1617,4246,1142,455,451,4,135,2,0.064301552,0,empty,CD-0722-4
"B5,E1",13624,14962,9919,5043,7684,3838,54,3894,2407,1487,1.61869536,2253,3440,732,304,303,1,83,1,0.138613861,0,empty,CD-0722-4
"B5,E2",904550,1060846,659123,401723,521200,293477,1,293695,229574,64121,3.580324699,176566,128236,14699,5706,5541,165,952,5,0.049990976,0,hg38,CD-0722-4
"B5,E3",6534,7239,4938,2301,3683,1745,0,1745,1110,635,1.748031496,982,2623,559,267,266,1,69,1,0.037593985,0,empty,CD-0722-4
"B5,E4",1255875,1490795,914108,576687,720829,414865,4,415264,331700,83564,3.969412666,250128,174837,33506,13058,12873,185,1763,6,0.055231881,0,hg38,CD-0722-4
"B5,E5",8676,9265,6644,2621,4639,2059,0,2063,1319,744,1.772849462,1078,1434,584,228,227,1,53,1,0.044052863,0,empty,CD-0722-4
"B5,E6",14551,16294,10672,5622,8287,4243,0,4250,2652,1598,1.659574468,2508,4007,991,391,390,1,104,1,0.046153846,0,empty,CD-0722-4
"B5,E7",12852,13774,9571,4203,7033,3365,0,3365,2229,1136,1.962147887,1874,3041,637,247,247,0,77,0,0.016194332,0,empty,CD-0722-4
"B5,E8",19345,20502,14362,6140,10392,5165,0,5170,3244,1926,1.684319834,2772,3905,983,385,380,5,105,2,0.013157895,0,empty,CD-0722-4
"B5,E9",575130,655487,433260,222227,323021,164373,2,164510,127099,37411,3.397369758,96218,178187,26956,10494,10299,195,1581,6,0.045635499,0,hg38,CD-0722-4
"B5,E10",8213,8919,6208,2711,4596,2143,17,2168,1448,720,2.011111111,1193,1588,582,192,191,1,47,1,0.010471204,0,empty,CD-0722-4
"B5,E11",9039,10053,6587,3466,5174,2555,1,2567,1674,893,1.874580067,1473,2011,474,202,201,1,59,1,0.064676617,0,empty,CD-0722-4
"B5,E12",9701,10645,7108,3537,5541,2847,0,2849,1821,1028,1.771400778,1627,2765,527,217,214,3,68,2,0.042056075,0,empty,CD-0722-4
"B5,F1",12323,13032,9016,4016,6579,3237,22,3259,2053,1206,1.702321725,1801,2934,694,238,234,4,61,2,0.064102564,0,empty,CD-0722-4
"B5,F2",9785,10388,7273,3115,5443,2586,1,2594,1701,893,1.90481523,1422,3733,649,263,255,8,63,2,0.090196078,0,empty,CD-0722-4
"B5,F3",8981,9453,6603,2850,4964,2429,0,2429,1573,856,1.837616822,1383,3114,537,256,253,3,80,2,0.063241107,0,empty,CD-0722-4
"B5,F4",13673,14297,10117,4180,7582,3541,1,3553,2280,1273,1.791044776,1924,866,275,115,114,1,34,1,0.01754386,0,empty,CD-0722-4
"B5,F5",1177986,1333965,874219,459746,640260,344661,2,344977,277275,67702,4.09552155,197969,45381,7279,2737,2698,39,679,2,0.011119348,0,hg38,CD-0722-4
"B5,F6",10275,11500,7512,3988,5958,3163,0,3165,2035,1130,1.800884956,1825,3591,828,333,331,2,98,1,0.120845921,0,empty,CD-0722-4
"B5,F7",945020,1024995,732438,292557,505171,236564,17,236843,189363,47480,3.988268745,130723,30727,6644,2387,2369,18,435,3,0.005487547,0,hg38,CD-0722-4
"B5,F8",8211,8888,6082,2806,4606,2206,7,2215,1496,719,2.080667594,1247,445,103,50,50,0,18,0,0,0,empty,CD-0722-4
"B5,F9",9163,9846,6831,3015,5193,2483,5,2494,1633,861,1.896631823,1366,3106,748,304,301,3,83,2,0.059800664,0,empty,CD-0722-4
"B5,F10",11927,13083,9058,4025,6742,3182,0,3184,2065,1119,1.845397676,1737,1899,312,158,154,4,55,2,0.084415584,0,empty,CD-0722-4
"B5,F11",9057,9485,6928,2557,5101,2332,37,2371,1665,706,2.358356941,1252,2326,556,232,229,3,54,2,0.048034934,0,empty,CD-0722-4
"B5,F12",1011954,1128207,755888,372319,542539,278415,1,278714,226397,52317,4.327407917,159379,11160,1382,462,450,12,101,2,0.084444444,0,hg38,CD-0722-4
"B5,G1",11561,12514,8601,3913,6522,3091,0,3092,2031,1061,1.914231857,1718,3418,716,331,329,2,96,2,0.018237082,0,empty,CD-0722-4
"B5,G2",6703,7277,4739,2538,3747,1940,0,1943,1231,712,1.728932584,1149,643,173,67,66,1,13,1,0,0,empty,CD-0722-4
"B5,G3",14187,15387,10561,4826,7817,3869,21,3891,2573,1318,1.952200303,2143,3135,749,284,282,2,71,2,0.063829787,0,empty,CD-0722-4
"B5,G4",21685,24235,15603,8632,12252,6714,24,6744,4118,2626,1.568164509,3846,101,19,13,13,0,6,0,0,0,empty,CD-0722-4
"B5,G5",7592,8334,5556,2778,4316,2100,30,2132,1360,772,1.761658031,1251,1739,356,125,121,4,39,2,0.099173554,0,empty,CD-0722-4
"B5,G6",11065,12081,8300,3781,6265,3032,0,3032,2026,1006,2.013916501,1681,127,19,11,11,0,8,0,0,0,empty,CD-0722-4
"B5,G7",10991,12114,8374,3740,6213,2943,2,2947,2026,921,2.199782845,1620,3696,889,324,319,5,89,2,0.084639498,0,empty,CD-0722-4
"B5,G8",6739,7328,5037,2291,3861,1843,13,1857,1183,674,1.755192878,1007,2578,675,230,229,1,63,1,0.100436681,0,empty,CD-0722-4
"B5,G9",7801,8482,5810,2672,4345,2077,1,2084,1381,703,1.964438122,1143,2614,545,226,225,1,71,1,0.08,0,empty,CD-0722-4
"B5,G10",962203,1075948,733098,342850,522918,264881,0,265196,210458,54738,3.844824436,150340,375214,44051,17991,17546,445,2392,15,0.064231164,0,hg38,CD-0722-4
"B5,G11",9490,10399,7183,3216,5340,2587,0,2591,1677,914,1.834792123,1419,2062,570,215,215,0,54,0,0.237209302,0,empty,CD-0722-4
"B5,G12",7599,8316,5611,2705,4397,2237,6,2244,1483,761,1.948751643,1259,2583,751,292,291,1,57,1,0.099656357,0,empty,CD-0722-4
"B5,H1",3358056,3882085,2446452,1435633,1826585,1056813,12,1057752,871166,186586,4.66897838,630698,213864,35787,13510,13289,221,2033,6,0.033561592,0,hg38,CD-0722-4
"B5,H2",8897,9795,6573,3222,5102,2504,15,2522,1602,920,1.741304348,1453,3155,609,209,207,2,70,1,0.053140097,0,empty,CD-0722-4
"B5,H3",756136,862616,558165,304451,419843,223882,0,224076,180440,43636,4.135117793,131769,88549,12173,4969,4858,111,822,6,0.066488267,0,hg38,CD-0722-4
"B5,H4",11310,12368,8418,3950,6233,3002,20,3022,1999,1023,1.954056696,1690,296,37,4,3,1,2,1,0.666666667,0,empty,CD-0722-4
"B5,H5",12624,13822,9249,4573,7045,3548,1,3551,2339,1212,1.929867987,2020,2547,460,189,188,1,62,1,0.10106383,0,empty,CD-0722-4
"B5,H6",7103,7797,5226,2571,4020,2001,0,2002,1331,671,1.983606557,1151,2333,649,286,284,2,67,1,0.091549296,0,empty,CD-0722-4
"B5,H7",8610,9082,6277,2805,4963,2351,0,2352,1532,820,1.868292683,1342,2088,548,220,220,0,51,0,0.022727273,0,empty,CD-0722-4
"B5,H8",689118,755890,528294,227596,369949,175878,1,176017,139371,36646,3.803170878,99350,79689,12401,4695,4598,97,822,5,0.030013049,0,hg38,CD-0722-4
"B5,H9",7802,8519,5886,2633,4385,2041,31,2076,1380,696,1.982758621,1155,1630,291,121,117,4,37,2,0.034188034,0,empty,CD-0722-4
"B5,H10",6661,6927,4816,2111,3657,1770,0,1775,1156,619,1.867528271,1004,1740,287,135,132,3,37,1,0.007575758,0,empty,CD-0722-4
"B5,H11",8213,9133,5787,3346,4806,2805,2,2809,1499,1310,1.144274809,1678,93,40,19,19,0,4,0,0,0,empty,CD-0722-4
"B5,H12",6733,7170,4941,2229,3714,1837,0,1842,1194,648,1.842592593,1029,1480,298,127,127,0,40,0,0.039370079,0,empty,CD-0722-4
"B6,A1",7167,7713,5248,2465,4060,2089,4,2093,1349,744,1.813172043,1125,1740,294,137,136,1,34,1,0.058823529,0,empty,CD-0722-4
"B6,A2",645457,710295,492335,217960,348358,168623,13,168829,126329,42500,2.972447059,94721,85330,13099,5098,5025,73,854,4,0.055522388,0,hg38,CD-0722-4
"B6,A3",934943,1039532,702363,337169,509990,260884,3,261110,226043,35067,6.446031882,148475,132729,25157,9891,9736,155,1596,5,0.035024651,0,hg38,CD-0722-4
"B6,A4",12112,13087,8961,4126,6737,3294,4,3299,2092,1207,1.733222867,1815,871,162,75,71,4,23,1,0,0,empty,CD-0722-4
"B6,A5",9689,10724,7246,3478,5665,2823,1,2829,1788,1041,1.717579251,1642,2658,685,247,247,0,53,0,0.129554656,0,empty,CD-0722-4
"B6,A6",10157,11306,7601,3705,5871,3032,0,3037,2059,978,2.105316973,1717,2737,536,225,221,4,74,2,0.131221719,0,empty,CD-0722-4
"B6,A7",714407,781619,559525,222094,383523,181845,19,182022,139191,42831,3.249772361,100161,19243,3462,1404,1375,29,293,2,0.003636364,0,hg38,CD-0722-4
"B6,A8",4543,5042,3340,1702,2814,1517,0,1519,1051,468,2.245726496,871,1666,395,163,163,0,46,0,0.012269939,0,empty,CD-0722-4
"B6,A9",7430,8200,5681,2519,4265,2041,15,2056,1325,731,1.812585499,1150,1368,304,129,126,3,42,1,0,0,empty,CD-0722-4
"B6,A10",8070,8755,6097,2658,4530,2192,0,2193,1434,759,1.889328063,1187,268,17,9,9,0,6,0,0.222222222,0,empty,CD-0722-4
"B6,A11",6187,6839,4786,2053,3588,1669,20,1689,1118,571,1.957968476,904,1353,321,145,143,2,36,2,0,0,empty,CD-0722-4
"B6,A12",9162,10070,6925,3145,5192,2405,0,2408,1590,818,1.943765281,1368,4850,893,353,348,5,83,2,0.103448276,0,empty,CD-0722-4
"B6,B1",7618,8530,5553,2977,4365,2259,0,2263,1421,842,1.687648456,1303,880,186,86,86,0,23,0,0.23255814,0,empty,CD-0722-4
"B6,B2",8940,9926,6194,3732,5109,2701,0,2703,1716,987,1.738601824,1633,616,102,54,53,1,13,1,0,0,empty,CD-0722-4
"B6,B3",6043,6526,4466,2060,3454,1753,0,1755,1148,607,1.891268534,1025,1140,231,95,93,2,26,2,0,0,empty,CD-0722-4
"B6,B4",7344,8034,5300,2734,4278,2271,0,2271,1413,858,1.646853147,1306,1394,211,86,85,1,29,1,0,0,empty,CD-0722-4
"B6,B5",7804,4942,3097,1845,3201,1687,0,1698,1115,583,1.912521441,1065,1108,435,171,171,0,39,0,0.134502924,0,empty,CD-0722-4
"B6,B6",567926,685613,389684,295929,342320,223507,0,223652,161818,61834,2.61697448,135304,10420,890,324,317,7,93,3,0.179810726,0,hg38,CD-0722-4
"B6,B7",8222,9093,6215,2878,4633,2248,0,2249,1457,792,1.839646465,1236,1071,298,109,109,0,34,0,0.146788991,0,empty,CD-0722-4
"B6,B8",669694,759646,506530,253116,373988,193018,13,193212,151079,42133,3.585764128,110967,72600,9121,3540,3472,68,690,4,0.051267281,0,hg38,CD-0722-4
"B6,B9",10650,11964,7718,4246,5973,3145,0,3154,1971,1183,1.666103128,1819,912,175,57,54,3,26,2,0.018518519,0,empty,CD-0722-4
"B6,B10",5427,5941,3960,1981,3301,1656,0,1656,986,670,1.471641791,961,494,104,35,35,0,6,0,0.114285714,0,empty,CD-0722-4
"B6,B11",16482,18936,11872,7064,9616,5288,0,5297,3342,1955,1.709462916,3135,200,93,45,45,0,8,0,0,0,empty,CD-0722-4
"B6,B12",6747,7303,4966,2337,3889,1941,0,1942,1202,740,1.624324324,1115,1737,383,151,151,0,45,0,0.006622517,0,empty,CD-0722-4
"B6,C1",13932,15003,10629,4374,7813,3663,0,3663,2327,1336,1.741766467,2008,1313,180,74,73,1,31,1,0.01369863,0,empty,CD-0722-4
"B6,C2",11695,12682,8467,4215,6490,3304,16,3324,2120,1204,1.760797342,1859,2629,754,279,275,4,70,3,0.010909091,0,empty,CD-0722-4
"B6,C3",11622,12355,8739,3616,6530,3171,0,3175,1970,1205,1.634854772,1670,982,78,42,41,1,16,1,0,0,empty,CD-0722-4
"B6,C4",6852,7569,5196,2373,3956,1807,1,1815,1189,626,1.899361022,983,2322,487,207,201,6,54,2,0.099502488,0,empty,CD-0722-4
"B6,C5",17737,20490,13212,7278,10254,5610,0,5612,3851,1761,2.186825667,3308,1981,572,245,237,8,47,1,0.219409283,0,empty,CD-0722-4
"B6,C6",8815,9821,6393,3428,5174,2649,29,2679,1655,1024,1.616210938,1549,1388,262,109,106,3,30,3,0.047169811,0,empty,CD-0722-4
"B6,C7",12224,13663,9003,4660,6942,3820,0,3827,2281,1546,1.47542044,2156,252,84,36,36,0,10,0,0,0,empty,CD-0722-4
"B6,C8",12688,14268,9476,4792,7450,3733,1,3738,2417,1321,1.829674489,2155,2933,646,233,232,1,53,1,0.043103448,0,empty,CD-0722-4
"B6,C9",8807,9953,6418,3535,5169,2614,1,2624,1677,947,1.770855333,1531,1410,406,164,164,0,32,0,0.073170732,0,empty,CD-0722-4
"B6,C10",10462,11417,7927,3490,6018,2867,6,2878,1800,1078,1.669758813,1596,1652,305,125,124,1,37,1,0.024193548,0,empty,CD-0722-4
"B6,C11",9582,10425,7057,3368,5420,2658,15,2673,1750,923,1.895991333,1485,1774,504,176,174,2,48,2,0.040229885,0,empty,CD-0722-4
"B6,C12",12783,13777,9585,4192,7202,3422,1,3429,2242,1187,1.888795282,1900,2668,572,208,199,9,55,2,0.130653266,0,empty,CD-0722-4
"B6,D1",11488,12782,8201,4581,6570,3527,9,3539,2141,1398,1.531473534,2103,723,55,18,18,0,9,0,0,0,empty,CD-0722-4
"B6,D2",10061,10874,7598,3276,5705,2680,0,2686,1746,940,1.857446809,1469,2357,722,268,266,2,70,1,0.033834586,0,empty,CD-0722-4
"B6,D3",686719,734788,539938,194850,360989,159268,0,159434,127710,31724,4.025658807,86166,13356,1591,612,604,8,131,2,0.014900662,0,hg38,CD-0722-4
"B6,D4",6286,7058,4651,2407,3612,1801,0,1802,1133,669,1.693572496,983,1870,341,107,102,5,41,2,0.029411765,0,empty,CD-0722-4
"B6,D5",7738,8468,5740,2728,4410,2155,6,2169,1365,804,1.697761194,1239,1340,298,106,103,3,28,1,0.087378641,0,empty,CD-0722-4
"B6,D6",12344,13592,8874,4718,6972,3729,0,3729,2254,1475,1.528135593,2154,2299,315,142,141,1,42,1,0.04964539,0,empty,CD-0722-4
"B6,D7",1001603,1145373,743880,401493,557228,302477,2,302708,239549,63159,3.792792793,176520,154802,27387,10583,10433,150,1585,5,0.038435733,0,hg38,CD-0722-4
"B6,D8",7431,8163,5522,2641,4218,2050,16,2069,1362,707,1.926449788,1155,1225,229,80,79,1,28,1,0.151898734,0,empty,CD-0722-4
"B6,D9",4917,5371,3703,1668,2768,1294,2,1298,872,426,2.046948357,740,1684,345,98,96,2,28,1,0.010416667,0,empty,CD-0722-4
"B6,D10",7939,8762,5760,3002,4479,2333,0,2333,1463,870,1.681609195,1346,878,137,40,40,0,17,0,0.025,0,empty,CD-0722-4
"B6,D11",8078,8553,6110,2443,4450,2062,0,2063,1304,759,1.718050066,1118,2779,857,275,266,9,60,3,0.135338346,0,empty,CD-0722-4
"B6,D12",1125922,1295208,841112,454096,629606,338919,3,339223,264285,74938,3.526715418,198660,154924,20555,8245,8045,200,1399,5,0.043629584,0,hg38,CD-0722-4
"B6,E1",13185,14356,9835,4521,7305,3600,1,3603,2241,1362,1.645374449,1971,2641,491,193,189,4,56,3,0.084656085,0,empty,CD-0722-4
"B6,E2",9962,10796,7338,3458,5596,2819,0,2821,1808,1013,1.784797631,1578,2048,340,128,128,0,43,0,0.03125,0,empty,CD-0722-4
"B6,E3",1033957,1277781,743036,534745,628619,399368,19,399710,299853,99857,3.002824038,240107,73363,35563,13384,13348,36,1950,3,0.020752173,0,hg38,CD-0722-4
"B6,E4",8626,9321,6403,2918,4960,2447,0,2453,1576,877,1.797035348,1351,1589,358,149,149,0,43,0,0.020134228,0,empty,CD-0722-4
"B6,E5",8516,9128,6501,2627,4677,2074,16,2096,1360,736,1.847826087,1150,1022,270,111,109,2,27,2,0,0,empty,CD-0722-4
"B6,E6",14135,15761,10358,5403,8023,4018,0,4019,2572,1447,1.777470629,2329,3127,835,290,288,2,77,1,0.024305556,0,empty,CD-0722-4
"B6,E7",12442,13602,9259,4343,7169,3432,0,3437,2224,1213,1.833470734,1929,2377,519,199,197,2,67,2,0.147208122,0,empty,CD-0722-4
"B6,E8",10884,11828,8340,3488,6002,2806,1,2811,1844,967,1.906928645,1476,2351,562,207,206,1,67,1,0.106796117,0,empty,CD-0722-4
"B6,E9",689929,853824,472901,380923,423496,281656,5,281851,207738,74113,2.802990029,172276,14359,1466,501,484,17,99,3,0.272727273,0,hg38,CD-0722-4
"B6,E10",8068,8904,6114,2790,4587,2201,1,2203,1408,795,1.771069182,1231,1453,398,151,148,3,41,2,0.087837838,0,empty,CD-0722-4
"B6,E11",9141,9888,6783,3105,5205,2633,0,2633,1669,964,1.731327801,1449,2003,568,199,197,2,50,1,0.101522843,0,empty,CD-0722-4
"B6,E12",9435,10349,6851,3498,5469,2801,0,2806,1779,1027,1.732229796,1644,1620,394,162,162,0,35,0,0.092592593,0,empty,CD-0722-4
"B6,F1",11902,12729,8798,3931,6525,3110,0,3113,1996,1117,1.786929275,1705,2071,496,207,204,3,44,2,0.12745098,0,empty,CD-0722-4
"B6,F2",9071,9628,6661,2967,5127,2410,9,2421,1606,815,1.970552147,1379,2601,591,203,201,2,58,1,0,0,empty,CD-0722-4
"B6,F3",8729,9771,6448,3323,5057,2486,1,2487,1564,923,1.69447454,1463,2513,572,232,231,1,70,1,0.112554113,0,empty,CD-0722-4
"B6,F4",13416,14411,10040,4371,7537,3553,0,3558,2368,1190,1.989915966,1939,529,84,32,30,2,10,1,0.1,0,empty,CD-0722-4
"B6,F5",10702,11493,8014,3479,5940,2780,0,2782,1808,974,1.856262834,1538,2006,455,198,195,3,46,2,0.107692308,0,empty,CD-0722-4
"B6,F6",10131,11576,7376,4200,6025,3161,13,3174,2054,1120,1.833928571,1920,2580,575,245,241,4,85,2,0.070539419,0,empty,CD-0722-4
"B6,F7",11839,13061,8758,4303,6919,3428,0,3433,2234,1199,1.863219349,1963,866,178,72,71,1,30,1,0,0,empty,CD-0722-4
"B6,F8",9201,10093,6846,3247,5263,2555,0,2557,1701,856,1.987149533,1444,214,36,21,21,0,14,0,0.142857143,0,empty,CD-0722-4
"B6,F9",8988,9988,6719,3269,5093,2484,1,2485,1718,767,2.239895698,1409,2454,562,250,249,1,52,1,0.080321285,0,empty,CD-0722-4
"B6,F10",2343330,2744554,1704734,1039820,1315224,776292,4,776938,596378,180560,3.302935312,461863,98327,18337,6967,6874,93,1123,5,0.038114635,0,hg38,CD-0722-4
"B6,F11",8685,9135,6625,2510,4837,2261,0,2263,1504,759,1.981554677,1194,1221,317,110,109,1,26,1,0.128440367,0,empty,CD-0722-4
"B6,F12",10039,10993,7407,3586,5688,2812,0,2818,1870,948,1.97257384,1608,150,6,6,6,0,4,0,0,0,empty,CD-0722-4
"B6,G1",11367,12202,8500,3702,6265,2920,0,2925,1948,977,1.993858751,1629,3076,884,332,330,2,71,1,0.093939394,0,empty,CD-0722-4
"B6,G2",787084,876202,575553,300649,431963,227183,0,227366,181777,45589,3.987299568,131870,15821,2746,1034,1023,11,223,2,0.017595308,0,hg38,CD-0722-4
"B6,G3",11931,12716,8872,3844,6519,3247,0,3247,1945,1302,1.493855607,1720,2741,720,273,258,15,76,2,0.019379845,0,empty,CD-0722-4
"B6,G4",22049,24880,15643,9237,12672,7153,0,7157,4358,2799,1.556984637,4201,27,0,0,0,0,0,0,0,0,empty,CD-0722-4
"B6,G5",7442,8071,5672,2399,4257,2075,1,2077,1407,670,2.1,1086,1381,309,126,124,2,29,1,0.040322581,0,empty,CD-0722-4
"B6,G6",11512,12536,8602,3934,6362,3148,0,3150,2091,1059,1.974504249,1708,135,21,16,16,0,8,0,0.0625,0,empty,CD-0722-4
"B6,G7",12348,13854,9559,4295,7244,3519,15,3537,2472,1065,2.321126761,2023,2425,467,202,197,5,73,1,0.035532995,0,empty,CD-0722-4
"B6,G8",6166,6727,4500,2227,3560,1724,12,1741,1149,592,1.940878378,995,1501,336,124,121,3,32,2,0.008264463,0,empty,CD-0722-4
"B6,G9",7686,8554,5592,2962,4470,2264,1,2267,1456,811,1.795314427,1304,2141,663,270,268,2,64,1,0.026119403,0,empty,CD-0722-4
"B6,G10",9405,10608,6885,3723,5402,2744,18,2764,1812,952,1.903361345,1652,2179,506,222,221,1,62,1,0.045248869,0,empty,CD-0722-4
"B6,G11",9217,9993,6865,3128,5244,2493,2,2496,1620,876,1.849315068,1401,1142,292,137,135,2,29,2,0.185185185,0,empty,CD-0722-4
"B6,G12",1900387,2368619,1289513,1079106,1174448,768150,2,768696,594718,173978,3.418351746,489303,159241,36470,13740,13597,143,1864,5,0.053688314,0,hg38,CD-0722-4
"B6,H1",7631,8210,5580,2630,4361,2081,1,2083,1341,742,1.807277628,1208,1223,213,106,106,0,26,0,0.056603774,0,empty,CD-0722-4
"B6,H2",8988,10213,6499,3714,5204,2659,0,2664,1658,1006,1.648111332,1584,2528,519,233,231,2,72,1,0.03030303,0,empty,CD-0722-4
"B6,H3",7485,8004,5555,2449,4211,2043,15,2061,1347,714,1.886554622,1142,1845,280,129,129,0,36,0,0.069767442,0,empty,CD-0722-4
"B6,H4",1237335,1497266,884669,612597,723715,431409,7,431741,349368,82373,4.241292657,264832,2980,788,275,268,7,80,2,0.130597015,0,hg38,CD-0722-4
"B6,H5",1151424,1335830,852689,483141,647921,355813,4,356099,285026,71073,4.01032741,210959,115336,20605,7798,7694,104,1277,5,0.050558877,0,hg38,CD-0722-4
"B6,H6",7271,8090,5257,2833,4095,2088,4,2097,1381,716,1.92877095,1202,1328,235,110,108,2,42,1,0.083333333,0,empty,CD-0722-4
"B6,H7",8480,9166,6257,2909,4890,2354,22,2380,1616,764,2.115183246,1361,1769,411,203,202,1,49,1,0.084158416,0,empty,CD-0722-4
"B6,H8",18222,20905,12885,8020,10965,6395,0,6397,4464,1933,2.309363683,3769,2121,491,200,199,1,61,1,0.190954774,0,empty,CD-0722-4
"B6,H9",7196,7605,5420,2185,4030,1835,0,1838,1221,617,1.978930308,1005,936,176,61,61,0,20,0,0.032786885,0,empty,CD-0722-4
"B6,H10",6487,7354,4727,2627,3701,1875,0,1875,1171,704,1.663352273,1078,833,198,77,77,0,23,0,0.051948052,0,empty,CD-0722-4
"B6,H11",8760,9752,6183,3569,5052,3043,11,3064,1693,1371,1.234865062,1792,127,1,1,1,0,1,0,0,0,empty,CD-0722-4
"B6,H12",6580,7204,4821,2383,3741,1965,0,1965,1216,749,1.623497997,1113,1230,266,97,94,3,17,2,0.276595745,0,empty,CD-0722-4
"B7,A1",7368,7752,5508,2244,4062,2020,12,2035,1329,706,1.882436261,1068,1177,189,77,77,0,21,0,0.064935065,0,empty,CD-0722-4
"B7,A2",11101,12162,8128,4034,6157,3177,0,3180,2055,1125,1.826666667,1784,1739,503,216,212,4,39,2,0.066037736,0,empty,CD-0722-4
"B7,A3",6862,7511,5026,2485,3825,1885,0,1889,1263,626,2.017571885,1076,1214,318,131,129,2,30,2,0.046511628,0,empty,CD-0722-4
"B7,A4",1190987,1366580,895378,471202,636966,339803,3,340107,261254,78853,3.313177685,196939,48940,7646,3051,3003,48,534,4,0.044955045,0,hg38,CD-0722-4
"B7,A5",10479,11402,7649,3753,5767,2822,23,2847,1905,942,2.022292994,1640,2521,611,278,275,3,76,2,0.101818182,0,empty,CD-0722-4
"B7,A6",919421,1071265,694691,376574,506096,267919,2,268187,219200,48987,4.474656542,156616,189473,34340,13646,13447,199,2008,5,0.074960958,0,hg38,CD-0722-4
"B7,A7",7945,9005,5879,3126,4483,2277,25,2303,1445,858,1.684149184,1317,983,266,108,105,3,30,2,0.019047619,0,empty,CD-0722-4
"B7,A8",4586,5052,3533,1519,2565,1259,9,1270,897,373,2.404825737,668,1586,407,156,155,1,48,1,0.019354839,0,empty,CD-0722-4
"B7,A9",8009,9178,5958,3220,4642,2342,0,2342,1530,812,1.884236453,1362,1514,338,121,119,2,43,1,0.042016807,0,empty,CD-0722-4
"B7,A10",8963,9725,6907,2818,4882,2334,3,2341,1426,915,1.558469945,1308,349,34,25,22,3,7,1,0,0,empty,CD-0722-4
"B7,A11",6403,7126,4936,2190,3646,1657,0,1660,1085,575,1.886956522,926,934,193,83,80,3,33,1,0.1125,0,empty,CD-0722-4
"B7,A12",10042,10917,7452,3465,5442,2613,2,2615,1720,895,1.921787709,1491,3142,774,271,267,4,72,2,0.086142322,0,empty,CD-0722-4
"B7,B1",7995,8887,5963,2924,4493,2297,2,2307,1490,817,1.82374541,1286,737,200,99,99,0,24,0,0,0,empty,CD-0722-4
"B7,B2",8521,9260,5715,3545,4710,2502,1,2510,1615,895,1.804469274,1482,643,214,68,68,0,13,0,0,0,empty,CD-0722-4
"B7,B3",6768,7761,4983,2778,3848,1872,0,1876,1229,647,1.899536321,1074,1182,312,115,112,3,35,1,0.044642857,0,empty,CD-0722-4
"B7,B4",7713,8880,5611,3269,4459,2378,0,2384,1458,926,1.574514039,1402,1399,389,130,128,2,29,2,0,0,empty,CD-0722-4
"B7,B5",11121,7977,5113,2864,4793,2536,7,2555,1797,758,2.370712401,1553,998,272,97,92,5,26,4,0.173913043,0,empty,CD-0722-4
"B7,B6",8959,9868,6507,3361,4981,2581,0,2581,1648,933,1.766345123,1486,1801,486,166,165,1,39,1,0.096969697,0,empty,CD-0722-4
"B7,B7",11562,12922,8563,4359,6460,3209,0,3215,2090,1125,1.857777778,1839,1072,254,109,109,0,28,0,0.018348624,0,empty,CD-0722-4
"B7,B8",663740,763065,491529,271536,365963,199039,1,199259,160749,38510,4.17421449,115861,54693,8604,3393,3322,71,683,4,0.049066827,0,hg38,CD-0722-4
"B7,B9",11614,13071,8614,4457,6528,3390,7,3406,2155,1251,1.722621902,1902,909,225,95,92,3,27,1,0.293478261,0,empty,CD-0722-4
"B7,B10",865221,943718,609482,334236,476354,251261,10,252028,190618,61410,3.104022146,149867,5625,712,251,249,2,62,1,0.076305221,0,hg38,CD-0722-4
"B7,B11",1930430,2121678,1476847,644831,968033,479235,2,479718,369013,110705,3.333300212,269372,34003,3014,1208,1172,36,260,3,0.062286689,0,hg38,CD-0722-4
"B7,B12",7087,7864,5216,2648,4044,2005,8,2020,1303,717,1.817294282,1153,1695,211,109,108,1,33,1,0.166666667,0,empty,CD-0722-4
"B7,C1",14790,15906,11133,4773,7998,3823,0,3829,2473,1356,1.823746313,2110,860,196,104,103,1,33,1,0.058252427,0,empty,CD-0722-4
"B7,C2",11843,12778,8746,4032,6537,3327,2,3331,2189,1142,1.916812609,1813,1874,435,200,195,5,49,2,0.133333333,0,empty,CD-0722-4
"B7,C3",12292,13565,9213,4352,6728,3237,0,3239,2026,1213,1.670239077,1813,926,97,35,34,1,21,1,0.088235294,0,empty,CD-0722-4
"B7,C4",7553,7999,5576,2423,4183,1934,0,1934,1262,672,1.87797619,1090,1951,470,189,188,1,44,1,0.303191489,0,empty,CD-0722-4
"B7,C5",11335,12372,8437,3935,6177,3029,2,3035,1937,1098,1.764116576,1704,1384,232,110,108,2,38,1,0.074074074,0,empty,CD-0722-4
"B7,C6",9250,10072,6897,3175,5223,2557,0,2560,1621,939,1.726304579,1458,1333,352,150,150,0,40,0,0.006666667,0,empty,CD-0722-4
"B7,C7",12845,14759,8975,5784,7586,4266,0,4269,2520,1749,1.440823328,2635,539,113,47,47,0,12,0,0,0,empty,CD-0722-4
"B7,C8",15804,16881,11932,4949,8586,4187,1,4195,2720,1475,1.844067797,2231,3786,792,339,328,11,79,3,0.170731707,0,empty,CD-0722-4
"B7,C9",9650,10664,7173,3491,5384,2693,0,2693,1794,899,1.995550612,1502,1410,203,116,114,2,31,1,0,0,empty,CD-0722-4
"B7,C10",11196,12006,8294,3712,5963,2904,0,2906,1885,1021,1.846229187,1601,1850,565,211,209,2,49,1,0.028708134,0,empty,CD-0722-4
"B7,C11",9572,10342,7075,3267,5226,2549,0,2550,1651,899,1.836484983,1419,1631,443,152,149,3,41,1,0.046979866,0,empty,CD-0722-4
"B7,C12",394791,463305,277207,186098,234780,146067,2,146169,86680,59489,1.457076098,89421,2215,696,225,225,0,60,0,0.026666667,0,hg38,CD-0722-4
"B7,D1",12024,13569,8749,4820,6861,3659,0,3661,2239,1422,1.574542897,2137,805,94,31,30,1,10,1,0.066666667,0,empty,CD-0722-4
"B7,D2",16292,19662,11828,7834,9925,5910,0,5913,4368,1545,2.827184466,3527,2097,464,215,212,3,73,2,0.028301887,0,empty,CD-0722-4
"B7,D3",8584,9217,6320,2897,4677,2345,0,2345,1544,801,1.927590512,1282,1325,341,97,97,0,31,0,0.010309278,0,empty,CD-0722-4
"B7,D4",7018,7687,5285,2402,3905,1956,1,1960,1257,703,1.788051209,1090,1455,340,116,115,1,35,1,0.026086957,0,empty,CD-0722-4
"B7,D5",7780,8246,5790,2456,4283,2016,1,2021,1296,725,1.787586207,1125,964,197,82,81,1,31,1,0.074074074,0,empty,CD-0722-4
"B7,D6",11737,12905,8511,4394,6461,3423,0,3425,2084,1341,1.554064131,1930,1518,276,119,118,1,42,1,0.042372881,0,empty,CD-0722-4
"B7,D7",6711,7066,4931,2135,3651,1750,0,1750,1159,591,1.96108291,950,1463,342,147,147,0,42,0,0.047619048,0,empty,CD-0722-4
"B7,D8",8564,9553,6449,3104,4752,2345,0,2349,1450,899,1.612903226,1327,1032,202,90,90,0,29,0,0.1,0,empty,CD-0722-4
"B7,D9",4326,4507,3280,1227,2368,1075,0,1075,744,331,2.247734139,564,1451,318,96,90,6,27,2,0.033333333,0,empty,CD-0722-4
"B7,D10",8128,9027,5930,3097,4582,2326,0,2326,1472,854,1.723653396,1350,817,159,80,79,1,25,1,0.164556962,0,empty,CD-0722-4
"B7,D11",9276,10134,6890,3244,5094,2431,0,2432,1536,896,1.714285714,1367,3051,718,261,258,3,63,1,0.073643411,0,empty,CD-0722-4
"B7,D12",13667,15171,10197,4974,7729,3899,0,3903,2435,1468,1.658719346,2270,4228,912,366,361,5,89,2,0.04432133,0,empty,CD-0722-4
"B7,E1",15138,16040,11193,4847,8166,3985,1,3995,2470,1525,1.619672131,2221,2787,646,260,255,5,66,2,0.133333333,0,empty,CD-0722-4
"B7,E2",10236,11097,7392,3705,5559,2768,0,2768,1722,1046,1.646271511,1584,1721,281,110,110,0,30,0,0.063636364,0,empty,CD-0722-4
"B7,E3",6952,7868,5202,2666,3898,1864,10,1874,1184,690,1.715942029,1087,2186,629,220,220,0,61,0,0.145454545,0,empty,CD-0722-4
"B7,E4",9448,10494,7056,3438,5182,2517,0,2520,1672,848,1.971698113,1460,2180,371,149,147,2,55,2,0.047619048,0,empty,CD-0722-4
"B7,E5",8864,9955,6745,3210,5004,2381,41,2424,1638,786,2.083969466,1340,1107,316,149,149,0,35,0,0,0,empty,CD-0722-4
"B7,E6",15098,16771,11238,5533,8427,4234,1,4240,2752,1488,1.849462366,2399,3196,891,310,309,1,72,1,0.1197411,0,empty,CD-0722-4
"B7,E7",720431,800881,550947,249934,380268,191228,0,191424,146938,44486,3.303016679,107800,30693,6117,2141,2120,21,463,3,0.032075472,0,hg38,CD-0722-4
"B7,E8",11044,11926,8281,3645,6050,2786,1,2789,1836,953,1.926547744,1560,2290,575,203,201,2,50,2,0.004975124,0,empty,CD-0722-4
"B7,E9",6548,7017,4906,2111,3633,1818,1,1820,1258,562,2.238434164,1015,1782,566,224,224,0,57,0,0.075892857,0,empty,CD-0722-4
"B7,E10",8371,9035,6359,2676,4608,2196,0,2196,1445,751,1.924101198,1159,1647,498,184,184,0,35,0,0.201086957,0,empty,CD-0722-4
"B7,E11",9611,10747,7127,3620,5366,2722,1,2725,1694,1031,1.643064985,1573,1921,427,155,154,1,43,1,0.012987013,0,empty,CD-0722-4
"B7,E12",10047,11021,7360,3661,5658,2708,1,2714,1750,964,1.815352697,1576,1371,315,129,123,6,32,1,0.081300813,0,empty,CD-0722-4
"B7,F1",1851631,2082845,1395149,687696,979448,532492,19,532998,374858,158140,2.370418616,304789,33810,12276,4473,4449,24,888,2,0.039334682,0,hg38,CD-0722-4
"B7,F2",9455,10460,6976,3484,5220,2557,3,2560,1659,901,1.841287458,1454,2709,690,232,226,6,63,3,0.238938053,0,empty,CD-0722-4
"B7,F3",9612,10306,7197,3109,5237,2472,8,2482,1616,866,1.866050808,1334,2370,599,228,227,1,49,1,0.110132159,0,empty,CD-0722-4
"B7,F4",14086,14790,10481,4309,7511,3447,0,3458,2188,1270,1.722834646,1875,544,112,54,54,0,18,0,0,0,empty,CD-0722-4
"B7,F5",11346,11959,8562,3397,6195,2881,0,2881,1876,1005,1.866666667,1541,2261,591,193,188,5,42,2,0.090425532,0,empty,CD-0722-4
"B7,F6",2026346,2398302,1475742,922560,1118592,643472,7,644070,527735,116335,4.536339021,387822,336864,69089,27165,26800,365,3115,12,0.065820896,0,hg38,CD-0722-4
"B7,F7",13026,14445,9804,4641,7283,3616,9,3625,2355,1270,1.854330709,2020,1142,316,122,120,2,31,1,0.008333333,0,empty,CD-0722-4
"B7,F8",9225,9899,6939,2960,5133,2503,1,2509,1648,861,1.914053426,1353,305,44,14,13,1,10,1,0,0,empty,CD-0722-4
"B7,F9",9484,10233,7293,2940,5197,2415,10,2429,1654,775,2.134193548,1326,2384,529,199,196,3,61,1,0.005102041,0,empty,CD-0722-4
"B7,F10",12742,13684,9596,4088,6925,3266,0,3270,2129,1141,1.865907099,1786,1524,356,144,144,0,41,0,0,0,empty,CD-0722-4
"B7,F11",9547,10220,7270,2950,5155,2400,0,2400,1584,816,1.941176471,1260,1898,440,153,151,2,44,2,0.046357616,0,empty,CD-0722-4
"B7,F12",11124,12037,8150,3887,6037,2925,1,2928,1930,998,1.933867735,1675,263,72,21,21,0,8,0,0,0,empty,CD-0722-4
"B7,G1",12436,13600,9476,4124,6968,3372,13,3386,2234,1152,1.939236111,1881,2582,620,241,241,0,56,0,0.033195021,0,empty,CD-0722-4
"B7,G2",6937,7226,4950,2276,3704,1851,13,1869,1168,701,1.666191155,1041,395,13,8,7,1,7,1,0.142857143,0,empty,CD-0722-4
"B7,G3",13023,13930,9625,4305,6996,3437,4,3444,2095,1349,1.553002224,1843,1962,460,197,195,2,48,2,0,0,empty,CD-0722-4
"B7,G4",22628,25334,16497,8837,12586,6828,0,6831,4194,2637,1.590443686,3862,125,26,15,15,0,3,0,0,0,empty,CD-0722-4
"B7,G5",7754,8462,5721,2741,4309,2111,1,2116,1307,809,1.615574784,1220,1372,272,101,100,1,34,1,0.02,0,empty,CD-0722-4
"B7,G6",11615,12441,8707,3734,6382,3125,1,3128,2133,995,2.143718593,1688,196,30,17,17,0,6,0,0.235294118,0,empty,CD-0722-4
"B7,G7",9611,10585,7233,3352,5392,2597,1,2599,1725,874,1.973684211,1424,2179,762,271,270,1,70,1,0.1,0,empty,CD-0722-4
"B7,G8",801879,912472,603288,309184,435434,225645,3,225851,172020,53831,3.195556464,132557,93556,9534,3851,3740,111,791,3,0.044652406,0,hg38,CD-0722-4
"B7,G9",8709,9111,6477,2634,4574,2149,3,2155,1378,777,1.773487773,1147,1742,369,152,152,0,59,0,0.111842105,0,empty,CD-0722-4
"B7,G10",861047,975909,638260,337649,468435,251371,0,251579,207372,44207,4.6909313,145048,72612,16894,6611,6535,76,1151,6,0.033664881,0,hg38,CD-0722-4
"B7,G11",10033,10703,7465,3238,5444,2598,27,2629,1779,850,2.092941176,1429,1366,318,111,111,0,32,0,0.081081081,0,empty,CD-0722-4
"B7,G12",7792,8418,5610,2808,4266,2200,7,2209,1436,773,1.857697283,1263,2489,744,249,248,1,50,1,0.056451613,0,empty,CD-0722-4
"B7,H1",8493,9254,6354,2900,4652,2265,2,2270,1467,803,1.826899128,1233,894,194,85,85,0,26,0,0.035294118,0,empty,CD-0722-4
"B7,H2",9738,11044,7147,3897,5532,2849,2,2855,1793,1062,1.688323917,1689,2828,680,281,277,4,78,3,0.0433213,0,empty,CD-0722-4
"B7,H3",8082,8813,5880,2933,4402,2209,0,2209,1425,784,1.817602041,1279,1416,347,132,132,0,32,0,0.045454545,0,empty,CD-0722-4
"B7,H4",11459,12615,8505,4110,6302,3112,0,3117,2035,1082,1.88077634,1764,149,18,14,14,0,7,0,0.071428571,0,empty,CD-0722-4
"B7,H5",12772,14044,9219,4825,6837,3424,0,3427,2284,1143,1.998250219,1946,1977,525,208,205,3,43,1,0.058536585,0,empty,CD-0722-4
"B7,H6",7573,8447,5447,3000,4207,2224,0,2227,1428,799,1.787234043,1292,1738,488,172,171,1,54,1,0.052631579,0,empty,CD-0722-4
"B7,H7",10188,10455,7230,3225,5396,2552,0,2557,1663,894,1.860178971,1442,1805,482,186,182,4,39,2,0.082417582,0,empty,CD-0722-4
"B7,H8",10556,11719,7807,3912,5863,3033,11,3046,1943,1103,1.761559383,1750,2743,494,221,219,2,60,1,0.050228311,0,empty,CD-0722-4
"B7,H9",7754,8436,5909,2527,4194,1891,0,1891,1270,621,2.045088567,1032,1334,491,180,178,2,32,2,0.005617978,0,empty,CD-0722-4
"B7,H10",6969,7439,5276,2163,3707,1709,20,1729,1133,596,1.901006711,924,1251,304,97,94,3,28,1,0.021276596,0,empty,CD-0722-4
"B7,H11",8665,9811,5997,3814,4962,2975,0,2977,1659,1318,1.258725341,1777,19,7,6,6,0,4,0,0,0,empty,CD-0722-4
"B7,H12",7235,8093,5340,2753,4095,2099,0,2099,1317,782,1.684143223,1207,1761,411,174,172,2,40,2,0.046511628,0,empty,CD-0722-4
"B8,A1",8054,8910,5822,3088,4718,2460,0,2462,1656,806,2.054590571,1422,1740,561,208,204,4,50,2,0.06372549,0,empty,CD-0722-4
"B8,A2",10446,11377,7673,3704,5907,3003,4,3010,1871,1139,1.642669008,1745,2132,447,153,152,1,46,1,0.072368421,0,empty,CD-0722-4
"B8,A3",6605,7401,4797,2604,3737,1863,13,1878,1231,647,1.902627512,1064,1135,279,105,104,1,34,1,0.067307692,0,empty,CD-0722-4
"B8,A4",11693,12698,8764,3934,6575,3215,0,3222,2078,1144,1.816433566,1821,699,173,56,56,0,17,0,0.339285714,0,empty,CD-0722-4
"B8,A5",605314,727131,418700,308431,364048,235129,3,235307,173485,61822,2.806201676,141720,22563,1818,630,599,31,120,2,0.242070117,0,hg38,CD-0722-4
"B8,A6",15578,17729,11778,5951,9031,4511,0,4513,3135,1378,2.275036284,2600,3712,1081,407,407,0,96,0,0.125307125,0,empty,CD-0722-4
"B8,A7",7022,7670,5213,2457,4068,2088,0,2090,1329,761,1.746386334,1167,1642,417,130,130,0,34,0,0.1,0,empty,CD-0722-4
"B8,A8",4599,5196,3510,1686,2765,1359,0,1359,895,464,1.92887931,762,1691,480,176,176,0,46,0,0.011363636,0,empty,CD-0722-4
"B8,A9",7471,8192,5757,2435,4278,2032,20,2052,1346,706,1.906515581,1106,2545,640,266,265,1,57,1,0.128301887,0,empty,CD-0722-4
"B8,A10",8678,9524,6579,2945,4920,2430,0,2433,1562,871,1.793340987,1317,449,43,31,28,3,14,1,0.107142857,0,empty,CD-0722-4
"B8,A11",6426,6763,4859,1904,3523,1575,30,1605,1096,509,2.15324165,836,1626,358,124,119,5,26,2,0.050420168,0,empty,CD-0722-4
"B8,A12",976288,1073042,752947,320095,513441,245476,2,245691,186840,58851,3.17479737,137459,176477,17173,6846,6635,211,1237,8,0.037076112,0,hg38,CD-0722-4
"B8,B1",1014590,1140924,755119,385805,551985,293194,3,293494,244681,48813,5.012619589,166074,245437,65271,25092,24882,210,2829,8,0.040471023,0,hg38,CD-0722-4
"B8,B2",8330,9092,5693,3399,4747,2540,0,2540,1628,912,1.785087719,1491,450,60,15,15,0,9,0,0,0,empty,CD-0722-4
"B8,B3",6323,6961,4643,2318,3690,1793,1,1795,1142,653,1.748851455,1039,1632,433,180,178,2,56,2,0.04494382,0,empty,CD-0722-4
"B8,B4",9025,10014,6580,3434,5128,2687,1,2690,1709,981,1.742099898,1531,1503,283,120,119,1,35,1,0.025210084,0,empty,CD-0722-4
"B8,B5",8032,5175,3155,2020,3282,1745,0,1759,1157,602,1.92192691,1118,948,97,41,41,0,18,0,0.048780488,0,empty,CD-0722-4
"B8,B6",8241,9304,5979,3325,4852,2567,0,2567,1577,990,1.592929293,1493,2029,405,181,180,1,52,1,0.1,0,empty,CD-0722-4
"B8,B7",1849080,2000083,1444130,555953,952258,452682,27,453148,367441,85707,4.287176077,247904,93778,14274,5437,5346,91,920,3,0.023381968,0,hg38,CD-0722-4
"B8,B8",6501,7123,4964,2159,3740,1877,0,1879,1248,631,1.977812995,967,1470,323,119,119,0,40,0,0.033613445,0,empty,CD-0722-4
"B8,B9",985064,1138314,732876,405438,550330,294879,6,295168,238155,57013,4.177205199,172885,76325,7664,2989,2914,75,656,6,0.047357584,0,hg38,CD-0722-4
"B8,B10",5383,5993,3906,2087,3231,1622,1,1624,1033,591,1.747884941,936,572,77,38,38,0,15,0,0,0,empty,CD-0722-4
"B8,B11",11872,13358,8445,4913,6919,3837,0,3839,2222,1617,1.37414966,2279,311,35,20,20,0,10,0,0.05,0,empty,CD-0722-4
"B8,B12",6866,7751,5068,2683,3994,1995,1,1998,1297,701,1.85021398,1154,1713,344,135,134,1,38,1,0.111940299,0,empty,CD-0722-4
"B8,C1",1573446,1771659,1153991,617668,858957,485871,3,486328,371811,114517,3.246775588,276911,19093,2716,1009,983,26,233,3,0.018311292,0,hg38,CD-0722-4
"B8,C2",11398,12872,8311,4561,6541,3328,1,3339,2124,1215,1.748148148,1962,2698,714,259,255,4,56,2,0.074509804,0,empty,CD-0722-4
"B8,C3",11711,12865,8665,4200,6750,3319,0,3329,2179,1150,1.894782609,1871,1316,288,121,121,0,25,0,0.066115702,0,empty,CD-0722-4
"B8,C4",7352,8219,5538,2681,4356,2053,0,2053,1318,735,1.793197279,1159,2130,449,167,167,0,52,0,0.19760479,0,empty,CD-0722-4
"B8,C5",10609,11594,7959,3635,6024,2962,0,2963,1963,1000,1.963,1657,1868,306,128,126,2,43,1,0.047619048,0,empty,CD-0722-4
"B8,C6",9001,9818,6596,3222,5244,2663,0,2667,1732,935,1.852406417,1505,1736,556,242,236,6,50,2,0.161016949,0,empty,CD-0722-4
"B8,C7",12103,13833,8509,5324,7087,3900,23,3926,2314,1612,1.435483871,2360,303,28,20,20,0,11,0,0.05,0,empty,CD-0722-4
"B8,C8",14988,16440,11010,5430,8523,4354,10,4365,2826,1539,1.83625731,2423,3611,731,304,297,7,88,2,0.121212121,0,empty,CD-0722-4
"B8,C9",9617,10735,7096,3639,5584,2823,0,2823,1832,991,1.84863774,1652,1918,444,169,167,2,45,2,0.083832335,0,empty,CD-0722-4
"B8,C10",10359,11387,7703,3684,5966,2990,0,2993,1956,1037,1.886210222,1703,1806,384,186,185,1,50,1,0.016216216,0,empty,CD-0722-4
"B8,C11",9289,10339,6865,3474,5372,2657,0,2661,1712,949,1.804004215,1511,1897,407,158,155,3,48,1,0.025806452,0,empty,CD-0722-4
"B8,C12",17176,18227,12686,5541,9260,4576,0,4586,2996,1590,1.88427673,2498,2685,746,273,272,1,64,1,0.073529412,0,empty,CD-0722-4
"B8,D1",13338,15121,9755,5366,7738,4098,0,4106,2506,1600,1.56625,2402,1318,167,71,67,4,26,2,0.089552239,0,empty,CD-0722-4
"B8,D2",9500,10339,7303,3036,5377,2531,2,2536,1575,961,1.638917794,1377,3163,952,356,352,4,86,2,0.036931818,0,empty,CD-0722-4
"B8,D3",8234,9020,6141,2879,4716,2385,0,2388,1620,768,2.109375,1320,1892,388,158,156,2,44,2,0.121794872,0,empty,CD-0722-4
"B8,D4",1311235,1512848,1004114,508734,729163,380994,1,381359,311056,70303,4.424505355,220521,191465,21822,8678,8455,223,1427,9,0.049674749,0,hg38,CD-0722-4
"B8,D5",7055,7961,5147,2814,4061,2044,0,2048,1294,754,1.716180371,1179,1391,293,111,110,1,31,1,0,0,empty,CD-0722-4
"B8,D6",11439,12799,8199,4600,6560,3574,7,3583,2157,1426,1.512622721,2044,2119,499,180,180,0,47,0,0.1,0,empty,CD-0722-4
"B8,D7",6074,6778,4591,2187,3508,1665,0,1667,1108,559,1.982110912,942,2010,425,153,153,0,51,0,0.098039216,0,empty,CD-0722-4
"B8,D8",7593,8527,5613,2914,4588,2311,0,2316,1489,827,1.800483676,1339,1395,295,115,110,5,38,2,0.018181818,0,empty,CD-0722-4
"B8,D9",4160,4656,3140,1516,2484,1173,1,1174,723,451,1.603104213,711,1267,295,114,114,0,34,0,0.105263158,0,empty,CD-0722-4
"B8,D10",7775,8566,5640,2926,4549,2333,0,2334,1492,842,1.771971496,1360,781,198,97,97,0,25,0,0.082474227,0,empty,CD-0722-4
"B8,D11",8830,9795,6603,3192,5045,2384,17,2403,1499,904,1.658185841,1347,2971,1019,393,387,6,76,2,0.093023256,0,empty,CD-0722-4
"B8,D12",10974,12102,8075,4027,6293,3107,0,3108,2034,1074,1.893854749,1765,3770,1024,367,364,3,108,1,0.076923077,0,empty,CD-0722-4
"B8,E1",13463,14428,9893,4535,7482,3692,0,3693,2337,1356,1.723451327,2030,2598,569,223,223,0,80,0,0.049327354,0,empty,CD-0722-4
"B8,E2",9555,10498,6961,3537,5544,2870,1,2872,1752,1120,1.564285714,1650,2438,471,130,127,3,35,2,0.05511811,0,empty,CD-0722-4
"B8,E3",6619,7229,5005,2224,3812,1791,1,1793,1188,605,1.963636364,983,2615,802,296,293,3,75,1,0.081911263,0,empty,CD-0722-4
"B8,E4",9226,10134,6729,3405,5034,2502,1,2505,1617,888,1.820945946,1420,2025,534,245,245,0,76,0,0.06122449,0,empty,CD-0722-4
"B8,E5",8060,8819,6149,2670,4658,2153,5,2162,1384,778,1.778920308,1263,1890,550,199,197,2,45,2,0.091370558,0,empty,CD-0722-4
"B8,E6",14557,16266,10641,5625,8312,4286,0,4289,2766,1523,1.816152331,2477,3979,1118,461,459,2,108,1,0.047930283,0,empty,CD-0722-4
"B8,E7",884021,1002070,664373,337697,485611,251846,2,252101,202862,49239,4.119945572,145388,152770,24732,9443,9279,164,1456,5,0.072529367,0,hg38,CD-0722-4
"B8,E8",12321,13549,9446,4103,6917,3231,0,3239,2158,1081,1.996299722,1784,2936,468,171,168,3,61,2,0.023809524,0,empty,CD-0722-4
"B8,E9",6511,7460,4869,2591,3875,1953,0,1957,1281,676,1.894970414,1178,2565,603,242,237,5,67,2,0.101265823,0,empty,CD-0722-4
"B8,E10",7835,8482,5805,2677,4503,2204,0,2204,1383,821,1.68453106,1272,3735,542,182,179,3,48,1,0.022346369,0,empty,CD-0722-4
"B8,E11",9235,10169,6856,3313,5297,2660,0,2660,1652,1008,1.638888889,1488,2512,631,233,233,0,56,0,0.08583691,0,empty,CD-0722-4
"B8,E12",9480,10489,7062,3427,5469,2785,0,2788,1824,964,1.892116183,1563,2438,601,224,224,0,58,0,0.026785714,0,empty,CD-0722-4
"B8,F1",11522,12262,8492,3770,6521,3079,15,3103,1924,1179,1.631891433,1735,2589,625,249,246,3,65,1,0.130081301,0,empty,CD-0722-4
"B8,F2",9056,9803,6786,3017,5114,2488,1,2491,1579,912,1.731359649,1367,3125,816,347,346,1,81,1,0.12716763,0,empty,CD-0722-4
"B8,F3",8624,9503,6271,3232,5014,2470,4,2479,1595,884,1.804298643,1477,3076,716,311,310,1,75,1,0.229032258,0,empty,CD-0722-4
"B8,F4",1455100,1690127,1050988,639139,826030,481620,19,482081,386653,95428,4.051777256,281766,2147,863,218,217,1,59,1,0,0,hg38,CD-0722-4
"B8,F5",10705,11692,8049,3643,5921,2736,0,2740,1735,1005,1.726368159,1488,2094,440,166,165,1,59,1,0.03030303,0,empty,CD-0722-4
"B8,F6",10460,11473,7620,3853,6079,3080,0,3081,1984,1097,1.808568824,1767,3064,722,300,294,6,94,3,0.078231293,0,empty,CD-0722-4
"B8,F7",12049,13317,8930,4387,7001,3415,1,3423,2176,1247,1.744987971,1969,1327,305,149,149,0,47,0,0.120805369,0,empty,CD-0722-4
"B8,F8",8232,8922,6240,2682,4594,2176,0,2176,1433,743,1.928667564,1169,312,17,8,8,0,5,0,0,0,empty,CD-0722-4
"B8,F9",9666,10594,7393,3201,5528,2647,0,2649,1739,910,1.910989011,1427,3280,671,221,219,2,73,1,0.063926941,0,empty,CD-0722-4
"B8,F10",46561,60719,29357,31362,31259,22229,0,22253,16212,6041,2.683661645,14459,6954,766,270,261,9,77,2,0.172413793,0,empty,CD-0722-4
"B8,F11",8818,9588,6665,2923,4973,2313,5,2320,1521,799,1.903629537,1271,1591,337,144,141,3,33,1,0.063829787,0,empty,CD-0722-4
"B8,F12",10506,11262,7646,3616,5909,2888,21,2915,1937,978,1.980572597,1620,422,181,46,46,0,13,0,0,0,empty,CD-0722-4
"B8,G1",11271,12345,8426,3919,6546,3185,0,3185,2098,1087,1.930082797,1824,2628,501,243,238,5,68,2,0.050420168,0,empty,CD-0722-4
"B8,G2",13673,15528,9329,6199,7962,4768,2,4774,3012,1762,1.709421112,2852,680,171,69,66,3,19,1,0.03030303,0,empty,CD-0722-4
"B8,G3",12325,13193,9166,4027,6782,3340,0,3345,2029,1316,1.541793313,1763,2653,679,265,264,1,66,1,0.068181818,0,empty,CD-0722-4
"B8,G4",22201,24814,15949,8865,12804,7147,0,7151,4341,2810,1.544839858,4117,110,15,11,10,1,7,1,0,0,empty,CD-0722-4
"B8,G5",7262,8079,5433,2646,4148,2014,0,2014,1295,719,1.801112656,1143,1735,572,209,207,2,59,1,0.120772947,0,empty,CD-0722-4
"B8,G6",11146,12456,8503,3953,6295,2974,0,2975,1906,1069,1.782974743,1672,143,23,11,11,0,9,0,0,0,empty,CD-0722-4
"B8,G7",9136,9928,6847,3081,5301,2559,0,2561,1607,954,1.684486373,1420,2732,599,227,227,0,68,0,0.215859031,0,empty,CD-0722-4
"B8,G8",1033891,1195773,770109,425664,579047,309963,0,310252,246159,64093,3.840653425,183525,183559,30914,12077,11869,208,1708,5,0.051899907,0,hg38,CD-0722-4
"B8,G9",11598,12774,8405,4369,6590,3518,5,3527,2407,1120,2.149107143,2056,2925,855,308,305,3,91,2,0.039344262,0,empty,CD-0722-4
"B8,G10",9618,10558,7075,3483,5508,2754,0,2767,1774,993,1.786505539,1570,2572,612,254,253,1,66,1,0.055335968,0,empty,CD-0722-4
"B8,G11",1059377,1227000,786422,440578,595234,328585,2,328870,263206,65664,4.008375975,191469,50970,10784,4078,4006,72,758,3,0.034947579,0,hg38,CD-0722-4
"B8,G12",7760,8608,5699,2909,4430,2250,0,2252,1456,796,1.829145729,1278,2347,587,222,220,2,48,1,0.136363636,0,empty,CD-0722-4
"B8,H1",7982,8317,5918,2399,4467,2098,0,2098,1420,678,2.09439528,1160,1212,279,120,120,0,36,0,0,0,empty,CD-0722-4
"B8,H2",447637,539920,325926,213994,260928,152400,19,152518,131982,20536,6.426860148,92312,106321,13254,5335,5230,105,907,6,0.048565966,0,hg38,CD-0722-4
"B8,H3",2147499,2478438,1591188,887250,1177851,658368,31,659068,537274,121794,4.411333892,390104,290381,41146,16137,15758,379,2271,6,0.064792486,0,hg38,CD-0722-4
"B8,H4",10869,11761,8099,3662,5997,2866,1,2870,1823,1047,1.741165234,1564,183,24,15,15,0,10,0,0,0,empty,CD-0722-4
"B8,H5",1035690,1129640,791104,338536,544589,266804,4,267104,203551,63553,3.202854311,149509,26008,3905,1410,1384,26,356,3,0.025289017,0,hg38,CD-0722-4
"B8,H6",7392,8109,5459,2650,4193,2136,1,2143,1449,694,2.087896254,1198,2089,380,183,181,2,50,1,0.20441989,0,empty,CD-0722-4
"B8,H7",8929,9670,6603,3067,5123,2501,13,2516,1666,850,1.96,1405,2168,514,232,229,3,48,1,0.135371179,0,empty,CD-0722-4
"B8,H8",9946,10868,7368,3500,5593,2798,0,2798,1765,1033,1.708615682,1575,2766,577,211,207,4,69,2,0.130434783,0,empty,CD-0722-4
"B8,H9",7920,8450,6166,2284,4338,1903,32,1938,1329,609,2.18226601,1045,1272,345,132,131,1,46,1,0.061068702,0,empty,CD-0722-4
"B8,H10",13302,15034,9976,5058,7592,3820,2,3829,2760,1069,2.581852198,2220,2662,471,224,217,7,52,2,0.069124424,0,empty,CD-0722-4
"B8,H11",8501,9916,5901,4015,5089,3081,0,3081,1694,1387,1.221341024,1841,33,0,0,0,0,0,0,0,0,empty,CD-0722-4
"B8,H12",6903,7804,4952,2852,3906,1972,0,1973,1259,714,1.763305322,1150,1334,296,112,108,4,34,1,0.324074074,0,empty,CD-0722-4
"B9,A1",7079,7868,5191,2677,4152,2190,0,2190,1446,744,1.943548387,1241,1085,208,95,94,1,26,1,0.159574468,0,empty,CD-0722-4
"B9,A2",11254,12156,8434,3722,6410,3150,28,3181,2034,1147,1.773321709,1731,2042,317,128,126,2,36,1,0.03968254,0,empty,CD-0722-4
"B9,A3",6970,7545,5113,2432,3884,1934,0,1936,1214,722,1.681440443,1099,997,144,72,67,5,26,2,0.089552239,0,empty,CD-0722-4
"B9,A4",11920,13280,8954,4326,6789,3297,32,3333,2122,1211,1.752270851,1849,516,100,53,53,0,20,0,0.20754717,0,empty,CD-0722-4
"B9,A5",10182,10925,7619,3306,5783,2764,0,2767,1830,937,1.953041622,1495,2067,428,158,156,2,51,1,0.083333333,0,empty,CD-0722-4
"B9,A6",18578,20553,14030,6523,10712,5414,0,5416,3779,1637,2.308491142,3134,2805,715,275,274,1,80,1,0.058394161,0,empty,CD-0722-4
"B9,A7",7335,8015,5368,2647,4167,2144,0,2146,1394,752,1.853723404,1216,913,141,68,67,1,25,1,0,0,empty,CD-0722-4
"B9,A8",4496,4822,3349,1473,2604,1272,0,1274,857,417,2.055155875,721,1609,333,145,143,2,43,1,0.062937063,0,empty,CD-0722-4
"B9,A9",7949,8864,5941,2923,4539,2214,0,2220,1510,710,2.126760563,1255,1377,317,130,126,4,39,2,0.007936508,0,empty,CD-0722-4
"B9,A10",8883,9680,6759,2921,4973,2362,22,2385,1525,860,1.773255814,1303,476,133,48,48,0,17,0,0.1875,0,empty,CD-0722-4
"B9,A11",6780,7353,5110,2243,3811,1774,8,1782,1160,622,1.864951768,962,1503,457,182,181,1,43,1,0.082872928,0,empty,CD-0722-4
"B9,A12",9453,10321,7163,3158,5405,2571,1,2574,1714,860,1.993023256,1458,3769,810,318,311,7,85,2,0.073954984,0,empty,CD-0722-4
"B9,B1",8366,9487,6161,3326,4818,2500,0,2504,1553,951,1.633017876,1443,1023,293,98,97,1,23,1,0.216494845,0,empty,CD-0722-4
"B9,B2",8668,9424,5901,3523,4929,2656,0,2656,1640,1016,1.614173228,1569,557,58,26,26,0,12,0,0.153846154,0,empty,CD-0722-4
"B9,B3",6755,7324,5066,2258,3860,1894,0,1896,1303,593,2.197301855,1030,1376,388,154,154,0,43,0,0.012987013,0,empty,CD-0722-4
"B9,B4",936742,1119632,682391,437241,548373,314638,0,314866,261280,53586,4.875900422,189985,106679,21217,8377,8287,90,1336,8,0.050923133,0,hg38,CD-0722-4
"B9,B5",7887,4672,2899,1773,3056,1608,0,1615,1054,561,1.878787879,1031,923,140,66,63,3,22,2,0.015873016,0,empty,CD-0722-4
"B9,B6",9184,10670,6570,4100,5440,2934,0,2940,1773,1167,1.519280206,1789,1738,464,179,178,1,44,1,0.050561798,0,empty,CD-0722-4
"B9,B7",8389,9310,6380,2930,4800,2305,1,2311,1509,802,1.881546135,1259,1380,285,105,105,0,35,0,0.028571429,0,empty,CD-0722-4
"B9,B8",424145,505325,302209,203116,254111,157358,1,157454,99596,57858,1.721386844,95054,3873,584,197,193,4,62,2,0.067357513,0,hg38,CD-0722-4
"B9,B9",11115,12476,8204,4272,6504,3384,0,3385,2049,1336,1.533682635,1957,1253,283,108,107,1,30,1,0,0,empty,CD-0722-4
"B9,B10",5562,6309,4045,2264,3395,1694,25,1722,1116,606,1.841584158,1008,533,112,34,34,0,9,0,0,0,empty,CD-0722-4
"B9,B11",12326,14343,8872,5471,7280,4036,0,4038,2269,1769,1.282645562,2476,238,58,14,13,1,2,1,0,0,empty,CD-0722-4
"B9,B12",7874,8704,5724,2980,4501,2221,23,2245,1465,780,1.878205128,1302,2106,504,239,238,1,47,1,0.176470588,0,empty,CD-0722-4
"B9,C1",20370,21642,15622,6020,10934,4799,32,4835,3060,1775,1.723943662,2626,1117,191,83,80,3,27,2,0.0375,0,empty,CD-0722-4
"B9,C2",12008,13148,8936,4212,6847,3430,0,3439,2150,1289,1.667959659,1941,2269,532,211,210,1,56,1,0.061904762,0,empty,CD-0722-4
"B9,C3",11888,12933,8944,3989,6793,3304,0,3307,2109,1198,1.760434057,1849,702,106,51,49,2,16,2,0.183673469,0,empty,CD-0722-4
"B9,C4",7833,8614,5859,2755,4472,2144,0,2147,1336,811,1.647348952,1210,1678,393,123,121,2,38,1,0.074380165,0,empty,CD-0722-4
"B9,C5",10612,11864,7835,4029,6102,3090,0,3093,2063,1030,2.002912621,1796,1394,197,87,87,0,30,0,0.126436782,0,empty,CD-0722-4
"B9,C6",682313,821300,479697,341603,419739,267468,2,267656,167133,100523,1.662634422,163478,1671,326,154,154,0,52,0,0.103896104,0,hg38,CD-0722-4
"B9,C7",12397,13813,8888,4925,7159,3895,1,3901,2382,1519,1.568136932,2274,362,118,53,53,0,13,0,0.018867925,0,empty,CD-0722-4
"B9,C8",13714,15027,10224,4803,7560,3820,0,3827,2507,1320,1.899242424,2077,2601,604,213,213,0,61,0,0.037558685,0,empty,CD-0722-4
"B9,C9",9467,10466,6874,3592,5546,2768,0,2778,1757,1021,1.7208619,1633,1543,320,144,139,5,39,1,0.100719424,0,empty,CD-0722-4
"B9,C10",10641,11522,7805,3717,5921,2894,4,2901,1875,1026,1.82748538,1665,1881,439,167,163,4,49,1,0.049079755,0,empty,CD-0722-4
"B9,C11",9654,10695,6991,3704,5595,2763,0,2772,1735,1037,1.673095468,1640,1947,325,139,138,1,55,1,0.028985507,0,empty,CD-0722-4
"B9,C12",13747,14979,10075,4904,7808,3901,0,3907,2556,1351,1.891931902,2263,2221,586,228,227,1,59,1,0.074889868,0,empty,CD-0722-4
"B9,D1",11831,13067,8541,4526,6787,3560,14,3576,2130,1446,1.473029046,2058,563,116,53,53,0,20,0,0.037735849,0,empty,CD-0722-4
"B9,D2",10027,11118,7574,3544,5766,2762,0,2767,1686,1081,1.559666975,1548,2470,619,264,259,5,74,3,0.023166023,0,empty,CD-0722-4
"B9,D3",8733,9483,6488,2995,4911,2441,3,2444,1588,856,1.855140187,1355,1412,380,150,146,4,35,2,0.034246575,0,empty,CD-0722-4
"B9,D4",6808,7301,5210,2091,3913,1885,15,1901,1222,679,1.799705449,1011,1330,334,138,138,0,42,0,0.144927536,0,empty,CD-0722-4
"B9,D5",7607,8315,5641,2674,4424,2115,0,2115,1375,740,1.858108108,1200,1237,313,129,129,0,32,0,0.054263566,0,empty,CD-0722-4
"B9,D6",12148,13362,8680,4682,7033,3823,0,3826,2316,1510,1.533774834,2195,1868,333,133,133,0,36,0,0.135338346,0,empty,CD-0722-4
"B9,D7",6438,6805,4903,1902,3592,1683,3,1686,1107,579,1.911917098,888,2441,605,255,254,1,59,1,0.102362205,0,empty,CD-0722-4
"B9,D8",8589,9415,6333,3082,4965,2491,0,2494,1600,894,1.789709172,1386,1135,297,139,139,0,35,0,0.071942446,0,empty,CD-0722-4
"B9,D9",640812,739370,472707,266663,362451,196559,10,196732,164709,32023,5.143459389,115476,75820,7909,3144,3078,66,665,3,0.050682261,0,hg38,CD-0722-4
"B9,D10",7962,8941,5885,3056,4635,2368,12,2384,1500,884,1.696832579,1404,564,104,37,37,0,12,0,0.216216216,0,empty,CD-0722-4
"B9,D11",8677,9432,6434,2998,4945,2436,0,2438,1531,907,1.687982359,1367,2462,634,236,234,2,61,1,0.047008547,0,empty,CD-0722-4
"B9,D12",11326,12403,8543,3860,6403,3081,1,3090,1991,1099,1.811646952,1761,3460,1035,411,411,0,89,0,0.0486618,0,empty,CD-0722-4
"B9,E1",14640,16100,10902,5198,8191,4096,2,4105,2659,1446,1.838865837,2238,2202,589,269,266,3,65,1,0.045112782,0,empty,CD-0722-4
"B9,E2",9981,11099,7295,3804,5757,2914,0,2921,1836,1085,1.692165899,1743,2023,411,128,128,0,34,0,0.0546875,0,empty,CD-0722-4
"B9,E3",6701,7483,5024,2459,3958,1895,0,1898,1230,668,1.841317365,1072,1689,431,201,201,0,50,0,0.114427861,0,empty,CD-0722-4
"B9,E4",9938,11240,7265,3975,5741,2906,0,2912,1915,997,1.920762287,1717,2167,496,214,212,2,57,2,0.160377358,0,empty,CD-0722-4
"B9,E5",8428,9155,6395,2760,4800,2287,1,2291,1462,829,1.763570567,1312,1151,318,120,120,0,32,0,0.066666667,0,empty,CD-0722-4
"B9,E6",14736,16385,11063,5322,8376,4189,0,4196,2695,1501,1.795469687,2385,3034,815,285,282,3,75,2,0.184397163,0,empty,CD-0722-4
"B9,E7",736885,806441,564578,241863,391796,189258,2,189469,146738,42731,3.433994056,105279,38653,7008,2622,2571,51,500,4,0.022948269,0,hg38,CD-0722-4
"B9,E8",11081,11993,8454,3539,6267,2907,0,2916,1966,950,2.069473684,1598,2717,455,201,197,4,72,3,0.015228426,0,empty,CD-0722-4
"B9,E9",6657,7394,5043,2351,3872,1871,0,1873,1215,658,1.846504559,1056,2266,657,221,220,1,55,1,0.077272727,0,empty,CD-0722-4
"B9,E10",7942,8547,5984,2563,4572,2166,0,2168,1396,772,1.808290155,1201,1651,370,157,157,0,50,0,0.070063694,0,empty,CD-0722-4
"B9,E11",9548,10571,7031,3540,5517,2848,0,2849,1815,1034,1.755319149,1645,1745,287,115,114,1,33,1,0.122807018,0,empty,CD-0722-4
"B9,E12",10930,12327,7867,4460,6416,3336,1,3341,2270,1071,2.119514472,2000,1978,423,170,164,6,42,2,0.237804878,0,empty,CD-0722-4
"B9,F1",11791,12651,8739,3912,6474,3065,0,3071,2023,1048,1.930343511,1663,2298,378,153,152,1,42,1,0.052631579,0,empty,CD-0722-4
"B9,F2",9382,10446,6846,3600,5442,2690,32,2729,1770,959,1.845672576,1594,2373,503,198,197,1,53,1,0.086294416,0,empty,CD-0722-4
"B9,F3",9020,9818,6652,3166,5165,2529,0,2531,1638,893,1.834266517,1438,2821,693,276,276,0,68,0,0.097826087,0,empty,CD-0722-4
"B9,F4",13622,14596,10338,4258,7720,3694,3,3702,2397,1305,1.836781609,1992,712,185,68,68,0,24,0,0.161764706,0,empty,CD-0722-4
"B9,F5",10866,11404,8166,3238,5932,2680,0,2680,1792,888,2.018018018,1418,2403,536,235,231,4,52,2,0.108225108,0,empty,CD-0722-4
"B9,F6",1841382,2120386,1369595,750791,1018029,553430,6,553893,427422,126471,3.379604811,326642,291742,44174,17389,17026,363,2178,7,0.034711618,0,hg38,CD-0722-4
"B9,F7",12615,13852,9482,4370,7314,3598,0,3600,2352,1248,1.884615385,2015,1212,195,83,81,2,31,1,0.061728395,0,empty,CD-0722-4
"B9,F8",9169,9782,6865,2917,5047,2393,1,2399,1589,810,1.961728395,1269,241,39,17,17,0,8,0,0,0,empty,CD-0722-4
"B9,F9",9562,10600,7136,3464,5455,2626,0,2633,1775,858,2.068764569,1482,2839,743,248,245,3,66,2,0.134693878,0,empty,CD-0722-4
"B9,F10",12445,13595,9391,4204,6933,3229,21,3258,2150,1108,1.940433213,1750,1595,384,159,158,1,50,1,0.113924051,0,empty,CD-0722-4
"B9,F11",9458,10177,7277,2900,5150,2345,0,2348,1558,790,1.972151899,1261,1640,386,154,154,0,31,0,0.155844156,0,empty,CD-0722-4
"B9,F12",10676,11591,7955,3636,5827,2773,0,2777,1803,974,1.851129363,1528,193,50,14,13,1,4,1,0,0,empty,CD-0722-4
"B9,G1",1072042,1227086,797491,429595,600856,328128,3,328425,256137,72288,3.543285193,191715,53432,5014,1893,1830,63,437,3,0.032786885,0,hg38,CD-0722-4
"B9,G2",936792,1042635,687874,354761,511890,263775,6,264032,202348,61684,3.280396861,154088,39205,7535,3041,2994,47,553,6,0.04742819,0,hg38,CD-0722-4
"B9,G3",12618,13594,9361,4233,7087,3538,0,3541,2126,1415,1.502473498,1986,2361,731,249,249,0,57,0,0.016064257,0,empty,CD-0722-4
"B9,G4",22297,24633,16122,8511,12715,6931,21,6954,4216,2738,1.53981008,3974,70,29,14,14,0,5,0,0.214285714,0,empty,CD-0722-4
"B9,G5",7504,8258,5614,2644,4294,2111,0,2111,1333,778,1.713367609,1194,1451,262,98,97,1,29,1,0.020618557,0,empty,CD-0722-4
"B9,G6",1193197,1319099,922374,396725,633439,306447,1,306755,237997,68758,3.461371768,171828,18445,2570,938,917,21,205,2,0.046892039,0,hg38,CD-0722-4
"B9,G7",9039,9797,6942,2855,5158,2433,2,2440,1515,925,1.637837838,1317,2488,765,283,276,7,63,2,0.09057971,0,empty,CD-0722-4
"B9,G8",6441,7013,4792,2221,3657,1785,1,1789,1190,599,1.986644407,1003,1770,358,136,135,1,51,1,0.02962963,0,empty,CD-0722-4
"B9,G9",1387969,1649551,983448,666103,806012,493180,3,493581,358801,134780,2.66212346,300091,166863,26332,10301,10128,173,1572,8,0.066449447,0,hg38,CD-0722-4
"B9,G10",9910,10524,7474,3050,5563,2743,0,2748,1821,927,1.964401294,1472,2049,443,171,163,8,44,2,0.042944785,0,empty,CD-0722-4
"B9,G11",9760,10773,7335,3438,5614,2658,13,2675,1759,916,1.920305677,1495,1240,364,135,134,1,26,1,0.268656716,0,empty,CD-0722-4
"B9,G12",7701,8393,5701,2692,4490,2232,0,2237,1379,858,1.607226107,1286,2042,421,166,166,0,35,0,0.186746988,0,empty,CD-0722-4
"B9,H1",8541,9115,6321,2794,4817,2323,17,2341,1527,814,1.875921376,1292,1014,252,106,106,0,28,0,0.103773585,0,empty,CD-0722-4
"B9,H2",9206,10184,6733,3451,5435,2672,0,2673,1677,996,1.68373494,1571,2278,521,224,218,6,65,2,0.133027523,0,empty,CD-0722-4
"B9,H3",7593,8641,5520,3121,4457,2298,1,2302,1533,769,1.993498049,1336,1735,316,79,78,1,27,1,0.166666667,0,empty,CD-0722-4
"B9,H4",11470,12560,8570,3990,6485,3109,0,3112,2042,1070,1.908411215,1777,111,28,15,15,0,9,0,0.066666667,0,empty,CD-0722-4
"B9,H5",12320,13565,9118,4447,6964,3455,1,3458,2193,1265,1.733596838,1942,1592,330,159,158,1,39,1,0.075949367,0,empty,CD-0722-4
"B9,H6",7247,8008,5282,2726,4170,2140,0,2141,1410,731,1.928864569,1264,2278,492,249,247,2,61,1,0.04048583,0,empty,CD-0722-4
"B9,H7",8471,9227,6296,2931,4846,2357,0,2357,1503,854,1.759953162,1335,1998,430,186,185,1,43,1,0.010810811,0,empty,CD-0722-4
"B9,H8",10864,12102,8014,4088,6338,3350,0,3352,2243,1109,2.022542831,1884,2271,406,166,164,2,64,1,0.030487805,0,empty,CD-0722-4
"B9,H9",7547,8028,5742,2286,4227,1924,0,1929,1284,645,1.990697674,1056,1107,250,85,85,0,30,0,0.047058824,0,empty,CD-0722-4
"B9,H10",984970,1143225,728223,415002,552402,303795,0,304108,243226,60882,3.995039585,179341,105246,15446,6097,6006,91,1056,7,0.049284049,0,hg38,CD-0722-4
"B9,H11",9543,11216,6504,4712,5768,3537,0,3541,1809,1732,1.044457275,2151,58,24,13,12,1,3,1,0,0,empty,CD-0722-4
"B9,H12",7325,8005,5373,2632,4263,2150,1,2157,1422,735,1.934693878,1244,1335,157,60,57,3,19,1,0.140350877,0,empty,CD-0722-4
"B10,A1",7330,7966,5347,2619,4200,2129,0,2132,1382,750,1.842666667,1189,1189,118,65,64,1,30,1,0.046875,0,empty,CD-0722-4
"B10,A2",2021927,2403595,1454288,949307,1156284,714973,11,715560,545994,169566,3.219949754,423589,108152,21238,8704,8621,83,1384,6,0.068437536,0,hg38,CD-0722-4
"B10,A3",6820,7411,4922,2489,3919,2001,0,2001,1292,709,1.822284908,1168,2188,440,170,168,2,50,1,0.017857143,0,empty,CD-0722-4
"B10,A4",11882,12994,8946,4048,6738,3294,14,3309,2116,1193,1.773679799,1801,1149,203,81,80,1,30,1,0.0625,0,empty,CD-0722-4
"B10,A5",753342,843759,565909,277850,417205,223580,1,223829,172439,51390,3.355497178,126233,51851,13446,4804,4761,43,864,7,0.014072674,0,hg38,CD-0722-4
"B10,A6",10210,11365,7655,3710,5888,2926,0,2926,1976,950,2.08,1687,3059,725,305,301,4,108,2,0.023255814,0,empty,CD-0722-4
"B10,A7",7174,7835,5364,2471,4039,2049,0,2050,1336,714,1.871148459,1126,1769,349,145,145,0,36,0,0.034482759,0,empty,CD-0722-4
"B10,A8",4271,4775,3289,1486,2662,1328,0,1332,881,451,1.953436807,758,2552,591,233,232,1,72,1,0.021551724,0,empty,CD-0722-4
"B10,A9",9233,10253,6970,3283,5247,2544,0,2544,1754,790,2.220253165,1420,2442,606,264,263,1,71,1,0.11026616,0,empty,CD-0722-4
"B10,A10",620898,729984,461717,268267,360826,197862,17,198039,150718,47321,3.185012996,117394,27951,5734,2164,2144,20,444,3,0.05363806,0,hg38,CD-0722-4
"B10,A11",6463,6637,4811,1826,3594,1668,1,1671,1095,576,1.901041667,887,2349,511,207,201,6,59,2,0.014925373,0,empty,CD-0722-4
"B10,A12",8926,9689,6751,2938,4957,2351,1,2357,1506,851,1.769682726,1258,4176,1201,462,458,4,111,2,0.072052402,0,empty,CD-0722-4
"B10,B1",7776,8340,5681,2659,4348,2153,21,2175,1327,848,1.564858491,1239,1336,292,125,122,3,43,2,0.081967213,0,empty,CD-0722-4
"B10,B2",8968,9740,6230,3510,5040,2714,18,2732,1687,1045,1.614354067,1571,734,198,52,51,1,18,1,0.137254902,0,empty,CD-0722-4
"B10,B3",6656,7210,4828,2382,3834,1889,0,1889,1290,599,2.153589316,1070,1677,352,173,172,1,52,1,0.087209302,0,empty,CD-0722-4
"B10,B4",7502,8498,5319,3179,4388,2314,12,2328,1478,850,1.738823529,1362,2086,547,231,223,8,58,2,0.089686099,0,empty,CD-0722-4
"B10,B5",11024,8024,5274,2750,4857,2561,0,2575,1825,750,2.433333333,1536,1435,273,109,108,1,46,1,0.027777778,0,empty,CD-0722-4
"B10,B6",8545,9737,6140,3597,4924,2593,0,2599,1652,947,1.744456177,1545,2080,535,243,242,1,73,1,0.161157025,0,empty,CD-0722-4
"B10,B7",1299369,1480821,976315,504506,720228,379651,5,380067,295311,84756,3.484248903,218938,89089,14919,5782,5693,89,951,3,0.0346039,0,hg38,CD-0722-4
"B10,B8",661039,758725,497662,261063,373825,198225,7,198407,166910,31497,5.299234848,114789,72024,13117,5320,5242,78,945,4,0.05322396,0,hg38,CD-0722-4
"B10,B9",10912,11995,7997,3998,6241,3264,10,3276,2044,1232,1.659090909,1907,1744,489,187,184,3,53,2,0.059782609,0,empty,CD-0722-4
"B10,B10",748606,804442,535685,268757,415536,210939,8,211490,166104,45386,3.659806989,123179,84741,10160,4211,4108,103,775,5,0.080331061,0,hg38,CD-0722-4
"B10,B11",11889,13060,8703,4357,6585,3441,0,3444,1895,1549,1.223369916,1979,301,34,20,20,0,15,0,0,0,empty,CD-0722-4
"B10,B12",6802,7563,4996,2567,4006,2006,1,2007,1315,692,1.900289017,1157,2213,654,253,251,2,68,1,0.003984064,0,empty,CD-0722-4
"B10,C1",17297,18321,12980,5341,9495,4475,0,4476,3054,1422,2.147679325,2399,1585,389,165,165,0,46,0,0.03030303,0,empty,CD-0722-4
"B10,C2",12184,13273,8933,4340,6760,3390,0,3392,2127,1265,1.681422925,1970,3341,969,364,362,2,84,1,0.074585635,0,empty,CD-0722-4
"B10,C3",1031642,1189639,787968,401671,582659,300882,22,301154,227468,73686,3.086990745,175291,5005,687,218,209,9,73,2,0.038277512,0,hg38,CD-0722-4
"B10,C4",7433,7921,5530,2391,4221,2007,0,2008,1325,683,1.939970717,1124,2037,462,195,191,4,64,2,0.094240838,0,empty,CD-0722-4
"B10,C5",12040,13627,8901,4726,6934,3474,0,3478,2324,1154,2.013864818,1985,2171,511,199,199,0,66,0,0.040201005,0,empty,CD-0722-4
"B10,C6",8827,9808,6360,3448,5218,2663,0,2665,1725,940,1.835106383,1581,2182,568,241,239,2,67,1,0.066945607,0,empty,CD-0722-4
"B10,C7",12698,14746,9085,5661,7660,4274,0,4277,2562,1715,1.493877551,2581,462,68,37,37,0,16,0,0.405405405,0,empty,CD-0722-4
"B10,C8",13184,14584,9727,4857,7500,3803,0,3805,2376,1429,1.66270119,2156,3961,942,377,371,6,104,2,0.094339623,0,empty,CD-0722-4
"B10,C9",11459,12914,8630,4284,6559,3277,10,3291,2184,1107,1.972899729,1867,2732,508,195,191,4,54,2,0.02617801,0,empty,CD-0722-4
"B10,C10",10952,11725,8223,3502,6150,2992,0,2993,2001,992,2.017137097,1643,2596,555,239,238,1,55,1,0.12605042,0,empty,CD-0722-4
"B10,C11",9151,10266,6775,3491,5369,2636,0,2645,1726,919,1.8781284,1519,2363,676,226,226,0,68,0,0.066371681,0,empty,CD-0722-4
"B10,C12",2660975,2980540,2007693,972847,1426112,756068,12,756798,607807,148991,4.079488023,434826,260632,39001,14951,14625,326,2164,11,0.042666667,0,hg38,CD-0722-4
"B10,D1",11031,12185,7871,4314,6402,3430,0,3435,2152,1283,1.677318784,1970,1063,243,112,109,3,23,1,0.055045872,0,empty,CD-0722-4
"B10,D2",10051,10640,7525,3115,5730,2639,14,2660,1733,927,1.869471413,1475,3351,748,292,290,2,89,2,0.044827586,0,empty,CD-0722-4
"B10,D3",1716205,1964348,1290117,674231,948425,508130,1,508580,400037,108543,3.685516339,297306,220596,35722,13940,13665,275,1931,9,0.038053421,0,hg38,CD-0722-4
"B10,D4",6180,7044,4556,2488,3804,1951,1,1955,1222,733,1.667121419,1161,2031,483,219,217,2,74,2,0.023041475,0,empty,CD-0722-4
"B10,D5",7595,8332,5716,2616,4295,2088,0,2088,1345,743,1.810228802,1152,1930,569,237,236,1,62,1,0.144067797,0,empty,CD-0722-4
"B10,D6",11642,12806,8334,4472,6573,3544,1,3546,2159,1387,1.556596972,2021,1988,492,211,210,1,60,1,0.023809524,0,empty,CD-0722-4
"B10,D7",6557,7030,4970,2060,3659,1707,0,1707,1077,630,1.70952381,941,3173,703,290,287,3,61,1,0.034843206,0,empty,CD-0722-4
"B10,D8",18465,20408,14266,6142,10137,4811,0,4815,3516,1299,2.70669746,2639,3408,752,279,277,2,72,1,0,0,empty,CD-0722-4
"B10,D9",4318,4585,3213,1372,2472,1159,0,1163,775,388,1.99742268,650,2116,626,209,209,0,52,0,0.129186603,0,empty,CD-0722-4
"B10,D10",7909,8835,5789,3046,4540,2344,0,2344,1479,865,1.70982659,1368,1327,404,122,121,1,26,1,0.272727273,0,empty,CD-0722-4
"B10,D11",8501,9345,6268,3077,4981,2453,1,2454,1601,853,1.876905041,1417,3336,1147,442,441,1,104,1,0.056689342,0,empty,CD-0722-4
"B10,D12",1142605,1355247,834631,520616,656912,375699,1,376005,302609,73396,4.122963104,224853,419698,76863,30717,30283,434,3438,6,0.036852359,0,hg38,CD-0722-4
"B10,E1",13615,14721,10035,4686,7651,3862,4,3873,2388,1485,1.608080808,2128,3960,755,354,345,9,106,2,0.086956522,0,empty,CD-0722-4
"B10,E2",998517,1160085,738982,421103,569136,312675,3,312974,251212,61762,4.067420096,184814,197971,21572,8897,8639,258,1314,10,0.064590809,0,hg38,CD-0722-4
"B10,E3",6650,7414,5047,2367,3769,1794,0,1794,1172,622,1.884244373,987,2688,797,293,292,1,80,1,0.047945205,0,empty,CD-0722-4
"B10,E4",2114948,2498871,1518909,979962,1204262,736223,10,736854,548590,188264,2.913939999,441264,104440,11016,4021,3891,130,914,9,0.027242354,0,hg38,CD-0722-4
"B10,E5",8408,9017,6454,2563,4648,2117,0,2118,1362,756,1.801587302,1181,1833,601,228,226,2,53,2,0.039823009,0,empty,CD-0722-4
"B10,E6",14357,15926,10722,5204,8106,4070,3,4079,2653,1426,1.860448808,2348,4388,1015,436,436,0,124,0,0.064220183,0,empty,CD-0722-4
"B10,E7",13576,14779,10138,4641,7689,3712,1,3719,2377,1342,1.77123696,2085,4759,1103,511,505,6,115,2,0.043564356,0,empty,CD-0722-4
"B10,E8",10849,11638,8338,3300,6034,2850,0,2850,1910,940,2.031914894,1486,3181,855,332,326,6,97,2,0.098159509,0,empty,CD-0722-4
"B10,E9",6224,6784,4664,2120,3621,1802,0,1802,1223,579,2.112262522,993,3217,843,349,348,1,84,1,0.045977011,0,empty,CD-0722-4
"B10,E10",7840,8439,5774,2665,4404,2084,0,2089,1319,770,1.712987013,1164,2423,800,296,291,5,62,1,0.048109966,0,empty,CD-0722-4
"B10,E11",9559,10402,7076,3326,5439,2713,26,2743,1756,987,1.779128673,1513,2760,517,187,182,5,61,2,0.06043956,0,empty,CD-0722-4
"B10,E12",924377,1106983,662170,444813,547208,319605,2,319844,258127,61717,4.182429476,196925,97308,15386,5984,5877,107,1080,5,0.026884465,0,hg38,CD-0722-4
"B10,F1",2019101,2269940,1516181,753759,1077841,571304,4,571869,452881,118988,3.806106498,329354,233152,40008,15827,15544,283,2150,11,0.054426145,0,hg38,CD-0722-4
"B10,F2",10175,10873,7544,3329,5760,2765,24,2793,1856,937,1.980789755,1573,4318,765,371,367,4,96,1,0.073569482,0,empty,CD-0722-4
"B10,F3",9160,10162,6841,3321,5328,2605,0,2612,1622,990,1.638383838,1535,3533,806,346,343,3,96,1,0.049562682,0,empty,CD-0722-4
"B10,F4",1203581,1342539,910033,432506,651992,331100,7,331440,254816,76624,3.325537691,189333,61165,5722,2195,2129,66,468,4,0.072804133,0,hg38,CD-0722-4
"B10,F5",10990,11807,8131,3676,6059,2822,0,2824,1856,968,1.917355372,1604,2456,640,280,275,5,76,2,0.076363636,0,empty,CD-0722-4
"B10,F6",10767,12100,7878,4222,6331,3342,1,3344,2116,1228,1.723127036,1964,3835,905,420,419,1,123,1,0.045346062,0,empty,CD-0722-4
"B10,F7",12139,13158,9000,4158,7035,3512,0,3518,2312,1206,1.91708126,1967,1556,358,146,144,2,49,2,0.013888889,0,empty,CD-0722-4
"B10,F8",10788,12125,7980,4145,6385,3276,0,3276,2182,1094,1.994515539,1931,518,147,35,35,0,19,0,0,0,empty,CD-0722-4
"B10,F9",1685229,2035969,1172665,863304,998470,656444,18,656985,460077,196908,2.336507404,395472,28690,2628,865,824,41,196,3,0.171116505,0,hg38,CD-0722-4
"B10,F10",12194,12887,9212,3675,6850,3171,15,3191,2098,1093,1.919487649,1726,2820,708,316,306,10,65,2,0.091503268,0,empty,CD-0722-4
"B10,F11",1271546,1430776,984207,446569,685899,344736,5,345102,280916,64186,4.376593027,193156,209494,19561,8153,7870,283,1337,8,0.057687421,0,hg38,CD-0722-4
"B10,F12",10494,11344,7755,3589,5766,2764,0,2766,1816,950,1.911578947,1538,345,74,41,41,0,18,0,0,0,empty,CD-0722-4
"B10,G1",14573,16653,10514,6139,8651,4745,10,4757,3371,1386,2.432178932,2793,4122,881,369,358,11,98,3,0.162011173,0,empty,CD-0722-4
"B10,G2",6718,7411,4729,2682,3857,1996,13,2016,1290,726,1.776859504,1201,625,130,56,55,1,18,1,0.272727273,0,empty,CD-0722-4
"B10,G3",12600,13755,9190,4565,7138,3594,11,3606,2195,1411,1.555634302,2061,3854,1240,459,453,6,98,2,0.112582781,0,empty,CD-0722-4
"B10,G4",21612,24288,15526,8762,12454,6942,1,6945,4224,2721,1.552370452,3989,79,15,13,12,1,9,1,0,0,empty,CD-0722-4
"B10,G5",952557,1115209,710563,404646,540726,290950,1,291203,220945,70258,3.144766432,174512,173782,22516,9086,8892,194,1468,9,0.060728745,0,hg38,CD-0722-4
"B10,G6",10931,12124,8237,3887,6267,3088,3,3101,2123,978,2.170756646,1764,227,58,35,34,1,8,1,0.294117647,0,empty,CD-0722-4
"B10,G7",9037,9769,6986,2783,5069,2285,0,2290,1513,777,1.947232947,1238,3624,748,315,312,3,102,1,0.038461538,0,empty,CD-0722-4
"B10,G8",6759,7307,4987,2320,3737,1779,0,1785,1157,628,1.842356688,1022,2787,819,322,321,1,81,1,0.087227414,0,empty,CD-0722-4
"B10,G9",22673,25695,15921,9774,12966,7484,16,7503,4683,2820,1.660638298,4416,3606,689,268,263,5,101,2,0.053231939,0,empty,CD-0722-4
"B10,G10",12813,14227,9655,4572,7209,3475,0,3480,2357,1123,2.098842386,1939,4329,1054,403,403,0,105,0,0.034739454,0,empty,CD-0722-4
"B10,G11",9356,10241,6980,3261,5422,2582,1,2583,1759,824,2.134708738,1469,1766,382,182,180,2,57,2,0.061111111,0,empty,CD-0722-4
"B10,G12",7538,8513,5534,2979,4423,2254,1,2256,1435,821,1.747868453,1329,2428,558,199,197,2,60,1,0.030456853,0,empty,CD-0722-4
"B10,H1",7923,8351,5858,2493,4501,2145,0,2146,1439,707,2.035360679,1143,1420,250,132,131,1,49,1,0.045801527,0,empty,CD-0722-4
"B10,H2",9388,10252,6859,3393,5261,2588,0,2590,1713,877,1.953249715,1480,2853,942,344,342,2,85,2,0.032163743,0,empty,CD-0722-4
"B10,H3",7532,8599,5494,3105,4416,2235,0,2235,1371,864,1.586805556,1349,1972,439,173,170,3,53,2,0.158823529,0,empty,CD-0722-4
"B10,H4",11534,12647,8466,4181,6486,3199,0,3203,2055,1148,1.790069686,1850,196,31,17,17,0,11,0,0,0,empty,CD-0722-4
"B10,H5",12161,13314,8897,4417,6750,3409,1,3414,2172,1242,1.748792271,1955,2585,543,222,221,1,66,1,0.113122172,0,empty,CD-0722-4
"B10,H6",7642,8402,5491,2911,4292,2220,0,2221,1453,768,1.891927083,1297,2270,405,181,177,4,57,2,0.06779661,0,empty,CD-0722-4
"B10,H7",1003174,1128187,757961,370226,553048,285033,6,285305,216062,69243,3.120344295,163840,153013,20501,8037,7874,163,1231,6,0.048895098,0,hg38,CD-0722-4
"B10,H8",9943,11182,7330,3852,5703,2946,1,2948,1904,1044,1.823754789,1687,2902,598,308,302,6,107,2,0.069536424,0,empty,CD-0722-4
"B10,H9",7382,8077,5539,2538,4140,1956,1,1964,1321,643,2.054432348,1080,1727,503,203,195,8,49,2,0,0,empty,CD-0722-4
"B10,H10",6386,6834,4797,2037,3495,1661,0,1663,1032,631,1.635499208,909,1554,245,120,117,3,40,2,0.11965812,0,empty,CD-0722-4
"B10,H11",9001,10163,6351,3812,5257,3146,0,3146,1735,1411,1.22962438,1790,46,1,1,1,0,1,0,0,0,empty,CD-0722-4
"B10,H12",6980,7866,5026,2840,3998,2113,0,2117,1359,758,1.792875989,1268,1940,487,201,196,5,53,1,0.025510204,0,empty,CD-0722-4
"B11,A1",913261,1062112,681099,381013,524933,284686,1,284959,214948,70011,3.070203254,168184,68769,7153,2687,2615,72,559,5,0.06500956,0,hg38,CD-0722-4
"B11,A2",11650,12717,8769,3948,6549,3258,0,3260,2099,1161,1.807924203,1793,2396,541,253,249,4,72,1,0.104417671,0,empty,CD-0722-4
"B11,A3",6651,7037,4850,2187,3795,1852,4,1860,1259,601,2.09484193,1039,1556,370,151,148,3,40,2,0.121621622,0,empty,CD-0722-4
"B11,A4",11833,13166,8868,4298,6691,3357,16,3375,2206,1169,1.887082977,1865,780,174,61,61,0,29,0,0.098360656,0,empty,CD-0722-4
"B11,A5",13620,14863,10180,4683,7655,3658,0,3664,2422,1242,1.950080515,2041,6933,574,304,299,5,82,2,0.086956522,0,empty,CD-0722-4
"B11,A6",14432,15510,10882,4628,8208,3965,0,3974,2931,1043,2.810162991,2175,2589,552,242,240,2,81,1,0.095833333,0,empty,CD-0722-4
"B11,A7",25027,29585,17608,11977,15120,9240,0,9254,6552,2702,2.424870466,5507,1601,376,142,137,5,30,2,0.02189781,0,empty,CD-0722-4
"B11,A8",5038,5741,3806,1935,2947,1467,0,1469,985,484,2.035123967,856,1901,564,173,172,1,44,1,0.011627907,0,empty,CD-0722-4
"B11,A9",8111,9115,6041,3074,4730,2260,0,2264,1542,722,2.135734072,1297,1953,420,184,181,3,57,2,0.022099448,0,empty,CD-0722-4
"B11,A10",562770,628238,433230,195008,310511,150112,11,150256,119088,31168,3.820841889,84163,38226,4313,1653,1595,58,375,4,0.020062696,0,hg38,CD-0722-4
"B11,A11",6549,7064,4998,2066,3568,1660,0,1660,1057,603,1.752902156,879,1418,193,106,100,6,33,2,0.12,0,empty,CD-0722-4
"B11,A12",9194,9760,6914,2846,5049,2403,3,2411,1511,900,1.678888889,1306,3550,854,402,399,3,96,2,0.062656642,0,empty,CD-0722-4
"B11,B1",7724,8542,5686,2856,4381,2211,0,2215,1379,836,1.649521531,1279,921,182,82,81,1,22,1,0,0,empty,CD-0722-4
"B11,B2",9216,9808,6265,3543,5193,2765,0,2770,1724,1046,1.648183556,1629,689,145,50,49,1,16,1,0.204081633,0,empty,CD-0722-4
"B11,B3",6792,7423,4930,2493,3983,2013,26,2044,1340,704,1.903409091,1158,1502,361,119,118,1,37,1,0,0,empty,CD-0722-4
"B11,B4",7561,8372,5568,2804,4367,2290,0,2290,1397,893,1.564389698,1315,978,165,65,65,0,28,0,0.046153846,0,empty,CD-0722-4
"B11,B5",10686,8352,5022,3330,4994,2910,0,2919,1806,1113,1.622641509,1801,712,140,63,63,0,18,0,0,0,empty,CD-0722-4
"B11,B6",8664,9732,6280,3452,5120,2705,13,2719,1707,1012,1.686758893,1587,1335,362,167,162,5,38,2,0.117283951,0,empty,CD-0722-4
"B11,B7",712035,744413,580174,164239,365020,133337,1,133520,100035,33485,2.98745707,68729,194656,25949,10112,9871,241,1406,6,0.045588086,0,hg38,CD-0722-4
"B11,B8",1443729,1588800,1104874,483926,761594,375445,5,375841,319041,56800,5.616919014,209717,135051,17815,7271,7109,162,1225,6,0.075397384,0,hg38,CD-0722-4
"B11,B9",854597,944325,651545,292780,458195,222913,5,223124,170025,53099,3.202037703,126935,43223,5693,2159,2116,43,409,5,0.079395085,0,hg38,CD-0722-4
"B11,B10",1035063,1214001,661842,552159,643740,438751,7,439414,277450,161964,1.713034995,269995,7297,872,256,237,19,69,3,0.075949367,0,hg38,CD-0722-4
"B11,B11",12125,13449,8798,4651,6884,3695,33,3729,2193,1536,1.427734375,2149,360,57,29,29,0,9,0,0.068965517,0,empty,CD-0722-4
"B11,B12",6999,7754,5128,2626,3981,1960,1,1961,1228,733,1.675306958,1122,1508,267,118,115,3,41,2,0.113043478,0,empty,CD-0722-4
"B11,C1",22161,23838,16828,7010,11829,5612,1,5616,3691,1925,1.917402597,3055,1298,268,117,116,1,38,1,0,0,empty,CD-0722-4
"B11,C2",1268130,1535260,910463,624797,742915,462511,1,462838,324433,138405,2.34408439,280171,24864,8685,3107,3092,15,722,3,0.01778784,0,hg38,CD-0722-4
"B11,C3",11776,13011,8688,4323,6791,3362,0,3369,2137,1232,1.734577922,1938,990,137,70,67,3,23,2,0.014925373,0,empty,CD-0722-4
"B11,C4",7400,8035,5635,2400,4261,1960,0,1964,1288,676,1.905325444,1109,1718,478,193,193,0,45,0,0.103626943,0,empty,CD-0722-4
"B11,C5",899644,1036837,664969,371868,521142,305551,3,305763,191461,114302,1.675045056,178463,8177,1266,390,379,11,77,3,0.166226913,0,hg38,CD-0722-4
"B11,C6",9107,9925,6775,3150,5350,2685,0,2696,1814,882,2.056689342,1488,1581,467,166,166,0,44,0,0.102409639,0,empty,CD-0722-4
"B11,C7",11980,13658,8567,5091,6989,3845,1,3850,2403,1447,1.660677263,2268,558,96,38,36,2,13,1,0.027777778,0,empty,CD-0722-4
"B11,C8",13264,14467,9804,4663,7549,3813,0,3816,2479,1337,1.854151085,2125,3217,618,258,254,4,66,1,0.102362205,0,empty,CD-0722-4
"B11,C9",9562,10732,7040,3692,5616,2783,0,2783,1821,962,1.892931393,1580,2171,528,190,185,5,43,2,0.075675676,0,empty,CD-0722-4
"B11,C10",10975,11983,8238,3745,6192,3008,0,3009,1935,1074,1.801675978,1659,1744,538,221,220,1,57,1,0.081818182,0,empty,CD-0722-4
"B11,C11",9251,10290,6813,3477,5397,2725,15,2749,1761,988,1.782388664,1563,1914,386,189,182,7,53,1,0.087912088,0,empty,CD-0722-4
"B11,C12",13269,14337,9890,4447,7334,3473,13,3491,2320,1171,1.981212639,1953,2347,431,203,198,5,53,2,0.111111111,0,empty,CD-0722-4
"B11,D1",11788,12911,8507,4404,6750,3501,0,3501,2122,1379,1.538796229,2017,623,133,73,73,0,24,0,0.054794521,0,empty,CD-0722-4
"B11,D2",11005,11805,8552,3253,6030,2672,0,2681,1711,970,1.763917526,1384,3235,855,321,318,3,72,2,0.037735849,0,empty,CD-0722-4
"B11,D3",8577,9723,6267,3456,5017,2527,1,2530,1625,905,1.79558011,1466,1571,404,140,137,3,42,1,0.131386861,0,empty,CD-0722-4
"B11,D4",8470,9400,6368,3032,4885,2422,9,2438,1687,751,2.246338216,1347,1500,445,158,155,3,40,3,0.051612903,0,empty,CD-0722-4
"B11,D5",7804,8798,5836,2962,4637,2334,19,2355,1485,870,1.706896552,1358,1532,336,124,123,1,33,1,0.008130081,0,empty,CD-0722-4
"B11,D6",11872,12945,8631,4314,6625,3498,0,3501,2104,1397,1.506084467,1984,1995,601,209,207,2,47,1,0.057971014,0,empty,CD-0722-4
"B11,D7",6536,7153,4784,2369,3728,1801,5,1806,1214,592,2.050675676,1009,1661,341,147,146,1,38,1,0.089041096,0,empty,CD-0722-4
"B11,D8",7767,8465,5801,2664,4411,2153,0,2153,1377,776,1.774484536,1193,1007,302,115,111,4,28,2,0.009009009,0,empty,CD-0722-4
"B11,D9",4238,4780,3108,1672,2444,1215,0,1217,803,414,1.939613527,753,2038,439,201,201,0,54,0,0.039800995,0,empty,CD-0722-4
"B11,D10",8683,9745,6389,3356,5125,2637,0,2639,1674,965,1.734715026,1583,864,157,69,67,2,22,1,0,0,empty,CD-0722-4
"B11,D11",13033,14249,9521,4728,7425,3883,0,3885,2516,1369,1.837837838,2137,2704,804,318,315,3,75,2,0.063492063,0,empty,CD-0722-4
"B11,D12",11760,13226,8637,4589,6763,3374,1,3378,2171,1207,1.798674399,1982,3734,741,303,299,4,98,2,0.170568562,0,empty,CD-0722-4
"B11,E1",13870,14977,10182,4795,7711,3869,0,3869,2446,1423,1.718903725,2150,2315,529,216,214,2,66,1,0.102803738,0,empty,CD-0722-4
"B11,E2",9856,10788,7051,3737,5597,2867,5,2877,1824,1053,1.732193732,1667,1839,302,108,106,2,30,2,0.160377358,0,empty,CD-0722-4
"B11,E3",650446,787529,465655,321874,390247,234877,1,235061,189427,45634,4.151005829,142704,12751,5002,1784,1778,6,456,2,0.031496063,0,hg38,CD-0722-4
"B11,E4",9262,9951,6967,2984,5250,2578,1,2581,1675,906,1.848785872,1404,2324,610,239,238,1,68,1,0.021008403,0,empty,CD-0722-4
"B11,E5",8207,8886,6222,2664,4639,2127,0,2128,1387,741,1.871794872,1137,1388,526,193,193,0,40,0,0.139896373,0,empty,CD-0722-4
"B11,E6",1021356,1164772,768204,396568,559795,293945,5,294228,241789,52439,4.610862145,168007,342062,55848,22133,21756,377,2753,10,0.060443096,0,hg38,CD-0722-4
"B11,E7",13130,14072,9821,4251,7295,3429,0,3432,2242,1190,1.884033613,1916,2821,721,312,312,0,83,0,0.03525641,0,empty,CD-0722-4
"B11,E8",11111,11943,8406,3537,6211,2900,0,2901,1916,985,1.945177665,1584,2774,802,368,366,2,85,2,0.049180328,0,empty,CD-0722-4
"B11,E9",6030,6375,4412,1963,3370,1598,1,1601,1080,521,2.07293666,895,2243,568,258,253,5,68,3,0.146245059,0,empty,CD-0722-4
"B11,E10",7744,8554,5788,2766,4524,2155,1,2158,1389,769,1.806241873,1259,1527,326,131,129,2,35,2,0.364341085,0,empty,CD-0722-4
"B11,E11",9165,10159,6775,3384,5208,2612,0,2616,1686,930,1.812903226,1500,1395,271,123,118,5,40,2,0.06779661,0,empty,CD-0722-4
"B11,E12",9580,10548,7014,3534,5459,2690,6,2697,1702,995,1.710552764,1573,1882,281,104,102,2,47,2,0.098039216,0,empty,CD-0722-4
"B11,F1",11994,13122,8878,4244,6830,3324,0,3329,2124,1205,1.762655602,1893,1930,615,197,196,1,43,1,0.056122449,0,empty,CD-0722-4
"B11,F2",9449,10385,6831,3554,5415,2583,23,2617,1681,936,1.795940171,1525,3445,680,306,301,5,80,3,0.086378738,0,empty,CD-0722-4
"B11,F3",8885,9736,6612,3124,5093,2428,0,2428,1587,841,1.887039239,1374,2446,624,213,205,8,59,2,0.12195122,0,empty,CD-0722-4
"B11,F4",13415,14470,9966,4504,7692,3688,9,3702,2359,1343,1.756515264,2116,652,199,85,85,0,18,0,0.011764706,0,empty,CD-0722-4
"B11,F5",10806,11549,8097,3452,6023,2799,0,2805,1825,980,1.862244898,1561,1960,419,178,177,1,51,1,0.096045198,0,empty,CD-0722-4
"B11,F6",10892,12040,8036,4004,6208,3183,11,3195,2120,1075,1.972093023,1806,3224,722,255,255,0,71,0,0.145098039,0,empty,CD-0722-4
"B11,F7",12097,13315,9069,4246,7141,3571,0,3576,2339,1237,1.890864996,2057,952,222,95,95,0,34,0,0.042105263,0,empty,CD-0722-4
"B11,F8",8569,9591,6385,3206,4961,2457,6,2465,1593,872,1.826834862,1399,284,23,17,17,0,8,0,0,0,empty,CD-0722-4
"B11,F9",9388,10074,7055,3019,5301,2482,0,2484,1671,813,2.055350554,1387,3004,843,334,333,1,62,1,0.117117117,0,empty,CD-0722-4
"B11,F10",11948,13034,9128,3906,6846,3240,0,3243,2192,1051,2.085632731,1775,2137,680,249,246,3,64,1,0.024390244,0,empty,CD-0722-4
"B11,F11",8656,9475,6581,2894,4877,2272,12,2284,1511,773,1.954721863,1256,1516,303,142,138,4,31,2,0.144927536,0,empty,CD-0722-4
"B11,F12",10441,11610,7819,3791,5895,2850,0,2859,1840,1019,1.805691855,1637,338,80,26,26,0,12,0,0,0,empty,CD-0722-4
"B11,G1",11320,12147,8525,3622,6428,3014,0,3015,1942,1073,1.809878844,1706,2379,579,241,239,2,62,2,0.112970711,0,empty,CD-0722-4
"B11,G2",6485,7391,4534,2857,3844,2087,0,2088,1293,795,1.626415094,1279,539,99,44,44,0,11,0,0.113636364,0,empty,CD-0722-4
"B11,G3",12187,13429,9118,4311,6868,3504,7,3512,2136,1376,1.552325581,1911,2509,717,253,253,0,58,0,0.035573123,0,empty,CD-0722-4
"B11,G4",1242468,1386550,947949,438601,669656,332522,2,332803,262581,70222,3.739298226,187824,3185,297,135,128,7,33,2,0.0859375,0,hg38,CD-0722-4
"B11,G5",7949,8881,5801,3080,4555,2260,0,2266,1490,776,1.920103093,1298,1552,224,100,99,1,35,1,0.04040404,0,empty,CD-0722-4
"B11,G6",11280,12089,8559,3530,6198,3010,0,3017,2001,1016,1.969488189,1614,204,60,30,30,0,9,0,0.333333333,0,empty,CD-0722-4
"B11,G7",1078741,1242490,798803,443687,607818,332439,3,332708,260754,71954,3.623898602,194047,122673,18307,7137,7000,137,1224,6,0.06,0,hg38,CD-0722-4
"B11,G8",6459,6913,4772,2141,3630,1766,0,1766,1167,599,1.948247078,1005,1584,355,150,149,1,47,1,0.140939597,0,empty,CD-0722-4
"B11,G9",8043,8698,5816,2882,4624,2300,0,2300,1547,753,2.054448871,1306,2453,589,238,236,2,62,1,0.097457627,0,empty,CD-0722-4
"B11,G10",9596,10859,7042,3817,5563,2865,23,2893,1804,1089,1.656565657,1719,2038,425,186,185,1,58,1,0.010810811,0,empty,CD-0722-4
"B11,G11",9044,9750,6920,2830,5118,2444,0,2444,1624,820,1.980487805,1321,1581,400,135,130,5,38,1,0.038461538,0,empty,CD-0722-4
"B11,G12",7680,8630,5602,3028,4427,2262,0,2266,1434,832,1.723557692,1329,2215,660,251,250,1,53,1,0.012,0,empty,CD-0722-4
"B11,H1",709336,791967,534547,257420,391565,195711,2,195883,148433,47450,3.128198103,113017,45478,8163,3173,3128,45,564,4,0.047314578,0,hg38,CD-0722-4
"B11,H2",15026,16417,11439,4978,8431,4026,0,4028,2760,1268,2.176656151,2230,2652,819,288,288,0,61,0,0.135416667,0,empty,CD-0722-4
"B11,H3",7737,8616,5700,2916,4438,2263,2,2265,1467,798,1.838345865,1288,1438,287,115,114,1,31,1,0.271929825,0,empty,CD-0722-4
"B11,H4",10876,11956,7977,3979,6122,2991,1,2993,1918,1075,1.784186047,1717,183,15,7,7,0,4,0,0,0,empty,CD-0722-4
"B11,H5",12100,13126,8972,4154,6778,3375,1,3378,2220,1158,1.917098446,1898,2344,627,254,246,8,63,2,0.056910569,0,empty,CD-0722-4
"B11,H6",7139,8086,5128,2958,4262,2229,1,2230,1421,809,1.756489493,1329,2325,482,209,208,1,56,1,0.048076923,0,empty,CD-0722-4
"B11,H7",8477,9254,6275,2979,4829,2248,1,2252,1469,783,1.876117497,1318,1710,335,124,124,0,32,0,0.072580645,0,empty,CD-0722-4
"B11,H8",9911,11095,7196,3899,5604,2891,0,2899,1891,1008,1.875992063,1683,2447,421,188,185,3,62,2,0.032432432,0,empty,CD-0722-4
"B11,H9",1764388,1925332,1358824,566508,912644,444921,14,445368,338455,106913,3.165704825,248131,130910,19085,7421,7268,153,1242,4,0.043478261,0,hg38,CD-0722-4
"B11,H10",785496,855975,605939,250036,416472,198201,3,198422,146396,52026,2.813900742,111054,54199,10185,3938,3883,55,785,3,0.032191604,0,hg38,CD-0722-4
"B11,H11",8715,10048,6216,3832,5050,3023,0,3024,1620,1404,1.153846154,1779,17,1,1,1,0,1,0,0,0,empty,CD-0722-4
"B11,H12",6859,7664,5039,2625,3919,2005,4,2009,1367,642,2.129283489,1167,1820,383,112,108,4,30,2,0.157407407,0,empty,CD-0722-4
"B12,A1",6849,7477,5006,2471,3982,1975,0,1981,1265,716,1.766759777,1091,1254,292,123,120,3,32,1,0.116666667,0,empty,CD-0722-4
"B12,A2",796114,888481,604410,284071,435091,220535,15,220808,172249,48559,3.54721061,124673,165266,24806,9851,9688,163,1521,7,0.0302436,0,hg38,CD-0722-4
"B12,A3",6221,6880,4579,2301,3611,1778,1,1785,1150,635,1.811023622,1022,1073,159,66,61,5,21,1,0.016393443,0,empty,CD-0722-4
"B12,A4",10887,11992,8160,3832,6233,3017,0,3019,1904,1115,1.707623318,1676,937,193,54,48,6,18,1,0.083333333,0,empty,CD-0722-4
"B12,A5",763410,859294,570502,288792,427530,223097,6,223347,171325,52022,3.293318212,128938,152538,19169,7485,7288,197,1146,7,0.04884742,0,hg38,CD-0722-4
"B12,A6",12552,15274,8906,6368,8031,4748,0,4748,3266,1482,2.203778677,2924,3317,550,236,234,2,84,1,0.05982906,0,empty,CD-0722-4
"B12,A7",6873,7783,5018,2765,4139,2193,9,2202,1396,806,1.732009926,1251,1149,350,155,153,2,37,1,0.137254902,0,empty,CD-0722-4
"B12,A8",4170,4628,3132,1496,2423,1186,2,1189,813,376,2.162234043,664,2107,479,214,213,1,57,1,0.009389671,0,empty,CD-0722-4
"B12,A9",6763,7381,5090,2291,3798,1806,1,1809,1180,629,1.875993641,977,1982,420,175,173,2,46,2,0.132947977,0,empty,CD-0722-4
"B12,A10",648002,593225,561920,31305,280082,47918,0,48073,35879,12194,2.942348696,14167,1030,300,86,85,1,24,1,0,0,empty,CD-0722-4
"B12,A11",5891,6425,4459,1966,3426,1591,0,1596,1021,575,1.775652174,865,1700,463,161,157,4,41,1,0.038216561,0,empty,CD-0722-4
"B12,A12",8591,9244,6500,2744,4720,2216,0,2218,1402,816,1.718137255,1201,4096,1117,454,452,2,98,1,0.068584071,0,empty,CD-0722-4
"B12,B1",7568,8293,5508,2785,4309,2163,0,2167,1352,815,1.658895706,1203,1158,246,93,93,0,31,0,0.107526882,0,empty,CD-0722-4
"B12,B2",7939,8389,5442,2947,4408,2371,0,2371,1432,939,1.525026624,1362,718,309,114,114,0,14,0,0.140350877,0,empty,CD-0722-4
"B12,B3",529375,578253,406857,171396,290074,137846,35,138012,109411,28601,3.825425684,77317,15305,2310,992,969,23,220,3,0.016511868,0,hg38,CD-0722-4
"B12,B4",6819,7626,4952,2674,3992,2084,0,2089,1245,844,1.475118483,1253,1353,305,134,130,4,29,1,0.153846154,0,empty,CD-0722-4
"B12,B5",1824056,995722,749357,246365,627843,259392,14,261238,199913,61325,3.259894007,146120,9984,2566,912,906,6,210,1,0.070640177,0,hg38,CD-0722-4
"B12,B6",8351,9348,6039,3309,4982,2582,0,2584,1620,964,1.680497925,1487,1981,584,185,185,0,45,0,0.016216216,0,empty,CD-0722-4
"B12,B7",746519,896278,530646,365632,447465,282702,1,282928,203628,79300,2.567818411,167438,2548,543,177,175,2,50,1,0.068571429,0,hg38,CD-0722-4
"B12,B8",864901,993592,641913,351679,487183,264042,16,264308,213827,50481,4.235791684,153308,134893,22323,8724,8582,142,1381,6,0.049056164,0,hg38,CD-0722-4
"B12,B9",10143,11132,7482,3650,5730,2937,0,2939,1794,1145,1.566812227,1624,1217,283,103,102,1,32,1,0.245098039,0,empty,CD-0722-4
"B12,B10",796286,827542,576744,250798,430555,200675,18,201332,159597,41735,3.824056547,112943,41313,3686,1438,1393,45,286,3,0.068198134,0,hg38,CD-0722-4
"B12,B11",11066,12153,7968,4185,6353,3398,0,3398,1950,1448,1.346685083,1944,276,74,27,27,0,7,0,0,0,empty,CD-0722-4
"B12,B12",6646,7410,4927,2483,3891,1903,6,1912,1214,698,1.739255014,1151,2205,482,155,154,1,54,1,0.058441558,0,empty,CD-0722-4
"B12,C1",12907,13774,9839,3935,7248,3385,0,3387,2078,1309,1.587471352,1821,1390,313,147,142,5,42,2,0,0,empty,CD-0722-4
"B12,C2",10469,11252,7690,3562,5907,2982,0,2987,1979,1008,1.963293651,1649,2554,953,323,322,1,67,1,0.068322981,0,empty,CD-0722-4
"B12,C3",11052,12179,8243,3936,6306,3070,0,3076,1967,1109,1.773669973,1715,961,250,86,85,1,24,1,0.011764706,0,empty,CD-0722-4
"B12,C4",7456,7989,5599,2390,4215,1957,0,1959,1265,694,1.822766571,1084,1981,496,199,194,5,47,1,0.056701031,0,empty,CD-0722-4
"B12,C5",10225,11623,7607,4016,6150,3115,0,3115,2076,1039,1.998075072,1796,2025,516,207,206,1,61,1,0.101941748,0,empty,CD-0722-4
"B12,C6",8911,9858,6582,3276,5208,2604,6,2616,1693,923,1.834236186,1497,1801,407,150,149,1,36,1,0.087248322,0,empty,CD-0722-4
"B12,C7",14445,16145,10632,5513,8170,4256,19,4278,2621,1657,1.581774291,2489,791,263,100,99,1,17,1,0.04040404,0,empty,CD-0722-4
"B12,C8",12413,13495,9183,4312,6902,3421,0,3424,2209,1215,1.818106996,1913,3277,780,273,270,3,71,1,0.007407407,0,empty,CD-0722-4
"B12,C9",9462,10474,7060,3414,5567,2702,0,2703,1693,1010,1.676237624,1548,2029,386,140,139,1,36,1,0.071942446,0,empty,CD-0722-4
"B12,C10",10236,11111,7766,3345,5767,2787,24,2816,1863,953,1.954879328,1538,1806,473,195,189,6,60,2,0.005291005,0,empty,CD-0722-4
"B12,C11",8900,9916,6569,3347,5235,2628,2,2636,1695,941,1.801275239,1503,2200,452,175,171,4,43,2,0.011695906,0,empty,CD-0722-4
"B12,C12",11873,12694,8587,4107,6685,3276,1,3280,2097,1183,1.772612003,1811,2226,580,206,205,1,51,1,0.087804878,0,empty,CD-0722-4
"B12,D1",10769,11995,7582,4413,6214,3325,0,3325,2003,1322,1.515128593,1946,552,109,32,32,0,15,0,0.1875,0,empty,CD-0722-4
"B12,D2",9422,9986,7071,2915,5229,2395,18,2415,1523,892,1.707399103,1260,2885,815,310,307,3,76,1,0.048859935,0,empty,CD-0722-4
"B12,D3",7811,8567,5816,2751,4414,2219,2,2224,1385,839,1.650774732,1211,1561,397,171,170,1,39,1,0.247058824,0,empty,CD-0722-4
"B12,D4",6248,6932,4613,2319,3606,1753,15,1769,1136,633,1.794628752,1025,1692,633,234,234,0,52,0,0.08974359,0,empty,CD-0722-4
"B12,D5",7088,7756,5285,2471,4067,1947,18,1971,1266,705,1.795744681,1138,1590,326,111,110,1,35,1,0.009090909,0,empty,CD-0722-4
"B12,D6",10722,11798,7740,4058,6204,3365,0,3368,2031,1337,1.51907255,1930,2298,629,213,211,2,55,2,0.028436019,0,empty,CD-0722-4
"B12,D7",5908,6453,4406,2047,3457,1563,1,1571,998,573,1.741710297,885,2158,428,187,179,8,53,2,0.05027933,0,empty,CD-0722-4
"B12,D8",7137,7595,5310,2285,4075,1981,1,1984,1268,716,1.770949721,1115,1278,308,130,128,2,41,2,0.0234375,0,empty,CD-0722-4
"B12,D9",4046,4491,3086,1405,2427,1159,0,1159,733,426,1.720657277,663,1732,472,165,157,8,46,2,0.101910828,0,empty,CD-0722-4
"B12,D10",8183,8937,5978,2959,4785,2510,0,2511,1623,888,1.827702703,1420,663,172,60,60,0,19,0,0.016666667,0,empty,CD-0722-4
"B12,D11",7971,8829,5908,2921,4531,2148,5,2155,1422,733,1.939972715,1215,2178,599,254,251,3,64,2,0.03187251,0,empty,CD-0722-4
"B12,D12",10524,11495,7842,3653,6072,3030,0,3032,1919,1113,1.724168913,1675,4420,1392,455,454,1,93,1,0.085903084,0,empty,CD-0722-4
"B12,E1",12775,13822,9287,4535,7188,3617,13,3635,2292,1343,1.706626955,2060,2930,591,263,260,3,82,3,0.069230769,0,empty,CD-0722-4
"B12,E2",9397,10218,6854,3364,5294,2639,9,2648,1700,948,1.793248945,1495,2277,501,177,172,5,43,2,0.110465116,0,empty,CD-0722-4
"B12,E3",6242,6922,4633,2289,3552,1740,1,1745,1101,644,1.709627329,1004,2436,583,237,236,1,63,1,0.105932203,0,empty,CD-0722-4
"B12,E4",8454,9392,6075,3317,5010,2542,0,2542,1578,964,1.636929461,1505,2312,437,214,212,2,57,1,0.075471698,0,empty,CD-0722-4
"B12,E5",7784,8680,5814,2866,4468,2154,9,2166,1383,783,1.766283525,1236,1535,207,80,80,0,21,0,0.175,0,empty,CD-0722-4
"B12,E6",957752,1071380,725155,346225,520721,264931,2,265147,196416,68731,2.857749778,150922,156877,20130,7883,7703,180,1292,4,0.028560301,0,hg38,CD-0722-4
"B12,E7",11897,13172,8815,4357,7013,3523,0,3529,2254,1275,1.767843137,2059,2635,813,306,302,4,77,2,0.122516556,0,empty,CD-0722-4
"B12,E8",9861,10619,7568,3051,5527,2553,0,2555,1655,900,1.838888889,1420,3318,642,253,248,5,65,2,0.108870968,0,empty,CD-0722-4
"B12,E9",6067,6558,4432,2126,3427,1718,0,1718,1121,597,1.877721943,956,2400,593,223,221,2,55,1,0.185520362,0,empty,CD-0722-4
"B12,E10",7452,7984,5553,2431,4083,1963,1,1968,1268,700,1.811428571,1067,1877,639,280,279,1,50,1,0.053763441,0,empty,CD-0722-4
"B12,E11",8818,9587,6537,3050,4982,2469,0,2471,1543,928,1.662715517,1381,2397,657,256,251,5,62,3,0.039840637,0,empty,CD-0722-4
"B12,E12",966532,1135248,707724,427524,564171,312515,19,312800,245060,67740,3.617655743,189557,77789,11981,4634,4553,81,855,4,0.058203382,0,hg38,CD-0722-4
"B12,F1",10949,11580,8199,3381,5998,2856,5,2864,1839,1025,1.794146341,1547,2143,664,266,266,0,52,0,0.082706767,0,empty,CD-0722-4
"B12,F2",8666,9339,6365,2974,4863,2369,0,2370,1516,854,1.775175644,1343,3201,902,340,339,1,68,1,0.026548673,0,empty,CD-0722-4
"B12,F3",8233,8944,6124,2820,4865,2384,1,2387,1555,832,1.868990385,1362,3315,785,304,301,3,66,1,0.119601329,0,empty,CD-0722-4
"B12,F4",1137817,1263703,862631,401072,620135,309086,11,309432,240609,68823,3.496055098,175447,64353,8352,3156,3077,79,561,6,0.07799805,0,hg38,CD-0722-4
"B12,F5",10109,10463,7617,2846,5496,2427,14,2447,1627,820,1.984146341,1323,2346,420,170,167,3,51,2,0.131736527,0,empty,CD-0722-4
"B12,F6",2872082,3419407,2085528,1333879,1636103,984114,5,984935,796626,188309,4.230419152,595079,600792,94085,36261,35615,646,3746,12,0.068482381,0,hg38,CD-0722-4
"B12,F7",10861,12255,8143,4112,6434,3243,0,3243,2079,1164,1.786082474,1837,1537,377,151,150,1,34,1,0.04,0,empty,CD-0722-4
"B12,F8",9124,10101,6856,3245,5348,2623,13,2640,1728,912,1.894736842,1493,376,36,21,21,0,11,0,0,0,empty,CD-0722-4
"B12,F9",8811,9446,6646,2800,5024,2294,0,2294,1511,783,1.929757344,1267,3297,877,345,340,5,88,1,0.123529412,0,empty,CD-0722-4
"B12,F10",10999,11872,8383,3489,6114,2832,0,2834,1854,980,1.891836735,1517,2640,650,257,255,2,66,1,0.035294118,0,empty,CD-0722-4
"B12,F11",8678,9262,6561,2701,4821,2248,0,2254,1451,803,1.806973848,1222,1778,392,173,169,4,43,2,0.082840237,0,empty,CD-0722-4
"B12,F12",9415,10235,7052,3183,5303,2553,0,2556,1639,917,1.787350055,1414,237,33,21,21,0,15,0,0.047619048,0,empty,CD-0722-4
"B12,G1",10462,11250,7867,3383,6004,2866,0,2872,1864,1008,1.849206349,1581,3477,697,246,240,6,68,3,0.041666667,0,empty,CD-0722-4
"B12,G2",5983,6598,4292,2306,3438,1776,11,1790,1135,655,1.732824427,1017,487,101,34,34,0,14,0,0,0,empty,CD-0722-4
"B12,G3",11531,12219,8471,3748,6321,3220,0,3226,1946,1280,1.5203125,1733,2559,570,238,237,1,60,1,0.151898734,0,empty,CD-0722-4
"B12,G4",20528,23007,14844,8163,11772,6468,15,6487,3888,2599,1.495959985,3726,123,22,15,15,0,4,0,0,0,empty,CD-0722-4
"B12,G5",7078,7776,5186,2590,4145,2074,0,2074,1379,695,1.984172662,1159,1773,430,176,176,0,50,0,0.011363636,0,empty,CD-0722-4
"B12,G6",10066,10952,7559,3393,5689,2662,0,2665,1697,968,1.753099174,1456,161,38,23,23,0,8,0,0,0,empty,CD-0722-4
"B12,G7",8262,8890,6220,2670,4792,2250,0,2254,1457,797,1.828105395,1256,2402,449,196,196,0,67,0,0.091836735,0,empty,CD-0722-4
"B12,G8",5797,6411,4339,2072,3340,1603,0,1604,979,625,1.5664,917,1746,333,154,150,4,51,1,0.026666667,0,empty,CD-0722-4
"B12,G9",16771,19114,13024,6090,9853,5048,0,5051,3888,1163,3.343078246,2802,3102,797,330,329,1,84,1,0.106382979,0,empty,CD-0722-4
"B12,G10",8420,9128,6323,2805,4739,2343,0,2345,1488,857,1.736289382,1249,2470,559,217,215,2,68,2,0.03255814,0,empty,CD-0722-4
"B12,G11",8648,9403,6538,2865,4921,2420,0,2421,1563,858,1.821678322,1338,1628,439,183,182,1,40,1,0,0,empty,CD-0722-4
"B12,G12",7136,7683,5197,2486,4045,2018,8,2029,1218,811,1.501849568,1131,2559,940,359,356,3,68,1,0.101123596,0,empty,CD-0722-4
"B12,H1",853359,971748,634252,337496,480124,251896,1,252166,200235,51931,3.855789413,147589,66128,10015,3708,3655,53,689,9,0.012311902,0,hg38,CD-0722-4
"B12,H2",8391,9182,6123,3059,4862,2485,0,2489,1666,823,2.024301337,1460,3048,768,320,317,3,76,1,0.063091483,0,empty,CD-0722-4
"B12,H3",6973,7642,5063,2579,4052,2073,14,2087,1340,747,1.793842035,1175,1530,388,164,162,2,59,1,0.055555556,0,empty,CD-0722-4
"B12,H4",10638,11449,7869,3580,6055,2931,10,2945,1954,991,1.971745711,1690,160,22,11,11,0,5,0,0,0,empty,CD-0722-4
"B12,H5",12352,13355,9337,4018,6795,3287,3,3296,2132,1164,1.83161512,1767,3167,515,221,217,4,58,1,0.004608295,0,empty,CD-0722-4
"B12,H6",1777444,2181566,1203748,977818,1093225,746263,8,746729,510357,236372,2.159126292,460003,5635,2259,484,483,1,128,1,0.136645963,0,hg38,CD-0722-4
"B12,H7",8276,8848,6062,2786,4735,2258,11,2271,1491,780,1.911538462,1270,1821,598,193,191,2,43,1,0.015706806,0,empty,CD-0722-4
"B12,H8",9071,9828,6415,3413,5183,2640,0,2644,1669,975,1.711794872,1537,2907,610,250,245,5,69,2,0.048979592,0,empty,CD-0722-4
"B12,H9",7315,7876,5448,2428,4057,1957,0,1958,1304,654,1.993883792,1076,1217,231,83,83,0,29,0,0.024096386,0,empty,CD-0722-4
"B12,H10",5884,6304,4571,1733,3346,1588,0,1588,1047,541,1.935304991,865,1161,280,105,102,3,29,1,0.196078431,0,empty,CD-0722-4
"B12,H11",8526,9619,5945,3674,4859,2848,0,2851,1542,1309,1.177998472,1671,73,2,2,1,1,1,1,1,0,empty,CD-0722-4
"B12,H12",6478,6913,4724,2189,3618,1804,0,1806,1154,652,1.76993865,990,1695,344,152,145,7,33,2,0.006896552,0,empty,CD-0722-4
"C1,A1",6790,7400,4977,2423,3852,1899,23,1925,1281,644,1.989130435,1061,1580,454,174,174,0,41,0,0.120689655,0,empty,CD-0722-4
"C1,A2",9635,10556,7043,3513,5464,2732,0,2734,1746,988,1.767206478,1554,2011,457,177,176,1,53,1,0.142045455,0,empty,CD-0722-4
"C1,A3",1586868,1830324,1192886,637438,882039,479155,1,479580,411976,67604,6.093958937,279869,82299,8083,3102,3045,57,768,3,0.027586207,0,hg38,CD-0722-4
"C1,A4",11009,11983,8101,3882,6253,3060,0,3065,1922,1143,1.681539808,1729,710,112,59,57,2,18,1,0.035087719,0,empty,CD-0722-4
"C1,A5",12738,13901,9389,4512,7043,3389,5,3400,2256,1144,1.972027972,1921,4908,945,404,399,5,91,2,0.110275689,0,empty,CD-0722-4
"C1,A6",7981,8738,5945,2793,4642,2361,0,2361,1587,774,2.050387597,1287,2709,618,249,248,1,75,1,0.048387097,0,empty,CD-0722-4
"C1,A7",6582,7225,4932,2293,3820,1958,11,1971,1273,698,1.823782235,1096,1398,412,148,146,2,31,1,0.01369863,0,empty,CD-0722-4
"C1,A8",4186,4513,3090,1423,2461,1210,0,1212,773,439,1.760820046,688,1880,456,177,169,8,60,3,0.00591716,0,empty,CD-0722-4
"C1,A9",7511,8584,5560,3024,4260,2126,41,2168,1360,808,1.683168317,1180,1802,460,187,185,2,40,1,0.227027027,0,empty,CD-0722-4
"C1,A10",7999,8589,6140,2449,4514,2165,0,2166,1349,817,1.651162791,1148,663,124,67,66,1,21,1,0.03030303,0,empty,CD-0722-4
"C1,A11",5968,6601,4554,2047,3416,1594,0,1594,1046,548,1.908759124,875,1548,259,123,122,1,43,1,0.008196721,0,empty,CD-0722-4
"C1,A12",8513,8897,6326,2571,4781,2293,0,2293,1497,796,1.880653266,1215,3362,1157,397,395,2,95,1,0.078481013,0,empty,CD-0722-4
"C1,B1",7386,8051,5494,2557,4172,2048,17,2065,1249,816,1.530637255,1150,1402,383,147,144,3,45,1,0.041666667,0,empty,CD-0722-4
"C1,B2",9138,10095,6359,3736,5332,2868,6,2876,1852,1024,1.80859375,1700,531,94,38,38,0,15,0,0.026315789,0,empty,CD-0722-4
"C1,B3",6116,6890,4656,2234,3676,1821,19,1840,1162,678,1.713864307,1030,2500,749,343,341,2,62,2,0.114369501,0,empty,CD-0722-4
"C1,B4",6681,7541,4744,2797,3971,2175,0,2175,1376,799,1.722152691,1315,1697,292,130,123,7,34,2,0.008130081,0,empty,CD-0722-4
"C1,B5",15277,13466,8951,4515,7624,3829,0,3837,2867,970,2.955670103,2303,893,71,39,39,0,13,0,0.025641026,0,empty,CD-0722-4
"C1,B6",8057,9334,5738,3596,4763,2576,13,2591,1543,1048,1.472328244,1580,1674,559,236,234,2,66,1,0.021367521,0,empty,CD-0722-4
"C1,B7",8165,8763,6015,2748,4896,2356,0,2362,1547,815,1.898159509,1370,1232,192,103,102,1,35,1,0,0,empty,CD-0722-4
"C1,B8",5585,6002,4185,1817,3163,1480,0,1480,974,506,1.924901186,849,1629,305,112,112,0,35,0,0.089285714,0,empty,CD-0722-4
"C1,B9",855823,951474,649771,301703,460585,226285,23,226561,174773,51788,3.374777941,129074,58976,7352,2782,2713,69,467,5,0.09657206,0,hg38,CD-0722-4
"C1,B10",5256,5732,3702,2030,3026,1481,0,1489,954,535,1.78317757,861,612,135,49,49,0,18,0,0.102040816,0,empty,CD-0722-4
"C1,B11",15450,17712,11187,6525,9007,4968,0,4975,3153,1822,1.730515917,2926,357,77,31,31,0,12,0,0.064516129,0,empty,CD-0722-4
"C1,B12",6477,7207,4784,2423,3727,1858,10,1868,1264,604,2.092715232,1065,1459,438,203,203,0,47,0,0.118226601,0,empty,CD-0722-4
"C1,C1",20109,20156,14285,5871,12075,5864,2,5869,3977,1892,2.102008457,3142,1564,500,200,199,1,51,1,0.070351759,0,empty,CD-0722-4
"C1,C2",956479,1104190,702919,401271,536657,294384,0,294683,243023,51660,4.704277971,174710,145138,20256,8096,7951,145,1338,7,0.065274808,0,hg38,CD-0722-4
"C1,C3",11527,12876,8627,4249,6620,3247,0,3251,2078,1173,1.771526002,1860,935,142,80,79,1,22,1,0.012658228,0,empty,CD-0722-4
"C1,C4",7022,7498,5181,2317,4055,1891,0,1893,1256,637,1.971742543,1021,1890,464,158,155,3,38,2,0.032258065,0,empty,CD-0722-4
"C1,C5",10617,11904,7809,4095,6139,3143,22,3165,2028,1137,1.783641161,1825,1451,231,114,113,1,41,1,0.088495575,0,empty,CD-0722-4
"C1,C6",8311,9129,6158,2971,4856,2378,0,2380,1508,872,1.729357798,1327,2182,462,200,198,2,48,2,0.075757576,0,empty,CD-0722-4
"C1,C7",11295,12832,8145,4687,6654,3655,0,3662,2182,1480,1.474324324,2189,434,74,40,40,0,16,0,0.025,0,empty,CD-0722-4
"C1,C8",12228,13055,9072,3983,6838,3346,0,3347,2221,1126,1.972468917,1819,3357,933,374,372,2,85,1,0.077956989,0,empty,CD-0722-4
"C1,C9",987098,1104557,760218,344339,538517,266155,0,266415,210921,55494,3.800789275,150765,121146,21022,8402,8287,115,1246,5,0.033787861,0,hg38,CD-0722-4
"C1,C10",10243,11102,7686,3416,5833,2839,0,2843,1790,1053,1.699905033,1611,2487,516,234,231,3,53,1,0.064935065,0,empty,CD-0722-4
"C1,C11",1052926,1258558,760472,498086,612062,349814,9,350106,297103,53003,5.605399694,213018,205161,39240,15565,15385,180,2131,8,0.056873578,0,hg38,CD-0722-4
"C1,C12",12824,13720,9520,4200,7087,3374,0,3383,2184,1199,1.821517932,1851,2386,480,206,206,0,59,0,0.106796117,0,empty,CD-0722-4
"C1,D1",11414,12575,8363,4212,6637,3416,19,3437,2079,1358,1.530927835,1967,942,99,44,44,0,18,0,0.068181818,0,empty,CD-0722-4
"C1,D2",9660,10272,7493,2779,5424,2515,0,2518,1585,933,1.698821008,1294,3592,1125,417,415,2,97,1,0.072289157,0,empty,CD-0722-4
"C1,D3",7984,8595,5887,2708,4609,2285,0,2289,1472,817,1.801713586,1303,1675,307,134,130,4,37,2,0.3,0,empty,CD-0722-4
"C1,D4",6124,7049,4496,2553,3673,1890,4,1894,1191,703,1.694167852,1120,1543,540,193,191,2,45,1,0.089005236,0,empty,CD-0722-4
"C1,D5",7231,7825,5345,2480,4210,2136,0,2137,1378,759,1.815546772,1188,2628,657,210,203,7,50,2,0.02955665,0,empty,CD-0722-4
"C1,D6",10878,11894,7766,4128,6050,3159,0,3163,1896,1267,1.496448303,1801,1810,479,175,175,0,48,0,0.108571429,0,empty,CD-0722-4
"C1,D7",6202,6553,4712,1841,3485,1600,2,1602,1053,549,1.918032787,836,2008,497,225,222,3,56,1,0.072072072,0,empty,CD-0722-4
"C1,D8",7473,8349,5466,2883,4257,2055,48,2106,1431,675,2.12,1200,1563,371,120,119,1,40,1,0.050420168,0,empty,CD-0722-4
"C1,D9",535799,587927,412081,175846,289750,137942,1,138063,108910,29153,3.735807636,77471,24865,4198,1547,1524,23,322,4,0.018372703,0,hg38,CD-0722-4
"C1,D10",7758,8735,5612,3123,4413,2274,0,2274,1405,869,1.616800921,1315,845,194,71,71,0,20,0,0,0,empty,CD-0722-4
"C1,D11",7954,8480,6040,2440,4425,2083,1,2085,1301,784,1.659438776,1155,3093,698,268,265,3,75,1,0.067924528,0,empty,CD-0722-4
"C1,D12",10872,11790,8059,3731,6008,2883,0,2885,1847,1038,1.77938343,1588,4248,1307,481,476,5,111,2,0.102941176,0,empty,CD-0722-4
"C1,E1",954708,1070419,720562,349857,519255,264069,2,264350,203416,60934,3.338300456,151628,163240,23365,9234,9047,187,1414,7,0.053056262,0,hg38,CD-0722-4
"C1,E2",9836,10797,7072,3725,5692,2883,1,2889,1878,1011,1.857566766,1712,1812,454,174,172,2,43,1,0.063953488,0,empty,CD-0722-4
"C1,E3",6506,6981,4801,2180,3765,1803,0,1807,1200,607,1.97693575,993,2458,849,326,326,0,78,0,0.036809816,0,empty,CD-0722-4
"C1,E4",10170,10371,7142,3229,5981,2944,0,2950,1942,1008,1.926587302,1582,2791,585,227,225,2,71,1,0.182222222,0,empty,CD-0722-4
"C1,E5",7750,8373,5869,2504,4458,2065,0,2065,1344,721,1.86407767,1168,1169,184,88,85,3,33,2,0.176470588,0,empty,CD-0722-4
"C1,E6",13540,14865,9973,4892,7683,3845,0,3850,2507,1343,1.866716307,2160,3683,1062,367,365,2,106,2,0.052054795,0,empty,CD-0722-4
"C1,E7",14049,15435,10414,5021,8064,3842,0,3851,2616,1235,2.118218623,2184,4656,1133,409,404,5,101,2,0.047029703,0,empty,CD-0722-4
"C1,E8",10389,11082,7894,3188,5845,2722,0,2730,1797,933,1.926045016,1474,3893,1130,444,440,4,89,3,0.047727273,0,empty,CD-0722-4
"C1,E9",6107,6750,4504,2246,3505,1704,5,1709,1126,583,1.931389365,995,2772,651,280,279,1,74,1,0.039426523,0,empty,CD-0722-4
"C1,E10",7368,7757,5432,2325,4118,1946,0,1948,1230,718,1.713091922,1043,1922,424,156,156,0,39,0,0.108974359,0,empty,CD-0722-4
"C1,E11",9257,10022,6778,3244,5419,2733,0,2742,1730,1012,1.709486166,1593,1708,419,138,136,2,49,2,0.036764706,0,empty,CD-0722-4
"C1,E12",10319,11150,7602,3548,5915,2956,0,2957,2005,952,2.106092437,1671,1855,339,173,172,1,57,1,0.011627907,0,empty,CD-0722-4
"C1,F1",23325,24484,17801,6683,12417,5310,0,5323,3529,1794,1.967112598,2889,10461,2828,1146,1145,1,221,1,0.041048035,0,empty,CD-0722-4
"C1,F2",45937,48652,33824,14828,24354,11715,0,11733,8597,3136,2.741390306,6538,4105,728,318,313,5,92,2,0.095846645,0,empty,CD-0722-4
"C1,F3",11707,12815,8789,4026,6507,3220,0,3226,2106,1120,1.880357143,1794,3485,961,387,386,1,99,1,0.025906736,0,empty,CD-0722-4
"C1,F4",12588,13525,9464,4061,7104,3383,1,3386,2149,1237,1.737267583,1869,620,112,55,55,0,26,0,0.036363636,0,empty,CD-0722-4
"C1,F5",1736947,1915437,1308552,606885,910754,468524,4,469002,373437,95565,3.907675404,264516,350713,56192,22633,22225,408,2563,9,0.049493813,0,hg38,CD-0722-4
"C1,F6",10637,12078,7779,4299,6408,3304,33,3340,2113,1227,1.72208639,2025,3763,841,354,352,2,95,1,0.048295455,0,empty,CD-0722-4
"C1,F7",12105,13127,9014,4113,6826,3328,2,3337,2184,1153,1.894189072,1867,1192,226,120,119,1,39,1,0.008403361,0,empty,CD-0722-4
"C1,F8",8841,9417,6485,2932,5211,2492,0,2494,1661,833,1.993997599,1415,220,43,19,19,0,9,0,0,0,empty,CD-0722-4
"C1,F9",8771,9514,6750,2764,5006,2361,1,2364,1583,781,2.026888604,1294,2860,704,244,237,7,66,1,0.054852321,0,empty,CD-0722-4
"C1,F10",11908,12635,8916,3719,6712,3117,25,3148,2072,1076,1.925650558,1697,2146,542,209,208,1,55,1,0.0625,0,empty,CD-0722-4
"C1,F11",8386,8665,6389,2276,4536,2054,0,2055,1378,677,2.035450517,1080,2000,482,166,166,0,39,0,0.072289157,0,empty,CD-0722-4
"C1,F12",993606,1153250,727752,425498,557364,309539,7,309812,235019,74793,3.142259302,184460,8238,895,372,358,14,84,3,0.122905028,0,hg38,CD-0722-4
"C1,G1",10438,11162,7748,3414,5872,2700,1,2711,1777,934,1.902569593,1517,2684,560,184,173,11,58,2,0.086705202,0,empty,CD-0722-4
"C1,G2",6387,6839,4633,2206,3654,1871,3,1876,1193,683,1.74670571,1088,519,145,70,70,0,18,0,0.1,0,empty,CD-0722-4
"C1,G3",1087632,1271277,802008,469269,618041,336063,32,336370,261648,74722,3.501619336,202212,211799,27724,10768,10494,274,1578,6,0.063178959,0,hg38,CD-0722-4
"C1,G4",21287,23685,15226,8459,12167,6721,1,6728,4091,2637,1.551384149,3863,106,28,15,15,0,5,0,0.2,0,empty,CD-0722-4
"C1,G5",7335,8112,5444,2668,4181,2087,0,2089,1372,717,1.913528591,1212,2001,527,173,173,0,44,0,0.132947977,0,empty,CD-0722-4
"C1,G6",10445,11194,7782,3412,5805,2702,42,2748,1862,886,2.101580135,1468,228,78,39,39,0,12,0,0.025641026,0,empty,CD-0722-4
"C1,G7",8846,9212,6804,2408,4846,2169,0,2169,1407,762,1.846456693,1103,3573,730,302,301,1,79,1,0.096345515,0,empty,CD-0722-4
"C1,G8",6701,7161,4747,2414,3923,1978,0,1982,1323,659,2.007587253,1177,1838,334,109,108,1,38,1,0.018518519,0,empty,CD-0722-4
"C1,G9",7585,8385,5658,2727,4451,2250,0,2251,1495,756,1.977513228,1275,2557,556,233,231,2,74,1,0.008658009,0,empty,CD-0722-4
"C1,G10",873902,981444,661580,319864,479961,245747,2,245932,193001,52931,3.64627534,140921,210606,27330,10667,10439,228,1649,7,0.073857649,0,hg38,CD-0722-4
"C1,G11",9258,9864,6838,3026,5405,2583,0,2585,1705,880,1.9375,1437,1737,454,157,156,1,47,1,0.038461538,0,empty,CD-0722-4
"C1,G12",7458,8323,5436,2887,4420,2281,1,2289,1408,881,1.598183882,1379,1998,345,176,169,7,55,2,0.124260355,0,empty,CD-0722-4
"C1,H1",7920,8139,5939,2200,4365,2041,1,2044,1364,680,2.005882353,1071,1284,306,141,141,0,45,0,0.007092199,0,empty,CD-0722-4
"C1,H2",8647,9606,6438,3168,4973,2460,11,2475,1576,899,1.753058954,1432,2807,750,292,289,3,69,2,0.079584775,0,empty,CD-0722-4
"C1,H3",7027,7643,5268,2375,4024,1994,0,1994,1274,720,1.769444444,1156,2031,356,161,160,1,47,1,0.1375,0,empty,CD-0722-4
"C1,H4",1262447,1504314,910879,593435,722482,419460,2,419831,330608,89223,3.705412282,254697,10419,1762,670,659,11,138,3,0.025796662,0,hg38,CD-0722-4
"C1,H5",11494,12961,8433,4528,6665,3375,7,3388,2111,1277,1.653093187,2033,1689,392,136,134,2,46,1,0.052238806,0,empty,CD-0722-4
"C1,H6",6446,7317,4675,2642,3837,2000,1,2004,1332,672,1.982142857,1179,1653,485,215,214,1,72,1,0.03271028,0,empty,CD-0722-4
"C1,H7",8105,8670,6105,2565,4581,2170,0,2172,1437,735,1.955102041,1174,2184,479,184,174,10,44,2,0.206896552,0,empty,CD-0722-4
"C1,H8",833557,932616,634912,297704,452007,225946,4,226140,171672,54468,3.15179555,128872,116116,16980,6905,6801,104,1124,7,0.047345979,0,hg38,CD-0722-4
"C1,H9",6783,7422,5100,2322,3827,1806,0,1806,1216,590,2.061016949,1014,1574,298,141,140,1,36,1,0.007142857,0,empty,CD-0722-4
"C1,H10",9523,10148,7036,3112,5173,2474,1,2477,1693,784,2.159438776,1408,2007,448,161,159,2,44,1,0.050314465,0,empty,CD-0722-4
"C1,H11",20911,25971,12393,13578,13667,10033,13,10059,5482,4577,1.197727769,6725,30,0,0,0,0,0,0,0,0,empty,CD-0722-4
"C1,H12",6412,6864,4747,2117,3611,1853,0,1856,1231,625,1.9696,987,1581,257,102,99,3,26,2,0.050505051,0,empty,CD-0722-4
"C2,A1",17369,19290,12445,6845,9877,5379,0,5386,2952,2434,1.212818406,3130,2431,742,250,246,4,67,1,0.040650407,0,empty,CD-0722-4
"C2,A2",3716282,4225827,2789084,1436743,1942137,1084313,14,1085355,888014,197341,4.499896119,620168,460236,73538,29218,28789,429,3434,10,0.055437841,0,hg38,CD-0722-4
"C2,A3",6316,6760,4577,2183,3611,1805,0,1807,1196,611,1.957446809,1040,1667,449,182,179,3,54,1,0.033519553,0,empty,CD-0722-4
"C2,A4",11353,12533,8536,3997,6475,3218,0,3220,2090,1130,1.849557522,1796,887,150,63,62,1,28,1,0.064516129,0,empty,CD-0722-4
"C2,A5",9891,10842,7283,3559,5672,2724,0,2724,1786,938,1.904051173,1565,3289,708,276,274,2,88,1,0.02189781,0,empty,CD-0722-4
"C2,A6",696890,807567,527119,280448,398684,210494,6,210694,168241,42453,3.96299437,122386,31434,7602,2804,2786,18,638,4,0.042713568,0,hg38,CD-0722-4
"C2,A7",672050,805097,476400,328697,400041,252228,0,252385,187673,64712,2.900126715,151601,7211,916,336,331,5,67,2,0.105740181,0,hg38,CD-0722-4
"C2,A8",4405,5040,3293,1747,2636,1310,2,1312,873,439,1.988610478,772,2019,494,221,220,1,60,1,0.081818182,0,empty,CD-0722-4
"C2,A9",7814,8422,5853,2569,4398,2120,16,2139,1402,737,1.902306649,1144,1713,371,146,143,3,60,2,0.06993007,0,empty,CD-0722-4
"C2,A10",12404,13508,9385,4123,6828,3376,7,3384,2230,1154,1.932409012,1841,426,151,58,58,0,14,0,0.068965517,0,empty,CD-0722-4
"C2,A11",6601,6999,5076,1923,3680,1723,5,1731,1157,574,2.015679443,917,1933,532,219,217,2,62,1,0.096774194,0,empty,CD-0722-4
"C2,A12",10031,10706,7477,3229,5497,2598,0,2602,1679,923,1.819068256,1408,4263,958,338,333,5,87,1,0.075075075,0,empty,CD-0722-4
"C2,B1",7809,8509,5630,2879,4517,2306,0,2310,1395,915,1.524590164,1306,1324,289,103,103,0,38,0,0.067961165,0,empty,CD-0722-4
"C2,B2",7674,8272,5291,2981,4388,2268,1,2269,1413,856,1.650700935,1334,717,94,37,37,0,12,0,0,0,empty,CD-0722-4
"C2,B3",10459,11999,7451,4548,6185,3347,0,3349,2330,1019,2.286555447,1989,1966,441,197,195,2,54,2,0.076923077,0,empty,CD-0722-4
"C2,B4",8077,9257,5803,3454,4806,2579,0,2587,1590,997,1.594784353,1549,1985,391,162,158,4,49,2,0.03164557,0,empty,CD-0722-4
"C2,B5",8295,5353,3320,2033,3388,1813,0,1827,1229,598,2.055183946,1129,1172,257,87,84,3,28,2,0.071428571,0,empty,CD-0722-4
"C2,B6",8934,9840,6459,3381,5080,2681,1,2684,1567,1117,1.402864816,1516,2316,801,289,286,3,83,2,0.01048951,0,empty,CD-0722-4
"C2,B7",8259,9272,6265,3007,4815,2348,0,2350,1522,828,1.838164251,1290,1620,405,135,135,0,45,0,0.140740741,0,empty,CD-0722-4
"C2,B8",5981,6618,4525,2093,3455,1573,0,1577,1064,513,2.074074074,891,1733,280,107,106,1,43,1,0.235849057,0,empty,CD-0722-4
"C2,B9",11335,12691,8106,4585,6468,3392,0,3398,2080,1318,1.57814871,1980,1544,345,129,129,0,35,0,0.217054264,0,empty,CD-0722-4
"C2,B10",5416,5971,3864,2107,3269,1616,1,1619,1053,566,1.860424028,910,864,266,113,107,6,26,1,0.018691589,0,empty,CD-0722-4
"C2,B11",913246,1002686,702084,300602,482090,230054,1,230292,179344,50948,3.52013818,128570,25504,2980,1235,1202,33,242,4,0.058236273,0,hg38,CD-0722-4
"C2,B12",7375,8166,5439,2727,4181,2082,2,2085,1354,731,1.852257182,1150,2911,635,222,219,3,59,2,0.03196347,0,empty,CD-0722-4
"C2,C1",14785,15358,10724,4634,8149,3931,6,3940,2516,1424,1.766853933,2153,1598,300,127,119,8,51,1,0.016806723,0,empty,CD-0722-4
"C2,C2",1123087,1270620,846645,423975,613350,317403,7,317725,248965,68760,3.620782432,184072,115833,13698,5305,5198,107,1077,5,0.039245864,0,hg38,CD-0722-4
"C2,C3",12991,14127,9647,4480,7391,3560,0,3564,2281,1283,1.77786438,1981,1072,285,68,66,2,19,2,0.121212121,0,empty,CD-0722-4
"C2,C4",7672,8271,5896,2375,4382,2037,0,2037,1339,698,1.918338109,1071,2469,585,238,237,1,61,1,0.05907173,0,empty,CD-0722-4
"C2,C5",12944,13881,9227,4654,7443,3884,25,3914,2609,1305,1.999233716,2221,2464,556,220,217,3,59,1,0.059907834,0,empty,CD-0722-4
"C2,C6",9150,10064,6502,3562,5528,2876,1,2880,1876,1004,1.868525896,1698,2247,724,315,304,11,66,1,0.046052632,0,empty,CD-0722-4
"C2,C7",12100,13764,8483,5281,7141,3997,0,4002,2356,1646,1.431348724,2415,600,135,54,54,0,19,0,0.018518519,0,empty,CD-0722-4
"C2,C8",836511,975713,605052,370661,485007,277003,0,277199,229683,47516,4.83380335,165268,69792,22349,8689,8650,39,1280,4,0.050635838,0,hg38,CD-0722-4
"C2,C9",9688,10502,7100,3402,5509,2707,0,2711,1761,950,1.853684211,1530,2217,662,247,247,0,49,0,0.020242915,0,empty,CD-0722-4
"C2,C10",10446,11231,7820,3411,5730,2737,0,2739,1786,953,1.874081847,1503,3363,728,276,271,5,72,2,0.022140221,0,empty,CD-0722-4
"C2,C11",9265,10370,6743,3627,5345,2665,2,2673,1711,962,1.778586279,1549,2355,525,220,216,4,54,2,0.023148148,0,empty,CD-0722-4
"C2,C12",13683,14519,9987,4532,7637,3708,0,3708,2424,1284,1.887850467,2130,2275,428,183,182,1,58,1,0.087912088,0,empty,CD-0722-4
"C2,D1",11955,12861,8544,4317,6901,3581,4,3586,2108,1478,1.426251691,2094,1293,475,190,190,0,37,0,0.078947368,0,empty,CD-0722-4
"C2,D2",9492,10192,7280,2912,5269,2403,0,2407,1510,897,1.683389075,1255,3877,1038,409,402,7,94,2,0.077114428,0,empty,CD-0722-4
"C2,D3",2128291,2591935,1458898,1133037,1277765,851127,5,851748,601738,250010,2.406855726,524498,43944,6715,2381,2325,56,524,3,0.058494624,0,hg38,CD-0722-4
"C2,D4",8902,9768,6795,2973,5043,2359,0,2359,1624,735,2.20952381,1316,1577,525,221,218,3,55,1,0.077981651,0,empty,CD-0722-4
"C2,D5",7846,8782,5714,3068,4530,2313,0,2316,1480,836,1.770334928,1358,2152,442,176,173,3,44,2,0.052023121,0,empty,CD-0722-4
"C2,D6",11570,12828,8403,4425,6596,3519,0,3523,2037,1486,1.370794078,2041,2401,608,260,260,0,70,0,0.053846154,0,empty,CD-0722-4
"C2,D7",6463,6886,4836,2050,3575,1620,6,1631,1059,572,1.851398601,914,2950,636,218,217,1,67,1,0.050691244,0,empty,CD-0722-4
"C2,D8",2019826,2358474,1486936,871538,1133512,639507,8,640080,504476,135604,3.720214743,383006,171636,27419,10243,10087,156,1736,5,0.046792902,0,hg38,CD-0722-4
"C2,D9",5460,5804,4077,1727,3037,1397,0,1399,916,483,1.896480331,782,1694,466,199,195,4,61,1,0.066666667,0,empty,CD-0722-4
"C2,D10",7573,8721,5410,3311,4555,2397,0,2403,1461,942,1.550955414,1449,1053,276,131,130,1,38,1,0.023076923,0,empty,CD-0722-4
"C2,D11",8701,9452,6451,3001,4991,2450,14,2467,1528,939,1.627263046,1458,2741,742,291,287,4,73,2,0.034843206,0,empty,CD-0722-4
"C2,D12",11555,12613,8481,4132,6595,3289,0,3293,2139,1154,1.85355286,1873,5142,1295,504,503,1,122,1,0.033797217,0,empty,CD-0722-4
"C2,E1",844316,912007,650854,261153,443939,209173,3,209421,165763,43658,3.79685281,115963,24054,5164,1909,1872,37,412,2,0.031517094,0,hg38,CD-0722-4
"C2,E2",10448,11682,7489,4193,5969,3100,0,3103,2006,1097,1.828623519,1847,2580,616,279,278,1,67,1,0.133093525,0,empty,CD-0722-4
"C2,E3",6557,7158,4978,2180,3731,1753,0,1756,1139,617,1.846029173,919,2558,572,234,228,6,72,2,0.021929825,0,empty,CD-0722-4
"C2,E4",815233,899623,628450,271173,439655,208158,4,208379,171175,37204,4.600983765,117049,63268,16729,6173,6108,65,948,4,0.015389653,0,hg38,CD-0722-4
"C2,E5",8119,8711,6053,2658,4623,2210,2,2212,1422,790,1.8,1239,1662,504,165,165,0,39,0,0.187878788,0,empty,CD-0722-4
"C2,E6",14817,16140,10535,5605,8382,4336,0,4340,2665,1675,1.591044776,2495,3959,799,328,328,0,109,0,0.039634146,0,empty,CD-0722-4
"C2,E7",1596258,1817069,1184888,632181,876343,476069,1,476539,374111,102428,3.652429023,277223,175423,33085,12723,12541,182,1821,10,0.04911889,0,hg38,CD-0722-4
"C2,E8",10148,10703,7737,2966,5657,2596,0,2599,1681,918,1.831154684,1375,3644,853,316,307,9,82,2,0.039087948,0,empty,CD-0722-4
"C2,E9",6651,7431,4886,2545,3874,1912,3,1916,1260,656,1.920731707,1122,3322,853,367,363,4,92,2,0.099173554,0,empty,CD-0722-4
"C2,E10",7626,8299,5752,2547,4367,2141,0,2144,1398,746,1.873994638,1227,2028,557,221,221,0,57,0,0.108597285,0,empty,CD-0722-4
"C2,E11",9325,10215,6918,3297,5319,2676,0,2677,1742,935,1.863101604,1487,2759,923,317,311,6,70,2,0.051446945,0,empty,CD-0722-4
"C2,E12",879450,965817,679557,286260,472182,224742,7,224959,164863,60096,2.743327343,126704,123652,13773,5335,5170,165,863,9,0.071953578,0,hg38,CD-0722-4
"C2,F1",11589,12346,8469,3877,6549,3178,0,3179,1929,1250,1.5432,1799,2842,470,224,224,0,68,0,0.066964286,0,empty,CD-0722-4
"C2,F2",869519,971828,655012,316816,476721,243518,17,243786,186021,57765,3.220306414,140640,220085,25926,9917,9679,238,1611,8,0.042463064,0,hg38,CD-0722-4
"C2,F3",3050449,3619349,2206745,1412604,1705199,1030503,5,1031403,789184,242219,3.258142425,624676,621324,75186,29699,28927,772,3525,12,0.067376499,0,hg38,CD-0722-4
"C2,F4",13627,13725,9818,3907,7340,3429,2,3438,2206,1232,1.790584416,1882,1041,165,71,70,1,18,1,0.028571429,0,empty,CD-0722-4
"C2,F5",10594,10927,7787,3140,5804,2673,0,2675,1684,991,1.699293643,1469,2427,540,247,241,6,71,2,0.074688797,0,empty,CD-0722-4
"C2,F6",962233,1107253,719995,387258,539543,284815,4,285077,225228,59849,3.763270898,167087,118769,21241,8005,7903,102,1414,4,0.041123624,0,hg38,CD-0722-4
"C2,F7",1183332,1353883,882917,470966,669407,359811,1,360110,304078,56032,5.426863221,208149,47313,6276,2443,2398,45,546,6,0.041701418,0,hg38,CD-0722-4
"C2,F8",13214,14475,9852,4623,7766,3862,19,3888,2803,1085,2.583410138,2250,445,57,40,40,0,18,0,0,0,empty,CD-0722-4
"C2,F9",9344,9881,7078,2803,5249,2401,0,2403,1577,826,1.909200969,1305,4030,847,365,361,4,102,2,0.030470914,0,empty,CD-0722-4
"C2,F10",11810,12766,9122,3644,6512,3049,0,3051,1966,1085,1.811981567,1597,2484,430,219,216,3,61,2,0.097222222,0,empty,CD-0722-4
"C2,F11",9564,9839,7108,2731,5240,2375,0,2376,1609,767,2.097783572,1268,2379,566,223,222,1,45,1,0.121621622,0,empty,CD-0722-4
"C2,F12",10620,11453,7763,3690,5845,2832,0,2836,1817,1019,1.783120707,1609,331,63,29,28,1,15,1,0,0,empty,CD-0722-4
"C2,G1",13312,14900,10053,4847,7576,3625,0,3633,2347,1286,1.82503888,2057,5720,1129,500,493,7,119,2,0.044624746,0,empty,CD-0722-4
"C2,G2",6250,6575,4395,2180,3442,1763,0,1764,1124,640,1.75625,973,383,88,42,42,0,17,0,0.023809524,0,empty,CD-0722-4
"C2,G3",13052,13548,9518,4030,6994,3464,11,3481,2157,1324,1.629154079,1855,2901,678,261,261,0,77,0,0.126436782,0,empty,CD-0722-4
"C2,G4",21311,24011,15126,8885,12081,6730,0,6731,4025,2706,1.487435329,3900,189,31,20,20,0,9,0,0.05,0,empty,CD-0722-4
"C2,G5",7406,8239,5396,2843,4238,2110,1,2117,1401,716,1.956703911,1208,1629,404,161,159,2,42,1,0.044025157,0,empty,CD-0722-4
"C2,G6",10789,11482,8078,3404,5980,2895,1,2901,1878,1023,1.835777126,1547,265,49,19,19,0,11,0,0,0,empty,CD-0722-4
"C2,G7",9170,9725,6920,2805,5073,2235,99,2335,1548,787,1.966963151,1286,3205,814,334,332,2,92,2,0.105421687,0,empty,CD-0722-4
"C2,G8",6242,6771,4690,2081,3629,1735,0,1735,1123,612,1.83496732,961,2646,812,329,328,1,74,1,0,0,empty,CD-0722-4
"C2,G9",8035,8724,5825,2899,4617,2313,0,2315,1515,800,1.89375,1314,3603,587,309,307,2,100,2,0.09771987,0,empty,CD-0722-4
"C2,G10",9654,10798,7066,3732,5538,2871,0,2873,1843,1030,1.789320388,1677,3107,984,404,402,2,91,1,0.039800995,0,empty,CD-0722-4
"C2,G11",9068,10018,6856,3162,5326,2577,23,2603,1656,947,1.748680042,1488,1685,401,187,185,2,63,1,0.032432432,0,empty,CD-0722-4
"C2,G12",7765,8617,5628,2989,4577,2356,0,2359,1592,767,2.075619296,1374,2378,638,251,246,5,65,2,0.056910569,0,empty,CD-0722-4
"C2,H1",8159,8844,6062,2782,4602,2201,9,2210,1426,784,1.818877551,1202,1550,265,91,90,1,35,1,0.288888889,0,empty,CD-0722-4
"C2,H2",925951,1118213,635159,483054,553335,362319,0,362577,261690,100887,2.593892176,221047,6450,1359,504,494,10,114,2,0.149797571,0,hg38,CD-0722-4
"C2,H3",7730,8246,5625,2621,4311,2156,0,2157,1354,803,1.686176837,1189,2146,354,133,132,1,48,1,0.234848485,0,empty,CD-0722-4
"C2,H4",993465,1070110,775412,294698,513872,234525,1,234721,187592,47129,3.980394237,128397,2695,618,259,259,0,65,0,0.019305019,0,hg38,CD-0722-4
"C2,H5",11843,13007,8748,4259,6590,3264,0,3266,2137,1129,1.892825509,1824,3136,839,340,339,1,87,1,0.032448378,0,empty,CD-0722-4
"C2,H6",395714,477082,271431,205651,244796,157452,1,157563,60542,97021,0.624009235,99188,23565,13311,1869,1866,3,387,3,0.068595927,0,empty,CD-0722-4
"C2,H7",8827,9846,6481,3365,5109,2546,0,2548,1609,939,1.713525027,1435,2193,645,252,252,0,61,0,0.023809524,0,empty,CD-0722-4
"C2,H8",10181,11420,7395,4025,5863,3040,0,3041,1899,1142,1.662872154,1766,2861,725,308,307,1,85,1,0.052117264,0,empty,CD-0722-4
"C2,H9",8269,8929,6373,2556,4647,2212,0,2214,1509,705,2.140425532,1182,1528,462,187,187,0,53,0,0.042780749,0,empty,CD-0722-4
"C2,H10",6432,7088,4797,2291,3665,1793,0,1793,1147,646,1.775541796,1021,1545,241,99,98,1,40,1,0.163265306,0,empty,CD-0722-4
"C2,H11",8904,10246,6041,4205,5407,3308,6,3315,1705,1610,1.059006211,2040,57,4,2,2,0,1,0,0,0,empty,CD-0722-4
"C2,H12",7497,8146,5379,2767,4291,2212,5,2224,1505,719,2.093184979,1265,1759,298,109,106,3,31,3,0.028301887,0,empty,CD-0722-4
"C3,A1",6457,6866,4729,2137,3651,1817,1,1828,1217,611,1.991816694,1004,1611,370,132,129,3,33,2,0.069767442,0,empty,CD-0722-4
"C3,A2",10684,11852,7837,4015,5923,3015,4,3021,1933,1088,1.776654412,1700,2419,457,190,188,2,47,1,0.042553191,0,empty,CD-0722-4
"C3,A3",6155,6722,4447,2275,3474,1723,13,1737,1093,644,1.697204969,985,1363,399,159,157,2,39,2,0.012738854,0,empty,CD-0722-4
"C3,A4",11166,12238,8339,3899,6312,3115,0,3121,1952,1169,1.669803251,1753,760,179,79,79,0,22,0,0.17721519,0,empty,CD-0722-4
"C3,A5",8752,9217,6592,2625,4782,2303,0,2304,1439,865,1.663583815,1182,2347,362,151,150,1,57,1,0.166666667,0,empty,CD-0722-4
"C3,A6",14514,16727,10837,5890,8432,4298,12,4315,3127,1188,2.632154882,2530,2760,593,224,221,3,76,2,0.036199095,0,empty,CD-0722-4
"C3,A7",6202,6871,4631,2240,3678,1869,0,1870,1204,666,1.807807808,1061,1372,320,122,120,2,37,1,0.083333333,0,empty,CD-0722-4
"C3,A8",3989,4350,2998,1352,2274,1130,0,1130,786,344,2.284883721,622,2516,432,187,184,3,60,2,0.032608696,0,empty,CD-0722-4
"C3,A9",6925,7759,5195,2564,3884,1882,0,1884,1188,696,1.706896552,1056,1789,371,169,168,1,50,1,0.06547619,0,empty,CD-0722-4
"C3,A10",8175,8834,6103,2731,4580,2319,5,2326,1486,840,1.769047619,1268,280,53,28,28,0,12,0,0.285714286,0,empty,CD-0722-4
"C3,A11",5666,6033,4328,1705,3128,1478,0,1482,948,534,1.775280899,792,1588,469,195,192,3,41,2,0.057291667,0,empty,CD-0722-4
"C3,A12",3921211,4580479,2800240,1780239,2131328,1339224,9,1340373,965255,375118,2.573203632,790056,470521,58973,23048,22478,570,2799,11,0.035545867,0,hg38,CD-0722-4
"C3,B1",7039,7828,5252,2576,4018,2039,0,2045,1245,800,1.55625,1155,1466,351,136,135,1,43,1,0,0,empty,CD-0722-4
"C3,B2",8263,8887,5746,3141,4685,2563,0,2563,1625,938,1.732409382,1485,722,124,38,37,1,12,1,0,0,empty,CD-0722-4
"C3,B3",766497,875370,587118,288252,428313,213355,3,213560,160139,53421,2.997678815,123965,31593,7203,2851,2811,40,549,6,0.050871576,0,hg38,CD-0722-4
"C3,B4",6174,6993,4535,2458,3670,1929,1,1931,1204,727,1.656121045,1115,1605,284,103,103,0,37,0,0.058252427,0,empty,CD-0722-4
"C3,B5",9262,6848,4396,2452,4049,2118,0,2123,1506,617,2.440842788,1278,1008,159,78,77,1,24,1,0.038961039,0,empty,CD-0722-4
"C3,B6",648293,792211,466243,325968,391310,235773,25,235979,183756,52223,3.518679509,145350,5723,1875,683,679,4,186,1,0.06921944,0,hg38,CD-0722-4
"C3,B7",7761,8482,5959,2523,4354,2048,0,2048,1356,692,1.959537572,1058,1315,413,151,148,3,30,2,0.128378378,0,empty,CD-0722-4
"C3,B8",4907,5234,3690,1544,2843,1338,5,1347,819,528,1.551136364,759,1408,296,141,140,1,33,1,0.035714286,0,empty,CD-0722-4
"C3,B9",15519,16837,11801,5036,8451,4047,0,4053,2728,1325,2.058867925,2171,1450,305,137,136,1,34,1,0.147058824,0,empty,CD-0722-4
"C3,B10",805788,869461,562214,307247,452856,239545,15,240258,191299,48959,3.907330624,141851,44878,5807,2247,2200,47,453,3,0.061363636,0,hg38,CD-0722-4
"C3,B11",10324,11444,7650,3794,5935,3201,0,3204,1794,1410,1.272340426,1781,221,40,13,13,0,6,0,0,0,empty,CD-0722-4
"C3,B12",782407,928384,567824,360560,456737,259824,9,260078,202702,57376,3.532870887,157781,129220,22915,8493,8349,144,1377,6,0.042879387,0,hg38,CD-0722-4
"C3,C1",13531,14065,10105,3960,7305,3423,1,3426,2198,1228,1.78990228,1820,1333,320,132,129,3,37,2,0.007751938,0,empty,CD-0722-4
"C3,C2",10852,11602,7999,3603,6024,3054,0,3058,2026,1032,1.963178295,1698,2220,656,243,243,0,61,0,0.111111111,0,empty,CD-0722-4
"C3,C3",10736,11938,7876,4062,6352,3172,5,3180,1932,1248,1.548076923,1876,952,247,102,97,5,32,1,0,0,empty,CD-0722-4
"C3,C4",6930,7341,5216,2125,3767,1708,0,1710,1125,585,1.923076923,887,1931,446,154,152,2,50,2,0.032894737,0,empty,CD-0722-4
"C3,C5",12120,13193,9083,4110,7037,3457,0,3464,2405,1059,2.271010387,1934,1945,351,155,152,3,45,1,0.059210526,0,empty,CD-0722-4
"C3,C6",10497,11516,7661,3855,6164,3151,0,3154,2155,999,2.157157157,1800,1534,343,145,144,1,51,1,0.034722222,0,empty,CD-0722-4
"C3,C7",1000390,1175064,733721,441343,569816,319475,5,319753,256482,63271,4.053705489,191860,27781,3876,1539,1525,14,313,2,0.112131148,0,hg38,CD-0722-4
"C3,C8",11839,12777,8900,3877,6551,3175,0,3180,2003,1177,1.701784197,1644,3001,750,298,297,1,84,1,0.016835017,0,empty,CD-0722-4
"C3,C9",8609,9769,6432,3337,5035,2484,0,2489,1522,967,1.573940021,1460,1355,193,66,66,0,19,0,0.212121212,0,empty,CD-0722-4
"C3,C10",10136,11093,7437,3656,5572,2759,0,2762,1743,1019,1.710500491,1537,2092,455,181,177,4,44,2,0,0,empty,CD-0722-4
"C3,C11",9335,10545,6942,3603,5319,2650,5,2655,1710,945,1.80952381,1490,2792,776,290,288,2,73,2,0.027777778,0,empty,CD-0722-4
"C3,C12",12013,12787,8820,3967,6775,3328,1,3344,2228,1116,1.996415771,1869,1891,503,199,197,2,53,1,0.081218274,0,empty,CD-0722-4
"C3,D1",10301,11171,7464,3707,5916,3030,1,3033,1878,1155,1.625974026,1740,760,195,86,85,1,19,1,0,0,empty,CD-0722-4
"C3,D2",9223,10122,6978,3144,5174,2427,1,2428,1507,921,1.636264929,1360,3133,969,364,363,1,104,1,0.044077135,0,empty,CD-0722-4
"C3,D3",974077,1097751,734173,363578,532299,276682,3,276962,218833,58129,3.764609747,158432,100450,15352,5756,5621,135,902,3,0.048212062,0,hg38,CD-0722-4
"C3,D4",5792,6467,4293,2174,3361,1678,0,1680,1069,611,1.749590835,979,1255,228,112,109,3,36,1,0.082568807,0,empty,CD-0722-4
"C3,D5",6782,7172,5156,2016,3777,1772,0,1774,1140,634,1.798107256,954,1713,529,196,196,0,47,0,0.137755102,0,empty,CD-0722-4
"C3,D6",825684,949134,610744,338390,464532,247961,3,248189,192553,55636,3.460942555,147178,72750,18905,7331,7273,58,1122,3,0.047573216,0,hg38,CD-0722-4
"C3,D7",5769,6126,4321,1805,3183,1441,1,1442,971,471,2.061571125,795,2067,588,211,207,4,47,1,0.09178744,0,empty,CD-0722-4
"C3,D8",7184,7802,5437,2365,4045,1951,0,1951,1279,672,1.90327381,1092,1473,440,151,150,1,41,1,0.113333333,0,empty,CD-0722-4
"C3,D9",3649,4045,2757,1288,2081,983,0,983,591,392,1.507653061,543,1649,465,191,189,2,57,1,0.015873016,0,empty,CD-0722-4
"C3,D10",1007771,1212292,726425,485867,592228,341796,3,342055,273332,68723,3.977300176,210299,112519,18029,7324,7178,146,1167,3,0.067010309,0,hg38,CD-0722-4
"C3,D11",7612,8399,5753,2646,4363,2116,5,2125,1331,794,1.676322418,1183,2762,782,279,276,3,67,2,0.079710145,0,empty,CD-0722-4
"C3,D12",10843,11864,8044,3820,6038,2967,1,2972,1945,1027,1.893865628,1656,3678,1024,355,349,6,82,2,0.134670487,0,empty,CD-0722-4
"C3,E1",12228,13413,9055,4358,6910,3421,22,3449,2173,1276,1.702978056,1940,2656,509,233,233,0,63,0,0.064377682,0,empty,CD-0722-4
"C3,E2",9005,9638,6584,3054,5028,2437,0,2445,1521,924,1.646103896,1389,1848,330,122,122,0,43,0,0.06557377,0,empty,CD-0722-4
"C3,E3",6237,6818,4666,2152,3622,1754,0,1754,1129,625,1.8064,1013,2307,652,228,224,4,58,2,0.040178571,0,empty,CD-0722-4
"C3,E4",8165,8629,5984,2645,4640,2271,4,2276,1483,793,1.870113493,1280,2568,614,226,221,5,67,2,0.031674208,0,empty,CD-0722-4
"C3,E5",8326,9085,6251,2834,4601,2185,11,2198,1441,757,1.903566711,1228,1371,271,112,112,0,39,0,0.0625,0,empty,CD-0722-4
"C3,E6",13155,14612,9793,4819,7429,3761,0,3764,2325,1439,1.615705351,2157,3550,994,370,370,0,95,0,0.140540541,0,empty,CD-0722-4
"C3,E7",1012612,1166297,749114,417183,559679,305493,3,305725,245321,60404,4.061336998,177776,129551,25861,10037,9885,152,1484,7,0.080323723,0,hg38,CD-0722-4
"C3,E8",10433,11147,7839,3308,5802,2750,0,2752,1882,870,2.163218391,1542,3015,889,267,267,0,74,0,0.011235955,0,empty,CD-0722-4
"C3,E9",5637,6181,4226,1955,3232,1572,1,1575,1041,534,1.949438202,891,2208,371,174,174,0,52,0,0.022988506,0,empty,CD-0722-4
"C3,E10",7400,8097,5478,2619,4141,2027,1,2028,1378,650,2.12,1151,2118,523,200,199,1,52,1,0.050251256,0,empty,CD-0722-4
"C3,E11",8624,9365,6375,2990,4994,2503,0,2506,1628,878,1.854214123,1429,2105,661,248,248,0,52,0,0.096774194,0,empty,CD-0722-4
"C3,E12",9040,9645,6653,2992,5083,2492,0,2496,1558,938,1.66098081,1395,1742,342,163,163,0,50,0,0.036809816,0,empty,CD-0722-4
"C3,F1",10712,11450,7871,3579,5880,2856,0,2858,1830,1028,1.780155642,1571,2421,706,297,293,4,65,2,0.092150171,0,empty,CD-0722-4
"C3,F2",8385,8945,6208,2737,4629,2231,1,2232,1437,795,1.80754717,1244,2979,851,280,277,3,68,1,0.122743682,0,empty,CD-0722-4
"C3,F3",20136,22369,15430,6939,10845,5088,4,5092,3720,1372,2.711370262,2808,3795,846,267,265,2,78,2,0.128301887,0,empty,CD-0722-4
"C3,F4",1076655,1175208,830776,344432,567584,267984,8,268300,203361,64939,3.131569627,150657,34005,2946,1198,1159,39,248,4,0.077653149,0,hg38,CD-0722-4
"C3,F5",10020,10874,7498,3376,5618,2582,0,2589,1644,945,1.73968254,1425,2543,491,150,148,2,58,1,0.033783784,0,empty,CD-0722-4
"C3,F6",9440,10298,6937,3361,5393,2736,7,2745,1768,977,1.80962129,1573,2914,724,310,306,4,98,2,0.062091503,0,empty,CD-0722-4
"C3,F7",11029,11789,8208,3581,6350,3081,0,3081,2049,1032,1.985465116,1717,1311,428,154,152,2,40,1,0.125,0,empty,CD-0722-4
"C3,F8",7821,8589,6007,2582,4471,2175,0,2175,1407,768,1.83203125,1186,245,30,21,21,0,12,0,0.047619048,0,empty,CD-0722-4
"C3,F9",8567,9167,6507,2660,4831,2279,0,2281,1487,794,1.87279597,1255,3078,785,287,286,1,82,1,0.087412587,0,empty,CD-0722-4
"C3,F10",11290,12205,8489,3716,6285,2998,0,2998,1954,1044,1.87164751,1620,1565,338,149,144,5,39,1,0.0625,0,empty,CD-0722-4
"C3,F11",8360,8928,6348,2580,4676,2177,0,2177,1457,720,2.023611111,1237,1815,368,140,138,2,39,1,0.101449275,0,empty,CD-0722-4
"C3,F12",9941,10523,7130,3393,5579,2788,1,2791,1846,945,1.953439153,1591,375,82,20,20,0,9,0,0.05,0,empty,CD-0722-4
"C3,G1",10626,11553,7858,3695,6027,2929,0,2934,1871,1063,1.760112888,1704,2946,539,234,227,7,70,2,0.118942731,0,empty,CD-0722-4
"C3,G2",6084,6684,4323,2361,3425,1769,0,1769,1103,666,1.656156156,1035,369,123,56,55,1,21,1,0.054545455,0,empty,CD-0722-4
"C3,G3",855689,968702,640335,328367,467916,242625,3,242865,176337,66528,2.650568182,143343,103119,12740,5080,4934,146,965,8,0.052087556,0,hg38,CD-0722-4
"C3,G4",20457,23036,14818,8218,11623,6335,7,6356,3840,2516,1.526232114,3675,75,17,7,7,0,5,0,0.285714286,0,empty,CD-0722-4
"C3,G5",7490,8516,5606,2910,4282,2134,0,2136,1384,752,1.840425532,1241,1766,387,174,173,1,46,1,0.132947977,0,empty,CD-0722-4
"C3,G6",954361,1006013,756340,249673,481923,205718,2,205927,169491,36436,4.651745526,108984,3496,977,321,320,1,74,1,0.003125,0,hg38,CD-0722-4
"C3,G7",8377,8941,6496,2445,4708,2140,0,2148,1435,713,2.012622721,1135,3197,471,228,223,5,77,2,0.058295964,0,empty,CD-0722-4
"C3,G8",6203,6657,4607,2050,3413,1642,0,1644,1029,615,1.673170732,889,2431,565,192,191,1,55,1,0.157068063,0,empty,CD-0722-4
"C3,G9",7264,7954,5455,2499,3996,1982,0,1982,1289,693,1.86002886,1089,2730,543,214,206,8,73,2,0.082524272,0,empty,CD-0722-4
"C3,G10",798235,907188,600107,307081,443897,232083,3,232323,185993,46330,4.014526225,133346,120914,28963,11331,11186,145,1681,6,0.03379224,0,hg38,CD-0722-4
"C3,G11",8552,9200,6542,2658,4724,2193,0,2197,1467,730,2.009589041,1195,1584,518,192,192,0,43,0,0.036458333,0,empty,CD-0722-4
"C3,G12",7232,8042,5185,2857,4204,2163,13,2178,1335,843,1.583629893,1285,1965,527,223,221,2,52,1,0.07239819,0,empty,CD-0722-4
"C3,H1",7160,7579,5214,2365,3991,1886,0,1887,1225,662,1.850453172,1050,1126,288,99,97,2,27,1,0.092783505,0,empty,CD-0722-4
"C3,H2",8834,9901,6349,3552,5183,2684,1,2685,1760,925,1.902702703,1592,2647,739,261,261,0,57,0,0.084291188,0,empty,CD-0722-4
"C3,H3",6564,7441,4800,2641,3902,1960,0,1960,1251,709,1.764456982,1196,1851,394,166,163,3,41,2,0.147239264,0,empty,CD-0722-4
"C3,H4",10540,11597,7894,3703,5908,2882,14,2909,1849,1060,1.744339623,1614,167,62,24,24,0,7,0,0,0,empty,CD-0722-4
"C3,H5",11474,12458,8394,4064,6386,3221,5,3234,2106,1128,1.867021277,1830,2164,651,230,230,0,52,0,0.030434783,0,empty,CD-0722-4
"C3,H6",6497,7177,4798,2379,3749,1939,0,1939,1246,693,1.797979798,1089,1660,551,244,242,2,63,1,0.074380165,0,empty,CD-0722-4
"C3,H7",7944,8615,5798,2817,4621,2304,8,2320,1570,750,2.093333333,1337,2079,536,184,179,5,55,1,0.106145251,0,empty,CD-0722-4
"C3,H8",8475,9457,6270,3187,4903,2492,0,2498,1578,920,1.715217391,1445,3355,703,240,239,1,61,1,0.259414226,0,empty,CD-0722-4
"C3,H9",6846,7206,5191,2015,3654,1699,2,1701,1126,575,1.95826087,910,1123,256,116,115,1,35,1,0.026086957,0,empty,CD-0722-4
"C3,H10",5789,6396,4364,2032,3256,1578,0,1581,1013,568,1.783450704,892,1513,326,122,121,1,28,1,0.074380165,0,empty,CD-0722-4
"C3,H11",7786,8643,5429,3214,4468,2653,16,2671,1469,1202,1.222129784,1557,15,0,0,0,0,0,0,0,0,empty,CD-0722-4
"C3,H12",6189,6908,4431,2477,3589,1861,0,1862,1187,675,1.758518519,1112,1291,299,104,100,4,31,1,0.04,0,empty,CD-0722-4
"C4,A1",7224,8256,5230,3026,4281,2224,7,2235,1435,800,1.79375,1320,1281,234,116,112,4,39,2,0.026785714,0,empty,CD-0722-4
"C4,A2",11147,12447,8156,4291,6466,3342,0,3349,2095,1254,1.670653907,1950,2341,586,253,252,1,69,1,0.043650794,0,empty,CD-0722-4
"C4,A3",2108671,2448417,1560438,887979,1164121,644810,1,645376,500806,144570,3.464107353,383990,285705,43023,16878,16539,339,2283,6,0.062881674,0,hg38,CD-0722-4
"C4,A4",11977,12930,9054,3876,6635,3242,3,3245,2071,1174,1.764054514,1720,1551,372,119,119,0,31,0,0.033613445,0,empty,CD-0722-4
"C4,A5",10258,10938,7583,3355,5797,2819,0,2821,1774,1047,1.694364852,1592,2806,502,214,211,3,67,2,0.104265403,0,empty,CD-0722-4
"C4,A6",20075,22863,15100,7763,11457,5742,1,5747,4168,1579,2.639645345,3314,3323,799,320,315,5,90,2,0.082539683,0,empty,CD-0722-4
"C4,A7",7415,8113,5340,2773,4245,2217,0,2219,1425,794,1.794710327,1288,1239,319,128,128,0,37,0,0.0859375,0,empty,CD-0722-4
"C4,A8",1207716,1444739,885437,559302,708968,402926,0,403238,325056,78182,4.157683354,243604,291476,56798,22131,21765,366,2691,8,0.045669653,0,hg38,CD-0722-4
"C4,A9",1887237,2186232,1414156,772076,1046095,572185,8,572689,459950,112739,4.079777184,333450,285001,43602,16968,16609,359,2208,9,0.060689987,0,hg38,CD-0722-4
"C4,A10",9604,10144,7337,2807,5334,2535,0,2538,1634,904,1.807522124,1336,478,128,59,58,1,21,1,0,0,empty,CD-0722-4
"C4,A11",897987,1032290,670850,361440,504006,272115,6,272380,229089,43291,5.29183895,157327,49109,8544,3263,3211,52,656,3,0.055745874,0,hg38,CD-0722-4
"C4,A12",10230,10987,7887,3100,5620,2612,1,2617,1765,852,2.071596244,1368,5157,1108,457,453,4,113,2,0.077262693,0,empty,CD-0722-4
"C4,B1",8059,8885,5933,2952,4567,2356,1,2360,1452,908,1.599118943,1330,1477,307,143,141,2,55,1,0.028368794,0,empty,CD-0722-4
"C4,B2",10654,11477,7492,3985,5997,3173,0,3177,2091,1086,1.925414365,1761,699,101,36,36,0,15,0,0.166666667,0,empty,CD-0722-4
"C4,B3",6673,7696,4872,2824,4013,2061,0,2061,1320,741,1.781376518,1248,1690,326,106,104,2,43,1,0.125,0,empty,CD-0722-4
"C4,B4",8276,9287,5905,3382,4852,2620,0,2628,1587,1041,1.524495677,1568,1647,526,177,173,4,47,2,0.023121387,0,empty,CD-0722-4
"C4,B5",15791,13806,8938,4868,7851,4110,0,4119,3125,994,3.143863179,2483,1319,325,106,105,1,28,1,0.00952381,0,empty,CD-0722-4
"C4,B6",9274,10315,6782,3533,5353,2836,0,2837,1769,1068,1.656367041,1577,2165,417,164,164,0,57,0,0.079268293,0,empty,CD-0722-4
"C4,B7",8409,9221,6435,2786,4763,2330,0,2331,1553,778,1.996143959,1264,1708,409,186,185,1,51,1,0.064864865,0,empty,CD-0722-4
"C4,B8",6395,6932,4945,1987,3607,1686,3,1691,1111,580,1.915517241,913,1633,290,114,110,4,39,3,0.118181818,0,empty,CD-0722-4
"C4,B9",11265,12623,8233,4390,6568,3417,4,3422,2013,1409,1.428672818,2022,1114,286,128,126,2,41,2,0.015873016,0,empty,CD-0722-4
"C4,B10",5985,6439,4207,2232,3450,1750,0,1752,1128,624,1.807692308,1006,1185,273,107,106,1,31,1,0.018867925,0,empty,CD-0722-4
"C4,B11",12662,14008,9024,4984,7252,3980,12,3992,2236,1756,1.273348519,2308,401,88,34,34,0,14,0,0,0,empty,CD-0722-4
"C4,B12",7095,7936,5248,2688,4186,2086,0,2088,1338,750,1.784,1210,2814,557,194,189,5,59,2,0.052910053,0,empty,CD-0722-4
"C4,C1",866888,932628,675175,257453,450166,205209,21,205442,155173,50269,3.086852732,112196,66410,6361,2637,2551,86,480,5,0.089376715,0,hg38,CD-0722-4
"C4,C2",11413,12438,8272,4166,6383,3228,0,3234,2079,1155,1.8,1829,3076,736,293,289,4,78,2,0.076124567,0,empty,CD-0722-4
"C4,C3",12250,13663,9141,4522,7004,3460,0,3464,2142,1322,1.620272315,1952,1275,251,106,105,1,30,1,0.00952381,0,empty,CD-0722-4
"C4,C4",835311,935266,637965,297301,458109,227911,1,228148,170811,57337,2.979071106,130512,101201,13967,5495,5368,127,900,9,0.051415797,0,hg38,CD-0722-4
"C4,C5",10462,11644,7817,3827,6017,2956,8,2969,1860,1109,1.677186655,1702,1672,244,105,104,1,38,1,0.115384615,0,empty,CD-0722-4
"C4,C6",9932,10982,7345,3637,5768,2919,0,2923,1844,1079,1.708989805,1661,2011,649,241,239,2,52,1,0.09623431,0,empty,CD-0722-4
"C4,C7",12779,14753,9086,5667,7518,4183,14,4204,2472,1732,1.427251732,2547,602,106,51,51,0,20,0,0.117647059,0,empty,CD-0722-4
"C4,C8",14329,15855,10552,5303,8131,4129,0,4136,2674,1462,1.829001368,2340,3226,728,300,296,4,80,2,0.033783784,0,empty,CD-0722-4
"C4,C9",1167412,1375394,858482,516912,666437,375624,0,375916,309751,66165,4.681493237,225542,102056,13057,5110,5007,103,916,4,0.054723387,0,hg38,CD-0722-4
"C4,C10",10697,11763,8083,3680,6106,2901,0,2906,1880,1026,1.832358674,1622,3016,614,232,229,3,69,2,0.152838428,0,empty,CD-0722-4
"C4,C11",9748,10944,7206,3738,5655,2860,0,2860,1837,1023,1.795698925,1694,2213,549,206,200,6,64,2,0.1,0,empty,CD-0722-4
"C4,C12",13572,14373,10061,4312,7520,3604,14,3619,2326,1293,1.798917247,1975,2978,534,196,196,0,65,0,0.071428571,0,empty,CD-0722-4
"C4,D1",1266188,1454363,946553,507810,700073,374636,4,374961,300611,74350,4.043187626,219060,21343,1670,671,659,12,194,2,0.051593323,0,hg38,CD-0722-4
"C4,D2",9904,10547,7453,3094,5447,2507,1,2516,1597,919,1.737758433,1404,2771,744,250,242,8,60,2,0.008264463,0,empty,CD-0722-4
"C4,D3",8910,9759,6586,3173,5115,2584,0,2586,1687,899,1.876529477,1442,1720,346,147,146,1,46,1,0.089041096,0,empty,CD-0722-4
"C4,D4",6660,7453,4998,2455,3884,1922,0,1922,1236,686,1.801749271,1076,1919,310,126,125,1,37,1,0.032,0,empty,CD-0722-4
"C4,D5",7426,8146,5410,2736,4305,2107,1,2113,1386,727,1.906464924,1216,1959,435,172,170,2,45,1,0.147058824,0,empty,CD-0722-4
"C4,D6",11996,13088,8632,4456,6701,3577,9,3590,2166,1424,1.521067416,2011,2674,588,224,222,2,64,1,0.081081081,0,empty,CD-0722-4
"C4,D7",6635,7190,4939,2251,3905,1865,0,1869,1198,671,1.785394933,1082,2187,389,158,154,4,55,1,0.064935065,0,empty,CD-0722-4
"C4,D8",9045,9872,6642,3230,5281,2638,0,2638,1704,934,1.824411135,1530,2161,600,224,217,7,48,2,0.184331797,0,empty,CD-0722-4
"C4,D9",4424,4533,3395,1138,2429,1150,0,1150,730,420,1.738095238,607,2337,470,200,200,0,49,0,0.055,0,empty,CD-0722-4
"C4,D10",8754,9799,6355,3444,5140,2629,4,2635,1682,953,1.764952781,1587,964,177,66,66,0,20,0,0.045454545,0,empty,CD-0722-4
"C4,D11",8671,9352,6514,2838,4941,2375,14,2390,1512,878,1.722095672,1310,2908,695,261,251,10,70,2,0.055776892,0,empty,CD-0722-4
"C4,D12",11412,12854,8489,4365,6587,3258,1,3266,2107,1159,1.817946506,1862,4816,1292,506,502,4,123,1,0.097609562,0,empty,CD-0722-4
"C4,E1",192400,219767,148821,70946,107609,55107,0,55160,43400,11760,3.69047619,30759,10142,2392,1014,1008,6,265,2,0.020833333,0,empty,CD-0722-4
"C4,E2",891006,972160,685040,287120,472860,227845,4,228080,173448,54632,3.174842583,127903,33139,6845,2666,2643,23,525,2,0.023079834,0,hg38,CD-0722-4
"C4,E3",6581,7575,4975,2600,3928,1971,0,1973,1249,724,1.725138122,1165,3049,733,282,280,2,74,2,0.117857143,0,empty,CD-0722-4
"C4,E4",980584,1155707,717742,437965,559530,313826,0,314081,251913,62168,4.05213293,189093,266459,36551,14284,14008,276,1972,8,0.0736008,0,hg38,CD-0722-4
"C4,E5",1009020,1122726,766175,356551,542222,275198,9,275517,210229,65288,3.220025119,154505,34212,4247,1702,1674,28,436,3,0.014934289,0,hg38,CD-0722-4
"C4,E6",15716,16971,11888,5083,8762,4286,0,4289,2730,1559,1.751122514,2356,5093,1246,447,439,8,120,1,0.038724374,0,empty,CD-0722-4
"C4,E7",1093310,1248306,822284,426022,596865,313413,1,313709,252823,60886,4.152399566,181014,211136,46535,17993,17755,238,2265,8,0.084708533,0,hg38,CD-0722-4
"C4,E8",1132189,1270075,872261,397814,613537,308169,1,308476,245494,62982,3.897843828,172331,61383,6062,2397,2329,68,577,4,0.025332761,0,hg38,CD-0722-4
"C4,E9",7117,7650,5375,2275,3929,1867,0,1871,1186,685,1.731386861,973,3024,637,227,226,1,65,1,0.137168142,0,empty,CD-0722-4
"C4,E10",8143,9086,6015,3071,4581,2179,1,2180,1419,761,1.864651774,1269,2008,472,178,178,0,48,0,0.134831461,0,empty,CD-0722-4
"C4,E11",1173663,1359254,876300,482954,660109,358656,1,358979,281033,77946,3.605483283,210197,114178,20452,7913,7814,99,1359,6,0.062324034,0,hg38,CD-0722-4
"C4,E12",9786,10861,7257,3604,5695,2787,36,2825,1864,961,1.939646202,1645,2160,389,166,160,6,61,2,0.03125,0,empty,CD-0722-4
"C4,F1",1116508,1276796,827632,449164,615598,330565,6,330932,270398,60534,4.466878118,192855,292895,57586,22392,22069,323,2557,12,0.070007703,0,hg38,CD-0722-4
"C4,F2",9342,10026,6887,3139,5214,2472,0,2476,1574,902,1.745011086,1415,4545,979,379,372,7,87,2,0.069892473,0,empty,CD-0722-4
"C4,F3",9460,10621,7106,3515,5379,2592,1,2598,1675,923,1.814734561,1485,3766,1082,450,449,1,95,1,0.04454343,0,empty,CD-0722-4
"C4,F4",13905,15040,10416,4624,7814,3722,1,3728,2454,1274,1.926216641,2093,820,118,65,65,0,19,0,0.046153846,0,empty,CD-0722-4
"C4,F5",10672,11303,8093,3210,5912,2721,1,2731,1744,987,1.766970618,1455,2720,650,289,279,10,76,2,0.089605735,0,empty,CD-0722-4
"C4,F6",11948,13277,8531,4746,6824,3633,0,3633,2349,1284,1.829439252,2152,3755,746,342,339,3,103,1,0.115044248,0,empty,CD-0722-4
"C4,F7",11911,12984,8914,4070,6885,3394,1,3395,2134,1261,1.692307692,1891,1044,261,111,109,2,34,2,0.073394495,0,empty,CD-0722-4
"C4,F8",824164,1000964,575815,425149,499284,318226,1,318477,248900,69577,3.577331589,194825,819,295,82,82,0,34,0,0.085365854,0,empty,CD-0722-4
"C4,F9",9521,10333,7277,3056,5358,2542,0,2545,1736,809,2.145859085,1400,3728,1004,408,406,2,104,2,0.088669951,0,empty,CD-0722-4
"C4,F10",11992,13215,9034,4181,6858,3240,0,3241,2043,1198,1.705342237,1905,2049,390,183,176,7,55,2,0,0,empty,CD-0722-4
"C4,F11",9787,10532,7409,3123,5401,2476,0,2479,1623,856,1.896028037,1387,2033,306,161,161,0,51,0,0.204968944,0,empty,CD-0722-4
"C4,F12",10668,11591,7759,3832,5985,2910,1,2913,1917,996,1.924698795,1685,350,48,32,29,3,16,1,0.137931034,0,empty,CD-0722-4
"C4,G1",22212,24964,16896,8068,12656,6211,0,6223,4304,1919,2.24283481,3458,3367,960,412,411,1,100,1,0.053527981,0,empty,CD-0722-4
"C4,G2",6612,7141,4736,2405,3791,1962,8,1974,1239,735,1.685714286,1130,443,199,90,90,0,21,0,0.188888889,0,empty,CD-0722-4
"C4,G3",1057231,1253296,767978,485318,608587,348160,6,348431,279398,69033,4.047310706,210127,209398,34643,13901,13646,255,1863,9,0.040378133,0,hg38,CD-0722-4
"C4,G4",22037,24764,15945,8819,12599,6890,0,6899,4269,2630,1.623193916,4014,111,34,20,20,0,8,0,0.4,0,empty,CD-0722-4
"C4,G5",7185,7925,5313,2612,4209,2157,0,2158,1388,770,1.802597403,1223,1590,400,149,148,1,38,1,0.067567568,0,empty,CD-0722-4
"C4,G6",11021,11978,8305,3673,6086,2885,5,2890,1969,921,2.137893594,1590,377,114,49,48,1,20,1,0,0,empty,CD-0722-4
"C4,G7",9304,10037,7074,2963,5236,2380,0,2385,1566,819,1.912087912,1318,5694,1237,497,486,11,148,3,0.090534979,0,empty,CD-0722-4
"C4,G8",6831,7524,4967,2557,3936,1946,0,1946,1265,681,1.857562408,1102,1855,276,124,124,0,47,0,0.096774194,0,empty,CD-0722-4
"C4,G9",8097,8662,6035,2627,4537,2228,7,2235,1476,759,1.944664032,1244,2867,551,264,261,3,81,2,0.149425287,0,empty,CD-0722-4
"C4,G10",10185,11365,7530,3835,5833,3017,0,3021,1965,1056,1.860795455,1738,3520,1022,406,402,4,104,2,0.017412935,0,empty,CD-0722-4
"C4,G11",1067777,1210135,812237,397898,585246,301207,3,301471,229953,71518,3.215316424,173322,26481,2788,1108,1080,28,313,5,0.006481481,0,hg38,CD-0722-4
"C4,G12",8213,9164,6104,3060,4761,2410,0,2413,1478,935,1.580748663,1385,2106,529,233,232,1,55,1,0.012931034,0,empty,CD-0722-4
"C4,H1",888692,1003998,672988,331010,490934,248972,1,249281,187777,61504,3.053085978,144000,54301,7872,3032,2978,54,549,5,0.036601746,0,hg38,CD-0722-4
"C4,H2",9461,10388,6912,3476,5237,2518,55,2581,1712,869,1.970080552,1441,2536,538,235,232,3,59,2,0.103448276,0,empty,CD-0722-4
"C4,H3",7819,8600,5683,2917,4488,2270,1,2274,1480,794,1.863979849,1302,1665,303,112,111,1,50,1,0.054054054,0,empty,CD-0722-4
"C4,H4",10930,11942,8114,3828,6097,2888,11,2905,1880,1025,1.834146341,1654,242,87,24,24,0,12,0,0,0,empty,CD-0722-4
"C4,H5",12446,13646,9204,4442,6993,3506,0,3509,2269,1240,1.82983871,1961,2505,577,250,248,2,66,1,0.088709677,0,empty,CD-0722-4
"C4,H6",8091,8820,5924,2896,4581,2291,0,2292,1545,747,2.068273092,1293,2110,426,147,144,3,52,2,0.006944444,0,empty,CD-0722-4
"C4,H7",8695,9309,6522,2787,5009,2396,0,2396,1554,842,1.845605701,1333,2027,709,289,285,4,63,2,0.168421053,0,empty,CD-0722-4
"C4,H8",10342,11438,7655,3783,5856,2909,0,2918,1865,1053,1.771130104,1665,2944,596,221,215,6,78,2,0.069767442,0,empty,CD-0722-4
"C4,H9",7977,8664,6117,2547,4405,2037,0,2038,1363,675,2.019259259,1121,1740,393,142,138,4,37,2,0.115942029,0,empty,CD-0722-4
"C4,H10",6610,7546,4926,2620,3860,1949,0,1949,1304,645,2.021705426,1147,1664,244,121,116,5,36,2,0.017241379,0,empty,CD-0722-4
"C4,H11",9690,11611,6747,4864,5808,3524,0,3527,1897,1630,1.163803681,2151,118,48,18,18,0,3,0,0,0,empty,CD-0722-4
"C4,H12",7633,8181,5540,2641,4282,2158,5,2172,1414,758,1.865435356,1216,2013,393,158,156,2,39,2,0.076923077,0,empty,CD-0722-4
"C5,A1",7087,7694,5287,2407,4128,2104,1,2106,1376,730,1.884931507,1157,1825,463,198,196,2,51,1,0.005102041,0,empty,CD-0722-4
"C5,A2",10244,11234,7455,3779,5782,3016,0,3017,1923,1094,1.757769653,1687,2193,541,232,228,4,67,2,0.096491228,0,empty,CD-0722-4
"C5,A3",7600,8147,5686,2461,4276,2093,0,2095,1402,693,2.023088023,1171,2107,342,143,143,0,45,0,0.027972028,0,empty,CD-0722-4
"C5,A4",11742,12772,8802,3970,6544,3119,0,3125,1939,1186,1.634907251,1764,929,84,44,41,3,15,1,0.073170732,0,empty,CD-0722-4
"C5,A5",9942,10616,7437,3179,5547,2638,0,2643,1692,951,1.779179811,1463,2948,642,272,269,3,88,2,0.05204461,0,empty,CD-0722-4
"C5,A6",11184,12454,8431,4023,6480,3244,12,3263,2174,1089,1.996326905,1815,3523,865,331,323,8,92,2,0.068111455,0,empty,CD-0722-4
"C5,A7",7026,7758,5161,2597,4055,2078,0,2084,1310,774,1.69250646,1162,1337,229,101,100,1,40,1,0.02,0,empty,CD-0722-4
"C5,A8",4590,5139,3428,1711,2546,1284,0,1285,871,414,2.103864734,691,2427,657,264,254,10,63,2,0.043307087,0,empty,CD-0722-4
"C5,A9",8038,8893,6074,2819,4480,2174,24,2198,1425,773,1.843467012,1180,2475,502,221,220,1,60,1,0.1,0,empty,CD-0722-4
"C5,A10",8716,9391,6631,2760,4761,2205,0,2207,1426,781,1.825864277,1188,433,74,41,40,1,15,1,0,0,empty,CD-0722-4
"C5,A11",6334,6641,4789,1852,3557,1608,0,1609,1045,564,1.852836879,836,1727,309,114,113,1,35,1,0.008849558,0,empty,CD-0722-4
"C5,A12",9115,9947,6868,3079,5111,2479,1,2484,1631,853,1.912075029,1389,4208,942,402,398,4,105,2,0.020100503,0,empty,CD-0722-4
"C5,B1",7749,8380,5731,2649,4399,2213,0,2217,1370,847,1.617473436,1203,1795,470,200,197,3,43,2,0.096446701,0,empty,CD-0722-4
"C5,B2",8599,9591,5840,3751,5016,2726,0,2729,1713,1016,1.686023622,1632,643,69,34,34,0,14,0,0,0,empty,CD-0722-4
"C5,B3",7033,7759,5213,2546,4165,2138,2,2144,1422,722,1.969529086,1258,1667,523,228,224,4,57,1,0.169642857,0,empty,CD-0722-4
"C5,B4",1450291,1686020,1098795,587225,809022,438400,26,438826,374235,64591,5.793918657,255025,172547,26014,10495,10300,195,1632,5,0.057475728,0,hg38,CD-0722-4
"C5,B5",7934,4930,3151,1779,3156,1627,1,1636,1076,560,1.921428571,998,1302,342,113,112,1,32,1,0.116071429,0,empty,CD-0722-4
"C5,B6",809413,933369,596412,336957,452372,247733,1,247968,202782,45186,4.487717435,145277,61456,10862,4390,4327,63,824,6,0.072105385,0,hg38,CD-0722-4
"C5,B7",10002,10860,7538,3322,5734,2769,1,2770,1813,957,1.89446186,1617,2713,521,202,200,2,53,1,0.07,0,empty,CD-0722-4
"C5,B8",700590,779635,533427,246208,381343,187974,2,188193,144381,43812,3.295466995,106383,105696,16054,6045,5923,122,978,7,0.044572007,0,hg38,CD-0722-4
"C5,B9",10735,11758,7921,3837,6131,3129,0,3131,2034,1097,1.854147675,1764,1585,371,115,115,0,42,0,0.060869565,0,empty,CD-0722-4
"C5,B10",5697,6112,4124,1988,3261,1560,2,1565,1032,533,1.936210131,878,593,112,70,69,1,28,1,0.15942029,0,empty,CD-0722-4
"C5,B11",11846,12873,8617,4256,6625,3586,0,3591,1951,1640,1.189634146,2015,242,33,23,22,1,11,1,0.272727273,0,empty,CD-0722-4
"C5,B12",15724,17015,11360,5655,8555,4248,0,4256,3015,1241,2.429492345,2409,4004,1212,449,443,6,110,2,0.058690745,0,empty,CD-0722-4
"C5,C1",15016,15890,11120,4770,8187,3919,0,3924,2506,1418,1.767277856,2150,1794,560,161,159,2,51,1,0.018867925,0,empty,CD-0722-4
"C5,C2",37359,43023,28359,14664,20401,10457,1,10471,7138,3333,2.141614161,6027,2785,650,287,281,6,73,1,0.024911032,0,empty,CD-0722-4
"C5,C3",11812,13075,8806,4269,6735,3293,0,3294,2134,1160,1.839655172,1830,1189,270,102,97,5,32,2,0.175257732,0,empty,CD-0722-4
"C5,C4",7507,8130,5582,2548,4185,1930,0,1941,1257,684,1.837719298,1052,2155,428,204,201,3,51,2,0.07960199,0,empty,CD-0722-4
"C5,C5",10560,11644,7749,3895,5999,2944,0,2946,1979,967,2.046535677,1697,2369,443,182,181,1,49,1,0.193370166,0,empty,CD-0722-4
"C5,C6",9720,10792,7251,3541,5740,2911,1,2915,1943,972,1.998971193,1643,2751,609,216,211,5,55,2,0.104265403,0,empty,CD-0722-4
"C5,C7",12454,14039,8886,5153,7228,4002,0,4012,2358,1654,1.425634825,2398,558,193,73,73,0,12,0,0.04109589,0,empty,CD-0722-4
"C5,C8",13232,14328,9615,4713,7491,3826,3,3834,2483,1351,1.837897853,2171,3232,703,322,320,2,91,2,0.05625,0,empty,CD-0722-4
"C5,C9",9236,10178,6951,3227,5333,2589,0,2591,1629,962,1.693347193,1457,2114,500,191,190,1,53,1,0.142105263,0,empty,CD-0722-4
"C5,C10",11141,12362,8221,4141,6282,3089,1,3090,2032,1058,1.920604915,1765,2761,579,248,245,3,68,2,0.032653061,0,empty,CD-0722-4
"C5,C11",950571,1115396,680339,435057,544017,315580,11,315846,276168,39678,6.96022985,191003,180762,36535,14466,14324,142,1968,5,0.042446244,0,hg38,CD-0722-4
"C5,C12",13136,14097,9830,4267,7216,3326,14,3348,2268,1080,2.1,1860,1972,448,183,183,0,49,0,0.071038251,0,empty,CD-0722-4
"C5,D1",11407,12836,8203,4633,6613,3536,0,3539,2193,1346,1.629271917,2126,1042,124,62,62,0,20,0,0.112903226,0,empty,CD-0722-4
"C5,D2",10040,11020,7708,3312,5652,2565,5,2570,1639,931,1.76047261,1431,3607,1082,396,393,3,84,1,0.053435115,0,empty,CD-0722-4
"C5,D3",8789,9535,6369,3166,4966,2482,0,2482,1586,896,1.770089286,1457,1660,368,157,157,0,52,0,0.031847134,0,empty,CD-0722-4
"C5,D4",6590,7186,5018,2168,3783,1835,20,1856,1194,662,1.803625378,1020,1720,518,213,211,2,43,2,0.260663507,0,empty,CD-0722-4
"C5,D5",7174,7747,5322,2425,4085,1999,5,2005,1286,719,1.788595271,1122,1602,462,191,186,5,52,1,0.096774194,0,empty,CD-0722-4
"C5,D6",11847,13057,8404,4653,6657,3587,20,3610,2163,1447,1.494816862,2089,2354,740,300,299,1,74,1,0.120401338,0,empty,CD-0722-4
"C5,D7",6650,7171,5041,2130,3779,1775,1,1786,1115,671,1.661698957,964,3129,831,284,275,9,63,2,0.225454545,0,empty,CD-0722-4
"C5,D8",8289,9200,6188,3012,4732,2354,1,2358,1577,781,2.019206146,1353,1772,536,192,190,2,39,2,0.084210526,0,empty,CD-0722-4
"C5,D9",4304,4727,3206,1521,2350,1119,1,1122,723,399,1.812030075,603,1891,441,168,164,4,53,2,0.036585366,0,empty,CD-0722-4
"C5,D10",9237,10349,6717,3632,5276,2737,0,2742,1802,940,1.917021277,1642,1221,238,85,81,4,30,1,0.172839506,0,empty,CD-0722-4
"C5,D11",8463,9067,6251,2816,4715,2265,0,2271,1458,813,1.793357934,1264,4187,889,395,394,1,91,1,0.063451777,0,empty,CD-0722-4
"C5,D12",11518,12438,8668,3770,6354,3064,0,3069,2012,1057,1.903500473,1680,5594,1483,590,583,7,142,2,0.024013722,0,empty,CD-0722-4
"C5,E1",13848,15110,10267,4843,7800,3907,3,3913,2505,1408,1.779119318,2183,3345,830,342,337,5,101,3,0.03264095,0,empty,CD-0722-4
"C5,E2",17282,20877,12659,8218,10558,6051,0,6057,4568,1489,3.067830759,3677,2614,496,204,202,2,52,2,0.044554455,0,empty,CD-0722-4
"C5,E3",6812,7647,5147,2500,3927,1879,0,1880,1197,683,1.752562225,1077,2699,640,289,287,2,78,1,0.18815331,0,empty,CD-0722-4
"C5,E4",9057,10222,6554,3668,5318,2707,1,2712,1692,1020,1.658823529,1622,2966,757,251,249,2,91,2,0.004016064,0,empty,CD-0722-4
"C5,E5",8420,9137,6483,2654,4718,2189,0,2195,1443,752,1.918882979,1225,1288,288,103,103,0,33,0,0.048543689,0,empty,CD-0722-4
"C5,E6",14541,15552,10731,4821,7880,3978,0,3978,2563,1415,1.81130742,2191,3993,1120,420,417,3,99,2,0.064748201,0,empty,CD-0722-4
"C5,E7",18878,21186,14307,6879,10653,5445,1,5448,3888,1560,2.492307692,3057,3401,924,355,346,9,71,2,0.046242775,0,empty,CD-0722-4
"C5,E8",35937,37831,24535,13296,18628,10224,0,10237,6222,4015,1.549688667,5732,3730,1017,395,395,0,97,0,0.035443038,0,empty,CD-0722-4
"C5,E9",6367,6907,4738,2169,3570,1761,3,1764,1154,610,1.891803279,977,3439,688,276,270,6,75,2,0.103703704,0,empty,CD-0722-4
"C5,E10",8007,8888,5830,3058,4595,2222,0,2230,1438,792,1.815656566,1306,2300,453,187,187,0,48,0,0.032085561,0,empty,CD-0722-4
"C5,E11",9329,10091,6864,3227,5307,2642,0,2649,1677,972,1.725308642,1515,2880,639,227,222,5,59,2,0.081081081,0,empty,CD-0722-4
"C5,E12",855114,952346,651000,301346,464815,229151,9,229384,175491,53893,3.256285603,131971,134427,17545,6791,6621,170,1079,9,0.038966923,0,hg38,CD-0722-4
"C5,F1",11990,12866,8763,4103,6660,3300,8,3312,2143,1169,1.833190761,1854,2562,486,217,215,2,59,2,0.2,0,empty,CD-0722-4
"C5,F2",8877,9363,6585,2778,4935,2389,0,2391,1574,817,1.926560588,1309,3529,696,252,252,0,66,0,0.087301587,0,empty,CD-0722-4
"C5,F3",9727,10898,7305,3593,5612,2796,1,2797,1876,921,2.036916395,1598,3287,738,284,282,2,95,1,0.010638298,0,empty,CD-0722-4
"C5,F4",25980,30820,19291,11529,15675,8476,1,8490,6712,1778,3.775028121,5141,2247,233,107,101,6,39,2,0.108910891,0,empty,CD-0722-4
"C5,F5",10970,12066,7955,4111,6153,2905,0,2907,1836,1071,1.714285714,1680,2714,723,280,274,6,71,2,0.098540146,0,empty,CD-0722-4
"C5,F6",11092,12228,8227,4001,6292,3193,0,3197,2056,1141,1.801928133,1801,3720,883,378,377,1,113,1,0.119363395,0,empty,CD-0722-4
"C5,F7",12566,13751,9368,4383,7125,3468,16,3488,2339,1149,2.035683203,1944,1641,396,155,153,2,45,2,0.065359477,0,empty,CD-0722-4
"C5,F8",181448,188153,151114,37039,97721,39177,7,39225,29298,9927,2.951344817,17450,453,126,22,21,1,17,1,0,0,empty,CD-0722-4
"C5,F9",2223549,2524616,1666020,858596,1194452,648259,6,648883,536258,112625,4.761447281,373820,323259,35694,14183,13767,416,2125,9,0.051717876,0,hg38,CD-0722-4
"C5,F10",1366093,1556781,1021743,535038,743716,400982,2,401310,318005,83305,3.817357902,231652,89648,13870,5030,4949,81,933,4,0.02768236,0,hg38,CD-0722-4
"C5,F11",9130,9982,6815,3167,5105,2342,38,2381,1573,808,1.946782178,1306,1924,419,164,160,4,37,1,0.1125,0,empty,CD-0722-4
"C5,F12",10446,11346,7615,3731,5637,2743,0,2744,1794,950,1.888421053,1516,213,31,20,20,0,12,0,0,0,empty,CD-0722-4
"C5,G1",11370,12289,8549,3740,6397,3052,12,3064,1959,1105,1.772850679,1689,3821,1046,373,371,2,84,1,0.008086253,0,empty,CD-0722-4
"C5,G2",6803,7443,4869,2574,3799,1894,32,1928,1236,692,1.786127168,1076,419,108,26,26,0,10,0,0.153846154,0,empty,CD-0722-4
"C5,G3",12151,13193,9067,4126,6727,3374,0,3380,2044,1336,1.52994012,1832,2764,764,285,283,2,61,2,0.053003534,0,empty,CD-0722-4
"C5,G4",21747,24740,15426,9314,12543,7126,12,7144,4342,2802,1.549607423,4244,124,18,9,9,0,6,0,0,0,empty,CD-0722-4
"C5,G5",8279,8649,5921,2728,4465,2199,0,2205,1445,760,1.901315789,1245,1503,373,165,164,1,47,1,0.158536585,0,empty,CD-0722-4
"C5,G6",11137,12396,8251,4145,6378,3192,0,3195,2116,1079,1.96107507,1846,192,30,10,10,0,4,0,0,0,empty,CD-0722-4
"C5,G7",9904,11039,7551,3488,5708,2729,0,2733,1793,940,1.907446809,1550,3537,879,355,350,5,95,2,0.062857143,0,empty,CD-0722-4
"C5,G8",6623,7371,4824,2547,3848,1872,17,1889,1187,702,1.690883191,1077,2244,589,256,251,5,55,1,0.007968127,0,empty,CD-0722-4
"C5,G9",8192,9228,6083,3145,4777,2379,0,2380,1497,883,1.695356738,1413,2663,552,238,237,1,85,1,0.016877637,0,empty,CD-0722-4
"C5,G10",9766,10876,7243,3633,5467,2791,0,2796,1753,1043,1.680728667,1524,3700,745,321,314,7,84,2,0.24522293,0,empty,CD-0722-4
"C5,G11",1747863,1937542,1345318,592224,912158,460033,4,460556,370413,90143,4.109170984,256946,183927,33800,13167,12975,192,1964,7,0.040770713,0,hg38,CD-0722-4
"C5,G12",7783,8894,5704,3190,4637,2301,0,2301,1428,873,1.635738832,1401,2710,697,267,265,2,66,1,0.105660377,0,empty,CD-0722-4
"C5,H1",888107,1043424,643032,400392,508801,287317,15,287594,236247,51347,4.600989347,173324,54298,11003,4045,3992,53,774,2,0.054609218,0,hg38,CD-0722-4
"C5,H2",9062,9943,6697,3246,5166,2502,6,2511,1605,906,1.771523179,1426,3364,919,343,343,0,88,0,0.102040816,0,empty,CD-0722-4
"C5,H3",785209,869070,604505,264565,421443,198973,1,199186,152419,46767,3.259114333,112600,162311,23050,9025,8844,181,1449,6,0.019787427,0,hg38,CD-0722-4
"C5,H4",11134,12392,8339,4053,6233,3052,0,3058,2017,1041,1.937560038,1745,136,20,14,14,0,9,0,0.214285714,0,empty,CD-0722-4
"C5,H5",12512,14047,8987,5060,7109,3642,0,3648,2244,1404,1.598290598,2176,2125,627,241,239,2,56,1,0.071129707,0,empty,CD-0722-4
"C5,H6",870210,1018366,641126,377240,496268,272207,2,272423,217780,54643,3.98550592,163490,175220,30521,11812,11622,190,1759,7,0.037429014,0,hg38,CD-0722-4
"C5,H7",1043107,1175765,790121,385644,568692,288355,9,288707,226440,62267,3.636597234,165995,137545,16064,5958,5815,143,1052,8,0.036629407,0,hg38,CD-0722-4
"C5,H8",709421,852388,500383,352005,416426,252999,2,253211,205383,47828,4.29420005,154161,37146,10463,4046,4013,33,811,4,0.055569399,0,hg38,CD-0722-4
"C5,H9",7519,8237,5671,2566,4151,1846,0,1851,1222,629,1.942766296,1023,1622,328,134,131,3,36,1,0.022900763,0,empty,CD-0722-4
"C5,H10",985994,1177285,714537,462748,565937,330540,1,330801,257573,73228,3.517411373,200230,9806,2209,735,725,10,221,3,0.027586207,0,hg38,CD-0722-4
"C5,H11",8727,10093,6062,4031,5192,3112,11,3135,1660,1475,1.125423729,1914,45,14,4,4,0,1,0,0,0,empty,CD-0722-4
"C5,H12",6914,7442,5104,2338,3810,1969,7,1980,1297,683,1.89897511,1089,1903,247,87,87,0,34,0,0.011494253,0,empty,CD-0722-4
"C6,A1",8165,8878,5924,2954,4727,2434,2,2437,1602,835,1.918562874,1415,1430,242,108,104,4,32,2,0.038461538,0,empty,CD-0722-4
"C6,A2",12640,13934,9508,4426,7118,3538,0,3540,2166,1374,1.576419214,1976,1814,460,178,174,4,50,1,0.068965517,0,empty,CD-0722-4
"C6,A3",7349,7947,5511,2436,4181,2102,1,2105,1327,778,1.705655527,1177,1811,454,176,175,1,44,1,0.028571429,0,empty,CD-0722-4
"C6,A4",12906,14079,9756,4323,7377,3588,5,3593,2274,1319,1.724033359,1989,1089,221,93,90,3,23,2,0.066666667,0,empty,CD-0722-4
"C6,A5",11094,12138,8139,3999,6374,3118,0,3120,1952,1168,1.671232877,1770,3431,741,300,300,0,77,0,0.023333333,0,empty,CD-0722-4
"C6,A6",9419,10442,7017,3425,5400,2842,0,2842,1865,977,1.908904811,1596,3368,669,305,300,5,89,3,0.063333333,0,empty,CD-0722-4
"C6,A7",8256,9201,5991,3210,4877,2532,13,2548,1602,946,1.693446089,1525,1464,289,136,134,2,44,1,0.052238806,0,empty,CD-0722-4
"C6,A8",4850,5412,3614,1798,2891,1405,0,1406,949,457,2.076586433,795,2491,644,254,251,3,54,1,0.03187251,0,empty,CD-0722-4
"C6,A9",9166,10141,6813,3328,5284,2615,0,2620,1744,876,1.99086758,1501,2088,446,212,209,3,63,1,0.052631579,0,empty,CD-0722-4
"C6,A10",684776,781447,519720,261727,385220,195993,16,196201,150748,45453,3.316568763,113271,17194,1800,769,746,23,173,4,0.033512064,0,hg38,CD-0722-4
"C6,A11",7428,8211,5740,2471,4265,1987,0,1990,1288,702,1.834757835,1095,1521,329,115,115,0,36,0,0.165217391,0,empty,CD-0722-4
"C6,A12",779509,833227,610310,222917,405044,181719,1,181938,135079,46859,2.882669284,98200,99227,18184,6792,6673,119,1043,3,0.028472951,0,hg38,CD-0722-4
"C6,B1",8720,9604,6506,3098,5096,2580,0,2585,1544,1041,1.483189241,1454,1204,333,143,142,1,41,1,0.077464789,0,empty,CD-0722-4
"C6,B2",8926,10059,6197,3862,5186,2821,0,2821,1716,1105,1.552941176,1667,652,138,53,53,0,13,0,0.132075472,0,empty,CD-0722-4
"C6,B3",7665,8414,5733,2681,4310,2016,50,2069,1337,732,1.826502732,1189,1692,328,140,138,2,34,2,0,0,empty,CD-0722-4
"C6,B4",9138,10328,6554,3774,5410,2916,1,2919,1785,1134,1.574074074,1715,1869,442,174,173,1,33,1,0.080924855,0,empty,CD-0722-4
"C6,B5",8626,5279,3318,1961,3419,1750,1,1763,1167,596,1.958053691,1090,1122,119,63,62,1,22,1,0.016129032,0,empty,CD-0722-4
"C6,B6",892520,1005385,651872,353513,486456,256150,2,256426,218347,38079,5.73405289,150795,319804,79801,29582,29335,247,3859,11,0.032657235,0,hg38,CD-0722-4
"C6,B7",8822,9801,6666,3135,5118,2443,0,2445,1613,832,1.938701923,1378,1754,467,184,183,1,46,1,0.027322404,0,empty,CD-0722-4
"C6,B8",7102,7716,5359,2357,3997,1951,0,1952,1268,684,1.85380117,1041,1553,318,152,150,2,46,2,0.02,0,empty,CD-0722-4
"C6,B9",12543,13401,9315,4086,6939,3499,0,3505,2196,1309,1.677616501,1865,1129,210,84,84,0,26,0,0.380952381,0,empty,CD-0722-4
"C6,B10",6060,6678,4392,2286,3709,1856,0,1859,1142,717,1.592747559,1102,592,145,53,53,0,20,0,0,0,empty,CD-0722-4
"C6,B11",1051002,1164780,806802,357978,559058,270279,2,270539,211889,58650,3.612770673,151737,14996,2085,845,829,16,186,3,0.047044632,0,hg38,CD-0722-4
"C6,B12",8190,9007,6017,2990,4800,2428,1,2433,1571,862,1.8225058,1406,1966,409,166,164,2,52,2,0.054878049,0,empty,CD-0722-4
"C6,C1",15978,16774,12130,4644,8782,4165,23,4193,2676,1517,1.76400791,2204,1472,267,119,116,3,32,1,0.034482759,0,empty,CD-0722-4
"C6,C2",12812,14011,9356,4655,7237,3702,0,3704,2303,1401,1.643825839,2077,3531,1021,333,331,2,79,1,0.108761329,0,empty,CD-0722-4
"C6,C3",13171,14668,9834,4834,7637,3751,0,3756,2353,1403,1.677120456,2101,1229,384,111,111,0,20,0,0.18018018,0,empty,CD-0722-4
"C6,C4",8659,9389,6517,2872,4952,2305,0,2305,1496,809,1.849196539,1305,2632,606,225,223,2,55,1,0.01793722,0,empty,CD-0722-4
"C6,C5",14673,15982,11003,4979,8202,3896,0,3903,2599,1304,1.99309816,2201,1944,418,184,181,3,60,2,0.011049724,0,empty,CD-0722-4
"C6,C6",10218,11219,7558,3661,5933,2944,1,2946,1908,1038,1.838150289,1679,2071,561,224,221,3,49,2,0.040723982,0,empty,CD-0722-4
"C6,C7",13870,15762,9828,5934,8107,4514,0,4514,2690,1824,1.474780702,2723,468,90,36,36,0,10,0,0,0,empty,CD-0722-4
"C6,C8",15756,17009,11778,5231,8729,4319,0,4320,2890,1430,2.020979021,2418,3825,986,398,397,1,92,1,0.146095718,0,empty,CD-0722-4
"C6,C9",10734,11922,7970,3952,6315,3121,0,3125,2051,1074,1.909683426,1810,2163,483,229,227,2,50,2,0.110132159,0,empty,CD-0722-4
"C6,C10",11963,13378,9011,4367,6812,3257,0,3261,2138,1123,1.903829029,1870,1979,497,236,232,4,49,2,0.094827586,0,empty,CD-0722-4
"C6,C11",10553,11545,7810,3735,6130,3013,0,3014,1883,1131,1.66489832,1744,2463,651,234,232,2,51,1,0.112068966,0,empty,CD-0722-4
"C6,C12",15454,16821,11469,5352,8630,4151,1,4158,2700,1458,1.851851852,2347,2828,897,330,328,2,75,2,0.057926829,0,empty,CD-0722-4
"C6,D1",13292,15190,9735,5455,7845,4250,2,4257,2612,1645,1.587841945,2492,685,72,34,33,1,17,1,0.03030303,0,empty,CD-0722-4
"C6,D2",10718,11235,8258,2977,5897,2656,1,2657,1650,1007,1.638530288,1340,3139,892,348,345,3,86,2,0.124637681,0,empty,CD-0722-4
"C6,D3",10655,11725,7881,3844,6171,3062,0,3066,1951,1115,1.749775785,1788,2311,419,194,193,1,43,1,0.18134715,0,empty,CD-0722-4
"C6,D4",1097789,1307983,808288,499695,639877,366225,2,366528,286016,80512,3.552464229,219626,112598,21482,8066,7970,96,1300,8,0.040652447,0,hg38,CD-0722-4
"C6,D5",8862,9792,6507,3285,4979,2419,0,2422,1555,867,1.793540946,1381,2045,515,168,166,2,43,1,0.114457831,0,empty,CD-0722-4
"C6,D6",13362,14684,9636,5048,7656,4067,1,4071,2547,1524,1.671259843,2326,2727,540,193,192,1,51,1,0.036458333,0,empty,CD-0722-4
"C6,D7",7464,8280,5587,2693,4285,2072,3,2080,1434,646,2.219814241,1172,2969,1050,353,353,0,74,0,0.135977337,0,empty,CD-0722-4
"C6,D8",9192,10241,6759,3482,5260,2629,0,2631,1719,912,1.884868421,1502,1580,504,164,154,10,42,2,0.038961039,0,empty,CD-0722-4
"C6,D9",5132,5672,3796,1876,3014,1471,0,1471,934,537,1.739292365,848,2389,663,259,259,0,54,0,0.069498069,0,empty,CD-0722-4
"C6,D10",8429,9227,6011,3216,4865,2546,1,2547,1652,895,1.845810056,1461,1157,271,108,107,1,28,1,0.009345794,0,empty,CD-0722-4
"C6,D11",811988,911379,612625,298754,444489,227448,3,227655,176070,51585,3.413201512,129536,202507,32656,12619,12404,215,1861,8,0.060303128,0,hg38,CD-0722-4
"C6,D12",12555,13809,9303,4506,7142,3533,2,3541,2237,1304,1.715490798,2057,3908,866,351,349,2,116,1,0.025787966,0,empty,CD-0722-4
"C6,E1",16475,18012,12128,5884,9167,4539,7,4549,2875,1674,1.71744325,2631,2839,579,239,234,5,81,2,0.017094017,0,empty,CD-0722-4
"C6,E2",11493,12583,8327,4256,6516,3278,0,3285,2057,1228,1.675081433,1901,2848,713,250,244,6,59,2,0.036885246,0,empty,CD-0722-4
"C6,E3",7461,8318,5650,2668,4425,2127,17,2144,1300,844,1.54028436,1222,3384,893,311,307,4,88,1,0.084690554,0,empty,CD-0722-4
"C6,E4",10113,11047,7483,3564,5765,2820,7,2829,1733,1096,1.58120438,1631,2809,552,266,263,3,81,2,0.041825095,0,empty,CD-0722-4
"C6,E5",8869,9592,6695,2897,4935,2252,0,2252,1462,790,1.850632911,1223,1691,528,228,223,5,50,1,0.085201794,0,empty,CD-0722-4
"C6,E6",16189,17734,11884,5850,9107,4574,0,4576,2882,1694,1.701298701,2619,3804,1066,381,374,7,92,2,0.010695187,0,empty,CD-0722-4
"C6,E7",15497,16953,11686,5267,8806,4252,11,4267,2774,1493,1.858004019,2405,3744,806,341,332,9,96,2,0.03313253,0,empty,CD-0722-4
"C6,E8",12281,13044,9297,3747,6827,3188,0,3189,2121,1068,1.985955056,1647,3371,685,267,265,2,69,2,0.00754717,0,empty,CD-0722-4
"C6,E9",7951,8804,5937,2867,4538,2214,0,2216,1408,808,1.742574257,1295,2991,895,325,321,4,68,2,0.00623053,0,empty,CD-0722-4
"C6,E10",9054,9813,6651,3162,5190,2527,1,2528,1563,965,1.619689119,1447,1973,489,177,176,1,44,1,0.130681818,0,empty,CD-0722-4
"C6,E11",11083,12113,8349,3764,6238,3044,0,3044,1900,1144,1.660839161,1670,2603,521,221,217,4,47,2,0.082949309,0,empty,CD-0722-4
"C6,E12",11321,12836,8313,4523,6585,3272,0,3274,2111,1163,1.815133276,1950,2037,339,147,146,1,42,1,0,0,empty,CD-0722-4
"C6,F1",13206,14023,9755,4268,7315,3566,0,3575,2326,1249,1.862289832,1982,2553,849,321,319,2,76,1,0.018808777,0,empty,CD-0722-4
"C6,F2",10296,11004,7676,3328,5774,2736,0,2737,1705,1032,1.652131783,1525,3201,724,255,255,0,72,0,0.152941176,0,empty,CD-0722-4
"C6,F3",10264,11184,7674,3510,5847,2822,0,2825,1876,949,1.976817703,1613,3050,654,257,256,1,73,1,0.046875,0,empty,CD-0722-4
"C6,F4",1464683,1673973,1094439,579534,815055,440567,16,440951,356194,84757,4.202531944,254931,21847,2991,1173,1170,3,287,2,0.115384615,0,hg38,CD-0722-4
"C6,F5",11433,12140,8566,3574,6319,2920,0,2924,1903,1021,1.863858962,1547,3285,794,257,252,5,65,3,0.095238095,0,empty,CD-0722-4
"C6,F6",12975,14179,9552,4627,7219,3693,2,3699,2410,1289,1.869666408,2074,3456,749,293,285,8,95,2,0.014035088,0,empty,CD-0722-4
"C6,F7",13377,14624,9929,4695,7612,3805,0,3809,2477,1332,1.85960961,2122,1319,326,144,143,1,31,1,0.20979021,0,empty,CD-0722-4
"C6,F8",11650,12646,8573,4073,6665,3360,3,3365,2184,1181,1.849280271,1916,339,90,21,21,0,8,0,0.619047619,0,empty,CD-0722-4
"C6,F9",10726,11633,8236,3397,6100,2952,0,2957,1935,1022,1.89334638,1602,2781,494,214,214,0,67,0,0.074766355,0,empty,CD-0722-4
"C6,F10",14631,15698,10927,4771,8065,3823,0,3824,2590,1234,2.098865478,2115,2021,497,174,173,1,47,1,0.034682081,0,empty,CD-0722-4
"C6,F11",10957,11507,8528,2979,5849,2663,1,2664,1737,927,1.873786408,1326,1991,446,179,174,5,45,3,0.011494253,0,empty,CD-0722-4
"C6,F12",11449,12406,8426,3980,6573,3269,0,3278,2213,1065,2.077934272,1894,339,31,23,23,0,8,0,0.043478261,0,empty,CD-0722-4
"C6,G1",12609,13919,9373,4546,7350,3575,0,3579,2271,1308,1.736238532,2047,3331,840,320,318,2,76,1,0.097484277,0,empty,CD-0722-4
"C6,G2",7023,7864,4988,2876,4098,2195,0,2195,1401,794,1.764483627,1309,507,69,43,43,0,16,0,0.023255814,0,empty,CD-0722-4
"C6,G3",13261,14375,9789,4586,7437,3772,0,3778,2357,1421,1.658691063,2021,2839,646,278,273,5,69,1,0.047619048,0,empty,CD-0722-4
"C6,G4",23450,26398,16846,9552,13536,7499,2,7503,4488,3015,1.488557214,4314,77,5,5,5,0,5,0,0,0,empty,CD-0722-4
"C6,G5",8612,9813,6366,3447,5056,2562,6,2568,1639,929,1.764262648,1547,2126,565,189,183,6,54,2,0.054644809,0,empty,CD-0722-4
"C6,G6",2628524,2948984,1993901,955083,1378894,723662,13,724346,605194,119152,5.079176178,413022,17137,2916,1146,1125,21,260,2,0.028444444,0,hg38,CD-0722-4
"C6,G7",10049,10875,7583,3292,5813,2717,0,2720,1763,957,1.842215256,1550,3244,996,418,415,3,107,2,0.014457831,0,empty,CD-0722-4
"C6,G8",7431,8242,5515,2727,4214,2011,4,2016,1268,748,1.695187166,1159,2123,431,170,164,6,51,2,0.012195122,0,empty,CD-0722-4
"C6,G9",1942487,2299519,1423013,876506,1100001,631245,39,631883,502948,128935,3.900787218,380607,410562,71492,27849,27431,418,3122,7,0.059203091,0,hg38,CD-0722-4
"C6,G10",10954,12574,8102,4472,6401,3302,0,3304,2180,1124,1.939501779,1918,3102,596,261,261,0,77,0,0.103448276,0,empty,CD-0722-4
"C6,G11",10482,11293,7964,3329,6158,2881,0,2881,1849,1032,1.791666667,1605,2004,463,137,135,2,37,1,0.066666667,0,empty,CD-0722-4
"C6,G12",8673,9753,6343,3410,4996,2588,1,2591,1614,977,1.651995906,1510,2324,552,225,225,0,54,0,0.128888889,0,empty,CD-0722-4
"C6,H1",9916,10901,7319,3582,5664,2750,0,2752,1798,954,1.884696017,1599,1449,314,101,99,2,27,1,0.02020202,0,empty,CD-0722-4
"C6,H2",11051,12351,8055,4296,6346,3215,1,3217,2111,1106,1.908679928,1906,3215,917,332,332,0,74,0,0.051204819,0,empty,CD-0722-4
"C6,H3",8826,9885,6499,3386,5194,2575,0,2577,1635,942,1.73566879,1531,2004,572,195,194,1,46,1,0.190721649,0,empty,CD-0722-4
"C6,H4",12718,13977,9496,4481,7135,3506,0,3508,2307,1201,1.920899251,1986,166,72,40,40,0,14,0,0,0,empty,CD-0722-4
"C6,H5",13239,14620,9689,4931,7384,3665,0,3674,2338,1336,1.75,2105,2753,694,276,273,3,69,1,0.19047619,0,empty,CD-0722-4
"C6,H6",8467,9333,6162,3171,4853,2489,0,2493,1642,851,1.929494712,1435,2656,911,337,334,3,64,2,0.080838323,0,empty,CD-0722-4
"C6,H7",10138,10964,7375,3589,5762,2880,17,2897,1910,987,1.935157042,1650,2248,554,217,217,0,60,0,0.064516129,0,empty,CD-0722-4
"C6,H8",11588,12791,8559,4232,6568,3373,0,3375,2152,1223,1.759607522,1941,2628,484,214,211,3,65,3,0.018957346,0,empty,CD-0722-4
"C6,H9",9274,9964,7024,2940,5100,2408,0,2413,1602,811,1.975339088,1307,1329,319,129,129,0,37,0,0.108527132,0,empty,CD-0722-4
"C6,H10",7451,8097,5508,2589,4024,1937,0,1937,1259,678,1.856932153,1068,1390,340,132,132,0,35,0,0.287878788,0,empty,CD-0722-4
"C6,H11",10603,12165,7379,4786,6248,3777,0,3781,2021,1760,1.148295455,2262,48,0,0,0,0,0,0,0,0,empty,CD-0722-4
"C6,H12",8330,8872,5998,2874,4638,2346,0,2350,1572,778,2.020565553,1341,1118,170,73,72,1,28,1,0.152777778,0,empty,CD-0722-4
"C7,A1",7118,8002,5170,2832,4111,2134,0,2134,1384,750,1.845333333,1268,1985,410,158,156,2,37,1,0.032051282,0,empty,CD-0722-4
"C7,A2",9842,10963,7126,3837,5672,2902,9,2911,1863,1048,1.777671756,1659,1812,393,162,161,1,36,1,0.031055901,0,empty,CD-0722-4
"C7,A3",6603,7202,5003,2199,3693,1783,1,1784,1197,587,2.039182283,969,1782,429,120,118,2,41,1,0,0,empty,CD-0722-4
"C7,A4",12255,13098,9249,3849,6756,3263,0,3267,2132,1135,1.878414097,1768,981,208,88,88,0,23,0,0.045454545,0,empty,CD-0722-4
"C7,A5",797042,897528,598003,299525,446211,229770,14,229975,176108,53867,3.269311452,132007,66241,5434,2061,1984,77,536,3,0.029737903,0,hg38,CD-0722-4
"C7,A6",10881,12375,8120,4255,6502,3349,3,3354,2225,1129,1.970770593,1956,4386,775,330,326,4,95,2,0.055214724,0,empty,CD-0722-4
"C7,A7",522258,625908,369010,256898,323437,205989,2,206105,119736,86369,1.386330744,125180,2039,857,184,180,4,55,2,0.022222222,0,hg38,CD-0722-4
"C7,A8",595636,709040,437148,271892,351669,198118,1,198289,161132,37157,4.336518018,118547,198792,27465,11307,11100,207,1725,7,0.081531532,0,hg38,CD-0722-4
"C7,A9",6954,7600,5371,2229,4011,1924,0,1931,1285,646,1.989164087,1048,1646,404,172,166,6,43,2,0.054216867,0,empty,CD-0722-4
"C7,A10",1098434,1249017,831119,417898,609332,318523,1,318843,249311,69532,3.585557729,183665,19624,2825,1101,1080,21,220,2,0.019444444,0,hg38,CD-0722-4
"C7,A11",6254,6765,4803,1962,3575,1621,13,1634,1090,544,2.003676471,888,1502,421,172,172,0,40,0,0.005813953,0,empty,CD-0722-4
"C7,A12",9102,9674,6816,2858,4993,2398,1,2400,1538,862,1.784222738,1301,4447,864,356,352,4,83,2,0.0625,0,empty,CD-0722-4
"C7,B1",7877,8567,5771,2796,4423,2120,73,2197,1390,807,1.722428748,1217,1406,376,166,164,2,42,1,0.018292683,0,empty,CD-0722-4
"C7,B2",8295,8934,5700,3234,4669,2470,0,2472,1536,936,1.641025641,1463,700,196,66,64,2,13,2,0.09375,0,empty,CD-0722-4
"C7,B3",1164720,1413650,828380,585270,688592,414551,1,414918,347496,67422,5.154044674,254981,116279,27222,10429,10306,123,1548,7,0.035028139,0,hg38,CD-0722-4
"C7,B4",6882,7604,5094,2510,4071,2112,1,2117,1335,782,1.707161125,1203,1418,331,149,148,1,39,1,0,0,empty,CD-0722-4
"C7,B5",8556,5178,3246,1932,3352,1726,1,1740,1125,615,1.829268293,1083,1055,244,97,95,2,34,2,0.221052632,0,empty,CD-0722-4
"C7,B6",8200,8978,5878,3100,4617,2363,0,2368,1435,933,1.538049303,1365,1719,319,129,128,1,52,1,0.1171875,0,empty,CD-0722-4
"C7,B7",14981,16643,11169,5474,8281,4325,0,4331,2829,1502,1.883488682,2326,1485,399,144,143,1,33,1,0.041958042,0,empty,CD-0722-4
"C7,B8",341173,394057,255682,138375,193896,104812,0,104887,80990,23897,3.389128342,60630,29199,4442,1745,1707,38,336,4,0.088459285,0,hg38,CD-0722-4
"C7,B9",10624,11884,7801,4083,6029,3123,0,3128,1963,1165,1.684978541,1774,923,242,95,95,0,31,0,0.021052632,0,empty,CD-0722-4
"C7,B10",5119,5452,3764,1688,2940,1407,2,1413,880,533,1.651031895,781,592,64,33,33,0,11,0,0.03030303,0,empty,CD-0722-4
"C7,B11",954530,1087227,703628,383599,525301,286566,2,286783,229516,57267,4.007823005,166051,12373,1417,600,588,12,156,3,0.035714286,0,hg38,CD-0722-4
"C7,B12",6685,7428,4898,2530,3864,1932,0,1934,1285,649,1.979969183,1143,1598,319,126,122,4,49,2,0.139344262,0,empty,CD-0722-4
"C7,C1",14546,15134,11140,3994,7822,3582,0,3583,2321,1262,1.839144216,1849,1067,321,132,131,1,38,1,0,0,empty,CD-0722-4
"C7,C2",11414,12294,8278,4016,6283,3160,1,3164,2065,1099,1.878980892,1753,2401,538,255,251,4,52,1,0.023904382,0,empty,CD-0722-4
"C7,C3",11808,12942,8646,4296,6898,3519,24,3547,2253,1294,1.741112828,2037,787,178,73,72,1,24,1,0.180555556,0,empty,CD-0722-4
"C7,C4",7101,7648,5309,2339,4054,1934,1,1935,1231,704,1.748579545,1061,2120,435,173,172,1,58,1,0.046511628,0,empty,CD-0722-4
"C7,C5",11043,12321,8340,3981,6324,3107,0,3111,2058,1053,1.954415954,1717,1867,386,157,155,2,45,1,0.096774194,0,empty,CD-0722-4
"C7,C6",9161,10076,6642,3434,5416,2771,0,2774,1807,967,1.868665977,1606,1451,393,144,144,0,41,0,0.076388889,0,empty,CD-0722-4
"C7,C7",11797,13583,8289,5294,7034,3893,0,3893,2297,1596,1.439223058,2370,547,154,51,51,0,10,0,0,0,empty,CD-0722-4
"C7,C8",15814,17214,11761,5453,8857,4384,16,4404,2880,1524,1.88976378,2481,4430,876,312,310,2,79,2,0.058064516,0,empty,CD-0722-4
"C7,C9",8994,9689,6744,2945,5078,2443,19,2465,1630,835,1.952095808,1361,1561,406,168,168,0,41,0,0.041666667,0,empty,CD-0722-4
"C7,C10",11339,12581,8339,4242,6379,3138,0,3140,1980,1160,1.706896552,1844,2274,508,194,194,0,49,0,0.041237113,0,empty,CD-0722-4
"C7,C11",8962,9683,6634,3049,5155,2514,0,2521,1618,903,1.791805094,1422,2193,544,206,206,0,53,0,0.048543689,0,empty,CD-0722-4
"C7,C12",922331,1050249,679905,370344,509135,272766,17,273021,221575,51446,4.306943203,160230,125746,17308,6793,6668,125,1151,6,0.038542292,0,hg38,CD-0722-4
"C7,D1",11397,12744,8264,4480,6537,3424,0,3430,2089,1341,1.557792692,1972,731,118,35,35,0,10,0,0.342857143,0,empty,CD-0722-4
"C7,D2",1028818,1158438,781082,377356,561329,288582,1,288855,228221,60634,3.763911337,163168,59239,13209,5005,4952,53,991,3,0.04220517,0,hg38,CD-0722-4
"C7,D3",7821,8522,5747,2775,4487,2282,0,2285,1525,760,2.006578947,1293,1858,378,127,126,1,37,1,0.03968254,0,empty,CD-0722-4
"C7,D4",1355169,1664305,933304,731001,824818,553387,0,553740,421762,131978,3.195699283,338249,19661,1390,474,429,45,95,3,0.20979021,0,hg38,CD-0722-4
"C7,D5",7334,8095,5500,2595,4258,2115,0,2120,1369,751,1.822902796,1220,1697,337,163,159,4,37,2,0.037735849,0,empty,CD-0722-4
"C7,D6",11363,12489,8207,4282,6508,3463,0,3466,2082,1384,1.50433526,1984,1481,360,145,138,7,46,2,0.02173913,0,empty,CD-0722-4
"C7,D7",687424,840781,470406,370375,417560,275354,2,275573,198666,76907,2.583197888,169557,4549,634,181,177,4,53,2,0.096045198,0,hg38,CD-0722-4
"C7,D8",7570,8260,5436,2824,4241,2116,21,2141,1377,764,1.802356021,1243,1463,282,106,103,3,34,1,0.106796117,0,empty,CD-0722-4
"C7,D9",4249,4633,3120,1513,2416,1203,0,1203,828,375,2.208,686,1733,397,150,146,4,38,2,0,0,empty,CD-0722-4
"C7,D10",9079,10087,6627,3460,5248,2631,1,2635,1672,963,1.736240914,1554,1363,423,162,161,1,33,1,0.01863354,0,empty,CD-0722-4
"C7,D11",8542,9304,6459,2845,4800,2296,0,2300,1449,851,1.702702703,1275,3675,1013,378,375,3,87,2,0.082666667,0,empty,CD-0722-4
"C7,D12",12372,13674,9238,4436,7028,3510,0,3511,2311,1200,1.925833333,1986,4404,1325,473,469,4,106,2,0.098081023,0,empty,CD-0722-4
"C7,E1",13890,15200,10262,4938,7868,3912,0,3915,2443,1472,1.659646739,2194,3325,790,338,333,5,88,2,0.096096096,0,empty,CD-0722-4
"C7,E2",9323,10309,6711,3598,5365,2685,1,2691,1647,1044,1.577586207,1540,1974,313,139,136,3,49,2,0.169117647,0,empty,CD-0722-4
"C7,E3",6797,7565,5173,2392,3886,1865,8,1873,1249,624,2.001602564,1045,2640,1006,356,353,3,72,2,0,0,empty,CD-0722-4
"C7,E4",8674,9424,6425,2999,4893,2340,1,2345,1502,843,1.78173191,1346,2405,441,161,160,1,59,1,0.1125,0,empty,CD-0722-4
"C7,E5",7933,8664,5998,2666,4538,2125,0,2130,1354,776,1.744845361,1161,1446,384,164,162,2,44,1,0.055555556,0,empty,CD-0722-4
"C7,E6",13699,15268,10179,5089,7690,3959,0,3962,2507,1455,1.723024055,2258,2931,620,280,279,1,89,1,0.035842294,0,empty,CD-0722-4
"C7,E7",12690,13561,9498,4063,7178,3397,0,3399,2270,1129,2.010628875,1891,3475,723,281,278,3,86,1,0.04676259,0,empty,CD-0722-4
"C7,E8",10776,11441,8041,3400,6014,2809,0,2810,1856,954,1.945492662,1495,3103,784,279,273,6,55,2,0.113553114,0,empty,CD-0722-4
"C7,E9",6162,6784,4602,2182,3471,1695,0,1695,1106,589,1.877758913,959,2754,736,275,270,5,77,2,0.02962963,0,empty,CD-0722-4
"C7,E10",7804,8571,5867,2704,4445,2138,0,2138,1427,711,2.007032349,1246,1983,562,196,195,1,49,1,0.041025641,0,empty,CD-0722-4
"C7,E11",9114,9710,6670,3040,5176,2602,21,2623,1739,884,1.96719457,1471,2438,543,219,212,7,51,2,0.066037736,0,empty,CD-0722-4
"C7,E12",9497,10628,7000,3628,5453,2746,0,2759,1772,987,1.795339412,1588,2134,454,189,184,5,51,2,0.043478261,0,empty,CD-0722-4
"C7,F1",17328,18372,13002,5370,9304,4284,0,4286,2788,1498,1.861148198,2410,3871,898,337,336,1,75,1,0.119047619,0,empty,CD-0722-4
"C7,F2",9148,9990,6748,3242,5143,2524,0,2525,1623,902,1.799334812,1414,3422,917,341,337,4,76,2,0.151335312,0,empty,CD-0722-4
"C7,F3",9233,10122,6796,3326,5283,2580,14,2596,1643,953,1.724029381,1453,3211,734,294,291,3,80,2,0.024054983,0,empty,CD-0722-4
"C7,F4",13919,14606,10404,4202,7627,3616,11,3635,2312,1323,1.747543462,1976,809,277,103,102,1,28,1,0,0,empty,CD-0722-4
"C7,F5",947055,1041641,706107,335534,507382,270685,13,270923,217065,53858,4.030320472,149021,40791,20455,7022,7007,15,980,3,0.011559869,0,hg38,CD-0722-4
"C7,F6",11319,12519,8336,4183,6402,3257,0,3261,2092,1169,1.78956373,1876,4131,923,376,369,7,100,2,0.170731707,0,empty,CD-0722-4
"C7,F7",1051262,1179217,799766,379451,579672,292291,2,292552,223235,69317,3.220494251,167732,89118,11051,4470,4376,94,752,5,0.055301645,0,hg38,CD-0722-4
"C7,F8",8128,8735,6052,2683,4620,2313,0,2315,1509,806,1.872208437,1246,404,57,22,22,0,8,0,0.136363636,0,empty,CD-0722-4
"C7,F9",8761,9358,6616,2742,4899,2360,0,2362,1505,857,1.756126021,1268,2619,750,295,290,5,79,2,0.127586207,0,empty,CD-0722-4
"C7,F10",12561,13728,9460,4268,6974,3279,0,3281,2196,1085,2.023963134,1784,1974,581,252,250,2,55,1,0.124,0,empty,CD-0722-4
"C7,F11",681503,736163,530831,205332,361649,162909,1,163094,125721,37373,3.363952586,88289,145472,18074,7209,7020,189,1121,7,0.049002849,0,hg38,CD-0722-4
"C7,F12",10602,11442,7956,3486,5793,2834,0,2838,1910,928,2.058189655,1555,334,61,35,35,0,13,0,0.057142857,0,empty,CD-0722-4
"C7,G1",12186,12849,9341,3508,6811,3134,0,3134,2044,1090,1.875229358,1649,2636,714,269,267,2,72,1,0.033707865,0,empty,CD-0722-4
"C7,G2",6339,6554,4458,2096,3524,1771,0,1771,1100,671,1.639344262,1024,668,77,43,43,0,17,0,0.023255814,0,empty,CD-0722-4
"C7,G3",13574,14379,10122,4257,7438,3675,12,3692,2282,1410,1.618439716,1916,2479,538,203,200,3,56,1,0.11,0,empty,CD-0722-4
"C7,G4",21583,23997,15571,8426,12117,6555,0,6571,4083,2488,1.64107717,3849,52,3,2,2,0,2,0,0,0,empty,CD-0722-4
"C7,G5",7560,8539,5601,2938,4282,2113,17,2130,1286,844,1.523696682,1212,1572,558,208,207,1,50,1,0.1352657,0,empty,CD-0722-4
"C7,G6",2662704,3082533,1986536,1095997,1443764,805339,7,806140,648971,157169,4.129128518,472598,23657,4165,1637,1603,34,329,4,0.036805989,0,hg38,CD-0722-4
"C7,G7",8929,9391,6767,2624,4882,2203,26,2231,1512,719,2.102920723,1135,3049,685,257,254,3,66,2,0.066929134,0,empty,CD-0722-4
"C7,G8",6369,6900,4760,2140,3556,1773,0,1776,1148,628,1.828025478,989,2106,494,238,235,3,65,2,0.034042553,0,empty,CD-0722-4
"C7,G9",8164,9030,6060,2970,4669,2284,3,2293,1498,795,1.88427673,1319,2611,735,300,298,2,76,2,0.073825503,0,empty,CD-0722-4
"C7,G10",8902,9616,6612,3004,5102,2569,0,2574,1679,895,1.875977654,1469,2667,916,261,259,2,55,2,0.034749035,0,empty,CD-0722-4
"C7,G11",9231,9724,6897,2827,5220,2432,0,2433,1630,803,2.02988792,1345,1790,365,133,132,1,40,1,0.113636364,0,empty,CD-0722-4
"C7,G12",7816,8605,5650,2955,4492,2316,0,2316,1454,862,1.686774942,1379,2075,552,228,227,1,62,1,0.052863436,0,empty,CD-0722-4
"C7,H1",862304,977731,631928,345803,479701,260003,2,260243,212911,47332,4.498246429,152332,58018,13794,5070,5025,45,866,4,0.034228856,0,hg38,CD-0722-4
"C7,H2",9016,9830,6657,3173,5215,2626,1,2629,1714,915,1.873224044,1526,2855,574,257,250,7,64,4,0.052,0,empty,CD-0722-4
"C7,H3",7436,7913,5503,2410,4106,2041,1,2045,1383,662,2.089123867,1149,1416,380,153,148,5,37,2,0.027027027,0,empty,CD-0722-4
"C7,H4",10672,11756,7957,3799,6075,3035,0,3037,2007,1030,1.948543689,1760,115,28,14,14,0,4,0,0,0,empty,CD-0722-4
"C7,H5",12028,12794,8796,3998,6620,3259,0,3261,2133,1128,1.890957447,1844,2496,772,268,267,1,65,1,0.011235955,0,empty,CD-0722-4
"C7,H6",6766,7337,5006,2331,3896,1975,16,1996,1350,646,2.089783282,1149,2013,511,162,158,4,43,2,0.278481013,0,empty,CD-0722-4
"C7,H7",8645,9302,6351,2951,4857,2366,12,2379,1540,839,1.835518474,1305,2140,536,237,235,2,44,2,0.017021277,0,empty,CD-0722-4
"C7,H8",9461,10348,7008,3340,5370,2678,0,2679,1715,964,1.779045643,1501,2976,595,241,238,3,64,2,0.029411765,0,empty,CD-0722-4
"C7,H9",7053,7533,5232,2301,3921,1820,1,1822,1199,623,1.924558587,1021,1572,149,62,60,2,36,2,0.05,0,empty,CD-0722-4
"C7,H10",875316,1018872,638787,380085,496063,277294,25,277551,231763,45788,5.061653708,164243,204958,26479,10696,10456,240,1700,5,0.046097934,0,hg38,CD-0722-4
"C7,H11",8238,9299,5805,3494,4794,2817,3,2821,1584,1237,1.280517381,1646,27,20,10,10,0,1,0,0,0,empty,CD-0722-4
"C7,H12",6450,7027,4735,2292,3663,1855,0,1863,1192,671,1.776453055,1057,2287,558,217,214,3,38,1,0.023364486,0,empty,CD-0722-4
"C8,A1",6969,7633,4938,2695,4001,2036,0,2036,1331,705,1.887943262,1198,1614,308,128,126,2,38,1,0.007936508,0,empty,CD-0722-4
"C8,A2",10942,11722,7831,3891,6172,3074,13,3093,1934,1159,1.668679896,1784,2192,511,216,216,0,58,0,0.032407407,0,empty,CD-0722-4
"C8,A3",5969,6589,4329,2260,3364,1670,0,1672,1063,609,1.745484401,960,1271,239,78,77,1,32,1,0,0,empty,CD-0722-4
"C8,A4",10850,11911,8146,3765,6154,3049,0,3060,1929,1131,1.705570292,1674,870,187,65,63,2,20,2,0.158730159,0,empty,CD-0722-4
"C8,A5",9337,10013,6831,3182,5326,2615,16,2633,1688,945,1.786243386,1447,3163,836,332,328,4,74,1,0.076219512,0,empty,CD-0722-4
"C8,A6",7572,8273,5451,2822,4417,2229,1,2230,1457,773,1.884864166,1271,3380,744,303,301,2,92,1,0.109634551,0,empty,CD-0722-4
"C8,A7",6484,7257,4724,2533,3808,1997,8,2006,1243,763,1.629095675,1160,1433,297,138,138,0,37,0,0.144927536,0,empty,CD-0722-4
"C8,A8",4517,5057,3335,1722,2549,1282,0,1283,850,433,1.963048499,696,1967,421,162,162,0,45,0,0.320987654,0,empty,CD-0722-4
"C8,A9",6843,7194,5143,2051,3865,1897,1,1903,1162,741,1.568151147,1041,2469,544,237,237,0,56,0,0.037974684,0,empty,CD-0722-4
"C8,A10",583600,705565,411175,294390,352232,222942,27,223115,164858,58257,2.829840191,133734,3848,251,74,73,1,23,1,0.383561644,0,empty,CD-0722-4
"C8,A11",6289,6567,4704,1863,3452,1599,19,1624,1063,561,1.89483066,911,1282,363,164,164,0,39,0,0.079268293,0,empty,CD-0722-4
"C8,A12",8654,9217,6564,2653,4736,2171,4,2175,1390,785,1.770700637,1169,4093,833,347,345,2,91,1,0.034782609,0,empty,CD-0722-4
"C8,B1",7421,7787,5498,2289,4020,1982,1,1988,1256,732,1.715846995,1047,1220,281,113,110,3,36,2,0.027272727,0,empty,CD-0722-4
"C8,B2",7556,8154,5235,2919,4301,2281,0,2281,1389,892,1.557174888,1340,863,113,54,53,1,16,1,0.075471698,0,empty,CD-0722-4
"C8,B3",1823305,2107367,1362870,744497,1016962,550919,2,551411,448455,102956,4.355792766,325007,164627,31707,11889,11731,158,1649,5,0.040576251,0,hg38,CD-0722-4
"C8,B4",7663,8574,5587,2987,4440,2390,0,2391,1479,912,1.621710526,1403,1602,420,176,173,3,51,1,0.005780347,0,empty,CD-0722-4
"C8,B5",8290,5723,3526,2197,3544,1856,0,1873,1195,678,1.762536873,1162,1197,216,96,94,2,29,2,0.095744681,0,empty,CD-0722-4
"C8,B6",8138,9002,5862,3140,4798,2503,3,2507,1570,937,1.675560299,1433,2333,623,228,221,7,65,2,0.013574661,0,empty,CD-0722-4
"C8,B7",7580,8343,5677,2666,4315,2070,11,2083,1325,758,1.748021108,1136,1618,354,173,171,2,51,1,0.046783626,0,empty,CD-0722-4
"C8,B8",6125,6777,4566,2211,3512,1763,0,1764,1163,601,1.935108153,989,1572,324,149,146,3,50,2,0.034246575,0,empty,CD-0722-4
"C8,B9",883344,989822,664579,325243,479647,244112,1,244357,190266,54091,3.517516777,141039,51002,6902,2635,2580,55,513,5,0.032170543,0,hg38,CD-0722-4
"C8,B10",5331,5669,3782,1887,3095,1511,9,1526,977,549,1.779599271,885,576,147,76,74,2,22,2,0.162162162,0,empty,CD-0722-4
"C8,B11",11541,12899,8311,4588,6782,3699,0,3701,2123,1578,1.345373891,2188,314,67,21,21,0,13,0,0,0,empty,CD-0722-4
"C8,B12",6570,7214,4893,2321,3750,1854,1,1856,1186,670,1.770149254,1059,2115,918,290,289,1,58,1,0.069204152,0,empty,CD-0722-4
"C8,C1",1008501,1120651,763642,357009,538184,269859,1,270150,211412,58738,3.599237291,152743,60591,9510,3560,3502,58,675,4,0.066818961,0,hg38,CD-0722-4
"C8,C2",10756,11665,7864,3801,6056,3069,0,3078,2008,1070,1.876635514,1712,2763,738,294,292,2,76,1,0.044520548,0,empty,CD-0722-4
"C8,C3",11739,12506,8507,3999,6606,3283,1,3286,2138,1148,1.862369338,1836,1315,335,153,147,6,31,2,0.136054422,0,empty,CD-0722-4
"C8,C4",733407,887980,504067,383913,441888,289081,2,289306,195916,93390,2.09782632,175933,7416,762,290,282,8,92,2,0.085106383,0,hg38,CD-0722-4
"C8,C5",1515645,1762131,1141718,620413,848600,462767,3,463196,377987,85209,4.435998545,272405,111852,22761,8826,8701,125,1503,5,0.036432594,0,hg38,CD-0722-4
"C8,C6",8831,9646,6518,3128,5179,2602,0,2604,1677,927,1.809061489,1460,1993,508,169,166,3,58,2,0.018072289,0,empty,CD-0722-4
"C8,C7",11274,12970,8061,4909,6694,3679,0,3683,2199,1484,1.48180593,2221,531,192,76,76,0,19,0,0.026315789,0,empty,CD-0722-4
"C8,C8",13046,14326,9582,4744,7507,3855,0,3863,2501,1362,1.836270191,2216,3615,997,377,374,3,94,1,0.109625668,0,empty,CD-0722-4
"C8,C9",9151,10061,6771,3290,5282,2658,1,2661,1722,939,1.833865815,1535,2573,586,253,247,6,56,2,0.064777328,0,empty,CD-0722-4
"C8,C10",9752,10628,7404,3224,5406,2601,5,2606,1642,964,1.703319502,1446,2491,618,268,262,6,82,2,0.007633588,0,empty,CD-0722-4
"C8,C11",8882,9601,6343,3258,5047,2556,0,2557,1716,841,2.040428062,1512,2280,673,227,225,2,47,2,0.071111111,0,empty,CD-0722-4
"C8,C12",1667612,1927077,1244494,682583,919314,504128,7,504633,429780,74853,5.741653641,295495,221778,35363,13364,13135,229,1930,9,0.06349448,0,hg38,CD-0722-4
"C8,D1",974027,1109776,716545,393231,540113,307471,13,307763,227972,79791,2.857114211,177612,36603,3291,1231,1177,54,275,2,0.056924384,0,hg38,CD-0722-4
"C8,D2",8846,9414,6738,2676,4937,2245,0,2245,1516,729,2.079561043,1198,3532,986,340,339,1,83,1,0.056047198,0,empty,CD-0722-4
"C8,D3",8009,8849,5766,3083,4691,2416,0,2418,1647,771,2.13618677,1374,1559,326,139,138,1,36,1,0,0,empty,CD-0722-4
"C8,D4",6177,6703,4541,2162,3540,1764,0,1768,1107,661,1.67473525,1016,1847,287,128,127,1,49,1,0.023622047,0,empty,CD-0722-4
"C8,D5",6635,7204,4904,2300,3803,1876,0,1879,1249,630,1.982539683,1037,2154,422,184,182,2,48,2,0.043956044,0,empty,CD-0722-4
"C8,D6",691008,744838,534412,210426,364784,165244,4,165415,118460,46955,2.522841018,90864,128770,19865,7444,7312,132,1117,4,0.053473742,0,hg38,CD-0722-4
"C8,D7",6043,6659,4486,2173,3487,1694,18,1712,1064,648,1.641975309,956,1980,483,180,178,2,59,2,0.095505618,0,empty,CD-0722-4
"C8,D8",7178,7830,5215,2615,4184,2073,0,2075,1336,739,1.807848444,1168,1458,382,119,119,0,39,0,0.042016807,0,empty,CD-0722-4
"C8,D9",479427,546026,347528,198498,272051,149162,6,149341,127841,21500,5.946093023,88158,211734,46097,17442,17229,213,2334,8,0.027511753,0,hg38,CD-0722-4
"C8,D10",8821,9449,6554,2895,4984,2487,0,2487,1600,887,1.803833145,1381,1073,250,97,95,2,21,1,0.010526316,0,empty,CD-0722-4
"C8,D11",8209,8786,6075,2711,4652,2214,2,2218,1397,821,1.701583435,1244,3699,1130,417,411,6,84,2,0.092457421,0,empty,CD-0722-4
"C8,D12",10870,11792,8055,3737,6132,3037,1,3041,1965,1076,1.826208178,1733,3867,1145,475,466,9,120,2,0.06223176,0,empty,CD-0722-4
"C8,E1",14853,16143,11074,5069,8341,4068,0,4070,2621,1449,1.808833678,2275,2551,684,232,231,1,63,1,0.142857143,0,empty,CD-0722-4
"C8,E2",9006,9684,6672,3012,4989,2434,0,2438,1510,928,1.627155172,1349,1911,381,165,163,2,46,1,0.012269939,0,empty,CD-0722-4
"C8,E3",6102,6809,4531,2278,3557,1731,3,1736,1120,616,1.818181818,1002,2734,645,258,253,5,64,2,0.027667984,0,empty,CD-0722-4
"C8,E4",8607,9347,6180,3167,4935,2425,15,2442,1636,806,2.029776675,1370,2539,495,243,243,0,77,0,0.090534979,0,empty,CD-0722-4
"C8,E5",7754,8398,5813,2585,4418,2066,0,2067,1321,746,1.77077748,1165,1688,327,131,130,1,45,1,0.053846154,0,empty,CD-0722-4
"C8,E6",13420,14956,9872,5084,7716,3907,0,3908,2586,1322,1.95612708,2252,4680,1201,451,450,1,124,1,0.097777778,0,empty,CD-0722-4
"C8,E7",12666,13840,9508,4332,7192,3460,18,3485,2250,1235,1.821862348,1956,3588,706,329,326,3,112,1,0.030674847,0,empty,CD-0722-4
"C8,E8",11283,12005,8488,3517,6336,2998,1,3000,1980,1020,1.941176471,1637,4816,989,397,388,9,114,3,0.069587629,0,empty,CD-0722-4
"C8,E9",6658,7178,4769,2409,3714,1828,0,1833,1206,627,1.923444976,1028,2607,585,250,248,2,61,1,0.084677419,0,empty,CD-0722-4
"C8,E10",7428,8031,5517,2514,4323,2068,5,2075,1361,714,1.906162465,1179,2654,637,250,245,5,69,1,0.081632653,0,empty,CD-0722-4
"C8,E11",8880,9519,6606,2913,5010,2490,0,2493,1574,919,1.71273123,1362,2220,745,251,248,3,51,2,0.024193548,0,empty,CD-0722-4
"C8,E12",10292,11524,7396,4128,6130,3149,0,3156,2082,1074,1.938547486,1899,2052,446,167,167,0,50,0,0.017964072,0,empty,CD-0722-4
"C8,F1",11158,11998,8148,3850,6205,3020,0,3024,1954,1070,1.826168224,1706,3046,753,274,272,2,60,1,0.080882353,0,empty,CD-0722-4
"C8,F2",8470,8902,6173,2729,4709,2242,0,2246,1438,808,1.77970297,1257,3497,1056,369,365,4,93,2,0.123287671,0,empty,CD-0722-4
"C8,F3",8646,9216,6264,2952,5020,2468,0,2473,1606,867,1.852364475,1405,3307,790,296,291,5,82,3,0.024054983,0,empty,CD-0722-4
"C8,F4",12538,13069,9425,3644,6925,3224,1,3233,2079,1154,1.801559792,1716,725,78,48,47,1,20,1,0.085106383,0,empty,CD-0722-4
"C8,F5",950686,1052300,708467,343833,508665,261288,3,261537,203890,57647,3.536870956,148825,107983,21142,7922,7794,128,1249,6,0.036951501,0,hg38,CD-0722-4
"C8,F6",926795,1068927,687122,381805,520807,278418,4,278664,208347,70317,2.962967703,166305,264906,31720,12541,12165,376,1636,8,0.085162351,0,hg38,CD-0722-4
"C8,F7",1309833,1528376,966126,562250,750429,416353,1,416674,336334,80340,4.186382873,248191,68783,10147,3924,3863,61,767,4,0.06549314,0,hg38,CD-0722-4
"C8,F8",7752,8554,5798,2756,4499,2208,16,2224,1487,737,2.017639077,1209,615,115,48,47,1,18,1,0,0,empty,CD-0722-4
"C8,F9",1031065,1204296,754648,449648,588998,332262,3,332542,276942,55600,4.980971223,197022,51904,14974,5466,5430,36,1008,2,0.020073665,0,hg38,CD-0722-4
"C8,F10",11690,12502,8862,3640,6448,3000,35,3045,1969,1076,1.829925651,1680,2510,411,174,173,1,70,1,0.063583815,0,empty,CD-0722-4
"C8,F11",8832,9527,6591,2936,4892,2306,11,2317,1524,793,1.921815889,1248,1831,294,108,105,3,39,2,0.066666667,0,empty,CD-0722-4
"C8,F12",931172,1068128,684196,383932,515749,276815,2,277068,211390,65678,3.218581565,165320,13078,1353,554,536,18,107,3,0.061567164,0,hg38,CD-0722-4
"C8,G1",10054,10731,7448,3283,5794,2753,10,2770,1816,954,1.903563941,1565,3127,747,296,294,2,71,2,0.003401361,0,empty,CD-0722-4
"C8,G2",9834,10957,6799,4158,5727,3319,0,3320,2102,1218,1.725779967,1978,680,138,64,62,2,22,1,0,0,empty,CD-0722-4
"C8,G3",12693,13603,9323,4280,6969,3452,0,3457,2169,1288,1.684006211,1900,2895,613,243,237,6,64,2,0.126582278,0,empty,CD-0722-4
"C8,G4",20397,22862,14765,8097,11508,6322,0,6328,3800,2528,1.503164557,3613,90,17,12,12,0,3,0,0,0,empty,CD-0722-4
"C8,G5",6944,7747,5098,2649,3961,2063,0,2064,1306,758,1.722955145,1152,1949,424,201,196,5,53,2,0.071428571,0,empty,CD-0722-4
"C8,G6",1134429,1291901,839826,452075,627348,338409,2,338717,301665,37052,8.141665767,195925,14625,2436,940,921,19,195,3,0.081433225,0,hg38,CD-0722-4
"C8,G7",8142,8775,6212,2563,4643,2157,0,2162,1373,789,1.74017744,1180,3507,865,363,361,2,95,1,0.232686981,0,empty,CD-0722-4
"C8,G8",6292,6718,4591,2127,3540,1724,12,1738,1103,635,1.737007874,999,2568,535,247,243,4,72,2,0.094650206,0,empty,CD-0722-4
"C8,G9",12092,13752,8714,5038,6954,3863,16,3881,2701,1180,2.288983051,2259,3111,842,349,340,9,85,2,0.032352941,0,empty,CD-0722-4
"C8,G10",8728,9743,6409,3334,5068,2559,0,2561,1616,945,1.71005291,1471,2205,604,272,271,1,81,1,0.062730627,0,empty,CD-0722-4
"C8,G11",8873,9468,6571,2897,5003,2372,14,2396,1533,863,1.77636153,1301,1784,409,159,154,5,45,1,0.058441558,0,empty,CD-0722-4
"C8,G12",7268,8090,5332,2758,4257,2156,4,2162,1379,783,1.761174968,1264,2587,553,237,237,0,54,0,0.054852321,0,empty,CD-0722-4
"C8,H1",779304,863650,590944,272706,425029,209449,4,209664,159653,50011,3.192357681,120418,91972,9580,3731,3617,114,697,5,0.071329831,0,hg38,CD-0722-4
"C8,H2",1005839,1158804,749461,409343,565184,297433,25,297708,223197,74511,2.995490599,177202,187626,26691,10027,9843,184,1439,3,0.029970537,0,hg38,CD-0722-4
"C8,H3",6976,7490,5099,2391,3901,1887,0,1888,1234,654,1.886850153,1059,2474,569,241,234,7,58,1,0.158119658,0,empty,CD-0722-4
"C8,H4",10716,11449,7848,3601,5926,2897,0,2898,1866,1032,1.808139535,1604,213,58,29,28,1,11,1,0.464285714,0,empty,CD-0722-4
"C8,H5",52808,61063,36269,24794,29904,18086,0,18101,12452,5649,2.204283944,10635,2185,541,203,201,2,53,2,0.094527363,0,empty,CD-0722-4
"C8,H6",685155,767927,517412,250515,378365,190057,0,190247,149825,40422,3.706521201,109783,62831,17270,6110,6011,99,921,3,0.015804359,0,hg38,CD-0722-4
"C8,H7",7905,8358,5711,2647,4493,2176,0,2176,1491,685,2.176642336,1206,2331,620,242,239,3,57,2,0.033472803,0,empty,CD-0722-4
"C8,H8",2224549,2572896,1671295,901601,1218005,673871,3,674517,542387,132130,4.104949671,395449,452624,63707,25191,24663,528,3084,10,0.043668653,0,hg38,CD-0722-4
"C8,H9",8318,8942,6239,2703,4552,2073,12,2091,1393,698,1.995702006,1155,1301,305,145,143,2,40,1,0.076923077,0,empty,CD-0722-4
"C8,H10",9366,10381,6841,3540,5285,2631,5,2644,1865,779,2.394094994,1533,2392,342,155,155,0,43,0,0.083870968,0,empty,CD-0722-4
"C8,H11",8092,9053,5683,3370,4672,2790,0,2795,1541,1254,1.228867624,1626,47,0,0,0,0,0,0,0,0,empty,CD-0722-4
"C8,H12",6791,7603,4749,2854,3926,2136,1,2141,1388,753,1.843293493,1294,1348,319,138,133,5,30,2,0.270676692,0,empty,CD-0722-4
"C9,A1",6487,7422,4710,2712,3853,2050,0,2052,1283,769,1.66840052,1203,1655,257,101,100,1,33,1,0.01,0,empty,CD-0722-4
"C9,A2",839880,949990,626709,323281,463220,246011,0,246222,194812,51410,3.789379498,140869,139209,21995,8732,8609,123,1444,6,0.034382623,0,hg38,CD-0722-4
"C9,A3",5977,6590,4501,2089,3366,1652,0,1653,1050,603,1.741293532,898,1287,302,120,120,0,40,0,0.041666667,0,empty,CD-0722-4
"C9,A4",10780,11469,8046,3423,5928,2800,5,2809,1772,1037,1.708775313,1578,962,179,72,72,0,27,0,0.055555556,0,empty,CD-0722-4
"C9,A5",9153,9789,6796,2993,5038,2371,10,2381,1564,817,1.914320685,1302,3181,750,307,295,12,74,2,0.115254237,0,empty,CD-0722-4
"C9,A6",7140,7954,5311,2643,4282,2256,0,2259,1422,837,1.698924731,1307,3429,858,374,371,3,88,2,0.161725067,0,empty,CD-0722-4
"C9,A7",6828,7301,4994,2307,3749,1910,6,1916,1197,719,1.664812239,1049,1582,368,138,137,1,43,1,0.00729927,0,empty,CD-0722-4
"C9,A8",3972,4301,2993,1308,2224,1096,0,1096,756,340,2.223529412,607,2814,741,258,252,6,67,2,0.087301587,0,empty,CD-0722-4
"C9,A9",6781,7445,5131,2314,3891,1885,0,1886,1200,686,1.749271137,1061,2347,532,214,214,0,55,0,0.186915888,0,empty,CD-0722-4
"C9,A10",7565,8196,5658,2538,4274,2079,0,2081,1270,811,1.565967941,1162,459,96,32,32,0,13,0,0.09375,0,empty,CD-0722-4
"C9,A11",5927,6306,4530,1776,3276,1497,14,1513,942,571,1.649737303,810,1952,481,181,176,5,42,2,0.136363636,0,empty,CD-0722-4
"C9,A12",8419,8865,6250,2615,4524,2133,0,2134,1341,793,1.691046658,1168,3776,805,329,327,2,96,2,0.125382263,0,empty,CD-0722-4
"C9,B1",984598,1074542,756854,317688,519394,249296,1,249565,187275,62290,3.006501846,138905,152855,15366,6103,5950,153,1014,7,0.036134454,0,hg38,CD-0722-4
"C9,B2",7813,8600,5299,3301,4444,2358,2,2363,1472,891,1.652076319,1396,428,96,35,35,0,13,0,0.028571429,0,empty,CD-0722-4
"C9,B3",5650,6280,4202,2078,3219,1592,0,1593,1041,552,1.885869565,895,1770,331,143,143,0,43,0,0.048951049,0,empty,CD-0722-4
"C9,B4",6294,7321,4513,2808,3901,2090,0,2090,1269,821,1.545676005,1283,1684,502,201,200,1,49,1,0.045,0,empty,CD-0722-4
"C9,B5",8140,4688,2822,1866,3023,1656,14,1683,1114,569,1.957820738,1100,1340,266,90,90,0,30,0,0,0,empty,CD-0722-4
"C9,B6",7751,8557,5749,2808,4508,2365,1,2367,1464,903,1.621262458,1300,1988,398,174,170,4,47,2,0.158823529,0,empty,CD-0722-4
"C9,B7",7643,8360,5733,2627,4313,2117,0,2121,1361,760,1.790789474,1169,1530,313,144,142,2,36,1,0.035211268,0,empty,CD-0722-4
"C9,B8",5463,5866,4138,1728,3020,1430,6,1440,971,469,2.070362473,783,1022,289,127,126,1,39,1,0.111111111,0,empty,CD-0722-4
"C9,B9",9784,10981,7250,3731,5702,3018,1,3021,1834,1187,1.545071609,1702,1130,392,161,159,2,48,1,0.150943396,0,empty,CD-0722-4
"C9,B10",5398,5772,3848,1924,3156,1631,0,1633,1027,606,1.694719472,917,911,194,59,58,1,28,1,0,0,empty,CD-0722-4
"C9,B11",14988,16780,11002,5778,8519,4540,0,4546,2711,1835,1.477384196,2675,175,7,5,4,1,3,1,0,0,empty,CD-0722-4
"C9,B12",1841619,2201987,1330811,871176,1066047,626561,3,627101,509362,117739,4.326196078,382062,471984,74443,27931,27438,493,3202,13,0.064399738,0,hg38,CD-0722-4
"C9,C1",35368,36271,28520,7751,17528,6662,0,6665,4288,2377,1.803954565,3421,1466,285,121,121,0,35,0,0.123966942,0,empty,CD-0722-4
"C9,C2",11014,12082,7999,4083,6283,3216,0,3220,2054,1166,1.761578045,1842,2676,814,318,317,1,68,1,0.129337539,0,empty,CD-0722-4
"C9,C3",11032,12132,8236,3896,6228,2981,0,2993,1921,1072,1.791977612,1710,1037,228,95,94,1,21,1,0.010638298,0,empty,CD-0722-4
"C9,C4",6665,7084,4988,2096,3742,1703,0,1704,1130,574,1.968641115,939,2170,596,237,237,0,61,0,0.130801688,0,empty,CD-0722-4
"C9,C5",9502,10369,7097,3272,5377,2593,0,2596,1642,954,1.721174004,1451,1689,323,111,106,5,39,2,0.056603774,0,empty,CD-0722-4
"C9,C6",1853607,2213562,1309367,904195,1098792,684467,6,685053,500876,184177,2.719536098,417488,42894,11258,3807,3765,42,752,2,0.048871182,0,hg38,CD-0722-4
"C9,C7",1128704,1328858,816564,512294,647771,372983,5,373337,315423,57914,5.446403288,224182,27541,4141,1690,1651,39,385,4,0.029073289,0,hg38,CD-0722-4
"C9,C8",11925,12883,8873,4010,6717,3377,0,3381,2127,1254,1.696172249,1842,3573,884,341,337,4,81,2,0.014836795,0,empty,CD-0722-4
"C9,C9",8862,9717,6563,3154,5141,2517,22,2542,1713,829,2.066344994,1420,2291,439,183,181,2,45,2,0.198895028,0,empty,CD-0722-4
"C9,C10",9831,10658,7202,3456,5455,2677,0,2682,1686,996,1.692771084,1530,2283,561,184,179,5,47,2,0.139664804,0,empty,CD-0722-4
"C9,C11",629130,812018,407775,404243,407559,290748,3,290983,208706,82277,2.536626275,187205,4186,880,303,296,7,82,1,0.003378378,0,hg38,CD-0722-4
"C9,C12",11638,12461,8669,3792,6500,3158,16,3182,2036,1146,1.776614311,1781,2943,874,294,294,0,64,0,0.040816327,0,empty,CD-0722-4
"C9,D1",10395,11739,7438,4301,5987,3193,0,3196,1879,1317,1.426727411,1825,964,175,57,57,0,16,0,0.070175439,0,empty,CD-0722-4
"C9,D2",9054,9657,6874,2783,5062,2349,0,2353,1517,836,1.814593301,1308,3045,788,312,307,5,79,3,0.039087948,0,empty,CD-0722-4
"C9,D3",7674,8332,5708,2624,4304,2045,0,2047,1346,701,1.920114123,1092,1495,298,114,112,2,43,1,0.026785714,0,empty,CD-0722-4
"C9,D4",6077,7029,4523,2506,3544,1831,0,1831,1193,638,1.869905956,1063,1872,532,229,227,2,39,2,0.030837004,0,empty,CD-0722-4
"C9,D5",6569,7331,4799,2532,3721,1844,0,1850,1191,659,1.807283763,1072,1906,356,159,156,3,42,2,0.16025641,0,empty,CD-0722-4
"C9,D6",10718,11563,7689,3874,5973,3117,0,3121,1877,1244,1.508842444,1819,2806,785,312,311,1,60,1,0.051446945,0,empty,CD-0722-4
"C9,D7",6086,6436,4642,1794,3385,1578,0,1580,1015,565,1.796460177,834,2211,486,214,212,2,48,2,0.009433962,0,empty,CD-0722-4
"C9,D8",821015,980219,565622,414597,484023,314124,1,314355,225900,88455,2.553840936,189651,3891,652,190,181,9,60,2,0.093922652,0,hg38,CD-0722-4
"C9,D9",4717,4997,3531,1466,2630,1239,0,1241,797,444,1.795045045,669,1993,539,210,209,1,49,1,0.129186603,0,empty,CD-0722-4
"C9,D10",7717,8684,5685,2999,4562,2361,0,2361,1483,878,1.689066059,1391,965,122,70,69,1,20,1,0.057971014,0,empty,CD-0722-4
"C9,D11",7729,8158,5719,2439,4305,2046,0,2052,1280,772,1.658031088,1129,3211,912,300,297,3,80,1,0.063973064,0,empty,CD-0722-4
"C9,D12",10653,11783,7909,3874,5995,2980,7,2991,1951,1040,1.875961538,1666,4910,1363,511,502,9,129,2,0.057768924,0,empty,CD-0722-4
"C9,E1",12501,13513,9056,4457,7019,3594,1,3596,2183,1413,1.544939844,2039,2529,521,195,192,3,66,2,0.041666667,0,empty,CD-0722-4
"C9,E2",8746,9858,6353,3505,5129,2667,0,2667,1653,1014,1.630177515,1564,2741,408,189,185,4,70,1,0.005405405,0,empty,CD-0722-4
"C9,E3",5976,6580,4417,2163,3394,1615,0,1617,1069,548,1.950729927,945,3034,923,318,316,2,76,1,0.028481013,0,empty,CD-0722-4
"C9,E4",8374,9179,6139,3040,4856,2434,0,2435,1493,942,1.58492569,1397,3319,668,279,277,2,80,2,0.061371841,0,empty,CD-0722-4
"C9,E5",7708,8111,5879,2232,4198,1889,7,1900,1203,697,1.725968436,1013,1189,452,170,170,0,39,0,0.011764706,0,empty,CD-0722-4
"C9,E6",12911,14171,9556,4615,7376,3724,0,3726,2378,1348,1.764094955,2123,4529,1240,472,468,4,108,2,0.042735043,0,empty,CD-0722-4
"C9,E7",11943,12591,8978,3613,6399,2975,1,2980,1887,1093,1.726440988,1586,3635,996,376,374,2,92,1,0.106951872,0,empty,CD-0722-4
"C9,E8",9601,10342,7371,2971,5311,2398,7,2410,1517,893,1.698768197,1327,3008,515,235,232,3,73,1,0.086206897,0,empty,CD-0722-4
"C9,E9",723097,818290,539936,278354,400516,210736,1,210956,166468,44488,3.741862974,121574,166840,24075,9183,8997,186,1331,5,0.07613649,0,hg38,CD-0722-4
"C9,E10",7493,8040,5445,2595,4269,2063,10,2080,1351,729,1.853223594,1181,2126,603,217,214,3,53,2,0.056074766,0,empty,CD-0722-4
"C9,E11",8369,9035,5978,3057,4864,2506,0,2508,1595,913,1.746987952,1456,1813,495,185,182,3,44,2,0.153846154,0,empty,CD-0722-4
"C9,E12",8537,9278,6186,3092,4910,2459,23,2484,1562,922,1.694143167,1444,2422,427,179,176,3,53,1,0.056818182,0,empty,CD-0722-4
"C9,F1",10914,11814,8088,3726,6049,2997,0,2997,1906,1091,1.747021082,1671,3102,852,280,280,0,69,0,0.032142857,0,empty,CD-0722-4
"C9,F2",8482,8999,6295,2704,4770,2284,0,2284,1462,822,1.778588808,1285,3466,925,364,363,1,81,1,0.093663912,0,empty,CD-0722-4
"C9,F3",8242,8848,6073,2775,4607,2187,0,2189,1382,807,1.712515489,1269,2679,608,236,235,1,63,1,0.055319149,0,empty,CD-0722-4
"C9,F4",12134,13140,9226,3914,6801,3236,1,3239,2093,1146,1.826352531,1768,894,136,72,71,1,16,1,0.309859155,0,empty,CD-0722-4
"C9,F5",9815,10344,7447,2897,5403,2493,8,2504,1622,882,1.839002268,1331,2530,694,250,247,3,66,1,0.08097166,0,empty,CD-0722-4
"C9,F6",857511,975345,642338,333007,477350,248233,2,248524,188178,60346,3.118317701,146414,188521,25624,9991,9756,235,1519,5,0.046945469,0,hg38,CD-0722-4
"C9,F7",11063,12001,8298,3703,6215,3030,0,3032,1962,1070,1.83364486,1649,1265,268,110,109,1,33,1,0.036697248,0,empty,CD-0722-4
"C9,F8",8790,9637,6591,3046,5019,2463,0,2468,1601,867,1.846597463,1399,481,31,22,21,1,10,1,0.142857143,0,empty,CD-0722-4
"C9,F9",878827,970546,666328,304218,475257,239998,0,240240,185256,54984,3.369271061,134949,85240,14441,5470,5388,82,923,4,0.017631774,0,hg38,CD-0722-4
"C9,F10",10979,12090,8359,3731,6245,2961,0,2966,1917,1049,1.827454719,1664,2197,483,219,218,1,70,1,0.064220183,0,empty,CD-0722-4
"C9,F11",8390,8858,6494,2364,4598,2001,10,2019,1356,663,2.045248869,1065,1813,268,117,116,1,40,1,0.025862069,0,empty,CD-0722-4
"C9,F12",9276,9960,6657,3303,5192,2567,0,2573,1613,960,1.680208333,1435,247,63,41,41,0,12,0,0.414634146,0,empty,CD-0722-4
"C9,G1",13378,14576,10202,4374,7464,3482,0,3492,2275,1217,1.869350863,2014,8535,1197,451,439,12,116,2,0.184510251,0,empty,CD-0722-4
"C9,G2",5962,6495,4188,2307,3424,1765,9,1775,1082,693,1.561327561,1035,424,74,38,38,0,13,0,0.052631579,0,empty,CD-0722-4
"C9,G3",11142,12184,8229,3955,6278,3174,0,3179,1891,1288,1.468167702,1772,3322,732,299,295,4,91,1,0.040677966,0,empty,CD-0722-4
"C9,G4",20221,23010,14472,8538,11679,6461,19,6488,3905,2583,1.511807975,3835,115,8,5,5,0,4,0,0,0,empty,CD-0722-4
"C9,G5",7354,7969,5473,2496,4049,1937,0,1939,1272,667,1.907046477,1092,1920,514,189,188,1,43,1,0.244680851,0,empty,CD-0722-4
"C9,G6",10713,11683,7909,3774,5970,2921,0,2925,1943,982,1.978615071,1684,331,47,25,20,5,9,1,0.5,0,empty,CD-0722-4
"C9,G7",8198,8653,6177,2476,4463,2019,32,2053,1313,740,1.774324324,1080,3077,564,242,234,8,81,2,0.038461538,0,empty,CD-0722-4
"C9,G8",5792,6182,4291,1891,3270,1608,5,1613,1078,535,2.014953271,881,2108,591,232,232,0,54,0,0.081896552,0,empty,CD-0722-4
"C9,G9",7323,7855,5387,2468,4167,2050,0,2052,1330,722,1.842105263,1126,3055,524,233,225,8,79,2,0.04,0,empty,CD-0722-4
"C9,G10",8332,9202,6189,3013,4769,2355,0,2361,1460,901,1.620421754,1329,2449,704,213,212,1,70,1,0.04245283,0,empty,CD-0722-4
"C9,G11",8648,9236,6633,2603,4804,2236,0,2240,1444,796,1.814070352,1231,1567,444,183,182,1,59,1,0.016483516,0,empty,CD-0722-4
"C9,G12",7037,7717,5149,2568,4047,2038,0,2038,1300,738,1.761517615,1191,2735,670,281,277,4,55,3,0.039711191,0,empty,CD-0722-4
"C9,H1",7453,8022,5478,2544,4235,2030,0,2030,1263,767,1.646675359,1202,1352,344,139,137,2,43,2,0.087591241,0,empty,CD-0722-4
"C9,H2",1227115,1433875,878961,554914,697309,419290,2,419663,335365,84298,3.978326888,247427,319382,73296,28126,27811,315,2936,8,0.028981338,0,hg38,CD-0722-4
"C9,H3",7047,7795,5030,2765,4074,2088,1,2090,1377,713,1.931276297,1250,1816,327,137,137,0,42,0,0.109489051,0,empty,CD-0722-4
"C9,H4",706977,755856,539839,216017,369531,176482,2,176639,133429,43210,3.087919463,97717,1926,356,143,141,2,32,2,0.078014184,0,hg38,CD-0722-4
"C9,H5",11253,12063,8142,3921,6235,3165,0,3171,1964,1207,1.627174814,1838,2806,618,242,240,2,74,1,0.1375,0,empty,CD-0722-4
"C9,H6",6712,7312,4802,2510,3833,1998,8,2009,1300,709,1.833568406,1177,2213,623,238,237,1,60,1,0.168776371,0,empty,CD-0722-4
"C9,H7",7638,8153,5730,2423,4229,1980,0,1983,1380,603,2.288557214,1092,1919,422,168,161,7,51,2,0.086956522,0,empty,CD-0722-4
"C9,H8",18301,20544,13759,6785,10477,5334,0,5342,3827,1515,2.526072607,3054,3081,681,236,233,3,65,1,0.064377682,0,empty,CD-0722-4
"C9,H9",7610,8179,5805,2374,4162,1937,9,1948,1337,611,2.188216039,1020,1897,446,139,138,1,44,1,0.036231884,0,empty,CD-0722-4
"C9,H10",1192348,1368690,895790,472900,655173,352560,1,352947,284277,68670,4.139755352,205249,160232,18609,7168,6975,193,1301,5,0.021218638,0,hg38,CD-0722-4
"C9,H11",8005,9241,5480,3761,4833,2893,9,2905,1629,1276,1.276645768,1767,98,56,19,19,0,2,0,0,0,empty,CD-0722-4
"C9,H12",6325,6775,4552,2223,3481,1791,0,1791,1186,605,1.960330579,1025,1718,275,91,91,0,23,0,0.197802198,0,empty,CD-0722-4
"C10,A1",7075,7802,5096,2706,4252,2218,1,2220,1387,833,1.665066026,1318,1405,350,146,146,0,23,0,0.109589041,0,empty,CD-0722-4
"C10,A2",12105,13489,8907,4582,6985,3614,4,3619,2302,1317,1.747911921,2114,1996,567,183,181,2,55,2,0.016574586,0,empty,CD-0722-4
"C10,A3",7010,7578,5290,2288,4026,1975,33,2010,1360,650,2.092307692,1096,1246,235,101,98,3,34,2,0.102040816,0,empty,CD-0722-4
"C10,A4",11624,12756,8555,4201,6535,3244,1,3252,2039,1213,1.680956307,1819,686,202,87,83,4,26,1,0.156626506,0,empty,CD-0722-4
"C10,A5",10688,11508,7882,3626,6051,2965,1,2970,1968,1002,1.964071856,1664,2389,566,197,194,3,61,2,0.108247423,0,empty,CD-0722-4
"C10,A6",21761,25005,15492,9513,12969,7536,8,7548,5275,2273,2.320721513,4482,3092,657,255,250,5,75,3,0.064,0,empty,CD-0722-4
"C10,A7",7658,8447,5634,2813,4307,2174,13,2188,1424,764,1.863874346,1222,1278,364,122,122,0,35,0,0.06557377,0,empty,CD-0722-4
"C10,A8",4633,5113,3450,1663,2702,1358,0,1361,944,417,2.263788969,763,2035,510,198,193,5,52,2,0.088082902,0,empty,CD-0722-4
"C10,A9",8175,9122,6230,2892,4726,2269,19,2289,1485,804,1.847014925,1310,1957,407,182,181,1,60,1,0.049723757,0,empty,CD-0722-4
"C10,A10",9938,10712,7476,3236,5435,2603,0,2603,1614,989,1.631951466,1463,379,21,15,14,1,8,1,0.071428571,0,empty,CD-0722-4
"C10,A11",6899,7587,5279,2308,3902,1848,0,1849,1218,631,1.930269414,997,1865,535,225,223,2,48,2,0.112107623,0,empty,CD-0722-4
"C10,A12",9976,10631,7385,3246,5571,2656,0,2663,1797,866,2.075057737,1495,3298,881,337,336,1,76,1,0.053571429,0,empty,CD-0722-4
"C10,B1",8552,9551,6183,3368,4902,2559,0,2559,1599,960,1.665625,1462,1209,327,119,117,2,33,1,0.290598291,0,empty,CD-0722-4
"C10,B2",8651,9272,5688,3584,4847,2599,0,2601,1595,1006,1.585487078,1592,736,169,57,57,0,14,0,0,0,empty,CD-0722-4
"C10,B3",6995,7942,5188,2754,4044,2028,0,2030,1298,732,1.773224044,1142,1720,297,119,115,4,44,2,0.008695652,0,empty,CD-0722-4
"C10,B4",8319,9686,5834,3852,5079,2864,0,2868,1747,1121,1.558429973,1777,1314,332,137,132,5,35,2,0.166666667,0,empty,CD-0722-4
"C10,B5",9089,5495,3470,2025,3543,1844,0,1860,1237,623,1.985553772,1178,1115,226,75,73,2,30,2,0.01369863,0,empty,CD-0722-4
"C10,B6",9520,10751,6728,4023,5523,2929,0,2933,1841,1092,1.685897436,1767,2066,484,179,175,4,51,1,0.154285714,0,empty,CD-0722-4
"C10,B7",8393,9003,6351,2652,4714,2260,3,2265,1508,757,1.992073976,1222,1605,355,153,151,2,47,1,0.059602649,0,empty,CD-0722-4
"C10,B8",5976,6643,4552,2091,3440,1647,0,1647,1091,556,1.962230216,860,1266,205,91,90,1,35,1,0.077777778,0,empty,CD-0722-4
"C10,B9",11978,13232,8882,4350,6712,3400,0,3402,2180,1222,1.78396072,1932,1300,173,78,78,0,30,0,0.076923077,0,empty,CD-0722-4
"C10,B10",5777,6256,4118,2138,3355,1664,0,1665,1024,641,1.5975039,933,662,71,38,38,0,16,0,0.289473684,0,empty,CD-0722-4
"C10,B11",12843,14259,9613,4646,7230,3819,0,3825,2171,1654,1.312575574,2088,338,23,10,9,1,7,1,0,0,empty,CD-0722-4
"C10,B12",7389,8340,5532,2808,4263,2109,1,2113,1372,741,1.851551957,1190,1350,374,148,147,1,40,1,0.06122449,0,empty,CD-0722-4
"C10,C1",14406,15262,10761,4501,7944,3787,0,3787,2399,1388,1.728386167,2047,1393,240,113,112,1,40,1,0.0625,0,empty,CD-0722-4
"C10,C2",768025,920623,522685,397938,450040,295912,1,296165,222621,73544,3.027045034,178731,8341,1315,357,345,12,106,2,0.017391304,0,hg38,CD-0722-4
"C10,C3",11546,12530,8646,3884,6517,3097,0,3097,1868,1229,1.519934906,1729,777,145,69,66,3,22,1,0.03030303,0,empty,CD-0722-4
"C10,C4",7880,8387,5952,2435,4421,2048,0,2053,1327,726,1.827823691,1088,1806,484,188,188,0,49,0,0.154255319,0,empty,CD-0722-4
"C10,C5",10964,12199,8134,4065,6326,3159,0,3159,2115,1044,2.025862069,1829,2099,414,164,160,4,56,1,0.00625,0,empty,CD-0722-4
"C10,C6",9103,9869,6663,3206,5190,2521,0,2524,1597,927,1.722761597,1443,1579,424,161,161,0,38,0,0.037267081,0,empty,CD-0722-4
"C10,C7",12527,14351,8831,5520,7305,4071,0,4074,2400,1674,1.433691756,2466,461,83,45,45,0,14,0,0,0,empty,CD-0722-4
"C10,C8",1984918,2256393,1493265,763128,1071880,569936,1,570468,443717,126751,3.500698219,329092,311226,42313,16182,15818,364,2301,10,0.047035023,0,hg38,CD-0722-4
"C10,C9",11958,12968,8966,4002,6743,3260,1,3263,2137,1126,1.897868561,1804,1833,351,156,156,0,42,0,0,0,empty,CD-0722-4
"C10,C10",11214,12601,8302,4299,6352,3176,0,3180,2069,1111,1.862286229,1753,2254,534,177,174,3,43,2,0,0,empty,CD-0722-4
"C10,C11",9550,10402,7157,3245,5503,2671,0,2672,1743,929,1.87621098,1526,1858,468,174,173,1,55,1,0.046242775,0,empty,CD-0722-4
"C10,C12",14037,15244,10591,4653,7801,3723,1,3729,2450,1279,1.91555903,2074,2753,748,272,271,1,65,1,0.022140221,0,empty,CD-0722-4
"C10,D1",11908,13047,8670,4377,6794,3573,5,3580,2138,1442,1.482662968,2014,940,287,101,99,2,22,1,0,0,empty,CD-0722-4
"C10,D2",9836,10227,7582,2645,5392,2382,1,2386,1608,778,2.066838046,1189,2961,806,352,350,2,98,2,0.085714286,0,empty,CD-0722-4
"C10,D3",8963,9862,6590,3272,5074,2547,8,2559,1735,824,2.105582524,1471,2075,408,186,177,9,48,2,0.033898305,0,empty,CD-0722-4
"C10,D4",8057,9044,6097,2947,4678,2345,0,2349,1535,814,1.885749386,1327,1493,321,140,139,1,38,1,0.057553957,0,empty,CD-0722-4
"C10,D5",8047,8819,5967,2852,4463,2175,1,2178,1464,714,2.050420168,1200,1744,349,147,142,5,41,1,0.056338028,0,empty,CD-0722-4
"C10,D6",11917,13094,8411,4683,6652,3599,0,3600,2146,1454,1.475928473,2017,2099,499,187,181,6,48,1,0.038674033,0,empty,CD-0722-4
"C10,D7",6835,7477,5066,2411,3949,1867,0,1874,1227,647,1.896445131,1100,1973,504,202,197,5,52,2,0.010152284,0,empty,CD-0722-4
"C10,D8",64920,70703,49706,20997,34082,15986,0,16007,12483,3524,3.542281498,8842,3934,981,376,373,3,89,2,0.050938338,0,empty,CD-0722-4
"C10,D9",4258,4702,3209,1493,2463,1142,19,1165,758,407,1.862407862,663,1545,397,144,144,0,42,0,0.006944444,0,empty,CD-0722-4
"C10,D10",7947,8600,5924,2676,4462,2227,0,2229,1467,762,1.92519685,1223,1055,259,117,116,1,29,1,0.215517241,0,empty,CD-0722-4
"C10,D11",8794,9503,6638,2865,4997,2361,0,2362,1505,857,1.756126021,1319,3180,823,289,284,5,85,1,0.116197183,0,empty,CD-0722-4
"C10,D12",1100743,1263807,816745,447062,609543,332204,3,332530,266895,65635,4.066351794,194436,139564,18040,7010,6852,158,1387,10,0.021745476,0,hg38,CD-0722-4
"C10,E1",2096980,2322239,1598273,723966,1090512,554578,6,555167,424369,130798,3.244460924,313180,279002,42035,16198,15880,318,2238,10,0.038035264,0,hg38,CD-0722-4
"C10,E2",10479,11686,7566,4120,5973,3009,3,3016,1913,1103,1.734360834,1788,1909,319,128,127,1,44,1,0.047244094,0,empty,CD-0722-4
"C10,E3",6589,7279,4999,2280,3784,1806,0,1809,1166,643,1.813374806,1007,2225,776,314,313,1,68,1,0.019169329,0,empty,CD-0722-4
"C10,E4",10074,10833,7279,3554,5646,2804,0,2808,1820,988,1.842105263,1610,2744,439,202,199,3,70,1,0.120603015,0,empty,CD-0722-4
"C10,E5",8716,9488,6745,2743,4826,2228,6,2239,1500,739,2.029769959,1201,1488,468,171,171,0,40,0,0.058479532,0,empty,CD-0722-4
"C10,E6",15072,16891,11137,5754,8638,4423,3,4432,2819,1613,1.747675139,2503,3219,718,286,284,2,87,2,0.070422535,0,empty,CD-0722-4
"C10,E7",1436714,1708556,1001497,707059,828944,532227,1,532647,390631,142016,2.750612607,318132,20588,2225,611,581,30,139,2,0.149741824,0,hg38,CD-0722-4
"C10,E8",958883,1046720,732946,313774,503521,245923,2,246154,199801,46353,4.310422195,135582,228328,22755,8149,7864,285,1273,10,0.09155646,0,hg38,CD-0722-4
"C10,E9",6859,7653,5156,2497,4011,1960,0,1966,1301,665,1.956390977,1124,2466,538,238,235,3,74,1,0.072340426,0,empty,CD-0722-4
"C10,E10",7799,8670,5813,2857,4574,2225,0,2225,1451,774,1.874677003,1299,2094,532,213,209,4,50,1,0.162679426,0,empty,CD-0722-4
"C10,E11",9973,10697,7402,3295,5568,2779,1,2782,1758,1024,1.716796875,1539,2330,657,227,226,1,57,1,0.022123894,0,empty,CD-0722-4
"C10,E12",9967,11152,7417,3735,5823,2870,0,2870,1813,1057,1.715231788,1688,1877,194,118,115,3,52,1,0.069565217,0,empty,CD-0722-4
"C10,F1",12462,13146,9158,3988,6934,3378,0,3386,2067,1319,1.567096285,1859,2485,648,261,261,0,61,0,0.057471264,0,empty,CD-0722-4
"C10,F2",9921,10567,7508,3059,5555,2592,28,2620,1667,953,1.749213012,1426,2874,759,303,302,1,66,1,0.158940397,0,empty,CD-0722-4
"C10,F3",9440,10259,7004,3255,5299,2419,24,2443,1626,817,1.990208078,1372,2799,823,298,296,2,76,1,0.131756757,0,empty,CD-0722-4
"C10,F4",13552,14595,10162,4433,7464,3572,3,3580,2329,1251,1.861710631,1958,430,51,27,24,3,17,2,0.041666667,0,empty,CD-0722-4
"C10,F5",10942,11789,8227,3562,6017,2728,7,2736,1800,936,1.923076923,1518,2425,543,195,189,6,64,1,0.08994709,0,empty,CD-0722-4
"C10,F6",11760,13042,8638,4404,6703,3404,0,3404,2185,1219,1.79245283,1948,2836,566,219,215,4,79,2,0.060465116,0,empty,CD-0722-4
"C10,F7",12240,13147,9183,3964,6970,3368,4,3378,2156,1222,1.764320786,1863,1222,274,101,101,0,36,0,0.02970297,0,empty,CD-0722-4
"C10,F8",8676,9562,6429,3133,4997,2472,3,2477,1629,848,1.920990566,1379,316,22,14,14,0,12,0,0.071428571,0,empty,CD-0722-4
"C10,F9",10247,11109,7701,3408,5718,2713,0,2713,1740,973,1.788283659,1494,3100,661,269,268,1,73,1,0.055970149,0,empty,CD-0722-4
"C10,F10",12420,13504,9455,4049,6930,3256,10,3271,2143,1128,1.899822695,1812,2213,596,199,199,0,57,0,0.085427136,0,empty,CD-0722-4
"C10,F11",9836,10560,7552,3008,5431,2545,1,2546,1708,838,2.038186158,1361,2034,474,185,184,1,31,1,0.114130435,0,empty,CD-0722-4
"C10,F12",10521,11636,7646,3990,5965,2993,0,2993,1998,995,2.008040201,1748,241,46,36,35,1,13,1,0.514285714,0,empty,CD-0722-4
"C10,G1",11255,12596,8351,4245,6613,3184,0,3186,2095,1091,1.920256645,1900,3260,951,346,343,3,77,1,0.099125364,0,empty,CD-0722-4
"C10,G2",6846,7477,4796,2681,3810,1981,1,1982,1200,782,1.534526854,1156,450,101,51,51,0,20,0,0.352941176,0,empty,CD-0722-4
"C10,G3",1968620,2206350,1482835,723515,1043293,546648,3,547146,428182,118964,3.599256918,313813,128995,20399,7732,7607,125,1283,8,0.028263442,0,hg38,CD-0722-4
"C10,G4",21806,24279,15465,8814,12512,6864,0,6877,4208,2669,1.576620457,3990,89,12,9,7,2,5,1,0,0,empty,CD-0722-4
"C10,G5",7452,8333,5434,2899,4283,2121,1,2125,1265,860,1.470930233,1257,1865,426,198,196,2,43,2,0.091836735,0,empty,CD-0722-4
"C10,G6",11081,12010,8243,3767,6237,2987,0,2987,1889,1098,1.720400729,1697,173,72,34,34,0,9,0,0,0,empty,CD-0722-4
"C10,G7",9424,10235,7299,2936,5300,2383,0,2387,1532,855,1.791812865,1291,2365,491,206,199,7,62,1,0.085427136,0,empty,CD-0722-4
"C10,G8",948885,1089212,710596,378616,527676,278366,1,278610,225951,52659,4.290833476,162756,268036,54270,21314,21030,284,2568,7,0.050451736,0,hg38,CD-0722-4
"C10,G9",29497,34638,20943,13695,17074,10033,0,10050,6151,3899,1.577583996,5942,2420,445,177,174,3,65,1,0.097701149,0,empty,CD-0722-4
"C10,G10",13698,14947,10295,4652,7519,3646,0,3646,2317,1329,1.743416102,2053,3770,1130,383,383,0,94,0,0.054830287,0,empty,CD-0722-4
"C10,G11",9883,10926,7590,3336,5685,2709,0,2709,1771,938,1.888059701,1522,1333,340,140,140,0,46,0,0.05,0,empty,CD-0722-4
"C10,G12",7851,8897,5753,3144,4646,2360,3,2365,1488,877,1.696693273,1375,2032,601,225,224,1,55,1,0.098214286,0,empty,CD-0722-4
"C10,H1",8490,9238,6385,2853,4859,2259,2,2263,1436,827,1.736396614,1286,1341,350,151,150,1,43,1,0.206666667,0,empty,CD-0722-4
"C10,H2",9294,10286,6836,3450,5280,2665,0,2668,1643,1025,1.602926829,1511,2570,660,238,236,2,68,1,0.055084746,0,empty,CD-0722-4
"C10,H3",1072078,1274872,771100,503772,618012,358540,4,358856,296730,62126,4.776261147,219508,91753,14447,5805,5668,137,929,4,0.08592096,0,hg38,CD-0722-4
"C10,H4",12078,13061,8951,4110,6604,3191,11,3206,2125,1081,1.965772433,1784,153,15,13,12,1,9,1,0.083333333,0,empty,CD-0722-4
"C10,H5",12362,13588,9241,4347,6881,3420,0,3424,2192,1232,1.779220779,1936,1660,410,132,131,1,41,1,0.091603053,0,empty,CD-0722-4
"C10,H6",7522,8628,5464,3164,4508,2418,0,2418,1556,862,1.805104408,1447,1747,449,169,169,0,57,0,0.035502959,0,empty,CD-0722-4
"C10,H7",9293,10080,6953,3127,5200,2456,1,2458,1540,918,1.677559913,1403,1818,379,192,191,1,57,1,0.062827225,0,empty,CD-0722-4
"C10,H8",10500,11911,7816,4095,6109,3143,0,3143,2041,1102,1.852087114,1806,2162,401,182,180,2,68,1,0.083333333,0,empty,CD-0722-4
"C10,H9",8039,8802,6032,2770,4491,2075,5,2086,1350,736,1.83423913,1151,985,206,89,85,4,40,2,0.058823529,0,empty,CD-0722-4
"C10,H10",6997,7923,5278,2645,3939,1953,24,1977,1218,759,1.604743083,1140,1430,351,104,104,0,28,0,0.038461538,0,empty,CD-0722-4
"C10,H11",9762,11342,6862,4480,5777,3453,0,3455,1843,1612,1.143300248,2002,60,32,18,18,0,4,0,0,0,empty,CD-0722-4
"C10,H12",8222,8828,5967,2861,4457,2247,0,2247,1489,758,1.964379947,1257,1612,290,100,99,1,29,1,0.070707071,0,empty,CD-0722-4
"C11,A1",7329,8212,5434,2778,4372,2293,0,2293,1539,754,2.041114058,1352,1394,324,134,133,1,42,1,0.203007519,0,empty,CD-0722-4
"C11,A2",13034,14201,9795,4406,7247,3537,0,3539,2239,1300,1.722307692,1941,2525,570,183,181,2,43,1,0.044198895,0,empty,CD-0722-4
"C11,A3",6654,7287,4853,2434,3850,1911,1,1913,1303,610,2.136065574,1091,1375,360,127,126,1,36,1,0.031746032,0,empty,CD-0722-4
"C11,A4",11559,12487,8621,3866,6567,3204,20,3230,2088,1142,1.828371278,1862,772,91,40,38,2,12,2,0,0,empty,CD-0722-4
"C11,A5",16419,17944,12545,5399,9166,4268,0,4278,2847,1431,1.98951782,2393,6341,645,256,249,7,61,2,0.096385542,0,empty,CD-0722-4
"C11,A6",25494,28362,19387,8975,14427,7240,1,7257,5198,2059,2.524526469,4059,3103,599,236,234,2,72,1,0.170940171,0,empty,CD-0722-4
"C11,A7",28375,33702,19797,13905,17040,10555,0,10564,7546,3018,2.500331345,6343,1487,441,181,180,1,46,1,0.105555556,0,empty,CD-0722-4
"C11,A8",4832,5287,3624,1663,2768,1394,0,1395,911,484,1.882231405,772,1895,530,199,198,1,51,1,0.055555556,0,empty,CD-0722-4
"C11,A9",1559590,1711271,1206614,504657,826834,406983,2,407361,333665,73696,4.5275863,226930,88443,13283,5080,4966,114,857,4,0.028191704,0,hg38,CD-0722-4
"C11,A10",9359,10289,7123,3166,5350,2620,0,2626,1649,977,1.687819857,1434,347,82,44,44,0,11,0,0.068181818,0,empty,CD-0722-4
"C11,A11",6827,7542,5093,2449,3925,1817,12,1829,1203,626,1.92172524,1045,1440,149,81,78,3,29,1,0.025641026,0,empty,CD-0722-4
"C11,A12",10096,10685,7664,3021,5620,2646,0,2649,1735,914,1.898249453,1427,3130,574,245,242,3,74,2,0.004132231,0,empty,CD-0722-4
"C11,B1",8025,8980,5975,3005,4710,2419,0,2424,1505,919,1.637649619,1421,1176,311,125,125,0,35,0,0.072,0,empty,CD-0722-4
"C11,B2",9851,11049,6838,4211,5706,3094,19,3115,1973,1142,1.727670753,1892,702,100,51,51,0,16,0,0,0,empty,CD-0722-4
"C11,B3",6772,7436,4880,2556,3967,1990,9,2002,1262,740,1.705405405,1171,1529,230,85,85,0,26,0,0.082352941,0,empty,CD-0722-4
"C11,B4",8006,9187,5778,3409,4773,2557,25,2585,1628,957,1.701149425,1531,1207,247,112,112,0,24,0,0.241071429,0,empty,CD-0722-4
"C11,B5",982294,589894,348438,241456,377117,214051,16,215326,180023,35303,5.099368326,138007,55168,8969,3470,3423,47,647,3,0.048787613,0,hg38,CD-0722-4
"C11,B6",8929,10006,6476,3530,5219,2763,13,2778,1747,1031,1.694471387,1608,1507,329,143,140,3,38,1,0.1,0,empty,CD-0722-4
"C11,B7",11022,12152,8314,3838,6308,3279,1,3282,2109,1173,1.797953964,1793,1487,483,183,183,0,46,0,0.120218579,0,empty,CD-0722-4
"C11,B8",6523,7077,4927,2150,3788,1810,0,1817,1199,618,1.94012945,1023,1307,262,99,99,0,27,0,0.131313131,0,empty,CD-0722-4
"C11,B9",11635,12598,8561,4037,6536,3297,7,3311,2061,1250,1.6488,1803,1217,281,82,82,0,32,0,0.012195122,0,empty,CD-0722-4
"C11,B10",5998,6167,4312,1855,3468,1671,0,1676,1022,654,1.562691131,946,396,48,22,22,0,7,0,0,0,empty,CD-0722-4
"C11,B11",12990,14764,9454,5310,7565,4166,0,4169,2340,1829,1.279387644,2459,219,28,10,10,0,7,0,0,0,empty,CD-0722-4
"C11,B12",7027,7964,5266,2698,4097,2009,0,2012,1358,654,2.076452599,1131,2007,428,149,147,2,40,2,0.102040816,0,empty,CD-0722-4
"C11,C1",855358,900820,675632,225188,438214,186313,2,186553,145977,40576,3.597619282,99202,12519,3221,1218,1211,7,238,2,0.014863749,0,hg38,CD-0722-4
"C11,C2",11765,13163,8583,4580,6835,3576,0,3581,2244,1337,1.678384443,2040,2395,743,293,292,1,68,1,0.01369863,0,empty,CD-0722-4
"C11,C3",15664,17532,11569,5963,9220,4659,0,4663,3172,1491,2.127431254,2703,844,233,62,61,1,21,1,0.131147541,0,empty,CD-0722-4
"C11,C4",7907,8471,5944,2527,4435,2006,0,2011,1354,657,2.060882801,1114,1587,489,200,196,4,46,1,0.086734694,0,empty,CD-0722-4
"C11,C5",11416,12531,8351,4180,6359,3137,59,3200,2065,1135,1.81938326,1834,1858,376,151,149,2,35,1,0.060402685,0,empty,CD-0722-4
"C11,C6",16640,20127,11804,8323,10599,6522,0,6532,4672,1860,2.511827957,3995,1000,187,88,87,1,37,1,0.057471264,0,empty,CD-0722-4
"C11,C7",53623,56742,39789,16953,27578,13310,32,13346,9537,3809,2.503806773,7334,1170,155,76,74,2,19,1,0,0,empty,CD-0722-4
"C11,C8",13970,15508,10353,5155,7926,3929,28,3957,2562,1395,1.83655914,2246,2594,692,313,313,0,86,0,0.111821086,0,empty,CD-0722-4
"C11,C9",910711,1033944,694296,339648,506816,255968,1,256209,197183,59026,3.340612611,148554,129207,17318,6640,6479,161,1102,6,0.048618614,0,hg38,CD-0722-4
"C11,C10",11422,12209,8609,3600,6243,2955,0,2959,1937,1022,1.895303327,1593,2145,276,106,105,1,40,1,0.133333333,0,empty,CD-0722-4
"C11,C11",9941,11195,7353,3842,5781,2897,0,2900,1837,1063,1.72812794,1678,1959,485,190,187,3,54,1,0.037433155,0,empty,CD-0722-4
"C11,C12",13817,15196,10351,4845,7900,3796,3,3804,2517,1287,1.955710956,2175,2425,777,277,272,5,55,1,0.139705882,0,empty,CD-0722-4
"C11,D1",12029,13578,8618,4960,7045,3766,0,3768,2312,1456,1.587912088,2257,808,131,47,47,0,20,0,0,0,empty,CD-0722-4
"C11,D2",11011,12143,8338,3805,6240,2919,0,2922,1910,1012,1.887351779,1618,3421,896,345,333,12,71,2,0.018018018,0,empty,CD-0722-4
"C11,D3",8973,10003,6499,3504,5228,2701,0,2705,1788,917,1.949836423,1592,1606,309,139,139,0,40,0,0.014388489,0,empty,CD-0722-4
"C11,D4",1234635,1418416,927247,491169,686999,373784,20,374152,290024,84128,3.447413465,216273,41261,7061,2777,2737,40,566,2,0.019364267,0,hg38,CD-0722-4
"C11,D5",7891,8741,5870,2871,4431,2171,0,2173,1326,847,1.565525384,1214,1615,309,118,109,9,33,2,0.073394495,0,empty,CD-0722-4
"C11,D6",12085,13362,8670,4692,6841,3669,0,3671,2175,1496,1.453877005,2074,1434,425,175,173,2,49,1,0.057803468,0,empty,CD-0722-4
"C11,D7",6546,6899,4990,1909,3742,1744,0,1745,1132,613,1.846655791,956,2065,589,222,215,7,53,2,0.134883721,0,empty,CD-0722-4
"C11,D8",8079,8920,5825,3095,4581,2311,0,2315,1494,821,1.819732034,1344,1426,313,125,123,2,33,2,0.081300813,0,empty,CD-0722-4
"C11,D9",4344,4634,3283,1351,2456,1161,5,1169,732,437,1.675057208,651,1594,454,191,190,1,42,1,0.157894737,0,empty,CD-0722-4
"C11,D10",7833,8700,5758,2942,4527,2307,0,2311,1491,820,1.818292683,1339,782,160,76,76,0,20,0,0.105263158,0,empty,CD-0722-4
"C11,D11",14106,15858,10288,5570,8149,4445,0,4445,2737,1708,1.602459016,2520,2506,831,276,276,0,53,0,0.086956522,0,empty,CD-0722-4
"C11,D12",11535,12879,8681,4198,6516,3258,6,3268,2119,1149,1.844212359,1809,4047,858,329,322,7,84,2,0.034161491,0,empty,CD-0722-4
"C11,E1",14303,15529,10547,4982,7928,3959,0,3963,2481,1482,1.674089069,2201,2459,591,210,208,2,53,1,0.110576923,0,empty,CD-0722-4
"C11,E2",10198,11707,7446,4261,5988,3091,0,3098,1872,1226,1.526916803,1862,2337,462,171,168,3,46,2,0.05952381,0,empty,CD-0722-4
"C11,E3",9945,10744,7705,3039,5566,2501,6,2514,1655,859,1.926658906,1396,4206,1046,411,406,5,86,1,0.13546798,0,empty,CD-0722-4
"C11,E4",9774,10803,7192,3611,5564,2802,0,2809,1780,1029,1.729834791,1616,2636,733,259,255,4,58,1,0.117647059,0,empty,CD-0722-4
"C11,E5",7997,8660,6020,2640,4480,2074,0,2075,1364,711,1.918424754,1168,1185,370,154,152,2,32,2,0.052631579,0,empty,CD-0722-4
"C11,E6",14571,16005,10806,5199,8130,3964,0,3971,2542,1429,1.77886634,2206,3467,899,381,375,6,91,1,0.042666667,0,empty,CD-0722-4
"C11,E7",1877149,2117777,1421363,696414,1006803,528829,5,529337,414844,114493,3.623313216,302122,44507,10412,3760,3719,41,717,4,0.023393385,0,hg38,CD-0722-4
"C11,E8",10866,11830,8368,3462,6183,2897,0,2897,1931,966,1.998964803,1552,3054,782,293,284,9,62,2,0.028169014,0,empty,CD-0722-4
"C11,E9",6952,7778,5188,2590,4044,2036,0,2039,1322,717,1.843793584,1167,2273,479,208,206,2,53,1,0.101941748,0,empty,CD-0722-4
"C11,E10",8161,8837,6203,2634,4577,2126,2,2139,1359,780,1.742307692,1187,1667,454,191,191,0,45,0,0.005235602,0,empty,CD-0722-4
"C11,E11",9531,10513,6997,3516,5412,2705,0,2705,1715,990,1.732323232,1517,1905,413,164,163,1,49,1,0.030674847,0,empty,CD-0722-4
"C11,E12",9915,10823,7298,3525,5571,2772,0,2774,1768,1006,1.757455268,1571,1912,432,148,145,3,47,1,0.131034483,0,empty,CD-0722-4
"C11,F1",12311,13416,9124,4292,7031,3487,1,3491,2189,1302,1.681259601,1972,2525,807,289,287,2,50,2,0.094076655,0,empty,CD-0722-4
"C11,F2",1974784,2250366,1469038,781328,1081873,583318,24,583889,462383,121506,3.805433477,342624,330813,46369,18080,17738,342,2302,12,0.059420453,0,hg38,CD-0722-4
"C11,F3",9348,9789,6928,2861,5183,2509,0,2512,1595,917,1.739367503,1356,2279,524,201,199,2,67,2,0.050251256,0,empty,CD-0722-4
"C11,F4",13423,14710,10060,4650,7595,3715,0,3722,2457,1265,1.94229249,2077,566,76,38,37,1,11,1,0.648648649,0,empty,CD-0722-4
"C11,F5",10968,11985,8412,3573,6140,2822,0,2827,1771,1056,1.677083333,1555,2276,357,160,160,0,48,0,0.0375,0,empty,CD-0722-4
"C11,F6",11632,12962,8499,4463,6906,3622,0,3623,2306,1317,1.750949127,2157,3211,640,305,305,0,88,0,0.009836066,0,empty,CD-0722-4
"C11,F7",11987,13328,9112,4216,7052,3474,0,3480,2239,1241,1.804190169,1970,1061,305,121,120,1,30,1,0.025,0,empty,CD-0722-4
"C11,F8",8964,9911,6742,3169,5155,2473,9,2482,1612,870,1.852873563,1440,274,33,26,26,0,10,0,0.115384615,0,empty,CD-0722-4
"C11,F9",9859,10714,7570,3144,5531,2585,0,2593,1731,862,2.00812065,1362,3285,815,290,282,8,70,2,0.056737589,0,empty,CD-0722-4
"C11,F10",12370,13593,9472,4121,7003,3333,28,3368,2167,1201,1.804329725,1867,1993,408,142,142,0,52,0,0.028169014,0,empty,CD-0722-4
"C11,F11",9888,10440,7503,2937,5446,2427,0,2430,1622,808,2.007425743,1330,1781,419,146,143,3,32,2,0.111888112,0,empty,CD-0722-4
"C11,F12",10926,11705,8069,3636,6036,2912,3,2923,1890,1033,1.829622459,1612,181,29,20,20,0,9,0,0,0,empty,CD-0722-4
"C11,G1",11336,12415,8630,3785,6493,3112,0,3117,2010,1107,1.815718157,1721,2857,677,276,275,1,74,1,0.105454545,0,empty,CD-0722-4
"C11,G2",6863,7364,4940,2424,3812,1906,14,1922,1236,686,1.801749271,1083,358,94,45,45,0,11,0,0.022222222,0,empty,CD-0722-4
"C11,G3",12481,13020,9319,3701,6675,3228,36,3264,1975,1289,1.5321955,1669,2905,901,306,303,3,58,3,0.079207921,0,empty,CD-0722-4
"C11,G4",23128,25812,16595,9217,13095,7234,50,7293,4418,2875,1.536695652,4161,53,7,3,3,0,2,0,0,0,empty,CD-0722-4
"C11,G5",7911,8525,5757,2768,4469,2222,0,2224,1396,828,1.685990338,1274,2090,442,192,187,5,48,1,0.053475936,0,empty,CD-0722-4
"C11,G6",11029,12092,8380,3712,6218,3016,0,3016,2023,993,2.037260826,1691,211,26,11,11,0,7,0,0,0,empty,CD-0722-4
"C11,G7",8981,9784,6815,2969,5268,2458,0,2460,1575,885,1.779661017,1383,2856,704,275,270,5,73,2,0.014814815,0,empty,CD-0722-4
"C11,G8",1001581,1131598,756669,374929,551978,285717,1,285998,224518,61480,3.651886792,165796,35813,8723,3107,3063,44,619,4,0.023506366,0,hg38,CD-0722-4
"C11,G9",8289,9144,6162,2982,4602,2223,0,2226,1423,803,1.772104608,1235,2557,566,268,265,3,69,2,0.143396226,0,empty,CD-0722-4
"C11,G10",9816,10874,7291,3583,5742,2882,0,2886,1853,1033,1.793804453,1656,2620,504,230,228,2,62,2,0.074561404,0,empty,CD-0722-4
"C11,G11",9844,10623,7367,3256,5540,2621,0,2624,1776,848,2.094339623,1424,1466,352,99,98,1,24,1,0,0,empty,CD-0722-4
"C11,G12",7995,8798,5885,2913,4517,2296,4,2306,1455,851,1.709753231,1317,1943,498,182,180,2,55,1,0.044444444,0,empty,CD-0722-4
"C11,H1",8439,9351,6291,3060,4941,2448,26,2476,1634,842,1.940617577,1437,1624,426,130,128,2,42,1,0.0625,0,empty,CD-0722-4
"C11,H2",9484,10225,7047,3178,5261,2584,0,2587,1696,891,1.903479237,1415,2590,610,211,207,4,61,2,0.06763285,0,empty,CD-0722-4
"C11,H3",778602,929364,540675,388689,467223,300444,0,300704,184664,116040,1.591382282,184040,2476,653,197,194,3,55,2,0.175257732,0,hg38,CD-0722-4
"C11,H4",11286,12271,8430,3841,6350,3059,12,3072,1980,1092,1.813186813,1718,205,112,39,39,0,6,0,0.820512821,0,empty,CD-0722-4
"C11,H5",1356590,1594432,992710,601722,770530,433290,2,433664,352762,80902,4.360361919,260848,133381,29227,10970,10837,133,1529,5,0.040693919,0,hg38,CD-0722-4
"C11,H6",1405080,1623803,1050857,572946,786814,431270,0,431614,346112,85502,4.047998877,254247,200888,32055,12130,11913,217,1839,5,0.045580458,0,hg38,CD-0722-4
"C11,H7",8992,9694,6660,3034,5077,2407,0,2413,1602,811,1.975339088,1343,1777,461,167,166,1,39,1,0.024096386,0,empty,CD-0722-4
"C11,H8",10570,11795,7650,4145,6117,3159,0,3160,1982,1178,1.682512733,1870,2586,571,257,254,3,74,1,0.094488189,0,empty,CD-0722-4
"C11,H9",7768,8251,5833,2418,4310,2054,0,2059,1367,692,1.975433526,1141,1543,522,185,184,1,40,1,0.005434783,0,empty,CD-0722-4
"C11,H10",6801,7521,4985,2536,3819,1860,2,1868,1195,673,1.775631501,1065,1656,302,86,83,3,23,1,0.012048193,0,empty,CD-0722-4
"C11,H11",9462,10899,6506,4393,5625,3412,10,3426,1833,1593,1.150659134,2070,43,0,0,0,0,0,0,0,0,empty,CD-0722-4
"C11,H12",7771,8733,5677,3056,4444,2321,0,2323,1460,863,1.691772885,1381,1267,279,127,120,7,28,2,0,0,empty,CD-0722-4
"C12,A1",6841,7484,5037,2447,3981,2005,0,2007,1226,781,1.56978233,1139,1286,205,90,89,1,30,1,0.146067416,0,empty,CD-0722-4
"C12,A2",10734,11816,8080,3736,6048,2988,0,2998,1849,1149,1.609225413,1632,2024,460,209,207,2,52,1,0.207729469,0,empty,CD-0722-4
"C12,A3",7240,7763,5229,2534,4205,2100,9,2117,1392,725,1.92,1196,887,206,96,95,1,29,1,0.115789474,0,empty,CD-0722-4
"C12,A4",11061,12092,8244,3848,6326,3124,9,3141,2034,1107,1.837398374,1772,724,159,77,73,4,23,2,0,0,empty,CD-0722-4
"C12,A5",9544,10612,7213,3399,5551,2710,0,2713,1743,970,1.796907216,1496,2646,560,240,237,3,69,2,0.004219409,0,empty,CD-0722-4
"C12,A6",8641,9902,6393,3509,5148,2686,3,2700,1731,969,1.786377709,1550,2655,709,278,276,2,75,1,0.039855072,0,empty,CD-0722-4
"C12,A7",7100,8234,5192,3042,4154,2156,1,2161,1345,816,1.648284314,1299,1116,237,117,117,0,37,0,0.008547009,0,empty,CD-0722-4
"C12,A8",1354991,1619722,1015321,604401,785419,443990,1,444367,368210,76157,4.834880576,263522,217566,29522,11618,11391,227,1739,10,0.077253972,0,hg38,CD-0722-4
"C12,A9",7741,8504,5727,2777,4538,2236,0,2236,1476,760,1.942105263,1248,2101,509,189,189,0,50,0,0.100529101,0,empty,CD-0722-4
"C12,A10",9441,10177,7206,2971,5106,2415,0,2418,1534,884,1.735294118,1332,388,41,25,25,0,14,0,0,0,empty,CD-0722-4
"C12,A11",6774,7502,5106,2396,3911,1855,0,1860,1167,693,1.683982684,1040,2360,433,154,150,4,39,2,0.18,0,empty,CD-0722-4
"C12,A12",9174,9958,6958,3000,5131,2458,0,2462,1583,879,1.800910125,1410,22771,3415,1287,1261,26,274,3,0.063441713,0,empty,CD-0722-4
"C12,B1",8005,8875,5862,3013,4656,2387,11,2403,1488,915,1.626229508,1407,887,132,82,82,0,26,0,0,0,empty,CD-0722-4
"C12,B2",8154,8611,5693,2918,4443,2358,3,2361,1498,863,1.73580533,1325,482,121,55,55,0,15,0,0.127272727,0,empty,CD-0722-4
"C12,B3",6287,6965,4672,2293,3677,1855,0,1857,1157,700,1.652857143,1061,1058,243,122,122,0,35,0,0.040983607,0,empty,CD-0722-4
"C12,B4",7298,8181,5344,2837,4280,2336,1,2342,1405,937,1.499466382,1328,1266,349,146,145,1,40,1,0.24137931,0,empty,CD-0722-4
"C12,B5",7915,4800,3077,1723,3144,1606,0,1617,1066,551,1.934664247,999,935,205,69,68,1,26,1,0.014705882,0,empty,CD-0722-4
"C12,B6",9118,10252,6690,3562,5402,2918,0,2920,1836,1084,1.693726937,1697,1528,409,149,148,1,46,1,0.087837838,0,empty,CD-0722-4
"C12,B7",7936,9151,6084,3067,4786,2381,0,2385,1497,888,1.685810811,1375,1244,253,102,102,0,36,0,0.009803922,0,empty,CD-0722-4
"C12,B8",6043,6629,4565,2064,3396,1571,2,1576,1020,556,1.834532374,896,1334,304,109,109,0,34,0,0.229357798,0,empty,CD-0722-4
"C12,B9",11363,12547,8334,4213,6453,3285,26,3311,2052,1259,1.629864972,1928,1130,337,135,134,1,34,1,0.044776119,0,empty,CD-0722-4
"C12,B10",5347,5680,3902,1778,3122,1500,0,1503,1015,488,2.079918033,829,494,75,41,41,0,16,0,0.024390244,0,empty,CD-0722-4
"C12,B11",12278,13560,8895,4665,6967,3796,0,3800,2138,1662,1.286401925,2190,152,10,8,8,0,7,0,0.125,0,empty,CD-0722-4
"C12,B12",7234,7624,5304,2320,4177,1999,0,2000,1321,679,1.9455081,1148,12214,2067,812,802,10,143,2,0.089775561,0,empty,CD-0722-4
"C12,C1",14614,16142,10832,5310,8027,3855,1,3864,2450,1414,1.732673267,2185,1155,206,87,87,0,31,0,0.034482759,0,empty,CD-0722-4
"C12,C2",10940,12153,7953,4200,6184,3094,0,3104,2018,1086,1.858195212,1799,1917,364,154,154,0,48,0,0.025974026,0,empty,CD-0722-4
"C12,C3",11157,12207,8446,3761,6412,3190,0,3194,1917,1277,1.501174628,1772,966,216,118,118,0,25,0,0.06779661,0,empty,CD-0722-4
"C12,C4",8007,8608,6059,2549,4522,2170,0,2174,1400,774,1.80878553,1196,1633,222,92,92,0,33,0,0.076086957,0,empty,CD-0722-4
"C12,C5",11917,12833,8951,3882,6636,3176,0,3177,2063,1114,1.851885099,1748,1449,479,141,141,0,42,0,0.063829787,0,empty,CD-0722-4
"C12,C6",1100216,1259329,820883,438446,621206,331883,3,332254,263604,68650,3.8398252,194649,91368,15945,6133,6033,100,1093,6,0.035803083,0,hg38,CD-0722-4
"C12,C7",661455,764150,501318,262832,372748,198068,0,198221,156740,41481,3.77859743,115434,1941,742,271,271,0,65,0,0.103321033,0,hg38,CD-0722-4
"C12,C8",13146,14284,9846,4438,7421,3712,0,3715,2364,1351,1.749814952,2077,2692,535,233,230,3,58,1,0.17826087,0,empty,CD-0722-4
"C12,C9",9582,10474,7120,3354,5477,2630,0,2632,1705,927,1.839266451,1489,1350,260,110,110,0,38,0,0.036363636,0,empty,CD-0722-4
"C12,C10",1045339,1158670,807004,351666,556944,271637,5,271959,205709,66250,3.105041509,152534,87458,10966,4474,4364,110,787,4,0.053620532,0,hg38,CD-0722-4
"C12,C11",9439,10458,7041,3417,5354,2634,0,2636,1647,989,1.665318504,1501,3123,646,253,251,2,64,1,0.087649402,0,empty,CD-0722-4
"C12,C12",12839,13774,9863,3911,7148,3347,0,3353,2231,1122,1.988413547,1808,14643,2306,914,902,12,186,2,0.035476718,0,empty,CD-0722-4
"C12,D1",11401,12797,8078,4719,6737,3665,0,3667,2192,1475,1.486101695,2139,733,55,27,26,1,12,1,0,0,empty,CD-0722-4
"C12,D2",9422,10172,7157,3015,5301,2457,1,2462,1596,866,1.84295612,1338,2669,878,326,323,3,74,1,0.095975232,0,empty,CD-0722-4
"C12,D3",8747,9772,6347,3425,5076,2612,14,2633,1731,902,1.919068736,1496,1917,508,200,199,1,46,1,0.060301508,0,empty,CD-0722-4
"C12,D4",8073,8702,6022,2680,4637,2223,0,2223,1459,764,1.909685864,1266,1423,404,148,148,0,44,0,0.081081081,0,empty,CD-0722-4
"C12,D5",7389,7980,5457,2523,4163,2059,0,2059,1321,738,1.7899729,1134,1917,470,169,169,0,46,0,0,0,empty,CD-0722-4
"C12,D6",740980,811164,562614,248550,396301,193420,1,193622,146712,46910,3.127520784,109295,40931,8774,3383,3329,54,634,7,0.012316011,0,hg38,CD-0722-4
"C12,D7",6422,6956,4718,2238,3651,1728,0,1731,1174,557,2.107719928,968,1820,453,158,157,1,38,1,0.050955414,0,empty,CD-0722-4
"C12,D8",7726,8379,5775,2604,4449,2125,0,2130,1367,763,1.791612058,1176,1058,245,106,104,2,27,1,0.086538462,0,empty,CD-0722-4
"C12,D9",612051,708985,449044,259941,347384,189646,0,189777,152517,37260,4.09331723,112561,158389,29158,11253,11059,194,1727,8,0.058142689,0,hg38,CD-0722-4
"C12,D10",8259,9055,6075,2980,4706,2407,0,2410,1529,881,1.735527809,1374,1034,251,100,99,1,25,1,0.262626263,0,empty,CD-0722-4
"C12,D11",8638,9543,6542,3001,4921,2396,21,2420,1575,845,1.863905325,1337,4132,1124,457,457,0,94,0,0.072210066,0,empty,CD-0722-4
"C12,D12",11610,12868,8590,4278,6685,3406,1,3409,2126,1283,1.65705378,1968,15595,2345,960,935,25,207,3,0.049197861,0,empty,CD-0722-4
"C12,E1",14412,15631,10234,5397,8344,4296,12,4310,2718,1592,1.707286432,2505,2421,565,193,190,3,63,2,0.110526316,0,empty,CD-0722-4
"C12,E2",9864,10457,7227,3230,5490,2716,9,2732,1705,1027,1.660175268,1547,2021,360,175,173,2,42,1,0.034682081,0,empty,CD-0722-4
"C12,E3",6716,7387,5201,2186,3869,1785,3,1794,1144,650,1.76,995,1701,272,131,122,9,56,2,0.057377049,0,empty,CD-0722-4
"C12,E4",1068181,1288163,777575,510588,625545,370322,2,370610,284985,85625,3.328291971,224962,12544,3365,1173,1163,10,374,2,0.023215821,0,hg38,CD-0722-4
"C12,E5",952572,1049413,739442,309971,506329,239432,1,239720,184269,55451,3.323096067,133482,100111,14578,5615,5496,119,960,4,0.036572052,0,hg38,CD-0722-4
"C12,E6",14512,15669,10663,5006,8096,4049,1,4050,2596,1454,1.785419532,2244,2911,629,207,206,1,70,1,0.033980583,0,empty,CD-0722-4
"C12,E7",13473,14374,9968,4406,7371,3507,16,3528,2265,1263,1.793349169,1945,2520,564,266,261,5,77,2,0.011494253,0,empty,CD-0722-4
"C12,E8",10892,11392,8235,3157,6093,2783,24,2815,1803,1012,1.781620553,1523,2528,658,313,309,4,59,2,0.093851133,0,empty,CD-0722-4
"C12,E9",6882,7694,5079,2615,3976,1975,0,1977,1302,675,1.928888889,1144,2643,653,217,216,1,52,1,0.074074074,0,empty,CD-0722-4
"C12,E10",7741,8277,5906,2371,4348,2005,25,2031,1303,728,1.789835165,1121,1818,417,159,158,1,48,1,0,0,empty,CD-0722-4
"C12,E11",9714,10287,7096,3191,5498,2769,0,2773,1796,977,1.83828045,1495,3410,567,221,216,5,50,2,0.041666667,0,empty,CD-0722-4
"C12,E12",10789,12359,8007,4352,6333,3185,0,3189,2089,1100,1.899090909,1895,5630,800,289,280,9,75,2,0.053571429,0,empty,CD-0722-4
"C12,F1",11739,12198,8556,3642,6461,3115,0,3119,1986,1133,1.752868491,1729,1555,275,121,116,5,43,1,0.025862069,0,empty,CD-0722-4
"C12,F2",9035,9870,6705,3165,5042,2415,0,2424,1596,828,1.927536232,1351,2621,533,185,185,0,60,0,0.081081081,0,empty,CD-0722-4
"C12,F3",9184,10125,6759,3366,5174,2558,14,2572,1691,881,1.919409762,1451,2345,645,226,225,1,61,1,0.057777778,0,empty,CD-0722-4
"C12,F4",13492,14574,10123,4451,7511,3482,13,3496,2294,1202,1.908485857,1921,658,109,53,52,1,19,1,0,0,empty,CD-0722-4
"C12,F5",10722,11509,7989,3520,5924,2784,8,2796,1824,972,1.87654321,1568,2003,522,218,213,5,59,2,0.0657277,0,empty,CD-0722-4
"C12,F6",11379,12426,8184,4242,6533,3455,2,3464,2180,1284,1.697819315,2010,3412,565,250,247,3,84,2,0.068825911,0,empty,CD-0722-4
"C12,F7",11726,12734,8656,4078,6649,3218,0,3221,2126,1095,1.941552511,1763,1015,204,71,67,4,24,2,0.164179104,0,empty,CD-0722-4
"C12,F8",8770,9631,6431,3200,5256,2526,55,2582,1738,844,2.059241706,1498,267,39,20,18,2,11,2,0.222222222,0,empty,CD-0722-4
"C12,F9",2229466,2543802,1668187,875615,1209730,657613,3,658177,541014,117163,4.61761819,380143,397801,60201,24357,23901,456,2946,10,0.084473453,0,hg38,CD-0722-4
"C12,F10",11931,12706,9218,3488,6459,2961,1,2963,1927,1036,1.86003861,1507,2496,638,243,242,1,58,1,0.123966942,0,empty,CD-0722-4
"C12,F11",854048,970951,634634,336317,472804,252232,0,252427,200990,51437,3.907498493,146507,136064,19276,7750,7615,135,1262,6,0.048588313,0,hg38,CD-0722-4
"C12,F12",10292,11012,7633,3379,5555,2678,0,2679,1762,917,1.921483097,1458,1113,174,76,76,0,19,0,0.013157895,0,empty,CD-0722-4
"C12,G1",11167,12275,8402,3873,6452,3103,0,3108,1989,1119,1.777479893,1727,2944,645,277,273,4,73,1,0.073260073,0,empty,CD-0722-4
"C12,G2",6457,6834,4609,2225,3618,1872,5,1877,1139,738,1.543360434,1065,511,129,41,41,0,9,0,0,0,empty,CD-0722-4
"C12,G3",12428,13136,9014,4122,6781,3313,0,3321,2033,1288,1.578416149,1786,2220,617,247,247,0,63,0,0.024291498,0,empty,CD-0722-4
"C12,G4",1282964,1433222,985259,447963,687970,340734,0,341084,264141,76943,3.432943868,192777,1324,286,96,95,1,27,1,0.063157895,0,empty,CD-0722-4
"C12,G5",7113,7930,5258,2672,4098,2091,0,2093,1317,776,1.697164948,1228,1152,256,73,73,0,29,0,0,0,empty,CD-0722-4
"C12,G6",10440,11716,7761,3955,5962,2977,1,2978,1894,1084,1.747232472,1682,103,19,15,15,0,11,0,0.066666667,0,empty,CD-0722-4
"C12,G7",1037909,1164256,795629,368627,567491,283741,25,284034,217941,66093,3.297489901,160546,148376,22377,8749,8578,171,1384,5,0.036022383,0,hg38,CD-0722-4
"C12,G8",6305,7088,4602,2486,3640,1784,1,1788,1143,645,1.772093023,1028,1888,484,214,211,3,50,2,0.047393365,0,empty,CD-0722-4
"C12,G9",8015,8441,5866,2575,4634,2238,0,2243,1413,830,1.702409639,1239,2269,616,248,247,1,69,1,0.036437247,0,empty,CD-0722-4
"C12,G10",9514,10550,7076,3474,5471,2721,12,2735,1749,986,1.773833671,1543,2297,558,241,238,3,63,2,0.109243697,0,empty,CD-0722-4
"C12,G11",9286,10159,6942,3217,5306,2543,0,2545,1682,863,1.949015064,1405,1574,396,183,181,2,56,1,0.055248619,0,empty,CD-0722-4
"C12,G12",7927,8810,5796,3014,4685,2466,0,2470,1564,906,1.726269316,1416,12313,1548,627,612,15,132,2,0.062091503,0,empty,CD-0722-4
"C12,H1",7920,8338,5774,2564,4489,2097,0,2102,1385,717,1.931659693,1199,1254,227,88,85,3,25,2,0.058823529,0,empty,CD-0722-4
"C12,H2",9182,9960,6691,3269,5185,2556,9,2569,1639,930,1.762365591,1493,1739,569,228,226,2,55,1,0.119469027,0,empty,CD-0722-4
"C12,H3",8293,9158,5893,3265,4669,2416,0,2423,1545,878,1.759681093,1389,1472,244,105,105,0,37,0,0.152380952,0,empty,CD-0722-4
"C12,H4",11337,12396,8399,3997,6360,3069,1,3074,1944,1130,1.720353982,1735,189,24,8,8,0,8,0,0,0,empty,CD-0722-4
"C12,H5",13036,14449,9586,4863,7378,3695,1,3707,2431,1276,1.905172414,2135,3851,642,221,216,5,55,2,0.111111111,0,empty,CD-0722-4
"C12,H6",846742,1000025,626443,373582,486316,264807,2,265026,200384,64642,3.099904087,159625,150848,28121,10772,10640,132,1637,4,0.041635338,0,hg38,CD-0722-4
"C12,H7",8482,9260,6316,2944,4802,2250,0,2250,1494,756,1.976190476,1256,2033,672,239,239,0,51,0,0.10460251,0,empty,CD-0722-4
"C12,H8",9514,10752,6816,3936,5514,2860,14,2874,1846,1028,1.795719844,1678,2112,425,179,178,1,65,1,0.106741573,0,empty,CD-0722-4
"C12,H9",7266,7697,5596,2101,3991,1819,0,1821,1202,619,1.94184168,944,881,251,93,88,5,25,3,0.011363636,0,empty,CD-0722-4
"C12,H10",7290,7943,5340,2603,4110,1995,2,2001,1305,696,1.875,1140,896,133,58,53,5,20,1,0.056603774,0,empty,CD-0722-4
"C12,H11",9167,10493,6478,4015,5507,3316,0,3317,1729,1588,1.088790932,1959,52,2,1,1,0,1,0,0,0,empty,CD-0722-4
"C12,H12",891791,988217,674354,313863,481681,242476,1,242692,191603,51089,3.750376793,138979,48493,7762,2972,2917,55,575,3,0.025368529,0,hg38,CD-0722-4
"D1,A1",6556,7258,4799,2459,3805,1954,1,1958,1274,684,1.862573099,1157,1811,480,176,174,2,48,2,0.08045977,0,empty,CD-0722-4
"D1,A2",8842,9810,6591,3219,4907,2421,5,2428,1439,989,1.455005056,1338,2239,596,214,211,3,68,2,0.023696682,0,empty,CD-0722-4
"D1,A3",6303,7157,4607,2550,3675,1837,14,1856,1195,661,1.807866868,1119,2291,510,206,205,1,51,1,0.043902439,0,empty,CD-0722-4
"D1,A4",10976,12180,8189,3991,6298,3153,5,3163,1930,1233,1.565287916,1789,923,282,92,92,0,26,0,0.043478261,0,empty,CD-0722-4
"D1,A5",379666,474032,260411,213621,242184,161332,4,161445,110461,50984,2.166581673,101513,7502,1343,540,526,14,119,2,0.079847909,0,hg38,CD-0722-4
"D1,A6",7126,7856,5259,2597,4277,2217,0,2221,1444,777,1.858429858,1258,3709,990,385,383,2,97,1,0.120104439,0,empty,CD-0722-4
"D1,A7",6201,6985,4651,2334,3645,1898,10,1912,1184,728,1.626373626,1103,1627,285,114,112,2,38,2,0.160714286,0,empty,CD-0722-4
"D1,A8",4041,4568,3012,1556,2366,1181,4,1185,810,375,2.16,696,2786,389,156,153,3,62,1,0.039215686,0,empty,CD-0722-4
"D1,A9",2434895,2796798,1815542,981256,1330794,744024,10,744691,570339,174352,3.271192759,431893,299647,45679,17209,16848,361,2295,9,0.040716999,0,hg38,CD-0722-4
"D1,A10",7446,8138,5572,2566,4147,2059,0,2059,1317,742,1.774932615,1106,476,39,21,21,0,14,0,0,0,empty,CD-0722-4
"D1,A11",5759,6265,4377,1888,3232,1495,2,1497,1002,495,2.024242424,846,1705,442,149,146,3,43,1,0.075342466,0,empty,CD-0722-4
"D1,A12",8088,8925,6080,2845,4611,2263,1,2270,1502,768,1.955729167,1279,5260,1225,428,426,2,108,2,0.0657277,0,empty,CD-0722-4
"D1,B1",7054,7592,5163,2429,3962,1994,0,1994,1261,733,1.720327422,1143,1615,445,186,178,8,45,2,0.039325843,0,empty,CD-0722-4
"D1,B2",7985,8489,5433,3056,4489,2395,0,2400,1471,929,1.583423036,1412,915,206,80,78,2,18,1,0.153846154,0,empty,CD-0722-4
"D1,B3",5940,6439,4436,2003,3401,1690,0,1695,1102,593,1.858347386,922,2580,369,152,150,2,56,1,0.073333333,0,empty,CD-0722-4
"D1,B4",6003,6820,4365,2455,3586,1878,0,1883,1170,713,1.640953717,1162,1786,464,155,155,0,41,0,0.006451613,0,empty,CD-0722-4
"D1,B5",6867,4128,2592,1536,2646,1342,0,1351,814,537,1.515828678,854,968,230,95,95,0,34,0,0.010526316,0,empty,CD-0722-4
"D1,B6",7697,8383,5641,2742,4337,2215,9,2225,1454,771,1.885862516,1259,2082,554,187,187,0,53,0,0.117647059,0,empty,CD-0722-4
"D1,B7",7417,8401,5413,2988,4404,2236,0,2238,1459,779,1.872913992,1320,1602,198,89,88,1,37,1,0.011363636,0,empty,CD-0722-4
"D1,B8",5170,5702,3904,1798,2966,1456,0,1457,982,475,2.067368421,780,2207,510,211,208,3,58,1,0.014423077,0,empty,CD-0722-4
"D1,B9",9963,11055,7378,3677,5751,2993,5,3004,1852,1152,1.607638889,1728,7633,2287,953,948,5,241,2,0.338607595,0,empty,CD-0722-4
"D1,B10",5254,5373,3821,1552,2938,1385,0,1387,888,499,1.779559118,785,679,205,88,87,1,23,1,0.011494253,0,empty,CD-0722-4
"D1,B11",11419,12880,8252,4628,6623,3572,1,3576,2070,1506,1.374501992,2086,345,57,20,20,0,9,0,0,0,empty,CD-0722-4
"D1,B12",6017,6700,4502,2198,3481,1757,0,1760,1157,603,1.918739635,997,1986,421,146,145,1,54,1,0.055172414,0,empty,CD-0722-4
"D1,C1",15685,16551,11762,4789,8490,3981,0,3994,2505,1489,1.682337139,2148,1669,383,160,158,2,37,1,0.151898734,0,empty,CD-0722-4
"D1,C2",10978,12049,8055,3994,6194,3167,0,3168,2128,1040,2.046153846,1793,2893,968,319,318,1,83,1,0.078616352,0,empty,CD-0722-4
"D1,C3",11132,12233,8300,3933,6332,3090,21,3118,1936,1182,1.637901861,1762,1278,172,76,76,0,24,0,0.013157895,0,empty,CD-0722-4
"D1,C4",6725,7375,5133,2242,3809,1785,0,1785,1180,605,1.950413223,965,2284,457,177,177,0,50,0,0.192090395,0,empty,CD-0722-4
"D1,C5",9253,10410,6713,3697,5236,2646,0,2648,1653,995,1.661306533,1580,2076,366,161,153,8,49,3,0.052287582,0,empty,CD-0722-4
"D1,C6",9662,11126,7094,4032,5950,3229,4,3242,2230,1012,2.203557312,1944,3298,677,258,256,2,61,2,0.015625,0,empty,CD-0722-4
"D1,C7",11002,12886,7920,4966,6559,3716,0,3723,2232,1491,1.496981891,2224,392,95,46,46,0,18,0,0.108695652,0,empty,CD-0722-4
"D1,C8",11835,12840,8760,4080,6665,3336,0,3340,2135,1205,1.771784232,1830,4074,935,380,374,6,94,2,0.06684492,0,empty,CD-0722-4
"D1,C9",8081,9150,6070,3080,4775,2363,0,2366,1486,880,1.688636364,1401,2424,459,200,194,6,44,2,0.06185567,0,empty,CD-0722-4
"D1,C10",972610,1123392,719372,404020,542694,299045,1,299286,242426,56860,4.26355962,175389,174520,24690,9791,9595,196,1612,5,0.049296509,0,hg38,CD-0722-4
"D1,C11",8683,9281,6363,2918,4905,2357,0,2359,1536,823,1.866342649,1342,3265,772,304,302,2,75,2,0.086092715,0,empty,CD-0722-4
"D1,C12",11975,12825,8860,3965,6617,3146,8,3157,2089,1068,1.955992509,1732,2844,761,307,304,3,89,2,0.115131579,0,empty,CD-0722-4
"D1,D1",11028,12520,8191,4329,6441,3404,1,3411,2127,1284,1.656542056,1945,998,272,79,79,0,20,0,0.227848101,0,empty,CD-0722-4
"D1,D2",9779,10138,7195,2943,5276,2412,29,2446,1588,858,1.850815851,1339,4457,900,368,365,3,103,1,0.04109589,0,empty,CD-0722-4
"D1,D3",7633,8375,5523,2852,4392,2283,2,2286,1547,739,2.093369418,1309,1882,346,119,115,4,40,1,0.104347826,0,empty,CD-0722-4
"D1,D4",5824,6231,4383,1848,3294,1591,0,1593,1070,523,2.045889101,870,2390,506,235,232,3,56,1,0.030172414,0,empty,CD-0722-4
"D1,D5",6630,7347,4922,2425,3829,1868,0,1873,1238,635,1.949606299,1076,1962,453,188,188,0,49,0,0.170212766,0,empty,CD-0722-4
"D1,D6",14319,16147,10447,5700,8331,4478,0,4486,2912,1574,1.850063532,2653,2356,598,232,230,2,65,1,0.017391304,0,empty,CD-0722-4
"D1,D7",671345,748096,507386,240710,364350,182016,1,182194,138847,43347,3.203151314,103796,188400,22488,8396,8155,241,1343,7,0.039117106,0,hg38,CD-0722-4
"D1,D8",6934,7537,5104,2433,3848,1836,0,1842,1180,662,1.782477341,1058,1636,461,169,168,1,42,1,0.05952381,0,empty,CD-0722-4
"D1,D9",3722,4116,2760,1356,2085,1000,0,1000,658,342,1.923976608,566,1740,502,195,186,9,49,1,0.107526882,0,empty,CD-0722-4
"D1,D10",7290,7819,5292,2527,4192,2141,0,2142,1349,793,1.701134931,1224,1025,257,89,88,1,34,1,0,0,empty,CD-0722-4
"D1,D11",7389,7919,5459,2460,4271,2092,2,2098,1341,757,1.771466314,1194,3519,979,329,327,2,76,2,0.024464832,0,empty,CD-0722-4
"D1,D12",11082,12377,8102,4275,6290,3153,6,3161,2118,1043,2.030680729,1834,4954,1189,475,473,2,106,2,0.095137421,0,empty,CD-0722-4
"D1,E1",1302137,1445468,995092,450376,683228,345000,48,345405,286618,58787,4.875533706,191352,285344,47726,18879,18621,258,2476,4,0.076043177,0,hg38,CD-0722-4
"D1,E2",9322,10483,6755,3728,5371,2773,1,2776,1743,1033,1.68731849,1624,3163,591,240,237,3,62,2,0.063291139,0,empty,CD-0722-4
"D1,E3",5998,6908,4423,2485,3524,1815,0,1815,1143,672,1.700892857,1072,3117,719,329,326,3,85,1,0.070552147,0,empty,CD-0722-4
"D1,E4",8436,9368,6314,3054,4800,2368,1,2371,1546,825,1.873939394,1314,2969,830,295,290,5,84,2,0.096551724,0,empty,CD-0722-4
"D1,E5",7536,8424,5680,2744,4353,2051,0,2051,1305,746,1.749329759,1204,1645,421,176,171,5,47,2,0.011695906,0,empty,CD-0722-4
"D1,E6",12650,13789,9452,4337,7134,3534,0,3537,2265,1272,1.780660377,1975,4737,1081,413,412,1,97,1,0.050970874,0,empty,CD-0722-4
"D1,E7",13366,14499,10086,4413,7462,3518,1,3519,2329,1190,1.957142857,1952,5745,1120,449,443,6,113,1,0.074492099,0,empty,CD-0722-4
"D1,E8",10104,10656,7679,2977,5518,2522,1,2525,1743,782,2.228900256,1261,4238,775,299,296,3,81,1,0.060810811,0,empty,CD-0722-4
"D1,E9",5519,6101,4027,2074,3124,1549,3,1557,1034,523,1.977055449,894,3376,769,302,298,4,79,2,0.10738255,0,empty,CD-0722-4
"D1,E10",7865,8286,5806,2480,4579,2260,0,2260,1481,779,1.901155327,1259,2006,541,197,195,2,51,2,0.020512821,0,empty,CD-0722-4
"D1,E11",8352,9045,6222,2823,4695,2343,0,2345,1575,770,2.045454545,1243,2943,689,242,236,6,61,3,0.144067797,0,empty,CD-0722-4
"D1,E12",9094,10071,6556,3515,5403,2807,12,2821,1891,930,2.033333333,1633,2378,422,200,200,0,57,0,0.125,0,empty,CD-0722-4
"D1,F1",29319,30401,22943,7458,15550,6076,0,6082,4219,1863,2.264626946,3220,11578,3725,1426,1412,14,301,2,0.03611898,0,empty,CD-0722-4
"D1,F2",12078,13430,9034,4396,6949,3385,2,3391,2339,1052,2.22338403,1925,4737,951,378,372,6,102,3,0.040322581,0,empty,CD-0722-4
"D1,F3",10805,11816,7875,3941,6057,3050,1,3054,2059,995,2.069346734,1707,3807,725,324,321,3,92,3,0.012461059,0,empty,CD-0722-4
"D1,F4",12097,13154,9088,4066,6905,3296,1,3304,2183,1121,1.947368421,1853,842,150,59,56,3,23,2,0.089285714,0,empty,CD-0722-4
"D1,F5",959858,1037442,737123,300319,496446,236503,0,236767,182362,54405,3.351934565,130852,195712,23043,8840,8612,228,1381,6,0.044472829,0,hg38,CD-0722-4
"D1,F6",1692726,2043724,1215097,828627,984286,587118,1,587586,483557,104029,4.648290381,360341,288185,52869,20217,19922,295,2658,10,0.06967172,0,hg38,CD-0722-4
"D1,F7",11344,12471,8376,4095,6635,3232,13,3250,2060,1190,1.731092437,1893,1515,433,163,162,1,47,1,0.049382716,0,empty,CD-0722-4
"D1,F8",7728,8270,5708,2562,4401,2106,0,2110,1384,726,1.906336088,1168,415,43,23,23,0,12,0,0,0,empty,CD-0722-4
"D1,F9",8378,9040,6296,2744,4590,2102,18,2121,1455,666,2.184684685,1175,4265,795,317,312,5,81,2,0.048076923,0,empty,CD-0722-4
"D1,F10",1264910,1440585,959819,480766,685841,358865,14,359255,283946,75309,3.770412567,204732,174897,25365,9962,9792,170,1636,8,0.03441585,0,hg38,CD-0722-4
"D1,F11",7760,8273,5901,2372,4343,1953,0,1953,1287,666,1.932432432,1091,2137,508,190,187,3,48,2,0.192513369,0,empty,CD-0722-4
"D1,F12",9286,9842,6864,2978,5158,2484,0,2485,1642,843,1.947805457,1405,325,43,22,22,0,8,0,0.227272727,0,empty,CD-0722-4
"D1,G1",10325,10981,7817,3164,5737,2685,0,2690,1800,890,2.02247191,1449,3154,739,298,295,3,75,1,0.108474576,0,empty,CD-0722-4
"D1,G2",5881,6495,4106,2389,3300,1709,0,1709,1018,691,1.473227207,1016,703,193,63,63,0,17,0,0.047619048,0,empty,CD-0722-4
"D1,G3",13024,13935,9666,4269,7342,3590,9,3604,2280,1324,1.722054381,2025,2858,704,278,277,1,78,1,0.039711191,0,empty,CD-0722-4
"D1,G4",20496,23103,14618,8485,11762,6612,14,6633,3874,2759,1.404131932,3855,98,30,21,20,1,9,1,0,0,empty,CD-0722-4
"D1,G5",166276,198524,105997,92527,98267,68956,12,69050,41060,27990,1.466952483,41974,8383,2420,513,501,12,155,5,0.101796407,0,empty,CD-0722-4
"D1,G6",10026,10900,7514,3386,5542,2702,2,2708,1762,946,1.862579281,1490,196,31,22,20,2,10,2,0,0,empty,CD-0722-4
"D1,G7",8198,8965,6134,2831,4664,2138,20,2161,1417,744,1.904569892,1201,4060,865,356,352,4,92,2,0.025568182,0,empty,CD-0722-4
"D1,G8",5675,6131,4102,2029,3237,1646,1,1652,1086,566,1.918727915,962,2247,594,230,229,1,68,1,0.034934498,0,empty,CD-0722-4
"D1,G9",2103791,2444886,1527667,917219,1165361,681779,4,682322,530951,151371,3.507613744,407030,250891,26280,9945,9651,294,1639,8,0.057921459,0,hg38,CD-0722-4
"D1,G10",8654,9678,6470,3208,4941,2382,0,2385,1526,859,1.776484284,1345,4004,832,400,395,5,98,2,0.078481013,0,empty,CD-0722-4
"D1,G11",8813,9493,6613,2880,5096,2392,1,2396,1613,783,2.060025543,1339,1537,386,167,167,0,44,0,0.053892216,0,empty,CD-0722-4
"D1,G12",6949,7920,4934,2986,4120,2182,0,2185,1393,792,1.758838384,1339,2496,580,250,249,1,69,1,0.02811245,0,empty,CD-0722-4
"D1,H1",7254,7698,5432,2266,4037,1926,0,1929,1252,677,1.849335303,1066,1495,370,163,163,0,40,0,0,0,empty,CD-0722-4
"D1,H2",9057,9990,6524,3466,5132,2521,32,2557,1651,906,1.822295806,1525,3413,861,298,297,1,73,1,0.094276094,0,empty,CD-0722-4
"D1,H3",6682,7506,4902,2604,3836,1970,0,1978,1331,647,2.057187017,1133,1736,491,223,219,4,60,1,0.02283105,0,empty,CD-0722-4
"D1,H4",10264,11182,7702,3480,5706,2806,0,2809,1779,1030,1.727184466,1579,226,66,29,29,0,9,0,0,0,empty,CD-0722-4
"D1,H5",11203,12661,8293,4368,6488,3295,2,3302,2113,1189,1.777123633,1934,2614,845,289,282,7,76,3,0.060283688,0,empty,CD-0722-4
"D1,H6",6246,7038,4499,2539,3583,1808,0,1811,1208,603,2.00331675,1064,2673,589,262,260,2,68,1,0.038461538,0,empty,CD-0722-4
"D1,H7",7886,8432,6004,2428,4371,2017,10,2028,1347,681,1.977973568,1143,2659,505,204,200,4,56,2,0.07,0,empty,CD-0722-4
"D1,H8",8755,9737,6339,3398,5129,2731,0,2734,1792,942,1.902335456,1587,3265,761,336,333,3,101,2,0.09009009,0,empty,CD-0722-4
"D1,H9",6728,7354,5262,2092,3762,1704,2,1709,1197,512,2.337890625,932,1596,385,160,157,3,48,2,0.121019108,0,empty,CD-0722-4
"D1,H10",8493,9462,6336,3126,4666,2225,0,2225,1501,724,2.07320442,1305,2586,718,285,285,0,55,0,0.115789474,0,empty,CD-0722-4
"D1,H11",7229,8382,5056,3326,4276,2554,0,2555,1360,1195,1.138075314,1521,63,2,2,2,0,2,0,0,0,empty,CD-0722-4
"D1,H12",6013,6686,4323,2363,3420,1796,0,1799,1207,592,2.038851351,1082,1548,354,154,148,6,34,2,0.027027027,0,empty,CD-0722-4
"D2,A1",6974,7493,5033,2460,3874,1911,8,1931,1218,713,1.708274895,1073,1671,485,144,142,2,38,2,0.049295775,0,empty,CD-0722-4
"D2,A2",9020,9957,6797,3160,5060,2514,0,2518,1611,907,1.776185226,1372,2490,897,351,350,1,86,1,0.02,0,empty,CD-0722-4
"D2,A3",6111,6579,4517,2062,3358,1588,0,1588,1030,558,1.845878136,905,1234,339,138,137,1,41,1,0.051094891,0,empty,CD-0722-4
"D2,A4",11203,12231,8284,3947,6439,3187,14,3204,2034,1170,1.738461538,1837,904,213,77,76,1,24,1,0.342105263,0,empty,CD-0722-4
"D2,A5",9211,9951,6845,3106,5228,2565,13,2579,1730,849,2.037691402,1443,3033,524,194,190,4,62,4,0.126315789,0,empty,CD-0722-4
"D2,A6",607894,702820,465311,237509,342509,175047,1,175200,134279,40921,3.281420298,101790,79695,10801,4127,4066,61,742,9,0.043039843,0,hg38,CD-0722-4
"D2,A7",6440,7326,4692,2634,3862,2047,0,2050,1267,783,1.618135377,1213,1558,449,164,163,1,49,1,0.098159509,0,empty,CD-0722-4
"D2,A8",3760,4072,2852,1220,2233,1089,0,1089,719,370,1.943243243,605,1973,301,155,154,1,65,1,0.012987013,0,empty,CD-0722-4
"D2,A9",6803,7587,5105,2482,3888,1932,2,1936,1265,671,1.885245902,1108,2218,445,189,186,3,45,3,0.010752688,0,empty,CD-0722-4
"D2,A10",10247,11387,7638,3749,5938,3061,0,3062,2040,1022,1.996086106,1705,500,84,37,37,0,18,0,0,0,empty,CD-0722-4
"D2,A11",5582,5895,4286,1609,3135,1430,0,1432,956,476,2.008403361,749,2030,529,226,216,10,54,2,0.037037037,0,empty,CD-0722-4
"D2,A12",862012,936780,668682,268098,446665,207860,1,208090,157676,50414,3.127623279,113875,227185,31917,12316,12070,246,1765,6,0.030985915,0,hg38,CD-0722-4
"D2,B1",7054,7803,5179,2624,4011,2029,0,2030,1277,753,1.695883134,1187,1504,311,146,144,2,46,2,0.125,0,empty,CD-0722-4
"D2,B2",8437,9207,5925,3282,4747,2516,0,2520,1522,998,1.5250501,1465,633,186,65,65,0,10,0,0.230769231,0,empty,CD-0722-4
"D2,B3",5633,6073,4164,1909,3274,1644,0,1648,1085,563,1.927175844,928,1702,411,158,156,2,44,1,0.076923077,0,empty,CD-0722-4
"D2,B4",7166,7884,5336,2548,3909,1891,66,1959,1298,661,1.963691377,1048,1928,470,201,201,0,48,0,0.004975124,0,empty,CD-0722-4
"D2,B5",16499,15601,9502,6099,8465,5020,0,5031,3556,1475,2.410847458,2985,950,201,69,69,0,21,0,0.101449275,0,empty,CD-0722-4
"D2,B6",7495,8406,5437,2969,4366,2339,1,2344,1406,938,1.498933902,1374,2296,465,196,196,0,52,0,0.020408163,0,empty,CD-0722-4
"D2,B7",1123068,1276148,847256,428892,613611,321144,2,321452,241637,79815,3.027463509,185262,121115,14558,5765,5599,166,972,4,0.062689766,0,hg38,CD-0722-4
"D2,B8",5458,5855,4070,1785,3184,1520,1,1527,985,542,1.817343173,848,2075,460,165,165,0,63,0,0.084848485,0,empty,CD-0722-4
"D2,B9",9569,10521,6969,3552,5515,2875,0,2876,1686,1190,1.416806723,1685,1566,468,192,189,3,47,1,0.047619048,0,empty,CD-0722-4
"D2,B10",5077,5394,3801,1593,2875,1393,9,1405,902,503,1.793240557,717,822,91,44,37,7,19,2,0.027027027,0,empty,CD-0722-4
"D2,B11",19108,21370,14266,7104,10677,5540,0,5540,3665,1875,1.954666667,3142,261,12,9,9,0,7,0,0,0,empty,CD-0722-4
"D2,B12",6651,7337,4928,2409,3905,1975,6,1981,1334,647,2.061823802,1097,2906,519,218,213,5,69,2,0.093896714,0,empty,CD-0722-4
"D2,C1",3746935,4113329,2867866,1245463,1857306,964534,6,965504,779129,186375,4.18043729,535894,153849,25087,9870,9710,160,1508,7,0.022245108,0,hg38,CD-0722-4
"D2,C2",10437,11535,7578,3957,5888,2959,0,2963,1916,1047,1.829990449,1670,2113,540,253,253,0,73,0,0.063241107,0,empty,CD-0722-4
"D2,C3",10812,12158,8124,4034,6349,3095,0,3099,1873,1226,1.527732463,1793,792,140,70,69,1,23,1,0.014492754,0,empty,CD-0722-4
"D2,C4",662228,745951,497841,248110,366127,186111,3,186292,138751,47541,2.918554511,108155,128236,16769,6406,6253,153,1037,7,0.056932672,0,hg38,CD-0722-4
"D2,C5",9800,10784,7236,3548,5484,2757,13,2770,1816,954,1.903563941,1545,2653,727,289,288,1,75,1,0.034722222,0,empty,CD-0722-4
"D2,C6",8632,9463,6328,3135,5022,2556,0,2558,1708,850,2.009411765,1444,2691,546,263,257,6,72,1,0.011673152,0,empty,CD-0722-4
"D2,C7",10632,12210,7741,4469,6335,3480,0,3480,2059,1421,1.448979592,2033,647,153,40,40,0,13,0,0.175,0,empty,CD-0722-4
"D2,C8",11469,12449,8557,3892,6400,3106,14,3122,2041,1081,1.888066605,1711,3529,996,362,361,1,97,1,0.108033241,0,empty,CD-0722-4
"D2,C9",1281047,1579267,885885,693382,774663,516782,6,517202,377269,139933,2.696068833,317543,12804,1665,600,583,17,148,2,0.096054889,0,hg38,CD-0722-4
"D2,C10",10109,11082,7571,3511,5713,2786,0,2787,1831,956,1.915271967,1576,2590,622,261,260,1,71,1,0.076923077,0,empty,CD-0722-4
"D2,C11",8790,9896,6420,3476,5104,2555,32,2592,1634,958,1.705636743,1469,2183,611,241,239,2,64,1,0.050209205,0,empty,CD-0722-4
"D2,C12",11285,12517,8377,4140,6574,3192,0,3203,2155,1048,2.05629771,1854,2872,523,203,200,3,52,2,0.1,0,empty,CD-0722-4
"D2,D1",10123,11226,7477,3749,5805,2895,0,2899,1776,1123,1.581478183,1640,1175,227,90,87,3,18,2,0.103448276,0,empty,CD-0722-4
"D2,D2",9642,10382,7411,2971,5354,2435,0,2439,1622,817,1.985312118,1311,2909,686,308,307,1,90,1,0.035830619,0,empty,CD-0722-4
"D2,D3",8041,8853,5852,3001,4555,2355,0,2357,1555,802,1.938902743,1289,2319,385,158,156,2,53,2,0.044871795,0,empty,CD-0722-4
"D2,D4",6037,6610,4523,2087,3481,1735,0,1735,1125,610,1.844262295,969,1471,363,127,126,1,45,1,0.031746032,0,empty,CD-0722-4
"D2,D5",650456,819324,437171,382153,404236,276737,3,276959,205652,71307,2.88403663,172177,6779,857,281,264,17,68,2,0.212121212,0,hg38,CD-0722-4
"D2,D6",10557,11298,7666,3632,5847,2995,0,2995,1819,1176,1.546768707,1656,2165,462,195,193,2,63,2,0.10880829,0,empty,CD-0722-4
"D2,D7",5759,5888,4381,1507,3147,1434,0,1434,970,464,2.090517241,745,2451,588,197,195,2,59,2,0.01025641,0,empty,CD-0722-4
"D2,D8",6876,7457,4989,2468,3947,1908,2,1910,1252,658,1.902735562,1121,1501,333,158,155,3,41,1,0.064516129,0,empty,CD-0722-4
"D2,D9",5469,6131,4063,2068,3070,1455,1,1457,1035,422,2.452606635,860,1811,414,153,152,1,39,1,0,0,empty,CD-0722-4
"D2,D10",8094,8765,6043,2722,4626,2343,0,2343,1524,819,1.860805861,1306,1127,288,110,110,0,33,0,0.1,0,empty,CD-0722-4
"D2,D11",7667,8359,5798,2561,4401,2091,0,2093,1347,746,1.805630027,1165,3566,1145,409,405,4,91,2,0.083950617,0,empty,CD-0722-4
"D2,D12",10561,11652,7796,3856,6027,3023,0,3027,1945,1082,1.797597043,1736,4585,1079,419,417,2,138,1,0.016786571,0,empty,CD-0722-4
"D2,E1",1915498,2158330,1429741,728589,1019585,547658,4,548193,424773,123420,3.441686923,316414,219362,34199,13209,12986,223,1960,7,0.047589712,0,hg38,CD-0722-4
"D2,E2",9424,10397,7078,3319,5377,2721,0,2723,1669,1054,1.583491461,1499,3430,711,252,251,1,70,1,0.115537849,0,empty,CD-0722-4
"D2,E3",726300,857229,536876,320353,418284,233893,2,234100,183229,50871,3.601836017,138548,154119,26866,10396,10246,150,1563,6,0.03747804,0,hg38,CD-0722-4
"D2,E4",3291624,3830650,2463782,1366868,1757782,995850,2,996757,761967,234790,3.245312833,586770,453687,67471,26182,25642,540,3080,10,0.051127057,0,hg38,CD-0722-4
"D2,E5",7601,8189,5700,2489,4342,2060,0,2060,1343,717,1.873082287,1135,1477,333,134,134,0,40,0,0.044776119,0,empty,CD-0722-4
"D2,E6",13090,14376,9785,4591,7404,3598,1,3602,2285,1317,1.735003797,2005,3928,1059,403,394,9,92,2,0.073604061,0,empty,CD-0722-4
"D2,E7",13585,15293,10244,5049,7697,3699,0,3699,2408,1291,1.865220759,2168,4384,688,317,309,8,107,2,0.061488673,0,empty,CD-0722-4
"D2,E8",10224,10925,7910,3015,5661,2555,13,2568,1685,883,1.908267271,1371,3247,733,286,284,2,83,2,0.059859155,0,empty,CD-0722-4
"D2,E9",5234,5958,3852,2106,3169,1610,0,1612,1064,548,1.941605839,973,3256,741,315,313,2,75,2,0.063897764,0,empty,CD-0722-4
"D2,E10",7305,8178,5516,2662,4283,2053,0,2060,1330,730,1.821917808,1193,2150,456,181,178,3,50,2,0.028089888,0,empty,CD-0722-4
"D2,E11",618897,730164,439400,290764,361121,213590,1,213764,166075,47689,3.482459267,130036,36662,20226,7418,7396,22,1198,2,0.009464575,0,hg38,CD-0722-4
"D2,E12",9085,10050,6633,3417,5245,2616,0,2621,1648,973,1.69373073,1560,3035,713,278,276,2,74,1,0.144927536,0,empty,CD-0722-4
"D2,F1",11612,12772,8656,4116,6530,3167,22,3190,2002,1188,1.685185185,1783,3185,550,257,252,5,84,3,0.043650794,0,empty,CD-0722-4
"D2,F2",8429,9245,6215,3030,4720,2288,11,2302,1521,781,1.947503201,1312,3609,815,309,308,1,79,1,0.058441558,0,empty,CD-0722-4
"D2,F3",8085,8741,6023,2718,4634,2223,0,2225,1415,810,1.74691358,1264,3566,790,291,287,4,81,3,0.059233449,0,empty,CD-0722-4
"D2,F4",12390,13613,9192,4421,7048,3362,1,3368,2159,1209,1.785773366,1919,776,161,86,85,1,29,1,0.070588235,0,empty,CD-0722-4
"D2,F5",1767667,1947981,1342996,604985,915261,458574,5,459057,350409,108648,3.225176717,260259,317204,46042,17553,17166,387,2259,8,0.03850635,0,hg38,CD-0722-4
"D2,F6",827743,955407,619280,336127,461790,245836,0,246073,189183,56890,3.325417472,145325,194320,28433,11025,10804,221,1606,7,0.040355424,0,hg38,CD-0722-4
"D2,F7",11166,12299,8199,4100,6485,3239,0,3242,2199,1043,2.108341323,1890,1436,407,163,162,1,52,1,0.030864198,0,empty,CD-0722-4
"D2,F8",1524943,1767069,1162645,604424,841273,450852,2,451214,376665,74549,5.052582865,260355,32457,3995,1529,1475,54,344,4,0.072542373,0,hg38,CD-0722-4
"D2,F9",8931,9566,6833,2733,4938,2255,0,2266,1532,734,2.08719346,1197,3408,921,376,375,1,103,1,0.077333333,0,empty,CD-0722-4
"D2,F10",1256938,1461030,924811,536219,697004,387827,6,388203,303283,84920,3.571396609,228435,352770,35275,13793,13386,407,1990,8,0.125803078,0,hg38,CD-0722-4
"D2,F11",8369,8971,6288,2683,4568,2097,0,2097,1433,664,2.15813253,1158,2380,454,193,190,3,57,2,0.021052632,0,empty,CD-0722-4
"D2,F12",692983,747541,535555,211986,361106,165454,0,165640,129331,36309,3.561954336,92457,4768,711,277,275,2,70,1,0.032727273,0,hg38,CD-0722-4
"D2,G1",12303,13324,9384,3940,6945,3233,0,3237,2148,1089,1.972451791,1822,5347,1242,525,522,3,115,2,0.053639847,0,empty,CD-0722-4
"D2,G2",6220,6786,4495,2291,3526,1740,0,1742,1054,688,1.531976744,995,518,176,63,63,0,15,0,0.031746032,0,empty,CD-0722-4
"D2,G3",1673226,1780423,1341515,438908,835129,328148,17,328545,253131,75414,3.356551834,189285,142684,19105,7473,7310,163,1192,5,0.052120383,0,hg38,CD-0722-4
"D2,G4",19841,21893,14310,7583,11325,6261,1,6264,3851,2413,1.595938666,3548,126,8,7,7,0,4,0,0,0,empty,CD-0722-4
"D2,G5",6732,7459,4945,2514,3933,1943,0,1945,1265,680,1.860294118,1131,2195,421,206,204,2,53,1,0.078431373,0,empty,CD-0722-4
"D2,G6",10446,11541,7799,3742,5959,2931,0,2937,1943,994,1.95472837,1705,236,69,36,36,0,12,0,0.027777778,0,empty,CD-0722-4
"D2,G7",8336,8918,6378,2540,4584,2076,0,2078,1339,739,1.811907984,1130,2506,477,227,225,2,91,2,0.044444444,0,empty,CD-0722-4
"D2,G8",6139,6846,4504,2342,3451,1646,50,1696,1114,582,1.914089347,966,2300,486,188,183,5,56,2,0.06010929,0,empty,CD-0722-4
"D2,G9",7562,8386,5694,2692,4352,2156,5,2161,1473,688,2.140988372,1264,3607,878,373,368,5,109,2,0.051630435,0,empty,CD-0722-4
"D2,G10",8571,9392,6306,3086,4871,2447,0,2452,1558,894,1.742729306,1385,3046,967,378,376,2,100,2,0.063829787,0,empty,CD-0722-4
"D2,G11",801351,911078,599915,311163,442910,233729,0,233946,178678,55268,3.232937685,135903,23522,3142,1198,1175,23,309,3,0.017021277,0,hg38,CD-0722-4
"D2,G12",7268,7871,5420,2451,4052,1986,10,2003,1304,699,1.865522175,1125,2483,576,270,269,1,59,1,0.118959108,0,empty,CD-0722-4
"D2,H1",576843,609888,447210,162678,299957,134383,1,134530,101654,32876,3.092042828,72761,27402,5973,2128,2101,27,414,3,0.005711566,0,hg38,CD-0722-4
"D2,H2",8633,9657,6351,3306,4941,2400,1,2403,1534,869,1.765247411,1373,2540,724,278,274,4,70,1,0.01459854,0,empty,CD-0722-4
"D2,H3",8825,9804,6401,3403,5043,2489,39,2532,1743,789,2.209125475,1520,2867,595,276,273,3,65,2,0.032967033,0,empty,CD-0722-4
"D2,H4",1691165,1987734,1264709,723025,932023,524485,0,525015,422124,102891,4.102632883,311303,8204,1555,631,614,17,134,3,0.035830619,0,hg38,CD-0722-4
"D2,H5",11560,12974,8574,4400,6790,3454,0,3458,2251,1207,1.864954432,2017,2809,732,255,254,1,73,1,0.192913386,0,empty,CD-0722-4
"D2,H6",7040,7835,5077,2758,3993,2120,13,2136,1422,714,1.991596639,1232,2865,525,267,265,2,84,1,0.033962264,0,empty,CD-0722-4
"D2,H7",7651,8332,5667,2665,4351,2035,2,2044,1350,694,1.945244957,1147,2334,568,265,261,4,58,2,0.114942529,0,empty,CD-0722-4
"D2,H8",8623,9597,6311,3286,4855,2510,2,2524,1671,853,1.958968347,1433,2835,426,199,197,2,65,2,0.076142132,0,empty,CD-0722-4
"D2,H9",6739,7300,5177,2123,3768,1767,0,1769,1204,565,2.130973451,947,1749,554,188,186,2,46,1,0.016129032,0,empty,CD-0722-4
"D2,H10",5931,6500,4394,2106,3380,1652,4,1659,1038,621,1.671497585,967,1371,207,101,101,0,45,0,0.03960396,0,empty,CD-0722-4
"D2,H11",7184,8094,5129,2965,4155,2430,0,2432,1322,1110,1.190990991,1430,72,3,2,2,0,2,0,0,0,empty,CD-0722-4
"D2,H12",6013,6500,4400,2100,3396,1719,1,1721,1106,615,1.798373984,983,1487,225,95,95,0,30,0,0.063157895,0,empty,CD-0722-4
"D3,A1",7001,7826,5127,2699,4014,2053,21,2080,1314,766,1.7154047,1191,2478,474,204,202,2,55,2,0.024752475,0,empty,CD-0722-4
"D3,A2",11004,12010,8135,3875,6309,3116,0,3119,2000,1119,1.787310098,1819,2848,587,262,262,0,68,0,0.06870229,0,empty,CD-0722-4
"D3,A3",6315,6861,4652,2209,3542,1745,0,1751,1163,588,1.977891156,974,1669,357,141,140,1,38,1,0.007142857,0,empty,CD-0722-4
"D3,A4",1054122,1224720,785747,438973,586128,321542,16,321868,259470,62398,4.158306356,188859,53273,9119,3629,3559,70,650,4,0.097499298,0,hg38,CD-0722-4
"D3,A5",9430,10196,6976,3220,5361,2634,0,2634,1713,921,1.859934853,1472,3185,580,251,249,2,80,1,0.13253012,0,empty,CD-0722-4
"D3,A6",7741,9106,5786,3320,4732,2539,0,2539,1604,935,1.715508021,1488,3760,916,379,376,3,112,2,0.125,0,empty,CD-0722-4
"D3,A7",6574,7397,4867,2530,3753,1968,0,1970,1210,760,1.592105263,1119,1594,418,183,182,1,46,1,0.252747253,0,empty,CD-0722-4
"D3,A8",4620,5352,3473,1879,2707,1313,0,1316,871,445,1.957303371,777,3399,564,234,231,3,87,1,0.051948052,0,empty,CD-0722-4
"D3,A9",7245,8110,5384,2726,4207,2171,0,2173,1438,735,1.956462585,1238,2373,448,199,194,5,62,1,0,0,empty,CD-0722-4
"D3,A10",7769,8493,5868,2625,4467,2212,0,2212,1384,828,1.671497585,1255,578,185,69,68,1,17,1,0.058823529,0,empty,CD-0722-4
"D3,A11",708905,813578,537340,276238,397856,210373,1,210549,165787,44762,3.703744247,121056,103188,12603,4945,4841,104,977,5,0.036356125,0,hg38,CD-0722-4
"D3,A12",720900,811413,543063,268350,390537,200779,3,200988,155562,45426,3.424514595,114786,278519,44626,16970,16671,299,2252,9,0.047987523,0,hg38,CD-0722-4
"D3,B1",7149,7738,5292,2446,3955,2001,5,2007,1311,696,1.88362069,1118,1495,323,134,133,1,39,1,0,0,empty,CD-0722-4
"D3,B2",1021235,1135237,729380,405857,555015,299583,4,299820,228044,71776,3.177162283,177185,53395,7757,3077,2992,85,533,5,0.041109626,0,hg38,CD-0722-4
"D3,B3",6123,7055,4499,2556,3698,1871,1,1876,1207,669,1.804185351,1145,2036,472,206,204,2,51,2,0.044117647,0,empty,CD-0722-4
"D3,B4",6438,7356,4786,2570,3858,2084,0,2084,1301,783,1.66155811,1212,1759,419,147,144,3,37,1,0.006944444,0,empty,CD-0722-4
"D3,B5",8309,5392,3484,1908,3393,1766,0,1777,1200,577,2.079722704,1090,1663,336,141,134,7,38,2,0,0,empty,CD-0722-4
"D3,B6",8048,9361,5997,3364,4872,2584,0,2584,1661,923,1.799566631,1524,2405,595,265,264,1,61,1,0.015151515,0,empty,CD-0722-4
"D3,B7",7526,8308,5778,2530,4324,2046,12,2058,1337,721,1.854368932,1121,1713,475,178,177,1,53,1,0.016949153,0,empty,CD-0722-4
"D3,B8",5549,6089,4178,1911,3206,1580,0,1580,1057,523,2.021032505,882,1570,317,142,141,1,41,1,0.007092199,0,empty,CD-0722-4
"D3,B9",1299098,1410897,1002253,408644,671766,318356,3,318669,251216,67453,3.724311743,177081,59755,11336,4386,4295,91,763,5,0.033760186,0,hg38,CD-0722-4
"D3,B10",5309,5792,3889,1903,3128,1518,19,1539,1046,493,2.121703854,897,674,154,62,61,1,25,1,0.081967213,0,empty,CD-0722-4
"D3,B11",10951,12099,7892,4207,6231,3379,1,3382,1952,1430,1.365034965,1981,501,138,56,55,1,12,1,0,0,empty,CD-0722-4
"D3,B12",6768,7594,4946,2648,3855,1957,0,1958,1290,668,1.931137725,1120,2194,418,201,198,3,66,2,0.035353535,0,empty,CD-0722-4
"D3,C1",782511,845931,605123,240808,409993,192358,0,192544,149781,42763,3.50258401,104692,65303,12173,4541,4480,61,763,7,0.025223214,0,hg38,CD-0722-4
"D3,C2",10384,11267,7762,3505,5858,2940,3,2945,1921,1024,1.875976563,1622,2311,613,239,237,2,76,1,0.033755274,0,empty,CD-0722-4
"D3,C3",10973,11750,8154,3596,6149,2981,0,2987,1895,1092,1.735347985,1676,1090,142,78,77,1,21,1,0.025974026,0,empty,CD-0722-4
"D3,C4",6765,7387,5191,2196,3994,1880,0,1882,1228,654,1.877675841,1055,2237,562,213,211,2,65,2,0.127962085,0,empty,CD-0722-4
"D3,C5",816541,973769,589123,384646,480162,280039,1,280315,203828,76487,2.664871155,173248,45976,6438,2446,2400,46,544,4,0.0325,0,hg38,CD-0722-4
"D3,C6",8278,9421,6033,3388,5004,2551,27,2582,1663,919,1.809575626,1508,2386,622,238,232,6,62,2,0.094827586,0,empty,CD-0722-4
"D3,C7",11271,12973,8181,4792,6555,3527,0,3530,2167,1363,1.589875275,2106,753,118,63,59,4,17,1,0.186440678,0,empty,CD-0722-4
"D3,C8",672213,718172,525606,192566,349654,157525,2,157709,121029,36680,3.299591058,85257,114407,18989,7281,7170,111,1145,5,0.030264993,0,hg38,CD-0722-4
"D3,C9",8904,10465,6513,3952,5247,2732,0,2739,1812,927,1.954692557,1648,1901,463,152,152,0,44,0,0.118421053,0,empty,CD-0722-4
"D3,C10",10421,11193,7878,3315,5642,2691,1,2696,1709,987,1.731509625,1430,2218,512,225,221,4,60,3,0.090497738,0,empty,CD-0722-4
"D3,C11",10151,10997,7485,3512,5745,2811,0,2818,1864,954,1.953878407,1569,3620,672,268,265,3,77,1,0.071698113,0,empty,CD-0722-4
"D3,C12",12438,13546,9244,4302,6992,3419,0,3421,2254,1167,1.931448158,1951,2687,674,271,262,9,74,2,0.049618321,0,empty,CD-0722-4
"D3,D1",683996,844294,461334,382960,416574,280747,1,280958,207143,73815,2.806245343,173553,1709,258,110,101,9,28,2,0.138613861,0,hg38,CD-0722-4
"D3,D2",8964,9712,6820,2892,4998,2341,0,2346,1480,866,1.709006928,1268,3413,1203,520,515,5,122,1,0.067961165,0,empty,CD-0722-4
"D3,D3",7621,8623,5560,3063,4402,2291,13,2306,1541,765,2.014379085,1342,1841,311,144,139,5,47,2,0.071942446,0,empty,CD-0722-4
"D3,D4",6280,6927,4633,2294,3650,1777,0,1779,1169,610,1.916393443,1003,1958,262,137,137,0,48,0,0.087591241,0,empty,CD-0722-4
"D3,D5",7072,7738,5254,2484,3953,1961,23,1986,1267,719,1.76216968,1103,2080,362,131,128,3,39,2,0.140625,0,empty,CD-0722-4
"D3,D6",10614,11567,7496,4071,5940,3187,1,3190,1994,1196,1.66722408,1849,2569,699,245,245,0,80,0,0.036734694,0,empty,CD-0722-4
"D3,D7",5699,6217,4255,1962,3203,1528,10,1540,1048,492,2.130081301,872,2713,648,269,269,0,59,0,0.130111524,0,empty,CD-0722-4
"D3,D8",7631,8479,5619,2860,4335,2162,0,2167,1374,793,1.732660782,1240,2162,636,265,265,0,58,0,0.037735849,0,empty,CD-0722-4
"D3,D9",3734,3978,2743,1235,2100,995,0,995,713,282,2.528368794,548,1978,480,152,151,1,46,1,0.119205298,0,empty,CD-0722-4
"D3,D10",8759,9714,6291,3423,5005,2617,9,2626,1581,1045,1.51291866,1523,1230,278,112,112,0,31,0,0.178571429,0,empty,CD-0722-4
"D3,D11",8077,8806,5845,2961,4571,2199,0,2201,1382,819,1.687423687,1260,3079,755,310,309,1,91,1,0.139158576,0,empty,CD-0722-4
"D3,D12",10904,12037,8103,3934,6163,3016,29,3053,2021,1032,1.958333333,1728,4436,1078,437,435,2,133,2,0.059770115,0,empty,CD-0722-4
"D3,E1",13046,14617,9601,5016,7498,3761,0,3763,2426,1337,1.814510097,2179,3654,805,329,326,3,85,2,0.116564417,0,empty,CD-0722-4
"D3,E2",8789,10054,6384,3670,5271,2725,19,2751,1666,1085,1.535483871,1680,2436,498,194,191,3,54,1,0.141361257,0,empty,CD-0722-4
"D3,E3",6293,6765,4793,1972,3462,1600,8,1611,1089,522,2.086206897,861,3453,895,403,400,3,97,1,0.11,0,empty,CD-0722-4
"D3,E4",8962,9633,6611,3022,5080,2523,0,2529,1646,883,1.86409966,1391,3657,827,359,355,4,92,1,0.022535211,0,empty,CD-0722-4
"D3,E5",7616,8262,5866,2396,4305,2011,1,2014,1305,709,1.840620592,1099,2135,382,162,162,0,46,0,0.135802469,0,empty,CD-0722-4
"D3,E6",13125,14426,9611,4815,7383,3753,0,3757,2369,1388,1.706772334,2129,4573,1251,467,464,3,104,2,0.0625,0,empty,CD-0722-4
"D3,E7",12023,13043,8998,4045,6929,3376,3,3383,2278,1105,2.061538462,1869,4132,1201,402,398,4,102,1,0.09798995,0,empty,CD-0722-4
"D3,E8",16581,20234,12207,8027,10198,5969,0,5971,4204,1767,2.379173741,3570,3905,972,353,350,3,85,1,0.071428571,0,empty,CD-0722-4
"D3,E9",5994,6550,4416,2134,3489,1740,0,1740,1114,626,1.779552716,1010,3673,849,325,321,4,73,2,0.168224299,0,empty,CD-0722-4
"D3,E10",7750,8430,5750,2680,4330,2065,0,2066,1357,709,1.913963329,1113,2445,587,252,252,0,58,0,0.103174603,0,empty,CD-0722-4
"D3,E11",8929,9732,6606,3126,4917,2494,1,2496,1625,871,1.865671642,1414,2778,533,235,233,2,59,1,0.167381974,0,empty,CD-0722-4
"D3,E12",9224,10234,6628,3606,5390,2761,0,2763,1807,956,1.890167364,1686,2824,510,199,189,10,58,2,0.068783069,0,empty,CD-0722-4
"D3,F1",894578,1024603,662498,362105,494979,268085,19,268308,203868,64440,3.163687151,157095,106151,19868,7740,7648,92,1259,6,0.054654812,0,hg38,CD-0722-4
"D3,F2",8458,9291,6307,2984,4826,2350,0,2353,1549,804,1.926616915,1317,3838,1141,390,389,1,85,1,0.092544987,0,empty,CD-0722-4
"D3,F3",18881,20631,14255,6376,10250,4928,0,4935,3680,1255,2.932270916,2787,4588,848,365,360,5,109,2,0.083333333,0,empty,CD-0722-4
"D3,F4",12673,13234,9392,3842,6968,3294,0,3297,2192,1105,1.983710407,1802,980,179,83,83,0,33,0,0.012048193,0,empty,CD-0722-4
"D3,F5",10059,10802,7642,3160,5641,2626,1,2628,1688,940,1.795744681,1436,3231,863,327,325,2,73,1,0.203076923,0,empty,CD-0722-4
"D3,F6",10682,11935,7980,3955,6150,3074,1,3077,2121,956,2.218619247,1775,4701,1196,433,428,5,108,2,0.172897196,0,empty,CD-0722-4
"D3,F7",11126,12312,8347,3965,6346,3169,0,3173,2041,1132,1.803003534,1765,1536,374,135,134,1,43,1,0.067164179,0,empty,CD-0722-4
"D3,F8",8029,8904,6119,2785,4654,2274,0,2276,1497,779,1.92169448,1243,265,50,32,31,1,14,1,0,0,empty,CD-0722-4
"D3,F9",9157,9922,6925,2997,5118,2389,0,2391,1620,771,2.101167315,1327,4609,1268,485,482,3,115,2,0.020746888,0,empty,CD-0722-4
"D3,F10",11511,12448,8673,3775,6429,3098,0,3098,2054,1044,1.96743295,1719,2599,517,241,239,2,62,2,0.062761506,0,empty,CD-0722-4
"D3,F11",7991,8409,6068,2341,4489,2061,0,2064,1394,670,2.080597015,1141,2186,526,239,238,1,56,1,0.155462185,0,empty,CD-0722-4
"D3,F12",9772,10832,7221,3611,5466,2695,17,2712,1749,963,1.816199377,1535,376,65,29,29,0,13,0,0.068965517,0,empty,CD-0722-4
"D3,G1",10773,11626,8091,3535,6002,2799,0,2802,1757,1045,1.681339713,1525,3426,798,373,372,1,87,1,0.112903226,0,empty,CD-0722-4
"D3,G2",5932,6385,4136,2249,3286,1663,0,1666,1072,594,1.804713805,989,643,112,55,55,0,13,0,0.018181818,0,empty,CD-0722-4
"D3,G3",13237,14127,9678,4449,7274,3645,0,3645,2300,1345,1.710037175,2012,3054,684,292,291,1,77,1,0.054982818,0,empty,CD-0722-4
"D3,G4",1205958,1368635,901421,467214,655844,349137,49,349535,278333,71202,3.909061543,201435,1286,210,86,85,1,26,1,0,0,empty,CD-0722-4
"D3,G5",7081,8019,5276,2743,4122,2094,0,2096,1365,731,1.867305062,1238,2100,595,270,268,2,58,2,0.01119403,0,empty,CD-0722-4
"D3,G6",10544,11318,7959,3359,5797,2793,0,2795,1853,942,1.967091295,1479,365,25,17,17,0,10,0,0,0,empty,CD-0722-4
"D3,G7",8428,8906,6325,2581,4614,2186,0,2190,1442,748,1.927807487,1180,3612,751,356,348,8,89,2,0.149425287,0,empty,CD-0722-4
"D3,G8",710265,816097,523040,293057,398253,216228,4,216426,168870,47556,3.550971486,127876,209311,23638,9625,9369,256,1511,8,0.038638062,0,hg38,CD-0722-4
"D3,G9",7682,8196,5619,2577,4290,2008,12,2027,1299,728,1.784340659,1088,3101,773,354,353,1,91,1,0.158640227,0,empty,CD-0722-4
"D3,G10",1307588,1480254,1002842,477412,708340,363246,0,363640,299525,64115,4.671683693,205408,345315,57306,22196,21795,401,2738,12,0.075246616,0,hg38,CD-0722-4
"D3,G11",8958,9853,6820,3033,5137,2445,2,2447,1661,786,2.113231552,1354,1908,282,110,107,3,46,2,0.009345794,0,empty,CD-0722-4
"D3,G12",7076,7977,5068,2909,4188,2160,6,2167,1396,771,1.810635538,1293,3364,892,307,301,6,71,1,0.119601329,0,empty,CD-0722-4
"D3,H1",8099,8659,6083,2576,4640,2229,0,2229,1501,728,2.061813187,1260,1825,384,159,154,5,37,2,0.116883117,0,empty,CD-0722-4
"D3,H2",1088967,1298220,789732,508488,630044,360688,6,361030,298837,62193,4.804994131,219647,206267,35220,13686,13457,229,2015,6,0.039161775,0,hg38,CD-0722-4
"D3,H3",7148,7707,5259,2448,4003,1980,12,1999,1324,675,1.961481481,1116,1937,325,143,143,0,51,0,0.027972028,0,empty,CD-0722-4
"D3,H4",10325,11419,7903,3516,5932,2894,0,2896,1856,1040,1.784615385,1673,245,31,14,14,0,7,0,0,0,empty,CD-0722-4
"D3,H5",11156,12207,8284,3923,6247,3118,21,3141,2040,1101,1.852861035,1759,2625,678,221,213,8,53,2,0.075117371,0,empty,CD-0722-4
"D3,H6",6921,7650,5087,2563,3959,2024,5,2029,1367,662,2.064954683,1168,2862,482,181,178,3,48,2,0.196629213,0,empty,CD-0722-4
"D3,H7",1475934,1728223,1062911,665312,841942,496224,11,496655,374719,121936,3.07307932,296512,386221,55583,21677,21258,419,2697,7,0.049157964,0,hg38,CD-0722-4
"D3,H8",1367353,1588068,1001231,586837,762155,438289,2,438659,311380,127279,2.446436568,259553,227792,21704,8776,8475,301,1408,6,0.063834808,0,hg38,CD-0722-4
"D3,H9",8076,8601,6155,2446,4392,2049,2,2053,1442,611,2.360065466,1081,1387,285,121,119,2,44,1,0.008403361,0,empty,CD-0722-4
"D3,H10",6641,7458,4829,2629,3892,1969,0,1970,1273,697,1.826398852,1169,1465,405,180,177,3,47,1,0.084745763,0,empty,CD-0722-4
"D3,H11",7471,8590,5148,3442,4397,2597,15,2613,1456,1157,1.258426966,1584,57,5,1,0,1,0,1,0,0,empty,CD-0722-4
"D3,H12",6729,7557,4995,2562,3891,2011,0,2013,1355,658,2.059270517,1166,1732,387,161,154,7,43,2,0.032467532,0,empty,CD-0722-4
"D4,A1",6073,6646,4498,2148,3530,1807,4,1813,1159,654,1.772171254,989,1698,449,166,161,5,34,2,0.01863354,0,empty,CD-0722-4
"D4,A2",8343,9333,6103,3230,4895,2434,0,2437,1561,876,1.78196347,1401,2373,519,234,234,0,60,0,0.081196581,0,empty,CD-0722-4
"D4,A3",10208,11093,7539,3554,5658,2717,0,2722,1965,757,2.595772787,1563,2202,669,266,266,0,88,0,0.033834586,0,empty,CD-0722-4
"D4,A4",10182,11188,7598,3590,5960,2845,0,2851,1844,1007,1.831181728,1655,912,187,66,63,3,24,1,0,0,empty,CD-0722-4
"D4,A5",8320,8962,6058,2904,4777,2363,3,2374,1533,841,1.822829964,1331,2564,518,174,173,1,55,1,0.034682081,0,empty,CD-0722-4
"D4,A6",6877,7909,5012,2897,4194,2170,0,2175,1398,777,1.799227799,1284,2890,531,263,263,0,65,0,0.038022814,0,empty,CD-0722-4
"D4,A7",6087,7017,4374,2643,3635,1930,5,1936,1265,671,1.885245902,1143,1439,326,142,141,1,47,1,0.014184397,0,empty,CD-0722-4
"D4,A8",3707,4122,2749,1373,2204,1080,0,1084,722,362,1.994475138,622,1965,471,149,146,3,60,2,0.191780822,0,empty,CD-0722-4
"D4,A9",8648,9598,6404,3194,5107,2530,14,2547,1701,846,2.010638298,1497,2780,577,236,235,1,70,1,0.042553191,0,empty,CD-0722-4
"D4,A10",336164,421140,230974,190166,211904,141457,1,141557,104850,36707,2.856403411,87379,2061,408,169,168,1,69,1,0.101190476,0,hg38,CD-0722-4
"D4,A11",9322,10224,7064,3160,5240,2644,0,2646,1791,855,2.094736842,1475,1923,488,164,160,4,36,3,0.0125,0,empty,CD-0722-4
"D4,A12",1132343,1336868,839418,497450,645392,356331,1,356680,300481,56199,5.346732148,212670,11479,4419,1248,1240,8,404,3,0.033870968,0,hg38,CD-0722-4
"D4,B1",6370,7106,4683,2423,3710,1837,2,1845,1130,715,1.58041958,1097,2524,417,146,143,3,41,2,0.055944056,0,empty,CD-0722-4
"D4,B2",8445,9138,5668,3470,4752,2593,0,2593,1654,939,1.761448349,1545,879,132,29,29,0,14,0,0,0,empty,CD-0722-4
"D4,B3",5414,6062,3979,2083,3088,1568,0,1568,1003,565,1.775221239,892,1871,367,127,127,0,42,0,0.086614173,0,empty,CD-0722-4
"D4,B4",5574,6218,4125,2093,3192,1633,0,1633,1040,593,1.753794266,940,1329,289,106,103,3,28,2,0.194174757,0,empty,CD-0722-4
"D4,B5",12375,10306,6465,3841,5959,3221,7,3232,2433,799,3.04505632,1969,990,244,88,85,3,26,2,0.035294118,0,empty,CD-0722-4
"D4,B6",7169,8019,5261,2758,4271,2289,0,2290,1482,808,1.834158416,1303,1773,314,137,137,0,42,0,0.094890511,0,empty,CD-0722-4
"D4,B7",6842,7543,5134,2409,4081,1946,0,1948,1273,675,1.885925926,1124,1721,408,135,135,0,41,0,0,0,empty,CD-0722-4
"D4,B8",5107,5346,3793,1553,2837,1319,3,1323,876,447,1.959731544,690,1543,329,138,136,2,44,1,0.125,0,empty,CD-0722-4
"D4,B9",8914,9735,6476,3259,5091,2583,0,2593,1642,951,1.726603575,1502,1250,350,124,124,0,43,0,0.161290323,0,empty,CD-0722-4
"D4,B10",4853,5119,3540,1579,2787,1368,0,1372,891,481,1.852390852,739,725,61,38,37,1,14,1,0,0,empty,CD-0722-4
"D4,B11",1576900,1709062,1213302,495760,810061,388720,26,389163,315200,73963,4.261590255,215287,16956,1936,743,718,25,187,3,0.011142061,0,hg38,CD-0722-4
"D4,B12",813482,966827,586009,380818,479457,278323,1,278541,214561,63980,3.353563614,168916,120105,19059,7075,6910,165,1170,5,0.054413893,0,hg38,CD-0722-4
"D4,C1",12564,13269,9513,3756,7063,3281,51,3335,2098,1237,1.696038804,1803,1467,498,154,152,2,45,1,0.111842105,0,empty,CD-0722-4
"D4,C2",10040,10945,7285,3660,5780,2896,0,2903,1901,1002,1.897205589,1711,2434,866,305,304,1,74,1,0.082236842,0,empty,CD-0722-4
"D4,C3",9942,11078,7478,3600,5847,2835,0,2843,1768,1075,1.644651163,1618,881,125,62,61,1,21,1,0.016393443,0,empty,CD-0722-4
"D4,C4",5994,6556,4407,2149,3457,1691,0,1691,1085,606,1.790429043,968,2154,390,152,152,0,47,0,0.026315789,0,empty,CD-0722-4
"D4,C5",8703,9568,6498,3070,4994,2445,0,2451,1631,820,1.98902439,1358,1759,327,116,116,0,46,0,0.034482759,0,empty,CD-0722-4
"D4,C6",8347,8934,6036,2898,4810,2446,0,2447,1645,802,2.051122195,1374,1951,572,216,213,3,37,1,0.103286385,0,empty,CD-0722-4
"D4,C7",3138200,3140291,2544713,595578,1395299,566528,6,567286,440540,126746,3.475770439,271387,2457,921,316,313,3,107,2,0.038338658,0,hg38,CD-0722-4
"D4,C8",11310,12262,8296,3966,6397,3233,0,3238,2090,1148,1.820557491,1801,3983,1019,346,342,4,81,2,0.073099415,0,empty,CD-0722-4
"D4,C9",722602,871703,519163,352540,432559,253716,5,253890,209651,44239,4.739053776,156515,46192,8558,3224,3178,46,652,3,0.085273757,0,hg38,CD-0722-4
"D4,C10",9173,9897,6884,3013,5164,2482,12,2499,1635,864,1.892361111,1353,2260,492,180,178,2,54,1,0.112359551,0,empty,CD-0722-4
"D4,C11",8040,8827,6021,2806,4667,2343,0,2343,1482,861,1.721254355,1333,2011,571,212,211,1,50,1,0.052132701,0,empty,CD-0722-4
"D4,C12",11143,12327,8323,4004,6314,3076,2,3090,2017,1073,1.879776328,1754,2076,573,193,191,2,56,2,0.083769634,0,empty,CD-0722-4
"D4,D1",9583,10381,7056,3325,5381,2765,1,2766,1688,1078,1.565862709,1545,985,117,56,56,0,11,0,0.125,0,empty,CD-0722-4
"D4,D2",8724,9274,6696,2578,4844,2220,9,2237,1465,772,1.897668394,1163,3008,736,317,311,6,78,2,0.106109325,0,empty,CD-0722-4
"D4,D3",7498,8066,5481,2585,4215,2084,33,2119,1378,741,1.859649123,1201,1863,265,132,131,1,41,1,0.122137405,0,empty,CD-0722-4
"D4,D4",5508,6020,4172,1848,3253,1547,0,1549,1043,506,2.061264822,869,1497,263,91,84,7,38,2,0.226190476,0,empty,CD-0722-4
"D4,D5",6313,6728,4726,2002,3530,1695,0,1695,1024,671,1.526080477,933,1876,403,152,151,1,46,1,0.145695364,0,empty,CD-0722-4
"D4,D6",9926,10558,7057,3501,5562,2907,0,2909,1831,1078,1.69851577,1613,2706,737,290,286,4,66,2,0.006993007,0,empty,CD-0722-4
"D4,D7",767868,880423,567865,312558,431745,235015,6,235188,190793,44395,4.297623606,137396,207501,33212,12903,12650,253,1900,7,0.052806324,0,hg38,CD-0722-4
"D4,D8",8111,8874,6148,2726,4645,2202,1,2205,1483,722,2.05401662,1247,1924,469,154,151,3,40,2,0.033112583,0,empty,CD-0722-4
"D4,D9",3382,3592,2544,1048,1931,903,0,903,597,306,1.950980392,499,3284,450,197,192,5,49,1,0.036458333,0,empty,CD-0722-4
"D4,D10",9528,10539,7136,3403,5388,2610,3,2616,1699,917,1.852780807,1449,1117,245,77,77,0,20,0,0,0,empty,CD-0722-4
"D4,D11",6973,7678,5285,2393,4029,1940,2,1945,1269,676,1.877218935,1079,3612,1130,392,389,3,76,1,0.028277635,0,empty,CD-0722-4
"D4,D12",9762,10785,7227,3558,5681,2821,23,2853,1900,953,1.993704092,1668,4368,1220,455,452,3,110,1,0.033185841,0,empty,CD-0722-4
"D4,E1",12072,13043,8976,4067,6629,3188,0,3195,2018,1177,1.714528462,1753,3154,680,279,270,9,83,2,0.17037037,0,empty,CD-0722-4
"D4,E2",8531,9271,6107,3164,4796,2414,8,2425,1482,943,1.571580064,1367,1831,236,114,114,0,41,0,0.149122807,0,empty,CD-0722-4
"D4,E3",5918,6534,4396,2138,3411,1666,0,1666,1065,601,1.772046589,959,2778,673,254,252,2,69,1,0.138888889,0,empty,CD-0722-4
"D4,E4",7940,8482,5915,2567,4600,2291,0,2292,1443,849,1.699646643,1261,3180,827,319,319,0,77,0,0.097178683,0,empty,CD-0722-4
"D4,E5",9415,10405,7038,3367,5283,2564,23,2589,1710,879,1.945392491,1433,1494,442,157,155,2,39,1,0.04516129,0,empty,CD-0722-4
"D4,E6",832462,934782,622385,312397,450111,233356,1,233591,189382,44209,4.283788369,133243,199333,33811,12923,12716,207,1879,5,0.044117647,0,hg38,CD-0722-4
"D4,E7",10622,11376,7854,3522,5904,2765,0,2771,1844,927,1.989212513,1553,3344,719,311,308,3,84,2,0.162337662,0,empty,CD-0722-4
"D4,E8",9379,10266,7112,3154,5420,2557,18,2577,1780,797,2.233375157,1450,3642,722,250,247,3,76,1,0.056680162,0,empty,CD-0722-4
"D4,E9",5179,5592,3784,1808,2992,1512,0,1516,1034,482,2.145228216,857,2899,799,292,292,0,68,0,0.030821918,0,empty,CD-0722-4
"D4,E10",465837,598922,306644,292278,302072,209791,2,209914,139793,70121,1.993596783,135221,4266,642,259,257,2,58,1,0.050583658,0,hg38,CD-0722-4
"D4,E11",8358,8816,6148,2668,4818,2371,0,2374,1531,843,1.816132859,1294,2380,520,180,178,2,49,1,0.011235955,0,empty,CD-0722-4
"D4,E12",7988,8743,5871,2872,4649,2324,0,2329,1526,803,1.900373599,1364,2190,509,194,191,3,61,1,0.005235602,0,empty,CD-0722-4
"D4,F1",10277,11055,7575,3480,5710,2724,3,2730,1691,1039,1.627526468,1556,2804,687,269,268,1,61,1,0.003731343,0,empty,CD-0722-4
"D4,F2",7831,8485,5726,2759,4558,2226,0,2235,1440,795,1.811320755,1331,3863,979,395,395,0,86,0,0.015189873,0,empty,CD-0722-4
"D4,F3",7602,8317,5618,2699,4392,2131,13,2147,1431,716,1.998603352,1211,3570,699,280,273,7,70,2,0.117216117,0,empty,CD-0722-4
"D4,F4",11917,12585,8893,3692,6522,3070,0,3072,2022,1050,1.925714286,1623,1185,206,88,87,1,29,1,0.011494253,0,empty,CD-0722-4
"D4,F5",9660,10280,7224,3056,5340,2491,16,2509,1601,908,1.763215859,1385,3017,1020,411,405,6,76,2,0.071604938,0,empty,CD-0722-4
"D4,F6",1403122,1637786,1055774,582012,789947,430859,5,431223,360842,70381,5.126980293,253298,359660,65921,25279,24901,378,3043,10,0.063531585,0,hg38,CD-0722-4
"D4,F7",10456,11321,7728,3593,6117,3015,2,3018,1962,1056,1.857954545,1717,1628,277,127,126,1,29,1,0.079365079,0,empty,CD-0722-4
"D4,F8",926139,1059563,696454,363109,519280,272323,1,272552,207019,65533,3.159003861,158452,9598,1220,528,520,8,111,2,0.073076923,0,hg38,CD-0722-4
"D4,F9",7767,8560,5883,2677,4428,2091,0,2097,1393,704,1.978693182,1150,3047,925,359,356,3,80,3,0.103932584,0,empty,CD-0722-4
"D4,F10",10729,11757,8089,3668,6067,2864,0,2867,1856,1011,1.835806133,1529,2174,534,226,225,1,43,1,0.044444444,0,empty,CD-0722-4
"D4,F11",7206,7911,5413,2498,4085,1876,0,1876,1236,640,1.93125,1038,2223,483,202,198,4,47,1,0.005050505,0,empty,CD-0722-4
"D4,F12",8614,9212,6309,2903,4850,2396,0,2396,1529,867,1.76355248,1349,346,162,26,25,1,8,1,0.6,0,empty,CD-0722-4
"D4,G1",18175,20217,13764,6453,10252,5076,24,5108,3514,1594,2.204516939,2852,3540,1019,374,371,3,84,2,0.070080863,0,empty,CD-0722-4
"D4,G2",5783,6312,4144,2168,3299,1637,0,1643,1033,610,1.693442623,967,753,181,52,52,0,15,0,0,0,empty,CD-0722-4
"D4,G3",11480,12013,8464,3549,6209,3070,0,3073,1913,1160,1.649137931,1688,4360,987,383,378,5,85,1,0.108465608,0,empty,CD-0722-4
"D4,G4",18549,20257,13339,6918,10483,5652,16,5679,3487,2192,1.590784672,3202,123,4,2,2,0,2,0,0,0,empty,CD-0722-4
"D4,G5",932780,1051741,707287,344454,506682,262784,0,263016,204204,58812,3.472148541,151077,95917,11460,4427,4318,109,811,6,0.062992126,0,hg38,CD-0722-4
"D4,G6",9370,10208,7000,3208,5384,2599,0,2599,1787,812,2.200738916,1434,122,24,15,15,0,6,0,0.533333333,0,empty,CD-0722-4
"D4,G7",7820,8342,6016,2326,4357,1999,0,1999,1364,635,2.148031496,1044,6961,1490,605,595,10,154,2,0.077310924,0,empty,CD-0722-4
"D4,G8",5610,6271,4136,2135,3194,1533,29,1562,1012,550,1.84,938,2058,513,183,182,1,46,1,0.148351648,0,empty,CD-0722-4
"D4,G9",7024,7659,5175,2484,4102,1991,0,1994,1320,674,1.958456973,1135,2667,560,239,238,1,76,1,0.037815126,0,empty,CD-0722-4
"D4,G10",7817,8550,6027,2523,4544,2201,0,2204,1392,812,1.714285714,1171,2794,751,325,322,3,76,3,0.124223602,0,empty,CD-0722-4
"D4,G11",8047,8836,6059,2777,4556,2148,0,2149,1444,705,2.04822695,1227,1971,460,202,200,2,48,1,0.12,0,empty,CD-0722-4
"D4,G12",6390,7074,4718,2356,3773,1919,0,1919,1213,706,1.718130312,1091,2240,791,250,250,0,47,0,0.004,0,empty,CD-0722-4
"D4,H1",745245,846100,551393,294707,418378,222408,4,222615,177947,44668,3.983769141,130058,67395,9261,3558,3492,66,703,4,0.042955326,0,hg38,CD-0722-4
"D4,H2",7603,8266,5617,2649,4379,2132,0,2132,1354,778,1.740359897,1185,2725,679,294,294,0,73,0,0.047619048,0,empty,CD-0722-4
"D4,H3",898338,1062693,650687,412006,520016,294765,1,295032,234435,60597,3.868755879,179055,164756,25727,9630,9469,161,1463,6,0.055760904,0,hg38,CD-0722-4
"D4,H4",9882,10580,7218,3362,5352,2574,0,2576,1710,866,1.974595843,1438,217,67,23,23,0,9,0,0.391304348,0,empty,CD-0722-4
"D4,H5",10661,11345,7710,3635,5983,2915,0,2927,1902,1025,1.855609756,1623,2590,665,264,261,3,62,2,0.038314176,0,empty,CD-0722-4
"D4,H6",5879,6371,4365,2006,3339,1677,0,1677,1129,548,2.060218978,940,2760,835,309,305,4,67,2,0.055737705,0,empty,CD-0722-4
"D4,H7",7155,7511,5194,2317,4082,2030,1,2036,1289,747,1.725568942,1152,2533,814,257,257,0,56,0,0.13229572,0,empty,CD-0722-4
"D4,H8",8714,9965,6349,3616,5069,2637,0,2639,1711,928,1.84375,1554,2647,524,242,241,1,70,1,0.136929461,0,empty,CD-0722-4
"D4,H9",6366,6845,4807,2038,3489,1639,0,1641,1150,491,2.342158859,899,1290,342,139,139,0,34,0,0.151079137,0,empty,CD-0722-4
"D4,H10",5467,6113,4132,1981,3171,1533,0,1535,1008,527,1.912713472,871,1711,426,183,183,0,43,0,0.092896175,0,empty,CD-0722-4
"D4,H11",6700,7783,4637,3146,3993,2359,0,2361,1209,1152,1.049479167,1465,72,3,2,2,0,2,0,0,0,empty,CD-0722-4
"D4,H12",5800,6537,4186,2351,3335,1651,0,1653,1099,554,1.983754513,964,2384,536,196,192,4,45,2,0.135416667,0,empty,CD-0722-4
"D5,A1",6244,7089,4580,2509,3653,1887,0,1887,1205,682,1.76686217,1088,1189,249,87,86,1,27,1,0.023255814,0,empty,CD-0722-4
"D5,A2",8446,9281,6285,2996,4789,2364,1,2368,1512,856,1.76635514,1326,2042,401,179,177,2,41,1,0.073446328,0,empty,CD-0722-4
"D5,A3",6669,7172,5012,2160,3775,1773,1,1780,1212,568,2.133802817,978,1722,385,159,156,3,37,2,0.051282051,0,empty,CD-0722-4
"D5,A4",10572,11458,7821,3637,5934,2871,4,2890,1857,1033,1.79767667,1627,685,161,49,47,2,16,2,0.021276596,0,empty,CD-0722-4
"D5,A5",8201,9027,6004,3023,4795,2386,1,2389,1543,846,1.823877069,1397,2350,512,228,226,2,69,1,0.128318584,0,empty,CD-0722-4
"D5,A6",6998,7840,5317,2523,4044,2065,0,2068,1319,749,1.761014686,1120,2506,750,268,267,1,66,1,0.04494382,0,empty,CD-0722-4
"D5,A7",5742,6533,4226,2307,3412,1771,0,1775,1143,632,1.808544304,1006,1107,297,128,127,1,33,1,0,0,empty,CD-0722-4
"D5,A8",24353,29173,17949,11224,14790,8438,0,8444,6729,1715,3.92361516,5112,9043,1242,442,441,1,120,1,0.024943311,0,empty,CD-0722-4
"D5,A9",6266,6948,4647,2301,3706,1845,0,1848,1233,615,2.004878049,1057,2003,374,156,154,2,48,1,0.038961039,0,empty,CD-0722-4
"D5,A10",7038,7475,5310,2165,3888,1833,1,1834,1136,698,1.627507163,964,264,13,9,9,0,8,0,0.222222222,0,empty,CD-0722-4
"D5,A11",5320,5756,3942,1814,3054,1450,15,1465,962,503,1.912524851,841,1275,221,95,94,1,34,1,0.180851064,0,empty,CD-0722-4
"D5,A12",7378,7972,5497,2475,4117,1969,0,1969,1322,647,2.043276662,1072,4012,1068,390,389,1,82,1,0.041131105,0,empty,CD-0722-4
"D5,B1",6553,7195,4830,2365,3752,1915,1,1920,1230,690,1.782608696,1076,1303,353,128,126,2,32,1,0.134920635,0,empty,CD-0722-4
"D5,B2",7328,7853,4935,2918,4182,2231,0,2233,1380,853,1.617819461,1329,478,154,58,58,0,14,0,0.517241379,0,empty,CD-0722-4
"D5,B3",6008,6839,4485,2354,3396,1688,0,1690,1072,618,1.734627832,970,1302,229,101,101,0,31,0,0.089108911,0,empty,CD-0722-4
"D5,B4",798498,882520,611814,270706,436865,209881,0,210073,159265,50808,3.134644151,118174,117744,17198,6789,6640,149,1046,6,0.063403614,0,hg38,CD-0722-4
"D5,B5",6725,4278,2601,1677,2763,1459,0,1472,948,524,1.809160305,956,1091,224,76,74,2,20,1,0.013513514,0,empty,CD-0722-4
"D5,B6",8038,8874,5814,3060,4775,2531,0,2532,1484,1048,1.416030534,1478,2243,467,213,207,6,59,2,0.062801932,0,empty,CD-0722-4
"D5,B7",7714,8561,5895,2666,4669,2322,1,2324,1520,804,1.890547264,1344,1556,371,125,124,1,33,1,0.088709677,0,empty,CD-0722-4
"D5,B8",5004,5308,3752,1556,2771,1280,12,1297,839,458,1.831877729,692,1339,379,124,123,1,42,1,0.024390244,0,empty,CD-0722-4
"D5,B9",8934,10138,6403,3735,5271,2808,0,2810,1749,1061,1.648444863,1689,865,227,97,95,2,31,1,0.010526316,0,empty,CD-0722-4
"D5,B10",4705,5210,3364,1846,2877,1464,0,1470,926,544,1.702205882,877,345,61,29,29,0,13,0,0.034482759,0,empty,CD-0722-4
"D5,B11",9577,10757,6920,3837,5599,3028,0,3030,1691,1339,1.262882748,1794,312,44,22,20,2,8,1,0,0,empty,CD-0722-4
"D5,B12",7968,8717,5903,2814,4581,2199,29,2228,1538,690,2.228985507,1265,2630,593,224,223,1,55,1,0.112107623,0,empty,CD-0722-4
"D5,C1",981550,1106644,736400,370244,538405,281451,2,281733,222252,59481,3.736520906,160109,41723,9497,3744,3709,35,698,3,0.068482071,0,hg38,CD-0722-4
"D5,C2",25477,28657,19276,9381,13977,6957,1,6966,4655,2311,2.014279533,3966,2481,634,245,244,1,75,1,0.053278689,0,empty,CD-0722-4
"D5,C3",13184,15095,9800,5295,7873,4026,1,4031,2743,1288,2.129658385,2388,853,256,109,109,0,23,0,0.165137615,0,empty,CD-0722-4
"D5,C4",6208,6594,4765,1829,3540,1606,0,1607,1055,552,1.911231884,880,1851,415,158,158,0,52,0,0.082278481,0,empty,CD-0722-4
"D5,C5",10917,12366,8030,4336,6356,3282,2,3287,2156,1131,1.90627763,1924,1877,430,148,148,0,39,0,0.128378378,0,empty,CD-0722-4
"D5,C6",7736,8234,5676,2558,4549,2225,0,2226,1383,843,1.640569395,1234,1741,404,154,153,1,40,1,0.045751634,0,empty,CD-0722-4
"D5,C7",10518,12003,7626,4377,6127,3347,0,3349,2000,1349,1.482579689,1959,349,119,37,37,0,14,0,0.135135135,0,empty,CD-0722-4
"D5,C8",11207,12322,8359,3963,6376,3207,0,3210,2064,1146,1.80104712,1813,3249,962,378,370,8,77,1,0.124324324,0,empty,CD-0722-4
"D5,C9",7863,8750,5906,2844,4613,2246,3,2249,1450,799,1.814768461,1288,1595,352,150,149,1,32,1,0.020134228,0,empty,CD-0722-4
"D5,C10",9662,10318,7122,3196,5346,2576,0,2576,1635,941,1.737513284,1465,2617,647,244,241,3,58,1,0.049792531,0,empty,CD-0722-4
"D5,C11",8295,9324,6047,3277,4804,2432,0,2434,1525,909,1.677667767,1405,1876,622,223,223,0,61,0,0.044843049,0,empty,CD-0722-4
"D5,C12",10888,11717,8029,3688,6161,2960,1,2965,1927,1038,1.856454721,1658,2000,594,170,168,2,40,1,0.279761905,0,empty,CD-0722-4
"D5,D1",10015,11012,7319,3693,5641,2884,1,2889,1796,1093,1.643183898,1653,746,143,56,54,2,19,1,0,0,empty,CD-0722-4
"D5,D2",8694,9434,6628,2806,5092,2439,0,2441,1515,926,1.636069114,1353,2464,690,223,221,2,64,1,0.004524887,0,empty,CD-0722-4
"D5,D3",7472,8462,5377,3085,4441,2286,1,2289,1488,801,1.857677903,1345,2028,488,163,162,1,37,1,0.030864198,0,empty,CD-0722-4
"D5,D4",886773,1081670,639506,442164,537252,316735,4,317040,252821,64219,3.936856694,195013,91741,20294,7747,7672,75,1255,3,0.066214807,0,hg38,CD-0722-4
"D5,D5",6472,6925,4896,2029,3629,1679,0,1679,1084,595,1.821848739,885,1741,234,127,123,4,33,3,0.024390244,0,empty,CD-0722-4
"D5,D6",972139,1096240,726526,369714,537012,285481,0,285794,225990,59804,3.778844224,164969,30269,3190,1221,1192,29,317,5,0.019295302,0,hg38,CD-0722-4
"D5,D7",5597,6111,4216,1895,3181,1496,1,1501,983,518,1.897683398,832,2028,585,249,247,2,63,1,0.072874494,0,empty,CD-0722-4
"D5,D8",6996,7570,5236,2334,3946,1876,5,1883,1275,608,2.097039474,1025,1414,402,169,167,2,46,2,0.047904192,0,empty,CD-0722-4
"D5,D9",3626,3972,2647,1325,2111,1019,8,1027,646,381,1.695538058,605,1638,334,141,141,0,42,0,0.127659574,0,empty,CD-0722-4
"D5,D10",8003,8680,5994,2686,4543,2285,0,2288,1502,786,1.910941476,1266,1154,266,103,102,1,32,1,0,0,empty,CD-0722-4
"D5,D11",7146,7779,5442,2337,4120,1976,0,1983,1285,698,1.840974212,1098,3312,853,314,307,7,67,3,0.110749186,0,empty,CD-0722-4
"D5,D12",9862,10707,7355,3352,5461,2658,0,2660,1738,922,1.885032538,1450,4614,1373,512,508,4,107,2,0.116141732,0,empty,CD-0722-4
"D5,E1",11632,12736,8443,4293,6597,3319,0,3333,2100,1233,1.703163017,1959,2874,674,260,256,4,71,1,0.0859375,0,empty,CD-0722-4
"D5,E2",9554,10864,6792,4072,5564,3008,0,3010,1907,1103,1.728921124,1813,2192,389,124,121,3,50,1,0.033057851,0,empty,CD-0722-4
"D5,E3",531169,572422,423221,149201,284682,118605,0,118721,90960,27761,3.27653903,63156,234819,35954,13834,13528,306,1852,7,0.045387345,0,hg38,CD-0722-4
"D5,E4",7836,8609,5793,2816,4548,2231,0,2234,1484,750,1.978666667,1295,2502,465,206,203,3,53,1,0.078817734,0,empty,CD-0722-4
"D5,E5",7099,7714,5368,2346,4004,1881,0,1881,1222,659,1.854324734,1002,1112,319,132,131,1,34,1,0.083969466,0,empty,CD-0722-4
"D5,E6",904162,1015984,685349,330635,492869,252939,2,253202,198793,54409,3.653678619,143574,184189,24288,9603,9410,193,1575,5,0.064930925,0,hg38,CD-0722-4
"D5,E7",10517,11115,7810,3305,5873,2750,1,2755,1794,961,1.866805411,1477,2423,547,228,226,2,64,2,0.115044248,0,empty,CD-0722-4
"D5,E8",36690,41313,26217,15096,20563,11476,14,11504,7038,4466,1.575906852,6599,2911,808,296,294,2,70,1,0.013605442,0,empty,CD-0722-4
"D5,E9",5021,5474,3707,1767,2834,1378,1,1380,854,526,1.623574144,780,2154,461,180,173,7,49,2,0.052023121,0,empty,CD-0722-4
"D5,E10",6977,7481,5299,2182,3935,1854,0,1855,1225,630,1.944444444,1011,1839,571,208,203,5,43,2,0,0,empty,CD-0722-4
"D5,E11",8090,8556,5991,2565,4578,2218,5,2228,1377,851,1.618096357,1245,2246,634,262,257,5,47,2,0.019455253,0,empty,CD-0722-4
"D5,E12",8176,9285,6019,3266,4913,2504,0,2505,1609,896,1.795758929,1522,2639,663,221,218,3,52,2,0.04587156,0,empty,CD-0722-4
"D5,F1",10423,11015,7678,3337,5814,2812,0,2818,1739,1079,1.611677479,1526,2368,575,220,220,0,57,0,0.027272727,0,empty,CD-0722-4
"D5,F2",1437495,1686846,1058203,628643,824201,469997,8,470422,389650,80772,4.824072698,279892,159708,28466,10782,10638,144,1879,8,0.047471329,0,hg38,CD-0722-4
"D5,F3",7516,8012,5498,2514,4181,2036,15,2056,1344,712,1.887640449,1162,2926,630,266,265,1,60,1,0.283018868,0,empty,CD-0722-4
"D5,F4",11890,12889,8976,3913,6829,3238,1,3243,2096,1147,1.827375763,1821,1014,134,63,63,0,22,0,0.047619048,0,empty,CD-0722-4
"D5,F5",9609,10159,7274,2885,5283,2347,38,2389,1537,852,1.80399061,1270,2198,453,187,187,0,60,0,0.122994652,0,empty,CD-0722-4
"D5,F6",8996,10064,6510,3554,5306,2721,0,2725,1772,953,1.859391396,1566,2794,565,279,276,3,80,1,0.010869565,0,empty,CD-0722-4
"D5,F7",10722,11515,7996,3519,6105,2959,0,2961,1949,1012,1.925889328,1609,1329,422,132,131,1,46,1,0,0,empty,CD-0722-4
"D5,F8",7058,8024,5209,2815,4142,2071,0,2073,1319,754,1.74933687,1216,209,52,17,17,0,6,0,0.411764706,0,empty,CD-0722-4
"D5,F9",7850,8648,5987,2661,4580,2192,9,2204,1441,763,1.888597641,1254,3743,965,379,374,5,90,2,0.139037433,0,empty,CD-0722-4
"D5,F10",10225,11042,7685,3357,5813,2682,0,2684,1782,902,1.975609756,1533,2083,415,157,155,2,47,2,0.032258065,0,empty,CD-0722-4
"D5,F11",7673,8276,5744,2532,4329,2010,0,2012,1288,724,1.779005525,1144,1767,384,155,149,6,38,1,0.187919463,0,empty,CD-0722-4
"D5,F12",8519,9345,6317,3028,4863,2393,13,2407,1535,872,1.760321101,1386,286,158,66,66,0,10,0,0,0,empty,CD-0722-4
"D5,G1",10003,10909,7449,3460,5898,2813,0,2819,1782,1037,1.718418515,1593,3094,663,284,282,2,64,2,0.141843972,0,empty,CD-0722-4
"D5,G2",5762,6125,4103,2022,3246,1647,1,1651,1049,602,1.742524917,922,423,52,31,30,1,13,1,0.333333333,0,empty,CD-0722-4
"D5,G3",11073,11753,8204,3549,6012,2978,10,2996,1793,1203,1.490440565,1592,2493,593,256,248,8,67,2,0.048387097,0,empty,CD-0722-4
"D5,G4",2137396,2406897,1620998,785899,1145533,597790,6,598350,496063,102287,4.849716973,340160,2633,472,166,163,3,34,1,0.055214724,0,hg38,CD-0722-4
"D5,G5",6515,7075,4860,2215,3640,1756,0,1758,1118,640,1.746875,978,1476,244,112,110,2,36,1,0,0,empty,CD-0722-4
"D5,G6",715698,861070,489080,371990,430357,283263,2,283453,203855,79598,2.56105681,170473,354,26,13,13,0,9,0,0,0,empty,CD-0722-4
"D5,G7",8332,8932,6232,2700,4715,2171,0,2171,1463,708,2.066384181,1184,2452,549,230,228,2,72,2,0.013157895,0,empty,CD-0722-4
"D5,G8",5581,6199,4116,2083,3222,1601,20,1626,1076,550,1.956363636,946,1755,348,146,145,1,46,1,0.006896552,0,empty,CD-0722-4
"D5,G9",6929,7491,5109,2382,4120,2006,0,2006,1288,718,1.793871866,1141,2345,577,244,239,5,76,2,0.0041841,0,empty,CD-0722-4
"D5,G10",7709,8683,5803,2880,4450,2247,10,2259,1473,786,1.874045802,1238,3110,1069,429,425,4,88,2,0.110588235,0,empty,CD-0722-4
"D5,G11",7954,8481,6181,2300,4341,2018,7,2025,1363,662,2.058912387,1027,1446,278,125,124,1,45,1,0.032258065,0,empty,CD-0722-4
"D5,G12",6761,7500,5014,2486,3909,1947,0,1947,1278,669,1.910313901,1112,1640,362,154,148,6,40,2,0.013513514,0,empty,CD-0722-4
"D5,H1",6621,6949,4781,2168,3713,1756,0,1761,1220,541,2.255083179,1008,1417,442,157,153,4,37,1,0.091503268,0,empty,CD-0722-4
"D5,H2",8040,8697,5941,2756,4600,2275,14,2289,1445,844,1.712085308,1317,2562,656,284,282,2,58,1,0.088652482,0,empty,CD-0722-4
"D5,H3",6096,6386,4532,1854,3432,1603,1,1610,1039,571,1.819614711,906,1645,423,175,173,2,40,1,0.052023121,0,empty,CD-0722-4
"D5,H4",9549,10379,6994,3385,5388,2566,32,2602,1681,921,1.825190011,1456,172,35,9,9,0,4,0,0,0,empty,CD-0722-4
"D5,H5",10471,11625,7709,3916,6099,3022,0,3024,1955,1069,1.828811974,1770,2012,609,238,238,0,53,0,0.016806723,0,empty,CD-0722-4
"D5,H6",5913,6528,4416,2112,3342,1631,4,1636,1111,525,2.116190476,879,1751,340,151,148,3,50,2,0.02027027,0,empty,CD-0722-4
"D5,H7",7921,8511,5830,2681,4490,2136,0,2137,1407,730,1.92739726,1204,2102,535,182,181,1,48,1,0.038674033,0,empty,CD-0722-4
"D5,H8",8177,8986,6013,2973,4670,2391,1,2392,1553,839,1.851013111,1392,2434,502,253,251,2,71,2,0.139442231,0,empty,CD-0722-4
"D5,H9",6316,6547,4831,1716,3407,1484,0,1486,992,494,2.008097166,768,964,177,69,69,0,34,0,0.086956522,0,empty,CD-0722-4
"D5,H10",6821,7391,5062,2329,4014,2026,0,2027,1413,614,2.301302932,1156,1038,279,106,106,0,28,0,0.245283019,0,empty,CD-0722-4
"D5,H11",6982,7642,4842,2800,4048,2417,0,2417,1302,1115,1.167713004,1379,21,1,1,1,0,1,0,0,0,empty,CD-0722-4
"D5,H12",5320,5798,3930,1868,3089,1590,0,1590,1005,585,1.717948718,914,1178,197,58,57,1,23,1,0.035087719,0,empty,CD-0722-4
"D6,A1",6320,6850,4540,2310,3662,1887,6,1894,1213,681,1.781204112,1098,2211,637,220,215,5,52,2,0.055813953,0,empty,CD-0722-4
"D6,A2",8255,9257,6031,3226,4750,2368,0,2372,1443,929,1.5532831,1368,2146,663,276,276,0,67,0,0.09057971,0,empty,CD-0722-4
"D6,A3",5641,6175,4135,2040,3347,1662,0,1662,1058,604,1.751655629,966,1955,316,120,120,0,39,0,0.2,0,empty,CD-0722-4
"D6,A4",4231820,4797269,3195378,1601891,2183900,1218833,8,1219945,973597,246348,3.952120577,703465,113495,17035,6814,6706,108,1170,5,0.045929019,0,hg38,CD-0722-4
"D6,A5",609131,644971,474628,170343,320470,142517,2,142674,110965,31709,3.499479643,76795,44950,9168,3599,3560,39,641,3,0.035674157,0,hg38,CD-0722-4
"D6,A6",365868,410524,281461,129063,206729,104269,0,104368,84151,20217,4.162388089,58971,56306,13143,5251,5191,60,921,3,0.022346369,0,hg38,CD-0722-4
"D6,A7",6349,6920,4626,2294,3702,1902,0,1902,1232,670,1.83880597,1068,1230,212,95,93,2,34,1,0.215053763,0,empty,CD-0722-4
"D6,A8",3545,3999,2642,1357,2067,1006,0,1008,659,349,1.888252149,565,2069,380,164,162,2,69,2,0.00617284,0,empty,CD-0722-4
"D6,A9",1157741,1371394,844757,526637,677439,394022,4,394338,308812,85526,3.610738255,236320,126965,17401,6735,6598,137,1184,6,0.058654138,0,hg38,CD-0722-4
"D6,A10",6487,6929,4882,2047,3585,1664,3,1670,1045,625,1.672,925,577,111,51,51,0,19,0,0.039215686,0,empty,CD-0722-4
"D6,A11",5324,5737,4019,1718,2993,1416,0,1417,900,517,1.740812379,805,1710,424,137,134,3,41,2,0.059701493,0,empty,CD-0722-4
"D6,A12",7383,7795,5564,2231,4107,1926,0,1927,1248,679,1.837997054,1035,6831,1700,672,664,8,150,2,0.096385542,0,empty,CD-0722-4
"D6,B1",6520,7268,4793,2475,3706,1847,3,1850,1213,637,1.904238619,1056,1244,220,110,108,2,43,1,0.027777778,0,empty,CD-0722-4
"D6,B2",7519,8309,5064,3245,4308,2345,0,2345,1506,839,1.794994041,1393,1059,205,101,101,0,26,0,0.099009901,0,empty,CD-0722-4
"D6,B3",5322,5512,3796,1716,2991,1496,0,1496,1002,494,2.028340081,814,1756,342,134,133,1,38,1,0.165413534,0,empty,CD-0722-4
"D6,B4",5525,5874,4082,1792,3223,1612,0,1612,982,630,1.558730159,877,1688,297,136,135,1,44,1,0.007407407,0,empty,CD-0722-4
"D6,B5",11826,9820,6429,3391,5636,2959,0,2971,2171,800,2.71375,1763,1721,580,225,223,2,44,2,0.013452915,0,empty,CD-0722-4
"D6,B6",7053,8031,5108,2923,4191,2220,17,2240,1398,842,1.660332542,1308,2980,694,308,308,0,72,0,0.087662338,0,empty,CD-0722-4
"D6,B7",7053,7754,5295,2459,4069,1882,16,1902,1240,662,1.873111782,1069,1443,288,152,152,0,43,0,0.026315789,0,empty,CD-0722-4
"D6,B8",4968,5459,3813,1646,2837,1327,1,1328,901,427,2.110070258,743,1632,287,102,101,1,40,1,0.04950495,0,empty,CD-0722-4
"D6,B9",8630,9675,6359,3316,5076,2599,0,2599,1624,975,1.665641026,1510,1174,223,106,106,0,35,0,0.037735849,0,empty,CD-0722-4
"D6,B10",4472,4863,3213,1650,2669,1285,1,1289,813,476,1.707983193,740,808,244,87,85,2,22,2,0.011764706,0,empty,CD-0722-4
"D6,B11",9232,10248,6685,3563,5318,2843,3,2849,1634,1215,1.344855967,1647,333,56,22,21,1,7,1,0.333333333,0,empty,CD-0722-4
"D6,B12",5528,6003,4135,1868,3255,1591,19,1611,1113,498,2.234939759,884,2336,441,185,184,1,58,1,0.070652174,0,empty,CD-0722-4
"D6,C1",12733,13374,9627,3747,7012,3239,0,3240,2098,1142,1.837127846,1759,1545,337,143,141,2,50,1,0,0,empty,CD-0722-4
"D6,C2",1356663,1509736,1052204,457532,721264,356330,3,356687,279044,77643,3.59393635,198419,180611,25527,10221,10035,186,1697,5,0.024813154,0,hg38,CD-0722-4
"D6,C3",10337,11181,7640,3541,5907,2892,0,2892,1856,1036,1.791505792,1631,1322,312,122,122,0,31,0,0.180327869,0,empty,CD-0722-4
"D6,C4",6159,6349,4712,1637,3436,1530,0,1532,991,541,1.831792976,814,2599,460,206,202,4,55,2,0.138613861,0,empty,CD-0722-4
"D6,C5",1009393,1191264,737640,453624,584817,329652,2,329928,265004,64924,4.081757131,199255,212731,35945,14129,13899,230,1964,8,0.069069717,0,hg38,CD-0722-4
"D6,C6",528678,634813,367974,266839,323300,197620,1,197779,162150,35629,4.55106795,123001,4476,1290,350,348,2,90,1,0.08908046,0,hg38,CD-0722-4
"D6,C7",10032,11497,7105,4392,6029,3369,0,3369,1983,1386,1.430735931,2057,322,58,27,27,0,10,0,0.037037037,0,empty,CD-0722-4
"D6,C8",14551,16385,10948,5437,8411,4231,0,4235,2894,1341,2.158090977,2396,4667,1281,439,434,5,106,1,0.032258065,0,empty,CD-0722-4
"D6,C9",787344,917608,580006,337602,452973,251420,3,251651,201838,49813,4.051914159,149252,46293,8807,3246,3204,42,637,3,0.014981273,0,hg38,CD-0722-4
"D6,C10",9318,10443,6931,3512,5519,2689,13,2709,1737,972,1.787037037,1584,3014,942,304,300,4,79,2,0.013333333,0,empty,CD-0722-4
"D6,C11",8394,9199,6071,3128,4729,2315,0,2315,1440,875,1.645714286,1346,2427,395,171,169,2,62,1,0.094674556,0,empty,CD-0722-4
"D6,C12",1546819,1741503,1142774,598729,837393,449894,10,450328,361149,89179,4.049709012,262156,286074,43346,16491,16141,350,2214,7,0.045102534,0,hg38,CD-0722-4
"D6,D1",9174,10333,6669,3664,5475,2870,6,2886,1810,1076,1.682156134,1753,1103,269,103,103,0,29,0,0.097087379,0,empty,CD-0722-4
"D6,D2",8827,9482,6661,2821,5001,2303,0,2312,1461,851,1.71680376,1253,3690,1237,378,373,5,92,2,0.056300268,0,empty,CD-0722-4
"D6,D3",8196,9041,6011,3030,4735,2389,0,2391,1592,799,1.992490613,1399,2474,755,252,252,0,60,0,0.047619048,0,empty,CD-0722-4
"D6,D4",9728,10879,7428,3451,5718,2902,0,2902,2218,684,3.242690058,1658,2009,337,138,132,6,52,2,0,0,empty,CD-0722-4
"D6,D5",6686,7140,5088,2052,3715,1749,6,1758,1168,590,1.979661017,949,1972,443,176,174,2,49,2,0.126436782,0,empty,CD-0722-4
"D6,D6",10128,10894,7325,3569,5596,2923,1,2931,1794,1137,1.577836412,1588,3007,729,318,317,1,81,1,0.028391167,0,empty,CD-0722-4
"D6,D7",5415,5643,3997,1646,3002,1383,0,1387,916,471,1.944798301,743,2420,541,206,202,4,62,2,0.044554455,0,empty,CD-0722-4
"D6,D8",6649,7330,4807,2523,3705,1792,0,1795,1177,618,1.904530744,1013,1539,372,143,143,0,48,0,0.048951049,0,empty,CD-0722-4
"D6,D9",423362,477425,316868,160557,238166,121698,1,121810,93276,28534,3.268942314,70409,232655,30059,11468,11156,312,1630,11,0.04446038,0,hg38,CD-0722-4
"D6,D10",7757,8355,5744,2611,4311,2090,1,2093,1343,750,1.790666667,1160,1167,262,120,118,2,36,1,0,0,empty,CD-0722-4
"D6,D11",7180,7713,5241,2472,4091,1951,0,1954,1261,693,1.81962482,1091,3694,797,279,276,3,72,1,0.014492754,0,empty,CD-0722-4
"D6,D12",9686,10561,7291,3270,5476,2608,0,2610,1611,999,1.612612613,1458,4257,945,398,395,3,119,2,0.126582278,0,empty,CD-0722-4
"D6,E1",11697,12512,8547,3965,6630,3333,20,3356,2157,1199,1.798999166,1887,3518,711,334,333,1,94,1,0.036036036,0,empty,CD-0722-4
"D6,E2",8506,9485,6323,3162,4841,2412,0,2413,1489,924,1.611471861,1361,3504,499,203,199,4,56,2,0.030150754,0,empty,CD-0722-4
"D6,E3",5803,6234,4360,1874,3306,1545,13,1558,974,584,1.667808219,822,3892,1061,426,423,3,108,1,0.106382979,0,empty,CD-0722-4
"D6,E4",7628,8342,5620,2722,4368,2182,1,2183,1401,782,1.791560102,1237,2763,515,236,232,4,81,2,0.137931034,0,empty,CD-0722-4
"D6,E5",7282,7972,5532,2440,4162,1908,16,1926,1221,705,1.731914894,1073,1516,308,127,120,7,41,2,0.091666667,0,empty,CD-0722-4
"D6,E6",11569,12752,8695,4057,6591,3233,0,3233,2058,1175,1.751489362,1805,4429,1030,428,426,2,94,1,0.056338028,0,empty,CD-0722-4
"D6,E7",11207,11901,8325,3576,6247,2937,0,2942,1917,1025,1.870243902,1624,3463,653,276,274,2,102,2,0.025547445,0,empty,CD-0722-4
"D6,E8",9330,9928,7167,2761,5236,2410,1,2417,1568,849,1.846878681,1244,3912,833,368,357,11,71,2,0.058823529,0,empty,CD-0722-4
"D6,E9",5483,6009,4061,1948,3161,1546,0,1546,1035,511,2.025440313,879,3022,540,241,237,4,75,2,0.025316456,0,empty,CD-0722-4
"D6,E10",7447,8165,5505,2660,4260,2074,0,2074,1324,750,1.765333333,1192,2154,671,276,275,1,60,1,0.16,0,empty,CD-0722-4
"D6,E11",7912,8621,5758,2863,4456,2217,0,2218,1382,836,1.653110048,1275,2540,628,243,238,5,61,2,0.012605042,0,empty,CD-0722-4
"D6,E12",756228,877641,554916,322725,435671,236952,1,237123,184569,52554,3.51198767,142772,153779,18084,7162,6993,169,1098,7,0.073073073,0,hg38,CD-0722-4
"D6,F1",10054,10704,7223,3481,5707,2915,0,2922,1824,1098,1.661202186,1660,2548,568,238,236,2,79,1,0.13559322,0,empty,CD-0722-4
"D6,F2",7569,8062,5607,2455,4288,2070,1,2072,1380,692,1.994219653,1139,3735,932,375,371,4,92,2,0.032345013,0,empty,CD-0722-4
"D6,F3",7279,7859,5404,2455,4087,1891,18,1912,1274,638,1.996865204,1065,3572,758,292,288,4,91,2,0.0625,0,empty,CD-0722-4
"D6,F4",12211,12701,8959,3742,6843,3301,1,3304,2196,1108,1.981949458,1779,941,188,43,41,2,19,2,0.097560976,0,empty,CD-0722-4
"D6,F5",757171,822099,578592,243507,400965,191479,1,191665,142745,48920,2.917927228,107620,45442,10326,4054,4011,43,704,2,0.011468462,0,hg38,CD-0722-4
"D6,F6",8264,9425,5962,3463,4825,2548,0,2548,1604,944,1.699152542,1512,4212,1150,421,414,7,122,2,0.050724638,0,empty,CD-0722-4
"D6,F7",10732,11746,8159,3587,6199,3067,12,3079,2007,1072,1.872201493,1670,1506,461,180,179,1,48,1,0.039106145,0,empty,CD-0722-4
"D6,F8",7454,8040,5470,2570,4224,2061,25,2089,1318,771,1.709468223,1193,523,40,28,28,0,19,0,0,0,empty,CD-0722-4
"D6,F9",8096,8545,6077,2468,4490,2055,18,2073,1417,656,2.160060976,1106,3246,838,375,372,3,95,2,0.083333333,0,empty,CD-0722-4
"D6,F10",11827,12606,8910,3696,6654,3255,0,3256,2151,1105,1.946606335,1748,2723,511,227,223,4,63,2,0.040358744,0,empty,CD-0722-4
"D6,F11",7497,8001,5714,2287,4183,1953,0,1955,1299,656,1.980182927,1013,2411,572,216,209,7,44,3,0.090909091,0,empty,CD-0722-4
"D6,F12",8808,9741,6362,3379,5040,2517,0,2517,1657,860,1.926744186,1426,365,110,60,60,0,19,0,0.233333333,0,empty,CD-0722-4
"D6,G1",9699,10328,7155,3173,5450,2597,3,2609,1661,948,1.752109705,1434,3827,882,350,346,4,101,2,0.023121387,0,empty,CD-0722-4
"D6,G2",5630,5872,3963,1909,3083,1553,17,1571,974,597,1.631490787,873,481,132,48,48,0,12,0,0.083333333,0,empty,CD-0722-4
"D6,G3",12050,12671,8760,3911,6631,3315,0,3318,2143,1175,1.823829787,1782,2942,669,299,296,3,83,2,0.023648649,0,empty,CD-0722-4
"D6,G4",18431,20628,13041,7587,10516,5781,0,5784,3539,2245,1.576391982,3376,163,28,18,18,0,7,0,0.722222222,0,empty,CD-0722-4
"D6,G5",6260,6917,4570,2347,3626,1809,0,1812,1182,630,1.876190476,1051,2177,362,136,127,9,46,1,0.039370079,0,empty,CD-0722-4
"D6,G6",9605,10439,7241,3198,5428,2629,0,2633,1666,967,1.722854188,1421,238,76,41,41,0,16,0,0,0,empty,CD-0722-4
"D6,G7",2830829,3249691,2093901,1155790,1549746,869552,2,870297,742640,127657,5.817463986,508847,656565,97987,38108,37323,785,3832,12,0.065937894,0,hg38,CD-0722-4
"D6,G8",5174,5703,3870,1833,3116,1561,0,1567,1023,544,1.880514706,914,2089,501,208,207,1,58,1,0.053140097,0,empty,CD-0722-4
"D6,G9",6711,7410,4796,2614,4003,2039,0,2044,1345,699,1.924177396,1211,3461,1070,400,394,6,110,2,0.159898477,0,empty,CD-0722-4
"D6,G10",1142787,1273361,886732,386629,619135,306241,4,306550,243005,63545,3.824140373,170808,231305,23157,9310,9066,244,1547,10,0.067615266,0,hg38,CD-0722-4
"D6,G11",7911,8539,5965,2574,4435,2120,3,2125,1442,683,2.111273792,1167,1933,531,239,238,1,49,1,0.142857143,0,empty,CD-0722-4
"D6,G12",6351,7092,4623,2469,3677,1908,0,1908,1141,767,1.487614081,1074,2844,769,267,266,1,76,1,0.022556391,0,empty,CD-0722-4
"D6,H1",620817,676429,475943,200486,335741,158316,5,158485,115288,43197,2.668889043,89384,88711,14763,5581,5485,96,948,6,0.030446673,0,hg38,CD-0722-4
"D6,H2",7736,8254,5732,2522,4409,2123,0,2125,1320,805,1.639751553,1190,2620,607,241,240,1,58,1,0.0125,0,empty,CD-0722-4
"D6,H3",6399,7056,4645,2411,3571,1775,0,1775,1094,681,1.606461087,1020,2136,307,101,98,3,46,1,0.142857143,0,empty,CD-0722-4
"D6,H4",9737,10338,7230,3108,5462,2596,0,2598,1649,949,1.737618546,1419,176,26,12,12,0,9,0,0.166666667,0,empty,CD-0722-4
"D6,H5",10594,11762,7635,4127,6042,3076,0,3081,1900,1181,1.608806097,1789,2796,555,227,226,1,78,1,0.017699115,0,empty,CD-0722-4
"D6,H6",5950,6536,4433,2103,3335,1694,0,1703,1152,551,2.090744102,940,2315,441,216,210,6,86,2,0.042857143,0,empty,CD-0722-4
"D6,H7",747606,897071,509864,387207,450470,296165,17,296433,220965,75468,2.927929719,178124,7134,1052,366,357,9,110,3,0.154061625,0,hg38,CD-0722-4
"D6,H8",1269961,1448115,944669,503446,702923,377220,14,377553,307867,69686,4.417917516,220761,95724,16540,6199,6114,85,1111,4,0.025024534,0,hg38,CD-0722-4
"D6,H9",5948,6253,4492,1761,3269,1467,0,1471,971,500,1.942,783,1489,335,140,138,2,39,1,0.02173913,0,empty,CD-0722-4
"D6,H10",5533,6060,4029,2031,3207,1624,0,1624,1049,575,1.824347826,924,1436,341,133,131,2,32,2,0.152671756,0,empty,CD-0722-4
"D6,H11",6532,7355,4581,2774,3873,2253,0,2254,1232,1022,1.205479452,1348,118,76,17,17,0,1,0,0,0,empty,CD-0722-4
"D6,H12",5126,5592,3811,1781,2972,1488,0,1488,1001,487,2.055441478,847,1621,416,183,183,0,51,0,0.071038251,0,empty,CD-0722-4
"D7,A1",6613,7123,4913,2210,3722,1918,0,1922,1218,704,1.730113636,1051,1180,197,81,81,0,29,0,0.074074074,0,empty,CD-0722-4
"D7,A2",9438,10071,6983,3088,5257,2615,1,2619,1648,971,1.697219361,1407,1802,440,158,155,3,47,1,0.148387097,0,empty,CD-0722-4
"D7,A3",756491,852411,572124,280287,415767,211397,2,211584,161743,49841,3.245179671,121794,97761,11465,4566,4444,122,802,5,0.065031503,0,hg38,CD-0722-4
"D7,A4",937354,1043577,724386,319191,502650,243676,27,243987,185200,58787,3.150356371,137200,57925,6782,2663,2594,69,487,4,0.053585197,0,hg38,CD-0722-4
"D7,A5",9018,9722,6717,3005,5141,2414,0,2414,1570,844,1.860189573,1362,2643,711,254,248,6,71,2,0.088709677,0,empty,CD-0722-4
"D7,A6",10059,11304,7712,3592,5814,2950,4,2962,1935,1027,1.88412853,1659,5348,1204,437,429,8,109,2,0.088578089,0,empty,CD-0722-4
"D7,A7",6507,7147,4831,2316,3693,1897,0,1900,1215,685,1.773722628,1049,1219,317,129,129,0,25,0,0.07751938,0,empty,CD-0722-4
"D7,A8",4464,5113,3390,1723,2630,1268,8,1276,854,422,2.023696682,730,1952,324,148,147,1,50,1,0.06122449,0,empty,CD-0722-4
"D7,A9",6888,7677,5043,2634,3930,1919,1,1924,1291,633,2.039494471,1131,1563,253,111,105,6,40,1,0.171428571,0,empty,CD-0722-4
"D7,A10",450993,506768,344035,162733,250413,127324,1,127459,99375,28084,3.538491668,72302,13947,2140,773,763,10,176,3,0.014416776,0,hg38,CD-0722-4
"D7,A11",5697,6332,4285,2047,3294,1534,0,1537,1005,532,1.889097744,855,1209,267,101,101,0,30,0,0.00990099,0,empty,CD-0722-4
"D7,A12",8435,9115,6463,2652,4654,2175,0,2176,1429,747,1.912985274,1161,3838,812,335,332,3,79,2,0.234939759,0,empty,CD-0722-4
"D7,B1",6937,7477,5174,2303,3889,1935,0,1939,1245,694,1.793948127,1066,1165,224,79,77,2,27,1,0.012987013,0,empty,CD-0722-4
"D7,B2",8491,9506,5865,3641,4917,2640,0,2640,1642,998,1.645290581,1592,530,139,46,46,0,7,0,0.043478261,0,empty,CD-0722-4
"D7,B3",7878,9006,5893,3113,4653,2382,0,2388,1647,741,2.222672065,1356,1254,252,126,125,1,44,1,0.032,0,empty,CD-0722-4
"D7,B4",6709,7432,4923,2509,3850,2001,0,2004,1227,777,1.579150579,1115,1333,203,84,81,3,34,2,0,0,empty,CD-0722-4
"D7,B5",9204,6142,3889,2253,3817,1991,10,2010,1355,655,2.06870229,1246,1056,202,76,75,1,22,1,0.133333333,0,empty,CD-0722-4
"D7,B6",7637,8457,5505,2952,4381,2321,6,2329,1439,890,1.616853933,1366,1728,355,145,144,1,40,1,0.034722222,0,empty,CD-0722-4
"D7,B7",16477,19018,12245,6773,9537,5156,0,5162,3400,1762,1.929625426,2998,1481,338,107,104,3,30,1,0.201923077,0,empty,CD-0722-4
"D7,B8",5445,6015,4042,1973,3172,1535,2,1537,1030,507,2.031558185,875,1415,296,111,107,4,35,2,0.046728972,0,empty,CD-0722-4
"D7,B9",958314,1067780,730230,337550,510759,252210,4,252456,193041,59415,3.249028023,143141,52218,6466,2673,2610,63,500,3,0.035632184,0,hg38,CD-0722-4
"D7,B10",5143,5663,3773,1890,3036,1485,3,1489,929,560,1.658928571,825,532,51,32,32,0,17,0,0.03125,0,empty,CD-0722-4
"D7,B11",1035363,1173277,757881,415396,567940,315719,2,315976,249914,66062,3.78302201,185103,7012,886,372,369,3,93,2,0.092140921,0,hg38,CD-0722-4
"D7,B12",6210,6859,4579,2280,3607,1793,0,1795,1175,620,1.89516129,1032,1736,414,130,128,2,40,2,0.078125,0,empty,CD-0722-4
"D7,C1",13611,14366,10424,3942,7404,3412,1,3418,2196,1222,1.79705401,1794,975,131,72,72,0,27,0,0,0,empty,CD-0722-4
"D7,C2",10792,11910,7977,3933,6036,2994,37,3032,1941,1091,1.779101742,1719,1876,582,197,196,1,65,1,0.066326531,0,empty,CD-0722-4
"D7,C3",10872,11954,8233,3721,6282,3112,0,3114,1973,1141,1.729184926,1722,870,189,66,66,0,16,0,0.166666667,0,empty,CD-0722-4
"D7,C4",6794,7405,5072,2333,3830,1814,1,1820,1142,678,1.684365782,1030,1803,589,248,248,0,54,0,0.008064516,0,empty,CD-0722-4
"D7,C5",10411,11422,7695,3727,5874,2884,1,2889,1893,996,1.90060241,1611,1522,268,126,126,0,36,0,0,0,empty,CD-0722-4
"D7,C6",8135,8848,5964,2884,4667,2307,0,2309,1504,805,1.868322981,1298,1479,575,186,186,0,52,0,0.005376344,0,empty,CD-0722-4
"D7,C7",11276,12613,8175,4438,6511,3558,0,3570,2114,1456,1.451923077,2055,338,118,48,48,0,8,0,0,0,empty,CD-0722-4
"D7,C8",15220,16508,11582,4926,8479,4095,0,4100,2739,1361,2.012490816,2243,3795,959,414,410,4,94,2,0.090243902,0,empty,CD-0722-4
"D7,C9",8354,9464,6124,3340,4982,2481,13,2495,1623,872,1.861238532,1509,1587,246,108,108,0,34,0,0.185185185,0,empty,CD-0722-4
"D7,C10",9953,10500,7556,2944,5435,2497,0,2501,1635,866,1.887990762,1352,1780,418,132,128,4,43,2,0.1328125,0,empty,CD-0722-4
"D7,C11",8377,9325,6295,3030,4950,2431,0,2434,1572,862,1.823665893,1400,1765,460,222,217,5,61,2,0.023041475,0,empty,CD-0722-4
"D7,C12",11781,12882,8837,4045,6826,3249,0,3251,2159,1092,1.977106227,1807,2415,795,311,305,6,77,1,0.026229508,0,empty,CD-0722-4
"D7,D1",10330,11440,7538,3902,5968,3092,0,3094,1907,1187,1.606571188,1811,733,194,85,84,1,19,1,0.095238095,0,empty,CD-0722-4
"D7,D2",9810,10676,7573,3103,5556,2605,0,2606,1677,929,1.805166846,1440,2899,869,356,354,2,85,1,0.04519774,0,empty,CD-0722-4
"D7,D3",7561,8343,5563,2780,4346,2172,1,2175,1445,730,1.979452055,1227,1631,320,162,157,5,43,2,0.025477707,0,empty,CD-0722-4
"D7,D4",695813,791840,530131,261709,387524,194764,1,194964,148616,46348,3.206524553,113696,116056,10055,3943,3780,163,725,10,0.05978836,0,hg38,CD-0722-4
"D7,D5",1321661,1555981,942646,613335,763824,468341,17,468693,353975,114718,3.08560993,277340,60195,15038,5102,5050,52,937,4,0.094653465,0,hg38,CD-0722-4
"D7,D6",11011,12493,7923,4570,6260,3301,1,3309,1929,1380,1.397826087,1960,1171,190,82,82,0,36,0,0.06097561,0,empty,CD-0722-4
"D7,D7",6040,6594,4515,2079,3408,1584,0,1584,1034,550,1.88,889,1648,296,121,117,4,33,2,0.145299145,0,empty,CD-0722-4
"D7,D8",7006,7759,5138,2621,3892,1861,1,1864,1173,691,1.697539797,1066,1147,251,94,93,1,27,1,0.010752688,0,empty,CD-0722-4
"D7,D9",3711,4057,2739,1318,2144,1031,0,1032,672,360,1.866666667,601,1402,400,130,130,0,45,0,0.053846154,0,empty,CD-0722-4
"D7,D10",8124,8897,5891,3006,4721,2311,12,2323,1531,792,1.933080808,1340,1426,144,45,45,0,20,0,0,0,empty,CD-0722-4
"D7,D11",161878,201793,111636,90157,105814,68387,29,68468,34793,33675,1.033199703,44526,3032,747,278,273,5,85,2,0.161172161,0,empty,CD-0722-4
"D7,D12",14807,17211,10628,6583,8815,4888,0,4892,3321,1571,2.113940165,2938,4247,1315,513,511,2,125,1,0.017612524,0,empty,CD-0722-4
"D7,E1",13181,14204,9849,4355,7506,3670,2,3674,2366,1308,1.808868502,2034,2687,411,216,212,4,78,2,0.023584906,0,empty,CD-0722-4
"D7,E2",9332,10118,6838,3280,5159,2577,7,2586,1629,957,1.702194357,1453,2084,408,170,166,4,50,2,0.144578313,0,empty,CD-0722-4
"D7,E3",6082,6696,4607,2089,3580,1731,0,1732,1161,571,2.033274956,959,2322,605,233,231,2,67,1,0.008658009,0,empty,CD-0722-4
"D7,E4",8534,9420,6270,3150,4862,2400,3,2407,1546,861,1.795586527,1399,2420,365,182,181,1,59,1,0.049723757,0,empty,CD-0722-4
"D7,E5",7765,8256,5861,2395,4307,1946,1,1951,1259,692,1.819364162,1046,1872,662,219,218,1,49,1,0.036697248,0,empty,CD-0722-4
"D7,E6",13011,14395,9804,4591,7432,3686,0,3689,2387,1302,1.833333333,2100,3259,747,303,299,4,88,2,0.053511706,0,empty,CD-0722-4
"D7,E7",11967,13035,8937,4098,6664,3168,17,3193,2027,1166,1.738421955,1784,2651,652,286,283,3,71,1,0.173144876,0,empty,CD-0722-4
"D7,E8",10377,11130,8006,3124,5754,2596,17,2616,1699,917,1.852780807,1431,2485,540,219,218,1,65,1,0.013761468,0,empty,CD-0722-4
"D7,E9",5658,6285,4047,2238,3310,1693,0,1701,1128,573,1.968586387,1002,1824,467,162,162,0,42,0,0.098765432,0,empty,CD-0722-4
"D7,E10",7598,8077,5705,2372,4318,2005,0,2009,1321,688,1.92005814,1085,1561,239,92,90,2,37,1,0.166666667,0,empty,CD-0722-4
"D7,E11",8332,9129,6168,2961,4852,2423,1,2427,1513,914,1.65536105,1330,1680,401,133,130,3,37,2,0.2,0,empty,CD-0722-4
"D7,E12",8934,9964,6648,3316,5297,2693,1,2694,1719,975,1.763076923,1567,1672,452,158,156,2,45,1,0.064102564,0,empty,CD-0722-4
"D7,F1",15501,16704,11698,5006,8487,4033,0,4037,2646,1391,1.902228613,2236,5933,1141,435,432,3,107,1,0.041666667,0,empty,CD-0722-4
"D7,F2",8267,8929,6052,2877,4706,2363,0,2366,1496,870,1.71954023,1338,2543,529,244,244,0,73,0,0.020491803,0,empty,CD-0722-4
"D7,F3",1488766,1755705,1110438,645267,842528,471070,35,471530,381599,89931,4.243242041,281329,265294,34166,13261,12998,263,2015,6,0.052854285,0,hg38,CD-0722-4
"D7,F4",13019,13796,9802,3994,7396,3479,10,3491,2253,1238,1.819870759,1911,860,220,87,87,0,27,0,0.206896552,0,empty,CD-0722-4
"D7,F5",12176,13161,9153,4008,6705,3136,4,3145,2085,1060,1.966981132,1744,2147,428,179,175,4,56,2,0.051428571,0,empty,CD-0722-4
"D7,F6",848334,973627,631712,341915,472775,252981,1,253171,193744,59427,3.260201592,148560,140422,11314,4324,4135,189,914,9,0.02974607,0,hg38,CD-0722-4
"D7,F7",11695,13004,8711,4293,6691,3271,0,3275,2203,1072,2.055037313,1843,1490,320,110,109,1,38,1,0.055045872,0,empty,CD-0722-4
"D7,F8",7992,8558,6021,2537,4505,2195,0,2203,1430,773,1.849935317,1227,400,29,15,14,1,12,1,0.214285714,0,empty,CD-0722-4
"D7,F9",8420,9120,6426,2694,4719,2240,5,2247,1490,757,1.968295905,1213,2416,524,247,247,0,71,0,0.072874494,0,empty,CD-0722-4
"D7,F10",11555,12350,8764,3586,6553,3099,0,3105,2036,1069,1.904583723,1722,1554,289,117,115,2,38,1,0.017391304,0,empty,CD-0722-4
"D7,F11",643603,710602,492660,217942,347145,167838,1,168006,132104,35902,3.679572169,94220,102911,14497,5701,5590,111,970,8,0.059570662,0,hg38,CD-0722-4
"D7,F12",9647,10564,7233,3331,5447,2672,0,2677,1736,941,1.844845909,1487,327,64,34,34,0,13,0,0.058823529,0,empty,CD-0722-4
"D7,G1",1479343,1778379,1008331,770048,875689,586470,3,586910,449080,137830,3.258216644,353162,9493,1151,409,395,14,104,2,0.098734177,0,hg38,CD-0722-4
"D7,G2",6054,6883,4171,2712,3436,1817,1,1818,1163,655,1.775572519,1131,446,147,55,55,0,18,0,0.036363636,0,empty,CD-0722-4
"D7,G3",11944,12492,8683,3809,6431,3159,2,3165,1934,1231,1.571080422,1702,1967,561,230,229,1,56,1,0.113537118,0,empty,CD-0722-4
"D7,G4",19688,22088,14180,7908,11399,6187,0,6192,3681,2511,1.465949821,3617,50,7,6,6,0,5,0,0,0,empty,CD-0722-4
"D7,G5",6835,7367,5047,2320,3859,1907,0,1907,1198,709,1.689703808,1061,1791,391,132,130,2,37,1,0.192307692,0,empty,CD-0722-4
"D7,G6",976446,1078635,742613,336022,520202,263807,2,264061,206820,57241,3.613144424,146520,11934,1786,711,696,15,154,3,0.00862069,0,hg38,CD-0722-4
"D7,G7",973724,1111477,732475,379002,541241,285001,10,285220,232057,53163,4.365009499,164185,268600,38291,14802,14492,310,2119,6,0.061413193,0,hg38,CD-0722-4
"D7,G8",5807,6196,4230,1966,3323,1594,1,1597,986,611,1.613747954,930,1690,309,110,109,1,43,1,0,0,empty,CD-0722-4
"D7,G9",1418728,1660466,1048199,612267,800333,441785,1,442136,347148,94988,3.654651114,264532,238549,34701,13612,13362,250,2074,8,0.054931896,0,hg38,CD-0722-4
"D7,G10",8843,10119,6458,3661,5193,2631,0,2633,1702,931,1.828141783,1567,1937,535,205,197,8,63,2,0.020304569,0,empty,CD-0722-4
"D7,G11",898865,976348,697374,278974,471517,218462,3,218702,163348,55354,2.95097012,119726,68431,10397,4044,3990,54,724,2,0.056641604,0,hg38,CD-0722-4
"D7,G12",6810,7605,5039,2566,4006,2036,0,2036,1276,760,1.678947368,1142,2125,784,277,276,1,60,1,0.119565217,0,empty,CD-0722-4
"D7,H1",7001,7715,5148,2567,4022,1924,0,1929,1245,684,1.820175439,1130,1412,375,156,151,5,30,2,0.152317881,0,empty,CD-0722-4
"D7,H2",969130,1088083,730145,357938,528362,273596,2,273854,225167,48687,4.624786904,157880,61657,12968,4574,4500,74,802,5,0.014666667,0,hg38,CD-0722-4
"D7,H3",844981,965898,629989,335909,469957,249094,7,249313,196727,52586,3.741052752,147285,82688,11145,4311,4237,74,819,4,0.043898985,0,hg38,CD-0722-4
"D7,H4",10602,11542,7840,3702,5860,2919,0,2919,1891,1028,1.839494163,1670,160,30,19,19,0,8,0,0.157894737,0,empty,CD-0722-4
"D7,H5",11262,12345,8345,4000,6292,3147,1,3149,2020,1129,1.789193977,1780,2475,721,283,276,7,57,2,0.072463768,0,empty,CD-0722-4
"D7,H6",6568,7282,4753,2529,3724,1897,1,1901,1256,645,1.947286822,1106,1858,433,163,162,1,48,1,0.080246914,0,empty,CD-0722-4
"D7,H7",7550,8136,5598,2538,4246,2040,25,2067,1370,697,1.965566714,1165,1722,456,172,172,0,45,0,0.093023256,0,empty,CD-0722-4
"D7,H8",8942,9732,6624,3108,5003,2446,22,2469,1633,836,1.953349282,1349,2970,488,220,218,2,77,1,0.082568807,0,empty,CD-0722-4
"D7,H9",7933,8565,5886,2679,4331,2099,0,2099,1472,627,2.3476874,1172,800,168,84,83,1,22,1,0.108433735,0,empty,CD-0722-4
"D7,H10",6014,6595,4426,2169,3423,1700,0,1702,1138,564,2.017730496,962,1134,252,99,99,0,35,0,0.04040404,0,empty,CD-0722-4
"D7,H11",7646,8759,5408,3351,4377,2497,29,2526,1415,1111,1.273627363,1480,23,9,5,5,0,3,0,0,0,empty,CD-0722-4
"D7,H12",6501,7130,4730,2400,3693,1863,8,1871,1253,618,2.027508091,1094,1859,339,152,150,2,39,2,0,0,empty,CD-0722-4
"D8,A1",6007,6773,4461,2312,3634,1912,0,1912,1226,686,1.787172012,1114,1218,195,64,63,1,23,1,0.015873016,0,empty,CD-0722-4
"D8,A2",1920265,2165995,1453372,712623,1021445,542209,3,542753,463410,79343,5.840590852,309249,23843,2462,783,762,21,236,4,0.082677165,0,hg38,CD-0722-4
"D8,A3",5743,6038,4286,1752,3120,1456,0,1457,939,518,1.812741313,795,1670,238,94,88,6,33,2,0.170454545,0,empty,CD-0722-4
"D8,A4",10825,12122,8020,4102,6117,3073,11,3092,1946,1146,1.698080279,1746,908,177,72,72,0,22,0,0.083333333,0,empty,CD-0722-4
"D8,A5",8616,9444,6475,2969,4920,2353,1,2365,1525,840,1.81547619,1376,2460,507,226,223,3,64,1,0.179372197,0,empty,CD-0722-4
"D8,A6",501211,574162,386183,187979,283612,141684,1,141843,105916,35927,2.948089181,81240,131112,16242,6503,6335,168,1003,6,0.046093133,0,hg38,CD-0722-4
"D8,A7",5975,6555,4384,2171,3374,1660,25,1686,1054,632,1.667721519,941,1594,287,111,111,0,31,0,0.081081081,0,empty,CD-0722-4
"D8,A8",3766,4164,2868,1296,2153,1020,0,1020,681,339,2.008849558,552,1929,542,193,190,3,45,2,0.205263158,0,empty,CD-0722-4
"D8,A9",648511,731428,487255,244173,359517,186750,3,186930,150130,36800,4.079619565,106802,138048,19704,7569,7419,150,1284,5,0.021161882,0,hg38,CD-0722-4
"D8,A10",6928,7497,5181,2316,3875,1846,3,1852,1169,683,1.711566618,1025,483,158,61,61,0,17,0,0,0,empty,CD-0722-4
"D8,A11",5518,5888,4099,1789,3165,1449,1,1460,973,487,1.997946612,831,1607,379,150,148,2,40,1,0.101351351,0,empty,CD-0722-4
"D8,A12",8250,8977,6185,2792,4723,2231,0,2239,1524,715,2.131468531,1278,4409,1060,443,441,2,106,1,0.031746032,0,empty,CD-0722-4
"D8,B1",7036,7789,5273,2516,3931,1939,18,1959,1227,732,1.676229508,1114,1557,392,151,150,1,34,1,0.013333333,0,empty,CD-0722-4
"D8,B2",7778,8443,5227,3216,4462,2441,0,2447,1559,888,1.755630631,1464,474,33,12,12,0,7,0,0.083333333,0,empty,CD-0722-4
"D8,B3",5289,5978,3896,2082,3128,1561,0,1561,1028,533,1.928705441,897,2121,576,195,192,3,45,1,0.041666667,0,empty,CD-0722-4
"D8,B4",7576,8468,5562,2906,4360,2261,9,2274,1519,755,2.01192053,1314,1528,282,106,104,2,28,2,0.173076923,0,empty,CD-0722-4
"D8,B5",8532,6449,4038,2411,3831,1965,14,1987,1348,639,2.109546166,1213,1320,289,110,108,2,29,2,0.055555556,0,empty,CD-0722-4
"D8,B6",7286,7883,5270,2613,4107,2076,0,2079,1294,785,1.648407643,1198,1798,432,197,195,2,48,1,0.087179487,0,empty,CD-0722-4
"D8,B7",7265,7989,5517,2472,4245,2060,6,2072,1312,760,1.726315789,1147,1666,334,120,116,4,29,2,0,0,empty,CD-0722-4
"D8,B8",1398785,1736039,952446,783593,860410,580293,13,580702,374886,205816,1.821461888,360180,35071,5033,1734,1690,44,403,3,0.104733728,0,hg38,CD-0722-4
"D8,B9",9697,10825,7115,3710,5656,2932,0,2934,1847,1087,1.699172033,1701,1172,275,104,104,0,34,0,0.009615385,0,empty,CD-0722-4
"D8,B10",607713,654805,434700,220105,342500,175068,7,175465,131112,44353,2.95610218,102564,60239,6850,2545,2482,63,482,3,0.108380338,0,hg38,CD-0722-4
"D8,B11",1752353,1979107,1314130,664977,934274,496943,3,497442,393424,104018,3.782268454,286610,19744,2140,807,783,24,187,3,0.04853129,0,hg38,CD-0722-4
"D8,B12",5917,6384,4483,1901,3381,1604,0,1606,1092,514,2.124513619,905,1681,440,173,171,2,48,1,0.099415205,0,empty,CD-0722-4
"D8,C1",13027,14053,9854,4199,7252,3448,3,3455,2262,1193,1.896060352,1913,1684,378,176,176,0,40,0,0.079545455,0,empty,CD-0722-4
"D8,C2",9959,10784,7392,3392,5585,2872,0,2876,1816,1060,1.713207547,1572,2289,562,210,206,4,60,1,0.014563107,0,empty,CD-0722-4
"D8,C3",889192,1106353,627154,479199,544091,336079,1,336314,260891,75423,3.459037694,212518,10484,3829,1522,1521,1,329,1,0.051282051,0,hg38,CD-0722-4
"D8,C4",731425,830343,552743,277600,406058,208843,3,209025,164010,45015,3.643452183,121091,134722,19710,7695,7545,150,1180,4,0.05805169,0,hg38,CD-0722-4
"D8,C5",9534,10173,7013,3160,5243,2554,0,2559,1691,868,1.948156682,1381,1714,394,140,140,0,47,0,0.035714286,0,empty,CD-0722-4
"D8,C6",7498,8281,5378,2903,4448,2205,9,2220,1462,758,1.928759894,1291,1810,455,211,211,0,49,0,0.047393365,0,empty,CD-0722-4
"D8,C7",10347,12209,7342,4867,6173,3480,0,3483,2142,1341,1.597315436,2102,536,129,57,57,0,19,0,0.01754386,0,empty,CD-0722-4
"D8,C8",11378,12343,8343,4000,6426,3225,0,3228,2079,1149,1.809399478,1842,3394,648,307,303,4,92,1,0.066006601,0,empty,CD-0722-4
"D8,C9",8144,8972,6116,2856,4645,2316,0,2316,1550,766,2.023498695,1309,1853,314,129,128,1,39,1,0.0078125,0,empty,CD-0722-4
"D8,C10",910269,1022127,686140,335987,493548,258213,0,258477,196745,61732,3.187082874,146098,83251,12581,4892,4820,72,881,3,0.064315353,0,hg38,CD-0722-4
"D8,C11",757753,860950,564646,296304,421645,222646,0,222861,174822,48039,3.639168176,130903,45689,6986,2690,2659,31,544,2,0.045505829,0,hg38,CD-0722-4
"D8,C12",15798,17742,11413,6329,9020,4604,0,4607,3038,1569,1.936265137,2711,2738,850,305,305,0,61,0,0.104918033,0,empty,CD-0722-4
"D8,D1",11996,13728,8690,5038,6978,3633,0,3633,2202,1431,1.538784067,2174,1528,275,76,75,1,22,1,0.013333333,0,empty,CD-0722-4
"D8,D2",8753,9440,6626,2814,4862,2225,0,2227,1366,861,1.586527294,1196,2831,792,301,299,2,83,2,0.030100334,0,empty,CD-0722-4
"D8,D3",7127,7861,5064,2797,4131,2105,0,2106,1318,788,1.672588832,1226,1843,541,191,191,0,44,0,0,0,empty,CD-0722-4
"D8,D4",6748,7456,5069,2387,3861,1911,0,1912,1338,574,2.331010453,1040,1330,300,151,148,3,47,2,0.040540541,0,empty,CD-0722-4
"D8,D5",6039,6573,4428,2145,3457,1663,0,1667,1045,622,1.680064309,954,1530,439,199,198,1,32,1,0.121212121,0,empty,CD-0722-4
"D8,D6",9548,10647,6968,3679,5557,2940,3,2948,1783,1165,1.530472103,1685,2104,552,212,212,0,48,0,0.141509434,0,empty,CD-0722-4
"D8,D7",5517,5847,4104,1743,2962,1310,0,1310,842,468,1.799145299,716,2697,639,234,233,1,71,1,0.042918455,0,empty,CD-0722-4
"D8,D8",591640,643302,458765,184537,317488,148931,1,149098,112490,36608,3.072825612,82882,22203,6126,2262,2243,19,402,2,0.019170753,0,hg38,CD-0722-4
"D8,D9",3955,4432,2948,1484,2341,1133,0,1133,771,362,2.129834254,649,1525,310,142,141,1,40,1,0.035460993,0,empty,CD-0722-4
"D8,D10",6743,7470,4944,2526,3895,2044,0,2046,1234,812,1.519704433,1192,1012,219,87,85,2,27,2,0.035294118,0,empty,CD-0722-4
"D8,D11",779270,899560,578596,320964,438475,237389,2,237592,196567,41025,4.791395491,139149,162959,26929,10128,9952,176,1714,5,0.041901125,0,hg38,CD-0722-4
"D8,D12",9821,10957,7270,3687,5737,2865,7,2872,1871,1001,1.869130869,1654,3576,864,388,384,4,106,1,0.013020833,0,empty,CD-0722-4
"D8,E1",11634,12721,8688,4033,6582,3258,0,3260,2089,1171,1.783945346,1828,3002,848,333,330,3,80,1,0.081818182,0,empty,CD-0722-4
"D8,E2",8313,8970,6055,2915,4775,2382,0,2394,1469,925,1.588108108,1377,1654,232,109,107,2,39,1,0.037383178,0,empty,CD-0722-4
"D8,E3",6051,6592,4597,1995,3393,1605,1,1608,1044,564,1.85106383,905,2937,770,313,312,1,83,1,0.076923077,0,empty,CD-0722-4
"D8,E4",8053,8609,6030,2579,4566,2196,0,2196,1438,758,1.897097625,1204,2325,521,225,224,1,73,1,0.1875,0,empty,CD-0722-4
"D8,E5",7525,8106,5748,2358,4280,1925,0,1926,1305,621,2.101449275,1087,2625,599,206,203,3,53,1,0.044334975,0,empty,CD-0722-4
"D8,E6",16898,18432,12412,6020,9348,4661,7,4673,3246,1427,2.274702172,2605,3992,857,334,332,2,104,1,0.03313253,0,empty,CD-0722-4
"D8,E7",884983,1085149,619455,465694,534576,351754,3,352014,264356,87658,3.015765817,212554,10523,1544,531,520,11,141,3,0.096153846,0,hg38,CD-0722-4
"D8,E8",11586,12291,8793,3498,6348,2933,0,2938,1987,951,2.0893796,1583,3436,797,332,331,1,84,1,0.111782477,0,empty,CD-0722-4
"D8,E9",5642,6374,4118,2256,3263,1643,0,1645,1091,554,1.969314079,988,2640,574,253,250,3,56,1,0.136,0,empty,CD-0722-4
"D8,E10",6791,7334,5039,2295,3826,1809,1,1812,1185,627,1.889952153,1029,3241,493,221,215,6,56,2,0.093023256,0,empty,CD-0722-4
"D8,E11",7900,8446,5919,2527,4499,2199,0,2201,1403,798,1.758145363,1219,2741,581,212,210,2,65,1,0.052380952,0,empty,CD-0722-4
"D8,E12",8313,9311,6089,3222,4852,2437,0,2440,1561,879,1.775881684,1422,2205,421,158,158,0,51,0,0.151898734,0,empty,CD-0722-4
"D8,F1",1027756,1232969,722813,510156,600924,381976,0,382264,270923,111341,2.433272559,230668,14477,1785,678,656,22,105,2,0.394817073,0,hg38,CD-0722-4
"D8,F2",8670,9461,6301,3160,4887,2347,6,2360,1564,796,1.964824121,1359,3395,724,296,292,4,75,2,0.051369863,0,empty,CD-0722-4
"D8,F3",7668,8331,5741,2590,4393,2098,0,2098,1356,742,1.827493261,1201,3124,610,251,250,1,62,1,0.148,0,empty,CD-0722-4
"D8,F4",11689,12768,8673,4095,6695,3108,0,3109,1952,1157,1.687121867,1783,937,120,65,64,1,29,1,0.0625,0,empty,CD-0722-4
"D8,F5",9481,10086,7110,2976,5275,2407,23,2434,1577,857,1.840140023,1362,2709,577,249,247,2,65,1,0.036437247,0,empty,CD-0722-4
"D8,F6",9139,10120,6752,3368,5309,2715,1,2718,1756,962,1.825363825,1542,3561,1000,378,371,7,107,1,0.07277628,0,empty,CD-0722-4
"D8,F7",10187,11182,7706,3476,5897,2858,20,2883,1930,953,2.025183631,1599,1181,241,97,93,4,35,1,0.11827957,0,empty,CD-0722-4
"D8,F8",9646,10566,7247,3319,5590,2739,0,2741,1948,793,2.456494325,1588,405,66,43,43,0,14,0,0,0,empty,CD-0722-4
"D8,F9",8427,9249,6325,2924,4803,2275,22,2298,1547,751,2.059920107,1309,3560,829,341,338,3,80,1,0.071005917,0,empty,CD-0722-4
"D8,F10",11184,11763,8627,3136,6076,2733,42,2780,1755,1025,1.712195122,1446,2561,597,207,205,2,50,1,0.024390244,0,empty,CD-0722-4
"D8,F11",7395,8030,5613,2417,4190,1894,5,1899,1247,652,1.912576687,1071,1624,280,109,107,2,28,2,0.065420561,0,empty,CD-0722-4
"D8,F12",9040,9730,6644,3086,5025,2386,3,2395,1582,813,1.945879459,1372,239,57,31,31,0,12,0,0,0,empty,CD-0722-4
"D8,G1",1675858,1896392,1265246,631146,912038,477365,5,477862,369550,108312,3.411902652,273952,253541,49738,18885,18633,252,2409,8,0.044651962,0,hg38,CD-0722-4
"D8,G2",9905,10816,6898,3918,5624,3135,23,3160,1938,1222,1.585924714,1770,604,166,77,76,1,16,1,0.065789474,0,empty,CD-0722-4
"D8,G3",10542,11201,7740,3461,5876,2944,1,2949,1843,1106,1.66636528,1582,2186,555,211,211,0,62,0,0.104265403,0,empty,CD-0722-4
"D8,G4",18438,20545,13108,7437,10562,5872,0,5874,3611,2263,1.595669465,3386,110,10,8,8,0,5,0,0,0,empty,CD-0722-4
"D8,G5",6215,6791,4552,2239,3580,1806,0,1809,1157,652,1.774539877,1044,1731,502,169,168,1,41,1,0.023809524,0,empty,CD-0722-4
"D8,G6",9456,9960,7221,2739,5222,2398,0,2398,1563,835,1.871856287,1238,173,44,23,23,0,8,0,0.130434783,0,empty,CD-0722-4
"D8,G7",896061,1030544,668108,362436,504073,269634,0,269869,219972,49897,4.408521554,157195,299774,43539,17077,16684,393,2302,7,0.047950132,0,hg38,CD-0722-4
"D8,G8",668335,745581,495448,250133,364274,191787,0,191997,158985,33012,4.815976009,111037,163355,33011,11265,11101,164,1670,8,0.032789839,0,hg38,CD-0722-4
"D8,G9",11361,12636,8148,4488,6523,3657,0,3660,2497,1163,2.147033534,2087,2932,573,219,217,2,75,2,0.041474654,0,empty,CD-0722-4
"D8,G10",8544,9043,6283,2760,4980,2496,6,2508,1676,832,2.014423077,1384,2246,520,195,190,5,60,1,0.036842105,0,empty,CD-0722-4
"D8,G11",757144,859214,564021,295193,422647,233104,2,233330,182271,51059,3.569811395,133620,28024,9014,3226,3202,24,619,3,0.018425984,0,hg38,CD-0722-4
"D8,G12",6671,7209,4954,2255,3774,1868,0,1872,1154,718,1.60724234,1038,2649,644,251,247,4,79,2,0.016194332,0,empty,CD-0722-4
"D8,H1",6590,7153,4802,2351,3799,1792,5,1800,1165,635,1.834645669,1027,1679,275,126,124,2,47,1,0.040322581,0,empty,CD-0722-4
"D8,H2",8786,9732,6438,3294,5169,2589,1,2590,1716,874,1.963386728,1521,2923,727,279,272,7,62,2,0.113970588,0,empty,CD-0722-4
"D8,H3",6582,7187,4773,2414,3810,1963,0,1964,1236,728,1.697802198,1144,1723,382,155,152,3,59,2,0.092105263,0,empty,CD-0722-4
"D8,H4",922052,1073192,680034,393158,515734,281272,26,281533,226572,54961,4.122414075,167819,6733,1242,497,493,4,119,2,0.044624746,0,hg38,CD-0722-4
"D8,H5",29503,32979,20932,12047,16056,9146,0,9153,6073,3080,1.971753247,5171,2232,633,228,225,3,57,3,0.111111111,0,empty,CD-0722-4
"D8,H6",6609,7489,4900,2589,3799,1930,0,1930,1242,688,1.805232558,1087,2357,388,175,174,1,64,1,0.028735632,0,empty,CD-0722-4
"D8,H7",7214,7934,5353,2581,4175,2058,1,2065,1341,724,1.852209945,1153,2242,609,195,193,2,49,1,0.082901554,0,empty,CD-0722-4
"D8,H8",8936,9992,6462,3530,5278,2697,12,2709,1782,927,1.922330097,1626,3333,847,339,336,3,91,2,0.041666667,0,empty,CD-0722-4
"D8,H9",21047,23991,16459,7532,11879,5741,0,5743,4270,1473,2.898845893,3220,2199,416,160,156,4,47,2,0.173076923,0,empty,CD-0722-4
"D8,H10",8031,8925,6037,2888,4392,2166,16,2183,1498,685,2.186861314,1213,2134,388,153,153,0,44,0,0.045751634,0,empty,CD-0722-4
"D8,H11",7191,8126,5066,3060,4191,2515,0,2519,1391,1128,1.233156028,1487,46,3,0,0,0,0,0,0,0,empty,CD-0722-4
"D8,H12",5748,6239,4230,2009,3240,1673,0,1673,1131,542,2.086715867,954,1350,445,179,179,0,44,0,0.106145251,0,empty,CD-0722-4
"D9,A1",5925,6609,4373,2236,3489,1765,0,1765,1157,608,1.902960526,1053,919,244,106,106,0,23,0,0.188679245,0,empty,CD-0722-4
"D9,A2",8805,9594,6565,3029,4959,2500,0,2506,1565,941,1.663124336,1351,2101,614,229,225,4,53,1,0.008888889,0,empty,CD-0722-4
"D9,A3",5857,6434,4294,2140,3362,1669,2,1671,1099,572,1.921328671,949,1103,154,80,79,1,28,1,0.025316456,0,empty,CD-0722-4
"D9,A4",10643,11398,8150,3248,5844,2820,0,2825,1860,965,1.92746114,1503,572,109,57,53,4,17,1,0.113207547,0,empty,CD-0722-4
"D9,A5",8635,9471,6429,3042,4945,2408,0,2410,1601,809,1.978986403,1351,2498,576,242,240,2,61,1,0.0625,0,empty,CD-0722-4
"D9,A6",6997,7760,5249,2511,4085,2098,0,2098,1411,687,2.053857351,1142,2790,660,328,326,2,97,2,0.033742331,0,empty,CD-0722-4
"D9,A7",6043,6696,4405,2291,3457,1763,0,1765,1111,654,1.698776758,1016,1301,228,104,101,3,29,1,0.138613861,0,empty,CD-0722-4
"D9,A8",3992,4342,2995,1347,2259,1097,0,1097,756,341,2.217008798,592,2002,286,123,122,1,50,1,0.06557377,0,empty,CD-0722-4
"D9,A9",6596,7426,5009,2417,3840,1816,10,1827,1169,658,1.776595745,1063,1799,431,176,172,4,47,1,0.11627907,0,empty,CD-0722-4
"D9,A10",6391,6906,4837,2069,3633,1749,0,1749,1105,644,1.715838509,959,541,192,84,84,0,21,0,0.154761905,0,empty,CD-0722-4
"D9,A11",712999,791345,537598,253747,385091,193797,2,193978,154102,39876,3.864530043,109652,76610,16093,6169,6084,85,1024,4,0.043063774,0,hg38,CD-0722-4
"D9,A12",7612,8059,5806,2253,4214,1961,0,1967,1312,655,2.003053435,1017,3363,865,342,340,2,82,2,0.029411765,0,empty,CD-0722-4
"D9,B1",6967,7623,5162,2461,4028,2029,0,2031,1351,680,1.986764706,1167,1229,328,137,136,1,41,1,0.058823529,0,empty,CD-0722-4
"D9,B2",7526,7926,5206,2720,4142,2154,0,2156,1330,826,1.610169492,1212,615,116,48,47,1,12,1,0.106382979,0,empty,CD-0722-4
"D9,B3",5408,5877,3992,1885,3124,1541,3,1546,991,555,1.785585586,882,1372,319,115,115,0,34,0,0.043478261,0,empty,CD-0722-4
"D9,B4",5902,6605,4281,2324,3521,1846,0,1846,1121,725,1.546206897,1099,1252,301,136,135,1,37,1,0.2,0,empty,CD-0722-4
"D9,B5",12765,11043,6763,4280,6238,3473,0,3482,2578,904,2.851769912,2149,1149,212,86,85,1,22,1,0,0,empty,CD-0722-4
"D9,B6",7218,7928,5301,2627,4167,2208,0,2208,1373,835,1.644311377,1274,1723,484,194,192,2,54,1,0.010416667,0,empty,CD-0722-4
"D9,B7",7338,7831,5566,2265,4187,2023,12,2035,1300,735,1.768707483,1116,1694,512,195,192,3,36,2,0.015625,0,empty,CD-0722-4
"D9,B8",5210,5595,3939,1656,2837,1283,36,1321,869,452,1.922566372,714,1227,310,123,122,1,34,1,0.008196721,0,empty,CD-0722-4
"D9,B9",464962,491655,365409,126246,240813,102487,18,102618,77211,25407,3.038965639,55139,9883,1765,642,636,6,147,2,0.055031447,0,hg38,CD-0722-4
"D9,B10",4940,5014,3680,1334,2786,1302,10,1313,854,459,1.860566449,662,584,80,47,47,0,17,0,0,0,empty,CD-0722-4
"D9,B11",13208,14786,9401,5385,7542,4205,18,4225,2633,1592,1.653894472,2421,145,21,13,13,0,8,0,0,0,empty,CD-0722-4
"D9,B12",1396012,1602915,1030153,572762,781019,424722,2,425080,344254,80826,4.259198773,252005,201959,34641,13190,12959,231,1932,9,0.038274558,0,hg38,CD-0722-4
"D9,C1",30675,31393,24430,6963,15515,6069,0,6082,3915,2167,1.806645132,3208,1235,364,128,128,0,32,0,0.1484375,0,empty,CD-0722-4
"D9,C2",10459,11276,7365,3911,5890,3047,0,3047,1994,1053,1.893637227,1742,2471,664,328,324,4,80,2,0.024691358,0,empty,CD-0722-4
"D9,C3",11477,12695,8592,4103,6648,3274,1,3281,2074,1207,1.718309859,1841,991,123,69,69,0,25,0,0.231884058,0,empty,CD-0722-4
"D9,C4",6465,6899,4841,2058,3584,1691,1,1692,1112,580,1.917241379,923,1779,395,149,147,2,47,1,0.013605442,0,empty,CD-0722-4
"D9,C5",9300,10104,6772,3332,5162,2533,0,2533,1657,876,1.891552511,1427,1555,296,127,127,0,44,0,0,0,empty,CD-0722-4
"D9,C6",10188,11086,7528,3558,5772,2937,29,2966,1969,997,1.974924774,1672,1531,285,135,134,1,39,1,0.007462687,0,empty,CD-0722-4
"D9,C7",10469,12453,7468,4985,6292,3562,1,3565,2132,1433,1.487787858,2166,449,103,44,39,5,14,2,0,0,empty,CD-0722-4
"D9,C8",11236,12522,8301,4221,6396,3219,2,3226,2108,1118,1.885509839,1834,2624,752,274,270,4,76,2,0.025925926,0,empty,CD-0722-4
"D9,C9",823450,984535,589254,395281,481067,281690,2,281912,234193,47719,4.907751629,171709,79139,21062,7965,7912,53,1296,6,0.051946411,0,hg38,CD-0722-4
"D9,C10",9538,10428,7044,3384,5322,2518,16,2534,1690,844,2.002369668,1444,2093,593,236,235,1,57,1,0.076595745,0,empty,CD-0722-4
"D9,C11",8575,9302,6159,3143,4827,2390,21,2415,1503,912,1.648026316,1391,2221,753,268,267,1,60,1,0.074906367,0,empty,CD-0722-4
"D9,C12",11108,11806,8322,3484,6112,2896,0,2904,1872,1032,1.813953488,1594,2063,499,214,211,3,53,1,0.056872038,0,empty,CD-0722-4
"D9,D1",10077,11224,7241,3983,5776,2982,25,3012,1848,1164,1.587628866,1764,816,211,67,67,0,15,0,0.492537313,0,empty,CD-0722-4
"D9,D2",9059,9912,6826,3086,5071,2362,22,2384,1553,831,1.868832732,1315,3100,786,313,311,2,86,1,0.061093248,0,empty,CD-0722-4
"D9,D3",7802,8591,5797,2794,4372,2117,26,2146,1444,702,2.056980057,1175,2246,528,161,160,1,37,1,0.0375,0,empty,CD-0722-4
"D9,D4",5806,6242,4475,1767,3248,1559,0,1559,984,575,1.711304348,798,1452,269,118,116,2,29,2,0,0,empty,CD-0722-4
"D9,D5",6344,6845,4761,2084,3670,1827,4,1834,1140,694,1.642651297,988,1504,417,172,167,5,40,1,0.041916168,0,empty,CD-0722-4
"D9,D6",10230,11359,7270,4089,5782,3156,6,3165,1987,1178,1.686757216,1864,1831,459,208,205,3,55,3,0.087804878,0,empty,CD-0722-4
"D9,D7",5493,5769,4044,1725,3121,1480,0,1481,976,505,1.932673267,805,1868,461,190,189,1,56,1,0.026455026,0,empty,CD-0722-4
"D9,D8",6665,7288,4945,2343,3883,1863,2,1877,1171,706,1.658640227,1070,1190,222,107,104,3,32,1,0.115384615,0,empty,CD-0722-4
"D9,D9",3607,3756,2640,1116,2005,979,7,988,631,357,1.767507003,563,1615,418,183,182,1,44,1,0.098901099,0,empty,CD-0722-4
"D9,D10",915608,1105492,645498,459994,542713,345753,0,346032,250977,95055,2.640334543,209748,23516,10064,3701,3677,24,769,3,0.018221376,0,hg38,CD-0722-4
"D9,D11",7339,8092,5397,2695,4218,2077,1,2080,1282,798,1.606516291,1218,2806,869,306,304,2,72,1,0.029605263,0,empty,CD-0722-4
"D9,D12",10021,10945,7489,3456,5561,2775,0,2776,1826,950,1.922105263,1517,4002,916,387,383,4,100,2,0.057441253,0,empty,CD-0722-4
"D9,E1",11553,12645,8589,4056,6668,3231,11,3247,2031,1216,1.670230263,1852,3018,608,297,284,13,81,2,0.080985915,0,empty,CD-0722-4
"D9,E2",8507,9407,6263,3144,4872,2440,0,2443,1549,894,1.732662192,1348,2128,435,185,183,2,54,1,0.027322404,0,empty,CD-0722-4
"D9,E3",6021,6730,4596,2134,3488,1690,0,1692,1132,560,2.021428571,963,2141,472,227,224,3,57,2,0.098214286,0,empty,CD-0722-4
"D9,E4",8190,8831,6007,2824,4622,2319,0,2321,1465,856,1.711448598,1311,2926,610,267,265,2,81,2,0.033962264,0,empty,CD-0722-4
"D9,E5",7355,7818,5563,2255,4038,1828,0,1829,1200,629,1.907790143,989,1347,384,148,148,0,43,0,0.013513514,0,empty,CD-0722-4
"D9,E6",751642,818405,576688,241717,392679,187063,10,187243,144856,42387,3.417462901,103386,206129,19229,7748,7503,245,1312,7,0.049313608,0,hg38,CD-0722-4
"D9,E7",14458,16011,10416,5595,8429,4553,14,4572,3093,1479,2.09127789,2628,3216,689,325,323,2,93,1,0.077399381,0,empty,CD-0722-4
"D9,E8",9340,10180,7147,3033,5249,2392,0,2394,1628,766,2.125326371,1333,2879,743,277,270,7,63,3,0.025925926,0,empty,CD-0722-4
"D9,E9",5065,5493,3673,1820,2913,1445,1,1448,919,529,1.737240076,836,1831,309,151,148,3,50,1,0.081081081,0,empty,CD-0722-4
"D9,E10",7238,7437,5219,2218,3988,1845,0,1848,1245,603,2.064676617,1036,1949,363,163,161,2,40,1,0.043478261,0,empty,CD-0722-4
"D9,E11",8000,8513,5919,2594,4394,2151,1,2153,1407,746,1.886058981,1182,1809,377,140,140,0,32,0,0.092857143,0,empty,CD-0722-4
"D9,E12",760079,876286,560522,315764,432393,230886,0,231085,181345,49740,3.645858464,138122,138790,16951,6481,6338,143,1050,5,0.039602398,0,hg38,CD-0722-4
"D9,F1",10072,10752,7480,3272,5675,2765,0,2768,1730,1038,1.666666667,1597,2366,558,199,198,1,61,1,0.095959596,0,empty,CD-0722-4
"D9,F2",689721,744180,531617,212563,365607,169281,4,169456,132423,37033,3.575810763,93420,60745,9890,3639,3577,62,719,4,0.016773833,0,hg38,CD-0722-4
"D9,F3",8094,8951,5924,3027,4500,2186,14,2202,1422,780,1.823076923,1275,2584,749,313,311,2,82,2,0.080385852,0,empty,CD-0722-4
"D9,F4",1182956,1318516,895376,423140,639144,322247,10,322589,252401,70188,3.596070553,184240,66607,8827,3373,3288,85,613,4,0.071472019,0,hg38,CD-0722-4
"D9,F5",9648,10079,6996,3083,5259,2431,14,2446,1548,898,1.723830735,1382,2350,709,304,303,1,75,1,0.089108911,0,empty,CD-0722-4
"D9,F6",840140,994427,591703,402724,489522,307703,2,307922,212387,95535,2.223132883,184292,15083,1642,572,550,22,144,3,0.123636364,0,hg38,CD-0722-4
"D9,F7",1066918,1211930,797659,414271,597020,312066,40,312358,254507,57851,4.399353512,180730,100343,16310,6297,6177,120,1119,6,0.028816578,0.008333333,hg38,CD-0722-4
"D9,F8",1805732,2100178,1337904,762274,1009215,558797,9,559330,445472,113858,3.912522616,330696,39983,6480,2569,2518,51,510,4,0.065131056,0,hg38,CD-0722-4
"D9,F9",8061,9031,6051,2980,4698,2250,0,2252,1473,779,1.890885751,1319,3123,760,282,278,4,73,1,0.061151079,0,empty,CD-0722-4
"D9,F10",11304,11938,8466,3472,6129,2859,0,2862,1887,975,1.935384615,1547,2040,497,204,195,9,50,2,0.194871795,0,empty,CD-0722-4
"D9,F11",8046,8524,6230,2294,4411,2007,0,2008,1323,685,1.931386861,1075,1742,366,147,146,1,42,1,0.082191781,0,empty,CD-0722-4
"D9,F12",8986,9970,6570,3400,5115,2544,0,2545,1633,912,1.790570175,1482,210,65,20,20,0,9,0,0,0,empty,CD-0722-4
"D9,G1",12512,13281,9535,3746,6775,3122,0,3124,2089,1035,2.018357488,1641,5315,798,300,296,4,74,2,0.057432432,0,empty,CD-0722-4
"D9,G2",786093,912200,543397,368803,451063,263176,2,263413,217168,46245,4.696032003,160435,49383,8908,3523,3451,72,654,5,0.084613156,0,hg38,CD-0722-4
"D9,G3",10960,11684,8076,3608,5983,2872,23,2897,1725,1172,1.471843003,1636,2288,632,233,232,1,66,1,0.103448276,0,empty,CD-0722-4
"D9,G4",20158,22179,14213,7966,11261,6222,14,6241,3779,2462,1.53493095,3666,42,16,6,6,0,2,0,0.833333333,0,empty,CD-0722-4
"D9,G5",6625,7350,4945,2405,3851,1935,4,1940,1205,735,1.639455782,1084,2100,480,137,134,3,36,2,0.179104478,0,empty,CD-0722-4
"D9,G6",1965880,2254857,1498591,756266,1058363,566558,5,567100,482892,84208,5.734514535,324246,13928,2830,1211,1189,22,244,2,0.056349874,0,hg38,CD-0722-4
"D9,G7",7660,8301,5914,2387,4388,2031,0,2033,1329,704,1.887784091,1097,3001,939,335,334,1,77,1,0.104790419,0,empty,CD-0722-4
"D9,G8",5491,5941,4046,1895,3142,1525,1,1528,1011,517,1.955512573,899,1730,446,163,161,2,45,1,0.173913043,0,empty,CD-0722-4
"D9,G9",7050,7802,5117,2685,4078,2056,0,2061,1346,715,1.882517483,1204,2152,417,163,160,3,62,2,0.025,0,empty,CD-0722-4
"D9,G10",8071,8809,6040,2769,4557,2210,13,2223,1456,767,1.898305085,1240,2575,769,340,340,0,74,0,0.085294118,0,empty,CD-0722-4
"D9,G11",8259,9075,6252,2823,4727,2196,0,2202,1485,717,2.071129707,1225,1866,455,180,174,6,52,2,0.074712644,0,empty,CD-0722-4
"D9,G12",6465,7094,4741,2353,3761,1938,0,1938,1237,701,1.764621969,1107,2144,627,227,226,1,59,1,0.026548673,0,empty,CD-0722-4
"D9,H1",6976,7477,5169,2308,3954,1879,0,1879,1286,593,2.168634064,1061,1336,245,98,97,1,34,1,0.072164948,0,empty,CD-0722-4
"D9,H2",8065,8672,5882,2790,4563,2228,0,2228,1440,788,1.827411168,1260,2553,581,228,228,0,64,0,0.166666667,0,empty,CD-0722-4
"D9,H3",6458,7199,4646,2553,3712,1893,0,1893,1206,687,1.755458515,1082,2064,578,219,217,2,58,1,0.032258065,0,empty,CD-0722-4
"D9,H4",923392,1104337,639900,464437,535561,344728,0,344950,249776,95174,2.624414231,208072,319,63,32,32,0,9,0,0.28125,0,empty,CD-0722-4
"D9,H5",10838,11950,7991,3959,6004,3004,0,3005,1935,1070,1.808411215,1685,2016,544,192,192,0,48,0,0.083333333,0,empty,CD-0722-4
"D9,H6",6156,6948,4600,2348,3544,1775,16,1793,1203,590,2.038983051,1008,2022,569,254,246,8,68,3,0.109756098,0,empty,CD-0722-4
"D9,H7",7426,7962,5409,2553,4323,2113,2,2116,1379,737,1.87109905,1178,1724,458,151,150,1,42,1,0.113333333,0,empty,CD-0722-4
"D9,H8",8381,9196,6191,3005,4808,2394,2,2398,1577,821,1.920828258,1360,2395,634,297,296,1,72,1,0.050675676,0,empty,CD-0722-4
"D9,H9",6427,7112,4805,2307,3679,1754,0,1754,1181,573,2.061082024,1040,1271,271,103,102,1,35,1,0.029411765,0,empty,CD-0722-4
"D9,H10",1278316,1496921,947454,549467,710924,397156,3,397565,328375,69190,4.745989305,235207,194470,30349,11939,11733,206,1722,4,0.074064604,0,hg38,CD-0722-4
"D9,H11",7000,8154,4917,3237,4173,2458,1,2461,1389,1072,1.295708955,1495,8,0,0,0,0,0,0,0,0,empty,CD-0722-4
"D9,H12",5995,6514,4410,2104,3301,1672,1,1673,1075,598,1.797658863,901,1435,211,106,101,5,32,1,0,0,empty,CD-0722-4
"D10,A1",6569,7342,4732,2610,3753,1931,15,1946,1226,720,1.702777778,1120,1150,238,89,89,0,28,0,0.033707865,0,empty,CD-0722-4
"D10,A2",8641,9329,6396,2933,4881,2440,21,2464,1559,905,1.722651934,1321,1202,283,145,145,0,39,0,0.310344828,0,empty,CD-0722-4
"D10,A3",6041,6653,4462,2191,3474,1692,0,1693,1104,589,1.874363328,944,1484,335,141,138,3,35,1,0.18115942,0,empty,CD-0722-4
"D10,A4",1759826,1951065,1336432,614633,928182,478174,9,478635,395217,83418,4.737790405,270768,24533,3944,1466,1455,11,319,2,0.008247423,0,hg38,CD-0722-4
"D10,A5",8507,9007,6319,2688,4767,2328,0,2330,1512,818,1.848410758,1218,2195,581,235,234,1,48,1,0.068376068,0,empty,CD-0722-4
"D10,A6",7035,7704,5075,2629,4100,2158,0,2163,1403,760,1.846052632,1246,2744,541,213,213,0,68,0,0.0657277,0,empty,CD-0722-4
"D10,A7",6189,6782,4669,2113,3594,1826,22,1849,1165,684,1.703216374,1036,881,229,91,89,2,29,1,0.04494382,0,empty,CD-0722-4
"D10,A8",3857,4213,2801,1412,2289,1133,21,1156,778,378,2.058201058,675,1456,357,181,181,0,51,0,0.005524862,0,empty,CD-0722-4
"D10,A9",6874,7793,5182,2611,4014,1946,0,1946,1262,684,1.84502924,1117,1657,346,144,140,4,35,2,0.078571429,0,empty,CD-0722-4
"D10,A10",6697,7067,5059,2008,3735,1725,0,1725,1073,652,1.645705521,936,263,53,19,18,1,8,1,0,0,empty,CD-0722-4
"D10,A11",5271,5766,4060,1706,3055,1427,0,1427,934,493,1.894523327,776,1724,305,135,135,0,32,0,0.185185185,0,empty,CD-0722-4
"D10,A12",7657,8366,5778,2588,4247,2023,2,2027,1363,664,2.052710843,1102,3981,975,323,321,2,71,2,0.003115265,0,empty,CD-0722-4
"D10,B1",6708,7247,4851,2396,3738,1868,9,1877,1209,668,1.80988024,1086,996,237,101,100,1,28,1,0.13,0,empty,CD-0722-4
"D10,B2",7690,8192,5316,2876,4288,2236,0,2240,1369,871,1.571756602,1299,620,104,53,53,0,19,0,0.037735849,0,empty,CD-0722-4
"D10,B3",5779,6180,4160,2020,3335,1693,0,1696,1130,566,1.996466431,976,1222,366,139,139,0,32,0,0.158273381,0,empty,CD-0722-4
"D10,B4",6069,6590,4443,2147,3551,1793,1,1796,1101,695,1.584172662,1013,1447,405,165,165,0,34,0,0.006060606,0,empty,CD-0722-4
"D10,B5",8364,5017,3312,1705,3348,1655,0,1671,1095,576,1.901041667,1026,1048,261,102,101,1,23,1,0.00990099,0,empty,CD-0722-4
"D10,B6",389318,450758,277581,173177,235495,140033,4,140206,98508,41698,2.362415464,84229,3083,1172,270,269,1,82,1,0.089219331,0,hg38,CD-0722-4
"D10,B7",7248,7559,5420,2139,3927,1800,0,1806,1217,589,2.066213922,954,1492,309,133,132,1,32,1,0.242424242,0,empty,CD-0722-4
"D10,B8",5028,5506,3666,1840,2932,1457,1,1458,1002,456,2.197368421,832,1367,433,132,131,1,37,1,0.061068702,0,empty,CD-0722-4
"D10,B9",9366,10357,6969,3388,5311,2664,0,2666,1707,959,1.779979145,1524,1067,277,110,109,1,29,1,0,0,empty,CD-0722-4
"D10,B10",4744,5125,3409,1716,2847,1437,1,1441,878,563,1.559502664,823,523,100,44,44,0,16,0,0.068181818,0,empty,CD-0722-4
"D10,B11",627682,682390,483705,198685,332149,156777,21,156973,122159,34814,3.508904464,87048,3032,374,140,139,1,34,1,0.115107914,0,hg38,CD-0722-4
"D10,B12",5831,6503,4237,2266,3413,1719,0,1722,1111,611,1.818330606,995,1328,287,114,112,2,48,1,0.008928571,0,empty,CD-0722-4
"D10,C1",1539072,1635988,1202793,433195,780656,357018,1,357425,272625,84800,3.214917453,191869,24274,4424,1689,1656,33,343,5,0.015096618,0,hg38,CD-0722-4
"D10,C2",1270132,1506829,923742,583087,724010,417991,9,418345,333291,85054,3.918581137,251842,45044,11268,4298,4265,33,854,2,0.056975381,0,hg38,CD-0722-4
"D10,C3",1129800,1356219,832961,523258,663303,389967,17,390290,292669,97621,2.998012723,234558,1876,449,151,151,0,38,0,0.145695364,0,hg38,CD-0722-4
"D10,C4",6402,6704,4890,1814,3573,1583,22,1607,1056,551,1.916515426,844,1823,517,191,190,1,46,1,0.010526316,0,empty,CD-0722-4
"D10,C5",8822,9672,6528,3144,5010,2481,5,2486,1631,855,1.907602339,1427,1388,296,80,80,0,25,0,0.075,0,empty,CD-0722-4
"D10,C6",7702,8436,5629,2807,4578,2270,12,2288,1533,755,2.030463576,1314,1598,447,138,138,0,39,0,0.086956522,0,empty,CD-0722-4
"D10,C7",10315,11342,7430,3912,5962,3183,0,3192,1912,1280,1.49375,1840,318,41,20,19,1,6,1,0,0,empty,CD-0722-4
"D10,C8",10870,11827,8042,3785,6146,3113,0,3125,2037,1088,1.872242647,1743,3238,691,282,279,3,90,1,0.046594982,0,empty,CD-0722-4
"D10,C9",9226,9897,6891,3006,5230,2484,0,2486,1646,840,1.95952381,1378,1804,362,141,141,0,47,0,0.04964539,0,empty,CD-0722-4
"D10,C10",12058,13316,9227,4089,6718,3342,0,3345,2313,1032,2.24127907,1783,1595,256,110,108,2,40,1,0.046296296,0,empty,CD-0722-4
"D10,C11",8317,9324,6161,3163,4782,2337,17,2357,1499,858,1.747086247,1303,1654,459,189,188,1,45,1,0.159574468,0,empty,CD-0722-4
"D10,C12",11594,12549,8521,4028,6720,3333,0,3341,2175,1166,1.86535163,1926,2727,577,210,210,0,50,0,0.023809524,0,empty,CD-0722-4
"D10,D1",9679,10877,7126,3751,5616,2944,0,2944,1764,1180,1.494915254,1679,816,207,64,62,2,17,1,0.080645161,0,empty,CD-0722-4
"D10,D2",722772,834740,526798,307942,414327,243405,20,243648,188879,54769,3.448647958,138230,57049,27708,9986,9967,19,1446,2,0.003210595,0,hg38,CD-0722-4
"D10,D3",7428,8431,5528,2903,4307,2148,29,2179,1451,728,1.993131868,1265,1777,312,157,154,3,41,1,0.032467532,0,empty,CD-0722-4
"D10,D4",5752,6244,4234,2010,3274,1645,0,1645,1073,572,1.875874126,939,1429,276,123,121,2,39,2,0,0,empty,CD-0722-4
"D10,D5",925954,1070292,692852,377440,523405,278137,1,278363,219461,58902,3.725866694,163285,108230,17107,6439,6327,112,1080,5,0.058637585,0,hg38,CD-0722-4
"D10,D6",9894,10767,7230,3537,5571,2960,0,2964,1733,1231,1.407798538,1685,1684,475,182,181,1,38,1,0.110497238,0,empty,CD-0722-4
"D10,D7",5811,6206,4371,1835,3270,1490,30,1520,1025,495,2.070707071,809,1726,281,129,128,1,35,1,0.0390625,0,empty,CD-0722-4
"D10,D8",872790,996134,655051,341083,488367,256708,1,256954,206681,50273,4.111172995,149237,100402,13129,5070,4947,123,866,5,0.070952092,0,hg38,CD-0722-4
"D10,D9",3478,3735,2578,1157,1984,913,0,913,592,321,1.84423676,523,1690,545,191,189,2,41,1,0.185185185,0,empty,CD-0722-4
"D10,D10",6998,7709,5041,2668,4029,1984,0,1984,1209,775,1.56,1174,936,105,60,59,1,18,1,0,0,empty,CD-0722-4
"D10,D11",658637,736330,500853,235477,362765,182794,0,182983,144088,38895,3.704537858,103582,67035,11531,4134,4056,78,785,5,0.019970414,0,hg38,CD-0722-4
"D10,D12",9939,10954,7396,3558,5712,2752,0,2756,1810,946,1.913319239,1558,4340,1239,499,491,8,119,2,0.075356415,0,empty,CD-0722-4
"D10,E1",11342,12263,8415,3848,6545,3255,2,3257,2142,1115,1.921076233,1816,2646,578,240,239,1,70,1,0.050209205,0,empty,CD-0722-4
"D10,E2",1684475,1961383,1255738,705645,955054,552955,6,553410,388247,165163,2.350689924,327680,70167,17543,6472,6401,71,1109,3,0.04780503,0,hg38,CD-0722-4
"D10,E3",5744,6212,4294,1918,3345,1632,0,1635,1043,592,1.761824324,918,2208,652,259,259,0,68,0,0.061776062,0,empty,CD-0722-4
"D10,E4",8522,9315,6411,2904,4832,2357,1,2359,1529,830,1.842168675,1308,3067,631,237,228,9,57,2,0.171052632,0,empty,CD-0722-4
"D10,E5",7303,7807,5626,2181,4184,1933,0,1933,1271,662,1.919939577,1025,1297,272,126,125,1,48,1,0.136,0,empty,CD-0722-4
"D10,E6",12500,13230,9456,3774,6755,3213,32,3248,2095,1153,1.816999133,1716,2943,683,248,246,2,77,1,0.044715447,0,empty,CD-0722-4
"D10,E7",11651,12733,8759,3974,6604,3067,4,3075,2047,1028,1.991245136,1710,2898,629,286,285,1,79,1,0.010526316,0,empty,CD-0722-4
"D10,E8",9641,10519,7335,3184,5437,2524,1,2531,1700,831,2.045728039,1408,2695,658,272,271,1,78,1,0.073800738,0,empty,CD-0722-4
"D10,E9",5271,5845,3868,1977,3112,1619,0,1619,1079,540,1.998148148,959,2418,613,272,272,0,60,0,0.110294118,0,empty,CD-0722-4
"D10,E10",880158,1036450,643454,392996,507441,285835,1,286096,227860,58236,3.912700048,171264,138076,24060,9448,9298,150,1492,8,0.057001506,0,hg38,CD-0722-4
"D10,E11",8074,8594,5872,2722,4551,2249,0,2255,1465,790,1.85443038,1255,1925,255,91,89,2,31,1,0.112359551,0,empty,CD-0722-4
"D10,E12",8554,9390,6222,3168,4912,2416,0,2418,1512,906,1.668874172,1382,1817,281,125,125,0,38,0,0.016,0,empty,CD-0722-4
"D10,F1",9967,10345,7422,2923,5480,2578,0,2579,1629,950,1.714736842,1356,2111,513,196,191,5,62,2,0.047120419,0,empty,CD-0722-4
"D10,F2",1425401,1663472,1029595,633877,819391,482970,4,483411,336824,146587,2.297775383,290448,39863,9301,3222,3187,35,587,3,0.045497333,0,hg38,CD-0722-4
"D10,F3",7851,8812,5890,2922,4502,2159,0,2162,1434,728,1.96978022,1247,2833,672,269,266,3,78,2,0.026315789,0,empty,CD-0722-4
"D10,F4",12395,13223,9405,3818,6789,3117,0,3121,2053,1068,1.922284644,1636,700,100,40,40,0,12,0,0.175,0,empty,CD-0722-4
"D10,F5",9825,10359,7183,3176,5522,2643,0,2646,1669,977,1.708290686,1461,1901,511,193,188,5,39,2,0.026595745,0,empty,CD-0722-4
"D10,F6",9290,10480,6809,3671,5514,2872,13,2891,1867,1024,1.823242188,1678,2245,462,228,224,4,74,2,0.026785714,0,empty,CD-0722-4
"D10,F7",10504,11516,7829,3687,6053,2949,5,2960,1946,1014,1.91913215,1654,1127,274,94,94,0,29,0,0.063829787,0,empty,CD-0722-4
"D10,F8",7120,7972,5397,2575,4219,2044,0,2044,1312,732,1.792349727,1123,173,35,19,19,0,7,0,0,0,empty,CD-0722-4
"D10,F9",8408,8943,6328,2615,4692,2169,1,2171,1463,708,2.066384181,1151,2744,604,256,251,5,64,2,0.131474104,0,empty,CD-0722-4
"D10,F10",2470928,2708869,1900731,808138,1266083,641447,1,642118,520007,122111,4.258477942,355427,159181,17308,6466,6314,152,1203,8,0.022172949,0,hg38,CD-0722-4
"D10,F11",7846,8137,5943,2194,4202,1889,0,1889,1232,657,1.875190259,978,1813,384,141,140,1,31,1,0.207142857,0,empty,CD-0722-4
"D10,F12",8976,9890,6629,3261,5185,2573,1,2580,1646,934,1.762312634,1458,285,40,25,25,0,7,0,0,0,empty,CD-0722-4
"D10,G1",10131,11140,7493,3647,5869,2817,0,2821,1829,992,1.84375,1622,2607,758,279,276,3,65,2,0.163043478,0,empty,CD-0722-4
"D10,G2",5646,6011,4023,1988,3206,1620,0,1621,1025,596,1.719798658,926,424,74,29,29,0,11,0,0,0,empty,CD-0722-4
"D10,G3",11223,11649,8288,3361,6131,2947,13,2971,1801,1170,1.539316239,1594,2673,734,241,238,3,63,2,0.042016807,0,empty,CD-0722-4
"D10,G4",18266,20097,13125,6972,10390,5581,0,5582,3296,2286,1.441819773,3171,49,11,9,9,0,4,0,0,0,empty,CD-0722-4
"D10,G5",6815,7594,4935,2659,3890,1966,6,1976,1279,697,1.835007174,1166,1445,326,128,125,3,35,2,0.016,0,empty,CD-0722-4
"D10,G6",1144934,1286824,872209,414615,619249,313728,1,314027,241664,72363,3.339607258,179135,12853,1406,561,549,12,135,2,0.074681239,0,hg38,CD-0722-4
"D10,G7",7646,8120,5902,2218,4295,1942,0,1944,1328,616,2.155844156,1060,2149,355,147,140,7,49,2,0.014285714,0,empty,CD-0722-4
"D10,G8",5857,6274,4415,1859,3191,1497,0,1497,993,504,1.970238095,774,2015,522,206,206,0,61,0,0.038834951,0,empty,CD-0722-4
"D10,G9",787370,909659,585870,323789,445484,240757,1,240943,185451,55492,3.341941181,142110,33439,5102,1978,1942,36,512,4,0.013903193,0,hg38,CD-0722-4
"D10,G10",10243,10930,7733,3197,5760,2779,1,2784,1849,935,1.977540107,1496,2863,773,303,300,3,65,2,0.063333333,0,empty,CD-0722-4
"D10,G11",801074,898025,603807,294218,439999,224446,1,224694,174091,50603,3.440329625,128874,51243,6574,2586,2525,61,560,2,0.028514851,0,hg38,CD-0722-4
"D10,G12",6734,7302,4915,2387,3852,1961,0,1973,1277,696,1.834770115,1109,2262,651,231,228,3,48,2,0.070175439,0,empty,CD-0722-4
"D10,H1",6855,7448,5080,2368,3926,1909,0,1909,1219,690,1.766666667,1084,1180,310,115,115,0,31,0,0.052173913,0,empty,CD-0722-4
"D10,H2",8517,9328,6252,3076,4857,2447,0,2447,1571,876,1.793378995,1391,1941,441,191,187,4,62,2,0.085561497,0,empty,CD-0722-4
"D10,H3",872194,1028046,630537,397509,504344,289977,1,290229,224205,66024,3.395810614,175615,114068,17571,6810,6656,154,1146,5,0.042067308,0,hg38,CD-0722-4
"D10,H4",9921,10738,7271,3467,5623,2743,0,2744,1789,955,1.873298429,1581,277,75,37,37,0,11,0,0.324324324,0,empty,CD-0722-4
"D10,H5",11031,12249,8004,4245,6318,3263,0,3274,2142,1132,1.892226148,1890,1779,436,153,149,4,42,1,0.080536913,0,empty,CD-0722-4
"D10,H6",6207,6718,4543,2175,3455,1723,0,1725,1126,599,1.879799666,972,1724,379,138,136,2,53,2,0.007352941,0,empty,CD-0722-4
"D10,H7",7237,7944,5387,2557,4145,1990,0,2000,1324,676,1.958579882,1160,1979,449,191,188,3,37,1,0.026595745,0,empty,CD-0722-4
"D10,H8",8450,9365,6205,3160,4757,2411,29,2441,1603,838,1.912887828,1366,2273,680,227,225,2,62,2,0.026666667,0,empty,CD-0722-4
"D10,H9",6938,7229,5301,1928,3840,1740,0,1742,1186,556,2.133093525,917,928,145,58,56,2,20,2,0.017857143,0,empty,CD-0722-4
"D10,H10",5617,6139,4162,1977,3205,1533,12,1545,1050,495,2.121212121,873,1552,233,100,98,2,27,2,0.255102041,0,empty,CD-0722-4
"D10,H11",914677,1048093,678621,369472,512539,275873,9,276114,210501,65613,3.208220932,161874,4528,646,258,257,1,47,1,0.042801556,0,hg38,CD-0722-4
"D10,H12",657085,733332,491746,241586,361640,182327,8,182517,143132,39385,3.634175448,106327,148903,13073,5093,4885,208,833,7,0.054042989,0,hg38,CD-0722-4
"D11,A1",721253,813088,543850,269238,406779,209625,1,209798,162958,46840,3.479035013,121228,76749,8698,3440,3335,105,656,6,0.057871064,0,hg38,CD-0722-4
"D11,A2",9115,9808,6818,2990,5048,2418,0,2419,1553,866,1.79330254,1303,1998,309,153,149,4,47,2,0.154362416,0,empty,CD-0722-4
"D11,A3",5439,5983,4023,1960,3114,1557,2,1559,1039,520,1.998076923,877,1082,230,75,75,0,27,0,0.053333333,0,empty,CD-0722-4
"D11,A4",9452,10154,7203,2951,5294,2528,0,2529,1660,869,1.910241657,1304,741,183,79,75,4,24,1,0.04,0,empty,CD-0722-4
"D11,A5",16870,18227,13350,4877,9186,4010,8,4022,2701,1321,2.044663134,2096,4123,590,209,205,4,66,1,0.024390244,0,empty,CD-0722-4
"D11,A6",10663,11807,8117,3690,6054,2915,0,2916,2020,896,2.254464286,1633,2304,679,270,269,1,71,1,0.063197026,0,empty,CD-0722-4
"D11,A7",16342,18690,11765,6925,9432,5475,0,5484,3725,1759,2.1176805,3148,1338,334,122,122,0,25,0,0.106557377,0,empty,CD-0722-4
"D11,A8",1011802,1237151,745333,491818,610236,359209,0,359451,293045,66406,4.412929555,217787,186730,33516,12430,12256,174,2003,6,0.040143603,0,hg38,CD-0722-4
"D11,A9",6349,6891,4730,2161,3586,1768,0,1771,1100,671,1.639344262,978,2046,350,162,160,2,46,2,0.05,0,empty,CD-0722-4
"D11,A10",6034,6531,4565,1966,3496,1703,1,1706,1079,627,1.720893142,963,277,104,37,36,1,8,1,0,0,empty,CD-0722-4
"D11,A11",5462,5927,4015,1912,3117,1500,0,1500,972,528,1.840909091,888,1221,351,124,123,1,29,1,0.138211382,0,empty,CD-0722-4
"D11,A12",6995,7520,5288,2232,3871,1831,29,1860,1227,633,1.938388626,967,2657,478,205,204,1,63,1,0.019607843,0,empty,CD-0722-4
"D11,B1",6145,6721,4526,2195,3476,1765,0,1766,1100,666,1.651651652,986,933,260,97,95,2,23,1,0,0,empty,CD-0722-4
"D11,B2",7715,8379,5275,3104,4423,2402,1,2407,1497,910,1.645054945,1443,660,222,74,72,2,12,1,0.152777778,0,empty,CD-0722-4
"D11,B3",4965,5223,3729,1494,2777,1309,0,1311,833,478,1.742677824,696,1494,330,123,123,0,32,0,0.195121951,0,empty,CD-0722-4
"D11,B4",5456,6181,3925,2256,3198,1677,1,1682,1046,636,1.644654088,1019,799,192,66,65,1,19,1,0,0,empty,CD-0722-4
"D11,B5",6572,3793,2458,1335,2566,1345,2,1363,879,484,1.816115702,823,846,230,111,110,1,24,1,0.081818182,0,empty,CD-0722-4
"D11,B6",6646,7066,4852,2214,3824,1977,1,1979,1193,786,1.517811705,1114,1375,296,138,138,0,45,0,0.086956522,0,empty,CD-0722-4
"D11,B7",8824,9578,6568,3010,5084,2580,0,2583,1650,933,1.768488746,1382,1112,338,135,135,0,40,0,0.02962963,0,empty,CD-0722-4
"D11,B8",930888,994308,724165,270143,488348,224736,4,224999,179844,45155,3.982814749,121827,77356,7928,3127,3035,92,631,5,0.044151565,0,hg38,CD-0722-4
"D11,B9",8641,9674,6381,3293,4983,2609,0,2612,1682,930,1.808602151,1476,763,74,33,33,0,17,0,0,0,empty,CD-0722-4
"D11,B10",4466,4622,3244,1378,2636,1251,0,1253,790,463,1.706263499,736,322,52,19,19,0,7,0,0.105263158,0,empty,CD-0722-4
"D11,B11",13765,15202,10239,4963,7849,4078,0,4089,2578,1511,1.706154864,2302,238,17,8,8,0,7,0,0.125,0,empty,CD-0722-4
"D11,B12",5457,5950,3915,2035,3186,1656,3,1659,1059,600,1.765,989,1437,382,135,133,2,32,1,0.180451128,0,empty,CD-0722-4
"D11,C1",859084,971873,643900,327973,477011,254350,0,254595,206747,47848,4.320912055,144868,13593,3819,1395,1388,7,312,2,0.00648415,0,hg38,CD-0722-4
"D11,C2",9328,10052,6787,3265,5327,2700,0,2707,1806,901,2.004439512,1502,1369,423,169,166,3,43,1,0.108433735,0,empty,CD-0722-4
"D11,C3",9697,10797,7155,3642,5603,2832,1,2838,1756,1082,1.622920518,1642,588,124,40,40,0,16,0,0,0,empty,CD-0722-4
"D11,C4",5903,6345,4361,1984,3414,1676,0,1677,1052,625,1.6832,979,1246,173,81,76,5,26,2,0.210526316,0,empty,CD-0722-4
"D11,C5",8469,9120,6237,2883,4789,2346,2,2350,1548,802,1.930174564,1316,1373,282,109,109,0,32,0,0.119266055,0,empty,CD-0722-4
"D11,C6",6885,7298,4968,2330,3924,1954,12,1968,1279,689,1.856313498,1118,1158,252,108,105,3,35,1,0.104761905,0,empty,CD-0722-4
"D11,C7",9732,10942,7148,3794,5743,3021,0,3023,1830,1193,1.53394803,1782,849,173,43,43,0,12,0,0,0,empty,CD-0722-4
"D11,C8",664162,737402,501293,236109,366662,183112,14,183336,141392,41944,3.370970818,104546,84053,10153,3928,3821,107,749,5,0.036901335,0,hg38,CD-0722-4
"D11,C9",7501,8226,5514,2712,4295,2158,2,2162,1409,753,1.871181939,1206,1592,253,110,108,2,33,1,0.083333333,0,empty,CD-0722-4
"D11,C10",605806,673828,458267,215561,327735,164694,2,164848,129006,35842,3.599296914,92643,84808,11874,4796,4685,111,868,5,0.050160085,0,hg38,CD-0722-4
"D11,C11",7987,8839,5837,3002,4651,2312,0,2315,1506,809,1.861557478,1345,1457,368,148,147,1,37,1,0.197278912,0,empty,CD-0722-4
"D11,C12",10194,10664,7520,3144,5694,2678,0,2686,1770,916,1.93231441,1448,1992,522,208,204,4,58,2,0.093137255,0,empty,CD-0722-4
"D11,D1",9237,10242,6807,3435,5398,2755,0,2757,1610,1147,1.403661726,1580,663,101,50,50,0,12,0,0.26,0,empty,CD-0722-4
"D11,D2",9131,9540,6986,2554,5013,2264,10,2274,1464,810,1.807407407,1149,2596,522,213,211,2,55,1,0.075829384,0,empty,CD-0722-4
"D11,D3",6521,7046,4786,2260,3743,1859,20,1879,1196,683,1.751098097,1046,1280,181,89,89,0,24,0,0.02247191,0,empty,CD-0722-4
"D11,D4",5499,6146,4150,1996,3316,1621,0,1621,1047,574,1.824041812,931,1107,153,62,61,1,25,1,0,0,empty,CD-0722-4
"D11,D5",6044,6647,4565,2082,3497,1664,9,1674,1013,661,1.532526475,932,1295,403,178,177,1,46,1,0.101694915,0,empty,CD-0722-4
"D11,D6",9105,9911,6475,3436,5148,2731,0,2740,1646,1094,1.504570384,1550,1037,376,176,173,3,36,1,0.23699422,0,empty,CD-0722-4
"D11,D7",657835,744044,490349,253695,368811,190519,2,190708,153239,37469,4.089754197,110185,104450,22871,8901,8798,103,1313,6,0.044555581,0,hg38,CD-0722-4
"D11,D8",6080,6532,4431,2101,3507,1734,0,1734,1100,634,1.735015773,983,1092,199,92,92,0,32,0,0,0,empty,CD-0722-4
"D11,D9",4476,4747,3472,1275,2630,1227,0,1228,818,410,1.995121951,685,1355,352,112,112,0,34,0,0.071428571,0,empty,CD-0722-4
"D11,D10",6374,7087,4566,2521,3773,1894,0,1894,1223,671,1.822652757,1132,805,160,67,67,0,17,0,0.104477612,0,empty,CD-0722-4
"D11,D11",11029,12045,8130,3915,6298,3340,3,3350,2134,1216,1.754934211,1885,1609,522,205,204,1,47,1,0.029411765,0,empty,CD-0722-4
"D11,D12",9242,9826,6804,3022,5211,2556,0,2559,1642,917,1.790621592,1387,3454,815,300,300,0,93,0,0.073333333,0,empty,CD-0722-4
"D11,E1",10622,11471,7772,3699,6034,3036,15,3054,1998,1056,1.892045455,1696,1695,441,180,178,2,43,1,0.117977528,0,empty,CD-0722-4
"D11,E2",8098,8700,5978,2722,4599,2291,0,2292,1456,836,1.741626794,1301,1922,438,177,177,0,48,0,0.118644068,0,empty,CD-0722-4
"D11,E3",6604,7267,5025,2242,3758,1763,0,1768,1134,634,1.788643533,963,2539,523,210,207,3,64,1,0.15942029,0,empty,CD-0722-4
"D11,E4",7020,7645,5177,2468,4058,2004,0,2010,1300,710,1.830985915,1146,1628,376,165,165,0,40,0,0.006060606,0,empty,CD-0722-4
"D11,E5",6634,7132,5037,2095,3765,1732,0,1735,1088,647,1.681607419,927,1223,396,162,162,0,31,0,0.00617284,0,empty,CD-0722-4
"D11,E6",11282,12341,8335,4006,6485,3182,0,3184,2015,1169,1.723695466,1820,2769,615,233,228,5,67,1,0.057017544,0,empty,CD-0722-4
"D11,E7",10233,10841,7727,3114,5753,2723,0,2724,1782,942,1.891719745,1489,2382,644,233,230,3,51,2,0.004347826,0,empty,CD-0722-4
"D11,E8",9293,10195,7092,3103,5244,2492,5,2499,1616,883,1.830124575,1353,2208,568,207,207,0,49,0,0.285024155,0,empty,CD-0722-4
"D11,E9",4847,5061,3621,1440,2613,1246,0,1247,811,436,1.860091743,634,1625,284,107,106,1,30,1,0.056603774,0,empty,CD-0722-4
"D11,E10",6387,6848,4676,2172,3647,1809,0,1809,1161,648,1.791666667,977,1159,280,135,133,2,36,1,0.037593985,0,empty,CD-0722-4
"D11,E11",7490,8082,5450,2632,4228,2121,21,2143,1396,747,1.868808568,1194,1360,345,142,142,0,31,0,0.190140845,0,empty,CD-0722-4
"D11,E12",7369,8273,5322,2951,4403,2208,11,2221,1425,796,1.790201005,1315,1737,354,161,159,2,41,1,0.062893082,0,empty,CD-0722-4
"D11,F1",9412,9790,7056,2734,5254,2516,0,2521,1574,947,1.662090813,1311,1471,458,177,172,5,35,2,0.186046512,0,empty,CD-0722-4
"D11,F2",7393,7919,5503,2416,4169,1953,23,1976,1261,715,1.763636364,1132,2335,724,298,298,0,60,0,0.134228188,0,empty,CD-0722-4
"D11,F3",6747,7221,5080,2141,3962,1874,0,1876,1200,676,1.775147929,1050,1667,236,138,135,3,48,2,0.125925926,0,empty,CD-0722-4
"D11,F4",10796,11357,8170,3187,6087,2796,2,2800,1827,973,1.877697842,1494,424,45,11,11,0,6,0,0,0,empty,CD-0722-4
"D11,F5",8952,9575,6580,2995,5119,2422,10,2434,1613,821,1.964677223,1383,1779,324,123,123,0,38,0,0.032520325,0,empty,CD-0722-4
"D11,F6",650448,745523,477465,268058,371916,200548,0,200754,160739,40015,4.016968637,119218,149494,17918,7022,6834,188,1161,8,0.035996488,0,hg38,CD-0722-4
"D11,F7",9389,10198,7082,3116,5473,2644,1,2645,1711,934,1.831905782,1466,1107,460,170,170,0,32,0,0,0,empty,CD-0722-4
"D11,F8",7136,7503,5344,2159,3979,1886,0,1886,1203,683,1.761346999,1011,233,16,14,14,0,8,0,0,0,empty,CD-0722-4
"D11,F9",683367,795474,489806,305668,400933,230563,1,230775,190236,40539,4.692666321,138285,28438,12081,4477,4463,14,826,3,0.029576518,0,hg38,CD-0722-4
"D11,F10",9807,10427,7396,3031,5519,2575,1,2578,1672,906,1.845474614,1386,1470,364,132,132,0,38,0,0.121212121,0,empty,CD-0722-4
"D11,F11",550141,577557,434403,143154,286027,120675,1,120840,95625,25215,3.792385485,63665,28130,5425,2121,2096,25,389,3,0.038645038,0,hg38,CD-0722-4
"D11,F12",803131,898154,601872,296282,439178,222957,0,223150,172952,50198,3.445396231,128711,7836,845,306,296,10,76,2,0.057432432,0,hg38,CD-0722-4
"D11,G1",9561,10164,7056,3108,5337,2522,0,2526,1665,861,1.933797909,1418,2000,457,228,227,1,59,1,0.061674009,0,empty,CD-0722-4
"D11,G2",5549,5993,3915,2078,3020,1490,28,1519,955,564,1.693262411,863,426,86,42,40,2,17,1,0.125,0,empty,CD-0722-4
"D11,G3",9918,10564,7222,3342,5521,2751,0,2753,1628,1125,1.447111111,1507,1786,410,173,173,0,49,0,0.040462428,0,empty,CD-0722-4
"D11,G4",2202440,2527195,1629344,897851,1214818,681511,4,682131,572579,109552,5.226549949,396377,2745,400,165,164,1,40,1,0.030487805,0,hg38,CD-0722-4
"D11,G5",5956,6380,4488,1892,3351,1657,0,1657,1010,647,1.561051005,897,1384,301,146,145,1,39,1,0.013793103,0,empty,CD-0722-4
"D11,G6",1229276,1445588,905932,539656,705089,403173,0,403521,309256,94265,3.280708641,239159,592,98,44,42,2,19,2,0,0,empty,CD-0722-4
"D11,G7",7362,7779,5539,2240,4087,1904,0,1904,1214,690,1.75942029,1012,1975,441,183,180,3,53,1,0.022222222,0,empty,CD-0722-4
"D11,G8",650874,737567,485390,252177,366047,190930,1,191125,143020,48105,2.973079721,111952,108105,14609,5945,5808,137,1035,5,0.025309917,0,hg38,CD-0722-4
"D11,G9",6542,7145,4826,2319,3749,1831,0,1831,1170,661,1.770045386,1040,1872,462,195,194,1,53,1,0.087628866,0,empty,CD-0722-4
"D11,G10",7074,7759,5202,2557,4080,2076,0,2078,1331,747,1.781793842,1151,1299,366,157,155,2,57,1,0.051612903,0,empty,CD-0722-4
"D11,G11",7516,8054,5542,2512,4213,1998,0,1999,1260,739,1.705006766,1095,1319,342,139,137,2,40,2,0.072992701,0,empty,CD-0722-4
"D11,G12",6482,7030,4739,2291,3732,1877,0,1882,1217,665,1.830075188,1063,1425,310,128,128,0,30,0,0.0703125,0,empty,CD-0722-4
"D11,H1",5969,6333,4461,1872,3409,1611,0,1612,1102,510,2.160784314,894,919,149,63,61,2,26,1,0.098360656,0,empty,CD-0722-4
"D11,H2",7351,8321,5300,3021,4243,2155,1,2161,1315,846,1.554373522,1265,1982,467,187,187,0,44,0,0.064171123,0,empty,CD-0722-4
"D11,H3",6003,6617,4477,2140,3492,1717,27,1749,1160,589,1.969439728,1012,1473,330,133,130,3,39,1,0.146153846,0,empty,CD-0722-4
"D11,H4",874342,974551,665353,309198,472706,235039,1,235255,182567,52688,3.465058457,135035,6649,667,282,271,11,62,2,0.04797048,0,hg38,CD-0722-4
"D11,H5",9624,10638,7060,3578,5634,2866,0,2867,1840,1027,1.791626095,1612,1608,292,131,131,0,46,0,0.015267176,0,empty,CD-0722-4
"D11,H6",621174,756605,428541,328064,378531,247301,12,247475,182388,65087,2.802218569,150603,4539,858,228,226,2,55,1,0.146017699,0,hg38,CD-0722-4
"D11,H7",6651,7208,4876,2332,3687,1763,0,1765,1126,639,1.762128326,1010,1225,293,130,125,5,39,2,0.104,0,empty,CD-0722-4
"D11,H8",7379,8377,5326,3051,4342,2242,0,2249,1499,750,1.998666667,1322,1859,510,198,196,2,53,2,0.081632653,0,empty,CD-0722-4
"D11,H9",5859,6286,4484,1802,3204,1442,1,1444,968,476,2.033613445,726,1009,190,85,83,2,26,1,0.060240964,0,empty,CD-0722-4
"D11,H10",6703,7333,5004,2329,3819,1885,1,1886,1294,592,2.185810811,1039,740,176,77,77,0,26,0,0.012987013,0,empty,CD-0722-4
"D11,H11",6239,7083,4332,2751,3741,2174,0,2178,1212,966,1.254658385,1304,24,0,0,0,0,0,0,0,0,empty,CD-0722-4
"D11,H12",5163,5554,3720,1834,2883,1463,1,1465,943,522,1.80651341,806,1257,387,124,123,1,29,1,0.073170732,0,empty,CD-0722-4
"D12,A1",5778,6379,4260,2119,3417,1734,0,1735,1039,696,1.492816092,1006,1366,267,103,100,3,31,1,0.06,0,empty,CD-0722-4
"D12,A2",8148,9097,6071,3026,4617,2307,1,2309,1452,857,1.69428238,1291,1965,642,231,228,3,57,2,0.114035088,0,empty,CD-0722-4
"D12,A3",5437,5931,4010,1921,3039,1469,2,1473,1002,471,2.127388535,831,1076,124,62,62,0,32,0,0.032258065,0,empty,CD-0722-4
"D12,A4",9923,10746,7421,3325,5543,2692,13,2709,1691,1018,1.661100196,1479,741,158,68,66,2,21,1,0.060606061,0,empty,CD-0722-4
"D12,A5",7606,8301,5629,2672,4316,2089,0,2091,1391,700,1.987142857,1175,2305,405,196,190,6,66,2,0.110526316,0,empty,CD-0722-4
"D12,A6",6465,7308,4714,2594,3833,2022,0,2024,1298,726,1.787878788,1149,2895,770,260,259,1,74,1,0.065637066,0,empty,CD-0722-4
"D12,A7",5664,6262,4268,1994,3255,1684,1,1689,1099,590,1.862711864,938,1097,132,68,68,0,25,0,0.132352941,0,empty,CD-0722-4
"D12,A8",4060,4485,2946,1539,2379,1174,10,1185,781,404,1.933168317,663,1947,476,189,186,3,56,1,0.086021505,0,empty,CD-0722-4
"D12,A9",712258,796381,548189,248192,387492,189233,2,189364,145662,43702,3.333074001,107273,131554,16057,6330,6178,152,1097,6,0.051796698,0,hg38,CD-0722-4
"D12,A10",7020,7505,5388,2117,3926,1795,0,1795,1199,596,2.011744966,971,602,97,38,38,0,17,0,0,0,empty,CD-0722-4
"D12,A11",616765,698437,469203,229234,340138,175034,3,175235,136851,38384,3.565313672,99917,98102,10642,4315,4196,119,829,7,0.035033365,0,hg38,CD-0722-4
"D12,A12",7042,7702,5239,2463,3996,1934,0,1938,1203,735,1.636734694,1126,3660,886,328,317,11,74,2,0.179810726,0,empty,CD-0722-4
"D12,B1",6334,6941,4633,2308,3660,1819,0,1821,1136,685,1.658394161,1019,1224,148,73,72,1,27,1,0.069444444,0,empty,CD-0722-4
"D12,B2",7173,7705,4910,2795,3940,2089,32,2122,1264,858,1.473193473,1247,483,122,60,59,1,18,1,0.118644068,0,empty,CD-0722-4
"D12,B3",5559,6023,4107,1916,3283,1678,0,1681,1083,598,1.811036789,958,1068,171,74,74,0,31,0,0,0,empty,CD-0722-4
"D12,B4",5263,5839,3787,2052,3046,1597,0,1599,1002,597,1.67839196,910,1225,329,123,118,5,43,2,0.152542373,0,empty,CD-0722-4
"D12,B5",11903,10511,6514,3997,5884,3257,0,3266,2415,851,2.837837838,2002,1173,354,149,149,0,33,0,0.208053691,0,empty,CD-0722-4
"D12,B6",618765,755909,445061,310848,374069,227577,0,227745,171428,56317,3.043983167,139384,3994,1453,333,333,0,98,0,0.081081081,0,hg38,CD-0722-4
"D12,B7",919957,1042416,707878,334538,505467,254584,3,254846,199197,55649,3.579525239,144950,83413,14617,5620,5528,92,959,5,0.046490593,0,hg38,CD-0722-4
"D12,B8",4596,4888,3565,1323,2581,1121,3,1132,771,361,2.135734072,581,1591,330,153,150,3,50,1,0.033333333,0,empty,CD-0722-4
"D12,B9",1679641,1931966,1246273,685693,919514,504024,2,504508,405083,99425,4.074256978,294087,43757,9231,3525,3501,24,706,2,0.073121965,0,hg38,CD-0722-4
"D12,B10",4307,4729,3092,1637,2571,1292,1,1294,821,473,1.735729387,727,652,157,54,52,2,13,2,0,0,empty,CD-0722-4
"D12,B11",9666,11081,6901,4180,5724,3239,0,3241,1730,1511,1.144937128,1975,243,90,40,40,0,15,0,0.225,0,empty,CD-0722-4
"D12,B12",1950859,2264315,1427648,836667,1092413,617364,6,617932,508893,109039,4.667073249,371193,249507,38334,14459,14191,268,2161,9,0.036924812,0,hg38,CD-0722-4
"D12,C1",934642,1040828,716508,324320,499355,247751,7,248007,192192,55815,3.443375437,139244,78587,10675,4132,4044,88,726,6,0.053907023,0,hg38,CD-0722-4
"D12,C2",9353,10215,6926,3289,5257,2645,0,2646,1708,938,1.820895522,1500,1818,468,203,201,2,69,1,0.074626866,0,empty,CD-0722-4
"D12,C3",11361,12632,8451,4181,6570,3356,0,3357,2301,1056,2.178977273,1915,1007,218,87,82,5,17,1,0.231707317,0,empty,CD-0722-4
"D12,C4",6142,6573,4611,1962,3552,1732,1,1735,1181,554,2.131768953,958,1943,465,175,173,2,43,2,0.138728324,0,empty,CD-0722-4
"D12,C5",8936,9864,6660,3204,5105,2522,3,2534,1691,843,2.005931198,1427,1339,330,131,131,0,34,0,0.221374046,0,empty,CD-0722-4
"D12,C6",6953,7748,5044,2704,4031,2064,1,2065,1317,748,1.760695187,1184,1519,317,169,164,5,36,2,0.067073171,0,empty,CD-0722-4
"D12,C7",1011653,1247740,721114,526626,603902,366638,0,366940,292926,74014,3.957710703,227750,10494,2527,1049,1032,17,240,2,0.063953488,0,hg38,CD-0722-4
"D12,C8",10525,11516,7826,3690,5828,2913,1,2916,1973,943,2.092258749,1632,2535,555,217,214,3,63,1,0.028037383,0,empty,CD-0722-4
"D12,C9",821279,999537,590397,409140,487561,285607,2,285828,235031,50797,4.626867728,176263,85423,14636,6026,5901,125,994,6,0.073716319,0,hg38,CD-0722-4
"D12,C10",2500137,2775637,1903784,871853,1290186,670590,8,671287,529611,141676,3.738184308,378809,252725,33272,13323,13031,292,1968,11,0.035146957,0,hg38,CD-0722-4
"D12,C11",7762,8258,5576,2682,4392,2150,0,2153,1386,767,1.807040417,1225,1828,370,140,138,2,47,2,0.007246377,0,empty,CD-0722-4
"D12,C12",10002,10705,7371,3334,5600,2638,0,2642,1802,840,2.145238095,1433,2005,693,257,257,0,52,0,0.06614786,0,empty,CD-0722-4
"D12,D1",8954,10045,6673,3372,5237,2693,0,2696,1586,1110,1.428828829,1561,887,236,92,91,1,23,1,0.120879121,0,empty,CD-0722-4
"D12,D2",931851,1073350,704383,368967,519079,276503,10,276779,225426,51353,4.389733803,159767,78760,14839,5668,5590,78,1067,4,0.059928444,0,hg38,CD-0722-4
"D12,D3",744358,858260,555107,303153,420147,222654,6,222875,176057,46818,3.76045538,131294,98579,10244,3915,3793,122,777,7,0.064329027,0,hg38,CD-0722-4
"D12,D4",5233,5865,3776,2089,3162,1657,0,1659,1121,538,2.083643123,991,1322,272,134,134,0,38,0,0.052238806,0,empty,CD-0722-4
"D12,D5",6194,6817,4520,2297,3657,1796,0,1800,1142,658,1.73556231,1052,1558,283,122,121,1,40,1,0.008264463,0,empty,CD-0722-4
"D12,D6",9202,10095,6608,3487,5156,2732,0,2736,1688,1048,1.610687023,1562,1673,396,164,164,0,51,0,0.036585366,0,empty,CD-0722-4
"D12,D7",5110,5570,3806,1764,2990,1382,0,1384,877,507,1.729783037,772,1536,296,112,111,1,37,1,0.018018018,0,empty,CD-0722-4
"D12,D8",6004,6593,4345,2248,3512,1761,0,1763,1148,615,1.866666667,1057,1097,257,87,86,1,40,1,0.046511628,0,empty,CD-0722-4
"D12,D9",3349,3569,2525,1044,1900,882,0,882,621,261,2.379310345,479,1362,307,135,135,0,43,0,0.066666667,0,empty,CD-0722-4
"D12,D10",6583,7396,4750,2646,3923,2036,0,2038,1298,740,1.754054054,1245,924,144,69,69,0,26,0,0.028985507,0,empty,CD-0722-4
"D12,D11",6453,7102,4910,2192,3700,1769,0,1776,1170,606,1.930693069,955,2463,374,168,166,2,52,1,0.024096386,0,empty,CD-0722-4
"D12,D12",8869,9521,6417,3104,5017,2484,1,2485,1596,889,1.795275591,1451,3553,925,367,365,2,105,2,0.073972603,0,empty,CD-0722-4
"D12,E1",895819,1022696,669794,352902,493379,262499,1,262752,200851,61901,3.244713333,152786,155653,21180,8285,8102,183,1289,7,0.071957541,0,hg38,CD-0722-4
"D12,E2",7705,8542,5589,2953,4579,2365,0,2368,1506,862,1.747099768,1397,1797,401,182,180,2,52,2,0.083333333,0,empty,CD-0722-4
"D12,E3",5571,5902,4299,1603,3099,1420,4,1424,932,492,1.894308943,727,1966,484,212,210,2,53,1,0.080952381,0,empty,CD-0722-4
"D12,E4",7696,8300,5630,2670,4477,2225,0,2227,1507,720,2.093055556,1279,1957,456,204,202,2,75,1,0.034653465,0,empty,CD-0722-4
"D12,E5",6624,7132,4995,2137,3736,1687,1,1690,1129,561,2.012477718,913,1486,371,113,109,4,33,1,0.119266055,0,empty,CD-0722-4
"D12,E6",11152,12257,8262,3995,6286,3236,0,3238,2046,1192,1.716442953,1855,2409,571,272,271,1,82,1,0.062730627,0,empty,CD-0722-4
"D12,E7",10400,10918,7691,3227,5914,2827,0,2830,1878,952,1.972689076,1563,2818,615,232,229,3,68,3,0.034934498,0,empty,CD-0722-4
"D12,E8",8713,9216,6639,2577,4819,2221,0,2223,1425,798,1.785714286,1166,2262,605,224,222,2,65,1,0.148648649,0,empty,CD-0722-4
"D12,E9",4792,5151,3482,1669,2778,1358,10,1369,914,455,2.008791209,755,2556,632,284,280,4,77,3,0.003571429,0,empty,CD-0722-4
"D12,E10",6710,7282,4957,2325,3857,1880,0,1883,1208,675,1.78962963,1106,1789,402,182,179,3,53,1,0.17877095,0,empty,CD-0722-4
"D12,E11",7552,8244,5557,2687,4293,2191,0,2195,1390,805,1.726708075,1224,1984,430,157,151,6,46,1,0,0,empty,CD-0722-4
"D12,E12",7492,8453,5461,2992,4451,2243,5,2248,1438,810,1.775308642,1385,1704,500,195,193,2,46,2,0.088082902,0,empty,CD-0722-4
"D12,F1",9223,9972,6829,3143,5143,2531,0,2534,1556,978,1.591002045,1403,1409,276,134,133,1,50,1,0.07518797,0,empty,CD-0722-4
"D12,F2",875887,1026434,640253,386181,498357,279600,12,279849,221782,58067,3.819415503,167691,157432,28803,11036,10905,131,1670,6,0.05823017,0,hg38,CD-0722-4
"D12,F3",579032,695590,400082,295508,341377,219233,6,219398,158602,60796,2.608757155,132260,4413,960,328,322,6,93,2,0.096273292,0,hg38,CD-0722-4
"D12,F4",10982,11669,8153,3516,5998,2766,1,2771,1776,995,1.784924623,1476,603,113,53,53,0,22,0,0.075471698,0,empty,CD-0722-4
"D12,F5",9276,9944,6890,3054,5105,2368,31,2405,1527,878,1.739179954,1354,2198,496,178,178,0,54,0,0.123595506,0,empty,CD-0722-4
"D12,F6",8453,9359,6167,3192,4937,2568,4,2572,1663,909,1.829482948,1478,3912,1020,446,436,10,114,2,0.116972477,0,empty,CD-0722-4
"D12,F7",10542,11593,7770,3823,6429,3230,0,3234,2124,1110,1.913513514,1869,1334,262,110,106,4,32,2,0.009433962,0,empty,CD-0722-4
"D12,F8",6745,7071,5039,2032,3797,1798,0,1800,1161,639,1.816901408,942,361,84,35,35,0,15,0,0.314285714,0,empty,CD-0722-4
"D12,F9",9159,9806,6884,2922,5111,2498,0,2500,1754,746,2.351206434,1342,2737,717,278,276,2,76,2,0.02173913,0,empty,CD-0722-4
"D12,F10",9683,10624,7311,3313,5513,2598,1,2606,1679,927,1.811218986,1477,2219,527,217,215,2,58,1,0.079069767,0,empty,CD-0722-4
"D12,F11",6955,7383,5260,2123,3837,1757,0,1757,1177,580,2.029310345,994,1720,301,131,121,10,44,4,0.049586777,0,empty,CD-0722-4
"D12,F12",848971,963136,631323,331813,462524,243074,0,243302,190430,52872,3.601717355,142696,14978,1699,747,723,24,157,2,0.095435685,0,hg38,CD-0722-4
"D12,G1",10770,11759,7969,3790,6158,3079,0,3085,1983,1102,1.799455535,1758,3485,785,307,306,1,93,1,0.120915033,0,empty,CD-0722-4
"D12,G2",5430,5963,3882,2081,2950,1452,25,1482,931,551,1.689655172,853,304,49,27,27,0,14,0,0,0,empty,CD-0722-4
"D12,G3",970617,1170387,677803,492584,568208,364078,1,364353,259262,105091,2.467023817,221890,33188,2085,788,753,35,164,4,0.304116866,0,hg38,CD-0722-4
"D12,G4",17692,20051,12767,7284,10269,5657,41,5705,3521,2184,1.612179487,3318,81,8,6,6,0,3,0,0,0,empty,CD-0722-4
"D12,G5",6455,7196,4706,2490,3770,1939,2,1944,1250,694,1.801152738,1162,1497,272,127,123,4,25,1,0.048780488,0,empty,CD-0722-4
"D12,G6",8890,9890,6634,3256,5098,2472,0,2472,1653,819,2.018315018,1403,215,22,16,16,0,9,0,0.0625,0,empty,CD-0722-4
"D12,G7",7547,8278,5635,2643,4336,2049,0,2053,1322,731,1.808481532,1136,2001,486,250,248,2,70,1,0.044354839,0,empty,CD-0722-4
"D12,G8",5011,5473,3593,1880,2942,1414,0,1414,900,514,1.750972763,837,1720,400,176,176,0,56,0,0.159090909,0,empty,CD-0722-4
"D12,G9",6644,7232,4926,2306,3731,1843,0,1845,1215,630,1.928571429,1019,2344,458,218,218,0,80,0,0.114678899,0,empty,CD-0722-4
"D12,G10",7417,8100,5521,2579,4211,2053,0,2058,1331,727,1.830811554,1141,2259,542,246,244,2,63,1,0.032786885,0,empty,CD-0722-4
"D12,G11",807047,903402,613568,289834,437057,219693,1,219897,177459,42438,4.181606108,124017,129844,19257,7614,7444,170,1347,5,0.036942504,0,hg38,CD-0722-4
"D12,G12",6153,6691,4493,2198,3637,1825,0,1825,1157,668,1.732035928,1052,2163,368,152,151,1,46,1,0.039735099,0,empty,CD-0722-4
"D12,H1",12202,13117,9069,4048,6803,3241,0,3248,2306,942,2.447983015,1874,4438,938,330,326,4,77,2,0.067484663,0,empty,CD-0722-4
"D12,H2",7121,7597,5335,2262,3879,1822,0,1822,1164,658,1.76899696,995,2059,519,215,215,0,66,0,0.11627907,0,empty,CD-0722-4
"D12,H3",6522,7397,4738,2659,3805,2032,0,2037,1321,716,1.844972067,1167,1486,407,168,168,0,44,0,0,0,empty,CD-0722-4
"D12,H4",9078,9835,6556,3279,4994,2477,3,2484,1597,887,1.800450958,1428,90,10,7,7,0,5,0,0,0,empty,CD-0722-4
"D12,H5",10909,12031,8159,3872,6064,3039,0,3040,2033,1007,2.018867925,1672,2662,687,297,294,3,63,1,0.057823129,0,empty,CD-0722-4
"D12,H6",6008,6449,4340,2109,3415,1805,0,1807,1186,621,1.909822866,1014,2360,504,201,200,1,55,1,0.17,0,empty,CD-0722-4
"D12,H7",6616,7167,4933,2234,3827,1820,22,1847,1242,605,2.052892562,1058,1824,326,135,134,1,42,1,0.141791045,0,empty,CD-0722-4
"D12,H8",7497,8361,5584,2777,4280,2118,0,2120,1388,732,1.896174863,1154,2259,504,225,221,4,80,2,0.135746606,0,empty,CD-0722-4
"D12,H9",5831,6226,4405,1821,3164,1471,5,1482,1023,459,2.22875817,781,839,172,76,76,0,28,0,0.210526316,0,empty,CD-0722-4
"D12,H10",5115,5573,3875,1698,2903,1395,9,1404,930,474,1.962025316,790,1251,211,105,101,4,39,1,0.108910891,0,empty,CD-0722-4
"D12,H11",6567,7305,4634,2671,3886,2268,1,2274,1250,1024,1.220703125,1334,32,4,3,3,0,2,0,0,0,empty,CD-0722-4
"D12,H12",5364,5834,3869,1965,3009,1533,0,1535,973,562,1.731316726,850,1548,394,134,134,0,33,0,0.02238806,0,empty,CD-0722-4
"E1,A1",8743,10172,6291,3881,5417,2856,27,2894,1949,945,2.062433862,1749,1643,388,179,177,2,46,2,0.124293785,0,empty,CD-0722-4
"E1,A2",12404,13726,9320,4406,7316,3816,0,3822,2527,1295,1.951351351,2166,3254,783,283,281,2,63,2,0.074733096,0,empty,CD-0722-4
"E1,A3",8085,8768,6042,2726,4672,2345,0,2345,1576,769,2.049414824,1320,1406,346,172,168,4,49,2,0.130952381,0,empty,CD-0722-4
"E1,A4",11827,13307,8821,4486,7024,3490,0,3494,2259,1235,1.829149798,2000,876,214,96,93,3,31,1,0.053763441,0,empty,CD-0722-4
"E1,A5",16715,18517,12549,5968,9791,4786,0,4798,3334,1464,2.277322404,2747,6080,1159,460,455,5,108,3,0.061538462,0,empty,CD-0722-4
"E1,A6",571551,668382,430418,237964,333435,177582,1,177746,136052,41694,3.263107402,104384,170323,23821,9505,9308,197,1382,6,0.050601633,0,hg38,CD-0722-4
"E1,A7",8164,9236,6021,3215,4919,2630,15,2647,1747,900,1.941111111,1547,1748,406,129,128,1,37,1,0.0078125,0,empty,CD-0722-4
"E1,A8",634076,769969,463930,306039,383543,220226,5,220411,176426,43985,4.011049221,134313,137997,24152,9243,9106,137,1580,7,0.043158357,0,hg38,CD-0722-4
"E1,A9",10950,12242,8132,4110,6513,3312,0,3312,2298,1014,2.266272189,1890,2508,493,199,197,2,72,1,0.091370558,0,empty,CD-0722-4
"E1,A10",860988,1009128,647336,361792,500249,273020,2,273252,227890,45362,5.023808474,159721,34576,4926,1968,1950,18,427,2,0.029230769,0,hg38,CD-0722-4
"E1,A11",7879,8832,6095,2737,4652,2252,0,2255,1512,743,2.034993271,1258,1520,320,106,105,1,35,1,0.038095238,0,empty,CD-0722-4
"E1,A12",12930,14356,9883,4473,7634,3794,0,3796,2703,1093,2.473010064,2111,4409,959,398,394,4,106,1,0.078680203,0,empty,CD-0722-4
"E1,B1",828720,909427,633682,275745,445247,219025,0,219246,173613,45633,3.804549339,121860,88553,12131,4603,4512,91,817,6,0.036569149,0,hg38,CD-0722-4
"E1,B2",8977,10045,6050,3995,5246,2825,0,2829,1725,1104,1.5625,1757,890,180,56,55,1,23,1,0.109090909,0,empty,CD-0722-4
"E1,B3",8846,9927,6479,3448,5331,2759,2,2767,1887,880,2.144318182,1638,2869,542,235,233,2,60,1,0.206008584,0,empty,CD-0722-4
"E1,B4",8819,10048,6498,3550,5346,2856,0,2858,1940,918,2.11328976,1653,1646,254,130,123,7,46,2,0.162601626,0,empty,CD-0722-4
"E1,B5",9448,5743,3599,2144,3797,2001,11,2029,1392,637,2.185243328,1247,1195,225,107,106,1,41,1,0.075471698,0,empty,CD-0722-4
"E1,B6",408803,481801,281810,199991,242323,150059,0,150205,117637,32568,3.612042496,91709,11830,4065,1351,1338,13,324,2,0.027653214,0,hg38,CD-0722-4
"E1,B7",1096463,1258947,820276,438671,619815,334044,7,334323,255230,79093,3.226960667,193692,208639,33263,12712,12501,211,1776,5,0.053915687,0,hg38,CD-0722-4
"E1,B8",9350,10280,7235,3045,5342,2611,0,2614,1792,822,2.180048662,1377,1919,310,144,142,2,42,1,0.105633803,0,empty,CD-0722-4
"E1,B9",767735,868795,575215,293580,427594,220970,0,221185,174869,46316,3.77556352,128380,95223,13319,5191,5077,114,849,7,0.048059878,0,hg38,CD-0722-4
"E1,B10",7654,8533,5500,3033,4776,2483,0,2485,1700,785,2.165605096,1422,641,103,62,61,1,24,1,0.032786885,0,empty,CD-0722-4
"E1,B11",15179,17062,11095,5967,8860,4753,20,4779,3015,1764,1.709183673,2766,217,27,13,13,0,7,0,0.307692308,0,empty,CD-0722-4
"E1,B12",836280,998348,602780,395568,498876,289597,0,289870,248601,41269,6.023916257,176389,147116,20064,7747,7601,146,1381,6,0.049730299,0,hg38,CD-0722-4
"E1,C1",21405,23472,16049,7423,12468,6259,1,6267,4098,2169,1.889349931,3443,2375,430,171,169,2,48,2,0.071005917,0,empty,CD-0722-4
"E1,C2",13017,14167,9549,4618,7458,3784,0,3786,2582,1204,2.144518272,2076,2640,794,336,327,9,89,2,0.146788991,0,empty,CD-0722-4
"E1,C3",13418,14886,10000,4886,8041,4077,0,4082,2629,1453,1.809359945,2381,2016,482,175,174,1,37,1,0.212643678,0,empty,CD-0722-4
"E1,C4",9368,10140,7018,3122,5527,2705,0,2715,1927,788,2.445431472,1510,2139,527,232,232,0,57,0,0.004310345,0,empty,CD-0722-4
"E1,C5",12251,13889,9018,4871,7329,3815,0,3821,2522,1299,1.941493457,2236,2138,563,227,222,5,55,2,0.162162162,0,empty,CD-0722-4
"E1,C6",10859,12118,7950,4168,6529,3386,0,3400,2278,1122,2.03030303,1958,2242,500,207,206,1,54,1,0.029126214,0,empty,CD-0722-4
"E1,C7",13257,15304,9718,5586,8055,4375,0,4387,2668,1719,1.552065154,2588,662,181,71,62,9,17,2,0.193548387,0,empty,CD-0722-4
"E1,C8",15151,16778,11152,5626,8904,4593,0,4599,3135,1464,2.141393443,2625,4343,1078,411,405,6,102,2,0.07654321,0,empty,CD-0722-4
"E1,C9",12471,13994,9242,4752,7413,3873,1,3878,2722,1156,2.35467128,2171,1885,454,186,184,2,56,2,0.054347826,0,empty,CD-0722-4
"E1,C10",11908,12928,8918,4010,6886,3372,2,3380,2279,1101,2.069936421,1878,2808,759,313,311,2,72,1,0.041800643,0,empty,CD-0722-4
"E1,C11",1021636,1173194,752708,420486,575499,315373,18,315671,249806,65865,3.792697184,186117,78218,9574,3590,3466,124,754,6,0.031159838,0,hg38,CD-0722-4
"E1,C12",16531,18623,12358,6265,9792,4911,0,4912,3419,1493,2.290020094,2868,2895,678,275,274,1,73,1,0.131386861,0,empty,CD-0722-4
"E1,D1",12461,13955,8996,4959,7417,3925,5,3933,2424,1509,1.606361829,2273,1204,216,95,90,5,24,2,0.022222222,0,empty,CD-0722-4
"E1,D2",9881,10841,7668,3173,5688,2628,28,2660,1715,945,1.814814815,1492,4278,1154,406,404,2,95,1,0.012376238,0,empty,CD-0722-4
"E1,D3",9653,10762,7130,3632,5654,2893,0,2893,1995,898,2.221603563,1647,1875,455,198,196,2,65,2,0.158163265,0,empty,CD-0722-4
"E1,D4",861276,1013722,638993,374729,502047,275498,1,275724,212161,63563,3.337806586,164704,114714,16657,6259,6119,140,1090,5,0.044941984,0,hg38,CD-0722-4
"E1,D5",832752,950760,621105,329655,474615,266497,1,266713,177943,88770,2.004539822,155361,37521,11989,4392,4359,33,686,3,0.01674696,0,hg38,CD-0722-4
"E1,D6",11916,13420,8487,4933,6870,3770,0,3776,2369,1407,1.683724236,2193,2255,518,224,219,5,57,2,0.03196347,0,empty,CD-0722-4
"E1,D7",721583,791201,551265,239936,390616,189045,3,189242,142854,46388,3.079546434,105692,147749,18265,7098,6923,175,1222,7,0.040011556,0,hg38,CD-0722-4
"E1,D8",842805,936570,646266,290304,460031,225823,2,226051,170666,55385,3.081448045,128430,118528,11061,4123,3986,137,734,6,0.039889614,0,hg38,CD-0722-4
"E1,D9",4975,5625,3639,1986,2927,1454,0,1458,971,487,1.993839836,864,2028,514,164,164,0,44,0,0.054878049,0,empty,CD-0722-4
"E1,D10",10643,12054,7756,4298,6510,3667,0,3669,2421,1248,1.939903846,2135,1337,378,148,144,4,28,2,0.055555556,0,empty,CD-0722-4
"E1,D11",9464,10351,7000,3351,5342,2596,0,2598,1756,842,2.085510689,1454,3549,975,437,430,7,93,2,0.072093023,0,empty,CD-0722-4
"E1,D12",13570,15081,10168,4913,8114,4080,1,4088,2793,1295,2.156756757,2290,4606,1260,528,510,18,132,2,0.074509804,0,empty,CD-0722-4
"E1,E1",17970,19689,13365,6324,10320,5201,25,5229,3490,1739,2.006900518,2941,3846,747,337,331,6,90,3,0.045317221,0,empty,CD-0722-4
"E1,E2",762177,914780,525902,388878,458125,296994,1,297225,198766,98459,2.018769234,179498,46973,2372,894,806,88,176,4,0.271712159,0,hg38,CD-0722-4
"E1,E3",7055,8059,5326,2733,4170,2066,2,2068,1362,706,1.92917847,1187,2854,833,359,357,2,96,1,0.056022409,0,empty,CD-0722-4
"E1,E4",12314,13970,9196,4774,7472,3826,3,3833,2589,1244,2.081189711,2253,2407,603,280,274,6,73,2,0.058394161,0,empty,CD-0722-4
"E1,E5",8527,9282,6507,2775,4990,2322,13,2335,1614,721,2.238557559,1280,2132,761,274,272,2,58,1,0.047794118,0,empty,CD-0722-4
"E1,E6",17471,19128,12868,6260,9931,4985,0,4988,3332,1656,2.012077295,2779,4463,1195,422,418,4,110,2,0.110047847,0,empty,CD-0722-4
"E1,E7",1573179,1750336,1190521,559815,843033,434441,23,434866,353145,81721,4.32134947,247159,237300,24149,9146,8915,231,1612,8,0.025462703,0,hg38,CD-0722-4
"E1,E8",1212136,1347673,936238,411435,653762,322008,3,322343,260804,61539,4.238027917,179881,273587,38783,15119,14825,294,2017,7,0.037166948,0,hg38,CD-0722-4
"E1,E9",8388,9365,6215,3150,4844,2456,0,2457,1721,736,2.338315217,1417,3361,901,299,296,3,80,2,0.047297297,0,empty,CD-0722-4
"E1,E10",9079,10162,6685,3477,5341,2680,0,2685,1783,902,1.976718404,1563,2373,597,268,267,1,84,1,0.048689139,0,empty,CD-0722-4
"E1,E11",10494,11652,7845,3807,6127,3213,0,3214,2143,1071,2.000933707,1753,2536,553,212,207,5,58,2,0.149758454,0,empty,CD-0722-4
"E1,E12",12276,13591,8988,4603,7382,3796,0,3806,2623,1183,2.217244294,2285,2457,444,195,192,3,56,2,0.026041667,0,empty,CD-0722-4
"E1,F1",26882,28543,20850,7693,14792,6303,9,6324,4343,1981,2.192327108,3486,7654,2037,828,824,4,180,2,0.038834951,0,empty,CD-0722-4
"E1,F2",12671,13598,9467,4131,7077,3392,1,3396,2344,1052,2.228136882,1891,5200,1093,432,423,9,95,3,0.177304965,0,empty,CD-0722-4
"E1,F3",13957,15390,10318,5072,8192,4213,0,4219,2990,1229,2.432872254,2458,4561,1102,428,422,6,105,1,0.08056872,0,empty,CD-0722-4
"E1,F4",16106,17502,11636,5866,9284,4725,2,4733,3172,1561,2.03203075,2728,1013,276,97,97,0,28,0,0,0,empty,CD-0722-4
"E1,F5",11774,12753,8734,4019,6844,3305,0,3307,2185,1122,1.94741533,1869,2668,619,290,285,5,90,2,0.01754386,0,empty,CD-0722-4
"E1,F6",17253,20039,12726,7313,10613,5594,0,5594,3932,1662,2.365824308,3309,4127,950,413,411,2,114,2,0.094890511,0,empty,CD-0722-4
"E1,F7",5103257,5973595,3771709,2201886,2780392,1651657,12,1653186,1328762,324424,4.095757404,980217,183177,33031,13001,12807,194,1910,6,0.070898727,0,hg38,CD-0722-4
"E1,F8",1235465,1438954,918667,520287,704324,390438,29,390799,314489,76310,4.121202988,230629,10110,1379,585,571,14,120,2,0.056042032,0,hg38,CD-0722-4
"E1,F9",11270,12388,8555,3833,6569,3228,0,3236,2240,996,2.248995984,1772,3286,742,310,309,1,99,1,0.048543689,0,empty,CD-0722-4
"E1,F10",14610,16117,11099,5018,8643,4202,0,4206,2886,1320,2.186363636,2407,2257,531,213,213,0,76,0,0.079812207,0,empty,CD-0722-4
"E1,F11",10526,11461,8018,3443,5975,2866,1,2869,2023,846,2.391252955,1600,2259,393,140,138,2,49,1,0.079710145,0,empty,CD-0722-4
"E1,F12",11567,12349,8591,3758,6517,3191,0,3193,2198,995,2.209045226,1769,417,103,51,51,0,21,0,0,0,empty,CD-0722-4
"E1,G1",13164,14857,9829,5028,7847,3901,0,3902,2623,1279,2.050820954,2254,3161,867,379,377,2,93,1,0.177718833,0,empty,CD-0722-4
"E1,G2",6632,7281,4735,2546,3895,1980,0,1985,1278,707,1.807637907,1148,534,116,50,49,1,14,1,0.367346939,0,empty,CD-0722-4
"E1,G3",12692,13472,9341,4131,7151,3584,1,3585,2267,1318,1.720030349,1921,3741,982,366,364,2,92,1,0.131868132,0,empty,CD-0722-4
"E1,G4",23203,26071,16896,9175,13621,7425,1,7437,4669,2768,1.686777457,4302,121,35,16,15,1,6,1,0,0,empty,CD-0722-4
"E1,G5",7746,8571,5810,2761,4667,2328,6,2335,1546,789,1.959442332,1311,2195,570,208,206,2,55,1,0.029126214,0,empty,CD-0722-4
"E1,G6",12139,13719,9069,4650,7161,3589,0,3591,2495,1096,2.276459854,2049,305,39,20,18,2,12,1,0,0,empty,CD-0722-4
"E1,G7",1191934,1381032,886385,494647,677377,360785,0,361075,280970,80105,3.507521378,212764,8825,2856,886,876,10,310,2,0.03196347,0,hg38,CD-0722-4
"E1,G8",7932,8869,5887,2982,4713,2430,0,2430,1650,780,2.115384615,1363,2331,657,278,276,2,70,1,0.036231884,0,empty,CD-0722-4
"E1,G9",10359,11671,7740,3931,6190,3121,17,3142,2197,945,2.324867725,1817,3045,708,332,330,2,96,2,0.157575758,0,empty,CD-0722-4
"E1,G10",12723,14082,9545,4537,7411,3812,0,3814,2638,1176,2.243197279,2090,3475,713,315,312,3,100,2,0.073717949,0,empty,CD-0722-4
"E1,G11",986103,1113906,748730,365176,545459,279669,2,279904,219657,60247,3.645940877,159393,88630,14222,5321,5197,124,877,5,0.056955936,0,hg38,CD-0722-4
"E1,G12",8292,9201,6008,3193,4941,2609,1,2613,1739,874,1.989702517,1521,2827,603,219,217,2,60,1,0.078341014,0,empty,CD-0722-4
"E1,H1",832378,1017518,584935,432583,509890,324669,4,324969,237492,87477,2.714907919,198253,4485,1836,443,439,4,140,2,0.036446469,0,hg38,CD-0722-4
"E1,H2",9800,10999,7172,3827,5850,3048,9,3060,2026,1034,1.959381044,1781,4933,810,327,322,5,82,3,0.027950311,0,empty,CD-0722-4
"E1,H3",10146,11640,7456,4184,6126,3276,2,3285,2212,1073,2.061509786,1912,1995,443,170,169,1,47,1,0.041420118,0,empty,CD-0722-4
"E1,H4",12276,13222,9085,4137,6897,3364,0,3364,2257,1107,2.038843722,1880,162,35,21,21,0,9,0,0,0,empty,CD-0722-4
"E1,H5",13149,14713,9712,5001,7729,3940,18,3963,2748,1215,2.261728395,2267,2942,822,284,283,1,69,1,0.077738516,0,empty,CD-0722-4
"E1,H6",9531,11083,6987,4096,5841,3139,6,3145,2143,1002,2.138722555,1858,2453,629,276,274,2,87,2,0.018248175,0,empty,CD-0722-4
"E1,H7",1129066,1392461,738874,653587,701449,492695,19,493048,426708,66340,6.432137474,302896,12707,1559,458,424,34,136,2,0.058962264,0,hg38,CD-0722-4
"E1,H8",14554,16559,10617,5942,8803,4722,0,4727,3283,1444,2.273545706,2818,3073,644,285,280,5,90,2,0.15,0,empty,CD-0722-4
"E1,H9",9490,10267,7289,2978,5417,2534,0,2537,1745,792,2.203282828,1361,1552,407,181,180,1,55,1,0.022222222,0,empty,CD-0722-4
"E1,H10",9481,10643,7012,3631,5548,2827,0,2829,1985,844,2.351895735,1636,2318,610,248,245,3,68,1,0.081632653,0,empty,CD-0722-4
"E1,H11",7971,9062,5603,3459,4691,2743,0,2746,1529,1217,1.256368118,1611,28,10,4,4,0,4,0,0,0,empty,CD-0722-4
"E1,H12",9553,10760,6918,3842,5521,2888,3,2896,2032,864,2.351851852,1681,1772,333,143,143,0,30,0,0.118881119,0,empty,CD-0722-4
"E2,A1",7449,8349,5467,2882,4392,2194,24,2220,1439,781,1.842509603,1290,1691,269,135,134,1,43,1,0.02238806,0,empty,CD-0722-4
"E2,A2",10256,11245,7532,3713,5896,2938,0,2947,1868,1079,1.731232623,1700,2364,337,153,152,1,51,1,0.039473684,0,empty,CD-0722-4
"E2,A3",6692,7262,5020,2242,3883,1903,0,1903,1271,632,2.011075949,1027,1719,497,173,173,0,50,0,0.132947977,0,empty,CD-0722-4
"E2,A4",11972,12901,8884,4017,6812,3396,0,3396,2244,1152,1.947916667,1881,1160,294,113,109,4,18,1,0.036697248,0,empty,CD-0722-4
"E2,A5",616315,663674,472859,190815,330211,153363,7,153524,126031,27493,4.584112319,85068,47771,9075,3569,3543,26,606,6,0.018628281,0,hg38,CD-0722-4
"E2,A6",23472,26454,17016,9438,13861,7949,0,7956,5046,2910,1.734020619,4528,4132,926,444,437,7,107,2,0.073226545,0,empty,CD-0722-4
"E2,A7",7328,8140,5355,2785,4346,2307,0,2307,1516,791,1.916561315,1311,1984,240,112,112,0,42,0,0.017857143,0,empty,CD-0722-4
"E2,A8",4362,4717,3268,1449,2581,1254,1,1257,898,359,2.501392758,695,2414,484,220,218,2,77,1,0.055045872,0,empty,CD-0722-4
"E2,A9",7699,8513,5721,2792,4460,2248,0,2248,1503,745,2.017449664,1204,2097,421,203,203,0,67,0,0.108374384,0,empty,CD-0722-4
"E2,A10",323321,386157,227163,158994,193739,117747,16,117861,89190,28671,3.110808831,71767,1080,374,147,147,0,38,0,0.19047619,0,hg38,CD-0722-4
"E2,A11",6207,6619,4667,1952,3568,1656,0,1660,1120,540,2.074074074,900,1733,388,148,146,2,39,1,0.226027397,0,empty,CD-0722-4
"E2,A12",9106,9845,6956,2889,5170,2452,8,2460,1639,821,1.99634592,1334,4417,1001,425,423,2,104,1,0.101654846,0,empty,CD-0722-4
"E2,B1",7775,8516,5818,2698,4433,2202,17,2223,1418,805,1.761490683,1265,1260,431,185,183,2,41,1,0.049180328,0,empty,CD-0722-4
"E2,B2",8700,9711,5993,3718,5073,2773,0,2781,1771,1010,1.753465347,1682,552,71,34,34,0,15,0,0.029411765,0,empty,CD-0722-4
"E2,B3",6574,7215,4875,2340,3857,1915,0,1919,1271,648,1.961419753,1117,1651,433,188,183,5,45,2,0.06010929,0,empty,CD-0722-4
"E2,B4",7222,7853,5294,2559,4210,2217,0,2217,1393,824,1.690533981,1253,2224,452,204,202,2,51,1,0.03960396,0,empty,CD-0722-4
"E2,B5",12761,10567,6506,4061,6117,3353,0,3365,2456,909,2.701870187,2088,1264,254,110,109,1,37,1,0.073394495,0,empty,CD-0722-4
"E2,B6",8498,9344,6176,3168,4960,2560,9,2569,1676,893,1.876819709,1468,2435,431,191,190,1,57,1,0.073684211,0,empty,CD-0722-4
"E2,B7",8580,9610,6526,3084,4970,2316,45,2365,1588,777,2.043758044,1332,1711,335,139,139,0,42,0,0.100719424,0,empty,CD-0722-4
"E2,B8",685673,768290,519452,248838,375608,189732,1,189901,144109,45792,3.147034416,108184,62941,5475,2119,2063,56,459,3,0.048957828,0,hg38,CD-0722-4
"E2,B9",10728,11889,7864,4025,6165,3204,2,3213,2095,1118,1.873881932,1795,1267,143,66,66,0,25,0,0.090909091,0,empty,CD-0722-4
"E2,B10",1694432,1865756,1179473,686283,960644,534087,26,535535,433556,101979,4.251424313,319661,170098,24617,9705,9543,162,1443,4,0.067169653,0,hg38,CD-0722-4
"E2,B11",18702,20375,13810,6565,10284,5177,0,5181,3208,1973,1.625950329,2938,284,41,15,15,0,9,0,0,0,empty,CD-0722-4
"E2,B12",7376,8059,5380,2679,4278,2174,4,2180,1462,718,2.036211699,1226,1970,375,141,137,4,55,2,0.04379562,0,empty,CD-0722-4
"E2,C1",15084,16399,11501,4898,8704,4216,5,4230,2730,1500,1.82,2386,1139,271,110,109,1,43,1,0.055045872,0,empty,CD-0722-4
"E2,C2",2084176,2403323,1505798,897525,1147950,680083,2,680660,511480,169180,3.023288805,400288,80346,13986,5208,5119,89,943,4,0.052158625,0,hg38,CD-0722-4
"E2,C3",12110,13446,8966,4480,7031,3485,34,3519,2285,1234,1.851701783,1988,928,285,123,122,1,34,1,0.032786885,0,empty,CD-0722-4
"E2,C4",7391,8200,5669,2531,4304,2052,1,2055,1401,654,2.142201835,1140,2211,608,248,247,1,62,1,0.113360324,0,empty,CD-0722-4
"E2,C5",12048,13519,8909,4610,7080,3539,13,3553,2418,1135,2.130396476,2035,2442,373,176,174,2,42,2,0.028735632,0,empty,CD-0722-4
"E2,C6",972009,1062772,750932,311840,525340,246924,1,247207,185543,61664,3.008935522,138816,99642,9239,3646,3510,136,693,5,0.034472934,0,hg38,CD-0722-4
"E2,C7",12240,13922,8806,5116,7214,3991,0,3991,2515,1476,1.703929539,2338,378,18,14,13,1,9,1,0,0,empty,CD-0722-4
"E2,C8",12843,14339,9402,4937,7569,3879,0,3881,2612,1269,2.058313633,2250,3870,702,317,313,4,81,2,0.143769968,0,empty,CD-0722-4
"E2,C9",9533,10303,7005,3298,5494,2737,5,2744,1815,929,1.953713671,1517,2000,329,146,143,3,48,2,0.013986014,0,empty,CD-0722-4
"E2,C10",11030,11658,8361,3297,5998,2797,24,2822,1886,936,2.014957265,1480,2866,837,325,322,3,71,2,0.071428571,0,empty,CD-0722-4
"E2,C11",9757,10947,7196,3751,5649,2838,0,2844,1885,959,1.965589155,1594,2397,614,221,218,3,57,2,0.091743119,0,empty,CD-0722-4
"E2,C12",977030,1044386,767720,276666,500704,221667,19,221965,164747,57218,2.879286239,119121,124524,21746,8032,7904,128,1193,5,0.026189271,0,hg38,CD-0722-4
"E2,D1",11159,12462,7997,4465,6535,3437,0,3444,2121,1323,1.603174603,1996,1014,148,57,56,1,17,1,0.089285714,0,empty,CD-0722-4
"E2,D2",9700,10196,7348,2848,5392,2404,11,2423,1577,846,1.864066194,1311,3431,969,365,364,1,81,1,0.131868132,0,empty,CD-0722-4
"E2,D3",1613920,1821504,1210338,611166,880994,464252,2,464729,356399,108330,3.289938152,270048,155209,16935,6721,6550,171,1125,8,0.032824427,0,hg38,CD-0722-4
"E2,D4",6573,7197,4869,2328,3907,1986,0,1986,1298,688,1.886627907,1132,1538,270,118,116,2,44,1,0.068965517,0,empty,CD-0722-4
"E2,D5",7537,8268,5616,2652,4324,2126,0,2126,1371,755,1.81589404,1214,1598,352,136,136,0,48,0,0.014705882,0,empty,CD-0722-4
"E2,D6",11789,13144,8509,4635,6698,3501,17,3524,2128,1396,1.524355301,2055,2842,546,224,221,3,66,2,0.018099548,0,empty,CD-0722-4
"E2,D7",6402,6890,4680,2210,3662,1786,1,1787,1178,609,1.934318555,993,2933,560,229,222,7,53,2,0.112612613,0,empty,CD-0722-4
"E2,D8",8193,8814,6098,2716,4773,2306,2,2309,1517,792,1.91540404,1321,2183,552,164,160,4,38,1,0.08125,0,empty,CD-0722-4
"E2,D9",5340,5533,3858,1675,2994,1362,15,1378,951,427,2.227166276,795,1605,403,168,168,0,46,0,0.029761905,0,empty,CD-0722-4
"E2,D10",9270,10342,6879,3463,5431,2847,0,2850,1915,935,2.048128342,1630,904,114,62,60,2,23,2,0.083333333,0,empty,CD-0722-4
"E2,D11",678208,736644,522446,214198,361919,170574,0,170774,132510,38264,3.463046205,94773,66748,14680,5034,4940,94,785,3,0.025506073,0,hg38,CD-0722-4
"E2,D12",859359,947472,662005,285467,460385,218172,1,218364,162929,55435,2.939099847,122962,186732,26803,10264,10044,220,1529,8,0.031362007,0,hg38,CD-0722-4
"E2,E1",14503,15578,10781,4797,8070,3961,0,3963,2503,1460,1.714383562,2138,3871,833,357,353,4,88,2,0.082152975,0,empty,CD-0722-4
"E2,E2",921929,1067304,685429,381875,521488,279185,1,279464,208546,70918,2.940663865,165968,119045,11686,4611,4449,162,808,5,0.053045628,0,hg38,CD-0722-4
"E2,E3",6725,7459,5186,2273,3899,1841,16,1858,1193,665,1.793984962,1028,2917,740,282,277,5,75,2,0.101083032,0,empty,CD-0722-4
"E2,E4",2080570,2529143,1476662,1052481,1215584,743108,4,743731,604637,139094,4.346966799,458956,290328,55301,21861,21551,310,2690,9,0.061528467,0,hg38,CD-0722-4
"E2,E5",8061,8799,6104,2695,4628,2121,0,2122,1379,743,1.855989233,1193,1931,463,161,160,1,40,1,0.04375,0,empty,CD-0722-4
"E2,E6",14220,15395,10561,4834,8075,4031,0,4036,2640,1396,1.891117479,2258,4675,976,388,384,4,90,3,0.088541667,0,empty,CD-0722-4
"E2,E7",770434,919980,535991,383989,459407,296548,5,296737,187023,109714,1.704641158,178979,7507,1551,509,498,11,143,2,0.13253012,0,hg38,CD-0722-4
"E2,E8",11226,12420,8553,3867,6552,3134,1,3139,2117,1022,2.071428571,1815,3777,789,287,281,6,83,2,0.035587189,0,empty,CD-0722-4
"E2,E9",6155,6801,4580,2221,3638,1843,0,1847,1258,589,2.13582343,1029,3097,552,224,217,7,63,2,0.082949309,0,empty,CD-0722-4
"E2,E10",8262,9045,6147,2898,4758,2285,0,2287,1545,742,2.082210243,1303,2127,521,210,208,2,47,1,0.091346154,0,empty,CD-0722-4
"E2,E11",9335,10100,6954,3146,5291,2629,0,2629,1718,911,1.885839737,1411,2299,537,199,199,0,56,0,0.085427136,0,empty,CD-0722-4
"E2,E12",1441285,1665820,1085476,580344,807744,439776,1,440158,365037,75121,4.859320297,257497,199092,21034,8263,8025,238,1408,10,0.056697819,0,hg38,CD-0722-4
"E2,F1",1011503,1137092,753669,383423,551880,288759,4,289031,246644,42387,5.818859556,166271,132961,21386,8424,8289,135,1402,7,0.038967306,0,hg38,CD-0722-4
"E2,F2",8793,9559,6357,3202,4973,2516,0,2521,1595,926,1.722462203,1428,3201,889,355,354,1,77,1,0.118644068,0,empty,CD-0722-4
"E2,F3",9257,10259,6806,3453,5386,2645,0,2650,1755,895,1.960893855,1543,3176,618,220,219,1,91,1,0.127853881,0,empty,CD-0722-4
"E2,F4",14195,15041,10337,4704,7830,3759,0,3763,2498,1265,1.974703557,2151,727,181,78,78,0,35,0,0.153846154,0,empty,CD-0722-4
"E2,F5",10652,11431,7961,3470,6015,2833,0,2836,1835,1001,1.833166833,1547,2798,704,247,244,3,66,1,0.102459016,0,empty,CD-0722-4
"E2,F6",11389,13179,8292,4887,7041,3857,0,3859,2601,1258,2.067567568,2315,3931,906,401,400,1,114,1,0.08,0,empty,CD-0722-4
"E2,F7",12225,13545,9009,4536,7088,3594,1,3600,2427,1173,2.069053708,2039,1511,443,161,160,1,49,1,0.0125,0,empty,CD-0722-4
"E2,F8",9463,10301,7124,3177,5407,2582,7,2591,1736,855,2.030409357,1431,425,30,14,14,0,13,0,0.142857143,0,empty,CD-0722-4
"E2,F9",9432,10292,7015,3277,5416,2554,0,2557,1687,870,1.93908046,1444,2921,545,308,303,5,87,2,0.02640264,0,empty,CD-0722-4
"E2,F10",13095,14352,9887,4465,7562,3616,23,3639,2441,1198,2.037562604,2059,2708,538,191,189,2,56,1,0.116402116,0,empty,CD-0722-4
"E2,F11",1221879,1415937,874506,541431,694238,406261,1,406607,335320,71287,4.703802937,241511,185067,29516,12061,11894,167,1900,8,0.059778039,0,hg38,CD-0722-4
"E2,F12",10289,11095,7581,3514,5868,2856,0,2862,1863,999,1.864864865,1598,311,79,38,37,1,13,1,0,0,empty,CD-0722-4
"E2,G1",14241,15532,10676,4856,8027,3806,10,3820,2523,1297,1.945258288,2190,5465,1066,456,445,11,110,2,0.130337079,0,empty,CD-0722-4
"E2,G2",6465,6867,4561,2306,3631,1864,0,1866,1189,677,1.756277696,1059,607,154,61,61,0,15,0,0,0,empty,CD-0722-4
"E2,G3",12803,13335,9304,4031,7017,3417,0,3423,2059,1364,1.509530792,1853,2797,566,244,244,0,71,0,0.102459016,0,empty,CD-0722-4
"E2,G4",21607,24422,15437,8985,12450,7047,3,7052,4342,2710,1.602214022,4116,141,14,9,9,0,6,0,0.111111111,0,empty,CD-0722-4
"E2,G5",7339,8282,5393,2889,4219,2186,0,2186,1406,780,1.802564103,1278,1918,483,208,207,1,50,1,0.115942029,0,empty,CD-0722-4
"E2,G6",11066,11931,8282,3649,6224,3002,0,3004,2006,998,2.01002004,1643,226,76,11,11,0,7,0,0.090909091,0,empty,CD-0722-4
"E2,G7",9372,10128,7104,3024,5284,2467,0,2468,1611,857,1.879813302,1352,3496,759,287,284,3,87,2,0.098591549,0,empty,CD-0722-4
"E2,G8",6559,7184,4806,2378,3859,1883,0,1883,1284,599,2.143572621,1093,2782,622,251,247,4,66,2,0.064777328,0,empty,CD-0722-4
"E2,G9",8720,9416,6383,3033,4967,2471,0,2475,1654,821,2.014616322,1360,3216,723,290,288,2,82,2,0.069444444,0,empty,CD-0722-4
"E2,G10",1079402,1229748,807943,421805,602333,332936,6,333224,250181,83043,3.012668136,191972,35897,11331,3966,3937,29,711,3,0.021336043,0,hg38,CD-0722-4
"E2,G11",9941,10808,7378,3430,5517,2689,1,2693,1840,853,2.157092614,1469,1266,401,172,169,3,42,2,0.041420118,0,empty,CD-0722-4
"E2,G12",7556,8480,5460,3020,4414,2239,0,2239,1442,797,1.809284818,1326,2498,719,304,300,4,80,2,0.023333333,0,empty,CD-0722-4
"E2,H1",982030,1143065,717630,425435,558048,309566,14,309849,249561,60288,4.139480494,185001,75847,14681,5516,5455,61,1005,4,0.051512374,0,hg38,CD-0722-4
"E2,H2",9929,10985,7216,3769,5615,2859,9,2872,1773,1099,1.613284804,1653,2779,653,269,267,2,75,2,0.04494382,0,empty,CD-0722-4
"E2,H3",7505,8282,5477,2805,4353,2170,6,2176,1472,704,2.090909091,1233,1541,325,143,142,1,37,1,0.056338028,0,empty,CD-0722-4
"E2,H4",835665,945185,627703,317482,459541,235824,0,236050,179109,56941,3.145519046,137404,9988,1061,449,433,16,87,2,0.030023095,0,hg38,CD-0722-4
"E2,H5",12482,13527,9186,4341,7017,3545,0,3545,2335,1210,1.929752066,1955,3799,894,351,350,1,84,1,0.108571429,0,empty,CD-0722-4
"E2,H6",7750,8602,5681,2921,4479,2299,0,2302,1554,748,2.077540107,1331,3243,942,370,368,2,92,1,0.182065217,0,empty,CD-0722-4
"E2,H7",8254,8796,6033,2763,4748,2275,11,2287,1523,764,1.993455497,1306,2268,523,220,217,3,57,2,0.078341014,0,empty,CD-0722-4
"E2,H8",10697,11974,7826,4148,6210,3260,20,3282,2238,1044,2.143678161,1889,2859,557,244,242,2,78,2,0.136363636,0,empty,CD-0722-4
"E2,H9",8236,8797,6280,2517,4581,2096,0,2099,1442,657,2.194824962,1163,1381,301,148,146,2,41,1,0.082191781,0,empty,CD-0722-4
"E2,H10",5933,6413,4366,2047,3395,1659,0,1661,1099,562,1.955516014,921,1310,231,87,86,1,26,1,0.046511628,0,empty,CD-0722-4
"E2,H11",7436,8525,5151,3374,4399,2586,0,2586,1387,1199,1.156797331,1548,24,0,0,0,0,0,0,0,0,empty,CD-0722-4
"E2,H12",6653,7564,4817,2747,3974,2081,0,2084,1368,716,1.910614525,1265,1858,387,119,117,2,32,1,0.136752137,0,empty,CD-0722-4
"E3,A1",7870,8707,5737,2970,4767,2454,3,2461,1707,754,2.263925729,1421,2445,455,181,180,1,52,1,0.2,0,empty,CD-0722-4
"E3,A2",13237,14670,9931,4739,7684,3849,30,3886,2570,1316,1.952887538,2183,2956,464,207,200,7,75,2,0.015,0,empty,CD-0722-4
"E3,A3",7376,8489,5475,3014,4486,2301,11,2312,1547,765,2.022222222,1386,2237,628,232,230,2,50,1,0.047826087,0,empty,CD-0722-4
"E3,A4",11953,13213,9049,4164,7042,3497,0,3497,2249,1248,1.802083333,1964,1074,270,85,84,1,37,1,0.023809524,0,empty,CD-0722-4
"E3,A5",11389,12750,8469,4281,6866,3451,11,3464,2379,1085,2.192626728,1946,3436,880,340,339,1,101,1,0.07079646,0,empty,CD-0722-4
"E3,A6",1083458,1260385,819447,440938,620616,328374,2,328622,261060,67562,3.864006394,192025,349141,84352,32030,31661,369,3319,9,0.032279461,0,hg38,CD-0722-4
"E3,A7",7281,8114,5385,2729,4321,2247,0,2252,1486,766,1.939947781,1239,1952,471,197,197,0,58,0,0.07106599,0,empty,CD-0722-4
"E3,A8",5171,5789,3902,1887,3119,1571,0,1571,1097,474,2.314345992,886,3268,657,306,302,4,77,2,0.069536424,0,empty,CD-0722-4
"E3,A9",9217,10119,6917,3202,5279,2611,3,2616,1834,782,2.345268542,1455,3009,728,312,311,1,79,1,0.073954984,0,empty,CD-0722-4
"E3,A10",8805,9687,6684,3003,5136,2531,0,2533,1678,855,1.962573099,1376,540,86,40,40,0,19,0,0.1,0,empty,CD-0722-4
"E3,A11",6718,7363,5031,2332,3960,1927,11,1941,1343,598,2.245819398,1092,2261,370,149,148,1,44,1,0.074324324,0,empty,CD-0722-4
"E3,A12",11314,12340,8554,3786,6587,3237,0,3241,2228,1013,2.1994077,1795,6226,1418,598,588,10,134,2,0.096938776,0,empty,CD-0722-4
"E3,B1",7668,8402,5691,2711,4462,2276,0,2279,1488,791,1.881163085,1296,1405,247,100,98,2,32,2,0,0,empty,CD-0722-4
"E3,B2",9074,10088,6202,3886,5311,2843,0,2846,1770,1076,1.644981413,1716,719,176,68,68,0,18,0,0.25,0,empty,CD-0722-4
"E3,B3",933720,1119480,677631,441849,555753,318689,1,318967,256868,62099,4.136427318,194630,176057,31314,12221,12057,164,1697,7,0.058886954,0,hg38,CD-0722-4
"E3,B4",7787,8927,5736,3191,4767,2518,22,2543,1681,862,1.950116009,1506,1947,463,207,205,2,45,2,0.141463415,0,empty,CD-0722-4
"E3,B5",9616,6332,3963,2369,4076,2121,0,2135,1428,707,2.01980198,1354,1805,408,160,159,1,42,1,0.094339623,0,empty,CD-0722-4
"E3,B6",1983706,2297253,1460101,837152,1109086,618562,17,619130,492188,126942,3.877266783,365853,348138,62358,24444,24023,421,2953,12,0.05652916,0.002375297,hg38,CD-0722-4
"E3,B7",9023,9917,6922,2995,5307,2572,29,2603,1735,868,1.998847926,1408,1936,497,175,174,1,45,1,0.068965517,0,empty,CD-0722-4
"E3,B8",7719,8389,5823,2566,4530,2198,0,2198,1516,682,2.2228739,1179,2279,515,209,205,4,63,3,0.126829268,0,empty,CD-0722-4
"E3,B9",29597,32635,22861,9774,16188,7615,0,7629,5510,2119,2.600283152,4162,3863,550,239,237,2,60,2,0.042194093,0,empty,CD-0722-4
"E3,B10",6985,7708,5003,2705,4217,2144,2,2150,1482,668,2.218562874,1268,916,173,84,82,2,16,1,0.06097561,0,empty,CD-0722-4
"E3,B11",12154,13687,8833,4854,7195,3936,3,3941,2370,1571,1.508593253,2347,373,28,17,17,0,9,0,0.235294118,0,empty,CD-0722-4
"E3,B12",7958,9106,5805,3301,4875,2556,0,2561,1789,772,2.317357513,1511,2582,737,319,319,0,70,0,0.07523511,0,empty,CD-0722-4
"E3,C1",16372,18090,12153,5937,9637,4803,0,4810,3208,1602,2.002496879,2755,2022,513,212,211,1,57,1,0.018957346,0,empty,CD-0722-4
"E3,C2",11640,12676,8586,4090,6780,3416,0,3416,2293,1123,2.041852182,1909,2886,744,277,275,2,74,2,0.054545455,0,empty,CD-0722-4
"E3,C3",12215,13046,9093,3953,7126,3532,1,3539,2356,1183,1.991546915,1964,1256,212,99,98,1,30,1,0.081632653,0,empty,CD-0722-4
"E3,C4",8765,9716,6560,3156,5178,2542,0,2545,1833,712,2.574438202,1402,2943,683,299,298,1,87,1,0.093959732,0,empty,CD-0722-4
"E3,C5",11420,12744,8400,4344,6764,3489,0,3495,2345,1150,2.039130435,2012,2733,629,264,261,3,72,1,0.061302682,0,empty,CD-0722-4
"E3,C6",9272,10292,6691,3601,5539,2894,0,2898,1983,915,2.167213115,1696,3047,966,375,374,1,77,1,0.016042781,0,empty,CD-0722-4
"E3,C7",11849,13197,8621,4576,7026,3756,2,3761,2335,1426,1.637447405,2172,922,276,84,84,0,18,0,0.154761905,0,empty,CD-0722-4
"E3,C8",14141,15526,10343,5183,8134,4151,13,4166,2782,1384,2.010115607,2365,4809,1119,439,433,6,104,2,0.036951501,0,empty,CD-0722-4
"E3,C9",10403,11810,7679,4131,6260,3140,1,3144,2134,1010,2.112871287,1791,3031,760,297,288,9,73,2,0.083333333,0,empty,CD-0722-4
"E3,C10",11240,11983,8374,3609,6202,2960,9,2975,2019,956,2.111924686,1602,3303,571,256,250,6,69,2,0.012,0,empty,CD-0722-4
"E3,C11",12186,13713,9057,4656,7155,3587,0,3590,2432,1158,2.100172712,2081,4533,1052,370,370,0,87,0,0.167567568,0,empty,CD-0722-4
"E3,C12",14978,16206,11154,5052,8634,4221,0,4229,2932,1297,2.260601388,2373,2957,668,290,288,2,78,1,0.163194444,0,empty,CD-0722-4
"E3,D1",11192,12440,8133,4307,6765,3531,0,3533,2271,1262,1.799524564,2100,1467,240,111,110,1,20,1,0.527272727,0,empty,CD-0722-4
"E3,D2",820370,896384,635124,261260,440391,208134,2,208350,160041,48309,3.312860958,114543,312202,42774,16546,16184,362,2105,12,0.041089965,0,hg38,CD-0722-4
"E3,D3",8551,9368,6346,3022,5053,2589,0,2595,1750,845,2.071005917,1418,2487,528,208,208,0,61,0,0.168269231,0,empty,CD-0722-4
"E3,D4",898462,1031477,681969,349508,508691,262658,13,262898,209595,53303,3.932142656,152434,86738,17704,6807,6738,69,1094,5,0.051350549,0,hg38,CD-0722-4
"E3,D5",7546,8405,5572,2833,4529,2262,0,2265,1539,726,2.119834711,1315,2023,636,213,208,5,47,2,0.072115385,0,empty,CD-0722-4
"E3,D6",11298,12475,8204,4271,6448,3409,4,3416,2132,1284,1.660436137,1949,2277,757,327,325,2,74,2,0.086153846,0,empty,CD-0722-4
"E3,D7",6256,6827,4719,2108,3657,1750,0,1750,1171,579,2.022452504,973,2599,582,215,210,5,65,2,0.038095238,0,empty,CD-0722-4
"E3,D8",8240,9279,6012,3267,4864,2476,3,2486,1687,799,2.111389237,1460,2101,525,179,176,3,50,1,0.005681818,0,empty,CD-0722-4
"E3,D9",4418,4976,3222,1754,2635,1318,1,1324,915,409,2.237163814,811,2429,659,265,252,13,71,3,0.015873016,0,empty,CD-0722-4
"E3,D10",9764,10901,6825,4076,5793,3149,0,3153,1965,1188,1.654040404,1876,1685,396,135,131,4,40,2,0.06870229,0,empty,CD-0722-4
"E3,D11",8944,9785,6805,2980,5209,2573,0,2574,1705,869,1.962025316,1433,3932,1047,422,416,6,90,2,0.055288462,0,empty,CD-0722-4
"E3,D12",12217,13655,9094,4561,7328,3634,0,3636,2454,1182,2.076142132,2127,6213,1694,671,668,3,164,3,0.058383234,0,empty,CD-0722-4
"E3,E1",794906,855307,623278,232029,420679,187426,7,187657,142832,44825,3.186436141,101184,182567,22893,8832,8608,224,1236,8,0.055762082,0,hg38,CD-0722-4
"E3,E2",10073,11203,7288,3915,5938,3084,1,3086,2038,1048,1.944656489,1760,2745,712,252,249,3,70,2,0.024096386,0,empty,CD-0722-4
"E3,E3",6508,7330,4936,2394,3930,1955,0,1960,1270,690,1.84057971,1074,3385,869,317,315,2,94,1,0.063492063,0,empty,CD-0722-4
"E3,E4",10552,12075,7693,4382,6363,3384,0,3395,2299,1096,2.097627737,2016,3947,1016,429,428,1,101,1,0.037383178,0,empty,CD-0722-4
"E3,E5",7903,8720,6065,2655,4587,2181,13,2196,1481,715,2.071328671,1162,1987,684,255,249,6,53,1,0.108433735,0,empty,CD-0722-4
"E3,E6",15285,17008,11371,5637,8862,4422,14,4445,2978,1467,2.029993183,2517,4995,941,374,367,7,103,3,0.021798365,0,empty,CD-0722-4
"E3,E7",16087,17722,12073,5649,9346,4616,0,4618,3220,1398,2.303290415,2537,4025,1077,424,423,1,102,1,0.139479905,0,empty,CD-0722-4
"E3,E8",12668,13752,9668,4084,7291,3410,23,3437,2349,1088,2.159007353,1861,4842,1327,491,488,3,109,2,0.075819672,0,empty,CD-0722-4
"E3,E9",7271,8093,5302,2791,4317,2242,0,2242,1554,688,2.25872093,1297,4393,818,378,376,2,89,2,0.066489362,0,empty,CD-0722-4
"E3,E10",8163,8488,6159,2329,4631,2168,0,2170,1468,702,2.091168091,1133,2874,546,243,240,3,69,2,0.041666667,0,empty,CD-0722-4
"E3,E11",9459,10271,7011,3260,5365,2715,0,2717,1773,944,1.878177966,1526,2872,602,259,257,2,71,1,0.077821012,0,empty,CD-0722-4
"E3,E12",10606,11655,7838,3817,6280,3149,40,3193,2191,1002,2.186626747,1819,2944,667,249,246,3,74,1,0.138211382,0,empty,CD-0722-4
"E3,F1",12021,13069,8974,4095,6938,3465,0,3465,2265,1200,1.8875,1913,3342,858,335,325,10,73,1,0.166153846,0,empty,CD-0722-4
"E3,F2",9342,10073,6935,3138,5517,2707,0,2708,1870,838,2.23150358,1540,3980,1031,348,347,1,94,1,0.048991354,0,empty,CD-0722-4
"E3,F3",20825,22901,15933,6968,11569,5591,0,5597,4087,1510,2.706622517,3107,5265,1505,590,587,3,132,2,0.131175468,0,empty,CD-0722-4
"E3,F4",13607,14414,10316,4098,7809,3712,1,3728,2448,1280,1.9125,2008,1355,447,180,178,2,36,2,0.028089888,0,empty,CD-0722-4
"E3,F5",11211,12470,8181,4289,6511,3137,0,3140,2058,1082,1.902033272,1839,3946,963,410,404,6,89,3,0.138613861,0,empty,CD-0722-4
"E3,F6",1506298,1762947,1098262,664685,866375,490888,0,491329,384617,106712,3.604252568,294891,325081,67926,25899,25542,357,3006,14,0.044319161,0,hg38,CD-0722-4
"E3,F7",12389,13593,9447,4146,7340,3589,0,3596,2386,1210,1.971900826,1977,1590,259,99,99,0,42,0,0.01010101,0,empty,CD-0722-4
"E3,F8",10062,11438,7563,3875,6042,3056,0,3059,2127,932,2.282188841,1780,416,46,20,20,0,14,0,0.05,0,empty,CD-0722-4
"E3,F9",795380,904398,591774,312624,447986,238369,17,238597,187369,51228,3.657550558,138938,188197,27173,10293,10033,260,1622,6,0.031595734,0,hg38,CD-0722-4
"E3,F10",13581,14779,10382,4397,7872,3766,7,3781,2616,1165,2.245493562,2041,2663,656,287,282,5,76,3,0.024822695,0,empty,CD-0722-4
"E3,F11",9352,10230,7029,3201,5341,2568,0,2570,1706,864,1.974537037,1467,2907,667,263,262,1,66,1,0.118320611,0,empty,CD-0722-4
"E3,F12",10700,11601,7895,3706,6244,3065,0,3069,2082,987,2.109422492,1742,323,85,38,36,2,18,1,0.111111111,0,empty,CD-0722-4
"E3,G1",12272,13394,9292,4102,7103,3442,1,3443,2410,1033,2.333010649,1923,3550,769,326,322,4,96,2,0.077639752,0,empty,CD-0722-4
"E3,G2",6188,6745,4459,2286,3643,1848,1,1850,1248,602,2.073089701,1042,577,191,81,81,0,26,0,0.098765432,0,empty,CD-0722-4
"E3,G3",13813,14811,10404,4407,7824,3890,1,3895,2429,1466,1.656889495,2045,3413,994,398,392,6,76,2,0.066326531,0,empty,CD-0722-4
"E3,G4",21933,24799,15766,9033,13033,7187,13,7209,4426,2783,1.590370104,4242,129,13,5,5,0,5,0,0,0,empty,CD-0722-4
"E3,G5",7671,8393,5699,2694,4481,2268,0,2268,1525,743,2.052489906,1270,2477,587,224,223,1,65,1,0.098654709,0,empty,CD-0722-4
"E3,G6",11800,12453,8919,3534,6608,3086,0,3089,2125,964,2.204356846,1630,319,51,9,9,0,7,0,0.222222222,0,empty,CD-0722-4
"E3,G7",9457,10508,7191,3317,5711,2747,1,2755,1847,908,2.034140969,1589,4429,1078,388,381,7,95,3,0.078740157,0,empty,CD-0722-4
"E3,G8",6929,7567,5093,2474,4115,2006,20,2026,1352,674,2.005934718,1170,2425,539,224,221,3,67,2,0.045248869,0,empty,CD-0722-4
"E3,G9",745066,830300,563556,266744,409056,207787,2,207978,161046,46932,3.431475326,119531,67186,11851,4431,4340,91,731,5,0.026267281,0,hg38,CD-0722-4
"E3,G10",11186,12317,8368,3949,6618,3397,0,3398,2397,1001,2.394605395,1911,5240,1405,554,550,4,145,3,0.098181818,0,empty,CD-0722-4
"E3,G11",10492,11339,7917,3422,6111,2940,0,2941,1993,948,2.102320675,1615,2250,717,292,292,0,67,0,0.023972603,0,empty,CD-0722-4
"E3,G12",7168,8051,5297,2754,4334,2198,0,2200,1423,777,1.831402831,1297,3765,743,319,317,2,78,1,0.110410095,0,empty,CD-0722-4
"E3,H1",9983,10886,7501,3385,5742,2794,1,2797,1941,856,2.267523364,1533,1947,476,175,171,4,41,1,0.099415205,0,empty,CD-0722-4
"E3,H2",1009184,1113161,762979,350182,547443,277479,18,277776,214737,63039,3.406415076,157952,113207,20500,7684,7549,135,1127,7,0.031394887,0,hg38,CD-0722-4
"E3,H3",8767,9826,6512,3314,5137,2540,0,2548,1735,813,2.134071341,1461,2050,309,143,139,4,58,2,0.107913669,0,empty,CD-0722-4
"E3,H4",11377,12637,8410,4227,6630,3282,0,3284,2189,1095,1.999086758,1941,228,29,17,17,0,12,0,0.176470588,0,empty,CD-0722-4
"E3,H5",12335,13949,8986,4963,7195,3694,3,3703,2479,1224,2.025326797,2182,2877,662,263,259,4,75,2,0.065637066,0,empty,CD-0722-4
"E3,H6",786017,889132,596602,292530,439979,224499,1,224693,174576,50117,3.483368917,129741,127010,13510,4971,4837,134,944,5,0.029563779,0,hg38,CD-0722-4
"E3,H7",8681,9123,6529,2594,4934,2309,1,2310,1552,758,2.047493404,1299,3083,841,294,287,7,61,2,0.090592334,0,empty,CD-0722-4
"E3,H8",1004526,1168381,747854,420527,569437,307334,1,307549,232069,75480,3.074576047,183112,172215,21731,8605,8376,229,1315,5,0.077602674,0,hg38,CD-0722-4
"E3,H9",8956,9957,6808,3149,5173,2482,0,2484,1730,754,2.294429708,1430,1849,512,200,199,1,46,1,0.075376884,0,empty,CD-0722-4
"E3,H10",6570,7334,4849,2485,3798,1856,17,1876,1293,583,2.217838765,1095,1759,316,151,144,7,41,3,0.118055556,0,empty,CD-0722-4
"E3,H11",7958,9056,5651,3405,4666,2699,13,2717,1514,1203,1.258520366,1601,54,10,6,6,0,3,0,0,0,empty,CD-0722-4
"E3,H12",8312,9307,5934,3373,4935,2610,0,2610,1810,800,2.2625,1566,2236,444,137,136,1,41,1,0.036764706,0,empty,CD-0722-4
"E4,A1",7309,8321,5397,2924,4356,2282,7,2291,1488,803,1.853051059,1329,1049,231,104,104,0,26,0,0.125,0,empty,CD-0722-4
"E4,A2",10532,11594,7764,3830,5972,2997,1,3003,1967,1036,1.898648649,1726,1795,406,188,184,4,58,1,0.038043478,0,empty,CD-0722-4
"E4,A3",13591,15034,9944,5090,7669,3857,0,3866,2840,1026,2.768031189,2301,1987,656,257,251,6,85,1,0.083665339,0,empty,CD-0722-4
"E4,A4",11870,12909,8934,3975,6809,3341,0,3343,2254,1089,2.069788797,1832,961,193,93,93,0,26,0,0,0,empty,CD-0722-4
"E4,A5",10618,11878,7855,4023,6375,3211,5,3220,2180,1040,2.096153846,1857,3146,822,259,256,3,60,1,0.1015625,0,empty,CD-0722-4
"E4,A6",8838,9815,6764,3051,5223,2675,0,2675,1832,843,2.173190985,1465,3066,607,267,266,1,82,1,0.063909774,0,empty,CD-0722-4
"E4,A7",7027,7725,5021,2704,4131,2201,0,2201,1372,829,1.655006031,1294,1350,248,138,135,3,40,2,0.014814815,0,empty,CD-0722-4
"E4,A8",4753,5409,3482,1927,2936,1523,0,1527,1051,476,2.207983193,882,2413,740,287,280,7,62,3,0.125,0,empty,CD-0722-4
"E4,A9",8182,8828,6268,2560,4625,2253,0,2255,1571,684,2.296783626,1214,2221,432,181,179,2,45,2,0.134078212,0,empty,CD-0722-4
"E4,A10",8361,9041,6317,2724,4773,2334,0,2338,1576,762,2.06824147,1302,425,114,42,42,0,13,0,0.166666667,0,empty,CD-0722-4
"E4,A11",12491,13874,9086,4788,7153,3783,4,3790,2487,1303,1.908672295,2143,1807,325,113,113,0,33,0,0.053097345,0,empty,CD-0722-4
"E4,A12",10100,11260,7547,3713,5736,2892,0,2892,1975,917,2.153762268,1603,3838,984,406,403,3,80,2,0.039702233,0,empty,CD-0722-4
"E4,B1",7559,8670,5476,3194,4585,2482,0,2485,1602,883,1.814269536,1508,1270,162,90,87,3,29,1,0,0,empty,CD-0722-4
"E4,B2",9598,10454,6528,3926,5398,2925,5,2931,1836,1095,1.676712329,1724,922,96,36,36,0,17,0,0.027777778,0,empty,CD-0722-4
"E4,B3",6851,7704,4966,2738,4094,2085,33,2120,1410,710,1.985915493,1248,1445,343,138,136,2,29,1,0.058823529,0,empty,CD-0722-4
"E4,B4",7304,8035,5320,2715,4301,2235,19,2259,1476,783,1.885057471,1327,1376,396,137,137,0,40,0,0.04379562,0,empty,CD-0722-4
"E4,B5",2026336,1187893,709015,478878,759365,427572,17,430185,343267,86918,3.949320049,276036,185585,24580,9533,9324,209,1579,8,0.045795796,0,hg38,CD-0722-4
"E4,B6",8930,10061,6523,3538,5324,2834,0,2838,1912,926,2.064794816,1682,1989,520,218,217,1,52,1,0.082949309,0,empty,CD-0722-4
"E4,B7",8622,9565,6557,3008,5018,2473,0,2478,1650,828,1.992753623,1325,1316,260,126,125,1,39,1,0.056,0,empty,CD-0722-4
"E4,B8",6425,7027,4785,2242,3767,1898,0,1901,1204,697,1.727403156,1075,1405,314,108,108,0,34,0,0.055555556,0,empty,CD-0722-4
"E4,B9",10950,12091,8009,4082,6271,3288,1,3290,2188,1102,1.985480944,1859,1396,340,169,166,3,41,1,0.072289157,0,empty,CD-0722-4
"E4,B10",6133,6835,4412,2423,3815,1960,0,1961,1299,662,1.96223565,1160,855,119,53,53,0,21,0,0.056603774,0,empty,CD-0722-4
"E4,B11",11656,12930,8377,4553,6792,3751,0,3753,2191,1562,1.40268886,2176,200,15,11,11,0,6,0,0,0,empty,CD-0722-4
"E4,B12",7504,8490,5444,3046,4441,2268,0,2270,1573,697,2.256814921,1305,1627,444,155,155,0,53,0,0.077419355,0,empty,CD-0722-4
"E4,C1",1406471,1592955,1056940,536015,764588,415170,7,415556,327138,88418,3.699902735,236751,99109,15524,6204,6094,110,1063,6,0.052018379,0,hg38,CD-0722-4
"E4,C2",11361,12545,8365,4180,6511,3278,0,3282,2075,1207,1.71913836,1872,2146,563,248,247,1,57,1,0.186234818,0,empty,CD-0722-4
"E4,C3",11856,13317,8782,4535,7013,3586,0,3591,2317,1274,1.818681319,2093,1027,265,106,104,2,29,1,0.153846154,0,empty,CD-0722-4
"E4,C4",7531,8364,5545,2819,4389,2146,1,2148,1447,701,2.064194009,1234,1838,504,215,215,0,54,0,0.055813953,0,empty,CD-0722-4
"E4,C5",12288,13726,9074,4652,7196,3714,2,3721,2528,1193,2.119027661,2142,1712,309,114,111,3,39,2,0,0,empty,CD-0722-4
"E4,C6",8797,9734,6426,3308,5239,2705,11,2719,1794,925,1.939459459,1548,1759,345,122,119,3,31,2,0,0,empty,CD-0722-4
"E4,C7",12199,13596,8789,4807,7131,3901,15,3918,2457,1461,1.681724846,2270,561,153,53,53,0,16,0,0.490566038,0,empty,CD-0722-4
"E4,C8",839517,921064,644765,276299,452376,220853,2,221065,172106,48959,3.515308728,123175,54976,9805,3437,3373,64,647,5,0.025200119,0,hg38,CD-0722-4
"E4,C9",11378,12690,8539,4151,6575,3260,1,3264,2279,985,2.313705584,1874,2815,486,175,173,2,48,2,0.098265896,0,empty,CD-0722-4
"E4,C10",965139,1066586,740230,326356,518072,252860,4,253150,189316,63834,2.965754927,142239,138899,17312,6744,6577,167,1148,6,0.034514216,0,hg38,CD-0722-4
"E4,C11",9269,10199,6954,3245,5380,2609,0,2613,1714,899,1.906562848,1447,2091,461,195,194,1,50,1,0.087628866,0,empty,CD-0722-4
"E4,C12",13805,15354,10117,5237,8016,4029,12,4044,2699,1345,2.00669145,2341,2226,681,237,236,1,56,1,0.127118644,0,empty,CD-0722-4
"E4,D1",11180,12460,8012,4448,6547,3510,0,3511,2164,1347,1.606533036,2123,1188,173,73,72,1,21,1,0.097222222,0,empty,CD-0722-4
"E4,D2",9838,10674,7412,3262,5473,2562,2,2566,1674,892,1.876681614,1352,2435,738,308,306,2,79,2,0.078431373,0,empty,CD-0722-4
"E4,D3",8705,9791,6368,3423,5137,2627,0,2631,1700,931,1.825993555,1523,1363,276,121,120,1,40,1,0.041666667,0,empty,CD-0722-4
"E4,D4",9151,10247,6851,3396,5417,2721,7,2734,1860,874,2.128146453,1577,1480,521,174,173,1,43,1,0.023121387,0,empty,CD-0722-4
"E4,D5",7374,8329,5484,2845,4343,2186,0,2186,1400,786,1.781170483,1244,1549,304,151,151,0,38,0,0.105960265,0,empty,CD-0722-4
"E4,D6",924466,1059155,670583,388572,518597,287852,5,288164,239750,48414,4.952079977,170381,253375,41575,16673,16393,280,2166,11,0.061916672,0,hg38,CD-0722-4
"E4,D7",6319,6761,4727,2034,3616,1732,0,1733,1204,529,2.275992439,940,2241,542,236,234,2,60,2,0.072649573,0,empty,CD-0722-4
"E4,D8",9945,10597,7537,3060,5483,2525,0,2526,1710,816,2.095588235,1335,1847,436,198,198,0,40,0,0.005050505,0,empty,CD-0722-4
"E4,D9",4243,4584,3145,1439,2381,1163,0,1163,781,382,2.044502618,666,1428,298,137,137,0,41,0,0.04379562,0,empty,CD-0722-4
"E4,D10",8887,10180,6626,3554,5188,2697,0,2702,1755,947,1.853220697,1545,1084,234,98,93,5,24,2,0.086021505,0,empty,CD-0722-4
"E4,D11",8149,8939,6063,2876,4677,2272,0,2274,1440,834,1.726618705,1288,2570,924,361,358,3,94,1,0.061452514,0,empty,CD-0722-4
"E4,D12",11672,12874,8722,4152,6743,3281,17,3298,2188,1110,1.971171171,1837,3474,810,323,316,7,85,2,0.07278481,0,empty,CD-0722-4
"E4,E1",3459823,3946981,2560253,1386728,1838421,1043711,6,1044687,844439,200248,4.216965962,604181,362215,58650,22657,22280,377,2961,10,0.056193896,0,hg38,CD-0722-4
"E4,E2",9872,10902,7349,3553,5723,2860,0,2861,1790,1071,1.671335201,1635,2613,517,196,194,2,60,1,0.139175258,0,empty,CD-0722-4
"E4,E3",6537,6944,4998,1946,3677,1738,0,1738,1118,620,1.803225806,919,2642,485,184,180,4,66,1,0.061111111,0,empty,CD-0722-4
"E4,E4",944570,1083687,705775,377912,529358,282010,3,282253,223980,58273,3.843632557,165919,87937,16809,6609,6485,124,1022,4,0.032999229,0,hg38,CD-0722-4
"E4,E5",10063,10688,7606,3082,5575,2643,0,2645,1703,942,1.807855626,1371,1644,461,133,132,1,32,1,0.265151515,0,empty,CD-0722-4
"E4,E6",2199106,2492180,1657939,834241,1168362,625840,6,626385,500961,125424,3.994139878,357010,297231,60596,23211,22926,285,2830,9,0.063639536,0,hg38,CD-0722-4
"E4,E7",13776,15055,10312,4743,7929,3873,1,3881,2585,1296,1.994598765,2130,3657,974,368,365,3,91,1,0.073972603,0,empty,CD-0722-4
"E4,E8",1045334,1137338,807838,329500,550011,259156,0,259410,193710,65700,2.948401826,142950,141614,24967,9506,9390,116,1467,5,0.041853035,0,hg38,CD-0722-4
"E4,E9",6554,7291,4850,2441,3823,1971,0,1971,1361,610,2.231147541,1129,2642,626,261,258,3,61,2,0.007751938,0,empty,CD-0722-4
"E4,E10",8845,9756,6639,3117,5081,2433,0,2436,1555,881,1.765039728,1371,2771,429,154,147,7,46,2,0.156462585,0,empty,CD-0722-4
"E4,E11",9209,10214,6761,3453,5382,2734,0,2736,1783,953,1.870933893,1549,1986,603,212,212,0,52,0,0.009433962,0,empty,CD-0722-4
"E4,E12",10084,11420,7376,4044,6112,3160,1,3164,2088,1076,1.940520446,1884,2150,485,195,193,2,59,2,0.056994819,0,empty,CD-0722-4
"E4,F1",11503,12526,8569,3957,6487,3190,0,3194,2076,1118,1.856887299,1738,2857,709,279,278,1,58,1,0.050359712,0,empty,CD-0722-4
"E4,F2",8746,9510,6457,3053,5101,2552,0,2552,1675,877,1.909920182,1424,2925,822,308,307,1,76,1,0.104234528,0,empty,CD-0722-4
"E4,F3",9124,9980,6749,3231,5304,2562,16,2580,1681,899,1.869855395,1486,3191,826,290,288,2,82,2,0.15625,0,empty,CD-0722-4
"E4,F4",13650,14678,10184,4494,7790,3790,6,3800,2483,1317,1.885345482,2173,1259,256,102,101,1,26,1,0.069306931,0,empty,CD-0722-4
"E4,F5",11038,11772,8245,3527,6133,2825,8,2836,1926,910,2.116483516,1524,2132,504,205,202,3,70,2,0.084158416,0,empty,CD-0722-4
"E4,F6",12375,14082,9155,4927,7459,3959,3,3966,2762,1204,2.294019934,2332,3953,1057,426,425,1,103,1,0.105882353,0,empty,CD-0722-4
"E4,F7",12354,13701,9312,4389,7310,3671,0,3679,2405,1274,1.887755102,2075,1323,261,124,121,3,39,2,0.066115702,0,empty,CD-0722-4
"E4,F8",9066,9724,6880,2844,5125,2412,0,2412,1614,798,2.022556391,1270,412,47,16,15,1,9,1,0,0,empty,CD-0722-4
"E4,F9",9466,10321,7120,3201,5512,2705,0,2706,1875,831,2.25631769,1510,2475,793,283,279,4,72,2,0.075268817,0,empty,CD-0722-4
"E4,F10",13193,14423,10041,4382,7573,3608,16,3626,2489,1137,2.189094107,1987,2495,445,200,193,7,47,2,0.020725389,0,empty,CD-0722-4
"E4,F11",8965,9434,6668,2766,4922,2237,0,2240,1478,762,1.939632546,1239,1580,250,129,125,4,39,2,0.128,0,empty,CD-0722-4
"E4,F12",10617,11465,7904,3561,6079,2990,0,2991,1964,1027,1.912366115,1684,245,34,23,19,4,8,1,0.052631579,0,empty,CD-0722-4
"E4,G1",19396,21903,14435,7468,11170,5758,0,5768,4000,1768,2.262443439,3253,3623,901,366,359,7,86,3,0.097493036,0,empty,CD-0722-4
"E4,G2",11640,12725,8080,4645,6462,3422,2,3427,2343,1084,2.161439114,1999,1110,243,90,90,0,24,0,0.177777778,0,empty,CD-0722-4
"E4,G3",13361,14553,9910,4643,7496,3752,0,3758,2297,1461,1.572210815,2067,4087,849,334,332,2,75,1,0.078313253,0,empty,CD-0722-4
"E4,G4",21207,23575,15335,8240,12324,6691,1,6704,4165,2539,1.64040961,3767,51,1,1,1,0,1,0,0,0,empty,CD-0722-4
"E4,G5",7011,7902,5062,2840,4152,2164,0,2168,1410,758,1.860158311,1296,1753,255,119,117,2,33,1,0.11965812,0,empty,CD-0722-4
"E4,G6",10732,11952,8113,3839,6157,2972,1,2975,2006,969,2.070175439,1628,207,38,22,22,0,12,0,0,0,empty,CD-0722-4
"E4,G7",1083589,1207698,824752,382946,590525,293930,2,294175,220228,73947,2.97818708,167064,198460,27087,10636,10457,179,1565,6,0.041981448,0,hg38,CD-0722-4
"E4,G8",6551,7339,4843,2496,3773,1837,28,1865,1226,639,1.918622848,1030,1670,273,154,150,4,56,2,0,0,empty,CD-0722-4
"E4,G9",8422,9433,6274,3159,4994,2531,5,2538,1696,842,2.014251781,1465,2700,415,183,180,3,62,1,0.083333333,0,empty,CD-0722-4
"E4,G10",10164,11206,7608,3598,5867,2939,0,2951,1936,1015,1.907389163,1640,2708,534,239,237,2,75,1,0.067510549,0,empty,CD-0722-4
"E4,G11",9715,10455,7438,3017,5506,2642,2,2647,1794,853,2.103165299,1462,1495,396,139,139,0,50,0,0.064748201,0,empty,CD-0722-4
"E4,G12",6975,8079,5058,3021,4260,2228,2,2232,1395,837,1.666666667,1330,1954,474,207,202,5,47,2,0.113861386,0,empty,CD-0722-4
"E4,H1",8896,9789,6665,3124,5210,2559,0,2560,1773,787,2.252858958,1438,1156,195,93,92,1,26,1,0.097826087,0,empty,CD-0722-4
"E4,H2",8726,9908,6305,3603,5163,2650,0,2650,1658,992,1.671370968,1599,2508,656,203,198,5,53,1,0.045454545,0,empty,CD-0722-4
"E4,H3",7908,9137,5757,3380,4758,2515,0,2524,1632,892,1.829596413,1480,1724,348,147,145,2,43,2,0.220689655,0,empty,CD-0722-4
"E4,H4",10779,11700,7980,3720,6110,3026,0,3029,2018,1011,1.996043521,1710,267,16,14,11,3,10,1,0.090909091,0,empty,CD-0722-4
"E4,H5",12387,13506,9255,4251,7013,3567,11,3581,2283,1298,1.758859784,1930,2188,553,226,222,4,66,2,0.018018018,0,empty,CD-0722-4
"E4,H6",7632,8390,5534,2856,4492,2421,4,2430,1597,833,1.917166867,1384,1910,435,175,169,6,45,2,0.100591716,0,empty,CD-0722-4
"E4,H7",8128,8963,5988,2975,4673,2284,0,2284,1544,740,2.086486486,1295,2710,754,301,299,2,58,1,0.073578595,0,empty,CD-0722-4
"E4,H8",11111,12251,8047,4204,6492,3368,8,3377,2306,1071,2.153127918,1960,1982,511,229,228,1,69,1,0.030701754,0,empty,CD-0722-4
"E4,H9",7570,8399,5736,2663,4325,2109,2,2114,1378,736,1.872282609,1182,1223,274,121,119,2,42,2,0.008403361,0,empty,CD-0722-4
"E4,H10",6406,6987,4751,2236,3655,1795,43,1839,1198,641,1.868954758,1014,1460,399,157,156,1,41,1,0.173076923,0,empty,CD-0722-4
"E4,H11",7607,8796,5324,3472,4581,2720,13,2735,1525,1210,1.260330579,1652,49,2,1,1,0,1,0,0,0,empty,CD-0722-4
"E4,H12",7293,8349,5296,3053,4383,2245,0,2246,1583,663,2.387631976,1345,1825,293,124,124,0,36,0,0.016129032,0,empty,CD-0722-4
"E5,A1",8037,8945,6085,2860,4868,2533,0,2542,1723,819,2.103785104,1426,1577,332,140,140,0,37,0,0.114285714,0,empty,CD-0722-4
"E5,A2",12133,13610,8964,4646,7184,3636,21,3660,2344,1316,1.781155015,2082,2976,933,309,308,1,59,1,0.107142857,0,empty,CD-0722-4
"E5,A3",9293,10147,6842,3305,5462,2704,6,2710,1917,793,2.41740227,1499,2743,538,227,222,5,61,2,0.126126126,0,empty,CD-0722-4
"E5,A4",12418,13061,9125,3936,7098,3436,0,3448,2254,1194,1.887772194,1890,952,288,65,65,0,23,0,0.215384615,0,empty,CD-0722-4
"E5,A5",12056,13322,8937,4385,7309,3776,3,3781,2666,1115,2.39103139,2174,3320,755,298,297,1,84,1,0.087542088,0,empty,CD-0722-4
"E5,A6",18451,20937,13574,7363,11138,6002,0,6003,4332,1671,2.592459605,3442,3970,1077,436,434,2,116,1,0.050691244,0,empty,CD-0722-4
"E5,A7",7538,8735,5487,3248,4682,2520,0,2521,1632,889,1.835770529,1461,1380,285,149,148,1,52,1,0.033783784,0,empty,CD-0722-4
"E5,A8",5276,6255,3864,2391,3395,1738,0,1739,1263,476,2.653361345,1074,2469,683,305,302,3,73,2,0.043046358,0,empty,CD-0722-4
"E5,A9",9550,10661,7107,3554,5870,2943,1,2949,2041,908,2.247797357,1707,2267,519,206,206,0,68,0,0.048543689,0,empty,CD-0722-4
"E5,A10",10486,11511,8030,3481,6036,2973,0,2974,2004,970,2.065979381,1577,510,97,38,38,0,18,0,0,0,empty,CD-0722-4
"E5,A11",6943,7551,5297,2254,4072,1909,0,1911,1305,606,2.153465347,1020,1751,372,145,145,0,44,0,0.027586207,0,empty,CD-0722-4
"E5,A12",11846,12942,9114,3828,6710,3226,0,3228,2254,974,2.314168378,1706,4829,1311,509,503,6,118,2,0.03777336,0,empty,CD-0722-4
"E5,B1",802642,906979,596695,310284,451971,239654,2,239866,183144,56722,3.228800113,138895,65780,13620,5290,5244,46,891,3,0.050152555,0,hg38,CD-0722-4
"E5,B2",8337,9023,5655,3368,4875,2666,4,2671,1706,965,1.767875648,1573,716,210,94,93,1,21,1,0,0,empty,CD-0722-4
"E5,B3",8203,8944,6062,2882,4834,2390,5,2395,1649,746,2.210455764,1385,1971,524,192,192,0,38,0,0.114583333,0,empty,CD-0722-4
"E5,B4",729473,805835,556592,249243,401497,198093,31,198326,161318,37008,4.359003459,111811,72707,10166,4010,3921,89,691,4,0.02958429,0,hg38,CD-0722-4
"E5,B5",9283,5429,3460,1969,3608,1849,11,1870,1250,620,2.016129032,1163,1338,341,128,128,0,35,0,0.1484375,0,empty,CD-0722-4
"E5,B6",10632,12157,7658,4499,6523,3549,1,3559,2298,1261,1.822363204,2092,3778,728,309,305,4,87,2,0.026229508,0,empty,CD-0722-4
"E5,B7",9778,10930,7413,3517,5805,2733,6,2741,1890,851,2.220916569,1575,2588,406,181,181,0,63,0,0.038674033,0,empty,CD-0722-4
"E5,B8",7567,8234,5707,2527,4482,2189,0,2195,1476,719,2.052851182,1244,2135,500,200,199,1,53,1,0.010050251,0,empty,CD-0722-4
"E5,B9",12146,13372,9079,4293,7085,3612,0,3614,2410,1204,2.00166113,2037,1450,463,193,193,0,45,0,0.005181347,0,empty,CD-0722-4
"E5,B10",7209,7759,5145,2614,4392,2156,1,2159,1488,671,2.217585693,1243,690,126,61,60,1,22,1,0.15,0,empty,CD-0722-4
"E5,B11",12706,14214,9236,4978,7559,4137,0,4142,2451,1691,1.449438202,2429,269,83,32,32,0,13,0,0,0,empty,CD-0722-4
"E5,B12",707665,770421,543156,227265,385460,187203,6,187363,144157,43206,3.336504189,104073,48681,9617,3447,3393,54,654,4,0.02858827,0,hg38,CD-0722-4
"E5,C1",16251,17772,12258,5514,9529,4684,0,4692,3151,1541,2.044776119,2612,1800,306,132,131,1,50,1,0.038167939,0,empty,CD-0722-4
"E5,C2",24656,27554,18257,9297,14026,7327,0,7333,5001,2332,2.144511149,4196,3202,701,283,278,5,79,2,0.053956835,0,empty,CD-0722-4
"E5,C3",14574,15978,10678,5300,8710,4477,20,4501,3092,1409,2.194464159,2607,1137,184,98,97,1,35,1,0.041237113,0,empty,CD-0722-4
"E5,C4",8771,9511,6535,2976,5175,2471,0,2479,1625,854,1.902810304,1377,2065,445,187,185,2,62,2,0.102702703,0,empty,CD-0722-4
"E5,C5",11509,12686,8481,4205,6875,3582,0,3584,2400,1184,2.027027027,2075,2446,476,215,212,3,64,1,0.089622642,0,empty,CD-0722-4
"E5,C6",12823,14304,9393,4911,7781,4195,0,4195,2967,1228,2.416123779,2418,2841,720,266,265,1,70,1,0.067924528,0,empty,CD-0722-4
"E5,C7",1059228,1213074,797225,415849,593270,311985,2,312256,227583,84673,2.687787134,182192,19214,2494,1089,1061,28,254,3,0.058435438,0,hg38,CD-0722-4
"E5,C8",14350,15580,10652,4928,8193,4108,6,4124,2763,1361,2.030124908,2280,3962,917,343,340,3,95,2,0.079411765,0,empty,CD-0722-4
"E5,C9",10845,12226,8009,4217,6455,3301,1,3308,2303,1005,2.291542289,1898,2116,453,174,168,6,47,2,0.017857143,0,empty,CD-0722-4
"E5,C10",11215,12302,8469,3833,6514,3100,0,3103,1978,1125,1.758222222,1711,3304,585,234,229,5,70,2,0.043668122,0,empty,CD-0722-4
"E5,C11",10298,11423,7605,3818,6183,3050,0,3055,2017,1038,1.943159923,1746,2336,472,202,202,0,59,0,0.024752475,0,empty,CD-0722-4
"E5,C12",843443,922472,642494,279978,452916,219199,2,219428,180067,39361,4.574756739,123310,57903,12565,4586,4536,50,757,4,0.018518519,0,hg38,CD-0722-4
"E5,D1",11395,12977,8377,4600,6844,3625,0,3628,2231,1397,1.596993558,2076,999,170,85,84,1,31,1,0,0,empty,CD-0722-4
"E5,D2",9448,10376,7229,3147,5563,2592,1,2598,1770,828,2.137681159,1474,3835,1047,410,404,6,94,2,0.113861386,0,empty,CD-0722-4
"E5,D3",9760,10453,7007,3446,5493,2772,12,2790,1843,947,1.946145723,1555,2395,487,209,206,3,56,2,0.04368932,0,empty,CD-0722-4
"E5,D4",7567,8312,5654,2658,4605,2326,0,2329,1597,732,2.181693989,1290,1898,553,237,237,0,57,0,0.046413502,0,empty,CD-0722-4
"E5,D5",7953,8844,5798,3046,4674,2365,1,2372,1520,852,1.784037559,1328,2114,461,187,182,5,38,2,0.104395604,0,empty,CD-0722-4
"E5,D6",11602,12892,8339,4553,6774,3624,1,3627,2185,1442,1.515256588,2161,2598,631,267,265,2,70,1,0.045283019,0,empty,CD-0722-4
"E5,D7",6899,7707,5105,2602,4155,2035,0,2035,1397,638,2.189655172,1205,3681,900,285,284,1,69,1,0.063380282,0,empty,CD-0722-4
"E5,D8",8694,9696,6402,3294,5272,2646,0,2649,1819,830,2.191566265,1518,1912,579,244,242,2,68,2,0.037190083,0,empty,CD-0722-4
"E5,D9",4780,5076,3512,1564,2777,1378,1,1379,958,421,2.275534442,769,2068,407,138,132,6,40,2,0.075757576,0,empty,CD-0722-4
"E5,D10",1415979,1725736,1024889,700847,848125,511718,0,512103,411090,101013,4.0696742,313265,51605,15815,6079,6044,35,1047,2,0.090172071,0,hg38,CD-0722-4
"E5,D11",8919,9678,6602,3076,5253,2555,8,2565,1680,885,1.898305085,1460,3793,839,334,331,3,85,1,0.048338369,0,empty,CD-0722-4
"E5,D12",2235196,2631876,1662275,969601,1263686,724233,9,724920,610145,114775,5.316009584,426385,439046,88111,34594,34193,401,3511,8,0.073026643,0,hg38,CD-0722-4
"E5,E1",16461,18373,12247,6126,9591,4871,0,4878,3313,1565,2.116932907,2765,4246,1159,480,475,5,116,3,0.033684211,0,empty,CD-0722-4
"E5,E2",10256,11358,7462,3896,6067,3108,0,3110,2052,1058,1.939508507,1819,3265,643,210,207,3,65,2,0.057971014,0,empty,CD-0722-4
"E5,E3",6854,7613,5080,2533,4071,2097,0,2097,1337,760,1.759210526,1222,3077,923,377,374,3,79,2,0.189839572,0,empty,CD-0722-4
"E5,E4",11247,12461,8321,4140,6681,3451,0,3454,2376,1078,2.204081633,1977,3761,997,331,330,1,81,1,0.018181818,0,empty,CD-0722-4
"E5,E5",8261,8874,6180,2694,4709,2229,0,2229,1490,739,2.01623816,1194,1760,466,184,181,3,50,1,0.138121547,0,empty,CD-0722-4
"E5,E6",15824,17923,11604,6319,9420,4825,0,4828,3092,1736,1.781105991,2868,4897,1119,425,419,6,128,2,0.107398568,0,empty,CD-0722-4
"E5,E7",834916,966552,614082,352470,476904,264790,2,264990,211029,53961,3.910768889,155629,67296,17338,6641,6580,61,1138,6,0.069756839,0,hg38,CD-0722-4
"E5,E8",46520,51926,33965,17961,26470,15126,0,15143,9684,5459,1.773951273,8457,4376,1237,432,430,2,102,2,0.051162791,0,empty,CD-0722-4
"E5,E9",7609,8404,5679,2725,4379,2234,0,2235,1572,663,2.371040724,1206,3631,888,353,346,7,84,2,0.164739884,0,empty,CD-0722-4
"E5,E10",8463,9039,6330,2709,4916,2398,0,2402,1657,745,2.224161074,1359,2461,464,220,208,12,57,2,0.067307692,0,empty,CD-0722-4
"E5,E11",909467,1014416,688301,326115,504467,253859,1,254094,194807,59287,3.285829946,145397,270698,30203,11567,11256,311,1635,5,0.049751244,0,hg38,CD-0722-4
"E5,E12",1740759,2073643,1282055,791588,1006901,578272,3,578767,482083,96684,4.986171445,347116,456611,58136,23724,23212,512,2776,11,0.078235395,0,hg38,CD-0722-4
"E5,F1",12381,13175,9125,4050,7089,3450,0,3458,2220,1238,1.793214863,1912,2920,830,335,333,2,88,1,0.039039039,0,empty,CD-0722-4
"E5,F2",844204,931153,628096,303057,462782,237694,2,237956,192037,45919,4.182081491,136396,204474,32212,12605,12349,256,1670,11,0.025832051,0,hg38,CD-0722-4
"E5,F3",10489,11809,7818,3991,6198,3106,0,3111,2127,984,2.161585366,1773,3947,879,368,365,3,101,2,0.131506849,0,empty,CD-0722-4
"E5,F4",14376,15570,10816,4754,8457,4040,1,4043,2628,1415,1.857243816,2277,907,286,127,127,0,33,0,0,0,empty,CD-0722-4
"E5,F5",11581,12195,8630,3565,6533,3049,12,3063,2051,1012,2.026679842,1629,2911,562,266,260,6,75,2,0.080769231,0,empty,CD-0722-4
"E5,F6",15110,17303,11166,6137,9240,4892,0,4893,3431,1462,2.346785226,2865,4557,762,342,338,4,118,3,0.059171598,0,empty,CD-0722-4
"E5,F7",13199,14814,9822,4992,8075,4019,24,4046,2759,1287,2.143745144,2301,2079,464,193,192,1,40,1,0.135416667,0,empty,CD-0722-4
"E5,F8",9977,11122,7361,3761,5818,2844,0,2849,1955,894,2.186800895,1654,401,97,47,46,1,17,1,0.02173913,0,empty,CD-0722-4
"E5,F9",10845,11884,8242,3642,6298,3008,0,3010,2077,933,2.226152197,1681,5158,1045,406,402,4,105,2,0.019900498,0,empty,CD-0722-4
"E5,F10",13719,14931,10319,4612,8131,4028,0,4035,2834,1201,2.35970025,2251,3014,727,227,223,4,62,3,0.085201794,0,empty,CD-0722-4
"E5,F11",9907,10671,7545,3126,5570,2584,0,2585,1767,818,2.160146699,1374,2544,697,233,233,0,64,0,0.055793991,0,empty,CD-0722-4
"E5,F12",11209,12282,8352,3930,6595,3218,31,3254,2286,968,2.361570248,1818,363,48,19,19,0,11,0,0,0,empty,CD-0722-4
"E5,G1",12709,13893,9402,4491,7483,3704,4,3709,2465,1244,1.981511254,2098,4466,954,378,370,8,90,3,0.07027027,0,empty,CD-0722-4
"E5,G2",873607,946325,649402,296923,469445,234300,12,234517,179196,55321,3.239203919,132222,16424,3007,1049,1039,10,240,2,0.009624639,0,hg38,CD-0722-4
"E5,G3",13174,13966,9834,4132,7436,3660,14,3679,2339,1340,1.745522388,1929,3016,765,286,282,4,78,2,0.056737589,0,empty,CD-0722-4
"E5,G4",22017,24782,15836,8946,13054,7145,0,7147,4408,2739,1.609346477,4188,143,24,18,18,0,8,0,0.055555556,0,empty,CD-0722-4
"E5,G5",7987,9044,5912,3132,4587,2244,18,2262,1478,784,1.885204082,1304,2488,676,236,227,9,57,2,0.207048458,0,empty,CD-0722-4
"E5,G6",11456,12205,8793,3412,6388,2980,2,2986,2052,934,2.197002141,1536,212,9,7,7,0,7,0,0,0,empty,CD-0722-4
"E5,G7",11773,12684,9005,3679,6737,3170,0,3176,2186,990,2.208080808,1724,4184,687,244,241,3,78,1,0.178423237,0,empty,CD-0722-4
"E5,G8",7304,7871,5360,2511,4255,2092,19,2114,1435,679,2.113402062,1214,2382,526,250,247,3,68,1,0.064777328,0,empty,CD-0722-4
"E5,G9",9392,10497,6925,3572,5608,2922,0,2922,1959,963,2.034267913,1701,3371,762,291,286,5,90,2,0.062937063,0,empty,CD-0722-4
"E5,G10",11259,12433,8417,4016,6777,3366,3,3374,2268,1106,2.050632911,1917,3740,894,379,378,1,94,1,0.018518519,0,empty,CD-0722-4
"E5,G11",10892,11841,8030,3811,6283,3036,0,3039,2052,987,2.079027356,1722,2395,445,160,159,1,56,1,0,0,empty,CD-0722-4
"E5,G12",7524,8362,5433,2929,4589,2396,0,2396,1530,866,1.766743649,1440,2340,539,177,168,9,45,3,0.023809524,0,empty,CD-0722-4
"E5,H1",576875,712355,383409,328946,358998,245150,3,245321,175433,69888,2.510202038,151332,4544,504,194,186,8,54,2,0.204301075,0,hg38,CD-0722-4
"E5,H2",9457,10472,6803,3669,5539,2832,0,2835,1917,918,2.088235294,1656,3547,827,251,245,6,71,3,0.024489796,0,empty,CD-0722-4
"E5,H3",9178,10248,6843,3405,5399,2733,19,2754,1821,933,1.951768489,1533,2329,409,178,175,3,51,1,0.028571429,0,empty,CD-0722-4
"E5,H4",11983,13350,8873,4477,6956,3434,9,3449,2287,1162,1.968158348,1982,470,64,28,28,0,10,0,0,0,empty,CD-0722-4
"E5,H5",12777,14169,9359,4810,7541,3893,0,3900,2613,1287,2.03030303,2223,2568,481,230,228,2,65,1,0.039473684,0,empty,CD-0722-4
"E5,H6",9358,10320,6843,3477,5627,2895,0,2901,1984,917,2.163576881,1649,3022,644,258,256,2,74,2,0.16015625,0,empty,CD-0722-4
"E5,H7",8809,9411,6674,2737,5003,2395,1,2396,1640,756,2.169312169,1259,3187,654,215,210,5,66,1,0.114285714,0,empty,CD-0722-4
"E5,H8",13361,15020,9843,5177,7826,4067,0,4070,2874,1196,2.403010033,2313,3477,865,413,412,1,106,1,0.080097087,0,empty,CD-0722-4
"E5,H9",8788,9442,6652,2790,5019,2448,0,2450,1681,769,2.185955787,1344,1642,364,139,135,4,34,3,0.014814815,0,empty,CD-0722-4
"E5,H10",6869,7684,5043,2641,4042,2024,8,2033,1394,639,2.181533646,1217,1877,438,191,191,0,50,0,0.104712042,0,empty,CD-0722-4
"E5,H11",8081,9002,5516,3486,4668,2766,1,2769,1526,1243,1.22767498,1636,46,25,6,6,0,2,0,0,0,empty,CD-0722-4
"E5,H12",910355,994569,697908,296661,490914,234685,3,234930,174854,60076,2.910546641,131994,100948,10238,3863,3756,107,810,4,0.032747604,0,hg38,CD-0722-4
"E6,A1",1954567,2286440,1453472,832968,1091516,604861,3,605371,490486,114885,4.269365017,358788,261968,38506,14987,14705,282,2119,10,0.049710983,0,hg38,CD-0722-4
"E6,A2",11544,12559,8512,4047,6450,3293,3,3301,2212,1089,2.031221304,1832,2418,605,260,254,6,67,3,0.216535433,0,empty,CD-0722-4
"E6,A3",7195,7869,5283,2586,4036,1999,9,2009,1300,709,1.833568406,1124,1657,524,204,202,2,52,1,0.084158416,0,empty,CD-0722-4
"E6,A4",12607,13670,9307,4363,7097,3443,16,3463,2197,1266,1.735387046,1967,1266,231,119,117,2,36,2,0.008547009,0,empty,CD-0722-4
"E6,A5",11329,12492,8454,4038,6507,3232,2,3242,2200,1042,2.111324376,1850,3606,732,310,305,5,91,2,0.032786885,0,empty,CD-0722-4
"E6,A6",9471,10972,6974,3998,5668,3037,0,3042,2066,976,2.116803279,1816,3661,1227,484,479,5,103,2,0.087682672,0,empty,CD-0722-4
"E6,A7",7625,8324,5700,2624,4317,2187,0,2193,1458,735,1.983673469,1171,1822,331,145,144,1,43,1,0.034722222,0,empty,CD-0722-4
"E6,A8",4972,5454,3644,1810,2869,1405,0,1406,963,443,2.173814898,768,2208,571,223,221,2,63,1,0.004524887,0,empty,CD-0722-4
"E6,A9",9850,11015,7380,3635,5775,2928,3,2936,2042,894,2.284116331,1702,2096,489,188,187,1,53,1,0.037433155,0,empty,CD-0722-4
"E6,A10",9524,10955,7198,3757,5482,2771,3,2775,1761,1014,1.736686391,1590,681,177,69,69,0,15,0,0.028985507,0,empty,CD-0722-4
"E6,A11",7363,8185,5486,2699,4229,2051,0,2056,1427,629,2.268680445,1157,1386,200,76,75,1,34,1,0.08,0,empty,CD-0722-4
"E6,A12",832586,925517,633895,291622,442761,219037,1,219273,168474,50799,3.316482608,124738,157877,23409,9004,8793,211,1384,6,0.057773229,0,hg38,CD-0722-4
"E6,B1",7961,8706,5890,2816,4371,2262,0,2263,1419,844,1.681279621,1219,1652,394,168,167,1,53,1,0.035928144,0,empty,CD-0722-4
"E6,B2",8633,9241,5889,3352,4726,2512,1,2515,1553,962,1.614345114,1448,1027,167,63,63,0,17,0,0.015873016,0,empty,CD-0722-4
"E6,B3",7605,8470,5553,2917,4417,2274,0,2277,1537,740,2.077027027,1300,1878,321,143,143,0,46,0,0.027972028,0,empty,CD-0722-4
"E6,B4",7911,8742,5746,2996,4577,2404,5,2409,1538,871,1.765786452,1419,1547,323,136,130,6,39,2,0.061538462,0,empty,CD-0722-4
"E6,B5",10020,6996,4471,2525,4294,2200,0,2210,1491,719,2.073713491,1390,1282,333,108,108,0,27,0,0.175925926,0,empty,CD-0722-4
"E6,B6",1763693,2100246,1300699,799547,995485,581267,14,581800,462894,118906,3.892940642,350095,195501,36997,14008,13788,220,2076,6,0.049318248,0,hg38,CD-0722-4
"E6,B7",27056,32521,20669,11852,16064,8626,0,8632,6588,2044,3.223091977,5097,2081,342,124,123,1,46,1,0.008130081,0,empty,CD-0722-4
"E6,B8",7293,8004,5521,2483,4114,1978,0,1981,1332,649,2.05238829,1070,1360,273,118,117,1,49,1,0.017094017,0,empty,CD-0722-4
"E6,B9",11929,13578,8755,4823,6812,3564,1,3569,2298,1271,1.808025177,2080,1333,357,141,139,2,40,2,0.035971223,0,empty,CD-0722-4
"E6,B10",6259,6460,4422,2038,3685,1825,5,1844,1228,616,1.993506494,1013,578,73,34,34,0,18,0,0.058823529,0,empty,CD-0722-4
"E6,B11",13047,14222,9427,4795,7253,3821,0,3825,2245,1580,1.420886076,2169,370,28,18,18,0,14,0,0.166666667,0,empty,CD-0722-4
"E6,B12",8111,8771,5857,2914,4529,2246,16,2263,1482,781,1.897567222,1307,2389,583,224,224,0,64,0,0.075892857,0,empty,CD-0722-4
"E6,C1",1193414,1326298,910884,415414,626552,320754,18,321098,240875,80223,3.002567842,180799,115270,14303,5677,5511,166,969,5,0.042097623,0,hg38,CD-0722-4
"E6,C2",11956,13444,8756,4688,6689,3434,0,3437,2253,1184,1.902871622,1957,3139,797,300,299,1,79,1,0.163879599,0,empty,CD-0722-4
"E6,C3",2970821,3571842,2170123,1401719,1655888,984510,3,985294,794871,190423,4.174238406,596565,97345,15161,5816,5724,92,1022,5,0.07617051,0,hg38,CD-0722-4
"E6,C4",8489,9312,6301,3011,4810,2360,0,2362,1573,789,1.993662864,1319,2845,607,248,245,3,67,2,0.114285714,0,empty,CD-0722-4
"E6,C5",16383,18332,12281,6051,9232,4588,1,4593,3144,1449,2.169772257,2733,2567,634,256,255,1,69,1,0.019607843,0,empty,CD-0722-4
"E6,C6",12081,13337,8945,4392,6971,3527,1,3534,2326,1208,1.925496689,2039,2815,625,241,239,2,53,1,0.10460251,0,empty,CD-0722-4
"E6,C7",12531,14567,8951,5616,7491,4221,0,4225,2612,1613,1.619342839,2563,570,123,51,51,0,16,0,0.137254902,0,empty,CD-0722-4
"E6,C8",777301,816534,617695,198839,392660,166385,0,166586,129146,37440,3.449412393,87443,112856,18849,7189,7055,134,1085,4,0.020836286,0,hg38,CD-0722-4
"E6,C9",10130,11418,7557,3861,5879,2961,1,2965,1940,1025,1.892682927,1736,2103,308,142,137,5,42,2,0.131386861,0,empty,CD-0722-4
"E6,C10",11584,12566,8854,3712,6470,3113,8,3126,2079,1047,1.985673352,1695,2919,547,240,238,2,60,2,0.054621849,0,empty,CD-0722-4
"E6,C11",10408,11619,7691,3928,6010,3044,0,3046,2018,1028,1.963035019,1771,2313,627,262,261,1,76,1,0.011494253,0,empty,CD-0722-4
"E6,C12",963769,1093490,711609,381881,523063,282569,15,282845,226090,56755,3.983613779,164545,78073,17183,6497,6431,66,1047,5,0.037630229,0,hg38,CD-0722-4
"E6,D1",11540,12691,8450,4241,6629,3479,0,3486,2128,1358,1.567010309,1958,876,120,55,54,1,22,1,0.018518519,0,empty,CD-0722-4
"E6,D2",9734,10583,7403,3180,5503,2614,3,2621,1737,884,1.964932127,1417,3385,1012,430,420,10,95,2,0.142857143,0,empty,CD-0722-4
"E6,D3",10346,11329,7797,3532,5774,2855,0,2855,1946,909,2.140814081,1565,2819,643,279,277,2,69,1,0.057761733,0,empty,CD-0722-4
"E6,D4",8408,9449,6421,3028,4818,2356,0,2359,1627,732,2.222677596,1303,2046,299,138,136,2,45,1,0.007352941,0,empty,CD-0722-4
"E6,D5",9237,9834,6794,3040,5147,2492,0,2495,1678,817,2.053855569,1392,2681,461,215,211,4,56,2,0.146919431,0,empty,CD-0722-4
"E6,D6",12351,14015,8982,5033,6967,3772,0,3773,2349,1424,1.649578652,2199,2750,617,248,246,2,65,2,0.052845528,0,empty,CD-0722-4
"E6,D7",6900,7481,5146,2335,3885,1852,0,1852,1258,594,2.117845118,1030,2257,469,180,177,3,59,2,0.005649718,0,empty,CD-0722-4
"E6,D8",8427,9336,6196,3140,4778,2468,0,2472,1602,870,1.84137931,1423,1636,462,189,189,0,47,0,0.021164021,0,empty,CD-0722-4
"E6,D9",4666,5076,3428,1648,2566,1232,0,1235,803,432,1.858796296,666,2354,477,193,192,1,55,1,0.005208333,0,empty,CD-0722-4
"E6,D10",1150600,1301835,875265,426570,619535,318790,2,319083,243659,75424,3.230523441,183733,36204,3268,1320,1278,42,359,4,0.046948357,0,hg38,CD-0722-4
"E6,D11",9384,10169,7034,3135,5197,2465,0,2473,1630,843,1.933570581,1411,3924,1025,382,382,0,90,0,0.081151832,0,empty,CD-0722-4
"E6,D12",12355,13874,9244,4630,7139,3640,0,3644,2430,1214,2.001647446,2099,4424,1144,494,489,5,137,3,0.024539877,0,empty,CD-0722-4
"E6,E1",15335,16637,11420,5217,8474,4272,0,4277,2763,1514,1.824966975,2331,3238,728,302,301,1,103,1,0.056478405,0,empty,CD-0722-4
"E6,E2",10935,12098,7979,4119,6286,3223,5,3233,2143,1090,1.966055046,1918,3860,893,344,342,2,72,1,0.125730994,0,empty,CD-0722-4
"E6,E3",969939,1112025,734000,378025,534918,280940,10,281252,222682,58570,3.801980536,162120,205010,30516,12004,11776,228,1655,7,0.058338995,0,hg38,CD-0722-4
"E6,E4",10984,12272,8110,4162,6281,3104,28,3138,2117,1021,2.073457395,1787,3226,797,322,317,5,88,2,0.05362776,0,empty,CD-0722-4
"E6,E5",7950,8699,6129,2570,4507,2060,1,2061,1363,698,1.952722063,1105,1555,364,140,133,7,38,2,0.022556391,0,empty,CD-0722-4
"E6,E6",15552,17315,11526,5789,8769,4453,3,4460,2903,1557,1.86448298,2532,4711,1245,445,435,10,97,2,0.089655172,0,empty,CD-0722-4
"E6,E7",15049,16500,11378,5122,8328,4016,0,4018,2764,1254,2.20414673,2177,3511,608,271,268,3,85,2,0.108208955,0,empty,CD-0722-4
"E6,E8",12296,13546,9374,4172,7113,3364,15,3386,2259,1127,2.004436557,1894,3832,784,326,326,0,86,0,0.076687117,0,empty,CD-0722-4
"E6,E9",7512,8120,5582,2538,4205,2111,0,2115,1449,666,2.175675676,1159,3540,695,326,321,5,80,2,0.07165109,0,empty,CD-0722-4
"E6,E10",8315,9206,6336,2870,4664,2225,7,2234,1429,805,1.77515528,1277,2026,536,180,178,2,52,2,0.04494382,0,empty,CD-0722-4
"E6,E11",956317,1090810,713556,377254,527517,282645,2,282873,219028,63845,3.430621035,163893,248333,31358,12241,11921,320,1807,10,0.044711014,0,hg38,CD-0722-4
"E6,E12",11367,12435,8340,4095,6570,3397,3,3403,2204,1199,1.838198499,1967,2960,532,238,238,0,84,0,0.06302521,0,empty,CD-0722-4
"E6,F1",12456,13519,9351,4168,6912,3340,5,3346,2122,1224,1.733660131,1841,3018,739,251,248,3,69,2,0.10483871,0,empty,CD-0722-4
"E6,F2",11769,12861,8703,4158,6746,3286,16,3308,2281,1027,2.221032132,1922,3792,890,347,345,2,81,2,0.101449275,0,empty,CD-0722-4
"E6,F3",10215,11346,7447,3899,5772,2861,3,2866,1949,917,2.125408942,1700,3955,813,336,329,7,77,2,0.112462006,0,empty,CD-0722-4
"E6,F4",13869,15105,10478,4627,7781,3754,0,3756,2501,1255,1.992828685,2066,1068,262,89,87,2,24,2,0.011494253,0,empty,CD-0722-4
"E6,F5",12156,12870,9230,3640,6631,3055,1,3060,2079,981,2.119266055,1648,5084,768,273,266,7,86,2,0.090225564,0,empty,CD-0722-4
"E6,F6",13707,15733,9924,5809,7900,4160,0,4162,2913,1249,2.332265813,2463,3669,671,323,319,4,109,3,0.065830721,0,empty,CD-0722-4
"E6,F7",13288,14897,9831,5066,7633,3893,0,3895,2557,1338,1.911061286,2208,1679,316,133,130,3,36,2,0.023076923,0,empty,CD-0722-4
"E6,F8",1855105,2102709,1431014,671695,998097,513704,2,514179,421403,92776,4.542155299,289983,33674,3234,1296,1269,27,306,3,0.01891253,0,hg38,CD-0722-4
"E6,F9",10789,11804,8020,3784,6012,2888,28,2919,2048,871,2.351320321,1620,3520,894,314,313,1,80,1,0.089456869,0,empty,CD-0722-4
"E6,F10",1311003,1452223,1007633,444590,688458,339492,4,339876,266121,73755,3.608175717,190937,146169,18506,7141,7003,138,1181,6,0.055262031,0,hg38,CD-0722-4
"E6,F11",874532,942398,688828,253570,451590,202132,2,202368,155482,46886,3.316171139,109333,118590,11135,4319,4149,170,822,7,0.047481321,0,hg38,CD-0722-4
"E6,F12",11385,12177,8289,3888,6191,3007,0,3017,2028,989,2.050556117,1691,463,51,20,19,1,6,1,0,0,empty,CD-0722-4
"E6,G1",1144872,1337810,840401,497409,644462,364568,2,364860,290786,74074,3.925614926,216780,147735,21908,8632,8459,173,1497,5,0.046695827,0,hg38,CD-0722-4
"E6,G2",6669,7257,4780,2477,3706,1902,0,1904,1254,650,1.929230769,1077,554,116,45,44,1,17,1,0,0,empty,CD-0722-4
"E6,G3",12681,13523,9281,4242,6950,3444,22,3471,2157,1314,1.641552511,1939,3609,863,328,324,4,87,2,0.043209877,0,empty,CD-0722-4
"E6,G4",21719,24113,15718,8395,12297,6767,0,6767,4121,2646,1.5574452,3810,124,30,16,15,1,6,1,0.066666667,0,empty,CD-0722-4
"E6,G5",7902,8804,5876,2928,4478,2264,0,2267,1467,800,1.83375,1296,2252,498,179,176,3,43,2,0.096590909,0,empty,CD-0722-4
"E6,G6",11806,13015,8938,4077,6542,3137,0,3139,2131,1008,2.114087302,1793,186,29,15,14,1,9,1,0,0,empty,CD-0722-4
"E6,G7",416019,491182,322148,169034,236536,124674,3,124763,97964,26799,3.655509534,72430,41412,7172,2802,2770,32,505,6,0.029602888,0,hg38,CD-0722-4
"E6,G8",7045,7620,5296,2324,4010,1927,0,1927,1280,647,1.978361669,1128,1836,400,163,161,2,59,1,0.080745342,0,empty,CD-0722-4
"E6,G9",8976,9792,6570,3222,5135,2508,0,2512,1731,781,2.216389245,1439,2812,585,266,262,4,97,2,0.122137405,0,empty,CD-0722-4
"E6,G10",1034747,1192974,773994,418980,574869,308803,3,309096,242520,66576,3.642754146,180854,91975,14273,5511,5372,139,1086,8,0.023082651,0,hg38,CD-0722-4
"E6,G11",12316,13578,9286,4292,7023,3429,0,3435,2435,1000,2.435,1897,1965,484,205,205,0,56,0,0.165853659,0,empty,CD-0722-4
"E6,G12",7332,8183,5381,2802,4275,2224,0,2224,1408,816,1.725490196,1269,2543,658,226,224,2,63,2,0.129464286,0,empty,CD-0722-4
"E6,H1",9442,10306,6928,3378,5387,2658,1,2664,1787,877,2.037628278,1536,1772,252,110,105,5,38,2,0.019047619,0,empty,CD-0722-4
"E6,H2",1233506,1335150,967745,367405,631181,292107,17,292458,219259,73199,2.995382451,160290,286701,28757,10949,10601,348,1596,7,0.064805207,0,hg38,CD-0722-4
"E6,H3",8938,10001,6508,3493,5068,2632,0,2634,1776,858,2.06993007,1522,2021,374,165,163,2,52,2,0.165644172,0,empty,CD-0722-4
"E6,H4",11905,13056,8846,4210,6576,3225,4,3233,2110,1123,1.878895815,1815,302,58,32,31,1,9,1,0,0,empty,CD-0722-4
"E6,H5",2209508,2337243,1715328,621915,1072432,497775,4,498310,405350,92960,4.360477625,271165,68002,11002,3897,3815,82,780,3,0.018086501,0,hg38,CD-0722-4
"E6,H6",8348,9621,6096,3525,4848,2549,6,2557,1701,856,1.987149533,1472,2314,662,252,252,0,68,0,0.007936508,0,empty,CD-0722-4
"E6,H7",8915,9900,6598,3302,5020,2446,17,2464,1617,847,1.909090909,1411,2636,611,243,242,1,62,1,0.041322314,0,empty,CD-0722-4
"E6,H8",11950,13232,8774,4458,6800,3518,0,3522,2411,1111,2.170117012,2064,2903,567,251,250,1,82,1,0.116,0,empty,CD-0722-4
"E6,H9",9147,10085,6937,3148,5074,2341,0,2341,1631,710,2.297183099,1264,1548,342,123,123,0,40,0,0.227642276,0,empty,CD-0722-4
"E6,H10",6732,7121,4953,2168,3702,1837,0,1837,1217,620,1.962903226,1024,1628,311,140,137,3,34,2,0.284671533,0,empty,CD-0722-4
"E6,H11",8378,9239,5922,3317,4828,2836,0,2841,1586,1255,1.26374502,1661,84,7,3,3,0,2,0,0,0,empty,CD-0722-4
"E6,H12",8391,9046,6109,2937,4649,2410,0,2415,1667,748,2.228609626,1338,1604,222,102,98,4,39,1,0.193877551,0,empty,CD-0722-4
"E7,A1",7989,8918,5846,3072,4693,2402,9,2414,1644,770,2.135064935,1342,1783,341,140,140,0,38,0,0.228571429,0,empty,CD-0722-4
"E7,A2",11012,12158,8138,4020,6375,3255,13,3272,2163,1109,1.950405771,1842,2585,488,222,218,4,73,2,0.032110092,0,empty,CD-0722-4
"E7,A3",7129,7727,5290,2437,4143,2024,0,2026,1314,712,1.845505618,1137,1724,364,159,154,5,43,2,0.084415584,0,empty,CD-0722-4
"E7,A4",11712,13013,8792,4221,6715,3302,0,3306,2141,1165,1.83776824,1800,1227,279,119,117,2,33,1,0.008547009,0,empty,CD-0722-4
"E7,A5",812118,925814,600208,325606,458564,246488,2,246696,199143,47553,4.187811495,144102,257806,34284,13561,13257,304,1934,10,0.049860451,0,hg38,CD-0722-4
"E7,A6",651152,740256,499752,240504,365853,183776,1,183964,141442,42522,3.326325196,105473,155314,19611,7856,7703,153,1237,7,0.04907179,0,hg38,CD-0722-4
"E7,A7",7148,8129,5297,2832,4233,2228,0,2232,1447,785,1.843312102,1318,1776,530,227,224,3,49,2,0.075892857,0,empty,CD-0722-4
"E7,A8",5113,5773,3725,2048,3080,1551,0,1551,1099,452,2.431415929,951,2421,637,256,253,3,75,1,0.063241107,0,empty,CD-0722-4
"E7,A9",8602,9430,6441,2989,5032,2460,4,2464,1765,699,2.525035765,1385,2214,533,244,240,4,71,1,0.075,0,empty,CD-0722-4
"E7,A10",8713,9412,6539,2873,5006,2509,0,2512,1685,827,2.037484885,1340,662,232,76,74,2,20,2,0.175675676,0,empty,CD-0722-4
"E7,A11",6594,7222,4999,2223,3827,1858,0,1860,1288,572,2.251748252,1041,2501,492,182,179,3,47,2,0.011173184,0,empty,CD-0722-4
"E7,A12",10753,11975,8045,3930,6419,3234,2,3237,2235,1002,2.230538922,1829,5331,1134,435,433,2,107,2,0.069284065,0,empty,CD-0722-4
"E7,B1",7873,8558,5781,2777,4555,2307,0,2311,1567,744,2.106182796,1321,1626,375,161,157,4,43,1,0.025477707,0,empty,CD-0722-4
"E7,B2",8035,8887,5501,3386,4703,2556,0,2556,1633,923,1.769230769,1540,734,190,65,62,3,24,2,0.096774194,0,empty,CD-0722-4
"E7,B3",7341,8022,5297,2725,4277,2155,1,2157,1458,699,2.08583691,1233,1685,302,120,117,3,48,1,0.034188034,0,empty,CD-0722-4
"E7,B4",7568,8641,5515,3126,4611,2453,0,2455,1587,868,1.828341014,1435,1733,521,220,219,1,55,1,0.0456621,0,empty,CD-0722-4
"E7,B5",11267,7815,5130,2685,4912,2573,0,2586,1880,706,2.662889518,1550,1941,414,183,181,2,43,1,0.038674033,0,empty,CD-0722-4
"E7,B6",9318,10402,6855,3547,5590,2916,0,2916,1884,1032,1.825581395,1676,2977,684,278,275,3,82,3,0.069090909,0,empty,CD-0722-4
"E7,B7",23969,27607,17853,9754,13887,7732,0,7735,5084,2651,1.91776688,4417,2169,353,150,146,4,44,2,0.054794521,0,empty,CD-0722-4
"E7,B8",7277,8420,5462,2958,4397,2216,0,2218,1569,649,2.417565485,1338,1934,492,170,170,0,47,0,0.129411765,0,empty,CD-0722-4
"E7,B9",11417,12605,8362,4243,6569,3383,0,3385,2208,1177,1.87595582,1961,1506,338,89,88,1,37,1,0.068181818,0,empty,CD-0722-4
"E7,B10",725795,799885,511184,288701,418993,222726,7,223239,176683,46556,3.795064009,133433,60063,7099,2604,2542,62,506,5,0.067269866,0,hg38,CD-0722-4
"E7,B11",11741,13165,8511,4654,6938,3787,0,3789,2210,1579,1.399620013,2225,352,87,41,41,0,18,0,0,0,empty,CD-0722-4
"E7,B12",7645,8697,5605,3092,4670,2450,0,2450,1700,750,2.266666667,1413,2613,839,301,301,0,56,0,0.112956811,0,empty,CD-0722-4
"E7,C1",15562,16671,11651,5020,8913,4310,0,4315,2916,1399,2.084345961,2374,1512,224,92,91,1,37,1,0.065934066,0,empty,CD-0722-4
"E7,C2",11603,13002,8460,4542,6819,3540,0,3544,2318,1226,1.890701468,2072,2923,913,342,340,2,90,2,0.129411765,0,empty,CD-0722-4
"E7,C3",12305,13616,9195,4421,7115,3530,0,3533,2266,1267,1.788476717,2013,1421,245,114,112,2,39,2,0,0,empty,CD-0722-4
"E7,C4",1684292,1939074,1239434,699640,943862,525190,6,525679,438327,87352,5.017938914,308518,333286,61098,24326,23986,340,3066,7,0.05198866,0,hg38,CD-0722-4
"E7,C5",2453264,2901855,1731858,1169997,1411593,903796,5,904461,656866,247595,2.652985723,539718,14198,1970,435,419,16,102,2,0.174224344,0,hg38,CD-0722-4
"E7,C6",14603,16556,10784,5772,8761,4632,2,4641,3285,1356,2.422566372,2638,2454,645,246,245,1,53,1,0.040816327,0,empty,CD-0722-4
"E7,C7",12107,13969,8784,5185,7382,4019,1,4022,2513,1509,1.665341286,2427,743,190,67,67,0,16,0,0.014925373,0,empty,CD-0722-4
"E7,C8",17055,18520,12930,5590,9595,4596,0,4598,3274,1324,2.472809668,2482,4710,1401,541,537,4,134,1,0.057728119,0,empty,CD-0722-4
"E7,C9",9875,10958,7388,3570,5882,2928,17,2950,2020,930,2.172043011,1674,2021,283,127,125,2,43,2,0.056,0,empty,CD-0722-4
"E7,C10",10936,11792,8291,3501,6201,2989,0,2995,2004,991,2.022199798,1635,3369,941,340,338,2,76,1,0.050295858,0,empty,CD-0722-4
"E7,C11",846002,972426,630793,341633,480532,255138,21,255402,196951,58451,3.369506082,151467,158898,26302,10306,10113,193,1466,7,0.044101651,0,hg38,CD-0722-4
"E7,C12",14489,16034,10836,5198,8492,4153,0,4164,2786,1378,2.021770682,2398,2771,459,182,180,2,62,1,0.033333333,0,empty,CD-0722-4
"E7,D1",11246,12671,8333,4338,6668,3525,17,3547,2191,1356,1.615781711,2003,1240,273,108,108,0,28,0,0.175925926,0,empty,CD-0722-4
"E7,D2",9364,9867,7224,2643,5184,2360,0,2364,1551,813,1.907749077,1251,4310,1041,441,439,2,104,1,0.079726651,0,empty,CD-0722-4
"E7,D3",8542,9400,6089,3311,5042,2571,0,2579,1714,865,1.98150289,1494,1830,318,138,138,0,45,0,0.007246377,0,empty,CD-0722-4
"E7,D4",799495,941638,591532,350106,465238,256913,0,257119,197058,60061,3.280964353,154427,177680,23175,8955,8756,199,1457,6,0.04568296,0,hg38,CD-0722-4
"E7,D5",7223,7877,5410,2467,4216,2085,0,2088,1382,706,1.957507082,1175,2036,410,175,173,2,46,2,0.046242775,0,empty,CD-0722-4
"E7,D6",11108,12330,7961,4369,6384,3384,0,3387,2120,1267,1.673243883,1956,2319,517,196,194,2,67,1,0.077319588,0,empty,CD-0722-4
"E7,D7",6339,6822,4831,1991,3579,1718,7,1726,1153,573,2.012216405,904,2447,751,255,253,2,71,2,0.177865613,0,empty,CD-0722-4
"E7,D8",7650,8279,5588,2691,4356,2147,0,2147,1445,702,2.058404558,1242,1936,448,147,138,9,42,2,0.036231884,0,empty,CD-0722-4
"E7,D9",4601,5009,3443,1566,2633,1257,6,1263,908,355,2.557746479,708,2174,576,223,223,0,50,0,0.031390135,0,empty,CD-0722-4
"E7,D10",3044669,3603937,2234575,1369362,1702440,992481,9,993358,777486,215872,3.601606508,599360,180241,23009,9086,8913,173,1657,9,0.039941658,0,hg38,CD-0722-4
"E7,D11",8691,9428,6506,2922,5067,2478,3,2483,1622,861,1.883855981,1374,4048,1052,372,359,13,80,2,0.091922006,0,empty,CD-0722-4
"E7,D12",14122,15913,10385,5528,8346,4304,1,4314,2899,1415,2.048763251,2512,5724,1567,642,640,2,146,1,0.1609375,0,empty,CD-0722-4
"E7,E1",806244,872343,622811,249532,427304,197055,0,197295,151528,45767,3.310857168,108519,116790,12516,4896,4767,129,903,7,0.071113908,0,hg38,CD-0722-4
"E7,E2",9864,10876,7107,3769,5764,2928,31,2961,1859,1102,1.686932849,1719,2196,254,118,117,1,57,1,0.051282051,0,empty,CD-0722-4
"E7,E3",6349,7145,4776,2369,3788,1877,0,1881,1286,595,2.161344538,1078,3294,951,367,364,3,81,2,0.057692308,0,empty,CD-0722-4
"E7,E4",10178,11888,7607,4281,6284,3248,0,3254,2146,1108,1.936823105,1929,3618,926,355,348,7,91,2,0.020114943,0,empty,CD-0722-4
"E7,E5",7930,8471,5925,2546,4476,2008,42,2056,1346,710,1.895774648,1152,2207,519,205,203,2,50,1,0.054187192,0,empty,CD-0722-4
"E7,E6",14500,16042,10832,5210,8319,4113,0,4127,2724,1403,1.941553813,2336,4576,1255,476,474,2,99,2,0.03164557,0,empty,CD-0722-4
"E7,E7",15125,16810,11370,5440,8789,4357,20,4384,3015,1369,2.202337473,2453,3973,746,367,359,8,111,2,0.050139276,0,empty,CD-0722-4
"E7,E8",1073607,1214463,812210,402253,591209,311022,3,311339,239931,71408,3.36000168,175984,142604,25422,9705,9592,113,1655,8,0.030233528,0,hg38,CD-0722-4
"E7,E9",6776,7608,5115,2493,4009,2012,1,2016,1433,583,2.457975986,1110,2805,726,305,302,3,88,2,0.052980132,0,empty,CD-0722-4
"E7,E10",8447,9631,6227,3404,5005,2589,7,2596,1722,874,1.970251716,1542,2070,359,180,177,3,57,1,0.056497175,0,empty,CD-0722-4
"E7,E11",9277,10020,6950,3070,5396,2708,0,2711,1785,926,1.927645788,1485,2770,457,212,208,4,60,2,0.076923077,0,empty,CD-0722-4
"E7,E12",10700,11890,7832,4058,6291,3135,22,3159,2188,971,2.253347065,1843,2528,620,228,216,12,66,3,0.162037037,0,empty,CD-0722-4
"E7,F1",15554,16740,11692,5048,8632,4123,0,4124,2735,1389,1.969042477,2235,5718,1314,493,486,7,104,2,0.127572016,0,empty,CD-0722-4
"E7,F2",9144,9655,6787,2868,5177,2500,2,2508,1613,895,1.802234637,1346,4300,817,342,330,12,95,2,0.13030303,0,empty,CD-0722-4
"E7,F3",9424,10234,6954,3280,5552,2724,0,2728,1864,864,2.157407407,1529,3669,793,355,351,4,108,2,0.034188034,0,empty,CD-0722-4
"E7,F4",1106526,1245099,827782,417317,613491,320145,9,320528,261034,59494,4.387568494,184230,68796,10678,4091,4010,81,726,3,0.045137157,0,hg38,CD-0722-4
"E7,F5",10796,11759,7971,3788,6258,3009,1,3015,1971,1044,1.887931034,1707,2896,589,200,199,1,73,1,0.020100503,0,empty,CD-0722-4
"E7,F6",14326,16229,10626,5603,8751,4610,0,4616,3212,1404,2.287749288,2715,5523,1058,463,450,13,139,2,0.135555556,0,empty,CD-0722-4
"E7,F7",12287,13362,9221,4141,7233,3499,0,3501,2384,1117,2.134288272,1953,1810,325,146,145,1,43,1,0.027586207,0,empty,CD-0722-4
"E7,F8",9337,10200,7012,3188,5406,2674,0,2678,1887,791,2.385587863,1473,437,76,36,36,0,14,0,0,0,empty,CD-0722-4
"E7,F9",9619,10635,7248,3387,5621,2720,0,2724,1928,796,2.422110553,1543,4098,1120,416,411,5,105,2,0.03892944,0,empty,CD-0722-4
"E7,F10",13742,15249,10577,4672,8054,3902,0,3908,2712,1196,2.267558528,2126,2728,866,324,322,2,83,2,0.068322981,0,empty,CD-0722-4
"E7,F11",8869,9885,6607,3278,5207,2475,0,2476,1666,810,2.056790123,1418,2652,415,191,183,8,51,1,0.081967213,0,empty,CD-0722-4
"E7,F12",1045078,1205913,764277,441636,583720,322508,0,322864,263279,59585,4.418544936,191303,23082,2775,1072,1059,13,239,3,0.0802644,0,hg38,CD-0722-4
"E7,G1",12405,13572,9431,4141,7154,3478,0,3481,2404,1077,2.232126277,1900,3984,954,372,369,3,83,1,0.094850949,0,empty,CD-0722-4
"E7,G2",6195,6704,4396,2308,3598,1877,2,1880,1233,647,1.905718702,1089,754,72,38,38,0,15,0,0.078947368,0,empty,CD-0722-4
"E7,G3",12029,12804,8873,3931,6874,3393,0,3398,2162,1236,1.749190939,1848,3260,1098,449,444,5,87,2,0.150900901,0,empty,CD-0722-4
"E7,G4",21822,24567,15708,8859,12966,7308,1,7318,4511,2807,1.607053794,4290,191,22,9,9,0,8,0,0.111111111,0,empty,CD-0722-4
"E7,G5",6994,7820,5186,2634,4106,2057,0,2058,1336,722,1.850415512,1175,2134,549,191,188,3,50,2,0.021276596,0,empty,CD-0722-4
"E7,G6",1485537,1705802,1121025,584777,819687,440274,2,440645,354190,86455,4.096813371,253615,11771,1939,757,749,8,187,2,0.029372497,0,hg38,CD-0722-4
"E7,G7",9025,9938,6784,3154,5287,2532,0,2535,1713,822,2.083941606,1401,3826,951,392,380,12,103,2,0.102631579,0,empty,CD-0722-4
"E7,G8",1050719,1254709,765510,489199,612317,352671,24,353013,288350,64663,4.459273464,213653,262506,45548,18066,17800,266,2414,9,0.063707865,0,hg38,CD-0722-4
"E7,G9",8368,9258,6242,3016,5050,2528,0,2530,1659,871,1.904707233,1474,3755,913,351,343,8,97,2,0.034985423,0,empty,CD-0722-4
"E7,G10",10736,12004,8113,3891,6316,3193,1,3197,2206,991,2.226034309,1755,3150,870,384,381,3,98,2,0.05511811,0,empty,CD-0722-4
"E7,G11",9849,10607,7459,3148,5792,2773,1,2776,1906,870,2.190804598,1538,2250,779,307,307,0,75,0,0.06514658,0,empty,CD-0722-4
"E7,G12",7504,8219,5481,2738,4361,2255,0,2260,1434,826,1.736077482,1309,2533,683,274,274,0,61,0,0.109489051,0,empty,CD-0722-4
"E7,H1",9306,10300,6924,3376,5575,2821,0,2828,1993,835,2.386826347,1590,1711,279,104,101,3,35,2,0.168316832,0,empty,CD-0722-4
"E7,H2",9914,10838,7458,3380,5663,2786,1,2790,1852,938,1.974413646,1553,3807,1020,377,374,3,104,1,0.096256684,0,empty,CD-0722-4
"E7,H3",8402,9496,6140,3356,5023,2577,0,2577,1764,813,2.169741697,1493,2252,569,216,211,5,56,2,0.037914692,0,empty,CD-0722-4
"E7,H4",10923,12067,8182,3885,6359,3174,1,3184,2091,1093,1.913083257,1780,251,107,28,28,0,7,0,0,0,empty,CD-0722-4
"E7,H5",12273,14200,8978,5222,7375,3850,16,3866,2598,1268,2.048895899,2348,3063,725,289,287,2,79,1,0.031358885,0,empty,CD-0722-4
"E7,H6",8763,10005,6489,3516,5215,2710,0,2715,1837,878,2.092255125,1583,3270,732,298,297,1,94,1,0.016835017,0,empty,CD-0722-4
"E7,H7",8880,9789,6588,3201,5209,2626,0,2626,1723,903,1.908084164,1475,2803,705,274,270,4,64,2,0.166666667,0,empty,CD-0722-4
"E7,H8",11561,13026,8505,4521,6920,3604,0,3608,2516,1092,2.304029304,2113,3657,748,301,297,4,90,2,0.063973064,0,empty,CD-0722-4
"E7,H9",7795,8348,5906,2442,4490,2117,4,2123,1469,654,2.24617737,1150,1865,532,181,180,1,38,1,0.061111111,0,empty,CD-0722-4
"E7,H10",6579,7132,4851,2281,3838,1921,0,1926,1316,610,2.157377049,1088,1996,591,235,233,2,49,2,0.124463519,0,empty,CD-0722-4
"E7,H11",7283,8323,5135,3188,4405,2599,1,2604,1455,1149,1.266318538,1558,70,10,5,2,3,2,1,0,0,empty,CD-0722-4
"E7,H12",8022,9038,5806,3232,4784,2526,1,2531,1791,740,2.42027027,1498,2567,301,138,135,3,38,2,0.059259259,0,empty,CD-0722-4
"E8,A1",8027,8955,5815,3140,4715,2418,0,2420,1651,769,2.146944083,1396,1516,265,124,116,8,42,2,0.146551724,0,empty,CD-0722-4
"E8,A2",13034,14391,9748,4643,7390,3695,8,3705,2436,1269,1.919621749,2040,2399,533,235,235,0,64,0,0.072340426,0,empty,CD-0722-4
"E8,A3",7903,8573,5798,2775,4537,2292,0,2297,1541,756,2.038359788,1296,1697,402,160,158,2,43,2,0.006329114,0,empty,CD-0722-4
"E8,A4",12298,13302,9169,4133,6950,3398,0,3407,2147,1260,1.703968254,1888,1399,349,150,148,2,34,1,0.013513514,0,empty,CD-0722-4
"E8,A5",849414,967732,633680,334052,475268,251398,1,251648,203800,47848,4.259321184,145738,217362,22703,8935,8698,237,1479,8,0.074959761,0,hg38,CD-0722-4
"E8,A6",13273,15382,9842,5540,8118,4233,25,4261,3035,1226,2.475530179,2493,3510,698,256,255,1,92,1,0.090196078,0,empty,CD-0722-4
"E8,A7",7699,8712,5674,3038,4663,2551,0,2551,1671,880,1.898863636,1460,1371,204,87,86,1,35,1,0.069767442,0,empty,CD-0722-4
"E8,A8",5811,6506,4334,2172,3432,1723,0,1725,1216,509,2.388998035,1000,2564,748,277,271,6,66,2,0.110701107,0,empty,CD-0722-4
"E8,A9",10532,11739,7961,3778,6156,3133,0,3135,2177,958,2.272442589,1751,2728,554,230,228,2,69,2,0.057017544,0,empty,CD-0722-4
"E8,A10",615738,725885,454151,271734,358652,200088,13,200228,161969,38259,4.233487545,118958,53118,8871,3538,3485,53,613,3,0.082926829,0,hg38,CD-0722-4
"E8,A11",7439,8257,5650,2607,4334,2046,13,2063,1418,645,2.198449612,1176,1970,491,206,203,3,50,1,0.078817734,0,empty,CD-0722-4
"E8,A12",13202,14474,10024,4450,7406,3627,28,3662,2545,1117,2.278424351,2034,5364,1360,534,529,5,119,2,0.051039698,0,empty,CD-0722-4
"E8,B1",8705,9759,6461,3298,5100,2623,0,2632,1653,979,1.68845761,1531,1468,275,131,130,1,46,1,0.092307692,0,empty,CD-0722-4
"E8,B2",1471441,1662766,1067776,594990,808482,441587,3,441971,360853,81118,4.448494785,259589,103429,12126,4944,4834,110,830,7,0.059577989,0,hg38,CD-0722-4
"E8,B3",8670,9491,6429,3062,5064,2579,0,2579,1766,813,2.172201722,1406,2275,482,192,186,6,48,1,0.043010753,0,empty,CD-0722-4
"E8,B4",11567,12830,8701,4129,6698,3431,0,3433,2368,1065,2.223474178,1929,2012,441,142,141,1,44,1,0.056737589,0,empty,CD-0722-4
"E8,B5",16361,13647,8746,4901,7783,4041,0,4052,2854,1198,2.38230384,2456,1407,372,133,130,3,38,2,0.138461538,0,empty,CD-0722-4
"E8,B6",11294,12885,8218,4667,6707,3560,0,3560,2451,1109,2.210099188,2105,2520,618,277,264,13,78,2,0.03030303,0,empty,CD-0722-4
"E8,B7",9606,10896,7224,3672,5736,2856,0,2859,1924,935,2.057754011,1668,1711,279,140,140,0,46,0,0.028571429,0,empty,CD-0722-4
"E8,B8",557349,617249,429769,187480,306249,150816,0,150933,116661,34272,3.40397409,83822,41582,5530,2211,2163,48,419,3,0.049930652,0,hg38,CD-0722-4
"E8,B9",13013,14428,9703,4725,7520,3753,0,3753,2435,1318,1.847496206,2122,1557,250,95,92,3,35,1,0.065217391,0,empty,CD-0722-4
"E8,B10",7790,8305,5426,2879,4634,2350,3,2357,1587,770,2.061038961,1370,756,154,66,65,1,26,1,0,0,empty,CD-0722-4
"E8,B11",13721,15435,10031,5404,7914,4179,7,4190,2517,1673,1.504482965,2448,310,116,32,32,0,10,0,0,0,empty,CD-0722-4
"E8,B12",9310,10442,6854,3588,5502,2753,16,2771,1954,817,2.391676867,1619,2508,475,177,175,2,61,1,0.062857143,0,empty,CD-0722-4
"E8,C1",17137,18388,12832,5556,9915,4928,0,4930,3344,1586,2.108448928,2727,1656,287,107,105,2,43,2,0.114285714,0,empty,CD-0722-4
"E8,C2",12315,13874,9022,4852,7318,3846,0,3854,2512,1342,1.871833085,2242,3342,910,332,329,3,81,1,0.045592705,0,empty,CD-0722-4
"E8,C3",1151126,1324897,871449,453448,642457,334852,0,335155,258595,76560,3.377677638,196467,62031,7533,2845,2753,92,542,5,0.044315292,0,hg38,CD-0722-4
"E8,C4",984830,1088037,762370,325667,531394,257788,6,258030,212215,45815,4.631998254,142538,178514,25084,9837,9616,221,1491,7,0.036501664,0,hg38,CD-0722-4
"E8,C5",12332,13714,9069,4645,7346,3814,21,3837,2632,1205,2.184232365,2184,2350,574,214,212,2,62,1,0.179245283,0,empty,CD-0722-4
"E8,C6",14005,15749,10120,5629,8200,4336,2,4342,3090,1252,2.468051118,2550,2251,522,198,198,0,58,0,0.055555556,0,empty,CD-0722-4
"E8,C7",13228,15225,9601,5624,8027,4394,2,4406,2680,1726,1.552723059,2655,531,120,47,47,0,8,0,0,0,empty,CD-0722-4
"E8,C8",16215,18173,11873,6300,9433,4926,0,4932,3323,1609,2.065257924,2825,4278,1142,396,393,3,96,2,0.078880407,0,empty,CD-0722-4
"E8,C9",906187,1038754,681257,357497,507485,264622,2,264903,198019,66884,2.960633335,155963,134012,13860,5610,5404,206,915,6,0.043301258,0,hg38,CD-0722-4
"E8,C10",12109,13000,9076,3924,6808,3277,23,3306,2228,1078,2.066790353,1838,2500,672,261,261,0,74,0,0.088122605,0,empty,CD-0722-4
"E8,C11",11116,11800,8172,3628,6361,3194,0,3196,2198,998,2.20240481,1792,2640,621,242,238,4,59,2,0.025210084,0,empty,CD-0722-4
"E8,C12",948516,1067059,710139,356920,518903,272641,16,272934,214425,58509,3.664820797,157168,107674,17138,6653,6539,114,1149,7,0.069735434,0,hg38,CD-0722-4
"E8,D1",1655326,1805385,1267343,538042,869803,427873,1,428308,343262,85046,4.036192178,239726,36044,6040,2144,2106,38,389,3,0.024691358,0,hg38,CD-0722-4
"E8,D2",9753,10562,7527,3035,5580,2575,0,2583,1669,914,1.826039387,1398,3889,1021,421,420,1,106,1,0.166666667,0,empty,CD-0722-4
"E8,D3",9649,10684,7129,3555,5617,2919,0,2921,1975,946,2.087737844,1655,2237,538,204,203,1,47,1,0.039408867,0,empty,CD-0722-4
"E8,D4",8209,8995,6049,2946,4763,2405,8,2417,1656,761,2.1760841,1350,1642,233,123,122,1,41,1,0.12295082,0,empty,CD-0722-4
"E8,D5",8286,9231,6099,3132,4956,2588,0,2598,1705,893,1.909294513,1518,2105,588,210,206,4,44,1,0.058252427,0,empty,CD-0722-4
"E8,D6",11801,13441,8529,4912,6965,3805,0,3810,2357,1453,1.622161046,2255,2710,584,243,241,2,80,2,0.029045643,0,empty,CD-0722-4
"E8,D7",7033,7725,5343,2382,4048,1959,1,1964,1316,648,2.030864198,1097,2316,561,213,210,3,62,1,0.023809524,0,empty,CD-0722-4
"E8,D8",8911,9928,6476,3452,5223,2622,9,2634,1738,896,1.939732143,1560,2231,562,234,232,2,54,1,0.043103448,0,empty,CD-0722-4
"E8,D9",5015,5421,3858,1563,2874,1355,0,1357,962,395,2.435443038,753,1953,510,215,211,4,51,1,0.090047393,0,empty,CD-0722-4
"E8,D10",2063607,2430938,1492076,938862,1170532,693391,6,693970,571618,122352,4.671913822,419720,33476,2472,938,894,44,289,3,0.025727069,0,hg38,CD-0722-4
"E8,D11",9762,10829,7322,3507,5602,2753,13,2771,1842,929,1.98277718,1576,4073,1114,433,433,0,101,0,0.03926097,0,empty,CD-0722-4
"E8,D12",13168,14574,9822,4752,7598,3744,2,3746,2568,1178,2.179966044,2113,4516,1099,429,424,5,129,2,0.014150943,0,empty,CD-0722-4
"E8,E1",17136,18556,12772,5784,9749,4808,0,4809,3160,1649,1.916312917,2682,3561,1081,364,362,2,92,2,0.011049724,0,empty,CD-0722-4
"E8,E2",10926,12343,8023,4320,6358,3238,0,3241,2068,1173,1.763000853,1909,2193,394,201,200,1,59,1,0.055,0,empty,CD-0722-4
"E8,E3",7077,7871,5263,2608,4149,2008,0,2015,1351,664,2.034638554,1189,3120,857,320,319,1,84,1,0.053291536,0,empty,CD-0722-4
"E8,E4",11341,12940,8442,4498,6776,3541,22,3563,2427,1136,2.136443662,2044,2873,536,220,217,3,66,3,0.129032258,0,empty,CD-0722-4
"E8,E5",1243679,1395245,947208,448037,672282,345795,2,346154,280323,65831,4.25822181,194068,185522,23260,9139,8974,165,1487,6,0.043124582,0,hg38,CD-0722-4
"E8,E6",1052999,1226027,781699,444328,591476,314521,0,314807,266926,47881,5.57477914,186130,11307,3323,1085,1076,9,383,3,0.059479554,0,hg38,CD-0722-4
"E8,E7",17045,18644,12787,5857,9886,5011,0,5017,3480,1537,2.264150943,2788,3872,975,380,373,7,99,2,0.029490617,0,empty,CD-0722-4
"E8,E8",14186,15560,10782,4778,8179,3975,0,3982,2699,1283,2.103663289,2176,4343,989,414,408,6,100,2,0.017156863,0,empty,CD-0722-4
"E8,E9",846861,1016099,590973,425126,499977,307139,0,307389,243415,63974,3.804905118,186508,5767,1740,583,572,11,176,2,0.120629371,0,hg38,CD-0722-4
"E8,E10",8740,9869,6478,3391,5162,2562,0,2562,1750,812,2.155172414,1500,3072,505,231,228,3,66,2,0.048245614,0,empty,CD-0722-4
"E8,E11",10426,11394,7803,3591,6051,3006,1,3007,2021,986,2.04969574,1720,2903,464,216,212,4,65,1,0.04245283,0,empty,CD-0722-4
"E8,E12",12377,13657,9134,4523,7280,3692,0,3695,2471,1224,2.01879085,2118,2743,662,256,253,3,78,1,0.086956522,0,empty,CD-0722-4
"E8,F1",13093,14039,9739,4300,7359,3600,0,3603,2445,1158,2.111398964,2011,3408,886,367,365,2,93,2,0.095890411,0,empty,CD-0722-4
"E8,F2",11071,12328,8200,4128,6313,3063,13,3082,2007,1075,1.866976744,1735,3502,854,370,367,3,98,1,0.005449591,0,empty,CD-0722-4
"E8,F3",10896,12283,8178,4105,6508,3254,0,3260,2249,1011,2.224530168,1898,3512,708,264,260,4,73,1,0.007692308,0,empty,CD-0722-4
"E8,F4",14638,15678,10884,4794,8334,4019,20,4049,2712,1337,2.02842184,2269,944,146,66,64,2,25,2,0,0,empty,CD-0722-4
"E8,F5",11814,12715,8864,3851,6630,3137,5,3145,2077,1068,1.944756554,1746,2961,841,315,312,3,91,2,0.105769231,0,empty,CD-0722-4
"E8,F6",17480,20245,12924,7321,10333,5509,10,5520,3949,1571,2.513685551,3223,4097,836,326,324,2,110,2,0.12345679,0,empty,CD-0722-4
"E8,F7",13005,14293,9714,4579,7863,3959,0,3962,2690,1272,2.114779874,2267,1477,279,135,130,5,45,1,0.030769231,0,empty,CD-0722-4
"E8,F8",10631,11707,7958,3749,6106,3017,8,3028,2135,893,2.390817469,1659,411,59,20,19,1,12,1,0,0,empty,CD-0722-4
"E8,F9",11657,12687,8661,4026,6815,3292,2,3294,2274,1020,2.229411765,1902,4685,1040,388,382,6,110,3,0.020942408,0,empty,CD-0722-4
"E8,F10",2411375,2712125,1825353,886772,1282262,678163,7,678889,539250,139639,3.861743496,385426,425704,72573,27618,27086,532,3000,7,0.054714613,0,hg38,CD-0722-4
"E8,F11",10289,11004,7823,3181,5719,2677,0,2677,1829,848,2.156839623,1466,2440,382,175,169,6,49,2,0.130177515,0,empty,CD-0722-4
"E8,F12",11719,12593,8604,3989,6689,3216,0,3223,2219,1004,2.210159363,1848,325,90,43,43,0,17,0,0.093023256,0,empty,CD-0722-4
"E8,G1",13489,14749,10177,4572,7844,3887,0,3887,2613,1274,2.051020408,2131,4249,805,333,333,0,85,0,0.075075075,0,empty,CD-0722-4
"E8,G2",9877,10874,6923,3951,5627,3172,0,3176,2058,1118,1.84078712,1829,830,160,69,68,1,19,1,0.176470588,0,empty,CD-0722-4
"E8,G3",12757,13615,9539,4076,7252,3599,0,3599,2270,1329,1.708051166,2001,3064,727,263,259,4,73,1,0.061776062,0,empty,CD-0722-4
"E8,G4",22039,24683,15916,8767,12838,7030,64,7099,4386,2713,1.616660523,4089,176,20,10,10,0,6,0,0,0,empty,CD-0722-4
"E8,G5",7575,8653,5636,3017,4461,2212,10,2224,1469,755,1.945695364,1335,2228,585,221,219,2,54,1,0.03196347,0,empty,CD-0722-4
"E8,G6",11767,12706,8826,3880,6622,3247,0,3248,2168,1080,2.007407407,1785,224,30,20,20,0,10,0,0,0,empty,CD-0722-4
"E8,G7",10515,11484,7925,3559,6076,2859,0,2860,2069,791,2.615676359,1577,3393,749,248,245,3,84,1,0.114285714,0,empty,CD-0722-4
"E8,G8",7738,8651,5757,2894,4503,2256,0,2258,1490,768,1.940104167,1327,2639,734,275,273,2,76,1,0.153846154,0,empty,CD-0722-4
"E8,G9",14017,15740,10135,5605,8338,4522,14,4545,3194,1351,2.364174685,2654,3697,875,407,403,4,110,3,0.091811414,0,empty,CD-0722-4
"E8,G10",12422,13638,9482,4156,7216,3540,56,3614,2418,1196,2.02173913,1964,3224,827,305,303,2,89,2,0.00990099,0,empty,CD-0722-4
"E8,G11",11516,12588,8654,3934,6651,3223,0,3223,2252,971,2.319258496,1790,2168,439,179,178,1,59,1,0.033707865,0,empty,CD-0722-4
"E8,G12",12533,14841,8507,6334,7650,4546,0,4547,2955,1592,1.856155779,2838,3554,921,338,335,3,71,3,0.07761194,0,empty,CD-0722-4
"E8,H1",11683,12901,8749,4152,6736,3358,0,3366,2337,1029,2.271137026,1885,1870,599,203,202,1,48,1,0.014851485,0,empty,CD-0722-4
"E8,H2",10114,11281,7521,3760,5918,3027,0,3027,2005,1022,1.96183953,1759,3623,931,346,337,9,83,2,0.077151335,0,empty,CD-0722-4
"E8,H3",10138,11349,7425,3924,6014,3137,15,3156,2210,946,2.33615222,1873,2291,483,212,207,5,61,2,0.062801932,0,empty,CD-0722-4
"E8,H4",12254,13668,9171,4497,7062,3525,1,3528,2357,1171,2.012809564,2029,209,20,12,12,0,4,0,0,0,empty,CD-0722-4
"E8,H5",22313,25265,16026,9239,12702,7119,0,7126,4729,2397,1.97288277,4163,2881,602,230,225,5,65,2,0.08,0,empty,CD-0722-4
"E8,H6",10324,11738,7571,4167,6098,3198,0,3202,2229,973,2.290853032,1892,2783,574,222,220,2,79,1,0.090909091,0,empty,CD-0722-4
"E8,H7",8827,9404,6483,2921,5015,2425,1,2427,1610,817,1.970624235,1375,2625,525,177,169,8,52,2,0.041420118,0,empty,CD-0722-4
"E8,H8",21848,25398,16064,9334,13103,7249,0,7257,5375,1882,2.856004251,4233,3568,866,378,377,1,103,1,0.061007958,0,empty,CD-0722-4
"E8,H9",9912,10571,7539,3032,5445,2510,0,2512,1752,760,2.305263158,1355,1422,380,158,158,0,42,0,0.069620253,0,empty,CD-0722-4
"E8,H10",11043,12493,8202,4291,6233,3136,20,3158,2249,909,2.474147415,1857,2437,525,221,221,0,52,0,0.067873303,0,empty,CD-0722-4
"E8,H11",8135,9177,5651,3526,4842,2762,21,2788,1564,1224,1.277777778,1674,105,33,10,10,0,4,0,0,0,empty,CD-0722-4
"E8,H12",760322,890525,544836,345689,441726,253909,2,254097,207598,46499,4.464569131,154306,45490,11578,4555,4526,29,873,3,0.087715422,0,hg38,CD-0722-4
"E9,A1",7385,8192,5330,2862,4369,2263,0,2266,1493,773,1.931435964,1311,1257,153,64,61,3,25,2,0.31147541,0,empty,CD-0722-4
"E9,A2",11131,12539,8230,4309,6606,3438,0,3441,2214,1227,1.804400978,2025,1961,648,276,275,1,69,1,0.029090909,0,empty,CD-0722-4
"E9,A3",7476,8254,5395,2859,4485,2262,0,2269,1542,727,2.121045392,1305,1718,310,143,143,0,37,0,0,0,empty,CD-0722-4
"E9,A4",11769,13213,8831,4382,6938,3438,0,3441,2288,1153,1.984388552,1977,799,114,60,57,3,22,1,0,0,empty,CD-0722-4
"E9,A5",11056,12066,8143,3923,6503,3281,11,3293,2241,1052,2.130228137,1825,3303,658,297,289,8,88,2,0.065743945,0,empty,CD-0722-4
"E9,A6",861848,1034838,636434,398404,504928,286376,3,286656,229116,57540,3.9818561,170830,218979,33966,13547,13298,249,2007,6,0.041058806,0,hg38,CD-0722-4
"E9,A7",7231,8054,5346,2708,4345,2306,0,2307,1517,790,1.920253165,1311,1235,332,98,97,1,28,1,0.010309278,0,empty,CD-0722-4
"E9,A8",436210,413812,363998,49814,202246,55186,11,55275,43558,11717,3.717504481,22603,4889,1672,561,556,5,198,1,0.01618705,0,empty,CD-0722-4
"E9,A9",8687,9755,6537,3218,5144,2601,0,2601,1812,789,2.296577947,1487,1663,288,136,136,0,54,0,0.007352941,0,empty,CD-0722-4
"E9,A10",8395,9322,6346,2976,4891,2382,0,2389,1653,736,2.245923913,1388,675,124,48,48,0,16,0,0,0,empty,CD-0722-4
"E9,A11",6793,7285,5106,2179,3886,1831,9,1840,1254,586,2.139931741,1033,1873,343,155,152,3,42,1,0.032894737,0,empty,CD-0722-4
"E9,A12",1032170,1160988,766173,394815,564681,316464,5,316780,226545,90235,2.510611182,179570,135470,53923,20349,20240,109,2301,4,0.031916996,0,hg38,CD-0722-4
"E9,B1",8822,9859,6536,3323,5157,2593,0,2595,1694,901,1.880133185,1512,1672,276,107,102,5,39,1,0.088235294,0,empty,CD-0722-4
"E9,B2",8659,9483,5864,3619,4910,2699,2,2701,1681,1020,1.648039216,1613,728,155,74,74,0,18,0,0.094594595,0,empty,CD-0722-4
"E9,B3",9103,10223,6646,3577,5336,2730,0,2731,2065,666,3.100600601,1555,1274,247,117,117,0,32,0,0.025641026,0,empty,CD-0722-4
"E9,B4",7736,8879,5551,3328,4708,2578,17,2595,1652,943,1.751855779,1530,1202,397,172,171,1,42,1,0.099415205,0,empty,CD-0722-4
"E9,B5",9354,5704,3647,2057,3721,1966,1,1977,1319,658,2.004559271,1187,1075,260,114,113,1,27,1,0.044247788,0,empty,CD-0722-4
"E9,B6",8995,10027,6622,3405,5356,2784,19,2807,1846,961,1.920915713,1582,2155,445,174,172,2,37,2,0.273255814,0,empty,CD-0722-4
"E9,B7",8551,9483,6439,3044,5103,2528,0,2533,1658,875,1.894857143,1459,1344,456,173,171,2,47,1,0.011695906,0,empty,CD-0722-4
"E9,B8",7299,7916,5647,2269,4274,2060,2,2063,1442,621,2.322061192,1077,1707,369,169,168,1,47,1,0.06547619,0,empty,CD-0722-4
"E9,B9",864763,981819,639425,342394,475970,255823,2,256065,194674,61391,3.171051131,149341,53849,8443,3337,3275,62,596,4,0.044885496,0,hg38,CD-0722-4
"E9,B10",6475,6951,4592,2359,3929,2006,0,2006,1381,625,2.2096,1175,692,217,87,86,1,22,1,0,0,empty,CD-0722-4
"E9,B11",19088,21297,14167,7130,10967,5666,22,5694,3788,1906,1.987408185,3270,225,23,14,14,0,5,0,0.142857143,0,empty,CD-0722-4
"E9,B12",7865,8776,5685,3091,4596,2377,12,2389,1595,794,2.008816121,1395,2273,383,176,176,0,61,0,0.011363636,0,empty,CD-0722-4
"E9,C1",1028351,1221200,727775,493425,598530,374201,1,374486,282404,92082,3.066875176,222845,20796,6066,2340,2331,9,484,2,0.023166023,0,hg38,CD-0722-4
"E9,C2",12127,13307,8664,4643,7026,3598,0,3604,2395,1209,1.980976013,2066,2480,580,202,197,5,77,2,0.040609137,0,empty,CD-0722-4
"E9,C3",12205,13470,8939,4531,6975,3477,0,3481,2296,1185,1.937552743,1968,790,199,95,94,1,28,1,0.031914894,0,empty,CD-0722-4
"E9,C4",8260,9004,6175,2829,4696,2259,1,2260,1560,700,2.228571429,1235,1816,486,176,174,2,52,1,0.074712644,0,empty,CD-0722-4
"E9,C5",17092,19303,12728,6575,9927,5149,3,5157,3780,1377,2.745098039,2925,1980,450,190,187,3,54,1,0.037433155,0,empty,CD-0722-4
"E9,C6",9355,10251,6858,3393,5582,2862,0,2866,1866,1000,1.866,1614,2275,625,181,181,0,52,0,0.066298343,0,empty,CD-0722-4
"E9,C7",12311,14193,8986,5207,7281,4002,0,4004,2495,1509,1.653412856,2340,376,73,27,27,0,10,0,0,0,empty,CD-0722-4
"E9,C8",13033,14224,9598,4626,7420,3761,0,3763,2505,1258,1.991255962,2130,2655,725,339,339,0,84,0,0.032448378,0,empty,CD-0722-4
"E9,C9",28793,35426,21274,14152,17954,10486,16,10512,8556,1956,4.374233129,6358,10065,1939,788,786,2,163,2,0.1043257,0,empty,CD-0722-4
"E9,C10",10840,11629,8189,3440,6015,2928,0,2930,1983,947,2.093980993,1558,2059,450,173,171,2,44,2,0.070175439,0,empty,CD-0722-4
"E9,C11",10240,11291,7306,3985,6082,3109,0,3114,2048,1066,1.92120075,1827,1929,458,200,200,0,56,0,0.05,0,empty,CD-0722-4
"E9,C12",14302,15680,10648,5032,8346,4108,0,4120,2806,1314,2.135464231,2322,1965,377,162,161,1,55,1,0.049689441,0,empty,CD-0722-4
"E9,D1",11474,12784,8342,4442,6612,3463,0,3470,2083,1387,1.501802451,2013,850,207,70,69,1,17,1,0.028985507,0,empty,CD-0722-4
"E9,D2",9743,10578,7374,3204,5587,2635,1,2642,1756,886,1.981941309,1446,3126,1048,404,400,4,85,2,0.0725,0,empty,CD-0722-4
"E9,D3",2212236,2567130,1635391,931739,1227656,690357,2,691014,557075,133939,4.159169473,408317,196397,31119,12315,12114,201,1811,6,0.036156513,0,hg38,CD-0722-4
"E9,D4",7373,8239,5461,2778,4279,2068,49,2122,1434,688,2.084302326,1238,1682,370,157,154,3,47,2,0.149350649,0,empty,CD-0722-4
"E9,D5",7787,8605,5868,2737,4416,2135,12,2149,1415,734,1.927792916,1204,1343,239,101,100,1,30,1,0.06,0,empty,CD-0722-4
"E9,D6",1708599,1903613,1275800,627813,912052,475527,28,475988,381880,94108,4.057890934,275193,259636,47259,18758,18478,280,2378,8,0.048977162,0,hg38,CD-0722-4
"E9,D7",6728,7152,5047,2105,3669,1734,0,1734,1189,545,2.181651376,920,2163,413,175,171,4,48,1,0,0,empty,CD-0722-4
"E9,D8",7762,8394,5767,2627,4505,2210,0,2212,1468,744,1.97311828,1241,1196,331,148,148,0,39,0,0.121621622,0,empty,CD-0722-4
"E9,D9",5855,6222,4341,1881,3405,1577,0,1579,1072,507,2.114398422,916,1952,641,223,223,0,55,0,0.094170404,0,empty,CD-0722-4
"E9,D10",10159,11467,7429,4038,6014,3143,1,3144,2112,1032,2.046511628,1869,1034,221,104,100,4,33,1,0.1,0,empty,CD-0722-4
"E9,D11",8598,9435,6293,3142,5054,2512,6,2520,1662,858,1.937062937,1428,2543,685,242,241,1,67,1,0.053941909,0,empty,CD-0722-4
"E9,D12",12310,13712,9129,4583,7254,3731,0,3736,2555,1181,2.16342083,2179,4385,1320,540,531,9,120,2,0.048964218,0,empty,CD-0722-4
"E9,E1",15438,17002,11499,5503,9014,4534,0,4538,2971,1567,1.895979579,2553,2823,836,346,346,0,96,0,0.11849711,0,empty,CD-0722-4
"E9,E2",1034726,1192597,771176,421421,582266,310503,2,310748,244462,66286,3.687988414,183369,74352,7468,2874,2795,79,603,5,0.038282648,0,hg38,CD-0722-4
"E9,E3",6855,7371,5224,2147,3848,1793,0,1795,1200,595,2.016806723,980,3245,1023,400,399,1,101,1,0.07518797,0,empty,CD-0722-4
"E9,E4",11012,12046,8096,3950,6444,3239,0,3243,2115,1128,1.875,1863,3178,620,241,237,4,78,2,0.037974684,0,empty,CD-0722-4
"E9,E5",8502,9083,6280,2803,4777,2247,5,2255,1462,793,1.843631778,1236,1789,688,262,259,3,48,2,0.146718147,0,empty,CD-0722-4
"E9,E6",2182539,2461588,1644697,816891,1152546,611019,1,611554,490284,121270,4.042912509,350296,364113,54856,21380,20984,396,2751,11,0.055375524,0,hg38,CD-0722-4
"E9,E7",15892,17280,11896,5384,8864,4343,0,4348,3036,1312,2.31402439,2380,3218,660,272,272,0,85,0,0.040441176,0,empty,CD-0722-4
"E9,E8",11336,12177,8546,3631,6346,3061,0,3062,2120,942,2.250530786,1686,3291,809,287,281,6,75,2,0.035587189,0,empty,CD-0722-4
"E9,E9",6949,7685,5089,2596,3986,1993,1,2001,1356,645,2.102325581,1144,2525,565,228,226,2,57,1,0.101769912,0,empty,CD-0722-4
"E9,E10",8440,8979,6361,2618,4818,2360,0,2362,1583,779,2.032092426,1309,1879,439,194,193,1,52,1,0.056994819,0,empty,CD-0722-4
"E9,E11",9433,10187,7064,3123,5458,2748,3,2753,1772,981,1.806320082,1503,2234,471,179,177,2,49,2,0.039548023,0,empty,CD-0722-4
"E9,E12",10499,11824,7722,4102,6305,3156,0,3163,2119,1044,2.029693487,1871,1914,326,155,152,3,59,2,0.111842105,0,empty,CD-0722-4
"E9,F1",11717,12709,8619,4090,6577,3237,0,3237,2163,1074,2.01396648,1757,2213,491,233,231,2,77,2,0.077922078,0,empty,CD-0722-4
"E9,F2",9159,9991,6703,3288,5183,2575,0,2576,1721,855,2.012865497,1470,3045,672,228,223,5,58,2,0.161434978,0,empty,CD-0722-4
"E9,F3",1642300,1934062,1219839,714223,929917,526153,1,526575,442681,83894,5.27667056,313667,111299,18215,6858,6754,104,1267,7,0.048267693,0,hg38,CD-0722-4
"E9,F4",13977,14823,10241,4582,7926,3738,1,3749,2425,1324,1.831570997,2112,644,101,58,55,3,24,2,0.072727273,0,empty,CD-0722-4
"E9,F5",11474,12120,8401,3719,6562,3127,0,3134,2123,1011,2.099901088,1732,2636,653,237,236,1,70,1,0.008474576,0,empty,CD-0722-4
"E9,F6",13277,14762,9663,5099,7725,4005,1,4008,2826,1182,2.390862944,2251,3909,794,365,363,2,106,1,0.074380165,0,empty,CD-0722-4
"E9,F7",12706,14030,9512,4518,7517,3779,16,3795,2542,1253,2.028731045,2066,1463,353,112,111,1,34,1,0.198198198,0,empty,CD-0722-4
"E9,F8",9411,10189,7127,3062,5473,2623,3,2626,1797,829,2.167671894,1468,472,121,51,51,0,19,0,0.078431373,0,empty,CD-0722-4
"E9,F9",10061,10925,7472,3453,5858,2879,7,2887,1958,929,2.107642626,1643,2891,646,287,285,2,80,1,0.042105263,0,empty,CD-0722-4
"E9,F10",13365,14265,10099,4166,7569,3628,2,3636,2490,1146,2.172774869,1991,2329,624,257,252,5,71,2,0.03968254,0,empty,CD-0722-4
"E9,F11",9033,9510,6928,2582,4904,2214,0,2216,1491,725,2.056551724,1102,1486,289,110,109,1,36,1,0.073394495,0,empty,CD-0722-4
"E9,F12",11228,11962,7999,3963,6384,3224,0,3224,2204,1020,2.160784314,1802,358,46,21,21,0,10,0,0,0,empty,CD-0722-4
"E9,G1",15710,17098,12057,5041,8876,4112,0,4117,2788,1329,2.097817908,2275,5279,619,265,264,1,76,1,0.079545455,0,empty,CD-0722-4
"E9,G2",6599,7307,4674,2633,3834,2044,0,2046,1307,739,1.768606225,1207,647,213,87,84,3,11,1,0,0,empty,CD-0722-4
"E9,G3",12717,13521,9377,4144,7008,3477,1,3483,2165,1318,1.642640364,1898,2623,758,269,266,3,67,2,0.011278195,0,empty,CD-0722-4
"E9,G4",21967,24464,15837,8627,12510,6838,10,6854,4318,2536,1.702681388,3945,142,20,10,10,0,6,0,0.2,0,empty,CD-0722-4
"E9,G5",7617,8394,5608,2786,4323,2170,0,2172,1376,796,1.728643216,1226,2466,614,242,237,5,59,1,0.004219409,0,empty,CD-0722-4
"E9,G6",11268,12440,8508,3932,6477,3109,0,3118,2056,1062,1.935969868,1753,225,81,36,35,1,14,1,0.171428571,0,empty,CD-0722-4
"E9,G7",9158,9897,6996,2901,5333,2546,0,2550,1720,830,2.072289157,1408,2661,572,246,244,2,75,2,0.057377049,0,empty,CD-0722-4
"E9,G8",6552,7166,4899,2267,3865,1866,0,1872,1211,661,1.832072617,1063,1898,453,208,206,2,60,2,0.048543689,0,empty,CD-0722-4
"E9,G9",8751,9371,6603,2768,5014,2469,0,2471,1618,853,1.896834701,1387,2790,541,209,209,0,75,0,0.004784689,0,empty,CD-0722-4
"E9,G10",1084111,1236645,816753,419892,601382,319274,0,319543,246921,72622,3.400085374,184274,103889,14460,5526,5405,121,1116,4,0.042738205,0,hg38,CD-0722-4
"E9,G11",10122,10949,7627,3322,5718,2760,12,2775,1889,886,2.132054176,1527,1494,370,171,170,1,48,1,0.288235294,0,empty,CD-0722-4
"E9,G12",7856,8459,5645,2814,4654,2425,0,2425,1566,859,1.823050058,1383,1995,389,166,166,0,44,0,0.030120482,0,empty,CD-0722-4
"E9,H1",8888,9669,6689,2980,5194,2562,0,2564,1781,783,2.27458493,1443,1433,304,120,117,3,38,1,0.017094017,0,empty,CD-0722-4
"E9,H2",9013,9591,6557,3034,5178,2553,18,2573,1675,898,1.865256125,1481,2539,548,209,208,1,61,1,0.134615385,0,empty,CD-0722-4
"E9,H3",9603,10760,7011,3749,5627,2891,0,2896,1965,931,2.110633727,1693,1905,337,135,135,0,50,0,0.111111111,0,empty,CD-0722-4
"E9,H4",1493865,1646035,1146985,499050,775961,388316,3,388681,316689,71992,4.398947105,218345,6047,1158,430,421,9,89,3,0.016627078,0,hg38,CD-0722-4
"E9,H5",12243,13497,9086,4411,7076,3453,0,3457,2322,1135,2.045814978,2003,2052,681,226,224,2,52,2,0.169642857,0,empty,CD-0722-4
"E9,H6",935826,1065876,699107,366769,519995,272761,10,273015,206888,66127,3.128646393,159845,245781,26711,10494,10223,271,1515,7,0.059278098,0,hg38,CD-0722-4
"E9,H7",8865,9721,6444,3277,5106,2581,1,2582,1633,949,1.720758693,1488,1613,414,187,186,1,52,1,0.123655914,0,empty,CD-0722-4
"E9,H8",11956,13727,8733,4994,7181,3775,20,3800,2560,1240,2.064516129,2215,2594,465,200,199,1,86,1,0.030150754,0,empty,CD-0722-4
"E9,H9",8004,8668,6105,2563,4576,2149,0,2152,1495,657,2.275494673,1185,1599,434,173,172,1,42,1,0.104651163,0,empty,CD-0722-4
"E9,H10",771125,863828,577867,285961,420600,214263,5,214453,161202,53251,3.027210757,124867,117002,13770,5476,5299,177,932,6,0.073787507,0,hg38,CD-0722-4
"E9,H11",7519,8593,5244,3349,4451,2618,2,2625,1407,1218,1.155172414,1577,19,5,5,5,0,3,0,0.6,0,empty,CD-0722-4
"E9,H12",7704,8598,5563,3035,4595,2416,16,2432,1610,822,1.95863747,1420,1779,395,162,159,3,37,2,0.037735849,0,empty,CD-0722-4
"E10,A1",7504,8497,5435,3062,4537,2398,0,2405,1600,805,1.98757764,1379,1710,270,118,117,1,45,1,0.162393162,0,empty,CD-0722-4
"E10,A2",11534,12726,8604,4122,6592,3354,0,3356,2263,1093,2.070448307,1881,2742,786,328,321,7,80,1,0.080996885,0,empty,CD-0722-4
"E10,A3",7263,8121,5316,2805,4220,2162,0,2164,1394,770,1.81038961,1223,2006,343,137,137,0,45,0,0.065693431,0,empty,CD-0722-4
"E10,A4",11244,12307,8432,3875,6340,3106,0,3115,2085,1030,2.024271845,1702,1356,293,104,104,0,34,0,0.144230769,0,empty,CD-0722-4
"E10,A5",10818,11978,8095,3883,6356,3210,2,3214,2154,1060,2.032075472,1767,3545,714,317,309,8,92,2,0.055016181,0,empty,CD-0722-4
"E10,A6",26801,30397,20170,10227,15376,7753,0,7761,5556,2205,2.519727891,4440,5048,1141,475,462,13,129,2,0.036796537,0,empty,CD-0722-4
"E10,A7",7329,7932,5454,2478,4104,2134,0,2136,1388,748,1.855614973,1149,1544,308,123,122,1,46,1,0.06557377,0,empty,CD-0722-4
"E10,A8",5364,6032,4002,2030,3180,1623,0,1625,1134,491,2.309572301,918,2885,639,270,269,1,78,1,0.059479554,0,empty,CD-0722-4
"E10,A9",9434,10894,7055,3839,5625,2951,1,2963,2061,902,2.284922395,1698,3222,673,255,251,4,78,1,0.12749004,0,empty,CD-0722-4
"E10,A10",9259,10108,6967,3141,5232,2588,2,2592,1750,842,2.078384798,1419,411,78,34,33,1,15,1,0,0,empty,CD-0722-4
"E10,A11",7235,8022,5498,2524,4141,2033,0,2033,1401,632,2.216772152,1163,2913,757,300,295,5,58,2,0.023728814,0,empty,CD-0722-4
"E10,A12",11472,12582,8678,3904,6636,3268,0,3273,2267,1006,2.253479125,1823,5189,963,455,452,3,129,2,0.024336283,0,empty,CD-0722-4
"E10,B1",7959,8673,5830,2843,4524,2267,0,2269,1443,826,1.746973366,1289,1637,290,126,124,2,38,1,0.040322581,0,empty,CD-0722-4
"E10,B2",8233,8904,5496,3408,4722,2589,4,2599,1614,985,1.63857868,1569,1024,250,92,92,0,20,0,0,0,empty,CD-0722-4
"E10,B3",7899,8960,5813,3147,4636,2364,0,2365,1584,781,2.028169014,1379,2244,528,214,208,6,60,1,0.019230769,0,empty,CD-0722-4
"E10,B4",8462,9489,6206,3283,4943,2640,0,2642,1731,911,1.900109769,1487,1746,419,157,155,2,48,1,0.058064516,0,empty,CD-0722-4
"E10,B5",18226,14974,10129,4845,8387,4010,0,4031,3021,1010,2.991089109,2372,1815,394,182,178,4,56,2,0.04494382,0,empty,CD-0722-4
"E10,B6",10065,11348,7352,3996,5945,3185,0,3187,2086,1101,1.894641235,1839,2851,802,349,343,6,82,2,0.040816327,0,empty,CD-0722-4
"E10,B7",8569,9566,6511,3055,5025,2461,0,2461,1630,831,1.961492178,1413,2155,668,252,252,0,61,0,0.075396825,0,empty,CD-0722-4
"E10,B8",7516,8306,5580,2726,4366,2191,5,2201,1537,664,2.314759036,1222,1897,363,168,168,0,56,0,0.041666667,0,empty,CD-0722-4
"E10,B9",12345,13418,9142,4276,7029,3567,0,3572,2319,1253,1.85075818,2043,1521,404,150,145,5,44,1,0.075862069,0,empty,CD-0722-4
"E10,B10",1101097,1211935,784893,427042,626849,335347,13,336121,274225,61896,4.430415536,197068,91060,12984,5201,5100,101,887,7,0.055294118,0,hg38,CD-0722-4
"E10,B11",12633,13973,9239,4734,7032,3808,0,3815,2241,1574,1.423761118,2150,342,19,13,13,0,10,0,0.076923077,0,empty,CD-0722-4
"E10,B12",8277,9267,6215,3052,4908,2464,0,2469,1687,782,2.157289003,1387,2690,751,271,268,3,73,1,0.119402985,0,empty,CD-0722-4
"E10,C1",16918,18205,12909,5296,9441,4492,18,4515,2914,1601,1.82011243,2386,1832,496,185,178,7,47,2,0.140449438,0,empty,CD-0722-4
"E10,C2",11530,13042,8524,4518,6681,3469,3,3474,2274,1200,1.895,1992,2969,787,304,303,1,67,1,0.075907591,0,empty,CD-0722-4
"E10,C3",11793,12902,8867,4035,6829,3375,0,3376,2219,1157,1.917891098,1833,1451,220,97,96,1,26,1,0,0,empty,CD-0722-4
"E10,C4",8350,9205,6251,2954,4861,2372,1,2376,1653,723,2.286307054,1342,2678,831,318,315,3,85,3,0.088888889,0,empty,CD-0722-4
"E10,C5",11174,12411,8100,4311,6598,3369,5,3379,2282,1097,2.080218778,1966,2545,528,229,228,1,63,1,0.01754386,0,empty,CD-0722-4
"E10,C6",9012,10477,6455,4022,5577,2978,1,2984,1940,1044,1.858237548,1847,2326,546,198,196,2,45,2,0.096938776,0,empty,CD-0722-4
"E10,C7",11939,13704,8602,5102,6937,3856,0,3860,2486,1374,1.809315866,2231,665,110,35,34,1,10,1,0.029411765,0,empty,CD-0722-4
"E10,C8",14104,15795,10529,5266,8180,4183,10,4197,2799,1398,2.002145923,2372,4960,1105,463,455,8,113,2,0.147252747,0,empty,CD-0722-4
"E10,C9",617766,668912,489515,179397,328499,137953,0,138113,104617,33496,3.12326845,75135,201762,21269,8334,8026,308,1215,9,0.045850984,0,hg38,CD-0722-4
"E10,C10",11218,12351,8424,3927,6520,3137,1,3140,2084,1056,1.973484848,1780,2791,642,268,266,2,66,2,0.022556391,0,empty,CD-0722-4
"E10,C11",9944,10985,7317,3668,5827,2999,0,3001,2015,986,2.043610548,1742,2896,921,284,283,1,75,1,0.028268551,0,empty,CD-0722-4
"E10,C12",14886,16525,11127,5398,8626,4299,5,4305,2956,1349,2.19125278,2412,3316,873,352,344,8,82,2,0.098837209,0,empty,CD-0722-4
"E10,D1",11492,12845,8254,4591,6655,3570,12,3583,2224,1359,1.636497425,2082,988,131,53,53,0,24,0,0,0,empty,CD-0722-4
"E10,D2",9219,9853,7007,2846,5111,2346,0,2349,1558,791,1.96965866,1250,4916,1651,569,564,5,107,1,0.024822695,0,empty,CD-0722-4
"E10,D3",8904,9980,6636,3344,5206,2652,15,2677,1791,886,2.021444695,1527,3228,828,332,320,12,56,2,0.0625,0,empty,CD-0722-4
"E10,D4",7447,8331,5527,2804,4303,2171,16,2189,1492,697,2.140602582,1241,2326,430,197,194,3,61,2,0.12371134,0,empty,CD-0722-4
"E10,D5",1464887,1653353,1126268,527085,797420,411763,1,412151,327766,84385,3.884173728,234203,506533,55079,21250,20610,640,2588,12,0.052450267,0,hg38,CD-0722-4
"E10,D6",10941,12043,7973,4070,6371,3444,0,3454,2150,1304,1.648773006,1970,2210,480,196,195,1,66,1,0.030769231,0,empty,CD-0722-4
"E10,D7",6866,7163,5187,1976,3763,1784,0,1788,1203,585,2.056410256,940,3638,882,342,339,3,87,2,0.112094395,0,empty,CD-0722-4
"E10,D8",28230,31827,21795,10032,15557,7669,0,7678,5884,1794,3.279821628,4309,4546,1007,403,397,6,100,2,0.032745592,0,empty,CD-0722-4
"E10,D9",4595,5008,3446,1562,2545,1196,0,1198,816,382,2.136125654,676,2689,791,319,318,1,72,1,0.062893082,0,empty,CD-0722-4
"E10,D10",7933,8853,5800,3053,4720,2479,13,2494,1618,876,1.847031963,1441,1508,550,180,180,0,50,0,0.1,0,empty,CD-0722-4
"E10,D11",8886,9722,6697,3025,4955,2417,0,2419,1655,764,2.166230366,1283,3863,1201,448,444,4,99,2,0.047297297,0,empty,CD-0722-4
"E10,D12",12199,13577,9201,4376,7054,3472,0,3475,2343,1132,2.069787986,1898,5942,1859,685,679,6,172,2,0.055964654,0,empty,CD-0722-4
"E10,E1",865170,973853,642405,331448,474864,250559,0,250756,203344,47412,4.288872016,145984,215312,27935,10655,10394,261,1649,6,0.041851068,0,hg38,CD-0722-4
"E10,E2",10279,11609,7476,4133,6084,3169,0,3171,1995,1176,1.696428571,1880,3090,591,231,226,5,65,2,0.048672566,0,empty,CD-0722-4
"E10,E3",6441,7224,4742,2482,3798,1900,0,1905,1259,646,1.948916409,1109,3316,1027,396,392,4,96,1,0.068877551,0,empty,CD-0722-4
"E10,E4",1072885,1275797,784511,491286,617585,347891,4,348221,274347,73874,3.713715245,210752,273917,41426,16085,15747,338,2188,9,0.049088715,0,hg38,CD-0722-4
"E10,E5",8138,8835,6023,2812,4647,2213,0,2215,1475,740,1.993243243,1232,2082,293,124,123,1,40,1,0.06504065,0,empty,CD-0722-4
"E10,E6",14917,16126,11229,4897,8406,4229,0,4234,2795,1439,1.942321056,2317,5101,1069,424,418,6,113,2,0.105263158,0,empty,CD-0722-4
"E10,E7",1571540,1781120,1184917,596203,852528,448975,21,449397,340272,109125,3.118185567,259076,246772,50048,19372,19118,254,2524,8,0.052934407,0,hg38,CD-0722-4
"E10,E8",11772,12921,8919,4002,6678,3187,0,3187,2190,997,2.196589769,1734,4599,975,394,391,3,103,2,0.035805627,0,empty,CD-0722-4
"E10,E9",7457,8227,5635,2592,4305,2212,1,2213,1555,658,2.363221884,1228,3889,806,320,319,1,86,1,0.065830721,0,empty,CD-0722-4
"E10,E10",7562,8393,5616,2777,4469,2275,0,2275,1498,777,1.927927928,1282,2743,797,278,274,4,73,2,0.087591241,0,empty,CD-0722-4
"E10,E11",9666,10680,7104,3576,5582,2844,0,2851,1844,1007,1.831181728,1630,3537,780,246,244,2,66,2,0.094262295,0,empty,CD-0722-4
"E10,E12",11139,12722,8351,4371,6703,3411,3,3420,2348,1072,2.190298507,2035,3400,627,229,223,6,73,1,0.134529148,0,empty,CD-0722-4
"E10,F1",11658,12502,8519,3983,6565,3281,0,3281,2113,1168,1.809075342,1851,3089,893,362,357,5,77,2,0.072829132,0,empty,CD-0722-4
"E10,F2",9106,9593,6846,2747,5120,2386,8,2399,1523,876,1.738584475,1273,5067,1266,522,515,7,124,2,0.14368932,0,empty,CD-0722-4
"E10,F3",9826,11121,7262,3859,5778,2956,12,2970,2069,901,2.296337403,1719,3589,947,387,384,3,98,1,0.088541667,0,empty,CD-0722-4
"E10,F4",13241,14418,9996,4422,7627,3710,1,3713,2408,1305,1.845210728,2021,1446,384,154,148,6,32,2,0.195945946,0,empty,CD-0722-4
"E10,F5",10671,11602,7997,3605,6084,2861,11,2876,1867,1009,1.850346878,1576,3990,925,367,358,9,88,2,0.072625698,0,empty,CD-0722-4
"E10,F6",14825,16946,10838,6108,8859,4687,0,4696,3339,1357,2.460574797,2791,4421,773,349,346,3,116,2,0.054913295,0,empty,CD-0722-4
"E10,F7",12374,13931,9206,4725,7330,3706,1,3711,2474,1237,2,2183,1696,409,137,134,3,41,1,0.067164179,0,empty,CD-0722-4
"E10,F8",9686,10943,7301,3642,5872,2925,0,2928,2021,907,2.228224917,1672,417,60,38,37,1,14,1,0,0,empty,CD-0722-4
"E10,F9",10962,11808,8302,3506,6205,3006,0,3011,2113,898,2.353006682,1666,5340,1244,507,501,6,115,2,0.143712575,0,empty,CD-0722-4
"E10,F10",12958,14124,9919,4205,7425,3555,0,3563,2344,1219,1.922887613,1952,3593,1019,327,323,4,80,2,0.055727554,0,empty,CD-0722-4
"E10,F11",10123,10915,7695,3220,5659,2688,0,2688,1856,832,2.230769231,1447,2947,617,252,250,2,53,2,0.008,0,empty,CD-0722-4
"E10,F12",10373,11064,7642,3422,5879,2843,0,2843,1847,996,1.854417671,1596,394,126,36,34,2,15,2,0.323529412,0,empty,CD-0722-4
"E10,G1",11566,12646,8688,3958,6722,3241,0,3244,2222,1022,2.174168297,1856,4128,1093,423,419,4,100,1,0.136038186,0,empty,CD-0722-4
"E10,G2",6374,6825,4591,2234,3530,1795,7,1802,1152,650,1.772307692,1004,796,211,88,88,0,19,0,0.011363636,0,empty,CD-0722-4
"E10,G3",12267,13363,8984,4379,6852,3440,9,3458,2200,1258,1.748807631,1913,4507,1063,439,437,2,116,2,0.043478261,0,empty,CD-0722-4
"E10,G4",21188,24265,15194,9071,12376,6888,0,6894,4349,2545,1.708840864,4039,116,13,11,11,0,4,0,0,0,empty,CD-0722-4
"E10,G5",7089,8096,5235,2861,4187,2137,0,2137,1396,741,1.883940621,1273,2337,444,202,194,8,62,2,0.015463918,0,empty,CD-0722-4
"E10,G6",11051,12135,8312,3823,6303,3088,20,3112,2063,1049,1.96663489,1752,370,97,43,43,0,14,0,0,0,empty,CD-0722-4
"E10,G7",9679,10789,7260,3529,5690,2759,13,2780,1877,903,2.0786268,1591,3950,915,366,363,3,105,2,0.060606061,0,empty,CD-0722-4
"E10,G8",1528678,1706568,1143828,562740,820548,434537,2,434969,352424,82545,4.269477255,248463,519775,70666,27881,27264,617,2949,11,0.043353873,0,hg38,CD-0722-4
"E10,G9",16376,18939,11793,7146,9514,5287,0,5294,3456,1838,1.880304679,3128,4166,1100,416,413,3,112,2,0.014527845,0,empty,CD-0722-4
"E10,G10",936742,1095225,688336,406889,535246,299690,3,299956,231181,68775,3.361410396,177528,234961,56872,21518,21269,249,2530,6,0.046405567,0,hg38,CD-0722-4
"E10,G11",911717,1038720,682524,356196,506142,269095,1,269336,217062,52274,4.152389333,155351,133817,19884,7597,7449,148,1293,5,0.052893006,0,hg38,CD-0722-4
"E10,G12",7230,8219,5243,2976,4302,2269,5,2282,1495,787,1.899618806,1331,3078,795,311,311,0,71,0,0.054662379,0,empty,CD-0722-4
"E10,H1",9711,10422,7279,3143,5474,2663,0,2664,1879,785,2.393630573,1415,2178,482,169,164,5,47,2,0.018292683,0,empty,CD-0722-4
"E10,H2",11096,11821,8441,3380,6239,2861,0,2862,1902,960,1.98125,1607,3901,1119,405,403,2,87,1,0.05707196,0,empty,CD-0722-4
"E10,H3",8789,9711,6526,3185,5109,2599,4,2603,1738,865,2.009248555,1443,2119,371,158,157,1,54,1,0.038216561,0,empty,CD-0722-4
"E10,H4",11614,12969,8774,4195,6535,3099,1,3102,2060,1042,1.97696737,1756,266,33,21,20,1,7,1,0,0,empty,CD-0722-4
"E10,H5",12041,13248,8784,4464,6793,3351,44,3395,2203,1192,1.848154362,1952,3157,1043,381,372,9,86,3,0.021505376,0,empty,CD-0722-4
"E10,H6",8263,9122,6084,3038,4729,2421,1,2426,1683,743,2.265141319,1386,2953,593,248,245,3,79,1,0.028571429,0,empty,CD-0722-4
"E10,H7",8662,9425,6458,2967,5011,2431,1,2437,1615,822,1.964720195,1391,2637,719,295,294,1,59,1,0.142857143,0,empty,CD-0722-4
"E10,H8",12708,14578,9181,5397,7440,3985,0,3987,2696,1291,2.088303641,2349,3572,812,312,310,2,105,1,0.035483871,0,empty,CD-0722-4
"E10,H9",520431,468140,447240,20900,222785,32525,1,32634,24226,8408,2.88130352,9882,34724,7012,2385,2344,41,444,3,0.024744027,0,empty,CD-0722-4
"E10,H10",6662,7543,4921,2622,3902,1995,0,2001,1327,674,1.96884273,1220,2130,467,185,184,1,49,1,0.032608696,0,empty,CD-0722-4
"E10,H11",7886,9027,5476,3551,4710,2809,0,2809,1598,1211,1.319570603,1731,42,10,9,9,0,4,0,0,0,empty,CD-0722-4
"E10,H12",8577,9479,6346,3133,4924,2491,2,2493,1771,722,2.452908587,1432,2680,740,293,286,7,63,1,0.076923077,0,empty,CD-0722-4
"E11,A1",7306,8019,5334,2685,4353,2264,0,2267,1507,760,1.982894737,1258,1822,402,179,174,5,49,2,0.103448276,0,empty,CD-0722-4
"E11,A2",11228,12262,8387,3875,6447,3182,0,3184,2038,1146,1.778359511,1799,5232,917,350,344,6,86,3,0.046511628,0,empty,CD-0722-4
"E11,A3",7030,7708,5123,2585,4141,2118,0,2118,1435,683,2.10102489,1233,1919,443,189,183,6,48,2,0.049180328,0,empty,CD-0722-4
"E11,A4",12720,13359,9040,4319,7320,3638,0,3646,2485,1161,2.14039621,2094,699,142,64,63,1,27,1,0.126984127,0,empty,CD-0722-4
"E11,A5",16579,17957,12564,5393,9359,4400,0,4404,3059,1345,2.274349442,2522,5765,647,287,285,2,94,1,0.066666667,0,empty,CD-0722-4
"E11,A6",8677,10066,6355,3711,5420,2851,1,2854,1837,1017,1.806293019,1716,3351,633,258,245,13,87,2,0.102040816,0,empty,CD-0722-4
"E11,A7",1671917,1887508,1273143,614365,910822,480074,1,480536,389689,90847,4.289508734,273129,311456,44317,18016,17686,330,2280,11,0.044950809,0,hg38,CD-0722-4
"E11,A8",4907,5485,3627,1858,3002,1558,2,1566,1134,432,2.625,922,2967,610,262,260,2,74,2,0.076923077,0,empty,CD-0722-4
"E11,A9",8618,9124,6366,2758,4958,2371,0,2376,1592,784,2.030612245,1261,3111,622,259,257,2,63,1,0.105058366,0,empty,CD-0722-4
"E11,A10",7953,8703,5922,2781,4548,2249,0,2249,1456,793,1.836065574,1251,470,78,53,51,2,17,2,0.098039216,0,empty,CD-0722-4
"E11,A11",6570,7156,4837,2319,3767,1865,1,1867,1264,603,2.096185738,1034,1924,337,125,123,2,39,1,0.06504065,0,empty,CD-0722-4
"E11,A12",9851,10381,7281,3100,5496,2651,0,2657,1800,857,2.100350058,1447,4311,976,356,354,2,93,1,0.121468927,0,empty,CD-0722-4
"E11,B1",7302,7662,5341,2321,4124,2046,21,2072,1323,749,1.76635514,1123,1401,337,161,158,3,41,2,0.025316456,0,empty,CD-0722-4
"E11,B2",9656,10214,6805,3409,5391,2807,0,2809,1739,1070,1.625233645,1618,758,151,64,62,2,13,1,0,0,empty,CD-0722-4
"E11,B3",662413,733814,503041,230773,363505,180935,3,181086,140073,41013,3.415331724,103450,90325,10096,4008,3900,108,768,6,0.038974359,0,hg38,CD-0722-4
"E11,B4",6417,6813,4761,2052,3800,1962,0,1964,1274,690,1.846376812,1055,1784,511,181,180,1,45,1,0.038888889,0,empty,CD-0722-4
"E11,B5",8190,5073,3190,1883,3369,1719,0,1733,1137,596,1.907718121,1083,1535,326,128,127,1,45,1,0.039370079,0,empty,CD-0722-4
"E11,B6",8744,9828,6195,3633,5205,2797,19,2818,1811,1007,1.798411122,1667,1947,494,191,189,2,66,1,0.105820106,0,empty,CD-0722-4
"E11,B7",15585,17293,11281,6012,8867,4766,8,4776,3038,1738,1.747986191,2641,2000,462,169,167,2,41,1,0.119760479,0,empty,CD-0722-4
"E11,B8",6284,6836,4735,2101,3717,1828,0,1831,1227,604,2.031456954,999,2235,664,254,252,2,56,1,0.063492063,0,empty,CD-0722-4
"E11,B9",11500,12789,8426,4363,6601,3473,0,3475,2273,1202,1.891014975,1970,1563,424,152,150,2,42,1,0.246666667,0,empty,CD-0722-4
"E11,B10",6315,6587,4375,2212,3660,1830,5,1845,1225,620,1.975806452,1060,730,128,50,50,0,18,0,0.02,0,empty,CD-0722-4
"E11,B11",11088,12550,8093,4457,6546,3578,0,3587,2039,1548,1.317183463,2139,386,68,32,28,4,13,2,0,0,empty,CD-0722-4
"E11,B12",7275,7936,5386,2550,4268,2121,18,2145,1484,661,2.245083207,1255,2400,662,278,268,10,67,1,0.145522388,0,empty,CD-0722-4
"E11,C1",28658,30954,21456,9498,15828,7849,0,7855,5503,2352,2.339710884,4338,1938,422,200,199,1,51,1,0.025125628,0,empty,CD-0722-4
"E11,C2",11665,12858,8389,4469,6758,3483,0,3487,2241,1246,1.798555377,1998,3536,1006,343,339,4,88,1,0.126843658,0,empty,CD-0722-4
"E11,C3",11653,12806,8670,4136,6983,3490,2,3500,2237,1263,1.771179731,1946,1126,284,106,105,1,24,1,0.076190476,0,empty,CD-0722-4
"E11,C4",7606,8217,5560,2657,4480,2098,18,2118,1406,712,1.974719101,1209,2448,555,216,211,5,58,1,0.071090047,0,empty,CD-0722-4
"E11,C5",11134,11874,8132,3742,6436,3227,12,3243,2177,1066,2.042213884,1872,2299,627,212,208,4,60,1,0.067307692,0,empty,CD-0722-4
"E11,C6",8701,9517,6253,3264,5255,2742,0,2742,1869,873,2.140893471,1551,1840,392,183,183,0,51,0,0.027322404,0,empty,CD-0722-4
"E11,C7",12253,14298,8746,5552,7326,4002,37,4041,2493,1548,1.610465116,2449,696,145,73,73,0,18,0,0.191780822,0,empty,CD-0722-4
"E11,C8",13029,14167,9645,4522,7382,3749,0,3755,2574,1181,2.179508891,2072,4288,1226,400,395,5,95,2,0.027848101,0,empty,CD-0722-4
"E11,C9",9670,10936,7134,3802,5880,2995,1,3004,1980,1024,1.93359375,1801,3749,672,316,315,1,86,1,0.114285714,0,empty,CD-0722-4
"E11,C10",11137,12564,8202,4362,6456,3240,0,3244,2145,1099,1.95177434,1918,2389,487,224,221,3,63,2,0.131221719,0,empty,CD-0722-4
"E11,C11",793770,872396,597296,275100,428714,215247,0,215461,159521,55940,2.851644619,123236,62897,13328,5094,5016,78,803,2,0.024122807,0,hg38,CD-0722-4
"E11,C12",14307,15510,10399,5111,8224,4029,20,4052,2739,1313,2.086062452,2296,3089,580,284,282,2,81,1,0.042553191,0,empty,CD-0722-4
"E11,D1",1242934,1440910,923503,517407,696454,381302,1,381616,302302,79314,3.811458255,225052,144328,14563,5869,5676,193,974,7,0.082628612,0,hg38,CD-0722-4
"E11,D2",10715,11436,8243,3193,6035,2828,7,2836,1904,932,2.042918455,1449,4845,1253,479,474,5,97,2,0.050632911,0,empty,CD-0722-4
"E11,D3",8360,8948,6168,2780,4780,2393,0,2397,1551,846,1.833333333,1346,1815,397,138,137,1,45,1,0.02189781,0,empty,CD-0722-4
"E11,D4",6871,7725,5010,2715,4120,2095,1,2099,1409,690,2.042028986,1232,1849,464,136,135,1,44,1,0.059259259,0,empty,CD-0722-4
"E11,D5",7605,8331,5604,2727,4348,2159,0,2161,1355,806,1.681141439,1221,2219,475,200,200,0,53,0,0.13,0,empty,CD-0722-4
"E11,D6",18166,20367,12874,7493,10219,5467,0,5470,3902,1568,2.488520408,3252,3849,899,271,266,5,73,1,0.060150376,0,empty,CD-0722-4
"E11,D7",6522,6906,4865,2041,3686,1745,2,1747,1162,585,1.986324786,976,2328,620,250,248,2,62,1,0.052419355,0,empty,CD-0722-4
"E11,D8",762592,863522,571050,292472,423920,222294,0,222460,176666,45794,3.857841639,129086,40482,9150,3465,3436,29,646,2,0.019790454,0,hg38,CD-0722-4
"E11,D9",4001,4406,3021,1385,2390,1147,3,1151,760,391,1.943734015,652,2405,678,261,261,0,62,0,0.042145594,0,empty,CD-0722-4
"E11,D10",8089,9113,5957,3156,4888,2566,10,2578,1645,933,1.763129689,1513,1711,444,179,178,1,39,1,0.050561798,0,empty,CD-0722-4
"E11,D11",16364,18409,11683,6726,9379,5254,0,5261,3405,1856,1.834590517,3045,3462,835,340,337,3,91,3,0.068249258,0,empty,CD-0722-4
"E11,D12",1135280,1278743,862136,416607,617456,315444,0,315761,245800,69961,3.513386029,180966,188499,34387,13357,13115,242,1851,6,0.046359131,0,hg38,CD-0722-4
"E11,E1",14507,15668,10751,4917,8227,4077,0,4081,2676,1405,1.904626335,2249,3661,877,322,311,11,105,1,0.045016077,0,empty,CD-0722-4
"E11,E2",9772,10619,7191,3428,5653,2849,0,2849,1877,972,1.931069959,1603,2888,742,287,282,5,58,2,0.113475177,0,empty,CD-0722-4
"E11,E3",11399,12952,8799,4153,6432,3052,0,3056,2080,976,2.131147541,1722,4938,1015,372,363,9,103,3,0.044077135,0,empty,CD-0722-4
"E11,E4",10076,11242,7375,3867,6103,3122,2,3130,2029,1101,1.842870118,1818,3729,911,384,378,6,102,1,0.108465608,0,empty,CD-0722-4
"E11,E5",8127,8766,6151,2615,4587,2171,0,2171,1369,802,1.706982544,1181,1638,394,154,147,7,38,2,0.142857143,0,empty,CD-0722-4
"E11,E6",14063,15640,10397,5243,8074,4029,8,4047,2589,1458,1.775720165,2296,4259,932,422,406,16,109,3,0.044334975,0,empty,CD-0722-4
"E11,E7",13592,14628,10037,4591,7843,3836,0,3837,2596,1241,2.091861402,2116,3694,984,432,428,4,100,3,0.140186916,0,empty,CD-0722-4
"E11,E8",11506,12383,8797,3586,6615,3106,0,3108,2080,1028,2.023346304,1705,4127,839,316,308,8,82,2,0.126623377,0,empty,CD-0722-4
"E11,E9",6884,8005,4976,3029,4067,2113,0,2118,1483,635,2.335433071,1278,3448,960,364,359,5,81,2,0.100278552,0,empty,CD-0722-4
"E11,E10",8208,8883,6003,2880,4732,2353,0,2353,1597,756,2.112433862,1345,2295,673,266,266,0,57,0,0.060150376,0,empty,CD-0722-4
"E11,E11",9535,10383,7063,3320,5486,2763,1,2766,1823,943,1.933191941,1556,2874,805,291,286,5,49,1,0.122377622,0,empty,CD-0722-4
"E11,E12",10131,11114,7393,3721,6145,3182,1,3187,2093,1094,1.913162706,1865,2992,697,280,276,4,63,1,0.061594203,0,empty,CD-0722-4
"E11,F1",11952,13224,8610,4614,6842,3480,39,3524,2205,1319,1.671721001,2045,2661,897,344,342,2,79,2,0,0,empty,CD-0722-4
"E11,F2",9017,9963,6688,3275,5318,2593,1,2596,1668,928,1.797413793,1489,4986,1089,397,390,7,100,3,0.058974359,0,empty,CD-0722-4
"E11,F3",1333681,1483572,1020974,462598,717375,362692,12,363042,292846,70196,4.171833153,205058,212695,33874,13286,13044,242,1904,7,0.024762343,0,hg38,CD-0722-4
"E11,F4",13837,14644,10385,4259,7903,3795,1,3799,2537,1262,2.010301109,2067,904,202,81,80,1,22,1,0.1125,0,empty,CD-0722-4
"E11,F5",11036,11688,8255,3433,6342,2930,0,2934,1946,988,1.969635628,1605,2863,562,270,267,3,73,2,0.041198502,0,empty,CD-0722-4
"E11,F6",12337,13735,8974,4761,7340,3883,0,3888,2665,1223,2.179067866,2203,3561,732,313,307,6,97,2,0.06514658,0,empty,CD-0722-4
"E11,F7",12476,13657,9083,4574,7461,3776,2,3783,2527,1256,2.011942675,2168,1745,443,191,189,2,52,1,0.116402116,0,empty,CD-0722-4
"E11,F8",1020907,1166326,766260,400066,570417,300819,1,301084,243332,57752,4.213395207,174285,13141,1546,585,565,20,130,2,0.063716814,0,hg38,CD-0722-4
"E11,F9",9577,10267,7227,3040,5461,2633,0,2634,1815,819,2.216117216,1412,3566,867,404,399,5,99,2,0.025062657,0,empty,CD-0722-4
"E11,F10",13286,14370,9985,4385,7658,3615,25,3646,2492,1154,2.159445407,2004,2695,606,287,285,2,73,2,0.073684211,0,empty,CD-0722-4
"E11,F11",8309,8983,6329,2654,4730,2243,1,2247,1469,778,1.888174807,1232,2118,576,221,217,4,51,2,0.023041475,0,empty,CD-0722-4
"E11,F12",12125,13385,8820,4565,7002,3501,0,3507,2260,1247,1.812349639,2029,338,70,29,29,0,9,0,0,0,empty,CD-0722-4
"E11,G1",12239,13430,9160,4270,7142,3436,9,3451,2286,1165,1.96223176,1938,4114,991,409,407,2,111,1,0.044226044,0,empty,CD-0722-4
"E11,G2",6394,6827,4615,2212,3631,1852,0,1853,1144,709,1.613540197,1042,335,54,32,31,1,14,1,0.322580645,0,empty,CD-0722-4
"E11,G3",1319485,1571321,960876,610445,759259,432459,6,432840,347510,85330,4.072541896,262593,173668,32352,12690,12514,176,1887,5,0.069442225,0,hg38,CD-0722-4
"E11,G4",21758,24214,15458,8756,12645,7063,40,7111,4339,2772,1.565295815,4145,122,16,10,10,0,8,0,0,0,empty,CD-0722-4
"E11,G5",7425,8184,5411,2773,4228,2102,17,2120,1390,730,1.904109589,1239,2431,439,154,151,3,55,1,0.072847682,0,empty,CD-0722-4
"E11,G6",11403,12261,8574,3687,6447,3102,14,3118,2091,1027,2.036027264,1720,369,72,45,40,5,17,2,0,0,empty,CD-0722-4
"E11,G7",10029,10372,7412,2960,5712,2654,0,2656,1822,834,2.184652278,1448,4039,889,360,360,0,106,0,0.058333333,0,empty,CD-0722-4
"E11,G8",6730,7217,4951,2266,3953,1983,0,1989,1364,625,2.1824,1085,2248,548,214,213,1,64,1,0.093896714,0,empty,CD-0722-4
"E11,G9",841703,948424,633496,314928,464602,237791,1,237995,181690,56305,3.226889264,136779,256920,44522,17582,17269,313,2274,10,0.064798193,0,hg38,CD-0722-4
"E11,G10",10173,11025,7505,3520,5962,2993,0,2995,2034,961,2.116545265,1670,3517,747,323,321,2,97,1,0.043613707,0,empty,CD-0722-4
"E11,G11",10045,11124,7511,3613,5852,2853,3,2860,1934,926,2.088552916,1665,2106,260,122,121,1,40,1,0.223140496,0,empty,CD-0722-4
"E11,G12",7400,8111,5361,2750,4235,2147,3,2152,1371,781,1.755441741,1226,2537,496,201,197,4,60,2,0.045685279,0,empty,CD-0722-4
"E11,H1",8928,9486,6604,2882,4988,2364,60,2427,1656,771,2.147859922,1298,1675,435,179,175,4,51,2,0.062857143,0,empty,CD-0722-4
"E11,H2",12857,14176,9839,4337,7511,3686,0,3687,2505,1182,2.11928934,2089,3074,591,267,265,2,84,2,0.086792453,0,empty,CD-0722-4
"E11,H3",7963,8708,5769,2939,4714,2461,0,2467,1663,804,2.06840796,1401,2190,536,176,175,1,55,1,0.165714286,0,empty,CD-0722-4
"E11,H4",10991,11846,8039,3807,6272,3071,0,3077,2022,1055,1.916587678,1712,327,123,28,28,0,11,0,0.035714286,0,empty,CD-0722-4
"E11,H5",1324677,1534818,964835,569983,742910,420143,3,420538,350157,70381,4.975163752,250044,148150,31172,11973,11828,145,1677,6,0.037876226,0,hg38,CD-0722-4
"E11,H6",7647,8604,5516,3088,4559,2375,0,2382,1593,789,2.019011407,1395,3320,784,346,344,2,81,1,0.075581395,0,empty,CD-0722-4
"E11,H7",12916,13552,9332,4220,7078,3475,1,3481,2445,1036,2.36003861,1978,2270,413,224,224,0,53,0,0.049107143,0,empty,CD-0722-4
"E11,H8",11079,12524,7888,4636,6877,3701,25,3731,2597,1134,2.290123457,2231,3604,888,378,374,4,81,3,0.114973262,0,empty,CD-0722-4
"E11,H9",993168,1054204,779256,274948,514287,227506,20,227772,180511,47261,3.81944944,121794,41900,8980,3367,3321,46,681,3,0.030412526,0,hg38,CD-0722-4
"E11,H10",6455,6953,4774,2179,3665,1810,0,1813,1243,570,2.180701754,1026,1874,382,161,159,2,34,1,0.327044025,0,empty,CD-0722-4
"E11,H11",7331,8420,5153,3267,4362,2568,0,2577,1416,1161,1.219638243,1546,74,17,8,8,0,2,0,0,0,empty,CD-0722-4
"E11,H12",802883,922739,581985,340754,457304,252834,4,253130,200019,53111,3.766055996,150826,113499,15763,6020,5859,161,1089,4,0.040791944,0,hg38,CD-0722-4
"E12,A1",6824,7556,4978,2578,4039,2067,0,2071,1308,763,1.714285714,1206,1637,349,139,139,0,40,0,0.050359712,0,empty,CD-0722-4
"E12,A2",10718,11716,8061,3655,6200,3081,0,3090,1977,1113,1.776280323,1751,2601,401,185,184,1,48,1,0.038043478,0,empty,CD-0722-4
"E12,A3",6510,7394,4756,2638,3805,1926,0,1926,1248,678,1.840707965,1138,1144,239,94,94,0,42,0,0.010638298,0,empty,CD-0722-4
"E12,A4",11626,12483,8804,3679,6591,3216,0,3220,2129,1091,1.951420715,1786,1091,235,100,98,2,23,1,0.010204082,0,empty,CD-0722-4
"E12,A5",9867,10892,7185,3707,5834,2888,0,2892,1922,970,1.981443299,1661,3099,658,312,306,6,87,2,0.081699346,0,empty,CD-0722-4
"E12,A6",764562,942037,523639,418398,485180,327782,11,327978,210017,117961,1.78039352,200831,7947,2512,672,669,3,224,2,0.043348281,0,hg38,CD-0722-4
"E12,A7",7010,7699,5185,2514,4113,2090,0,2092,1387,705,1.967375887,1195,1716,466,197,193,4,35,1,0.170984456,0,empty,CD-0722-4
"E12,A8",4367,4877,3276,1601,2658,1346,0,1346,946,400,2.365,768,2942,766,280,277,3,64,3,0.115523466,0,empty,CD-0722-4
"E12,A9",7427,8459,5699,2760,4411,2218,1,2220,1510,710,2.126760563,1236,2672,502,194,186,8,56,2,0.080645161,0,empty,CD-0722-4
"E12,A10",8899,9665,6916,2749,4934,2365,0,2368,1543,825,1.87030303,1280,463,187,71,71,0,12,0,0,0,empty,CD-0722-4
"E12,A11",6093,6472,4727,1745,3452,1599,0,1602,1104,498,2.21686747,854,1512,278,136,133,3,39,2,0.135338346,0,empty,CD-0722-4
"E12,A12",9216,10370,6900,3470,5422,2713,3,2716,1784,932,1.91416309,1589,4464,1019,393,389,4,100,1,0.043701799,0,empty,CD-0722-4
"E12,B1",6959,7561,5152,2409,3997,1981,0,1985,1212,773,1.567917206,1110,1218,267,114,113,1,40,1,0.026548673,0,empty,CD-0722-4
"E12,B2",8107,8748,5546,3202,4652,2533,1,2534,1611,923,1.74539545,1492,508,116,47,47,0,22,0,0.14893617,0,empty,CD-0722-4
"E12,B3",6531,7201,4847,2354,3863,1970,0,1972,1307,665,1.965413534,1117,2049,593,200,198,2,50,1,0.050505051,0,empty,CD-0722-4
"E12,B4",6481,7531,4710,2821,3853,2022,0,2025,1242,783,1.586206897,1210,1615,464,194,192,2,49,1,0.098958333,0,empty,CD-0722-4
"E12,B5",9369,6658,4198,2460,4104,2251,3,2265,1420,845,1.680473373,1404,990,215,75,75,0,31,0,0.013333333,0,empty,CD-0722-4
"E12,B6",8620,9484,6268,3216,5111,2731,8,2739,1740,999,1.741741742,1567,2189,635,261,261,0,57,0,0.053639847,0,empty,CD-0722-4
"E12,B7",8088,8964,6053,2911,4684,2337,13,2350,1568,782,2.00511509,1314,2140,503,199,197,2,43,1,0.020304569,0,empty,CD-0722-4
"E12,B8",932615,1133818,667043,466775,558504,357849,3,358135,263295,94840,2.776202024,212087,25024,11579,3805,3798,7,685,3,0.032648763,0,hg38,CD-0722-4
"E12,B9",10391,11580,7720,3860,5953,3029,0,3031,1996,1035,1.928502415,1695,1674,411,160,160,0,38,0,0.00625,0,empty,CD-0722-4
"E12,B10",497880,562460,321239,241221,301740,195617,17,196094,125826,70268,1.790658621,119321,967,170,71,70,1,23,1,0.114285714,0,empty,CD-0722-4
"E12,B11",11240,12567,8077,4490,6519,3562,2,3564,2119,1445,1.466435986,2067,252,52,23,23,0,9,0,0,0,empty,CD-0722-4
"E12,B12",6727,7542,4935,2607,3992,2030,0,2037,1324,713,1.856942496,1195,2235,549,210,210,0,54,0,0.061904762,0,empty,CD-0722-4
"E12,C1",14415,15694,10884,4810,8276,3957,0,3960,2663,1297,2.053199692,2172,1248,138,72,72,0,29,0,0.152777778,0,empty,CD-0722-4
"E12,C2",10970,12104,7968,4136,6295,3245,0,3251,2149,1102,1.950090744,1888,2319,727,246,244,2,62,1,0.004098361,0,empty,CD-0722-4
"E12,C3",11435,12658,8466,4192,6673,3435,0,3436,2121,1315,1.612927757,1982,1003,181,63,61,2,22,2,0.081967213,0,empty,CD-0722-4
"E12,C4",736306,892884,501793,391091,443419,295306,1,295514,221680,73834,3.002410813,178414,8273,1368,485,469,16,95,4,0.398720682,0,hg38,CD-0722-4
"E12,C5",10325,11410,7677,3733,6065,3021,12,3033,1991,1042,1.91074856,1697,1924,393,157,155,2,38,2,0.051612903,0,empty,CD-0722-4
"E12,C6",8038,8981,5843,3138,4834,2507,0,2512,1616,896,1.803571429,1480,2093,410,183,183,0,57,0,0.109289617,0,empty,CD-0722-4
"E12,C7",21242,24884,14422,10462,12593,7626,0,7631,4595,3036,1.513504611,4818,787,199,76,76,0,20,0,0.131578947,0,empty,CD-0722-4
"E12,C8",817139,885341,622465,262876,433418,211423,2,211659,172417,39242,4.393685337,116443,172723,27124,9972,9754,218,1537,8,0.064691409,0,hg38,CD-0722-4
"E12,C9",9148,9971,6886,3085,5342,2644,3,2653,1775,878,2.021640091,1470,2219,467,194,192,2,47,2,0.078125,0,empty,CD-0722-4
"E12,C10",10703,11493,8004,3489,6071,2894,11,2913,1886,1027,1.836416748,1570,3278,781,270,267,3,59,2,0.093632959,0,empty,CD-0722-4
"E12,C11",9307,10126,6847,3279,5338,2659,0,2661,1774,887,2,1449,2359,608,288,286,2,71,2,0.062937063,0,empty,CD-0722-4
"E12,C12",13197,14380,9819,4561,7477,3562,1,3571,2397,1174,2.041737649,2044,2736,765,269,266,3,63,2,0.056390977,0,empty,CD-0722-4
"E12,D1",10787,11856,8027,3829,6107,3087,0,3089,1883,1206,1.561359867,1759,928,140,56,56,0,15,0,0.267857143,0,empty,CD-0722-4
"E12,D2",9608,10510,7351,3159,5555,2500,2,2502,1624,878,1.849658314,1415,3077,894,344,342,2,88,1,0.01754386,0,empty,CD-0722-4
"E12,D3",8123,9069,6053,3016,4734,2419,2,2424,1557,867,1.795847751,1330,1678,370,149,149,0,37,0,0.100671141,0,empty,CD-0722-4
"E12,D4",7054,8104,5150,2954,4194,2090,39,2134,1456,678,2.147492625,1272,1961,506,198,195,3,50,1,0.061538462,0,empty,CD-0722-4
"E12,D5",7236,8277,5404,2873,4261,2182,9,2196,1451,745,1.947651007,1274,1760,306,132,130,2,41,2,0.030769231,0,empty,CD-0722-4
"E12,D6",10851,11708,7784,3924,6137,3228,13,3242,2020,1222,1.653027823,1853,1895,314,167,165,2,52,1,0.048484848,0,empty,CD-0722-4
"E12,D7",6184,6756,4748,2008,3556,1686,0,1686,1121,565,1.984070796,930,2219,583,230,228,2,52,1,0.030701754,0,empty,CD-0722-4
"E12,D8",7437,8127,5528,2599,4358,2189,16,2209,1464,745,1.965100671,1284,1207,156,64,63,1,27,1,0.031746032,0,empty,CD-0722-4
"E12,D9",505888,583296,367637,215659,287881,160186,0,160305,135024,25281,5.34092797,95180,70740,8194,3287,3203,84,730,5,0.013424914,0,hg38,CD-0722-4
"E12,D10",7828,8756,5615,3141,4550,2350,0,2355,1501,854,1.757611241,1383,846,187,91,91,0,29,0,0.065934066,0,empty,CD-0722-4
"E12,D11",840596,958285,628321,329964,465863,246195,1,246429,198324,48105,4.122731525,142857,243752,40988,16060,15749,311,2036,8,0.050987364,0,hg38,CD-0722-4
"E12,D12",11387,12103,8453,3650,6376,3129,1,3132,2044,1088,1.878676471,1694,3884,820,368,365,3,110,2,0.076712329,0,empty,CD-0722-4
"E12,E1",13424,14547,9918,4629,7613,3803,2,3806,2415,1391,1.736161035,2176,4057,1024,363,356,7,81,3,0.053370787,0,empty,CD-0722-4
"E12,E2",9184,10113,6813,3300,5413,2655,0,2666,1717,949,1.809272919,1511,2840,617,229,229,0,62,0,0.161572052,0,empty,CD-0722-4
"E12,E3",6531,7668,4869,2799,3887,1955,1,1960,1243,717,1.733612273,1148,2375,571,208,208,0,63,0,0.0625,0,empty,CD-0722-4
"E12,E4",10353,11220,7662,3558,5822,2928,32,2962,1967,995,1.976884422,1605,2557,572,268,268,0,76,0,0.02238806,0,empty,CD-0722-4
"E12,E5",7614,8250,5764,2486,4294,1974,0,1974,1254,720,1.741666667,1082,1840,430,147,146,1,42,1,0.082191781,0,empty,CD-0722-4
"E12,E6",13872,15243,10321,4922,7842,3910,0,3910,2547,1363,1.868672047,2188,4150,795,379,372,7,92,2,0.072580645,0,empty,CD-0722-4
"E12,E7",682836,738721,530915,207806,360641,165813,17,165985,130193,35792,3.637488824,91633,45565,10985,4211,4165,46,709,5,0.015606242,0,hg38,CD-0722-4
"E12,E8",10666,11483,8076,3407,6093,2883,3,2892,1901,991,1.918264379,1588,3494,1033,377,372,5,91,2,0.075268817,0,empty,CD-0722-4
"E12,E9",6355,7127,4730,2397,3627,1842,0,1847,1243,604,2.05794702,1042,3087,789,334,331,3,91,2,0.120845921,0,empty,CD-0722-4
"E12,E10",7229,7783,5504,2279,4170,2027,0,2028,1345,683,1.969253294,1112,2088,492,189,186,3,54,1,0.032258065,0,empty,CD-0722-4
"E12,E11",8911,10012,6664,3348,5180,2661,6,2669,1749,920,1.901086957,1497,2801,444,194,193,1,65,1,0.041450777,0,empty,CD-0722-4
"E12,E12",10532,11920,7707,4213,6135,3168,6,3174,2130,1044,2.040229885,1838,2064,354,166,165,1,43,1,0.006060606,0,empty,CD-0722-4
"E12,F1",11038,11793,8188,3605,6203,3085,0,3089,1971,1118,1.762969589,1656,2666,535,231,223,8,63,1,0.121076233,0,empty,CD-0722-4
"E12,F2",8438,9152,6289,2863,4890,2392,0,2392,1535,857,1.791131855,1358,3332,917,297,296,1,76,1,0.091216216,0,empty,CD-0722-4
"E12,F3",8924,9644,6544,3100,5226,2646,1,2648,1766,882,2.002267574,1523,3201,821,313,311,2,86,1,0.025723473,0,empty,CD-0722-4
"E12,F4",13716,14811,10177,4634,7701,3793,1,3797,2506,1291,1.941130906,2089,774,186,79,79,0,24,0,0.025316456,0,empty,CD-0722-4
"E12,F5",10764,11655,8054,3601,6098,2917,0,2920,1828,1092,1.673992674,1583,2871,850,304,299,5,65,2,0.150501672,0,empty,CD-0722-4
"E12,F6",1828077,2141960,1339149,802811,1031971,587787,3,588312,494818,93494,5.292510749,353015,353942,60189,23599,23201,398,2836,8,0.061118055,0,hg38,CD-0722-4
"E12,F7",11569,12708,8655,4053,6832,3388,23,3411,2244,1167,1.922879177,1913,1291,303,119,118,1,36,1,0,0,empty,CD-0722-4
"E12,F8",8623,9409,6430,2979,5055,2421,17,2444,1691,753,2.245683931,1386,540,27,18,17,1,10,1,0,0,empty,CD-0722-4
"E12,F9",9393,10590,7002,3588,5488,2721,23,2746,1819,927,1.962243797,1630,3070,740,280,278,2,76,1,0.089928058,0,empty,CD-0722-4
"E12,F10",12481,13448,9430,4018,7063,3351,11,3367,2218,1149,1.930374238,1863,2028,411,168,167,1,55,1,0.041916168,0,empty,CD-0722-4
"E12,F11",8719,9502,6663,2839,4880,2255,0,2257,1560,697,2.238163558,1257,2257,509,223,220,3,49,1,0.072727273,0,empty,CD-0722-4
"E12,F12",9946,10774,7302,3472,5618,2750,4,2755,1835,920,1.994565217,1571,274,25,15,15,0,8,0,0.066666667,0,empty,CD-0722-4
"E12,G1",1416300,1594662,1086375,508287,759735,393936,6,394397,316409,77988,4.057149818,222416,371759,51265,20802,20386,416,2670,10,0.04557049,0,hg38,CD-0722-4
"E12,G2",6015,6476,4282,2194,3374,1729,0,1730,1072,658,1.629179331,957,356,34,27,27,0,16,0,0,0,empty,CD-0722-4
"E12,G3",11877,12825,8770,4055,6691,3409,0,3409,2068,1341,1.542132737,1855,3328,773,317,315,2,77,2,0.028571429,0,empty,CD-0722-4
"E12,G4",20511,23058,14823,8235,11676,6354,0,6364,3814,2550,1.495686275,3692,127,7,5,5,0,3,0,0,0,empty,CD-0722-4
"E12,G5",6922,7507,5205,2302,3996,1991,11,2006,1282,724,1.770718232,1122,1428,293,121,120,1,33,1,0.133333333,0,empty,CD-0722-4
"E12,G6",10594,12023,8065,3958,6064,3048,0,3048,2113,935,2.259893048,1682,148,29,19,19,0,7,0,0,0,empty,CD-0722-4
"E12,G7",8828,9531,6649,2882,5037,2337,0,2341,1547,794,1.94836272,1289,3241,832,335,330,5,90,2,0.066666667,0,empty,CD-0722-4
"E12,G8",6427,6902,4776,2126,3591,1802,0,1805,1196,609,1.963875205,972,2233,465,194,190,4,61,1,0.036842105,0,empty,CD-0722-4
"E12,G9",7788,8609,5820,2789,4631,2276,0,2281,1520,761,1.997371879,1312,3210,657,286,276,10,88,2,0.018115942,0,empty,CD-0722-4
"E12,G10",9254,10086,6855,3231,5224,2573,0,2578,1676,902,1.858093126,1463,2805,825,335,335,0,83,0,0.074626866,0,empty,CD-0722-4
"E12,G11",9233,10078,6944,3134,5336,2523,0,2525,1767,758,2.331134565,1442,1771,321,147,147,0,46,0,0.034013605,0,empty,CD-0722-4
"E12,G12",7245,7903,5232,2671,4114,2166,0,2166,1404,762,1.842519685,1228,2423,707,271,270,1,57,1,0.062962963,0,empty,CD-0722-4
"E12,H1",9889,10554,7363,3191,5578,2715,1,2718,1875,843,2.224199288,1521,2236,458,170,170,0,46,0,0.058823529,0,empty,CD-0722-4
"E12,H2",9638,10741,7081,3660,5575,2844,0,2852,1876,976,1.922131148,1674,2448,597,253,241,12,63,2,0.12033195,0,empty,CD-0722-4
"E12,H3",443200,593704,274746,318958,299484,224478,17,224643,155162,69481,2.233157266,147445,5913,1022,280,277,3,83,2,0.296028881,0,hg38,CD-0722-4
"E12,H4",10746,11652,8105,3547,6122,2942,0,2949,1904,1045,1.822009569,1665,137,19,10,10,0,7,0,0,0,empty,CD-0722-4
"E12,H5",12863,14049,9706,4343,7301,3539,19,3559,2317,1242,1.865539452,1979,3551,859,270,267,3,76,2,0.183520599,0,empty,CD-0722-4
"E12,H6",7554,8470,5589,2881,4432,2322,0,2323,1589,734,2.164850136,1317,2711,469,215,212,3,66,1,0.014150943,0,empty,CD-0722-4
"E12,H7",808856,966523,572108,394415,479930,299757,6,299988,190877,109111,1.749383655,180805,29785,6427,2506,2472,34,539,4,0.055420712,0,hg38,CD-0722-4
"E12,H8",10032,11067,7258,3809,5764,2970,0,2971,1964,1007,1.950347567,1694,2794,413,183,180,3,56,1,0.033333333,0,empty,CD-0722-4
"E12,H9",7826,8654,6044,2610,4496,2103,1,2109,1520,589,2.580645161,1184,1147,386,135,133,2,38,1,0,0,empty,CD-0722-4
"E12,H10",6138,6469,4620,1849,3377,1635,0,1638,1088,550,1.978181818,893,1548,451,154,152,2,30,1,0.006578947,0,empty,CD-0722-4
"E12,H11",8286,9378,5885,3493,4851,2916,1,2921,1562,1359,1.14937454,1691,23,10,8,8,0,4,0,0,0,empty,CD-0722-4
"E12,H12",6506,7137,4734,2403,3712,1855,0,1863,1261,602,2.094684385,1047,1676,361,99,98,1,35,1,0.020408163,0,empty,CD-0722-4
"F1,A1",7463,8346,5427,2919,4388,2320,1,2326,1563,763,2.048492792,1357,1820,344,121,121,0,32,0,0.173553719,0,empty,CD-0722-4
"F1,A2",10834,11793,8210,3583,6157,3046,0,3050,2002,1048,1.910305344,1680,2273,544,239,238,1,57,1,0.071428571,0,empty,CD-0722-4
"F1,A3",7098,7800,5219,2581,4188,2067,10,2077,1434,643,2.230171073,1205,1826,451,180,175,5,46,3,0.034285714,0,empty,CD-0722-4
"F1,A4",11714,12915,8779,4136,6834,3320,1,3331,2140,1191,1.796809404,1917,866,242,81,81,0,16,0,0.024691358,0,empty,CD-0722-4
"F1,A5",17812,19589,13493,6096,10162,4803,13,4818,3229,1589,2.032095658,2683,6409,885,416,412,4,107,2,0.067961165,0,empty,CD-0722-4
"F1,A6",8652,10051,6435,3616,5427,2820,17,2839,1951,888,2.197072072,1649,3975,875,350,344,6,100,3,0.148255814,0,empty,CD-0722-4
"F1,A7",7192,8058,5342,2716,4338,2233,1,2237,1423,814,1.748157248,1277,1398,279,126,126,0,31,0,0.095238095,0,empty,CD-0722-4
"F1,A8",4909,5402,3683,1719,2940,1450,0,1451,982,469,2.093816631,839,2742,641,250,246,4,65,2,0.073170732,0,empty,CD-0722-4
"F1,A9",8338,9288,6210,3078,4901,2474,0,2474,1712,762,2.24671916,1429,2502,649,224,222,2,45,1,0.072072072,0,empty,CD-0722-4
"F1,A10",682676,785249,508091,277158,388344,209207,2,209384,162305,47079,3.447503133,121838,31837,4138,1675,1627,48,329,4,0.079901659,0,hg38,CD-0722-4
"F1,A11",540585,653975,377129,276846,326385,213753,0,213935,156063,57872,2.696692701,126766,6138,836,313,303,10,66,4,0.165016502,0,hg38,CD-0722-4
"F1,A12",9820,10759,7376,3383,5698,2805,0,2809,1943,866,2.243648961,1560,4217,1301,503,500,3,93,2,0.068,0,empty,CD-0722-4
"F1,B1",8017,8570,5952,2618,4560,2225,0,2233,1405,828,1.696859903,1206,2457,731,269,267,2,53,1,0.116104869,0,empty,CD-0722-4
"F1,B2",8496,9445,5915,3530,4980,2702,0,2702,1687,1015,1.662068966,1587,822,170,58,54,4,14,1,0.092592593,0,empty,CD-0722-4
"F1,B3",7165,7976,5293,2683,4380,2294,14,2311,1556,755,2.060927152,1294,1821,328,147,145,2,49,2,0.006896552,0,empty,CD-0722-4
"F1,B4",7390,8461,5435,3026,4392,2323,0,2323,1468,855,1.716959064,1357,1877,439,181,178,3,37,2,0.129213483,0,empty,CD-0722-4
"F1,B5",11016,8529,5363,3166,5130,2750,0,2758,1969,789,2.495564005,1700,914,135,69,69,0,22,0,0.014492754,0,empty,CD-0722-4
"F1,B6",9069,10442,6548,3894,5485,2921,0,2926,1939,987,1.964539007,1731,2097,445,174,174,0,53,0,0.051724138,0,empty,CD-0722-4
"F1,B7",8363,9490,6246,3244,5099,2547,0,2549,1702,847,2.0094451,1491,1558,497,180,180,0,46,0,0.016666667,0,empty,CD-0722-4
"F1,B8",6444,7215,4882,2333,3990,1990,0,1993,1388,605,2.294214876,1151,1564,344,134,133,1,50,1,0.015037594,0,empty,CD-0722-4
"F1,B9",10918,11999,8061,3938,6371,3246,0,3252,2149,1103,1.948322756,1807,1295,308,126,126,0,36,0,0.007936508,0,empty,CD-0722-4
"F1,B10",1274816,1385305,884647,500658,718685,404396,14,405405,305335,100070,3.05121415,239143,15704,4243,1432,1419,13,283,3,0.005637773,0,hg38,CD-0722-4
"F1,B11",11933,13221,8718,4503,6980,3680,0,3684,2102,1582,1.328697851,2171,287,102,32,32,0,12,0,0.03125,0,empty,CD-0722-4
"F1,B12",7431,8437,5542,2895,4411,2208,14,2222,1543,679,2.272459499,1303,2253,687,290,290,0,58,0,0.15862069,0,empty,CD-0722-4
"F1,C1",18796,20228,13971,6257,10812,5356,0,5364,3463,1901,1.821672804,2956,2405,553,188,187,1,44,1,0.090909091,0,empty,CD-0722-4
"F1,C2",11636,12874,8661,4213,6766,3439,14,3456,2222,1234,1.800648298,1968,2412,591,218,216,2,63,2,0.092592593,0,empty,CD-0722-4
"F1,C3",1202316,1421933,888646,533287,692090,386291,5,386600,307190,79410,3.868404483,232321,83211,11075,4257,4168,89,776,3,0.05806142,0,hg38,CD-0722-4
"F1,C4",7942,8631,6004,2627,4546,2174,0,2186,1441,745,1.934228188,1206,2710,713,255,249,6,59,2,0.128514056,0,empty,CD-0722-4
"F1,C5",11092,12263,8271,3992,6602,3347,2,3349,2193,1156,1.897058824,1877,2231,398,168,164,4,51,2,0.097560976,0,empty,CD-0722-4
"F1,C6",9410,10374,6898,3476,5664,2896,0,2901,1936,965,2.006217617,1646,3702,796,340,338,2,83,2,0.00887574,0,empty,CD-0722-4
"F1,C7",12106,13775,8706,5069,7306,3986,13,4009,2536,1473,1.721656483,2363,435,118,36,35,1,13,1,0,0,empty,CD-0722-4
"F1,C8",1604747,1813130,1238048,575082,871099,450805,6,451251,370943,80308,4.619004333,255495,374758,42416,16705,16284,421,2411,9,0.028371408,0,hg38,CD-0722-4
"F1,C9",9796,10690,7239,3451,5768,2852,3,2859,1908,951,2.006309148,1628,1881,384,155,155,0,47,0,0.070967742,0,empty,CD-0722-4
"F1,C10",10890,11808,8243,3565,6217,3023,4,3029,2035,994,2.047283702,1683,2508,725,252,247,5,61,1,0.036437247,0,empty,CD-0722-4
"F1,C11",951031,1122734,686208,436526,555282,316321,6,316597,258467,58130,4.446361603,192633,87715,16271,6060,5981,79,1069,6,0.060859388,0,hg38,CD-0722-4
"F1,C12",14348,15766,10606,5160,8410,4078,23,4106,2820,1286,2.192846034,2345,4538,806,352,344,8,84,2,0.101744186,0,empty,CD-0722-4
"F1,D1",1025316,1177885,769225,408660,576921,307220,2,307512,240874,66638,3.614664306,180271,76908,8613,3371,3265,106,583,3,0.05482389,0,hg38,CD-0722-4
"F1,D2",9816,10528,7536,2992,5754,2679,1,2683,1684,999,1.685685686,1444,4132,1350,485,482,3,117,1,0.076763485,0,empty,CD-0722-4
"F1,D3",8445,9534,6204,3330,4972,2474,26,2500,1675,825,2.03030303,1464,1691,397,135,132,3,36,2,0.242424242,0,empty,CD-0722-4
"F1,D4",8010,8920,5875,3045,4883,2487,0,2490,1771,719,2.463143255,1432,1827,483,206,204,2,53,1,0.049019608,0,empty,CD-0722-4
"F1,D5",7686,8275,5751,2524,4413,2123,0,2126,1371,755,1.81589404,1174,2350,560,237,235,2,53,2,0.008510638,0,empty,CD-0722-4
"F1,D6",11232,12608,8089,4519,6510,3463,0,3466,2199,1267,1.735595896,2000,2090,707,233,229,4,58,2,0.021834061,0,empty,CD-0722-4
"F1,D7",6575,7127,4828,2299,3743,1788,0,1789,1207,582,2.073883162,1026,2002,486,216,207,9,51,2,0.072463768,0,empty,CD-0722-4
"F1,D8",8075,8664,5957,2707,4671,2246,36,2286,1553,733,2.118690314,1248,1861,428,160,159,1,48,1,0.025157233,0,empty,CD-0722-4
"F1,D9",4308,4853,3205,1648,2581,1301,0,1301,842,459,1.834422658,759,1939,365,179,179,0,46,0,0.067039106,0,empty,CD-0722-4
"F1,D10",8214,9331,6081,3250,5010,2603,12,2615,1733,882,1.964852608,1522,796,170,71,70,1,22,1,0.128571429,0,empty,CD-0722-4
"F1,D11",8215,9008,6126,2882,4894,2433,0,2435,1630,805,2.02484472,1358,3288,857,313,312,1,74,1,0.131410256,0,empty,CD-0722-4
"F1,D12",1139755,1333146,842539,490607,646730,360109,5,360472,283852,76620,3.704672409,213602,166793,25892,10024,9850,174,1604,8,0.065583756,0,hg38,CD-0722-4
"F1,E1",14641,15792,10931,4861,8153,3989,37,4031,2658,1373,1.935906773,2167,3373,917,331,329,2,79,2,0.063829787,0,empty,CD-0722-4
"F1,E2",10022,11157,7304,3853,5890,3009,0,3011,1953,1058,1.845935728,1758,2695,475,196,191,5,51,2,0.104712042,0,empty,CD-0722-4
"F1,E3",6867,7447,5076,2371,3927,1907,0,1907,1275,632,2.017405063,1087,3034,790,311,311,0,82,0,0.080385852,0,empty,CD-0722-4
"F1,E4",9975,11105,7357,3748,5961,3046,2,3049,2020,1029,1.963070943,1792,3032,768,324,314,10,83,2,0.082802548,0,empty,CD-0722-4
"F1,E5",8065,8715,6016,2699,4612,2113,23,2137,1400,737,1.899592944,1220,1576,370,128,123,5,35,2,0.016260163,0,empty,CD-0722-4
"F1,E6",14811,16226,10957,5269,8567,4250,1,4257,2794,1463,1.909774436,2436,4150,942,398,393,5,104,1,0.150127226,0,empty,CD-0722-4
"F1,E7",22298,24535,17014,7521,12820,6264,0,6269,4533,1736,2.611175115,3469,7879,1331,595,579,16,155,2,0.020725389,0,empty,CD-0722-4
"F1,E8",1745261,1992433,1290388,702045,962204,535354,4,535845,414764,121081,3.425508544,310970,294185,36780,14101,13750,351,1980,10,0.046327273,0,hg38,CD-0722-4
"F1,E9",518751,609688,379224,230464,303132,171230,3,171350,127251,44099,2.885575637,102826,139432,19602,7680,7538,142,1236,6,0.058503582,0,hg38,CD-0722-4
"F1,E10",8055,8848,6064,2784,4676,2361,0,2366,1574,792,1.987373737,1314,1903,614,221,219,2,53,1,0.063926941,0,empty,CD-0722-4
"F1,E11",542391,675943,361310,314633,343810,237411,4,237542,142934,94608,1.510802469,148807,2891,758,298,298,0,89,0,0.11409396,0,hg38,CD-0722-4
"F1,E12",10397,11381,7769,3612,6168,3095,0,3099,2123,976,2.175204918,1709,1844,367,157,156,1,56,1,0.044871795,0,empty,CD-0722-4
"F1,F1",28280,29590,22122,7468,14860,5962,23,5994,4210,1784,2.359865471,3204,6301,1341,609,601,8,155,3,0.034941764,0,empty,CD-0722-4
"F1,F2",16114,15784,11049,4735,8260,3994,1,4007,2886,1121,2.574487065,2226,4358,1083,444,438,6,95,2,0.152968037,0,empty,CD-0722-4
"F1,F3",11820,13447,8788,4659,7113,3709,1,3714,2587,1127,2.295474712,2146,4184,1185,449,448,1,114,1,0.069196429,0,empty,CD-0722-4
"F1,F4",13761,14682,10277,4405,8032,3825,2,3836,2554,1282,1.992199688,2073,1055,180,74,74,0,28,0,0.067567568,0,empty,CD-0722-4
"F1,F5",11038,11766,8281,3485,6242,2904,2,2907,1855,1052,1.763307985,1590,3796,1016,395,386,9,91,2,0.075129534,0,empty,CD-0722-4
"F1,F6",770910,907668,553256,354412,454067,262024,7,262276,210271,52005,4.0432843,158263,173476,29652,11582,11425,157,1806,6,0.049452954,0,hg38,CD-0722-4
"F1,F7",12508,13703,9326,4377,7387,3599,0,3607,2422,1185,2.043881857,2049,1603,443,183,177,6,53,1,0.175141243,0,empty,CD-0722-4
"F1,F8",9190,9954,6815,3139,5428,2598,0,2603,1763,840,2.098809524,1498,424,45,28,28,0,18,0,0.142857143,0,empty,CD-0722-4
"F1,F9",9926,10710,7394,3316,5773,2828,0,2829,1948,881,2.211123723,1595,4023,904,328,325,3,86,2,0.178461538,0,empty,CD-0722-4
"F1,F10",12705,13780,9777,4003,7353,3449,0,3453,2339,1114,2.099640934,1868,2251,663,246,245,1,56,1,0.044897959,0,empty,CD-0722-4
"F1,F11",8544,9179,6505,2674,4804,2228,0,2228,1532,696,2.201149425,1158,1955,378,160,149,11,35,2,0.060402685,0,empty,CD-0722-4
"F1,F12",10629,11545,7818,3727,6162,2946,0,2947,1938,1009,1.920713578,1645,238,86,29,29,0,16,0,0,0,empty,CD-0722-4
"F1,G1",11706,13114,8682,4432,6977,3456,1,3457,2256,1201,1.878434638,1982,3192,811,284,280,4,84,2,0.021428571,0,empty,CD-0722-4
"F1,G2",6244,6637,4469,2168,3594,1843,0,1846,1178,668,1.763473054,1048,859,204,49,48,1,14,1,0.291666667,0,empty,CD-0722-4
"F1,G3",12037,13075,8973,4102,6872,3354,10,3368,2071,1297,1.596761758,1801,2605,566,223,220,3,57,2,0.018181818,0,empty,CD-0722-4
"F1,G4",21673,24261,15633,8628,12729,7033,0,7037,4340,2697,1.609195402,4092,83,9,4,4,0,4,0,0,0,empty,CD-0722-4
"F1,G5",7922,8503,5840,2663,4491,2152,0,2152,1409,743,1.896366083,1175,2816,679,269,266,3,61,2,0.04887218,0,empty,CD-0722-4
"F1,G6",10943,11884,8280,3604,6369,3112,5,3120,2092,1028,2.035019455,1731,258,43,20,20,0,9,0,0.35,0,empty,CD-0722-4
"F1,G7",9223,10277,6986,3291,5338,2565,0,2565,1712,853,2.007033998,1443,3329,761,320,311,9,85,2,0.154340836,0,empty,CD-0722-4
"F1,G8",902974,1024885,676657,348228,501790,259498,4,259727,190886,68841,2.772853387,151772,78790,15217,5912,5802,110,971,6,0.049465701,0,hg38,CD-0722-4
"F1,G9",8744,9512,6538,2974,5045,2474,8,2485,1701,784,2.169642857,1358,3387,699,317,313,4,87,1,0.044728435,0,empty,CD-0722-4
"F1,G10",1079524,1209207,824354,384853,589090,297304,4,297585,230705,66880,3.449536483,168959,130511,15412,6015,5853,162,1069,5,0.044934222,0,hg38,CD-0722-4
"F1,G11",9580,10288,7260,3028,5563,2656,7,2663,1764,899,1.9621802,1476,1852,524,191,190,1,42,1,0.005263158,0,empty,CD-0722-4
"F1,G12",7428,8366,5368,2998,4435,2283,0,2285,1512,773,1.956015524,1347,2809,797,308,308,0,74,0,0.090909091,0,empty,CD-0722-4
"F1,H1",8904,9242,6528,2714,5151,2508,0,2509,1706,803,2.124533001,1392,1507,301,147,147,0,47,0,0.136054422,0,empty,CD-0722-4
"F1,H2",11941,13036,8964,4072,6857,3363,9,3374,2269,1105,2.053393665,1967,3291,539,220,215,5,60,2,0.037209302,0,empty,CD-0722-4
"F1,H3",8156,8777,6039,2738,4726,2392,0,2397,1626,771,2.108949416,1312,1878,272,129,126,3,50,1,0.031746032,0,empty,CD-0722-4
"F1,H4",11310,12240,8369,3871,6470,3154,1,3160,2080,1080,1.925925926,1793,176,58,20,20,0,12,0,0.05,0,empty,CD-0722-4
"F1,H5",12347,13426,9065,4361,7038,3493,0,3497,2324,1173,1.981244672,2039,2235,550,252,252,0,63,0,0.03968254,0,empty,CD-0722-4
"F1,H6",8006,9044,5755,3289,4814,2557,0,2558,1713,845,2.027218935,1510,1946,551,240,240,0,67,0,0.045833333,0,empty,CD-0722-4
"F1,H7",8605,9395,6405,2990,4940,2421,7,2434,1680,754,2.228116711,1335,2799,805,309,309,0,63,0,0.038834951,0,empty,CD-0722-4
"F1,H8",18891,21596,13865,7731,11218,6007,0,6008,4346,1662,2.614921781,3535,2862,599,256,250,6,95,3,0.04,0,empty,CD-0722-4
"F1,H9",853356,926797,656715,270082,450228,213920,2,214108,165098,49010,3.368659457,118770,58212,11667,4533,4460,73,738,5,0.020403587,0,hg38,CD-0722-4
"F1,H10",11228,12093,8524,3569,6079,2850,21,2873,1996,877,2.275940707,1575,2485,438,171,169,2,52,1,0.035502959,0,empty,CD-0722-4
"F1,H11",7889,8962,5575,3387,4725,2756,1,2762,1580,1182,1.336717428,1674,94,3,3,3,0,3,0,0.333333333,0,empty,CD-0722-4
"F1,H12",7193,8055,5333,2722,4346,2265,11,2279,1549,730,2.121917808,1346,1524,239,113,112,1,38,1,0.116071429,0,empty,CD-0722-4
"F2,A1",1034214,1256487,747353,509134,621105,369696,7,370004,294920,75084,3.927867455,226257,52926,18601,6986,6947,39,1159,3,0.054555923,0,hg38,CD-0722-4
"F2,A2",14011,15815,10380,5435,8253,4348,0,4353,2960,1393,2.124910266,2508,3414,687,294,293,1,80,1,0.088737201,0,empty,CD-0722-4
"F2,A3",8330,9348,6097,3251,4877,2548,11,2559,1762,797,2.210790464,1484,1538,360,141,137,4,48,2,0.01459854,0,empty,CD-0722-4
"F2,A4",12221,13190,9178,4012,6915,3412,0,3418,2305,1113,2.070979335,1868,1225,298,104,104,0,37,0,0.048076923,0,empty,CD-0722-4
"F2,A5",14277,15764,10423,5341,8700,4435,0,4438,3076,1362,2.258443465,2577,3947,1018,393,389,4,98,2,0.118251928,0,empty,CD-0722-4
"F2,A6",677412,780851,512810,268041,383560,200981,1,201138,158666,42472,3.735778866,116817,287087,33039,12974,12622,352,1784,9,0.061004595,0,hg38,CD-0722-4
"F2,A7",8154,9140,5951,3189,4906,2595,0,2604,1693,911,1.858397366,1503,1933,537,200,198,2,57,1,0.02020202,0,empty,CD-0722-4
"F2,A8",6557,7408,4999,2409,3910,2021,3,2025,1461,564,2.590425532,1115,2529,591,254,252,2,80,2,0.075396825,0,empty,CD-0722-4
"F2,A9",11744,13153,8856,4297,6878,3509,1,3512,2545,967,2.631851086,1958,3046,639,265,262,3,83,1,0.160305344,0,empty,CD-0722-4
"F2,A10",16255,18483,12127,6356,9672,5063,16,5081,3525,1556,2.265424165,2962,679,106,49,49,0,24,0,0.387755102,0,empty,CD-0722-4
"F2,A11",8183,8867,6253,2614,4668,2279,0,2281,1543,738,2.090785908,1231,2416,483,200,194,6,51,2,0.072164948,0,empty,CD-0722-4
"F2,A12",14447,15851,10860,4991,8196,4086,0,4089,2882,1207,2.387738194,2264,5145,1260,538,531,7,117,2,0.047080979,0,empty,CD-0722-4
"F2,B1",8961,9721,6755,2966,5067,2493,0,2500,1613,887,1.81848929,1373,2222,638,229,228,1,50,1,0.052631579,0,empty,CD-0722-4
"F2,B2",9611,10325,6503,3822,5836,3063,2,3065,2058,1007,2.043694141,1823,623,102,34,33,1,16,1,0,0,empty,CD-0722-4
"F2,B3",10108,11719,7413,4306,6085,3205,1,3212,2215,997,2.221664995,1903,2490,595,233,230,3,70,1,0.047826087,0,empty,CD-0722-4
"F2,B4",1708979,1969568,1268940,700628,957156,523811,1,524268,422823,101445,4.168002366,307123,216890,43066,16707,16490,217,2184,6,0.05560946,0,hg38,CD-0722-4
"F2,B5",10038,5946,3752,2194,3944,2086,18,2111,1427,684,2.08625731,1322,1388,437,161,159,2,36,2,0.006289308,0,empty,CD-0722-4
"F2,B6",12205,13600,8992,4608,7065,3620,2,3622,2458,1164,2.111683849,2047,2719,482,197,197,0,48,0,0.101522843,0,empty,CD-0722-4
"F2,B7",1160857,1308187,901149,407038,637328,314588,0,314906,225680,89226,2.529307601,177661,59175,13286,5044,4991,53,859,4,0.051091966,0,hg38,CD-0722-4
"F2,B8",21561,22804,15855,6949,11668,5732,0,5739,4234,1505,2.813289037,3202,2845,444,221,216,5,60,2,0.152777778,0,empty,CD-0722-4
"F2,B9",14123,15675,10372,5303,8187,4170,0,4171,2822,1349,2.091919941,2374,1932,475,196,196,0,57,0,0.117346939,0,empty,CD-0722-4
"F2,B10",8076,8716,5705,3011,4852,2455,0,2465,1648,817,2.017135863,1405,952,203,85,84,1,26,1,0.035714286,0,empty,CD-0722-4
"F2,B11",18105,19784,13465,6319,10164,5284,0,5287,3281,2006,1.63559322,2975,393,62,26,25,1,9,1,0.12,0,empty,CD-0722-4
"F2,B12",1065993,1255729,786904,468825,610534,345733,2,346057,290389,55668,5.216443918,204764,160345,27436,10538,10378,160,1609,7,0.050105993,0,hg38,CD-0722-4
"F2,C1",19392,20770,14499,6271,11147,5609,4,5616,3720,1896,1.962025316,3070,1654,365,147,144,3,48,1,0.048611111,0,empty,CD-0722-4
"F2,C2",13272,14520,9597,4923,7672,3981,2,3983,2616,1367,1.91367959,2196,3230,836,344,344,0,95,0,0.122093023,0,empty,CD-0722-4
"F2,C3",13841,15090,10244,4846,8174,4082,0,4088,2746,1342,2.046199702,2252,1114,240,92,91,1,26,1,0.054945055,0,empty,CD-0722-4
"F2,C4",10436,11233,7669,3564,6128,2969,0,2970,2079,891,2.333333333,1627,2942,634,245,241,4,73,2,0.10373444,0,empty,CD-0722-4
"F2,C5",13674,15601,10059,5542,8185,4294,0,4296,2930,1366,2.144948755,2542,3289,757,269,268,1,71,1,0.041044776,0,empty,CD-0722-4
"F2,C6",1339508,1603211,959766,643445,796021,469324,5,469755,374843,94912,3.949374157,286028,230813,50317,19448,19204,244,2475,7,0.040147886,0,hg38,CD-0722-4
"F2,C7",13968,16177,10230,5947,8310,4629,1,4635,2865,1770,1.618644068,2701,577,138,32,31,1,17,1,0.129032258,0,empty,CD-0722-4
"F2,C8",16381,18165,12095,6070,9396,4775,1,4777,3280,1497,2.191048764,2713,4535,1029,432,419,13,114,4,0.045346062,0,empty,CD-0722-4
"F2,C9",13224,14873,9828,5045,8045,4113,0,4117,2893,1224,2.363562092,2370,2717,563,234,225,9,70,2,0.102222222,0,empty,CD-0722-4
"F2,C10",864802,967525,648491,319034,473894,244251,3,244483,183247,61236,2.992471749,139966,61553,12424,4749,4672,77,847,2,0.022688356,0,hg38,CD-0722-4
"F2,C11",2043273,2236574,1560811,675763,1062249,530506,2,531095,427523,103572,4.127785502,299560,78188,8954,3566,3499,67,724,5,0.020577308,0,hg38,CD-0722-4
"F2,C12",18303,19730,13870,5860,10561,5114,1,5123,3594,1529,2.350555919,2784,3536,984,412,406,6,108,2,0.133004926,0,empty,CD-0722-4
"F2,D1",1054005,1211549,774690,436859,598412,341341,7,341631,260291,81340,3.200036882,200833,16830,2383,1000,985,15,217,2,0.023350254,0,hg38,CD-0722-4
"F2,D2",10101,10914,7587,3327,5783,2807,1,2809,1798,1011,1.778437191,1576,4479,1318,415,411,4,98,3,0.055961071,0,empty,CD-0722-4
"F2,D3",10622,11779,7773,4006,6296,3275,0,3277,2240,1037,2.160077146,1858,2731,554,212,209,3,48,3,0.014354067,0,empty,CD-0722-4
"F2,D4",8743,10013,6472,3541,5433,2851,1,2862,1945,917,2.121046892,1733,2041,408,178,176,2,55,2,0.164772727,0,empty,CD-0722-4
"F2,D5",9236,10046,6849,3197,5303,2604,14,2627,1772,855,2.07251462,1476,2536,512,179,177,2,59,2,0.079096045,0,empty,CD-0722-4
"F2,D6",12661,13822,9041,4781,7073,3761,0,3767,2363,1404,1.683048433,2149,2793,689,295,293,2,64,2,0.071672355,0,empty,CD-0722-4
"F2,D7",7813,8365,5779,2586,4440,2154,0,2155,1454,701,2.074179743,1218,3435,618,301,295,6,75,2,0.169491525,0,empty,CD-0722-4
"F2,D8",10512,11891,7740,4151,6338,3297,0,3300,2218,1082,2.049907579,1931,2273,577,229,228,1,61,1,0.048245614,0,empty,CD-0722-4
"F2,D9",4957,5329,3661,1668,2912,1466,0,1468,1040,428,2.429906542,804,2431,459,189,185,4,50,2,0.178378378,0,empty,CD-0722-4
"F2,D10",10382,11305,7458,3847,6408,3411,0,3414,2388,1026,2.32748538,1987,1649,426,146,145,1,39,1,0.020689655,0,empty,CD-0722-4
"F2,D11",9914,11086,7549,3537,5803,2851,0,2853,1821,1032,1.764534884,1591,4342,1196,493,491,2,102,1,0.067209776,0,empty,CD-0722-4
"F2,D12",13979,15364,10541,4823,8129,4064,0,4072,2796,1276,2.191222571,2252,4850,1284,524,520,4,129,2,0.051923077,0,empty,CD-0722-4
"F2,E1",19302,21112,14488,6624,11007,5375,11,5388,3565,1823,1.955567745,3078,4312,903,348,337,11,89,2,0.065281899,0,empty,CD-0722-4
"F2,E2",1245272,1435833,936032,499801,699128,375785,3,376167,304595,71572,4.255784385,219161,307137,44824,17728,17388,340,2317,9,0.044628479,0,hg38,CD-0722-4
"F2,E3",7516,8330,5715,2615,4383,2160,0,2167,1422,745,1.908724832,1205,3563,748,331,324,7,90,3,0.030864198,0,empty,CD-0722-4
"F2,E4",13047,14696,9531,5165,7776,4047,0,4049,2850,1199,2.376980817,2371,4657,945,411,408,3,118,2,0.120098039,0,empty,CD-0722-4
"F2,E5",9396,10165,7120,3045,5493,2581,0,2583,1758,825,2.130909091,1382,1677,331,154,153,1,43,1,0.045751634,0,empty,CD-0722-4
"F2,E6",18814,20077,13908,6169,10701,5431,0,5436,3761,1675,2.245373134,2975,5594,1461,537,532,5,142,2,0.013157895,0,empty,CD-0722-4
"F2,E7",21209,23095,15747,7348,12112,5935,2,5945,4019,1926,2.086708204,3361,6816,1430,550,535,15,131,3,0.171962617,0,empty,CD-0722-4
"F2,E8",13648,14773,10424,4349,7712,3578,4,3584,2500,1084,2.306273063,1954,4049,987,398,393,5,108,2,0.127226463,0,empty,CD-0722-4
"F2,E9",638316,726656,466754,259902,358511,195493,2,195691,165880,29811,5.564388984,114623,392002,63768,24990,24541,449,2915,10,0.050323948,0,hg38,CD-0722-4
"F2,E10",996291,1167546,724404,443142,571359,323535,10,323833,261115,62718,4.163318346,194009,221445,30351,12008,11747,261,1902,8,0.045543543,0,hg38,CD-0722-4
"F2,E11",11182,12408,8400,4008,6553,3314,0,3326,2207,1119,1.972296693,1884,3469,926,374,372,2,85,2,0.088709677,0,empty,CD-0722-4
"F2,E12",13821,15630,10033,5597,8181,4249,0,4251,2914,1337,2.179506358,2469,3539,559,257,251,6,89,1,0.055776892,0,empty,CD-0722-4
"F2,F1",13968,15359,10204,5155,7991,4009,1,4010,2644,1366,1.935578331,2303,4093,876,314,310,4,89,2,0.05483871,0,empty,CD-0722-4
"F2,F2",10607,11559,7781,3778,6045,2982,9,2991,2017,974,2.070841889,1674,3795,744,294,290,4,76,1,0.079310345,0,empty,CD-0722-4
"F2,F3",11526,12969,8438,4531,6840,3492,7,3513,2396,1117,2.145031334,2046,4618,1191,498,489,9,113,2,0.120654397,0,empty,CD-0722-4
"F2,F4",15843,17255,11977,5278,9137,4391,3,4402,3000,1402,2.139800285,2442,1017,264,107,103,4,39,1,0.029126214,0,empty,CD-0722-4
"F2,F5",12108,13336,9020,4316,7022,3373,0,3379,2204,1175,1.875744681,1961,4714,899,402,388,14,97,2,0.010309278,0,empty,CD-0722-4
"F2,F6",18836,21911,13568,8343,11541,6273,10,6291,4551,1740,2.615517241,3808,5212,1232,505,502,3,142,2,0.015936255,0,empty,CD-0722-4
"F2,F7",13518,15221,10053,5168,8097,4139,0,4145,2735,1410,1.939716312,2347,1767,293,141,140,1,48,1,0.021428571,0,empty,CD-0722-4
"F2,F8",1131636,1325587,829409,496178,650097,367014,2,367326,292883,74443,3.934325591,218076,28592,5494,2144,2114,30,426,5,0.035477767,0,hg38,CD-0722-4
"F2,F9",12605,13979,9354,4625,7382,3694,0,3697,2561,1136,2.254401408,2144,4695,1397,467,464,3,108,2,0.094827586,0,empty,CD-0722-4
"F2,F10",16413,17666,12224,5442,10020,4876,0,4880,3421,1459,2.344756683,2702,3498,932,396,391,5,94,2,0.158567775,0,empty,CD-0722-4
"F2,F11",11219,12315,8564,3751,6433,3039,0,3039,2125,914,2.324945295,1684,2766,631,260,254,6,60,2,0.090551181,0,empty,CD-0722-4
"F2,F12",2012015,2219955,1517217,702738,1048356,542815,1,543366,436390,106976,4.079326204,308887,15924,2637,1019,1000,19,205,2,0.057,0,hg38,CD-0722-4
"F2,G1",3502747,3990275,2669030,1321245,1844928,1000361,7,1001311,821484,179827,4.568190539,573390,515710,77143,30564,29922,642,3346,13,0.063866052,0,hg38,CD-0722-4
"F2,G2",7032,7417,4987,2430,3975,2054,1,2055,1353,702,1.927350427,1187,751,195,65,65,0,21,0,0.015384615,0,empty,CD-0722-4
"F2,G3",14270,15192,10710,4482,7944,3898,0,3907,2480,1427,1.737911703,2054,3531,925,391,385,6,99,2,0.127272727,0,empty,CD-0722-4
"F2,G4",23783,26210,17088,9122,13710,7548,1,7559,4770,2789,1.710290427,4327,103,18,14,14,0,11,0,0,0,empty,CD-0722-4
"F2,G5",7914,8903,5827,3076,4687,2328,0,2328,1477,851,1.73560517,1352,2064,686,297,292,5,52,2,0.034246575,0,empty,CD-0722-4
"F2,G6",12269,13283,9236,4047,6999,3347,0,3357,2189,1168,1.874143836,1871,336,53,17,17,0,11,0,0,0,empty,CD-0722-4
"F2,G7",10673,11421,8208,3213,6028,2758,0,2759,1889,870,2.171264368,1467,3869,1116,430,426,4,107,2,0.227699531,0,empty,CD-0722-4
"F2,G8",8980,9427,6501,2926,5269,2546,13,2565,1759,806,2.182382134,1421,2820,741,300,300,0,77,0,0.09,0,empty,CD-0722-4
"F2,G9",10653,11953,7902,4051,6306,3169,0,3173,2212,961,2.301768991,1794,4624,1029,405,403,2,111,2,0.1191067,0,empty,CD-0722-4
"F2,G10",12857,14304,9595,4709,7610,3864,0,3866,2651,1215,2.181893004,2196,3788,815,365,364,1,104,1,0.041208791,0,empty,CD-0722-4
"F2,G11",11931,13253,8971,4282,6896,3336,2,3348,2321,1027,2.259980526,1888,2361,637,279,279,0,69,0,0.064516129,0,empty,CD-0722-4
"F2,G12",8295,9355,6148,3207,4919,2590,0,2592,1681,911,1.845225027,1493,3337,965,402,401,1,93,1,0.092269327,0,empty,CD-0722-4
"F2,H1",12180,13595,8873,4722,7162,3694,0,3699,2554,1145,2.230567686,2153,1814,285,137,135,2,42,2,0.125925926,0,empty,CD-0722-4
"F2,H2",10589,11982,7816,4166,6300,3229,0,3234,2077,1157,1.795159896,1990,3702,860,368,367,1,97,1,0.059945504,0,empty,CD-0722-4
"F2,H3",10684,12263,7796,4467,6388,3361,0,3365,2296,1069,2.147801684,1950,2272,386,159,154,5,51,3,0.097402597,0,empty,CD-0722-4
"F2,H4",13030,14621,9549,5072,7534,3791,0,3796,2586,1210,2.137190083,2257,337,52,33,32,1,14,1,0.15625,0,empty,CD-0722-4
"F2,H5",14142,15522,10351,5171,8078,4090,14,4113,2671,1442,1.852288488,2330,3619,772,311,307,4,68,2,0.104234528,0,empty,CD-0722-4
"F2,H6",10670,11880,8011,3869,6266,3231,5,3236,2188,1048,2.08778626,1820,3336,840,333,329,4,96,2,0.072948328,0,empty,CD-0722-4
"F2,H7",9872,10550,7259,3291,5603,2736,0,2741,1830,911,2.008781559,1474,2789,712,287,283,4,75,2,0.077738516,0,empty,CD-0722-4
"F2,H8",26098,29868,19249,10619,15296,8135,2,8152,6135,2017,3.041646009,4873,3565,557,288,285,3,94,1,0.207017544,0,empty,CD-0722-4
"F2,H9",10068,11025,7734,3291,5782,2662,0,2662,1836,826,2.222760291,1457,3099,508,218,216,2,54,1,0.162037037,0,empty,CD-0722-4
"F2,H10",7524,8597,5686,2911,4373,2193,2,2199,1517,682,2.224340176,1282,2107,557,248,248,0,55,0,0.068548387,0,empty,CD-0722-4
"F2,H11",8302,9636,5780,3856,5088,2995,0,2997,1641,1356,1.210176991,1836,24,5,3,3,0,2,0,0,0,empty,CD-0722-4
"F2,H12",10691,12001,7646,4355,6439,3436,1,3444,2381,1063,2.239887112,2011,1767,543,203,202,1,57,1,0.079207921,0,empty,CD-0722-4
"F3,A1",1761062,2059870,1334728,725142,992705,546652,10,547077,463459,83618,5.542574565,315960,392561,47629,18979,18492,487,2376,9,0.06819165,0,hg38,CD-0722-4
"F3,A2",14091,15423,10438,4985,8002,3980,1,3983,2704,1279,2.114151681,2176,2837,650,278,278,0,56,0,0.057553957,0,empty,CD-0722-4
"F3,A3",1226876,1410555,863498,547057,702758,438662,3,438975,288246,150729,1.912345998,257346,5790,2565,520,517,3,155,2,0.015473888,0,hg38,CD-0722-4
"F3,A4",1964310,2251359,1504729,746630,1058033,562909,16,563495,462160,101335,4.560714462,320050,156710,26242,10273,10104,169,1442,8,0.094615994,0,hg38,CD-0722-4
"F3,A5",12870,14193,9648,4545,7752,3880,1,3885,2603,1282,2.030421217,2182,2576,503,243,242,1,62,1,0.041322314,0,empty,CD-0722-4
"F3,A6",10971,12445,8218,4227,6564,3395,0,3403,2381,1022,2.329745597,1910,3212,856,354,351,3,90,1,0.051282051,0,empty,CD-0722-4
"F3,A7",7839,8804,5822,2982,4788,2578,0,2581,1710,871,1.96326062,1496,1465,285,121,120,1,35,1,0.033333333,0,empty,CD-0722-4
"F3,A8",5973,6783,4477,2306,3660,1851,7,1862,1295,567,2.283950617,1131,2254,459,182,178,4,49,2,0.028089888,0,empty,CD-0722-4
"F3,A9",11011,12562,8165,4397,6627,3495,0,3499,2512,987,2.54508612,2048,2433,410,200,197,3,59,3,0.060913706,0,empty,CD-0722-4
"F3,A10",10635,11763,8031,3732,6024,3050,0,3051,2014,1037,1.942140791,1687,387,107,32,32,0,11,0,0,0,empty,CD-0722-4
"F3,A11",7583,8287,5739,2548,4416,2080,0,2083,1413,670,2.108955224,1126,1819,430,196,194,2,43,2,0.108247423,0,empty,CD-0722-4
"F3,A12",13038,13968,9907,4061,7340,3599,3,3607,2549,1058,2.40926276,1972,4756,1094,465,461,4,120,2,0.075921909,0,empty,CD-0722-4
"F3,B1",8558,9379,6340,3039,4918,2475,0,2477,1631,846,1.927895981,1395,1232,318,133,133,0,36,0,0.082706767,0,empty,CD-0722-4
"F3,B2",9874,10957,6871,4086,5910,3183,0,3183,1962,1221,1.606879607,1901,833,239,78,76,2,14,1,0.052631579,0,empty,CD-0722-4
"F3,B3",8212,9217,6096,3121,4916,2535,0,2538,1795,743,2.415881561,1465,1898,500,188,188,0,46,0,0.015957447,0,empty,CD-0722-4
"F3,B4",8828,9930,6564,3366,5205,2694,0,2699,1768,931,1.899033298,1496,1530,437,171,166,5,40,2,0.030120482,0,empty,CD-0722-4
"F3,B5",9294,5733,3696,2037,3828,1958,1,1977,1361,616,2.209415584,1202,1553,347,147,147,0,36,0,0.170068027,0,empty,CD-0722-4
"F3,B6",11144,12581,8176,4405,6687,3535,1,3540,2367,1173,2.017902813,2023,2250,652,245,243,2,54,2,0.148148148,0,empty,CD-0722-4
"F3,B7",9866,10982,7464,3518,5813,2905,1,2913,1962,951,2.063091483,1620,1477,250,120,120,0,37,0,0.008333333,0,empty,CD-0722-4
"F3,B8",8268,9245,6255,2990,4952,2473,0,2473,1757,716,2.453910615,1416,1446,404,140,138,2,39,1,0,0,empty,CD-0722-4
"F3,B9",32409,35551,24935,10616,17490,8157,4,8170,5905,2265,2.607064018,4470,3080,582,212,212,0,51,0,0.070754717,0,empty,CD-0722-4
"F3,B10",7755,8715,5581,3134,4893,2574,0,2583,1755,828,2.119565217,1521,728,180,56,56,0,17,0,0.017857143,0,empty,CD-0722-4
"F3,B11",13480,15052,9842,5210,7856,4274,0,4279,2565,1714,1.496499417,2454,238,43,23,23,0,9,0,0,0,empty,CD-0722-4
"F3,B12",9402,10589,6937,3652,5676,2906,22,2928,2095,833,2.515006002,1738,1729,403,161,160,1,49,1,0.08125,0,empty,CD-0722-4
"F3,C1",17174,18158,13021,5137,9821,4608,19,4631,3090,1541,2.005191434,2505,1167,143,55,55,0,34,0,0.018181818,0,empty,CD-0722-4
"F3,C2",12506,13820,9191,4629,7182,3665,23,3702,2475,1227,2.017114914,2105,2571,671,286,282,4,72,3,0.081560284,0,empty,CD-0722-4
"F3,C3",13047,14234,9789,4445,7633,3818,3,3825,2519,1306,1.928790199,2160,1259,254,107,107,0,29,0,0.028037383,0,empty,CD-0722-4
"F3,C4",9682,10743,7293,3450,5619,2744,2,2746,1899,847,2.242030697,1520,2403,528,210,210,0,50,0,0.152380952,0,empty,CD-0722-4
"F3,C5",12345,13205,9185,4020,7043,3508,0,3512,2328,1184,1.966216216,1910,2155,364,149,140,9,48,2,0.035714286,0,empty,CD-0722-4
"F3,C6",10632,11437,7523,3914,6078,3179,0,3181,2094,1087,1.926402944,1835,2055,438,167,159,8,39,2,0.132075472,0,empty,CD-0722-4
"F3,C7",13114,14977,9518,5459,7922,4319,3,4332,2720,1612,1.687344913,2577,455,119,60,60,0,16,0,0.216666667,0,empty,CD-0722-4
"F3,C8",14909,16575,11096,5479,8686,4350,0,4351,2948,1403,2.101211689,2494,3559,900,348,344,4,99,2,0.165697674,0,empty,CD-0722-4
"F3,C9",11694,13480,8621,4859,7017,3725,0,3727,2527,1200,2.105833333,2185,1915,351,130,126,4,27,2,0.071428571,0,empty,CD-0722-4
"F3,C10",11546,12921,8687,4234,6775,3312,0,3313,2101,1212,1.73349835,1880,2202,473,216,210,6,49,2,0.128571429,0,empty,CD-0722-4
"F3,C11",14509,16425,10700,5725,8587,4392,0,4396,2960,1436,2.061281337,2608,4247,817,312,309,3,78,2,0.061488673,0,empty,CD-0722-4
"F3,C12",16169,17777,12083,5694,9425,4575,2,4582,3141,1441,2.179736294,2635,2250,537,205,202,3,71,1,0.00990099,0,empty,CD-0722-4
"F3,D1",12089,13777,8874,4903,7171,3833,2,3837,2407,1430,1.683216783,2227,806,189,64,64,0,17,0,0.296875,0,empty,CD-0722-4
"F3,D2",9736,10447,7407,3040,5565,2602,21,2625,1716,909,1.887788779,1395,3959,1122,406,401,5,84,2,0.102244389,0,empty,CD-0722-4
"F3,D3",9599,10595,7114,3481,5605,2826,0,2826,1915,911,2.10208562,1558,1320,250,113,111,2,36,2,0.036036036,0,empty,CD-0722-4
"F3,D4",8140,9242,6063,3179,4886,2488,27,2515,1690,825,2.048484848,1447,1924,551,211,211,0,51,0,0.123222749,0,empty,CD-0722-4
"F3,D5",8670,9543,6512,3031,4894,2412,30,2447,1641,806,2.035980149,1379,1578,325,133,127,6,38,2,0.015748031,0,empty,CD-0722-4
"F3,D6",11792,13050,8435,4615,6799,3613,9,3629,2256,1373,1.643117261,2091,2305,617,199,195,4,46,1,0.092307692,0,empty,CD-0722-4
"F3,D7",6937,7760,5080,2680,4135,1999,0,1999,1373,626,2.193290735,1234,2082,554,235,232,3,58,2,0.073275862,0,empty,CD-0722-4
"F3,D8",8498,9445,6291,3154,5170,2598,0,2601,1718,883,1.945639864,1486,1801,599,173,173,0,40,0,0.098265896,0,empty,CD-0722-4
"F3,D9",4948,5441,3680,1761,2878,1462,0,1462,973,489,1.989775051,825,1807,418,160,159,1,38,1,0.094339623,0,empty,CD-0722-4
"F3,D10",9827,11145,7204,3941,5910,3254,1,3257,1918,1339,1.432412248,1837,1345,371,180,179,1,26,1,0.201117318,0,empty,CD-0722-4
"F3,D11",9254,10022,6948,3074,5412,2659,0,2661,1781,880,2.023863636,1444,3278,1098,326,321,5,75,2,0.112149533,0,empty,CD-0722-4
"F3,D12",13210,15089,9798,5291,8104,4184,23,4214,2889,1325,2.180377358,2474,3733,1189,527,525,2,94,1,0.093333333,0,empty,CD-0722-4
"F3,E1",17970,19681,13377,6304,10180,4984,34,5024,3384,1640,2.063414634,2757,3603,988,390,384,6,89,2,0.083333333,0,empty,CD-0722-4
"F3,E2",10662,12037,7664,4373,6437,3354,1,3355,2178,1177,1.85046729,1977,2042,428,175,172,3,46,2,0.127906977,0,empty,CD-0722-4
"F3,E3",7009,7623,5301,2322,4075,1927,0,1927,1321,606,2.179867987,1063,3493,904,383,372,11,80,3,0.067204301,0,empty,CD-0722-4
"F3,E4",11624,13158,8533,4625,6938,3616,2,3621,2407,1214,1.982701812,2124,3116,840,353,350,3,76,2,0.117142857,0,empty,CD-0722-4
"F3,E5",8190,8691,6262,2429,4720,2165,4,2170,1402,768,1.825520833,1180,1485,381,149,147,2,37,1,0.170068027,0,empty,CD-0722-4
"F3,E6",1011530,1149205,757701,391504,554579,292250,2,292481,237451,55030,4.314937307,167733,183581,29316,11295,11087,208,1712,8,0.050870389,0,hg38,CD-0722-4
"F3,E7",16934,18508,12662,5846,9881,4874,1,4882,3286,1596,2.058897243,2766,3999,827,316,315,1,85,1,0.047619048,0,empty,CD-0722-4
"F3,E8",1101159,1253610,824691,428919,611023,328420,10,328721,265366,63355,4.188556546,188691,177094,31159,11664,11515,149,1598,6,0.066869301,0,hg38,CD-0722-4
"F3,E9",8054,9378,5948,3430,4861,2537,0,2537,1795,742,2.419137466,1512,3282,702,282,279,3,76,2,0.129032258,0,empty,CD-0722-4
"F3,E10",8753,9556,6526,3030,5105,2507,0,2508,1684,824,2.04368932,1415,2627,450,205,202,3,67,1,0.059405941,0,empty,CD-0722-4
"F3,E11",10206,11173,7647,3526,5959,2998,2,3004,1937,1067,1.815370197,1658,2395,597,189,186,3,50,2,0.016129032,0,empty,CD-0722-4
"F3,E12",12449,14094,9267,4827,7557,3834,5,3842,2679,1163,2.303525365,2235,2224,490,180,175,5,48,2,0.131428571,0,empty,CD-0722-4
"F3,F1",12883,13984,9350,4634,7394,3677,3,3684,2364,1320,1.790909091,2158,2589,617,220,219,1,47,1,0.073059361,0,empty,CD-0722-4
"F3,F2",9959,10988,7395,3593,5908,2879,0,2879,1944,935,2.079144385,1716,3289,658,261,260,1,69,1,0.065384615,0,empty,CD-0722-4
"F3,F3",19080,21637,14336,7301,10996,5451,1,5460,3976,1484,2.679245283,3183,4148,1082,421,416,5,99,2,0.151442308,0,empty,CD-0722-4
"F3,F4",14900,16339,11027,5312,8811,4300,0,4309,2887,1422,2.0302391,2452,700,146,65,65,0,23,0,0,0,empty,CD-0722-4
"F3,F5",11839,12876,9113,3763,6806,3194,0,3198,2062,1136,1.815140845,1763,2731,754,288,285,3,59,2,0.073684211,0,empty,CD-0722-4
"F3,F6",17103,19453,12504,6949,10408,5556,3,5567,3996,1571,2.543602801,3299,3984,939,378,371,7,97,3,0.045822102,0,empty,CD-0722-4
"F3,F7",13050,14723,9739,4984,7937,3943,0,3951,2661,1290,2.062790698,2265,1442,329,126,124,2,32,1,0,0,empty,CD-0722-4
"F3,F8",10339,11852,7677,4175,6332,3248,1,3254,2234,1020,2.190196078,1924,184,21,11,11,0,8,0,0,0,empty,CD-0722-4
"F3,F9",11740,12787,8965,3822,6835,3326,1,3341,2371,970,2.444329897,1841,4435,1013,425,422,3,107,1,0.037914692,0,empty,CD-0722-4
"F3,F10",14105,15315,10666,4649,8167,3921,0,3925,2636,1289,2.044996121,2146,1912,477,200,199,1,68,1,0.025125628,0,empty,CD-0722-4
"F3,F11",10571,11333,8088,3245,5950,2793,14,2807,1954,853,2.29073857,1499,1840,441,177,176,1,33,1,0.119318182,0,empty,CD-0722-4
"F3,F12",11580,12936,8577,4359,6827,3402,0,3406,2314,1092,2.119047619,1977,203,40,22,21,1,6,1,0,0,empty,CD-0722-4
"F3,G1",13042,14142,9724,4418,7578,3793,11,3808,2516,1292,1.947368421,2120,3489,1083,382,377,5,78,2,0.092838196,0,empty,CD-0722-4
"F3,G2",6638,7128,4756,2372,3803,1922,12,1936,1263,673,1.87667162,1107,371,91,42,42,0,17,0,0.166666667,0,empty,CD-0722-4
"F3,G3",14311,15408,10595,4813,8119,4119,2,4124,2642,1482,1.782726046,2289,2911,601,220,213,7,61,2,0.075117371,0,empty,CD-0722-4
"F3,G4",22322,25303,16041,9262,13199,7271,0,7281,4495,2786,1.613424264,4293,85,11,3,3,0,2,0,0,0,empty,CD-0722-4
"F3,G5",7600,8569,5690,2879,4486,2251,0,2251,1456,795,1.831446541,1307,2205,443,132,131,1,30,1,0.106870229,0,empty,CD-0722-4
"F3,G6",11888,12702,8906,3796,6647,3207,0,3210,2154,1056,2.039772727,1760,425,41,23,23,0,7,0,0,0,empty,CD-0722-4
"F3,G7",10339,11409,7874,3535,6127,2896,0,2898,1983,915,2.167213115,1653,3332,1079,351,348,3,79,2,0.051724138,0,empty,CD-0722-4
"F3,G8",7935,8507,5861,2646,4610,2274,18,2296,1574,722,2.180055402,1273,2648,594,245,244,1,55,1,0.06147541,0,empty,CD-0722-4
"F3,G9",9949,10719,7480,3239,5729,2776,0,2776,1917,859,2.231664726,1535,2962,804,360,358,2,90,1,0.047486034,0,empty,CD-0722-4
"F3,G10",11788,13126,8809,4317,7029,3556,0,3562,2385,1177,2.026338148,2064,3791,1058,387,377,10,87,2,0.031830239,0,empty,CD-0722-4
"F3,G11",11293,12420,8585,3835,6551,3160,0,3162,2178,984,2.213414634,1751,1636,242,103,101,2,34,2,0.01980198,0,empty,CD-0722-4
"F3,G12",7718,8969,5684,3285,4789,2505,0,2506,1620,886,1.828442438,1482,2348,571,208,207,1,60,1,0.033816425,0,empty,CD-0722-4
"F3,H1",11460,12861,8544,4317,6787,3379,0,3382,2380,1002,2.375249501,1985,1348,350,130,129,1,34,1,0.07751938,0,empty,CD-0722-4
"F3,H2",10320,11531,7399,4132,6123,3142,29,3172,1995,1177,1.694987256,1910,2938,772,264,264,0,63,0,0.075757576,0,empty,CD-0722-4
"F3,H3",9882,10997,7119,3878,5918,3118,5,3128,2120,1008,2.103174603,1846,2327,572,214,214,0,47,0,0.046728972,0,empty,CD-0722-4
"F3,H4",12255,13501,9153,4348,7000,3444,1,3452,2288,1164,1.965635739,1930,194,31,17,17,0,5,0,0,0,empty,CD-0722-4
"F3,H5",13171,14610,9617,4993,7711,3994,8,4005,2713,1292,2.099845201,2311,2640,803,280,277,3,53,2,0.028880866,0,empty,CD-0722-4
"F3,H6",9404,10812,6881,3931,5699,3010,0,3010,2116,894,2.36689038,1755,2755,649,250,250,0,67,0,0.116,0,empty,CD-0722-4
"F3,H7",9238,10195,6892,3303,5313,2636,4,2641,1723,918,1.876906318,1501,2418,621,208,203,5,51,2,0.192118227,0,empty,CD-0722-4
"F3,H8",14725,16319,10870,5449,8630,4451,4,4461,3052,1409,2.166075231,2523,3949,889,353,348,5,88,1,0.020114943,0,empty,CD-0722-4
"F3,H9",9241,10129,6987,3142,5278,2448,0,2450,1721,729,2.360768176,1346,1341,446,118,118,0,34,0,0.033898305,0,empty,CD-0722-4
"F3,H10",6891,7786,5166,2620,4047,2032,30,2062,1409,653,2.157733538,1132,1305,245,106,103,3,32,2,0.233009709,0,empty,CD-0722-4
"F3,H11",8508,9943,5893,4050,5117,3085,0,3089,1693,1396,1.212750716,1901,44,18,10,10,0,3,0,0,0,empty,CD-0722-4
"F3,H12",9397,10648,6946,3702,5536,2910,0,2914,2088,826,2.527845036,1663,2161,313,154,149,5,42,2,0.147651007,0,empty,CD-0722-4
"F4,A1",8110,9071,5988,3083,4749,2506,0,2506,1651,855,1.930994152,1409,1245,368,154,150,4,38,1,0.106666667,0,empty,CD-0722-4
"F4,A2",11529,12685,8343,4342,6777,3481,0,3486,2259,1227,1.841075795,1977,2126,484,226,220,6,59,2,0.090909091,0,empty,CD-0722-4
"F4,A3",17627,19662,12995,6667,9964,4919,0,4923,3698,1225,3.01877551,2853,2825,854,358,355,3,89,1,0.047887324,0,empty,CD-0722-4
"F4,A4",12501,13729,9296,4433,7187,3478,20,3500,2276,1224,1.859477124,2003,559,159,65,65,0,20,0,0,0,empty,CD-0722-4
"F4,A5",11551,12540,8477,4063,6777,3326,32,3359,2304,1055,2.183886256,1887,2159,348,152,152,0,50,0,0.039473684,0,empty,CD-0722-4
"F4,A6",9673,11100,7183,3917,5837,3087,0,3089,2009,1080,1.860185185,1762,2468,612,281,277,4,97,2,0.028880866,0,empty,CD-0722-4
"F4,A7",7580,8763,5500,3263,4540,2446,0,2450,1542,908,1.698237885,1440,1121,277,122,120,2,34,1,0.016666667,0,empty,CD-0722-4
"F4,A8",4941,5338,3705,1633,2877,1415,0,1417,1002,415,2.414457831,760,2323,413,175,172,3,51,3,0.127906977,0,empty,CD-0722-4
"F4,A9",8877,9537,6675,2862,5109,2460,1,2461,1685,776,2.171391753,1352,1743,406,169,168,1,47,1,0.101190476,0,empty,CD-0722-4
"F4,A10",9279,10156,7000,3156,5393,2701,1,2705,1775,930,1.908602151,1493,694,97,56,56,0,24,0,0,0,empty,CD-0722-4
"F4,A11",742582,853516,555347,298169,419733,225462,0,225643,177231,48412,3.660889862,130574,115395,19198,7295,7142,153,1164,5,0.056146738,0,hg38,CD-0722-4
"F4,A12",11079,12186,8309,3877,6356,3107,0,3107,2077,1030,2.016504854,1738,3307,878,318,317,1,92,1,0.03785489,0,empty,CD-0722-4
"F4,B1",8235,9359,5893,3466,4849,2499,0,2502,1585,917,1.728462377,1463,1045,100,50,49,1,21,1,0,0,empty,CD-0722-4
"F4,B2",10372,11255,7118,4137,5922,3258,0,3266,2124,1142,1.859894921,1897,596,135,61,61,0,19,0,0.016393443,0,empty,CD-0722-4
"F4,B3",7529,8209,5584,2625,4330,2207,0,2209,1523,686,2.220116618,1239,1671,338,129,126,3,41,1,0.071428571,0,empty,CD-0722-4
"F4,B4",7786,8779,5793,2986,4699,2438,0,2440,1611,829,1.943305187,1415,1251,366,120,119,1,37,1,0.067226891,0,empty,CD-0722-4
"F4,B5",9460,5449,3409,2040,3630,1940,1,1944,1333,611,2.181669394,1243,1030,195,98,95,3,24,1,0.2,0,empty,CD-0722-4
"F4,B6",10191,10974,7414,3560,5965,3063,0,3065,2083,982,2.121181263,1711,1553,463,191,189,2,50,1,0.153439153,0,empty,CD-0722-4
"F4,B7",9173,10176,6821,3355,5434,2714,1,2717,1778,939,1.893503727,1514,1262,223,106,106,0,31,0,0.113207547,0,empty,CD-0722-4
"F4,B8",7137,7714,5336,2378,4168,2003,0,2004,1391,613,2.269168026,1116,1239,253,128,128,0,43,0,0.0859375,0,empty,CD-0722-4
"F4,B9",12209,13491,8863,4628,7054,3683,0,3683,2363,1320,1.790151515,2131,700,209,92,92,0,39,0,0.032608696,0,empty,CD-0722-4
"F4,B10",6507,7169,4732,2437,4021,2004,0,2007,1337,670,1.995522388,1158,486,90,43,42,1,13,1,0,0,empty,CD-0722-4
"F4,B11",12560,14081,9014,5067,7233,3915,0,3919,2337,1582,1.477243995,2273,296,28,15,15,0,10,0,0,0,empty,CD-0722-4
"F4,B12",8292,9141,6028,3113,4816,2432,1,2439,1600,839,1.907032181,1427,2437,786,285,284,1,56,1,0.158450704,0,empty,CD-0722-4
"F4,C1",17144,18378,12775,5603,10087,4891,1,4895,3292,1603,2.053649407,2759,1177,279,134,132,2,35,2,0.234848485,0,empty,CD-0722-4
"F4,C2",12179,13344,8986,4358,6994,3505,0,3508,2351,1157,2.031979257,1955,1790,480,208,207,1,63,1,0.053140097,0,empty,CD-0722-4
"F4,C3",1154027,1351237,848719,502518,658411,366918,3,367177,289055,78122,3.700046082,220014,65444,9771,4012,3925,87,680,4,0.054267516,0,hg38,CD-0722-4
"F4,C4",8715,9355,6475,2880,5176,2484,32,2517,1692,825,2.050909091,1386,1963,463,169,163,6,43,2,0,0,empty,CD-0722-4
"F4,C5",11529,12975,8481,4494,6801,3487,0,3491,2269,1222,1.856792144,2086,1945,439,167,166,1,48,1,0.078313253,0,empty,CD-0722-4
"F4,C6",9429,10468,6828,3640,5620,2860,0,2871,1863,1008,1.848214286,1672,1563,323,131,128,3,37,1,0.1953125,0,empty,CD-0722-4
"F4,C7",13174,15056,9506,5550,7806,4254,2,4265,2616,1649,1.58641601,2545,440,95,49,48,1,17,1,0.020833333,0,empty,CD-0722-4
"F4,C8",14696,16183,10923,5260,8405,4212,0,4218,2747,1471,1.867437118,2388,3406,851,351,345,6,78,2,0.052173913,0,empty,CD-0722-4
"F4,C9",11652,13122,8688,4434,6876,3440,0,3445,2287,1158,1.974956822,1986,2590,590,203,199,4,46,2,0.070351759,0,empty,CD-0722-4
"F4,C10",11785,12526,8881,3645,6525,3049,0,3050,1904,1146,1.661431065,1632,2432,574,208,207,1,64,1,0.028985507,0,empty,CD-0722-4
"F4,C11",10880,11783,8063,3720,6358,3085,13,3103,2031,1072,1.894589552,1742,2143,456,181,181,0,50,0,0.055248619,0,empty,CD-0722-4
"F4,C12",14924,16089,11027,5062,8664,4284,0,4295,2934,1361,2.155767818,2372,1929,556,222,222,0,62,0,0.045045045,0,empty,CD-0722-4
"F4,D1",11930,13378,8672,4706,6963,3688,11,3704,2216,1488,1.489247312,2178,761,211,60,59,1,18,1,0.033898305,0,empty,CD-0722-4
"F4,D2",10482,11428,7899,3529,5981,2789,0,2790,1841,949,1.939936776,1549,2709,811,306,306,0,74,0,0.169934641,0,empty,CD-0722-4
"F4,D3",9743,10653,7100,3553,5613,2892,0,2900,1921,979,1.962206333,1588,1582,366,144,140,4,38,2,0.064285714,0,empty,CD-0722-4
"F4,D4",7133,7956,5255,2701,4230,2142,1,2150,1413,737,1.917232022,1252,1629,425,148,148,0,39,0,0.027027027,0,empty,CD-0722-4
"F4,D5",7712,8487,5771,2716,4513,2263,0,2267,1508,759,1.986824769,1297,1896,353,148,146,2,41,1,0.095890411,0,empty,CD-0722-4
"F4,D6",12020,12975,8713,4262,6693,3462,1,3463,2172,1291,1.682416731,1930,2451,562,205,205,0,50,0,0.165853659,0,empty,CD-0722-4
"F4,D7",7019,7455,5291,2164,3903,1846,11,1858,1231,627,1.963317384,1000,1820,449,165,161,4,48,2,0.080745342,0,empty,CD-0722-4
"F4,D8",802050,889598,600755,288843,437169,223387,17,223619,175550,48069,3.652041856,127960,44585,7909,2989,2929,60,587,2,0.021509047,0,hg38,CD-0722-4
"F4,D9",4444,4554,3300,1254,2582,1260,4,1265,880,385,2.285714286,665,2252,402,166,164,2,38,1,0.042682927,0,empty,CD-0722-4
"F4,D10",8382,9393,6103,3290,4966,2578,0,2586,1675,911,1.838638858,1529,883,304,118,117,1,29,1,0.290598291,0,empty,CD-0722-4
"F4,D11",8704,9474,6437,3037,4988,2430,0,2430,1596,834,1.913669065,1364,2729,662,260,256,4,66,2,0.0390625,0,empty,CD-0722-4
"F4,D12",13382,14598,9943,4655,7800,3867,0,3870,2649,1221,2.16953317,2235,3662,803,353,346,7,101,2,0.040462428,0,empty,CD-0722-4
"F4,E1",15885,17502,11805,5697,9101,4514,44,4560,2974,1586,1.875157629,2575,2444,540,222,218,4,78,2,0.077981651,0,empty,CD-0722-4
"F4,E2",10478,11385,7507,3878,6110,3143,1,3150,1940,1210,1.603305785,1808,2293,496,201,199,2,46,2,0.040201005,0,empty,CD-0722-4
"F4,E3",6976,7541,5269,2272,4023,1882,0,1882,1223,659,1.855842185,1026,2194,634,255,255,0,61,0,0.082352941,0,empty,CD-0722-4
"F4,E4",1044063,1172751,786554,386197,568229,291053,25,291311,227366,63945,3.555649386,168375,135465,17710,6936,6798,138,1149,5,0.054280671,0,hg38,CD-0722-4
"F4,E5",10695,11527,7975,3552,6063,2966,2,2968,1856,1112,1.669064748,1651,1250,313,112,112,0,26,0,0.125,0,empty,CD-0722-4
"F4,E6",17820,19467,13408,6059,9912,4885,9,4898,3239,1659,1.952380952,2753,4577,1105,395,394,1,94,1,0.081218274,0,empty,CD-0722-4
"F4,E7",14801,16034,11091,4943,8677,4327,0,4327,2868,1459,1.965729952,2416,3963,924,319,313,6,95,2,0.060702875,0,empty,CD-0722-4
"F4,E8",2230697,2431100,1743049,688051,1138687,545016,1,545525,424257,121268,3.498507438,297141,245145,38925,15013,14735,278,2091,8,0.031896844,0,hg38,CD-0722-4
"F4,E9",6980,7738,5161,2577,4028,2040,0,2042,1414,628,2.251592357,1146,2791,729,307,304,3,68,2,0.125,0,empty,CD-0722-4
"F4,E10",1087894,1247567,810180,437387,605843,324913,3,325261,256001,69260,3.696231591,191503,162975,21023,8270,8117,153,1295,7,0.073549341,0,hg38,CD-0722-4
"F4,E11",9793,10796,7360,3436,5597,2839,2,2846,1889,957,1.973876698,1564,1769,392,139,139,0,44,0,0.237410072,0,empty,CD-0722-4
"F4,E12",11232,12795,8215,4580,6719,3397,0,3399,2264,1135,1.994713656,1989,1769,280,148,146,2,47,2,0.061643836,0,empty,CD-0722-4
"F4,F1",13121,14178,9545,4633,7454,3701,1,3706,2394,1312,1.824695122,2095,2526,544,221,217,4,59,2,0.055299539,0,empty,CD-0722-4
"F4,F2",10603,11805,7838,3967,6197,3105,0,3107,2069,1038,1.993256262,1798,3708,962,394,391,3,90,2,0.140664962,0,empty,CD-0722-4
"F4,F3",10260,11327,7450,3877,6132,3154,17,3177,2136,1041,2.051873199,1832,3012,664,302,300,2,77,1,0.036666667,0,empty,CD-0722-4
"F4,F4",14597,15625,10941,4684,8321,3953,13,3966,2651,1315,2.015969582,2182,1051,287,134,134,0,27,0,0.104477612,0,empty,CD-0722-4
"F4,F5",710859,781613,535938,245675,383219,191840,0,192022,150512,41510,3.625921465,108221,125893,13158,5282,5133,149,927,10,0.054159361,0,hg38,CD-0722-4
"F4,F6",13597,15414,9923,5491,8382,4418,1,4420,3066,1354,2.264401773,2651,3224,646,252,252,0,76,0,0.047619048,0,empty,CD-0722-4
"F4,F7",15518,16976,11380,5596,9112,4521,0,4530,3052,1478,2.064952639,2603,1229,242,119,114,5,42,1,0.122807018,0,empty,CD-0722-4
"F4,F8",9726,10753,7320,3433,5635,2728,0,2730,1851,879,2.105802048,1543,174,16,14,14,0,10,0,0.071428571,0,empty,CD-0722-4
"F4,F9",10976,11907,8210,3697,6531,3269,7,3281,2228,1053,2.115859449,1826,2505,516,216,215,1,66,1,0.037209302,0,empty,CD-0722-4
"F4,F10",1286308,1472613,953863,518750,713256,387132,3,387495,312031,75464,4.134832503,225321,163485,27589,10798,10606,192,1651,9,0.055063172,0,hg38,CD-0722-4
"F4,F11",9579,10393,7184,3209,5528,2602,0,2609,1762,847,2.080283353,1509,1581,409,212,211,1,43,1,0.09478673,0,empty,CD-0722-4
"F4,F12",12287,12732,8841,3891,6831,3354,0,3358,2225,1133,1.963812886,1820,387,69,32,32,0,9,0,0,0,empty,CD-0722-4
"F4,G1",18830,20913,14241,6672,10731,5331,0,5335,3739,1596,2.34273183,2998,3045,695,267,254,13,80,2,0.070866142,0,empty,CD-0722-4
"F4,G2",17361,19017,12281,6736,9487,5085,32,5121,3543,1578,2.245247148,2926,1204,290,106,104,2,38,1,0.25,0,empty,CD-0722-4
"F4,G3",15311,16368,11465,4903,8636,4228,4,4238,2691,1547,1.739495798,2289,4222,746,322,313,9,82,2,0.130990415,0,empty,CD-0722-4
"F4,G4",22369,25057,15833,9224,13025,7242,20,7268,4524,2744,1.648688047,4249,58,13,8,8,0,4,0,0,0,empty,CD-0722-4
"F4,G5",8141,8934,5975,2959,4855,2474,0,2476,1609,867,1.855824683,1413,1751,427,162,160,2,39,1,0.04375,0,empty,CD-0722-4
"F4,G6",12023,13019,9072,3947,6712,3194,39,3237,2212,1025,2.15804878,1805,293,42,16,16,0,3,0,0,0,empty,CD-0722-4
"F4,G7",10173,10890,7757,3133,5663,2626,2,2630,1746,884,1.975113122,1404,6785,1259,493,487,6,129,2,0.104722793,0,empty,CD-0722-4
"F4,G8",6674,7144,4954,2190,3967,1994,0,1999,1313,686,1.913994169,1136,1723,340,157,156,1,44,1,0.185897436,0,empty,CD-0722-4
"F4,G9",937948,1104360,677584,426776,536940,305577,0,305873,251538,54335,4.629391736,184387,334857,48346,18984,18575,409,2450,9,0.079946164,0,hg38,CD-0722-4
"F4,G10",10849,12050,8092,3958,6330,3219,0,3227,2166,1061,2.041470311,1810,2259,530,214,209,5,66,1,0.119617225,0,empty,CD-0722-4
"F4,G11",10661,11598,7901,3697,6275,3068,0,3070,2086,984,2.119918699,1699,1541,285,126,123,3,39,2,0.06504065,0,empty,CD-0722-4
"F4,G12",7986,8730,5816,2914,4552,2294,0,2294,1527,767,1.990873533,1311,1795,542,211,208,3,58,2,0.100961538,0,empty,CD-0722-4
"F4,H1",9751,10563,7101,3462,5753,2842,0,2846,1969,877,2.245153934,1665,1721,313,122,120,2,45,2,0.008333333,0,empty,CD-0722-4
"F4,H2",9370,10308,6890,3418,5379,2734,7,2741,1776,965,1.840414508,1555,2093,707,228,228,0,53,0,0.083333333,0,empty,CD-0722-4
"F4,H3",8823,9655,6399,3256,5249,2744,0,2744,1841,903,2.03875969,1611,1621,306,139,129,10,43,2,0.209302326,0,empty,CD-0722-4
"F4,H4",12045,13573,8895,4678,7030,3492,1,3496,2326,1170,1.988034188,2053,211,42,22,22,0,8,0,0.090909091,0,empty,CD-0722-4
"F4,H5",1450412,1744963,1017914,727049,844008,538824,2,539215,378315,160900,2.351243008,327609,13706,1596,589,575,14,96,2,0.405217391,0,hg38,CD-0722-4
"F4,H6",664052,729839,506061,223778,359203,177801,1,177955,140707,37248,3.77757195,100307,65533,12659,4497,4442,55,816,3,0.025664115,0,hg38,CD-0722-4
"F4,H7",8758,9323,6470,2853,4920,2313,0,2317,1566,751,2.085219707,1297,2205,569,236,232,4,61,1,0.034482759,0,empty,CD-0722-4
"F4,H8",12158,13302,8764,4538,7156,3740,4,3749,2667,1082,2.464879852,2149,2352,569,205,201,4,64,2,0.104477612,0,empty,CD-0722-4
"F4,H9",8388,9026,6386,2640,4617,2122,0,2122,1432,690,2.075362319,1147,1146,223,94,93,1,31,1,0.010752688,0,empty,CD-0722-4
"F4,H10",6711,7380,4995,2385,3858,1942,0,1945,1303,642,2.029595016,1108,1099,161,79,79,0,28,0,0.17721519,0,empty,CD-0722-4
"F4,H11",7797,8774,5447,3327,4605,2697,0,2701,1520,1181,1.287044877,1593,20,1,0,0,0,0,0,0,0,empty,CD-0722-4
"F4,H12",8033,8941,5904,3037,4720,2457,0,2457,1637,820,1.996341463,1441,2024,289,132,130,2,35,1,0.015384615,0,empty,CD-0722-4
"F5,A1",8073,8800,5813,2987,4757,2460,0,2462,1608,854,1.882903981,1364,2005,510,205,205,0,54,0,0.097560976,0,empty,CD-0722-4
"F5,A2",11057,11833,8042,3791,6153,3047,13,3061,2007,1054,1.904174573,1726,2790,625,255,253,2,78,1,0.007905138,0,empty,CD-0722-4
"F5,A3",8758,9421,6562,2859,4953,2446,0,2448,1717,731,2.348837209,1374,2558,555,220,220,0,65,0,0.209090909,0,empty,CD-0722-4
"F5,A4",1425863,1665951,1057770,608181,798311,443523,4,443889,366514,77375,4.736852989,260435,83043,12498,4798,4734,64,838,6,0.090621039,0,hg38,CD-0722-4
"F5,A5",10979,11931,8114,3817,6325,3135,1,3138,2121,1017,2.085545723,1776,3664,939,372,368,4,102,3,0.04076087,0,empty,CD-0722-4
"F5,A6",9549,10990,6991,3999,5863,3096,0,3099,2141,958,2.234864301,1840,4433,1015,384,378,6,109,3,0.08994709,0,empty,CD-0722-4
"F5,A7",6936,7787,4967,2820,4126,2209,1,2214,1429,785,1.820382166,1288,1884,559,204,201,3,54,2,0.024875622,0,empty,CD-0722-4
"F5,A8",5030,5319,3723,1596,2900,1444,2,1447,1034,413,2.503631961,787,2736,800,295,291,4,93,2,0.024054983,0,empty,CD-0722-4
"F5,A9",635138,677329,499579,177750,335600,150905,1,151041,113665,37376,3.041122646,79915,31770,3537,1306,1274,32,338,4,0.033751962,0,hg38,CD-0722-4
"F5,A10",9314,9902,7205,2697,5257,2506,0,2506,1680,826,2.033898305,1336,466,95,44,44,0,22,0,0.113636364,0,empty,CD-0722-4
"F5,A11",6535,7259,4963,2296,3835,1841,16,1857,1200,657,1.826484018,1023,3169,751,301,301,0,79,0,0.003322259,0,empty,CD-0722-4
"F5,A12",10638,11512,7908,3604,6192,2999,1,3012,2057,955,2.153926702,1682,16508,4464,1690,1665,25,356,2,0.025825826,0,empty,CD-0722-4
"F5,B1",7926,8622,5857,2765,4488,2295,0,2296,1484,812,1.827586207,1287,2163,493,176,175,1,39,1,0.085714286,0,empty,CD-0722-4
"F5,B2",8239,8896,5655,3241,4815,2597,0,2599,1649,950,1.735789474,1562,716,167,83,81,2,26,1,0.074074074,0,empty,CD-0722-4
"F5,B3",8860,9762,6455,3307,5249,2750,2,2758,1975,783,2.522349936,1598,1729,410,182,181,1,54,1,0.022099448,0,empty,CD-0722-4
"F5,B4",7898,8820,5641,3179,4640,2445,0,2447,1583,864,1.832175926,1405,2536,611,230,228,2,65,1,0.074561404,0,empty,CD-0722-4
"F5,B5",992489,577895,352101,225794,373530,201055,20,202196,158176,44020,3.593275784,129346,168983,24340,9195,8985,210,1378,5,0.06722315,0,hg38,CD-0722-4
"F5,B6",855079,963244,646042,317202,468640,237872,2,238088,188537,49551,3.804908075,136137,145809,18741,7343,7182,161,1298,6,0.047201337,0,hg38,CD-0722-4
"F5,B7",1288595,1507866,959120,548746,735725,405627,4,406048,323661,82387,3.928544552,239056,136717,26404,9959,9803,156,1524,5,0.069672549,0,hg38,CD-0722-4
"F5,B8",6908,7506,5209,2297,4060,1964,1,1972,1413,559,2.527728086,1086,2192,553,238,230,8,61,2,0.1,0,empty,CD-0722-4
"F5,B9",11188,12459,8297,4162,6422,3269,16,3287,2093,1194,1.752931323,1846,1504,373,112,111,1,42,1,0.036036036,0,empty,CD-0722-4
"F5,B10",684211,726575,483370,243205,382829,195364,9,195896,151375,44521,3.400080861,113643,68223,9514,3677,3588,89,641,4,0.054069119,0,hg38,CD-0722-4
"F5,B11",12206,13567,8708,4859,6997,3810,0,3812,2303,1509,1.526176276,2230,648,168,78,77,1,22,1,0.077922078,0,empty,CD-0722-4
"F5,B12",31703,35836,22781,13055,18180,9881,0,9890,7393,2497,2.960752903,5812,9826,2652,1023,1012,11,250,3,0.005928854,0,empty,CD-0722-4
"F5,C1",2103092,2311291,1593105,718186,1097562,560447,14,561026,461706,99320,4.648670963,314686,114097,19932,7466,7335,131,1265,6,0.032447171,0,hg38,CD-0722-4
"F5,C2",21195,23518,15691,7827,11900,6105,2,6119,4180,1939,2.155750387,3469,3647,1001,357,355,2,91,1,0.047887324,0,empty,CD-0722-4
"F5,C3",12376,13845,9064,4781,7347,3710,1,3716,2455,1261,1.946867565,2131,1195,182,67,59,8,21,2,0.06779661,0,empty,CD-0722-4
"F5,C4",7742,8511,5830,2681,4634,2246,2,2250,1493,757,1.972258917,1281,2422,464,173,171,2,56,2,0,0,empty,CD-0722-4
"F5,C5",876139,958548,670672,287876,469182,226185,1,226416,172818,53598,3.224336729,128483,51559,8410,3135,3081,54,562,3,0.024991886,0,hg38,CD-0722-4
"F5,C6",9550,10380,6963,3417,5702,2876,5,2884,1906,978,1.948875256,1615,2366,759,275,272,3,71,1,0.095588235,0,empty,CD-0722-4
"F5,C7",12948,14762,9299,5463,7666,4243,0,4248,2669,1579,1.690310323,2493,659,132,60,56,4,20,2,0.017857143,0,empty,CD-0722-4
"F5,C8",795481,937298,560600,376698,468345,294452,1,294663,190764,103899,1.83605232,175575,5122,1546,485,484,1,135,1,0.154958678,0,hg38,CD-0722-4
"F5,C9",10573,11759,7857,3902,6135,3041,0,3051,2063,988,2.08805668,1775,2297,504,236,236,0,65,0,0.110169492,0,empty,CD-0722-4
"F5,C10",11091,12336,8397,3939,6450,3139,0,3139,2135,1004,2.126494024,1748,3257,822,346,344,2,87,2,0.058139535,0,empty,CD-0722-4
"F5,C11",9285,9936,6934,3002,5332,2570,0,2580,1718,862,1.993039443,1420,3095,869,353,353,0,91,0,0.008498584,0,empty,CD-0722-4
"F5,C12",939555,1062605,687198,375407,517610,278951,2,279222,218837,60385,3.624029146,163983,138541,26250,10006,9862,144,1461,5,0.046035287,0,hg38,CD-0722-4
"F5,D1",43496,56566,26360,30206,29204,21312,12,21348,8932,12416,0.71939433,14054,2779,1012,234,230,4,66,2,0.013043478,0,empty,CD-0722-4
"F5,D2",9218,10199,6962,3237,5480,2611,2,2615,1652,963,1.715472482,1477,3670,1149,477,469,8,109,2,0.029850746,0,empty,CD-0722-4
"F5,D3",9198,10156,6735,3421,5294,2653,3,2657,1746,911,1.916575192,1512,2158,393,154,151,3,54,2,0.072847682,0,empty,CD-0722-4
"F5,D4",7645,8855,5526,3329,4745,2532,0,2533,1692,841,2.011890606,1528,2059,456,218,218,0,59,0,0.013761468,0,empty,CD-0722-4
"F5,D5",7515,8518,5527,2991,4423,2269,0,2273,1524,749,2.034712951,1340,2026,529,199,198,1,61,1,0.035353535,0,empty,CD-0722-4
"F5,D6",11338,12586,8037,4549,6345,3351,15,3371,2189,1182,1.851945854,1944,3059,536,203,196,7,70,2,0.015306122,0,empty,CD-0722-4
"F5,D7",6592,7024,4944,2080,3804,1793,0,1799,1172,627,1.869218501,1003,3199,781,304,299,5,83,2,0.066889632,0,empty,CD-0722-4
"F5,D8",989144,1137790,735535,402255,558029,297999,1,298271,237649,60622,3.920177493,176201,119386,18501,7104,6946,158,1073,6,0.024762453,0,hg38,CD-0722-4
"F5,D9",4276,4657,3165,1492,2473,1210,0,1210,802,408,1.965686275,696,2394,445,192,191,1,72,1,0.104712042,0,empty,CD-0722-4
"F5,D10",8275,9277,6092,3185,4879,2510,9,2521,1676,845,1.983431953,1453,1726,408,175,173,2,37,2,0.167630058,0,empty,CD-0722-4
"F5,D11",8601,9472,6336,3136,4867,2349,0,2349,1532,817,1.875152999,1339,5388,1477,512,508,4,126,1,0.013779528,0,empty,CD-0722-4
"F5,D12",2348656,2644464,1767114,877350,1247558,665403,9,666064,564219,101845,5.539977417,382743,585932,78354,30455,29844,611,3357,9,0.047982844,0,hg38,CD-0722-4
"F5,E1",15166,16796,11208,5588,8809,4402,36,4443,2880,1563,1.842610365,2577,4733,1190,452,445,7,118,2,0.076404494,0,empty,CD-0722-4
"F5,E2",10047,10978,7163,3815,5748,2913,12,2928,1800,1128,1.595744681,1703,2853,406,173,172,1,61,1,0.093023256,0,empty,CD-0722-4
"F5,E3",6684,7276,5042,2234,3837,1855,1,1859,1232,627,1.964912281,993,3244,712,284,283,1,85,1,0.038869258,0,empty,CD-0722-4
"F5,E4",10409,11353,7718,3635,6068,2983,2,2985,2014,971,2.07415036,1698,3390,610,256,251,5,84,2,0.011952191,0,empty,CD-0722-4
"F5,E5",8062,8861,6039,2822,4754,2255,0,2255,1485,770,1.928571429,1266,2152,547,209,207,2,62,2,0.014492754,0,empty,CD-0722-4
"F5,E6",15236,17050,11137,5913,8832,4504,0,4508,2978,1530,1.946405229,2597,5927,1854,688,681,7,141,3,0.165932452,0,empty,CD-0722-4
"F5,E7",14721,15897,10893,5004,8521,4261,1,4265,2917,1348,2.163946588,2406,3963,893,368,365,3,104,1,0.049315068,0,empty,CD-0722-4
"F5,E8",1840359,2148824,1389890,758934,1029458,583673,0,584189,469441,114748,4.091060411,336830,20143,6095,1918,1905,13,532,2,0.039370079,0,hg38,CD-0722-4
"F5,E9",7490,8109,5474,2635,4247,2100,0,2100,1473,627,2.349282297,1170,3234,769,330,330,0,90,0,0.072727273,0,empty,CD-0722-4
"F5,E10",7986,8712,5983,2729,4558,2264,1,2268,1513,755,2.00397351,1238,1905,421,168,167,1,51,1,0.071856287,0,empty,CD-0722-4
"F5,E11",9511,10255,7023,3232,5315,2640,1,2646,1771,875,2.024,1398,3736,989,412,407,5,106,1,0.085995086,0,empty,CD-0722-4
"F5,E12",11213,12651,8153,4498,6701,3460,0,3466,2328,1138,2.0456942,2133,5301,1122,442,437,5,130,2,0.011441648,0,empty,CD-0722-4
"F5,F1",1090912,1235152,814014,421138,599663,316691,9,317009,254827,62182,4.098083047,182786,269131,42678,16542,16264,278,2118,9,0.078025086,0,hg38,CD-0722-4
"F5,F2",9305,10135,6804,3331,5391,2676,13,2689,1727,962,1.795218295,1528,4678,985,405,402,3,104,1,0.099502488,0,empty,CD-0722-4
"F5,F3",1088447,1289156,791249,497907,630443,367019,0,367338,302070,65268,4.628148557,220678,58449,12906,4798,4740,58,965,3,0.100421941,0,hg38,CD-0722-4
"F5,F4",13738,15257,10170,5087,7921,3885,0,3888,2545,1343,1.895011169,2280,1180,360,161,161,0,33,0,0.074534161,0,empty,CD-0722-4
"F5,F5",10647,11431,8052,3379,5963,2834,2,2836,1873,963,1.944963655,1516,3432,754,306,303,3,88,1,0.02970297,0,empty,CD-0722-4
"F5,F6",13994,15906,10331,5575,8352,4358,1,4360,2989,1371,2.180160467,2534,5845,1226,454,446,8,125,2,0.098654709,0,empty,CD-0722-4
"F5,F7",1216691,1375764,920660,455104,678090,349749,1,350088,276503,73585,3.757600054,201306,91387,10650,4249,4150,99,763,3,0.052048193,0,hg38,CD-0722-4
"F5,F8",9183,10247,6864,3383,5332,2658,12,2671,1809,862,2.098607889,1500,568,67,36,36,0,14,0,0,0,empty,CD-0722-4
"F5,F9",10201,11057,7621,3436,5996,2915,0,2915,2037,878,2.320045558,1614,4494,899,390,384,6,102,2,0.125,0,empty,CD-0722-4
"F5,F10",12872,13988,9719,4269,7434,3534,0,3537,2407,1130,2.130088496,1935,2567,748,263,262,1,69,1,0.103053435,0,empty,CD-0722-4
"F5,F11",9384,9714,7076,2638,5090,2323,0,2325,1557,768,2.02734375,1179,3362,672,310,309,1,73,1,0.022653722,0,empty,CD-0722-4
"F5,F12",10558,11183,7766,3417,5899,2866,0,2870,1903,967,1.967942089,1640,870,193,73,73,0,21,0,0,0,empty,CD-0722-4
"F5,G1",1127925,1265344,853849,411495,617825,318616,2,318960,241799,77161,3.133694483,182406,200002,37208,14057,13832,225,1833,8,0.048944477,0,hg38,CD-0722-4
"F5,G2",1066460,1161288,797577,363711,567297,280698,4,280963,209192,71771,2.914714857,159787,51279,7096,2777,2746,31,527,3,0.061544064,0,hg38,CD-0722-4
"F5,G3",12959,13865,9543,4322,7283,3660,27,3688,2273,1415,1.606360424,1989,3350,709,304,299,5,91,3,0.026755853,0,empty,CD-0722-4
"F5,G4",21293,23631,15167,8464,12156,6770,0,6782,4183,2599,1.609465179,3894,160,5,4,4,0,4,0,0,0,empty,CD-0722-4
"F5,G5",7406,8215,5455,2760,4339,2238,0,2242,1449,793,1.827238335,1271,2486,682,266,265,1,55,1,0.045283019,0,empty,CD-0722-4
"F5,G6",11302,12118,8421,3697,6295,3037,0,3040,1940,1100,1.763636364,1640,335,89,40,40,0,18,0,0.35,0,empty,CD-0722-4
"F5,G7",10684,11505,8034,3471,6008,2861,18,2880,1926,954,2.018867925,1556,4482,1140,476,470,6,118,2,0.044680851,0,empty,CD-0722-4
"F5,G8",6936,7362,5108,2254,4038,1951,1,1954,1306,648,2.015432099,1101,3191,833,304,298,6,92,2,0.077181208,0,empty,CD-0722-4
"F5,G9",8699,9624,6503,3121,5141,2571,0,2572,1741,831,2.095066185,1497,3775,844,336,330,6,96,1,0.057575758,0,empty,CD-0722-4
"F5,G10",993044,1136089,742161,393928,560009,302100,7,302350,235641,66709,3.532371944,175239,248504,34265,13190,12895,295,1912,5,0.046297014,0,hg38,CD-0722-4
"F5,G11",10030,11127,7416,3711,5954,2990,0,2994,2082,912,2.282894737,1749,2314,667,268,262,6,69,2,0.091603053,0,empty,CD-0722-4
"F5,G12",7603,8452,5458,2994,4480,2346,0,2348,1520,828,1.835748792,1407,8698,2753,916,902,14,183,3,0.015521064,0,empty,CD-0722-4
"F5,H1",10050,10899,7391,3508,5747,2803,0,2805,1918,887,2.162344983,1583,2446,446,208,207,1,62,1,0.096618357,0,empty,CD-0722-4
"F5,H2",12019,13753,8596,5157,7105,3870,16,3893,2510,1383,1.814895155,2337,3222,765,284,282,2,70,1,0.138297872,0,empty,CD-0722-4
"F5,H3",8484,9289,6107,3182,5017,2613,0,2616,1743,873,1.996563574,1521,2758,582,239,235,4,66,2,0.072340426,0,empty,CD-0722-4
"F5,H4",11738,12570,8811,3759,6560,3168,2,3175,2079,1096,1.89689781,1774,275,12,9,9,0,5,0,0,0,empty,CD-0722-4
"F5,H5",12158,13148,8957,4191,6979,3506,0,3510,2306,1204,1.915282392,1971,3057,811,310,303,7,65,2,0.04290429,0,empty,CD-0722-4
"F5,H6",8749,9510,6369,3141,4983,2616,0,2617,1752,865,2.025433526,1441,3089,680,269,268,1,76,1,0.097014925,0,empty,CD-0722-4
"F5,H7",8355,8885,6152,2733,4756,2326,0,2330,1516,814,1.862407862,1313,3366,797,316,308,8,79,2,0.038961039,0,empty,CD-0722-4
"F5,H8",2666772,3080390,1975668,1104722,1451397,822175,5,822891,680042,142849,4.760565352,484484,463615,68025,26978,26373,605,3067,14,0.037841732,0,hg38,CD-0722-4
"F5,H9",953538,1151845,652560,499285,565144,374388,2,374698,257523,117175,2.197764028,226113,20017,2050,639,608,31,118,3,0.345394737,0,hg38,CD-0722-4
"F5,H10",6902,7674,4950,2724,4006,2048,22,2071,1383,688,2.010174419,1188,1910,519,198,198,0,52,0,0.03030303,0,empty,CD-0722-4
"F5,H11",7744,8640,5415,3225,4608,2710,14,2731,1559,1172,1.330204778,1587,66,7,6,6,0,4,0,0,0,empty,CD-0722-4
"F5,H12",7837,8590,5727,2863,4510,2349,0,2350,1604,746,2.150134048,1338,6138,1537,576,570,6,138,1,0.031578947,0,empty,CD-0722-4
"F6,A1",9219,10514,6798,3716,5465,2887,0,2888,2009,879,2.285551763,1634,2222,541,232,231,1,41,1,0.090909091,0,empty,CD-0722-4
"F6,A2",13718,15230,10331,4899,7936,3968,0,3969,2683,1286,2.086314152,2176,2342,586,239,238,1,56,1,0.138655462,0,empty,CD-0722-4
"F6,A3",8634,9718,6345,3373,5190,2614,21,2640,1796,844,2.127962085,1500,1780,337,147,137,10,39,3,0.153284672,0,empty,CD-0722-4
"F6,A4",12908,14045,9662,4383,7446,3669,2,3673,2360,1313,1.79741051,2051,1709,587,220,215,5,29,3,0.479069767,0,empty,CD-0722-4
"F6,A5",13533,15147,10065,5082,8305,4198,0,4201,2906,1295,2.244015444,2434,3810,851,308,302,6,72,2,0.013245033,0,empty,CD-0722-4
"F6,A6",12627,14734,9371,5363,7737,4084,19,4112,2809,1303,2.155794321,2477,3822,854,340,338,2,101,1,0.109467456,0,empty,CD-0722-4
"F6,A7",11406,12815,8576,4239,6882,3504,0,3507,2396,1111,2.156615662,2024,2737,306,127,127,0,42,0,0.039370079,0,empty,CD-0722-4
"F6,A8",6252,7041,4598,2443,3735,1874,0,1878,1362,516,2.639534884,1090,2265,523,226,219,7,62,2,0.077625571,0,empty,CD-0722-4
"F6,A9",11442,12660,8581,4079,6803,3395,1,3398,2380,1018,2.337917485,1948,2516,524,190,184,6,55,1,0.059782609,0,empty,CD-0722-4
"F6,A10",10627,11688,8080,3608,6315,3102,10,3114,2163,951,2.27444795,1718,670,161,74,74,0,17,0,0,0,empty,CD-0722-4
"F6,A11",7979,8535,6183,2352,4643,2180,0,2182,1449,733,1.97680764,1129,1862,598,254,251,3,62,2,0.03187251,0,empty,CD-0722-4
"F6,A12",14505,16100,11064,5036,8615,4183,12,4200,2983,1217,2.451109285,2358,7425,1829,691,683,8,153,2,0.073206442,0,empty,CD-0722-4
"F6,B1",8722,9445,6474,2971,5111,2533,0,2533,1664,869,1.914844649,1437,1580,377,170,170,0,49,0,0.158823529,0,empty,CD-0722-4
"F6,B2",9193,10156,6276,3880,5397,2925,23,2952,1910,1042,1.833013436,1783,856,220,84,84,0,19,0,0.05952381,0,empty,CD-0722-4
"F6,B3",9033,10223,6640,3583,5512,2905,2,2907,2032,875,2.322285714,1664,1996,494,207,205,2,47,2,0,0,empty,CD-0722-4
"F6,B4",9366,10608,6951,3657,5636,2928,10,2945,1958,987,1.98378926,1693,2088,471,154,154,0,43,0,0.071428571,0,empty,CD-0722-4
"F6,B5",2389145,1386113,829129,556984,891962,505465,29,508526,404211,104315,3.874907731,325916,183130,33282,12931,12733,198,1879,4,0.075316108,0,hg38,CD-0722-4
"F6,B6",1333164,1479528,1003570,475958,734490,384446,9,384788,321727,63061,5.101837903,218258,138010,22586,9034,8871,163,1463,7,0.03235261,0,hg38,CD-0722-4
"F6,B7",10190,11375,7767,3608,6109,3002,6,3013,2047,966,2.119047619,1694,1398,269,120,120,0,39,0,0.091666667,0,empty,CD-0722-4
"F6,B8",8863,10013,6819,3194,5185,2494,1,2501,1837,664,2.766566265,1375,1729,383,159,158,1,49,1,0.025316456,0,empty,CD-0722-4
"F6,B9",13459,14930,9970,4960,7826,4013,1,4016,2694,1322,2.037821483,2291,1197,402,179,176,3,36,1,0.102272727,0,empty,CD-0722-4
"F6,B10",8386,9089,6008,3081,5027,2554,11,2566,1737,829,2.095295537,1464,563,84,39,38,1,16,1,0.105263158,0,empty,CD-0722-4
"F6,B11",14184,15715,10439,5276,8201,4341,0,4346,2727,1619,1.68437307,2479,159,15,10,10,0,6,0,0,0,empty,CD-0722-4
"F6,B12",10269,11595,7660,3935,6190,3188,0,3188,2285,903,2.530454042,1862,2614,598,236,235,1,56,1,0.127659574,0,empty,CD-0722-4
"F6,C1",1365851,1532624,1037404,495220,739059,386223,2,386592,315290,71302,4.421895599,218655,125553,19758,7518,7368,150,1197,6,0.045602606,0,hg38,CD-0722-4
"F6,C2",13066,14342,9561,4781,7669,3959,1,3964,2648,1316,2.012158055,2267,3495,825,311,309,2,71,2,0.042071197,0,empty,CD-0722-4
"F6,C3",14564,16165,10983,5182,8682,4353,1,4359,2908,1451,2.004135079,2487,1736,579,191,190,1,38,1,0.036842105,0,empty,CD-0722-4
"F6,C4",869278,1012444,634343,378101,505129,284408,2,284653,228595,56058,4.077830105,168108,210471,42276,16515,16324,191,2218,7,0.066344033,0,hg38,CD-0722-4
"F6,C5",20915,22928,15865,7063,11758,5773,0,5777,4061,1716,2.366550117,3257,4034,849,290,289,1,70,1,0.031141869,0,empty,CD-0722-4
"F6,C6",10793,12240,7876,4364,6671,3592,0,3594,2420,1174,2.06132879,2138,3008,897,366,365,1,68,1,0.112328767,0,empty,CD-0722-4
"F6,C7",13968,15530,10145,5385,8240,4466,0,4469,2786,1683,1.655377302,2605,424,66,29,29,0,12,0,0.24137931,0,empty,CD-0722-4
"F6,C8",15946,17574,11791,5783,9363,4774,1,4777,3231,1546,2.089909444,2675,5006,1202,529,524,5,108,1,0.051526718,0,empty,CD-0722-4
"F6,C9",12826,14686,9478,5208,7829,4047,1,4051,2806,1245,2.253815261,2362,2515,631,260,258,2,53,2,0.112403101,0,empty,CD-0722-4
"F6,C10",12534,13740,9469,4271,7261,3534,1,3537,2397,1140,2.102631579,1941,3362,908,311,306,5,64,2,0.111111111,0,empty,CD-0722-4
"F6,C11",11360,12648,8297,4351,6863,3505,0,3506,2415,1091,2.213565536,1993,2460,503,219,216,3,74,2,0.064814815,0,empty,CD-0722-4
"F6,C12",18084,19650,13630,6020,10396,4962,0,4964,3527,1437,2.454418928,2786,3102,761,323,318,5,75,2,0.081761006,0,empty,CD-0722-4
"F6,D1",12475,13950,9175,4775,7584,3977,0,3978,2510,1468,1.709809264,2341,1049,271,104,96,8,23,1,0.072916667,0,empty,CD-0722-4
"F6,D2",10281,11242,7714,3528,5983,2873,0,2879,1858,1021,1.819784525,1645,3471,1090,374,370,4,100,2,0.010810811,0,empty,CD-0722-4
"F6,D3",12080,13405,8944,4461,7124,3600,22,3626,2535,1091,2.32355637,2078,2969,577,227,223,4,57,1,0.049327354,0,empty,CD-0722-4
"F6,D4",8651,9743,6474,3269,5242,2647,0,2647,1831,816,2.243872549,1519,2108,671,252,251,1,53,1,0.035856574,0,empty,CD-0722-4
"F6,D5",12047,13623,8994,4629,7151,3531,2,3541,2468,1073,2.300093197,2076,5328,769,260,256,4,59,2,0.08203125,0,empty,CD-0722-4
"F6,D6",12346,13736,8949,4787,7225,3900,0,3902,2438,1464,1.665300546,2262,2682,606,249,247,2,62,1,0.097165992,0,empty,CD-0722-4
"F6,D7",7826,8703,5857,2846,4548,2158,2,2170,1488,682,2.181818182,1236,2815,805,347,347,0,72,0,0.095100865,0,empty,CD-0722-4
"F6,D8",9112,10249,6840,3409,5431,2658,0,2661,1806,855,2.112280702,1526,2045,586,262,259,3,57,2,0.003861004,0,empty,CD-0722-4
"F6,D9",532094,609742,395134,214608,308546,169838,0,169960,128680,41280,3.117248062,99550,55684,11972,4400,4338,62,727,3,0.04956201,0,hg38,CD-0722-4
"F6,D10",9337,10418,6825,3593,5554,2902,1,2910,1947,963,2.021806854,1642,1400,261,116,114,2,26,2,0.166666667,0,empty,CD-0722-4
"F6,D11",9866,10805,7350,3455,5736,2720,34,2759,1800,959,1.876955162,1562,4433,1387,408,405,3,95,1,0.037037037,0,empty,CD-0722-4
"F6,D12",14238,15760,10659,5101,8348,4200,0,4205,2924,1281,2.282591725,2382,4229,1235,504,501,3,119,2,0.077844311,0,empty,CD-0722-4
"F6,E1",19699,21449,14834,6615,11264,5494,23,5523,3763,1760,2.138068182,3002,3984,931,376,372,4,102,2,0.043010753,0,empty,CD-0722-4
"F6,E2",849208,979159,630955,348204,484791,258751,3,259062,197637,61425,3.217533578,153708,239575,26912,10682,10379,303,1554,9,0.052220831,0,hg38,CD-0722-4
"F6,E3",7553,8105,5646,2459,4412,2088,0,2090,1393,697,1.99856528,1178,5348,1258,486,483,3,112,1,0.082815735,0,empty,CD-0722-4
"F6,E4",1150429,1367361,839059,528302,671328,386971,7,387269,301881,85388,3.535403101,233947,191377,27381,10523,10276,247,1644,8,0.03629817,0,hg38,CD-0722-4
"F6,E5",8629,9275,6580,2695,4941,2259,1,2265,1508,757,1.992073976,1232,1664,350,156,154,2,38,1,0.045454545,0,empty,CD-0722-4
"F6,E6",17538,19625,13061,6564,10400,5357,8,5370,3716,1654,2.246674728,3078,4780,1129,458,455,3,117,1,0.068131868,0,empty,CD-0722-4
"F6,E7",18758,21165,14059,7106,11213,5648,0,5653,3968,1685,2.354896142,3283,3598,921,360,359,1,97,1,0.097493036,0,empty,CD-0722-4
"F6,E8",14332,15817,10822,4995,8583,4191,17,4216,2910,1306,2.228177642,2395,4373,950,397,391,6,108,2,0.040920716,0,empty,CD-0722-4
"F6,E9",9036,10247,6555,3692,5426,2911,0,2913,2044,869,2.352128884,1685,3075,691,246,245,1,70,1,0.085714286,0,empty,CD-0722-4
"F6,E10",9457,10421,6886,3535,5591,2817,0,2817,1952,865,2.256647399,1637,1846,531,166,165,1,46,1,0.084848485,0,empty,CD-0722-4
"F6,E11",11543,12851,8710,4141,6812,3361,8,3373,2304,1069,2.155285313,1886,3131,750,288,285,3,70,3,0.101754386,0,empty,CD-0722-4
"F6,E12",14829,16736,10999,5737,8894,4544,22,4571,3280,1291,2.54066615,2657,2852,568,224,221,3,60,2,0.07239819,0,empty,CD-0722-4
"F6,F1",650694,772463,444994,327469,390784,254736,10,254928,166989,87939,1.898918569,153343,4632,1453,498,494,4,111,2,0.194331984,0,hg38,CD-0722-4
"F6,F2",10776,11812,8180,3632,6275,3014,48,3066,2027,1039,1.950914341,1696,3831,802,325,324,1,88,1,0.030864198,0,empty,CD-0722-4
"F6,F3",11839,13469,8788,4681,7061,3647,1,3652,2525,1127,2.240461402,2167,4897,1070,423,419,4,112,3,0.038186158,0,empty,CD-0722-4
"F6,F4",15241,16595,11387,5208,8856,4350,7,4360,2938,1422,2.066104079,2390,1020,117,46,42,4,18,3,0.19047619,0,empty,CD-0722-4
"F6,F5",12356,13282,9363,3919,7086,3310,0,3313,2204,1109,1.987376014,1786,3307,756,284,282,2,71,1,0.085106383,0,empty,CD-0722-4
"F6,F6",19388,22296,14355,7941,11756,6208,12,6225,4455,1770,2.516949153,3581,4436,897,349,340,9,91,3,0.026470588,0,empty,CD-0722-4
"F6,F7",1175148,1378244,858181,520063,685748,388367,2,388647,306761,81886,3.746195931,233048,33315,7014,2699,2664,35,549,4,0.036786787,0,hg38,CD-0722-4
"F6,F8",11665,13076,8880,4196,6931,3398,0,3398,2417,981,2.463812436,1960,287,41,33,32,1,16,1,0.09375,0,empty,CD-0722-4
"F6,F9",736078,876931,503382,373549,441100,288716,0,288952,217699,71253,3.055295917,173045,10364,1568,553,537,16,119,3,0.109869646,0,hg38,CD-0722-4
"F6,F10",16669,18016,12590,5426,9683,4695,0,4698,3209,1489,2.155137676,2571,3512,792,267,262,5,71,1,0.049618321,0,empty,CD-0722-4
"F6,F11",11143,11908,8568,3340,6170,2789,19,2812,1930,882,2.188208617,1481,2242,359,175,174,1,39,1,0.063218391,0,empty,CD-0722-4
"F6,F12",12246,13304,9018,4286,7122,3424,0,3429,2300,1129,2.037201063,1912,134,43,18,18,0,9,0,0.055555556,0,empty,CD-0722-4
"F6,G1",14027,15377,10630,4747,8208,4097,4,4103,2714,1389,1.953923686,2287,3733,876,371,363,8,87,2,0.104683196,0,empty,CD-0722-4
"F6,G2",6943,7818,4853,2965,4109,2208,0,2210,1430,780,1.833333333,1332,376,115,52,52,0,13,0,0.096153846,0,empty,CD-0722-4
"F6,G3",13728,14748,10226,4522,7851,3909,0,3910,2549,1361,1.872887583,2105,3670,764,287,285,2,78,1,0.007017544,0,empty,CD-0722-4
"F6,G4",24219,27306,17430,9876,14272,7889,0,7892,4995,2897,1.724197446,4617,118,11,7,7,0,6,0,0,0,empty,CD-0722-4
"F6,G5",8224,9069,6043,3026,4823,2400,13,2418,1584,834,1.899280576,1415,2390,527,155,148,7,45,1,0.033783784,0,empty,CD-0722-4
"F6,G6",12593,13953,9438,4515,7344,3621,32,3657,2499,1158,2.158031088,2078,251,68,17,17,0,5,0,0,0,empty,CD-0722-4
"F6,G7",11011,11947,8353,3594,6425,2987,0,2990,2089,901,2.318534961,1625,4233,879,323,321,2,92,1,0.087227414,0,empty,CD-0722-4
"F6,G8",8420,9286,6203,3083,4972,2523,0,2527,1724,803,2.146948941,1447,2646,588,251,246,5,79,2,0.040650407,0,empty,CD-0722-4
"F6,G9",11041,12130,8114,4016,6607,3375,13,3391,2343,1048,2.235687023,1919,3231,682,290,286,4,94,2,0.017482517,0,empty,CD-0722-4
"F6,G10",13232,14364,10005,4359,7688,3881,0,3881,2637,1244,2.11977492,2092,4245,1104,398,396,2,104,1,0.047979798,0,empty,CD-0722-4
"F6,G11",953437,1043118,736035,307083,512833,248173,5,248433,187140,61293,3.053203465,137901,157714,24786,9442,9254,188,1382,7,0.062135293,0,hg38,CD-0722-4
"F6,G12",8165,9008,5944,3064,4847,2532,0,2536,1617,919,1.759521219,1499,3111,800,327,318,9,81,2,0.056603774,0,empty,CD-0722-4
"F6,H1",12157,13462,9135,4327,7193,3562,20,3590,2494,1096,2.275547445,2010,1865,492,189,189,0,47,0,0.010582011,0,empty,CD-0722-4
"F6,H2",10397,11488,7652,3836,6221,3241,0,3243,2127,1116,1.905913978,1871,3357,758,264,262,2,76,1,0.152671756,0,empty,CD-0722-4
"F6,H3",10842,12320,7936,4384,6682,3551,0,3551,2454,1097,2.237010027,2114,2328,528,219,218,1,57,1,0.082568807,0,empty,CD-0722-4
"F6,H4",13555,14591,10111,4480,7599,3635,1,3645,2470,1175,2.10212766,1996,193,7,7,7,0,5,0,0,0,empty,CD-0722-4
"F6,H5",14310,15800,10390,5410,8369,4228,10,4242,2855,1387,2.058399423,2494,2585,669,289,287,2,60,1,0.069686411,0,empty,CD-0722-4
"F6,H6",11493,12548,8299,4249,6709,3475,14,3490,2446,1044,2.342911877,2019,3145,718,274,271,3,68,1,0.099630996,0,empty,CD-0722-4
"F6,H7",9675,10448,7250,3198,5542,2729,1,2738,1848,890,2.076404494,1494,2493,523,200,199,1,56,1,0.095477387,0,empty,CD-0722-4
"F6,H8",15796,18085,11515,6570,9428,5051,0,5061,3556,1505,2.362790698,3018,3248,642,268,265,3,76,2,0.067924528,0,empty,CD-0722-4
"F6,H9",10489,11267,7994,3273,5839,2628,12,2642,1851,791,2.340075853,1450,1767,365,160,154,6,44,2,0.123376623,0,empty,CD-0722-4
"F6,H10",7453,8199,5581,2618,4333,2176,26,2202,1448,754,1.920424403,1253,1862,491,214,214,0,54,0,0.060747664,0,empty,CD-0722-4
"F6,H11",8372,9479,5866,3613,4923,2870,0,2874,1518,1356,1.119469027,1752,16,3,3,3,0,3,0,0,0,empty,CD-0722-4
"F6,H12",10083,11224,7331,3893,5880,3068,0,3068,2175,893,2.435610302,1742,1763,296,133,131,2,35,2,0.160305344,0,empty,CD-0722-4
"F7,A1",8538,9499,6287,3212,5050,2599,1,2601,1771,830,2.13373494,1451,1136,257,94,90,4,25,2,0.044444444,0,empty,CD-0722-4
"F7,A2",12851,14256,9426,4830,7490,3857,0,3861,2566,1295,1.981467181,2200,1781,457,173,172,1,40,1,0.098837209,0,empty,CD-0722-4
"F7,A3",8525,9364,6417,2947,4937,2523,0,2526,1485,1041,1.426512968,1404,1448,368,132,132,0,35,0,0.189393939,0,empty,CD-0722-4
"F7,A4",12327,13318,9229,4089,7075,3458,1,3467,2285,1182,1.933164129,1967,573,58,27,27,0,9,0,0,0,empty,CD-0722-4
"F7,A5",13108,14730,9712,5018,7749,3867,0,3868,2707,1161,2.33161068,2232,2233,442,166,162,4,34,2,0.148148148,0,empty,CD-0722-4
"F7,A6",357744,443960,249769,194191,223294,142209,2,142314,109075,33239,3.281536749,88354,21356,11126,3967,3953,14,774,2,0.005059449,0,hg38,CD-0722-4
"F7,A7",7916,9020,5739,3281,4783,2561,0,2562,1709,853,2.003516999,1529,1149,302,82,82,0,18,0,0.170731707,0,empty,CD-0722-4
"F7,A8",6072,6920,4466,2454,3603,1826,0,1826,1329,497,2.674044266,1052,1615,382,154,154,0,46,0,0.214285714,0,empty,CD-0722-4
"F7,A9",10208,11207,7688,3519,5922,3022,0,3026,2146,880,2.438636364,1661,1374,219,85,81,4,23,1,0.074074074,0,empty,CD-0722-4
"F7,A10",10608,11689,8021,3668,6036,2949,0,2951,2020,931,2.169709989,1669,275,92,38,37,1,10,1,0,0,empty,CD-0722-4
"F7,A11",675834,758779,515185,243594,373143,185852,2,186035,142804,43231,3.303277741,106297,68462,8083,3182,3109,73,592,4,0.053071727,0,hg38,CD-0722-4
"F7,A12",12874,13999,9893,4106,7269,3563,16,3586,2484,1102,2.254083485,1937,3009,684,250,248,2,55,1,0.157258065,0,empty,CD-0722-4
"F7,B1",9014,9856,6572,3284,5339,2749,1,2753,1907,846,2.254137116,1552,775,196,79,79,0,20,0,0,0,empty,CD-0722-4
"F7,B2",8677,9488,5829,3659,5022,2748,2,2757,1750,1007,1.737835154,1685,362,55,30,30,0,9,0,0,0,empty,CD-0722-4
"F7,B3",8344,9234,6136,3098,4935,2539,0,2544,1709,835,2.046706587,1489,1316,357,128,128,0,26,0,0.0703125,0,empty,CD-0722-4
"F7,B4",8604,9847,6379,3468,5128,2682,0,2684,1789,895,1.998882682,1564,1056,247,97,95,2,26,2,0.073684211,0,empty,CD-0722-4
"F7,B5",11982,7448,4747,2701,4790,2499,1,2516,1764,752,2.345744681,1537,945,166,63,61,2,25,2,0.049180328,0,empty,CD-0722-4
"F7,B6",10783,12062,7970,4092,6313,3348,0,3351,2265,1086,2.085635359,1918,1476,376,147,145,2,29,1,0.020689655,0,empty,CD-0722-4
"F7,B7",35026,40677,25790,14887,20469,11649,0,11658,7709,3949,1.952139782,6751,1295,229,80,79,1,28,1,0.113924051,0,empty,CD-0722-4
"F7,B8",8723,9790,6553,3237,5181,2602,1,2604,1841,763,2.412844037,1505,1042,344,118,118,0,26,0,0.161016949,0,empty,CD-0722-4
"F7,B9",13443,14768,10167,4601,7654,3882,0,3888,2598,1290,2.013953488,2125,862,294,104,104,0,26,0,0,0,empty,CD-0722-4
"F7,B10",7482,8085,5394,2691,4409,2235,0,2237,1554,683,2.275256223,1245,565,74,21,20,1,8,1,0.05,0,empty,CD-0722-4
"F7,B11",13604,15381,9901,5480,7825,4244,0,4246,2546,1700,1.497647059,2424,247,62,31,31,0,7,0,0.225806452,0,empty,CD-0722-4
"F7,B12",9432,10522,7092,3430,5482,2856,0,2862,2003,859,2.331781141,1602,1274,277,118,117,1,37,1,0.05982906,0,empty,CD-0722-4
"F7,C1",16584,17641,12414,5227,9379,4514,17,4531,3108,1423,2.18411806,2450,954,257,98,94,4,24,1,0.308510638,0,empty,CD-0722-4
"F7,C2",12796,14154,9358,4796,7381,3824,11,3840,2573,1267,2.030781373,2183,1997,565,203,203,0,50,0,0.014778325,0,empty,CD-0722-4
"F7,C3",14075,15749,10256,5493,8351,4191,32,4229,2881,1348,2.137240356,2455,1188,125,64,63,1,19,1,0.095238095,0,empty,CD-0722-4
"F7,C4",9472,10345,7161,3184,5506,2697,0,2700,1833,867,2.114186851,1497,1554,271,102,101,1,26,1,0.118811881,0,empty,CD-0722-4
"F7,C5",13328,15263,9778,5485,7988,4200,0,4207,2767,1440,1.921527778,2464,1575,430,168,164,4,34,1,0.170731707,0,empty,CD-0722-4
"F7,C6",10579,11660,7574,4086,6347,3330,0,3334,2290,1044,2.19348659,1942,1034,196,80,80,0,28,0,0,0,empty,CD-0722-4
"F7,C7",14649,16539,10413,6126,9003,4997,0,4999,3178,1821,1.745194948,2935,307,49,22,21,1,7,1,0.476190476,0,empty,CD-0722-4
"F7,C8",18281,20163,13592,6571,10367,5229,2,5238,3629,1609,2.25543816,2930,3600,893,360,356,4,84,2,0.036516854,0,empty,CD-0722-4
"F7,C9",11696,13241,8521,4720,7167,3774,1,3780,2610,1170,2.230769231,2238,1263,411,132,132,0,19,0,0.090909091,0,empty,CD-0722-4
"F7,C10",12340,13976,9227,4749,7092,3478,13,3497,2342,1155,2.027705628,2036,1830,513,198,194,4,35,1,0.164948454,0,empty,CD-0722-4
"F7,C11",10364,11595,7594,4001,6249,3222,1,3227,2126,1101,1.930971844,1892,1403,278,114,112,2,31,1,0.017857143,0,empty,CD-0722-4
"F7,C12",1300565,1499032,963462,535570,723152,398288,6,398659,318075,80584,3.947123498,233661,82331,14282,5602,5514,88,973,3,0.067464635,0,hg38,CD-0722-4
"F7,D1",12119,13521,8875,4646,7063,3741,0,3743,2370,1373,1.726147123,2147,613,231,87,87,0,19,0,0.229885057,0,empty,CD-0722-4
"F7,D2",9869,10675,7571,3104,5617,2565,0,2568,1730,838,2.064439141,1394,2623,635,246,244,2,57,1,0.12295082,0,empty,CD-0722-4
"F7,D3",10081,11142,7388,3754,5883,3039,0,3045,2061,984,2.094512195,1705,1068,176,51,51,0,15,0,0.254901961,0,empty,CD-0722-4
"F7,D4",8440,9410,6143,3267,4935,2442,32,2476,1729,747,2.3145917,1455,1236,245,85,85,0,17,0,0.058823529,0,empty,CD-0722-4
"F7,D5",9016,9955,6736,3219,5219,2617,0,2626,1771,855,2.071345029,1434,1269,244,84,83,1,25,1,0.036144578,0,empty,CD-0722-4
"F7,D6",12345,14007,8864,5143,7171,3901,1,3906,2507,1399,1.791994282,2321,1479,352,156,156,0,39,0,0.044871795,0,empty,CD-0722-4
"F7,D7",7199,8092,5378,2714,4152,2036,0,2037,1359,678,2.004424779,1134,1669,571,178,176,2,43,2,0.0625,0,empty,CD-0722-4
"F7,D8",8848,9836,6594,3242,5347,2757,0,2761,1819,942,1.930997877,1595,1047,296,105,103,2,32,1,0,0,empty,CD-0722-4
"F7,D9",4677,5138,3546,1592,2729,1284,6,1290,900,390,2.307692308,718,1144,372,144,143,1,35,1,0.020979021,0,empty,CD-0722-4
"F7,D10",10315,11523,7553,3970,6156,3174,0,3175,2150,1025,2.097560976,1890,1176,154,71,64,7,23,2,0.046875,0,empty,CD-0722-4
"F7,D11",10259,11181,7709,3472,5751,2783,15,2800,1883,917,2.053435115,1542,3033,719,292,290,2,67,1,0.062068966,0,empty,CD-0722-4
"F7,D12",14997,16598,11196,5402,8660,4364,18,4382,2996,1386,2.161616162,2463,3674,842,285,284,1,64,1,0.063380282,0,empty,CD-0722-4
"F7,E1",18356,20375,13594,6781,10630,5434,0,5434,3718,1716,2.166666667,3092,2653,505,160,158,2,50,1,0.037974684,0,empty,CD-0722-4
"F7,E2",10858,11700,8080,3620,6267,3094,0,3104,2093,1011,2.070227498,1722,1850,395,150,149,1,32,1,0.134228188,0,empty,CD-0722-4
"F7,E3",7008,7867,5159,2708,4064,1974,0,1979,1291,688,1.876453488,1131,2259,615,221,215,6,50,2,0.013953488,0,empty,CD-0722-4
"F7,E4",972254,1121614,723845,397769,546288,293948,4,294188,239687,54501,4.397845911,172372,150745,24787,9415,9287,128,1422,5,0.059437924,0,hg38,CD-0722-4
"F7,E5",8396,8995,6459,2536,4811,2215,0,2215,1435,780,1.83974359,1178,949,277,104,103,1,24,1,0.145631068,0,empty,CD-0722-4
"F7,E6",16521,18220,12463,5757,9456,4759,0,4766,3224,1542,2.09079118,2631,2904,684,212,211,1,56,1,0.009478673,0,empty,CD-0722-4
"F7,E7",18129,20104,13590,6514,10464,5280,0,5280,3680,1600,2.3,2972,2275,525,211,209,2,56,1,0.086124402,0,empty,CD-0722-4
"F7,E8",13260,14655,10148,4507,7730,3673,1,3679,2537,1142,2.221541156,2055,2095,510,182,182,0,58,0,0.093406593,0,empty,CD-0722-4
"F7,E9",8842,9741,6401,3340,5242,2744,5,2749,1904,845,2.253254438,1591,1850,549,190,188,2,38,2,0.026595745,0,empty,CD-0722-4
"F7,E10",9105,10108,6812,3296,5234,2556,1,2561,1702,859,1.98137369,1440,1699,460,174,174,0,42,0,0.08045977,0,empty,CD-0722-4
"F7,E11",10226,11213,7669,3544,5820,2930,6,2939,1934,1005,1.924378109,1589,1674,322,131,130,1,42,1,0.015384615,0,empty,CD-0722-4
"F7,E12",12942,14376,9586,4790,7585,3869,0,3876,2684,1192,2.251677852,2197,2013,370,145,142,3,37,2,0.161971831,0,empty,CD-0722-4
"F7,F1",16594,17734,12446,5288,9119,4425,1,4433,2953,1480,1.99527027,2447,3860,780,279,276,3,56,2,0.06884058,0,empty,CD-0722-4
"F7,F2",10358,11551,7460,4091,6068,3075,11,3090,2063,1027,2.008763389,1845,2529,643,259,257,2,76,1,0.027237354,0,empty,CD-0722-4
"F7,F3",10950,12412,8086,4326,6538,3328,0,3329,2288,1041,2.197886647,1992,2019,361,149,146,3,49,1,0.068493151,0,empty,CD-0722-4
"F7,F4",2442565,2907353,1754537,1152816,1410098,891035,15,891763,621806,269957,2.303352015,532397,10164,489,170,157,13,42,2,0.089171975,0,hg38,CD-0722-4
"F7,F5",12050,13019,8939,4080,6763,3120,50,3176,2134,1042,2.047984645,1843,1856,575,224,224,0,48,0,0.066964286,0,empty,CD-0722-4
"F7,F6",17396,19446,13071,6375,10157,5219,1,5223,3746,1477,2.536222072,2983,2748,547,227,225,2,53,2,0.16,0,empty,CD-0722-4
"F7,F7",14240,15557,10472,5085,8349,4184,62,4249,2979,1270,2.345669291,2381,912,114,54,54,0,23,0,0.314814815,0,empty,CD-0722-4
"F7,F8",10038,11404,7488,3916,6011,3032,1,3038,2156,882,2.444444444,1767,157,11,8,7,1,4,1,0,0,empty,CD-0722-4
"F7,F9",11368,12276,8503,3773,6459,3184,0,3185,2209,976,2.263319672,1743,2150,456,183,181,2,50,1,0,0,empty,CD-0722-4
"F7,F10",15022,16226,11119,5107,8787,4244,1,4248,2963,1285,2.305836576,2364,1586,369,105,105,0,28,0,0.019047619,0,empty,CD-0722-4
"F7,F11",10666,11361,8127,3234,6024,2787,0,2794,1957,837,2.338112306,1517,1520,292,135,135,0,32,0,0.088888889,0,empty,CD-0722-4
"F7,F12",885483,1008222,648211,360011,486788,267180,3,267415,212762,54653,3.892961045,156677,3662,565,215,212,3,51,2,0.070754717,0,hg38,CD-0722-4
"F7,G1",1030134,1250050,712041,538009,618223,408456,1,408742,264182,144560,1.827490315,247330,9943,1398,394,368,26,93,2,0.171195652,0,hg38,CD-0722-4
"F7,G2",6685,7087,4715,2372,3774,1984,0,1990,1274,716,1.779329609,1133,334,74,27,27,0,10,0,0,0,empty,CD-0722-4
"F7,G3",13219,14533,9843,4690,7553,3734,24,3766,2395,1371,1.746900073,2078,1924,648,236,236,0,46,0,0.008474576,0,empty,CD-0722-4
"F7,G4",22865,26040,16440,9600,13458,7451,0,7463,4618,2845,1.623198594,4397,48,13,3,3,0,3,0,0,0,empty,CD-0722-4
"F7,G5",7791,8541,5722,2819,4405,2183,13,2198,1434,764,1.876963351,1240,1656,450,188,187,1,49,1,0.042780749,0,empty,CD-0722-4
"F7,G6",12344,13267,9309,3958,6953,3303,0,3305,2221,1084,2.048892989,1787,81,11,8,7,1,6,1,0,0,empty,CD-0722-4
"F7,G7",10018,10916,7645,3271,5861,2819,0,2819,1915,904,2.118362832,1548,1430,286,130,128,2,45,1,0.0078125,0,empty,CD-0722-4
"F7,G8",8219,8943,6015,2928,4852,2394,27,2422,1673,749,2.23364486,1353,1663,418,176,174,2,40,1,0.074712644,0,empty,CD-0722-4
"F7,G9",10339,11816,7545,4271,6231,3261,2,3272,2248,1024,2.1953125,1959,2230,469,174,171,3,55,1,0.128654971,0,empty,CD-0722-4
"F7,G10",623991,729999,451631,278368,371244,217673,0,217841,169818,48023,3.53618058,130090,6050,1845,619,614,5,167,2,0.071661238,0,hg38,CD-0722-4
"F7,G11",11396,12485,8531,3954,6591,3190,0,3190,2217,973,2.278520041,1817,932,174,88,83,5,33,1,0,0,empty,CD-0722-4
"F7,G12",7600,8448,5588,2860,4488,2339,0,2345,1460,885,1.649717514,1369,1757,337,129,123,6,36,2,0.081300813,0,empty,CD-0722-4
"F7,H1",11681,13208,8583,4625,6940,3607,0,3610,2557,1053,2.428300095,2123,908,225,54,49,5,16,2,0.020408163,0,empty,CD-0722-4
"F7,H2",10175,11156,7462,3694,5981,3006,1,3007,2017,990,2.037373737,1778,2475,502,217,209,8,44,2,0.124401914,0,empty,CD-0722-4
"F7,H3",9960,11381,7185,4196,5892,3084,3,3095,2108,987,2.135764944,1836,1217,229,109,104,5,36,1,0.009615385,0,empty,CD-0722-4
"F7,H4",13497,15068,10215,4853,7796,3915,0,3917,2768,1149,2.409051349,2226,255,29,9,9,0,5,0,0,0,empty,CD-0722-4
"F7,H5",13467,15060,9756,5304,7816,4043,0,4045,2702,1343,2.011913626,2359,1877,573,251,242,9,38,2,0.148760331,0,empty,CD-0722-4
"F7,H6",9853,11325,7230,4095,5807,3064,14,3084,2011,1073,1.874184529,1789,2171,515,191,191,0,47,0,0.020942408,0,empty,CD-0722-4
"F7,H7",9632,10392,7127,3265,5594,2865,0,2866,1916,950,2.016842105,1590,1785,471,180,177,3,43,2,0.02259887,0,empty,CD-0722-4
"F7,H8",822366,926110,621274,304836,453263,229598,1,229805,175284,54521,3.214981383,133366,109984,15461,5881,5756,125,984,9,0.047255038,0,hg38,CD-0722-4
"F7,H9",9932,10794,7632,3162,5530,2578,14,2595,1790,805,2.223602484,1404,1731,327,115,115,0,28,0,0.113043478,0,empty,CD-0722-4
"F7,H10",7106,7996,5225,2771,4087,2070,0,2075,1419,656,2.163109756,1179,988,258,72,72,0,24,0,0.041666667,0,empty,CD-0722-4
"F7,H11",8019,9338,5596,3742,4840,2914,2,2918,1632,1286,1.269051322,1771,19,0,0,0,0,0,0,0,0,empty,CD-0722-4
"F7,H12",9518,10698,6942,3756,5508,2850,22,2876,1952,924,2.112554113,1679,1667,150,57,55,2,19,1,0.218181818,0,empty,CD-0722-4
"F8,A1",7575,8127,5481,2646,4216,2166,0,2168,1441,727,1.982118294,1222,2093,261,100,98,2,34,2,0.163265306,0,empty,CD-0722-4
"F8,A2",574347,627864,437730,190134,308269,148679,3,148837,115513,33324,3.466360581,82939,32423,6158,2426,2387,39,522,3,0.012568077,0,hg38,CD-0722-4
"F8,A3",6323,6983,4689,2294,3782,1925,0,1925,1199,726,1.651515152,1097,1792,359,145,142,3,39,1,0,0,empty,CD-0722-4
"F8,A4",3583720,4079600,2702567,1377033,1894000,1055456,14,1056393,764960,291433,2.624822858,609391,129427,19224,7442,7311,131,1232,8,0.042675421,0,hg38,CD-0722-4
"F8,A5",10088,10967,7495,3472,5816,2839,13,2854,1863,991,1.879919273,1557,2937,591,264,261,3,90,2,0.114942529,0,empty,CD-0722-4
"F8,A6",8330,9177,6216,2961,4816,2499,0,2499,1650,849,1.943462898,1399,3366,549,248,246,2,81,1,0.105691057,0,empty,CD-0722-4
"F8,A7",7176,7620,5267,2353,4025,2074,1,2078,1295,783,1.653895275,1101,1605,392,136,134,2,41,1,0.052238806,0,empty,CD-0722-4
"F8,A8",4584,5078,3420,1658,2693,1317,0,1317,948,369,2.569105691,735,1919,433,189,188,1,66,1,0.122340426,0,empty,CD-0722-4
"F8,A9",7485,8213,5652,2561,4356,2149,0,2150,1391,759,1.832674572,1185,2539,512,221,219,2,64,1,0.091324201,0,empty,CD-0722-4
"F8,A10",7824,8445,5903,2542,4446,2217,3,2220,1489,731,2.036935705,1212,589,35,22,22,0,17,0,0.045454545,0,empty,CD-0722-4
"F8,A11",6162,6728,4733,1995,3473,1617,0,1619,1027,592,1.734797297,868,1535,300,124,121,3,38,2,0.008264463,0,empty,CD-0722-4
"F8,A12",1475994,1616068,1118299,497769,777419,393494,7,393862,316550,77312,4.094448469,218535,247548,50445,18761,18518,243,2402,6,0.024732693,0,hg38,CD-0722-4
"F8,B1",7870,8750,5675,3075,4487,2330,1,2336,1464,872,1.678899083,1344,1491,350,138,134,4,40,2,0,0,empty,CD-0722-4
"F8,B2",8126,8718,5665,3053,4642,2455,0,2456,1504,952,1.579831933,1399,698,163,54,53,1,18,1,0.018867925,0,empty,CD-0722-4
"F8,B3",782936,890689,592926,297763,438502,224114,7,224312,173804,50508,3.441118239,130166,100537,14075,5332,5239,93,927,3,0.045237641,0,hg38,CD-0722-4
"F8,B4",12254,13712,9173,4539,7044,3584,0,3587,2464,1123,2.194122885,2054,1968,363,158,157,1,40,1,0.063694268,0,empty,CD-0722-4
"F8,B5",7780,4688,2949,1739,3114,1649,1,1658,1107,551,2.00907441,1024,1090,129,51,49,2,22,2,0.020408163,0,empty,CD-0722-4
"F8,B6",8548,9304,6296,3008,4943,2565,1,2567,1660,907,1.830209482,1442,2202,604,195,190,5,54,2,0.210526316,0,empty,CD-0722-4
"F8,B7",7959,8966,6044,2922,4704,2328,0,2332,1513,819,1.847374847,1328,1655,389,180,180,0,57,0,0.094444444,0,empty,CD-0722-4
"F8,B8",6804,7207,5046,2161,3774,1909,0,1909,1272,637,1.996860283,980,1872,498,195,194,1,51,1,0.118556701,0,empty,CD-0722-4
"F8,B9",933220,1049786,706787,342999,507449,257529,1,257772,198918,58854,3.379855235,147855,27950,4161,1557,1525,32,321,3,0.06295082,0,hg38,CD-0722-4
"F8,B10",5936,6594,4259,2335,3597,1813,1,1822,1218,604,2.016556291,1051,565,71,40,40,0,20,0,0.2,0,empty,CD-0722-4
"F8,B11",11610,12809,8410,4399,6637,3656,0,3658,2098,1560,1.344871795,2081,309,39,17,17,0,9,0,0.058823529,0,empty,CD-0722-4
"F8,B12",723453,816643,539099,277544,405286,211788,1,211976,161422,50554,3.193060885,123307,57168,10119,3857,3782,75,687,4,0.03622422,0,hg38,CD-0722-4
"F8,C1",14785,15805,11186,4619,8409,4108,0,4110,2605,1505,1.73089701,2196,1437,214,119,112,7,42,2,0.017857143,0,empty,CD-0722-4
"F8,C2",11431,12717,8374,4343,6622,3463,0,3463,2282,1181,1.932260796,2003,3626,775,322,317,5,73,2,0.025236593,0,empty,CD-0722-4
"F8,C3",12065,12916,9085,3831,6886,3417,1,3420,2283,1137,2.007915567,1843,1774,444,150,148,2,38,2,0.074324324,0,empty,CD-0722-4
"F8,C4",7640,8418,5735,2683,4409,2086,0,2088,1421,667,2.130434783,1222,2898,579,238,237,1,69,1,0.050632911,0,empty,CD-0722-4
"F8,C5",11689,13677,8563,5114,7085,3849,0,3850,2602,1248,2.084935897,2301,1757,427,188,188,0,54,0,0,0,empty,CD-0722-4
"F8,C6",9042,9822,6605,3217,5321,2673,0,2674,1807,867,2.084198385,1527,2376,517,215,210,5,57,2,0.080952381,0,empty,CD-0722-4
"F8,C7",11713,13464,8322,5142,6940,3825,0,3831,2300,1531,1.502286088,2315,435,61,36,34,2,17,1,0.029411765,0,empty,CD-0722-4
"F8,C8",12744,14259,9269,4990,7431,3752,0,3764,2476,1288,1.922360248,2246,3105,617,245,230,15,92,2,0.060869565,0,empty,CD-0722-4
"F8,C9",9061,9920,6758,3162,5139,2531,0,2532,1743,789,2.209125475,1397,2331,525,233,231,2,54,1,0.038961039,0,empty,CD-0722-4
"F8,C10",10264,11314,7795,3519,5766,2838,0,2844,1853,991,1.869828456,1569,2132,455,183,182,1,57,1,0.049450549,0,empty,CD-0722-4
"F8,C11",9498,10537,7100,3437,5558,2796,0,2796,1797,999,1.798798799,1562,2629,466,215,212,3,67,1,0.089622642,0,empty,CD-0722-4
"F8,C12",18725,20594,13678,6916,10507,5360,1,5366,3518,1848,1.903679654,3020,8249,699,298,286,12,82,3,0.097902098,0,empty,CD-0722-4
"F8,D1",13529,14943,10059,4884,7816,3891,13,3914,2461,1453,1.693737096,2247,1790,219,99,98,1,36,1,0.142857143,0,empty,CD-0722-4
"F8,D2",939770,1043110,715308,327802,507511,252910,2,253179,199629,53550,3.72789916,142176,281831,49873,19238,18957,281,2383,8,0.047001108,0,hg38,CD-0722-4
"F8,D3",7816,8671,5796,2875,4586,2337,0,2337,1494,843,1.772241993,1360,1911,397,156,151,5,58,3,0.026490066,0,empty,CD-0722-4
"F8,D4",7866,9042,5942,3100,4710,2363,1,2365,1576,789,1.997465146,1385,2349,434,185,181,4,46,1,0.027624309,0,empty,CD-0722-4
"F8,D5",7265,7975,5460,2515,4183,2055,25,2084,1324,760,1.742105263,1168,1704,451,178,177,1,55,1,0.073446328,0,empty,CD-0722-4
"F8,D6",11393,12816,8075,4741,6668,3611,8,3620,2174,1446,1.503457815,2169,1949,450,159,159,0,49,0,0.031446541,0,empty,CD-0722-4
"F8,D7",6124,6491,4582,1909,3450,1599,1,1600,1019,581,1.753872633,878,2092,570,242,238,4,62,1,0.176470588,0,empty,CD-0722-4
"F8,D8",7293,7835,5450,2385,4141,2013,0,2017,1299,718,1.809192201,1119,1899,493,175,173,2,45,1,0.034682081,0,empty,CD-0722-4
"F8,D9",4080,4254,3016,1238,2257,1068,0,1068,745,323,2.306501548,594,1787,539,205,202,3,51,1,0.024752475,0,empty,CD-0722-4
"F8,D10",7949,8856,5791,3065,4517,2338,4,2342,1533,809,1.894932015,1331,972,155,80,79,1,30,1,0.113924051,0,empty,CD-0722-4
"F8,D11",8654,9338,6436,2902,4825,2365,0,2370,1589,781,2.034571063,1325,3329,819,328,325,3,79,2,0.033846154,0,empty,CD-0722-4
"F8,D12",11624,13158,8597,4561,6719,3401,2,3404,2215,1189,1.862910008,1931,10446,1200,478,463,15,151,2,0.041036717,0,empty,CD-0722-4
"F8,E1",13484,14906,9954,4952,7637,3844,0,3847,2526,1321,1.912187737,2158,3120,458,192,190,2,81,2,0.063157895,0,empty,CD-0722-4
"F8,E2",9430,10331,6957,3374,5277,2688,0,2690,1689,1001,1.687312687,1506,2324,411,170,167,3,57,2,0.011976048,0,empty,CD-0722-4
"F8,E3",6305,6896,4694,2202,3640,1763,0,1766,1178,588,2.003401361,985,3145,754,289,284,5,74,2,0.014084507,0,empty,CD-0722-4
"F8,E4",9475,10555,6762,3793,5586,2878,0,2879,1895,984,1.925813008,1717,2738,574,276,268,8,89,1,0.03358209,0,empty,CD-0722-4
"F8,E5",9033,9589,6978,2611,5009,2225,0,2231,1515,716,2.115921788,1157,2549,569,208,208,0,54,0,0.100961538,0,empty,CD-0722-4
"F8,E6",934044,994478,733061,261417,478038,215139,10,215371,171865,43506,3.950374661,115546,46730,7938,3093,3035,58,626,4,0.02306425,0,hg38,CD-0722-4
"F8,E7",13494,14269,10120,4149,7410,3594,0,3600,2408,1192,2.020134228,1968,3427,933,348,346,2,97,2,0.066473988,0,empty,CD-0722-4
"F8,E8",1099840,1216293,850271,366022,586717,284008,18,284273,222318,61955,3.588378662,157771,149670,18452,7027,6861,166,1237,5,0.021425448,0,hg38,CD-0722-4
"F8,E9",7230,7933,5229,2704,4150,2146,4,2153,1479,674,2.194362018,1222,3010,825,302,302,0,79,0,0.056291391,0,empty,CD-0722-4
"F8,E10",7824,8402,5851,2551,4385,2048,0,2048,1365,683,1.998535871,1161,2863,555,207,203,4,52,2,0.137931034,0,empty,CD-0722-4
"F8,E11",9015,9712,6797,2915,5160,2472,14,2491,1664,827,2.012091898,1372,2828,654,297,295,2,67,1,0.047457627,0,empty,CD-0722-4
"F8,E12",1348138,1517962,1025637,492325,736207,382540,3,382943,317479,65464,4.849673103,220628,99457,12672,4912,4799,113,936,5,0.022921442,0,hg38,CD-0722-4
"F8,F1",11537,12419,8521,3898,6590,3254,1,3260,2060,1200,1.716666667,1841,2749,583,251,251,0,69,0,0.079681275,0,empty,CD-0722-4
"F8,F2",8925,9740,6741,2999,5110,2476,0,2477,1588,889,1.786276715,1365,3540,791,330,326,4,85,2,0.027607362,0,empty,CD-0722-4
"F8,F3",977003,1110375,729459,380916,542664,288970,0,289249,223873,65376,3.424391214,169176,131423,16336,6156,6003,153,1167,7,0.037481259,0,hg38,CD-0722-4
"F8,F4",13673,14573,10182,4391,7584,3634,0,3640,2344,1296,1.808641975,1992,750,117,60,60,0,28,0,0.166666667,0,empty,CD-0722-4
"F8,F5",1001432,1158802,716349,442453,566995,339864,2,340160,226693,113467,1.997876034,203287,24987,1192,494,462,32,129,4,0.192640693,0,hg38,CD-0722-4
"F8,F6",11261,12564,8321,4243,6733,3556,1,3561,2497,1064,2.346804511,2059,3626,819,333,327,6,111,2,0.018348624,0,empty,CD-0722-4
"F8,F7",11513,12340,8591,3749,6679,3217,0,3220,2187,1033,2.11713456,1757,1362,386,169,169,0,51,0,0.076923077,0,empty,CD-0722-4
"F8,F8",9130,9818,6872,2946,5138,2486,0,2489,1660,829,2.002412545,1332,328,72,41,40,1,16,1,0.15,0,empty,CD-0722-4
"F8,F9",9485,10252,7194,3058,5466,2665,0,2665,1861,804,2.314676617,1448,3497,785,298,294,4,99,2,0.047619048,0,empty,CD-0722-4
"F8,F10",12380,13570,9393,4177,7246,3484,0,3488,2239,1249,1.792634107,1943,2691,544,225,218,7,56,2,0.229357798,0,empty,CD-0722-4
"F8,F11",8628,8980,6450,2530,4753,2227,0,2228,1540,688,2.238372093,1210,2502,267,124,123,1,31,1,0.268292683,0,empty,CD-0722-4
"F8,F12",10468,11440,7678,3762,6054,3036,0,3042,1952,1090,1.790825688,1732,665,61,22,22,0,9,0,0.454545455,0,empty,CD-0722-4
"F8,G1",11119,12282,8265,4017,6459,3222,1,3224,2117,1107,1.91237579,1827,3434,791,334,332,2,92,1,0.021084337,0,empty,CD-0722-4
"F8,G2",9952,11293,6923,4370,5940,3395,16,3413,2220,1193,1.860854987,2043,713,250,100,100,0,24,0,0.14,0,empty,CD-0722-4
"F8,G3",14005,14716,10326,4390,7989,3973,0,3978,2468,1510,1.634437086,2145,3159,831,347,341,6,90,2,0.038123167,0,empty,CD-0722-4
"F8,G4",20896,23819,15031,8788,12137,6743,12,6760,4163,2597,1.603003466,4085,121,13,10,10,0,7,0,0,0,empty,CD-0722-4
"F8,G5",6935,7413,5101,2312,3845,1867,0,1867,1246,621,2.006441224,1035,1611,417,171,170,1,44,1,0.076470588,0,empty,CD-0722-4
"F8,G6",11129,11974,8380,3594,6178,2946,0,2952,1948,1004,1.940239044,1595,243,54,32,32,0,15,0,0.21875,0,empty,CD-0722-4
"F8,G7",1045285,1202740,768580,434160,591340,327074,1,327306,261103,66203,3.943975349,191884,211804,38204,14911,14667,244,2035,7,0.038794573,0,hg38,CD-0722-4
"F8,G8",6165,6817,4536,2281,3645,1829,0,1830,1229,601,2.044925125,1039,2026,430,204,203,1,69,1,0.049261084,0,empty,CD-0722-4
"F8,G9",12355,13838,9029,4809,7142,3869,0,3880,2690,1190,2.260504202,2167,2767,577,286,281,5,92,2,0.053380783,0,empty,CD-0722-4
"F8,G10",9815,10804,7209,3595,5625,2825,0,2827,1898,929,2.043057051,1617,2582,676,290,286,4,88,3,0.052447552,0,empty,CD-0722-4
"F8,G11",9708,10682,7305,3377,5567,2682,1,2689,1772,917,1.932388222,1504,1800,493,208,204,4,56,2,0.053921569,0,empty,CD-0722-4
"F8,G12",7536,8321,5436,2885,4354,2257,0,2257,1492,765,1.950326797,1293,6370,919,356,344,12,85,2,0.081395349,0,empty,CD-0722-4
"F8,H1",8038,8674,5918,2756,4555,2227,0,2228,1506,722,2.085872576,1253,1658,344,164,162,2,38,2,0.043209877,0,empty,CD-0722-4
"F8,H2",8713,9220,6539,2681,4831,2293,0,2293,1521,772,1.970207254,1213,2865,759,302,299,3,88,2,0.093645485,0,empty,CD-0722-4
"F8,H3",7438,8141,5394,2747,4369,2268,0,2269,1517,752,2.017287234,1296,2450,561,234,228,6,57,2,0.026315789,0,empty,CD-0722-4
"F8,H4",10549,11869,7792,4077,6136,3042,28,3075,2024,1051,1.925784967,1808,254,63,15,15,0,7,0,0.133333333,0,empty,CD-0722-4
"F8,H5",29788,34157,20637,13520,17090,10154,0,10166,6921,3245,2.132819723,6036,2548,711,260,254,6,68,2,0.118110236,0,empty,CD-0722-4
"F8,H6",639140,706669,477386,229283,349147,178297,1,178451,138055,40396,3.417541341,101724,108019,19300,7586,7436,150,1111,6,0.031871974,0,hg38,CD-0722-4
"F8,H7",7822,8561,5802,2759,4555,2213,0,2213,1462,751,1.946737683,1294,2183,565,223,223,0,58,0,0.121076233,0,empty,CD-0722-4
"F8,H8",4875204,5662260,3588356,2073904,2559994,1505124,6,1506463,1220681,285782,4.271371185,895001,702031,134403,52539,51787,752,4767,12,0.056056539,0,hg38,CD-0722-4
"F8,H9",8710,9369,6608,2761,4815,2216,0,2218,1505,713,2.110799439,1190,1538,431,188,186,2,51,1,0.290322581,0,empty,CD-0722-4
"F8,H10",18009,20131,13264,6867,9870,4923,5,4933,3635,1298,2.80046225,2906,3272,482,198,195,3,50,2,0.082051282,0,empty,CD-0722-4
"F8,H11",7491,8494,5256,3238,4365,2558,0,2561,1378,1183,1.164835165,1507,105,6,6,5,1,5,1,0.2,0,empty,CD-0722-4
"F8,H12",6858,7309,5041,2268,3912,1971,0,1971,1368,603,2.268656716,1109,4022,337,165,164,1,63,1,0.06097561,0,empty,CD-0722-4
"F9,A1",6891,7618,4944,2674,4091,2109,0,2112,1432,680,2.105882353,1249,1561,291,112,111,1,30,1,0,0,empty,CD-0722-4
"F9,A2",9992,10993,7304,3689,5758,2974,0,2979,1919,1060,1.810377358,1723,2689,754,301,297,4,57,2,0.090909091,0,empty,CD-0722-4
"F9,A3",6766,7182,5037,2145,3866,1875,3,1880,1302,578,2.252595156,1023,1782,400,176,173,3,37,2,0.023121387,0,empty,CD-0722-4
"F9,A4",11774,12827,8639,4188,6644,3248,0,3249,2068,1181,1.751058425,1829,1007,230,106,103,3,28,1,0.019417476,0,empty,CD-0722-4
"F9,A5",10246,11505,7551,3954,6059,3020,3,3028,1986,1042,1.905950096,1716,3855,925,340,332,8,90,2,0.021084337,0,empty,CD-0722-4
"F9,A6",15525,17736,11616,6120,9244,4829,20,4855,3525,1330,2.65037594,2802,3657,1180,472,462,10,104,2,0.103896104,0,empty,CD-0722-4
"F9,A7",6968,7707,5075,2632,3986,2072,3,2078,1333,745,1.789261745,1165,1288,326,129,129,0,42,0,0.007751938,0,empty,CD-0722-4
"F9,A8",10460,11629,7397,4232,5903,3179,0,3183,2392,791,3.024020228,1846,4536,958,342,338,4,78,2,0.127218935,0,empty,CD-0722-4
"F9,A9",9211,10465,7034,3431,5452,2728,1,2732,1889,843,2.240806643,1552,1824,369,135,134,1,41,1,0.089552239,0,empty,CD-0722-4
"F9,A10",7610,8108,5804,2304,4332,2069,14,2089,1388,701,1.980028531,1117,374,122,49,49,0,12,0,0,0,empty,CD-0722-4
"F9,A11",927837,1058162,699970,358192,516200,273236,1,273496,222107,51389,4.322072817,156111,186781,27011,10397,10197,200,1612,7,0.058154359,0,hg38,CD-0722-4
"F9,A12",9163,9618,6832,2786,5126,2481,9,2490,1701,789,2.155893536,1325,3848,1012,376,371,5,94,3,0.083557951,0,empty,CD-0722-4
"F9,B1",8189,9126,6073,3053,4784,2512,0,2512,1630,882,1.848072562,1357,2525,525,210,208,2,52,2,0.014423077,0,empty,CD-0722-4
"F9,B2",8186,8934,5703,3231,4685,2521,0,2523,1485,1038,1.430635838,1500,1157,213,92,91,1,20,1,0.087912088,0,empty,CD-0722-4
"F9,B3",6346,6835,4657,2178,3729,1874,0,1874,1241,633,1.960505529,1061,1992,511,206,205,1,37,1,0.034146341,0,empty,CD-0722-4
"F9,B4",6534,7170,4758,2412,3848,2009,5,2014,1322,692,1.910404624,1179,1604,426,184,181,3,42,2,0.093922652,0,empty,CD-0722-4
"F9,B5",333615,182272,113626,68646,121907,69870,2,70235,43338,26897,1.611257761,43134,1371,345,182,180,2,46,2,0.222222222,0,empty,CD-0722-4
"F9,B6",8473,9697,6212,3485,5096,2717,0,2719,1728,991,1.743693239,1591,2150,634,216,216,0,56,0,0.041666667,0,empty,CD-0722-4
"F9,B7",8054,9026,6034,2992,4902,2440,0,2440,1636,804,2.034825871,1416,1308,322,131,131,0,32,0,0.038167939,0,empty,CD-0722-4
"F9,B8",6161,6754,4591,2163,3636,1773,37,1814,1254,560,2.239285714,1043,1240,368,125,125,0,33,0,0.024,0,empty,CD-0722-4
"F9,B9",10385,11412,7606,3806,6048,3086,12,3098,2006,1092,1.836996337,1772,1372,336,136,134,2,39,2,0.074626866,0,empty,CD-0722-4
"F9,B10",5636,6267,4091,2176,3474,1800,1,1809,1178,631,1.866877971,1082,767,199,96,95,1,20,1,0.157894737,0,empty,CD-0722-4
"F9,B11",11175,12558,7993,4565,6480,3547,3,3550,2065,1485,1.390572391,2032,295,63,31,29,2,10,1,0.206896552,0,empty,CD-0722-4
"F9,B12",6778,7479,5057,2422,4033,1992,1,1996,1342,654,2.051987768,1163,2705,539,191,180,11,55,2,0.033333333,0,empty,CD-0722-4
"F9,C1",34772,35682,27574,8108,17569,6866,5,6880,4427,2453,1.804728903,3528,1379,243,127,125,2,41,1,0,0,empty,CD-0722-4
"F9,C2",11573,12919,8382,4537,6640,3407,0,3412,2236,1176,1.901360544,1960,3041,864,316,315,1,77,1,0.022222222,0,empty,CD-0722-4
"F9,C3",11662,12619,8733,3886,6793,3445,1,3452,2251,1201,1.87427144,1904,1076,228,90,89,1,21,1,0.02247191,0,empty,CD-0722-4
"F9,C4",7069,7496,5269,2227,4058,1896,0,1899,1288,611,2.10801964,1085,2164,455,192,189,3,52,1,0.148148148,0,empty,CD-0722-4
"F9,C5",10408,11636,7817,3819,6173,3114,0,3114,2050,1064,1.926691729,1771,1861,568,156,156,0,48,0,0.019230769,0,empty,CD-0722-4
"F9,C6",9354,10375,6872,3503,5577,2884,0,2885,1907,978,1.949897751,1642,2339,851,307,306,1,57,1,0.062091503,0,empty,CD-0722-4
"F9,C7",12312,13925,8921,5004,7138,3882,0,3884,2373,1511,1.570483124,2290,494,84,35,35,0,11,0,0.028571429,0,empty,CD-0722-4
"F9,C8",12340,13272,9154,4118,6964,3501,1,3507,2369,1138,2.08172232,1850,3472,981,386,383,3,80,2,0.041775457,0,empty,CD-0722-4
"F9,C9",9426,10606,6964,3642,5575,2917,0,2920,1957,963,2.03219107,1666,1807,296,135,134,1,46,1,0.141791045,0,empty,CD-0722-4
"F9,C10",10601,11285,8051,3234,5912,2788,0,2789,1834,955,1.920418848,1425,2183,578,230,230,0,50,0,0.043478261,0,empty,CD-0722-4
"F9,C11",1631250,1741528,1247368,494160,838803,398768,4,399207,325520,73687,4.417604191,221638,77390,9433,3744,3663,81,736,4,0.017199017,0,hg38,CD-0722-4
"F9,C12",13421,14371,9992,4379,7543,3572,0,3577,2426,1151,2.107732407,1937,2199,467,188,180,8,61,2,0.027777778,0,empty,CD-0722-4
"F9,D1",10232,11509,7524,3985,6102,3157,0,3161,1993,1168,1.706335616,1838,928,145,59,59,0,24,0,0.050847458,0,empty,CD-0722-4
"F9,D2",10019,10950,7607,3343,5761,2740,0,2742,1764,978,1.803680982,1497,3835,899,345,337,8,67,1,0.089020772,0,empty,CD-0722-4
"F9,D3",8306,9237,6124,3113,4706,2356,0,2356,1577,779,2.024390244,1357,1658,361,132,131,1,38,1,0.13740458,0,empty,CD-0722-4
"F9,D4",6852,7552,5045,2507,3969,2014,0,2017,1347,670,2.010447761,1135,1506,325,140,137,3,36,2,0.01459854,0,empty,CD-0722-4
"F9,D5",7293,8054,5451,2603,4194,2132,0,2139,1414,725,1.950344828,1237,2079,484,151,149,2,40,2,0.040268456,0,empty,CD-0722-4
"F9,D6",11086,12510,7970,4540,6401,3476,0,3481,2138,1343,1.591958302,2007,2929,770,243,240,3,68,2,0.154166667,0,empty,CD-0722-4
"F9,D7",6203,6335,4580,1755,3532,1641,11,1656,1087,569,1.910369069,881,2529,710,262,256,6,67,2,0.04296875,0,empty,CD-0722-4
"F9,D8",7461,8242,5539,2703,4322,2132,20,2153,1389,764,1.818062827,1244,1501,438,150,148,2,41,1,0.033783784,0,empty,CD-0722-4
"F9,D9",3938,4316,2977,1339,2247,1071,0,1071,745,326,2.285276074,563,2068,384,174,163,11,37,2,0.098159509,0,empty,CD-0722-4
"F9,D10",8566,9667,6206,3461,5067,2650,6,2658,1752,906,1.933774834,1543,964,194,74,74,0,20,0,0.040540541,0,empty,CD-0722-4
"F9,D11",8290,9209,6189,3020,4801,2332,0,2332,1502,830,1.809638554,1326,3195,825,386,382,4,92,2,0.054973822,0,empty,CD-0722-4
"F9,D12",11174,12156,8460,3696,6358,3167,1,3171,2064,1107,1.864498645,1691,5047,1350,496,492,4,121,2,0.06504065,0,empty,CD-0722-4
"F9,E1",13842,15197,10296,4901,7826,3966,0,3966,2529,1437,1.759916493,2144,2813,624,260,253,7,58,2,0.079051383,0,empty,CD-0722-4
"F9,E2",9333,10427,6890,3537,5519,2857,1,2859,1763,1096,1.608576642,1615,2289,415,165,163,2,49,1,0.220858896,0,empty,CD-0722-4
"F9,E3",6655,7449,4931,2518,3905,1922,1,1929,1275,654,1.949541284,1097,3192,682,261,258,3,72,2,0.042635659,0,empty,CD-0722-4
"F9,E4",9140,10481,6725,3756,5618,2881,0,2887,1886,1001,1.884115884,1706,3407,759,292,288,4,71,2,0.076388889,0,empty,CD-0722-4
"F9,E5",7699,8376,5891,2485,4419,2099,0,2099,1378,721,1.911234397,1127,1633,311,130,130,0,34,0,0.169230769,0,empty,CD-0722-4
"F9,E6",14139,15834,10457,5377,8043,4053,0,4059,2600,1459,1.782042495,2292,4568,1057,435,429,6,106,2,0.065268065,0,empty,CD-0722-4
"F9,E7",922795,1051871,678064,373807,513105,281430,4,281703,227855,53848,4.231447779,163759,209133,35766,13867,13625,242,1969,6,0.043449541,0,hg38,CD-0722-4
"F9,E8",10982,12015,8423,3592,6345,2974,0,2974,2002,972,2.059670782,1673,2987,701,272,271,1,80,1,0.081180812,0,empty,CD-0722-4
"F9,E9",5739,6140,4185,1955,3331,1653,0,1653,1092,561,1.946524064,911,2701,551,242,240,2,71,1,0.070833333,0,empty,CD-0722-4
"F9,E10",8139,8816,6041,2775,4592,2183,10,2199,1431,768,1.86328125,1270,2619,692,269,262,7,57,2,0.015267176,0,empty,CD-0722-4
"F9,E11",8767,9352,6568,2784,5045,2503,7,2516,1620,896,1.808035714,1391,2238,558,260,255,5,56,2,0.043137255,0,empty,CD-0722-4
"F9,E12",10007,11309,7328,3981,5956,3104,0,3108,2081,1027,2.026290166,1789,2150,407,154,153,1,41,1,0.019607843,0,empty,CD-0722-4
"F9,F1",11120,12061,8204,3857,6295,3084,0,3087,1966,1121,1.753791258,1724,2422,567,202,200,2,51,1,0.085,0,empty,CD-0722-4
"F9,F2",8521,9390,6299,3091,4927,2433,0,2435,1554,881,1.763904654,1360,3255,697,287,280,7,64,2,0.128571429,0,empty,CD-0722-4
"F9,F3",9148,9901,6776,3125,5256,2524,0,2524,1677,847,1.979929162,1429,3598,816,344,340,4,75,1,0.067647059,0,empty,CD-0722-4
"F9,F4",13256,14487,9842,4645,7662,3751,0,3753,2472,1281,1.929742389,2137,1114,178,56,54,2,22,2,0,0,empty,CD-0722-4
"F9,F5",11244,12018,8425,3593,6257,2914,48,2963,1982,981,2.02038736,1637,3132,781,310,310,0,68,0,0.14516129,0,empty,CD-0722-4
"F9,F6",11643,13428,8579,4849,7103,3732,0,3732,2564,1168,2.195205479,2190,4723,1255,500,489,11,107,2,0.071574642,0,empty,CD-0722-4
"F9,F7",11741,13051,8773,4278,7048,3664,0,3674,2459,1215,2.023868313,2068,1721,434,148,146,2,33,1,0.01369863,0,empty,CD-0722-4
"F9,F8",8473,9423,6355,3068,4964,2438,0,2442,1611,831,1.938628159,1398,274,22,19,19,0,10,0,0.105263158,0,empty,CD-0722-4
"F9,F9",9291,10182,7013,3169,5305,2565,1,2568,1696,872,1.944954128,1423,4129,1153,424,421,3,80,1,0.140142518,0,empty,CD-0722-4
"F9,F10",12219,13290,9325,3965,7066,3342,0,3344,2183,1161,1.880275624,1848,2082,438,165,162,3,43,1,0.086419753,0,empty,CD-0722-4
"F9,F11",9008,9426,6902,2524,4842,2226,15,2248,1493,755,1.977483444,1187,2540,627,255,250,5,50,3,0.072,0,empty,CD-0722-4
"F9,F12",10281,10995,7605,3390,5896,2861,0,2861,1890,971,1.946446962,1587,162,49,20,20,0,7,0,0,0,empty,CD-0722-4
"F9,G1",12819,13750,9718,4032,7229,3374,3,3386,2187,1199,1.824020017,1822,4602,954,364,354,10,90,2,0.062146893,0,empty,CD-0722-4
"F9,G2",6738,7120,4728,2392,3729,1896,3,1901,1232,669,1.841554559,1087,331,69,24,24,0,8,0,0.666666667,0,empty,CD-0722-4
"F9,G3",11855,12451,8725,3726,6467,3198,0,3201,2068,1133,1.825242718,1652,2574,665,258,255,3,68,1,0.039215686,0,empty,CD-0722-4
"F9,G4",1376103,1571358,1022773,548585,758353,413080,35,413491,339864,73627,4.616024013,238589,3440,406,178,175,3,32,2,0.017142857,0,hg38,CD-0722-4
"F9,G5",967371,1079401,738289,341112,522245,261698,1,261961,206726,55235,3.742663166,148964,62129,11058,4228,4144,84,744,8,0.026544402,0,hg38,CD-0722-4
"F9,G6",11270,12522,8392,4130,6525,3178,16,3197,2141,1056,2.027462121,1860,197,42,20,16,4,6,1,0,0,empty,CD-0722-4
"F9,G7",8750,9498,6566,2932,5076,2385,0,2386,1603,783,2.047254151,1306,3241,779,287,276,11,65,2,0.173913043,0,empty,CD-0722-4
"F9,G8",6566,7179,4739,2440,3834,1855,18,1873,1241,632,1.963607595,1089,2049,460,225,219,6,55,2,0.105022831,0,empty,CD-0722-4
"F9,G9",8102,9179,6081,3098,4804,2408,0,2411,1651,760,2.172368421,1380,2564,619,244,243,1,73,1,0.061728395,0,empty,CD-0722-4
"F9,G10",9799,10807,7349,3458,5680,2852,5,2861,1931,930,2.076344086,1569,2809,767,342,340,2,79,2,0.032352941,0,empty,CD-0722-4
"F9,G11",9517,10292,7148,3144,5448,2616,2,2618,1701,917,1.854961832,1444,2136,667,245,243,2,53,2,0.024691358,0,empty,CD-0722-4
"F9,G12",7408,8393,5374,3019,4356,2282,0,2286,1452,834,1.741007194,1346,2345,592,181,180,1,46,1,0.127777778,0,empty,CD-0722-4
"F9,H1",737076,842433,526652,315781,420437,248133,1,248335,181661,66674,2.724615292,144519,7570,709,252,237,15,50,2,0.172995781,0,hg38,CD-0722-4
"F9,H2",9120,10315,6715,3600,5254,2635,27,2664,1763,901,1.956714761,1584,2574,734,300,300,0,75,0,0.06,0,empty,CD-0722-4
"F9,H3",11659,13026,8645,4381,6619,3245,0,3253,2228,1025,2.173658537,1846,3661,790,296,293,3,63,2,0.078498294,0,empty,CD-0722-4
"F9,H4",11110,12193,8199,3994,6360,3111,6,3120,2083,1037,2.008678881,1795,235,20,15,15,0,10,0,0,0,empty,CD-0722-4
"F9,H5",12329,13914,9206,4708,7209,3700,0,3701,2392,1309,1.827349121,2141,1973,578,225,220,5,56,2,0.036363636,0,empty,CD-0722-4
"F9,H6",669399,649903,544539,105364,315222,106519,2,106653,82960,23693,3.501456126,47646,242812,53187,20736,20449,287,2488,8,0.037067827,0,hg38,CD-0722-4
"F9,H7",570830,727589,379134,348455,374117,256751,4,256940,149693,107247,1.39577797,166843,2832,766,262,261,1,67,1,0.149425287,0,hg38,CD-0722-4
"F9,H8",10266,11575,7464,4111,5995,3083,0,3089,2080,1009,2.061446977,1786,2901,511,192,190,2,59,1,0.089473684,0,empty,CD-0722-4
"F9,H9",7421,7902,5648,2254,4111,1898,3,1903,1295,608,2.129934211,1013,1885,459,200,194,6,43,2,0.077319588,0,empty,CD-0722-4
"F9,H10",900622,1063070,631417,431653,521815,328928,3,329212,216371,112841,1.917485666,197971,2177,621,228,227,1,59,1,0.123348018,0,hg38,CD-0722-4
"F9,H11",7477,8649,5179,3470,4457,2650,13,2665,1469,1196,1.22826087,1634,23,0,0,0,0,0,0,0,0,empty,CD-0722-4
"F9,H12",6829,7739,4929,2810,3967,2048,1,2053,1356,697,1.945480631,1218,1809,573,182,182,0,38,0,0.236263736,0,empty,CD-0722-4
"F10,A1",8816,9747,6473,3274,5227,2772,0,2772,1900,872,2.178899083,1620,1375,227,95,93,2,32,1,0.193548387,0,empty,CD-0722-4
"F10,A2",13652,14882,10252,4630,7804,3939,0,3944,2641,1303,2.02686109,2206,2211,551,211,203,8,61,2,0.088669951,0,empty,CD-0722-4
"F10,A3",8588,9513,6361,3152,5085,2592,0,2597,1711,886,1.931151242,1488,1252,239,113,111,2,25,1,0.09009009,0,empty,CD-0722-4
"F10,A4",13550,14755,9982,4773,7716,3835,0,3839,2540,1299,1.955350269,2126,815,180,75,69,6,21,1,0.014492754,0,empty,CD-0722-4
"F10,A5",13749,15060,10392,4668,8006,3899,0,3903,2628,1275,2.061176471,2157,3125,492,200,199,1,68,1,0.085427136,0,empty,CD-0722-4
"F10,A6",1662432,2040435,1201850,838585,988113,593519,43,594012,481327,112685,4.27143808,363864,285116,49483,19088,18809,279,2627,7,0.042160668,0,hg38,CD-0722-4
"F10,A7",607052,749727,424937,324790,385280,251669,1,251802,156523,95279,1.642785923,156950,2672,960,301,299,2,74,1,0.197324415,0,hg38,CD-0722-4
"F10,A8",6189,7038,4608,2430,3767,1928,0,1928,1419,509,2.787819253,1145,1973,397,180,180,0,58,0,0.033333333,0,empty,CD-0722-4
"F10,A9",11084,12390,8203,4187,6542,3411,0,3415,2420,995,2.432160804,1928,2530,496,200,200,0,66,0,0.095,0,empty,CD-0722-4
"F10,A10",10105,11363,7744,3619,6061,3047,1,3055,2046,1009,2.027750248,1719,443,37,25,24,1,13,1,0,0,empty,CD-0722-4
"F10,A11",8474,9262,6363,2899,4871,2345,0,2350,1567,783,2.001277139,1313,1934,448,192,191,1,51,1,0.089005236,0,empty,CD-0722-4
"F10,A12",13621,15298,10193,5105,7841,3893,0,3895,2689,1206,2.229684909,2167,4657,1147,460,456,4,109,3,0.081140351,0,empty,CD-0722-4
"F10,B1",9227,10036,6758,3278,5264,2695,0,2695,1775,920,1.929347826,1519,1275,229,108,108,0,36,0,0.074074074,0,empty,CD-0722-4
"F10,B2",9562,10280,6612,3668,5418,2785,26,2811,1768,1043,1.695110259,1659,1033,264,95,95,0,22,0,0.073684211,0,empty,CD-0722-4
"F10,B3",9917,11167,7153,4014,5782,3014,17,3034,2129,905,2.352486188,1780,1924,556,217,212,5,53,2,0.056603774,0,empty,CD-0722-4
"F10,B4",1329933,1451477,1026752,424725,706423,340391,4,340713,272478,68235,3.993229281,188501,107833,18806,6961,6821,140,1049,4,0.027415335,0,hg38,CD-0722-4
"F10,B5",11824,6923,4607,2316,4645,2298,1,2314,1606,708,2.268361582,1410,1328,314,131,129,2,38,2,0.170542636,0,empty,CD-0722-4
"F10,B6",11982,13413,8826,4587,7084,3765,6,3775,2579,1196,2.156354515,2181,2162,518,193,189,4,51,2,0.010582011,0,empty,CD-0722-4
"F10,B7",10130,11287,7694,3593,5943,2917,0,2920,1947,973,2.001027749,1599,1642,484,196,195,1,46,1,0.046153846,0,empty,CD-0722-4
"F10,B8",10020,11156,7464,3692,5939,3034,12,3050,2183,867,2.517877739,1760,1708,421,192,191,1,47,1,0.109947644,0,empty,CD-0722-4
"F10,B9",1007740,1118997,764751,354246,539665,272109,2,272393,208168,64225,3.241230051,154524,48585,6515,2502,2455,47,484,6,0.06191446,0,hg38,CD-0722-4
"F10,B10",8188,8834,5725,3109,4895,2485,0,2496,1740,756,2.301587302,1479,802,189,56,52,4,14,2,0.076923077,0,empty,CD-0722-4
"F10,B11",14717,16042,10715,5327,8497,4537,0,4543,2782,1761,1.579784214,2571,371,112,64,64,0,15,0,0.0625,0,empty,CD-0722-4
"F10,B12",10120,11468,7409,4059,6150,3233,0,3237,2279,958,2.378914405,1918,1852,434,174,173,1,46,1,0.115606936,0,empty,CD-0722-4
"F10,C1",18831,20394,14048,6346,10903,5373,1,5380,3613,1767,2.044708546,3017,1354,331,123,123,0,39,0,0.130081301,0,empty,CD-0722-4
"F10,C2",13272,14695,9698,4997,7767,3940,0,3948,2608,1340,1.946268657,2253,3014,974,383,381,2,92,2,0.073490814,0,empty,CD-0722-4
"F10,C3",14672,16125,10898,5227,8648,4363,0,4365,2851,1514,1.883091149,2513,944,201,95,95,0,33,0,0.052631579,0,empty,CD-0722-4
"F10,C4",10087,11408,7625,3783,5876,2854,15,2870,2014,856,2.352803738,1631,2201,514,187,184,3,55,2,0.043478261,0,empty,CD-0722-4
"F10,C5",12644,14169,9268,4901,7512,3785,26,3816,2583,1233,2.094890511,2244,2239,439,193,191,2,55,1,0.041884817,0,empty,CD-0722-4
"F10,C6",10743,11932,7718,4214,6353,3357,0,3361,2272,1089,2.086317723,1967,2255,754,305,299,6,59,3,0.043478261,0,empty,CD-0722-4
"F10,C7",14207,16481,10251,6230,8605,4639,12,4662,2960,1702,1.739130435,2801,342,88,44,44,0,13,0,0.022727273,0,empty,CD-0722-4
"F10,C8",16124,17735,12106,5629,9259,4694,0,4705,3215,1490,2.157718121,2631,3914,1006,373,363,10,87,2,0.08815427,0,empty,CD-0722-4
"F10,C9",13425,14637,9939,4698,7726,3863,0,3871,2681,1190,2.252941176,2215,2365,417,184,179,5,61,2,0.078212291,0,empty,CD-0722-4
"F10,C10",13302,14051,9916,4135,7327,3484,7,3494,2389,1105,2.16199095,1928,2174,539,230,223,7,60,2,0.053811659,0,empty,CD-0722-4
"F10,C11",11439,12530,8379,4151,6786,3398,0,3400,2290,1110,2.063063063,1975,2446,727,271,265,6,76,2,0.052830189,0,empty,CD-0722-4
"F10,C12",1014974,1142081,756651,385430,551765,289008,2,289267,231119,58148,3.974668088,167540,75117,8060,3000,2916,84,647,6,0.025034294,0,hg38,CD-0722-4
"F10,D1",12758,14694,9259,5435,7648,4081,0,4081,2546,1535,1.658631922,2445,1191,216,73,73,0,17,0,0.082191781,0,empty,CD-0722-4
"F10,D2",10746,11658,8070,3588,6121,2915,46,2963,1850,1113,1.662174304,1691,3307,862,347,347,0,84,0,0.008645533,0,empty,CD-0722-4
"F10,D3",10717,11423,7929,3494,6172,3056,0,3064,2060,1004,2.051792829,1690,3109,745,258,256,2,60,1,0.12109375,0,empty,CD-0722-4
"F10,D4",8735,9747,6658,3089,5173,2610,0,2616,1825,791,2.307206068,1435,1981,504,219,212,7,53,1,0.028301887,0,empty,CD-0722-4
"F10,D5",9117,10334,6647,3687,5270,2717,5,2723,1853,870,2.129885057,1603,2148,564,199,196,3,43,1,0.12244898,0,empty,CD-0722-4
"F10,D6",12710,13838,9274,4564,7148,3792,3,3796,2373,1423,1.667603654,2091,2252,453,203,200,3,59,2,0.055,0,empty,CD-0722-4
"F10,D7",7752,8342,5854,2488,4416,2105,0,2108,1390,718,1.935933148,1141,2754,703,323,319,4,68,2,0.034482759,0,empty,CD-0722-4
"F10,D8",22188,24437,16873,7564,12220,5769,0,5778,4233,1545,2.739805825,3297,3132,712,274,274,0,67,0,0.135036496,0,empty,CD-0722-4
"F10,D9",809041,892661,609848,282813,435075,220456,2,220677,173824,46853,3.709986554,123542,69944,11554,4308,4226,82,799,5,0.026502603,0,hg38,CD-0722-4
"F10,D10",10750,11623,7802,3821,6318,3286,0,3289,2257,1032,2.187015504,1851,1449,300,123,116,7,28,2,0.163793103,0,empty,CD-0722-4
"F10,D11",10167,11382,7677,3705,5925,2908,10,2920,1931,989,1.95247725,1685,3479,896,344,339,5,73,1,0.053097345,0,empty,CD-0722-4
"F10,D12",14383,15947,10750,5197,8650,4325,21,4349,2929,1420,2.062676056,2451,4776,1360,564,560,4,135,2,0.05,0,empty,CD-0722-4
"F10,E1",877537,968810,666089,302721,470337,231476,1,231751,166480,65271,2.550596743,131375,181823,22562,8720,8521,199,1316,5,0.069005985,0,hg38,CD-0722-4
"F10,E2",11604,12690,8552,4138,6747,3438,0,3440,2210,1230,1.796747967,1979,3017,815,288,288,0,65,0,0.079861111,0,empty,CD-0722-4
"F10,E3",8658,9264,6144,3120,4846,2435,1,2440,1580,860,1.837209302,1397,2688,678,297,292,5,78,2,0.02739726,0,empty,CD-0722-4
"F10,E4",13146,14466,9836,4630,7803,3955,0,3955,2589,1366,1.895314788,2264,3953,966,346,344,2,93,1,0.095930233,0,empty,CD-0722-4
"F10,E5",1323931,1437996,1043206,394790,686368,320197,2,320546,254976,65570,3.888607595,172433,62588,10906,4140,4095,45,757,5,0.035897436,0,hg38,CD-0722-4
"F10,E6",17620,19035,13015,6020,9908,4920,2,4924,3339,1585,2.106624606,2677,4317,1102,463,458,5,111,3,0.100436681,0,empty,CD-0722-4
"F10,E7",21708,23698,16396,7302,12436,6142,0,6143,4298,1845,2.329539295,3332,5142,1164,451,447,4,108,2,0.058165548,0,empty,CD-0722-4
"F10,E8",13676,14662,10567,4095,7946,3759,0,3761,2571,1190,2.160504202,2046,4190,993,361,358,3,100,2,0.075418994,0,empty,CD-0722-4
"F10,E9",8727,9981,6407,3574,5226,2675,0,2679,1871,808,2.315594059,1612,2951,649,234,233,1,70,1,0.030042918,0,empty,CD-0722-4
"F10,E10",9336,10172,6792,3380,5486,2729,11,2740,1871,869,2.153049482,1580,2397,626,222,221,1,65,1,0.049773756,0,empty,CD-0722-4
"F10,E11",11126,12262,8243,4019,6529,3346,0,3352,2229,1123,1.984861977,1880,2734,583,240,233,7,56,2,0.175965665,0,empty,CD-0722-4
"F10,E12",15101,17002,10991,6011,9144,4757,6,4773,3376,1397,2.416607015,2868,2562,600,227,227,0,64,0,0.136563877,0,empty,CD-0722-4
"F10,F1",14300,15421,10454,4967,8246,4095,0,4097,2612,1485,1.758922559,2336,2308,582,230,229,1,58,1,0.15720524,0,empty,CD-0722-4
"F10,F2",11408,12170,8445,3725,6468,3105,15,3121,2105,1016,2.071850394,1715,4559,967,383,380,3,95,2,0.057894737,0,empty,CD-0722-4
"F10,F3",11518,12584,8601,3983,6640,3310,0,3316,2216,1100,2.014545455,1841,3793,845,339,336,3,92,2,0.017857143,0,empty,CD-0722-4
"F10,F4",16010,17281,11906,5375,9266,4422,1,4431,3034,1397,2.171796707,2503,815,194,91,90,1,27,1,0,0,empty,CD-0722-4
"F10,F5",12736,13863,9556,4307,7205,3397,1,3407,2285,1122,2.036541889,1884,2752,803,326,324,2,70,2,0.037037037,0,empty,CD-0722-4
"F10,F6",18541,21408,13370,8038,11492,6246,1,6255,4427,1828,2.421772429,3775,4112,810,339,324,15,101,2,0.089506173,0,empty,CD-0722-4
"F10,F7",14823,16276,10909,5367,8707,4331,0,4338,2920,1418,2.059238364,2457,1392,311,143,140,3,51,1,0.014285714,0,empty,CD-0722-4
"F10,F8",11840,13043,8811,4232,6943,3439,3,3447,2431,1016,2.392716535,1917,270,66,22,21,1,8,1,0,0,empty,CD-0722-4
"F10,F9",12579,13611,9304,4307,7256,3594,0,3596,2580,1016,2.539370079,2031,4515,1019,417,412,5,102,2,0.048543689,0,empty,CD-0722-4
"F10,F10",14644,15856,11020,4836,8460,4148,1,4150,2900,1250,2.32,2321,2398,617,208,206,2,53,1,0.150485437,0,empty,CD-0722-4
"F10,F11",10924,11552,8295,3257,6129,2889,0,2891,2005,886,2.262979684,1565,2431,574,159,154,5,43,1,0.006493506,0,empty,CD-0722-4
"F10,F12",12690,13785,9464,4321,7158,3592,0,3594,2419,1175,2.058723404,2061,216,12,10,9,1,4,1,0,0,empty,CD-0722-4
"F10,G1",14135,15645,10431,5214,8346,4214,1,4218,2911,1307,2.22723795,2436,3110,496,202,201,1,62,1,0.124378109,0,empty,CD-0722-4
"F10,G2",7593,8141,5317,2824,4178,2150,0,2153,1399,754,1.855437666,1215,700,112,47,47,0,12,0,0,0,empty,CD-0722-4
"F10,G3",14329,15251,10584,4667,7994,3996,0,4000,2510,1490,1.684563758,2194,3541,864,309,307,2,75,1,0.029315961,0,empty,CD-0722-4
"F10,G4",24732,27854,17551,10303,14203,7867,1,7874,5021,2853,1.759901858,4615,69,5,3,3,0,3,0,0,0,empty,CD-0722-4
"F10,G5",8476,9221,6219,3002,4840,2419,7,2431,1573,858,1.833333333,1398,2162,619,228,227,1,46,1,0.066079295,0,empty,CD-0722-4
"F10,G6",13217,14284,9784,4500,7620,3783,3,3791,2613,1178,2.218166384,2070,298,82,33,33,0,12,0,0.03030303,0,empty,CD-0722-4
"F10,G7",10935,11860,8220,3640,6313,3048,0,3048,1977,1071,1.845938375,1698,3669,959,370,366,4,85,1,0.139344262,0,empty,CD-0722-4
"F10,G8",8559,9366,6238,3128,5123,2564,12,2581,1768,813,2.174661747,1493,2459,675,254,254,0,70,0,0.07480315,0,empty,CD-0722-4
"F10,G9",13940,15422,10246,5176,8187,4404,1,4408,2895,1513,1.913417052,2504,3395,629,258,256,2,86,2,0.09375,0,empty,CD-0722-4
"F10,G10",927684,1017953,715472,302481,497181,238850,1,239104,181442,57662,3.146647706,133474,193893,22061,8770,8538,232,1407,7,0.053056922,0,hg38,CD-0722-4
"F10,G11",12882,14055,9873,4182,7326,3510,10,3523,2475,1048,2.361641221,1951,1716,382,152,147,5,50,2,0.040816327,0,empty,CD-0722-4
"F10,G12",8485,9612,6186,3426,5024,2636,0,2640,1696,944,1.796610169,1569,3069,621,226,221,5,59,2,0.076923077,0,empty,CD-0722-4
"F10,H1",723832,802450,535532,266918,398356,206449,10,206621,164549,42072,3.911128542,119182,39936,7449,2685,2643,42,504,3,0.027998487,0,hg38,CD-0722-4
"F10,H2",10172,11363,7578,3785,6120,3112,2,3117,2090,1027,2.035053554,1814,3153,825,306,304,2,74,1,0.042763158,0,empty,CD-0722-4
"F10,H3",10293,11533,7615,3918,6105,3180,1,3181,2217,964,2.299792531,1837,2151,416,166,166,0,47,0,0.156626506,0,empty,CD-0722-4
"F10,H4",13546,14980,9810,5170,7871,3985,1,3988,2668,1320,2.021212121,2323,237,38,13,13,0,8,0,0,0,empty,CD-0722-4
"F10,H5",14258,15947,10485,5462,8289,4242,27,4269,2839,1430,1.985314685,2499,2938,748,271,269,2,64,1,0.152416357,0,empty,CD-0722-4
"F10,H6",10369,11682,7612,4070,6111,3173,1,3181,2198,983,2.236012208,1830,2388,472,200,198,2,59,1,0.106060606,0,empty,CD-0722-4
"F10,H7",9680,10786,7027,3759,5698,2830,8,2841,1919,922,2.081344902,1669,2417,682,232,230,2,58,1,0.004347826,0,empty,CD-0722-4
"F10,H8",901482,1064517,654968,409549,519786,295869,2,296152,233781,62371,3.748232352,178935,184766,33224,13128,12918,210,1767,7,0.065877071,0,hg38,CD-0722-4
"F10,H9",10062,10975,7702,3273,5707,2682,0,2686,1835,851,2.156286722,1492,1315,244,122,122,0,35,0,0.008196721,0,empty,CD-0722-4
"F10,H10",7988,8941,5873,3068,4623,2282,0,2286,1544,742,2.080862534,1320,1820,336,139,134,5,31,1,0.059701493,0,empty,CD-0722-4
"F10,H11",8832,9963,6094,3869,5181,3034,1,3040,1707,1333,1.280570143,1830,37,22,9,9,0,2,0,0,0,empty,CD-0722-4
"F10,H12",10060,11359,7446,3913,5874,2986,0,2986,2172,814,2.668304668,1715,2343,543,172,170,2,33,1,0.105882353,0,empty,CD-0722-4
"F11,A1",8155,9147,6059,3088,4788,2488,0,2493,1631,862,1.892111369,1432,1308,309,138,138,0,34,0,0.224637681,0,empty,CD-0722-4
"F11,A2",13829,15219,10420,4799,7793,3799,0,3799,2483,1316,1.886778116,2091,2745,520,215,212,3,69,1,0.160377358,0,empty,CD-0722-4
"F11,A3",7671,8367,5565,2802,4460,2223,0,2223,1511,712,2.122191011,1320,1497,288,126,123,3,40,2,0,0,empty,CD-0722-4
"F11,A4",11664,12801,8699,4102,6685,3354,0,3360,2215,1145,1.934497817,1889,855,182,71,70,1,25,1,0,0,empty,CD-0722-4
"F11,A5",15455,16942,11670,5272,8740,4209,0,4211,2846,1365,2.084981685,2372,5024,744,251,237,14,77,3,0.033755274,0,empty,CD-0722-4
"F11,A6",10494,11629,7747,3882,6151,3223,0,3225,2174,1051,2.068506185,1813,3189,585,262,261,1,78,1,0.134099617,0,empty,CD-0722-4
"F11,A7",18948,22117,13978,8139,11248,6469,0,6478,4596,1882,2.442082891,3720,1911,376,145,144,1,43,1,0.083333333,0,empty,CD-0722-4
"F11,A8",383835,428573,294149,134424,214056,106756,11,106858,82167,24691,3.327811753,60471,24397,4314,1549,1526,23,357,3,0.027522936,0,hg38,CD-0722-4
"F11,A9",9664,10838,7351,3487,5746,2841,5,2847,1986,861,2.306620209,1592,2077,482,176,175,1,53,1,0.04,0,empty,CD-0722-4
"F11,A10",9729,10721,7404,3317,5737,2879,2,2881,1898,983,1.930824008,1637,374,30,11,10,1,4,1,0,0,empty,CD-0722-4
"F11,A11",7530,7867,5814,2053,4101,1858,0,1861,1264,597,2.117252931,939,1664,338,138,136,2,38,2,0.125,0,empty,CD-0722-4
"F11,A12",12044,13271,9057,4214,6933,3444,12,3459,2374,1085,2.188018433,1957,3261,853,345,344,1,96,1,0.093023256,0,empty,CD-0722-4
"F11,B1",8328,9276,6184,3092,4911,2526,0,2526,1629,897,1.816053512,1459,1337,310,138,135,3,35,1,0.185185185,0,empty,CD-0722-4
"F11,B2",9752,10648,6737,3911,5720,3105,0,3108,1917,1191,1.609571788,1836,824,235,90,89,1,22,1,0.02247191,0,empty,CD-0722-4
"F11,B3",7655,8584,5652,2932,4458,2311,0,2312,1580,732,2.158469945,1357,1614,439,154,151,3,45,1,0.059602649,0,empty,CD-0722-4
"F11,B4",8269,9534,6057,3477,5035,2730,11,2742,1741,1001,1.739260739,1647,1315,186,71,68,3,26,1,0.044117647,0,empty,CD-0722-4
"F11,B5",1927748,1137980,724577,413403,718001,385093,21,387168,325104,62064,5.238205723,240547,65832,10391,3990,3913,77,747,6,0.030667007,0,hg38,CD-0722-4
"F11,B6",10554,11554,7650,3904,6214,3289,0,3295,2150,1145,1.877729258,1923,1900,592,216,214,2,56,1,0.014018692,0,empty,CD-0722-4
"F11,B7",13432,14831,10001,4830,7791,4077,1,4081,2680,1401,1.912919343,2244,1514,361,174,173,1,41,1,0.092485549,0,empty,CD-0722-4
"F11,B8",7704,8259,5817,2442,4430,2105,0,2110,1405,705,1.992907801,1167,1775,403,155,148,7,48,2,0.081081081,0,empty,CD-0722-4
"F11,B9",12584,13950,9427,4523,7227,3646,0,3648,2362,1286,1.836702955,2027,1493,457,182,182,0,47,0,0.016483516,0,empty,CD-0722-4
"F11,B10",7055,7650,5141,2509,4339,2183,0,2185,1415,770,1.837662338,1260,528,89,39,39,0,15,0,0.076923077,0,empty,CD-0722-4
"F11,B11",15296,17136,10774,6362,8871,4913,0,4918,2967,1951,1.520758585,2906,364,34,16,15,1,9,1,0,0,empty,CD-0722-4
"F11,B12",8824,9854,6436,3418,5315,2771,0,2778,1873,905,2.06961326,1585,2025,524,226,223,3,53,2,0.076233184,0,empty,CD-0722-4
"F11,C1",23782,25200,18042,7158,12889,6177,58,6239,4162,2077,2.003851709,3304,1658,422,183,179,4,44,1,0.016759777,0,empty,CD-0722-4
"F11,C2",1112434,1254854,846610,408244,607085,306890,1,307173,242909,64264,3.779861198,175153,143441,22310,8398,8234,164,1260,5,0.068860821,0,hg38,CD-0722-4
"F11,C3",12708,14234,9504,4730,7485,3767,0,3770,2498,1272,1.963836478,2165,936,115,44,43,1,18,1,0.023255814,0,empty,CD-0722-4
"F11,C4",8749,9744,6544,3200,5161,2543,0,2545,1741,804,2.165422886,1411,2361,483,224,221,3,59,2,0.131221719,0,empty,CD-0722-4
"F11,C5",11901,13088,8873,4215,6856,3401,15,3419,2264,1155,1.96017316,1907,2078,492,195,194,1,46,1,0.211340206,0,empty,CD-0722-4
"F11,C6",13774,15731,10044,5687,8332,4403,0,4406,3155,1251,2.521982414,2627,1631,381,169,165,4,45,1,0.078787879,0,empty,CD-0722-4
"F11,C7",13039,14794,9397,5397,7682,4143,0,4146,2541,1605,1.58317757,2422,493,87,39,38,1,16,1,0.289473684,0,empty,CD-0722-4
"F11,C8",15345,17177,11490,5687,9026,4647,0,4653,3152,1501,2.099933378,2576,3030,618,251,250,1,67,1,0.052,0,empty,CD-0722-4
"F11,C9",11977,13446,8814,4632,7052,3636,1,3639,2508,1131,2.217506631,2106,3025,488,181,177,4,51,2,0.18079096,0,empty,CD-0722-4
"F11,C10",11795,12755,8800,3955,6668,3287,6,3293,2147,1146,1.873472949,1799,2262,358,163,159,4,49,2,0.13836478,0,empty,CD-0722-4
"F11,C11",10395,11479,7650,3829,6107,3027,2,3038,1977,1061,1.863336475,1729,1875,392,169,167,2,51,2,0.113772455,0,empty,CD-0722-4
"F11,C12",15748,17088,11771,5317,8875,4315,0,4325,2860,1465,1.95221843,2437,2919,671,283,276,7,73,2,0.043478261,0,empty,CD-0722-4
"F11,D1",11635,12989,8502,4487,6882,3697,0,3701,2305,1396,1.651146132,2151,870,141,57,57,0,20,0,0.01754386,0,empty,CD-0722-4
"F11,D2",10483,11650,7878,3772,6022,2854,7,2864,1732,1132,1.530035336,1604,4244,1102,416,412,4,98,1,0.133495146,0,empty,CD-0722-4
"F11,D3",9251,10335,6742,3593,5510,2848,13,2862,1855,1007,1.842105263,1675,1787,461,203,202,1,44,1,0.094059406,0,empty,CD-0722-4
"F11,D4",9422,10660,7001,3659,5600,2756,0,2756,1901,855,2.223391813,1617,1636,416,160,156,4,46,1,0.076923077,0,empty,CD-0722-4
"F11,D5",8442,9192,6286,2906,4895,2385,0,2385,1518,867,1.750865052,1324,1512,389,155,153,2,45,1,0.098039216,0,empty,CD-0722-4
"F11,D6",12038,13243,8624,4619,6781,3679,0,3680,2289,1391,1.64557872,2117,2150,618,280,280,0,70,0,0.132142857,0,empty,CD-0722-4
"F11,D7",991542,1156983,725588,431395,566182,316402,2,316676,259042,57634,4.49460388,186735,47102,12886,4921,4890,31,1048,2,0.04601227,0,hg38,CD-0722-4
"F11,D8",8316,9289,6177,3112,4868,2428,0,2430,1597,833,1.917166867,1372,1251,197,89,88,1,34,1,0.113636364,0,empty,CD-0722-4
"F11,D9",4557,5096,3460,1636,2671,1270,0,1270,891,379,2.350923483,698,1946,415,161,155,6,40,2,0.135483871,0,empty,CD-0722-4
"F11,D10",2703422,3147845,1997657,1150188,1483748,835786,4,836510,709493,127017,5.585811348,497932,99092,17592,6866,6802,64,1232,4,0.045427815,0,hg38,CD-0722-4
"F11,D11",17704,19985,12738,7247,10227,5778,0,5785,3613,2172,1.663443831,3233,2691,936,373,369,4,87,2,0.043360434,0,empty,CD-0722-4
"F11,D12",2477091,2797106,1876931,920175,1310768,696938,3,697598,559948,137650,4.067911369,399738,456209,74912,29849,29330,519,3272,11,0.046334811,0,hg38,CD-0722-4
"F11,E1",16524,18440,12309,6131,9589,4885,0,4899,3136,1763,1.77878616,2807,2464,482,208,207,1,75,1,0.072463768,0,empty,CD-0722-4
"F11,E2",10536,11400,7736,3664,6130,3136,1,3139,1992,1147,1.736704446,1773,2398,366,152,149,3,41,1,0.147651007,0,empty,CD-0722-4
"F11,E3",9049,10351,6831,3520,5257,2506,17,2523,1627,896,1.815848214,1466,4793,1122,426,426,0,94,0,0.133802817,0,empty,CD-0722-4
"F11,E4",1179605,1343518,887729,455789,650614,338128,3,338449,258683,79766,3.243023343,196369,112051,17035,6868,6712,156,1123,7,0.054827175,0,hg38,CD-0722-4
"F11,E5",8284,9008,6238,2770,4752,2229,1,2230,1440,790,1.82278481,1238,1314,212,109,106,3,31,2,0.009433962,0,empty,CD-0722-4
"F11,E6",1211151,1348463,932239,416224,641150,318200,2,318498,246766,71732,3.440110411,178924,214353,28190,11360,11135,225,1771,7,0.039784463,0,hg38,CD-0722-4
"F11,E7",16358,17580,12346,5234,9159,4335,21,4363,3006,1357,2.215180545,2347,3785,1059,389,386,3,92,2,0.106217617,0,empty,CD-0722-4
"F11,E8",1765813,1961654,1386342,575312,924977,455742,4,456189,364781,91408,3.990690093,250366,207677,27169,10707,10420,287,1797,9,0.026295585,0,hg38,CD-0722-4
"F11,E9",8023,8823,5920,2903,4647,2315,0,2317,1611,706,2.281869688,1310,2526,532,227,223,4,65,2,0.035874439,0,empty,CD-0722-4
"F11,E10",8377,9068,6240,2828,4881,2408,0,2413,1592,821,1.93909866,1379,2294,691,220,220,0,51,0,0.104545455,0,empty,CD-0722-4
"F11,E11",10360,11480,7592,3888,6015,3142,0,3143,2077,1066,1.948405253,1793,2172,391,168,168,0,62,0,0.011904762,0,empty,CD-0722-4
"F11,E12",11566,12799,8459,4340,6793,3492,10,3507,2349,1158,2.028497409,2033,2222,612,227,226,1,58,1,0.048672566,0,empty,CD-0722-4
"F11,F1",12867,14085,9582,4503,7154,3579,6,3586,2328,1258,1.850556439,1962,2423,499,230,229,1,68,1,0.052401747,0,empty,CD-0722-4
"F11,F2",10668,11264,7912,3352,5956,2811,33,2851,1841,1010,1.822772277,1610,3527,578,228,226,2,71,1,0.057522124,0,empty,CD-0722-4
"F11,F3",10156,11461,7547,3914,6010,3001,0,3002,2062,940,2.193617021,1768,3089,844,369,363,6,91,3,0.132231405,0,empty,CD-0722-4
"F11,F4",14356,15632,10875,4757,8197,4017,1,4023,2630,1393,1.888011486,2204,739,128,61,60,1,24,1,0,0,empty,CD-0722-4
"F11,F5",1208797,1348475,907074,441401,646944,335307,2,335665,260338,75327,3.456104717,190643,146528,22302,8811,8631,180,1413,6,0.0324412,0,hg38,CD-0722-4
"F11,F6",15254,17270,11228,6042,8963,4644,11,4662,3325,1337,2.486910995,2718,3380,870,383,380,3,117,2,0.152631579,0,empty,CD-0722-4
"F11,F7",12855,14022,9557,4465,7572,3775,11,3798,2502,1296,1.930555556,2137,1477,399,159,158,1,35,1,0.151898734,0,empty,CD-0722-4
"F11,F8",1151079,1355418,853392,502026,662319,368618,19,368983,301085,67898,4.434372146,218776,30022,4070,1620,1589,31,323,2,0.039647577,0,hg38,CD-0722-4
"F11,F9",11025,12183,8201,3982,6433,3157,1,3160,2178,982,2.217922607,1820,2874,534,199,190,9,65,2,0.089473684,0,empty,CD-0722-4
"F11,F10",994560,1070876,763602,307274,523583,249015,0,249195,194519,54676,3.557666984,134691,89554,18371,6824,6712,112,1063,4,0.019815256,0,hg38,CD-0722-4
"F11,F11",10334,11392,7877,3515,5847,2769,2,2774,1890,884,2.13800905,1555,1656,354,134,134,0,37,0,0.059701493,0,empty,CD-0722-4
"F11,F12",13847,15446,10209,5237,7791,3815,0,3822,2611,1211,2.156069364,2222,264,59,23,22,1,9,1,0.363636364,0,empty,CD-0722-4
"F11,G1",2700992,3120157,2005957,1114200,1474490,827196,2,827911,654912,172999,3.785640379,484059,177396,38867,15081,14876,205,2208,9,0.038921753,0,hg38,CD-0722-4
"F11,G2",6883,7392,4972,2420,3848,1900,42,1943,1220,723,1.687413555,1134,454,159,81,81,0,24,0,0.037037037,0,empty,CD-0722-4
"F11,G3",14950,16233,11031,5202,8503,4261,11,4279,2617,1662,1.574608905,2376,2635,624,261,258,3,69,1,0.042635659,0,empty,CD-0722-4
"F11,G4",22561,25081,16435,8646,12979,7045,25,7081,4313,2768,1.55816474,4028,100,21,17,17,0,9,0,0.117647059,0,empty,CD-0722-4
"F11,G5",7471,8343,5575,2768,4253,2103,5,2112,1312,800,1.64,1200,1843,340,135,134,1,40,1,0.119402985,0,empty,CD-0722-4
"F11,G6",12011,13210,9020,4190,6839,3357,0,3364,2246,1118,2.008944544,1882,195,34,26,25,1,14,1,0.04,0,empty,CD-0722-4
"F11,G7",898043,992258,692115,300143,488457,236258,3,236514,174346,62168,2.804433149,132858,194665,22346,8737,8479,258,1380,9,0.04222196,0,hg38,CD-0722-4
"F11,G8",7307,8021,5473,2548,4272,2068,0,2073,1376,697,1.974175036,1180,2028,401,195,194,1,56,1,0.144329897,0,empty,CD-0722-4
"F11,G9",1264558,1478335,943557,534778,713198,396494,3,396847,320868,75979,4.223114282,233246,116718,19600,7983,7865,118,1326,5,0.022631914,0,hg38,CD-0722-4
"F11,G10",10988,12064,8150,3914,6443,3356,0,3361,2242,1119,2.00357462,1898,2898,986,351,345,6,85,2,0.07826087,0,empty,CD-0722-4
"F11,G11",11049,12288,8326,3962,6424,3136,0,3138,2121,1017,2.085545723,1785,1503,244,92,91,1,30,1,0.098901099,0,empty,CD-0722-4
"F11,G12",8031,9018,5904,3114,4729,2442,1,2444,1568,876,1.789954338,1448,2292,566,199,199,0,48,0,0.015075377,0,empty,CD-0722-4
"F11,H1",10153,11347,7547,3800,5905,2894,0,2894,2007,887,2.262683202,1658,1585,456,117,115,2,32,2,0.034782609,0,empty,CD-0722-4
"F11,H2",9487,10811,7076,3735,5717,2941,0,2949,1954,995,1.963819095,1706,2711,684,308,307,1,74,1,0.140065147,0,empty,CD-0722-4
"F11,H3",8883,9901,6579,3322,5264,2774,0,2776,1839,937,1.962646745,1580,1508,357,150,149,1,50,1,0.040268456,0,empty,CD-0722-4
"F11,H4",12031,13294,8964,4330,6813,3339,7,3348,2198,1150,1.911304348,1899,217,28,19,19,0,9,0,0.105263158,0,empty,CD-0722-4
"F11,H5",13051,13906,9701,4205,7307,3567,1,3577,2377,1200,1.980833333,1980,2590,644,261,260,1,61,1,0.215384615,0,empty,CD-0722-4
"F11,H6",9715,10705,6951,3754,5521,2847,0,2847,1919,928,2.067887931,1677,2422,631,232,231,1,68,1,0.03030303,0,empty,CD-0722-4
"F11,H7",9157,9991,6956,3035,5170,2453,1,2459,1598,861,1.855981417,1391,1757,409,199,198,1,57,1,0.03030303,0,empty,CD-0722-4
"F11,H8",12815,14402,9370,5032,7508,3988,1,3995,2703,1292,2.092105263,2301,2691,480,208,206,2,87,2,0.077669903,0,empty,CD-0722-4
"F11,H9",8909,9664,6720,2944,5051,2336,0,2340,1601,739,2.166441137,1297,1276,344,120,120,0,37,0,0.1,0,empty,CD-0722-4
"F11,H10",7111,7923,5371,2552,4090,2024,0,2024,1374,650,2.113846154,1161,1278,206,100,99,1,38,1,0.03030303,0,empty,CD-0722-4
"F11,H11",8384,9609,5907,3702,5003,3011,0,3015,1700,1315,1.292775665,1791,58,5,3,3,0,2,0,0,0,empty,CD-0722-4
"F11,H12",8949,9805,6574,3231,5036,2486,0,2492,1745,747,2.33601071,1400,1894,444,174,174,0,46,0,0.08045977,0,empty,CD-0722-4
"F12,A1",9210,10505,6579,3926,5564,2988,0,2988,2040,948,2.151898734,1783,1610,371,157,157,0,39,0,0.095541401,0,empty,CD-0722-4
"F12,A2",19070,21557,14262,7295,11056,5750,16,5768,3953,1815,2.177961433,3218,3087,585,251,250,1,82,1,0.052,0,empty,CD-0722-4
"F12,A3",8362,9452,6127,3325,4997,2578,0,2580,1795,785,2.286624204,1486,1470,449,192,191,1,41,1,0.120418848,0,empty,CD-0722-4
"F12,A4",12277,13654,9313,4341,7116,3558,1,3569,2286,1283,1.781761496,1982,829,145,65,65,0,28,0,0.092307692,0,empty,CD-0722-4
"F12,A5",13851,15225,10410,4815,8100,4028,0,4039,2739,1300,2.106923077,2269,2913,679,280,280,0,71,0,0.028571429,0,empty,CD-0722-4
"F12,A6",12449,14149,9350,4799,7365,3907,1,3910,2687,1223,2.197056419,2184,3611,755,284,279,5,89,1,0.093189964,0,empty,CD-0722-4
"F12,A7",8502,9475,6215,3260,4985,2596,0,2598,1707,891,1.915824916,1474,1659,359,145,141,4,44,3,0.007092199,0,empty,CD-0722-4
"F12,A8",1140987,1317187,854921,462266,646027,348336,0,348618,275971,72647,3.798794169,203767,286158,46906,18031,17727,304,2325,8,0.057764991,0,hg38,CD-0722-4
"F12,A9",11824,13193,8841,4352,6896,3534,3,3539,2505,1034,2.422630561,2009,2079,479,204,203,1,49,1,0.049261084,0,empty,CD-0722-4
"F12,A10",13101,14621,10059,4562,7457,3678,0,3683,2558,1125,2.273777778,2029,611,130,55,54,1,18,1,0.092592593,0,empty,CD-0722-4
"F12,A11",8763,9574,6641,2933,5093,2403,22,2427,1682,745,2.257718121,1343,2003,492,188,185,3,39,2,0.243243243,0,empty,CD-0722-4
"F12,A12",14505,15850,11143,4707,8196,3909,0,3912,2688,1224,2.196078431,2138,4040,910,354,347,7,90,2,0.100864553,0,empty,CD-0722-4
"F12,B1",2202575,2458633,1676844,781789,1155801,597105,2,597696,464106,133590,3.474107343,339826,208456,26132,9894,9624,270,1528,7,0.048628429,0,hg38,CD-0722-4
"F12,B2",9072,9986,6179,3807,5330,2891,18,2914,1863,1051,1.772597526,1714,558,50,26,25,1,10,1,0.32,0,empty,CD-0722-4
"F12,B3",9031,10313,6610,3703,5477,2838,0,2840,1960,880,2.227272727,1676,1794,447,225,223,2,51,1,0.107623318,0,empty,CD-0722-4
"F12,B4",9838,11303,7173,4130,5972,3202,0,3208,2105,1103,1.90843155,1933,1647,398,155,153,2,44,2,0.137254902,0,empty,CD-0722-4
"F12,B5",24384,23566,14569,8997,12933,7158,5,7183,5501,1682,3.270511296,4388,1141,175,71,71,0,23,0,0.23943662,0,empty,CD-0722-4
"F12,B6",13302,15292,9627,5665,7971,4455,0,4457,2934,1523,1.926460932,2607,2103,664,276,275,1,67,1,0.090909091,0,empty,CD-0722-4
"F12,B7",9804,10743,7416,3327,5818,2842,0,2842,1886,956,1.972803347,1596,1330,346,143,141,2,47,2,0.014184397,0,empty,CD-0722-4
"F12,B8",10012,10867,7553,3314,5773,2971,0,2974,2067,907,2.278941566,1652,1434,249,92,91,1,38,1,0.131868132,0,empty,CD-0722-4
"F12,B9",14841,16876,11048,5828,8736,4544,1,4553,3027,1526,1.9836173,2701,1334,321,133,130,3,46,3,0.069230769,0,empty,CD-0722-4
"F12,B10",807447,892133,575884,316249,459826,240825,8,241285,193945,47340,4.096852556,141736,38154,3388,1334,1269,65,314,3,0.033884949,0,hg38,CD-0722-4
"F12,B11",16324,18552,11596,6956,9385,5219,21,5247,3174,2073,1.531114327,3089,212,38,18,18,0,8,0,0,0,empty,CD-0722-4
"F12,B12",10400,11700,7688,4012,6071,3139,0,3139,2208,931,2.371643394,1747,2355,499,177,176,1,53,1,0.028409091,0,empty,CD-0722-4
"F12,C1",18311,19637,13798,5839,10435,5021,0,5025,3328,1697,1.961107837,2778,1350,429,155,153,2,45,1,0.071895425,0,empty,CD-0722-4
"F12,C2",13081,14468,9676,4792,7605,3922,0,3924,2671,1253,2.131683958,2211,2826,616,233,231,2,71,1,0.012987013,0,empty,CD-0722-4
"F12,C3",1644448,1900204,1242101,658103,903009,485679,4,486155,382595,103560,3.694428351,283318,58840,5446,2249,2200,49,472,3,0.028181818,0,hg38,CD-0722-4
"F12,C4",10727,12086,8115,3971,6278,3092,0,3101,2117,984,2.151422764,1747,2745,623,232,228,4,61,1,0.004385965,0,empty,CD-0722-4
"F12,C5",13520,15042,9853,5189,7891,4082,0,4089,2838,1251,2.268585132,2369,2626,655,259,250,9,56,2,0.032,0,empty,CD-0722-4
"F12,C6",2491954,3014514,1765850,1248664,1477926,915391,4,916273,761944,154329,4.937140784,570413,19718,8537,2862,2856,6,644,2,0.021008403,0,hg38,CD-0722-4
"F12,C7",6169682,7178315,4530893,2647422,3233156,1992620,6,1994268,1517355,476913,3.181618031,1177543,76756,16195,6107,6034,73,1047,5,0.033808419,0,hg38,CD-0722-4
"F12,C8",16626,18163,12328,5835,9495,4756,0,4758,3235,1523,2.124097177,2641,3403,888,356,354,2,86,2,0.053672316,0,empty,CD-0722-4
"F12,C9",1498122,1814350,1109804,704546,881376,520374,1,520804,416308,104496,3.983961109,316393,16947,4272,1627,1608,19,344,2,0.117537313,0,hg38,CD-0722-4
"F12,C10",12459,13775,9346,4429,7217,3606,0,3607,2440,1167,2.090831191,2032,2434,483,166,161,5,52,2,0.105590062,0,empty,CD-0722-4
"F12,C11",11757,12947,8674,4273,6850,3382,0,3382,2262,1120,2.019642857,1934,2431,559,187,185,2,54,2,0.102702703,0,empty,CD-0722-4
"F12,C12",18220,19925,13717,6208,10306,5018,0,5021,3511,1510,2.325165563,2765,2558,652,285,279,6,68,3,0.107526882,0,empty,CD-0722-4
"F12,D1",13022,14625,9404,5221,7783,4227,0,4237,2708,1529,1.771092217,2469,1194,215,93,92,1,22,1,0.054347826,0,empty,CD-0722-4
"F12,D2",10020,10821,7653,3168,5675,2625,0,2634,1727,907,1.904079383,1447,3706,1168,401,401,0,101,0,0.059850374,0,empty,CD-0722-4
"F12,D3",10598,11993,7740,4253,6265,3289,0,3291,2169,1122,1.93315508,1946,2350,381,148,142,6,46,1,0,0,empty,CD-0722-4
"F12,D4",8942,9794,6635,3159,5266,2688,0,2692,1844,848,2.174528302,1567,1994,418,159,157,2,47,1,0.050955414,0,empty,CD-0722-4
"F12,D5",747080,917712,504324,413388,456091,307428,1,307642,221828,85814,2.584986133,189541,5672,791,270,264,6,74,2,0.128787879,0,hg38,CD-0722-4
"F12,D6",13273,14687,9483,5204,7523,3988,15,4011,2493,1518,1.64229249,2254,3112,779,268,267,1,79,1,0.108614232,0,empty,CD-0722-4
"F12,D7",7519,8081,5706,2375,4245,2009,0,2009,1414,595,2.376470588,1105,2190,529,183,182,1,55,1,0.120879121,0,empty,CD-0722-4
"F12,D8",10421,11509,7487,4022,6036,3124,1,3129,2120,1009,2.101090188,1804,1207,206,78,78,0,23,0,0.205128205,0,empty,CD-0722-4
"F12,D9",5343,6004,3969,2035,3239,1529,0,1529,1053,476,2.212184874,893,2158,442,159,158,1,39,1,0.101265823,0,empty,CD-0722-4
"F12,D10",11755,13250,8568,4682,6993,3750,2,3756,2520,1236,2.038834951,2183,864,179,67,67,0,25,0,0.104477612,0,empty,CD-0722-4
"F12,D11",10220,11249,7577,3672,5959,2916,3,2919,1897,1022,1.856164384,1683,3370,881,370,370,0,84,0,0.008108108,0,empty,CD-0722-4
"F12,D12",14135,15737,10653,5084,8189,4075,0,4076,2784,1292,2.154798762,2271,3832,844,349,340,9,103,1,0.085294118,0,empty,CD-0722-4
"F12,E1",19578,21500,14714,6786,11210,5523,9,5537,3724,1813,2.054054054,3108,2943,633,253,250,3,70,1,0.112,0,empty,CD-0722-4
"F12,E2",12212,13602,8917,4685,7140,3682,0,3688,2466,1222,2.018003273,2129,2714,613,192,188,4,45,1,0.132978723,0,empty,CD-0722-4
"F12,E3",7462,8394,5640,2754,4376,2167,16,2184,1439,745,1.931543624,1212,3034,668,274,269,5,69,2,0.081784387,0,empty,CD-0722-4
"F12,E4",12662,14345,9337,5008,7457,3853,0,3856,2636,1220,2.160655738,2265,2935,760,311,309,2,89,2,0.064724919,0,empty,CD-0722-4
"F12,E5",9097,9739,7044,2695,5065,2312,1,2320,1552,768,2.020833333,1249,1942,421,168,168,0,55,0,0.107142857,0,empty,CD-0722-4
"F12,E6",18526,20940,13623,7317,10734,5623,0,5625,3765,1860,2.024193548,3274,4153,905,334,331,3,99,1,0.039274924,0,empty,CD-0722-4
"F12,E7",19051,21545,14262,7283,11195,5683,0,5690,3902,1788,2.182326622,3310,3340,887,323,321,2,87,1,0.140186916,0,empty,CD-0722-4
"F12,E8",13869,15200,10537,4663,8066,3803,9,3812,2618,1194,2.192629816,2108,2942,786,324,322,2,77,2,0.074534161,0,empty,CD-0722-4
"F12,E9",1967598,2343204,1435981,907223,1123172,652321,4,652875,532702,120173,4.432792724,393182,469877,102449,39790,39339,451,3830,8,0.044866418,0,hg38,CD-0722-4
"F12,E10",9450,10640,7047,3593,5469,2773,0,2779,1794,985,1.821319797,1583,2120,517,218,214,4,53,3,0.224299065,0,empty,CD-0722-4
"F12,E11",12475,13512,9037,4475,7331,3822,0,3826,2556,1270,2.012598425,2148,2868,614,234,232,2,60,1,0.077586207,0,empty,CD-0722-4
"F12,E12",13802,15594,10250,5344,8124,4122,0,4130,2849,1281,2.224043716,2381,2162,349,152,149,3,51,2,0.013422819,0,empty,CD-0722-4
"F12,F1",13723,14685,10074,4611,7598,3822,0,3831,2483,1348,1.841988131,2156,2697,684,234,234,0,79,0,0.08974359,0,empty,CD-0722-4
"F12,F2",12596,13881,9501,4380,7132,3417,0,3421,2282,1139,2.003511853,1930,3065,1091,386,385,1,81,1,0.05974026,0,empty,CD-0722-4
"F12,F3",11985,13200,8842,4358,6859,3369,0,3377,2248,1129,1.991142604,1929,2968,766,345,344,1,79,1,0.049418605,0,empty,CD-0722-4
"F12,F4",15953,17481,11841,5640,9126,4450,0,4457,3019,1438,2.099443672,2552,796,157,54,53,1,21,1,0,0,empty,CD-0722-4
"F12,F5",12117,12971,9082,3889,6854,3200,0,3204,2098,1106,1.896925859,1800,3166,728,280,278,2,71,2,0.097122302,0,empty,CD-0722-4
"F12,F6",19788,22608,14548,8060,11581,6228,2,6230,4500,1730,2.601156069,3642,5396,1238,486,484,2,119,2,0.092975207,0,empty,CD-0722-4
"F12,F7",14267,16141,10593,5548,8506,4350,0,4366,2886,1480,1.95,2506,1248,358,150,147,3,35,2,0.088435374,0,empty,CD-0722-4
"F12,F8",11650,12989,8833,4156,6748,3251,0,3258,2241,1017,2.203539823,1757,375,109,67,67,0,19,0,0,0,empty,CD-0722-4
"F12,F9",12404,13421,9356,4065,7075,3383,0,3383,2386,997,2.393179539,1868,3335,895,323,322,1,84,1,0.102484472,0,empty,CD-0722-4
"F12,F10",3919554,4353885,2988138,1365747,1982174,1065196,3,1066276,882325,183951,4.7965219,598161,275557,34849,13153,12835,318,1889,10,0.034281262,0,hg38,CD-0722-4
"F12,F11",11726,12944,8931,4013,6653,3074,0,3076,2135,941,2.268862912,1703,1966,446,134,133,1,36,1,0.007518797,0,empty,CD-0722-4
"F12,F12",12531,13816,9223,4593,7207,3655,0,3658,2478,1180,2.1,2085,241,34,23,22,1,13,1,0,0,empty,CD-0722-4
"F12,G1",14061,14858,10625,4233,7950,3799,0,3804,2554,1250,2.0432,2035,4343,932,401,397,4,101,2,0.065491184,0,empty,CD-0722-4
"F12,G2",7041,7985,4948,3037,4068,2162,0,2167,1366,801,1.70536829,1352,352,48,29,28,1,15,1,0.178571429,0,empty,CD-0722-4
"F12,G3",13898,15184,10261,4923,7999,4104,0,4108,2604,1504,1.731382979,2280,2820,528,234,232,2,65,1,0.142241379,0,empty,CD-0722-4
"F12,G4",25490,28652,18361,10291,14799,8127,0,8135,5080,3055,1.662847791,4782,158,7,7,7,0,6,0,0.285714286,0,empty,CD-0722-4
"F12,G5",9655,11212,7075,4137,5749,3011,0,3014,2056,958,2.146137787,1793,1895,467,166,165,1,46,1,0.006060606,0,empty,CD-0722-4
"F12,G6",13146,14425,9981,4444,7630,3827,0,3829,2627,1202,2.185524126,2145,237,34,21,20,1,14,1,0,0,empty,CD-0722-4
"F12,G7",11592,12650,8765,3885,6592,3101,0,3106,2145,961,2.232049948,1749,3391,694,271,268,3,81,1,0.074626866,0,empty,CD-0722-4
"F12,G8",970000,1128897,716853,412044,550278,301164,1,301448,225798,75650,2.984771976,179824,59076,12852,4807,4773,34,860,5,0.04336895,0,hg38,CD-0722-4
"F12,G9",940279,1098703,691987,406716,535275,297731,30,298016,236476,61540,3.842638934,177903,118893,16927,6414,6316,98,1194,6,0.049398353,0,hg38,CD-0722-4
"F12,G10",920249,1002746,711309,291437,489038,232844,0,233107,188608,44499,4.238477269,128824,83551,20033,7477,7392,85,1074,3,0.011498918,0,hg38,CD-0722-4
"F12,G11",12614,13872,9502,4370,7180,3507,1,3513,2457,1056,2.326704545,1956,2360,437,186,186,0,45,0,0.064516129,0,empty,CD-0722-4
"F12,G12",8786,9739,6490,3249,5155,2693,1,2695,1715,980,1.75,1500,2662,984,312,307,5,59,2,0.013029316,0,empty,CD-0722-4
"F12,H1",13040,14471,9538,4933,7578,3783,2,3789,2627,1162,2.260757315,2218,1960,469,200,199,1,44,1,0.015075377,0,empty,CD-0722-4
"F12,H2",10605,11709,7725,3984,6217,3259,1,3265,2121,1144,1.854020979,1898,2593,633,259,259,0,57,0,0.131274131,0,empty,CD-0722-4
"F12,H3",11341,12608,8197,4411,6594,3535,1,3536,2443,1093,2.235132662,2086,1913,486,191,191,0,61,0,0.036649215,0,empty,CD-0722-4
"F12,H4",12929,13855,9722,4133,7188,3449,3,3454,2323,1131,2.053934571,1871,268,23,11,10,1,4,1,0.1,0,empty,CD-0722-4
"F12,H5",14869,16644,11165,5479,8436,4211,0,4220,2887,1333,2.165791448,2393,3086,717,266,259,7,67,2,0.054054054,0,empty,CD-0722-4
"F12,H6",10729,11949,7975,3974,6295,3221,0,3221,2257,964,2.341286307,1873,3056,827,375,374,1,77,1,0.085561497,0,empty,CD-0722-4
"F12,H7",10219,11267,7660,3607,5903,2896,0,2905,1950,955,2.041884817,1584,2252,427,187,186,1,49,1,0.134408602,0,empty,CD-0722-4
"F12,H8",41445,48145,30708,17437,24767,13276,4,13293,10289,3004,3.425099867,7823,2869,560,225,224,1,81,1,0.049107143,0,empty,CD-0722-4
"F12,H9",10618,11497,8120,3377,5854,2765,0,2772,1920,852,2.253521127,1487,1398,360,153,153,0,47,0,0.08496732,0,empty,CD-0722-4
"F12,H10",7764,8748,5777,2971,4418,2159,1,2162,1413,749,1.886515354,1204,1328,292,90,89,1,31,1,0.157303371,0,empty,CD-0722-4
"F12,H11",9609,10630,6734,3896,5482,3235,3,3246,1770,1476,1.199186992,1850,58,3,2,2,0,2,0,0,0,empty,CD-0722-4
"F12,H12",11047,12134,8279,3855,6199,3183,0,3185,2245,940,2.388297872,1736,1885,364,164,163,1,35,1,0.116564417,0,empty,CD-0722-4
"G1,A1",9301,10189,6860,3329,5412,2830,0,2830,1923,907,2.120176406,1575,1039,300,114,113,1,33,1,0.088495575,0,empty,CD-0722-4
"G1,A2",14247,15479,10572,4907,8298,4221,1,4228,2863,1365,2.097435897,2371,1599,356,159,156,3,44,2,0.179487179,0,empty,CD-0722-4
"G1,A3",8661,9498,6329,3169,5031,2556,0,2556,1744,812,2.147783251,1455,1109,284,100,100,0,30,0,0.05,0,empty,CD-0722-4
"G1,A4",12543,13813,9305,4508,7345,3694,0,3696,2455,1241,1.978243352,2090,821,228,84,84,0,23,0,0.023809524,0,empty,CD-0722-4
"G1,A5",16796,18559,12539,6020,9787,4865,24,4900,3413,1487,2.295225286,2780,3516,518,220,216,4,57,2,0.111111111,0,empty,CD-0722-4
"G1,A6",830909,1001519,610446,391073,495647,283445,5,283696,228655,55041,4.154266819,171900,78708,17860,6947,6898,49,1207,3,0.049724558,0,hg38,CD-0722-4
"G1,A7",8742,9634,6541,3093,5070,2656,0,2658,1725,933,1.848874598,1471,1120,325,138,138,0,33,0,0.101449275,0,empty,CD-0722-4
"G1,A8",1145353,1291775,875160,416615,636398,324665,3,325009,273864,51145,5.354658324,185972,135863,16299,6260,6121,139,1091,6,0.03512498,0,hg38,CD-0722-4
"G1,A9",14139,15952,10662,5290,8330,4262,0,4263,3004,1259,2.386020651,2445,1914,401,167,159,8,49,2,0.056603774,0,empty,CD-0722-4
"G1,A10",12141,13322,9251,4071,6990,3388,26,3415,2311,1104,2.093297101,1855,365,44,27,27,0,18,0,0.148148148,0,empty,CD-0722-4
"G1,A11",8928,9865,6855,3010,5231,2490,0,2497,1773,724,2.448895028,1369,1432,325,123,121,2,35,2,0,0,empty,CD-0722-4
"G1,A12",14434,15912,10931,4981,8521,4133,0,4141,2886,1255,2.299601594,2345,2908,779,311,305,6,82,2,0.052459016,0,empty,CD-0722-4
"G1,B1",9748,10484,7326,3158,5495,2678,4,2686,1817,869,2.090909091,1437,1672,508,242,242,0,46,0,0.053719008,0,empty,CD-0722-4
"G1,B2",9066,10099,6234,3865,5371,2894,0,2894,1901,993,1.914400806,1739,686,101,43,43,0,17,0,0.23255814,0,empty,CD-0722-4
"G1,B3",11480,13019,8321,4698,6861,3577,2,3579,2522,1057,2.385998108,2120,1880,463,188,188,0,44,0,0.085106383,0,empty,CD-0722-4
"G1,B4",835227,928360,630775,297585,460663,232576,2,232813,183398,49415,3.711383183,132194,88521,13418,5257,5134,123,923,8,0.033502143,0.008130081,hg38,CD-0722-4
"G1,B5",9974,6086,3727,2359,4097,2164,0,2176,1504,672,2.238095238,1395,710,190,74,74,0,23,0,0,0,empty,CD-0722-4
"G1,B6",12643,14383,9290,5093,7575,4105,0,4111,2717,1394,1.949067432,2444,1369,367,139,139,0,37,0,0.09352518,0,empty,CD-0722-4
"G1,B7",10412,11538,7852,3686,6248,3061,0,3066,2087,979,2.131767109,1797,1409,508,161,160,1,38,1,0.04375,0,empty,CD-0722-4
"G1,B8",10455,11459,7966,3493,6073,2912,34,2956,2084,872,2.389908257,1599,1088,145,75,73,2,21,2,0.246575342,0,empty,CD-0722-4
"G1,B9",14204,15827,10416,5411,8331,4401,0,4407,2928,1479,1.979716024,2574,996,206,95,93,2,31,1,0.096774194,0,empty,CD-0722-4
"G1,B10",8992,9701,6450,3251,5408,2756,0,2759,1940,819,2.368742369,1588,543,179,60,60,0,16,0,0.066666667,0,empty,CD-0722-4
"G1,B11",15416,17072,11204,5868,8822,4719,0,4725,2854,1871,1.525387493,2758,337,79,40,39,1,15,1,0,0,empty,CD-0722-4
"G1,B12",10355,11672,7661,4011,6216,3236,0,3236,2274,962,2.363825364,1879,1676,533,198,196,2,42,2,0.107142857,0,empty,CD-0722-4
"G1,C1",21125,22907,15934,6973,12138,5845,0,5853,3885,1968,1.974085366,3186,1161,178,64,62,2,29,1,0.064516129,0,empty,CD-0722-4
"G1,C2",13761,15096,9964,5132,7900,4090,0,4100,2736,1364,2.005865103,2307,2010,444,171,167,4,51,3,0.083832335,0,empty,CD-0722-4
"G1,C3",1075533,1229106,804241,424865,606543,320086,4,320417,240832,79585,3.026097883,188451,50585,6118,2444,2407,37,430,4,0.059825509,0,hg38,CD-0722-4
"G1,C4",10733,11626,8165,3461,6197,3052,1,3056,2130,926,2.300215983,1676,1519,370,149,149,0,39,0,0.10738255,0,empty,CD-0722-4
"G1,C5",14508,16260,10674,5586,8653,4526,1,4531,3087,1444,2.137811634,2628,1865,476,163,162,1,47,1,0.024691358,0,empty,CD-0722-4
"G1,C6",11673,13315,8595,4720,7186,3763,0,3768,2517,1251,2.011990408,2218,2438,497,225,220,5,58,2,0.095454545,0,empty,CD-0722-4
"G1,C7",15121,17179,11013,6166,9027,4944,0,4951,3129,1822,1.717343578,2932,432,37,18,18,0,9,0,0,0,empty,CD-0722-4
"G1,C8",17542,19119,13060,6059,9977,5103,0,5108,3493,1615,2.162848297,2809,3915,939,331,324,7,84,2,0.040123457,0,empty,CD-0722-4
"G1,C9",12968,14621,9587,5034,7800,3997,0,4000,2731,1269,2.152088258,2299,1406,169,83,74,9,30,2,0.108108108,0,empty,CD-0722-4
"G1,C10",992164,1107678,755609,352069,540025,270267,1,270551,195475,75076,2.603694922,154687,169210,15349,6207,5979,228,1089,6,0.041144004,0,hg38,CD-0722-4
"G1,C11",12075,13461,8963,4498,7260,3698,0,3702,2515,1187,2.118786858,2173,2695,559,230,227,3,63,2,0.070484581,0,empty,CD-0722-4
"G1,C12",1185497,1301408,906985,394423,626911,304561,14,304906,240450,64456,3.730451781,171066,127178,21270,8262,8119,143,1312,3,0.043601429,0,hg38,CD-0722-4
"G1,D1",14769,16548,10516,6032,8690,4696,0,4697,2899,1798,1.612347052,2795,1110,168,80,80,0,18,0,0.15,0,empty,CD-0722-4
"G1,D2",10177,11139,7539,3600,5982,2898,1,2904,1868,1036,1.803088803,1675,2514,742,298,293,5,79,2,0.081911263,0,empty,CD-0722-4
"G1,D3",10837,11751,8127,3624,6253,3087,1,3091,2109,982,2.147657841,1668,1105,193,86,85,1,22,1,0,0,empty,CD-0722-4
"G1,D4",9192,10587,6911,3676,5528,2810,0,2814,1917,897,2.137123746,1654,1643,493,161,161,0,48,0,0.00621118,0,empty,CD-0722-4
"G1,D5",9294,10201,6774,3427,5471,2773,1,2777,1904,873,2.180985109,1595,1736,171,88,88,0,29,0,0.147727273,0,empty,CD-0722-4
"G1,D6",12839,14355,9210,5145,7450,4017,0,4021,2487,1534,1.62125163,2383,1475,418,174,171,3,50,1,0.023391813,0,empty,CD-0722-4
"G1,D7",7629,8400,5762,2638,4447,2147,0,2152,1459,693,2.105339105,1151,2094,581,216,210,6,51,2,0.080952381,0,empty,CD-0722-4
"G1,D8",10144,11347,7637,3710,5937,2882,1,2885,1949,936,2.082264957,1642,1011,203,99,98,1,31,1,0.06122449,0,empty,CD-0722-4
"G1,D9",5321,5869,3927,1942,3074,1472,0,1472,1007,465,2.165591398,828,1293,267,126,125,1,44,1,0.096,0,empty,CD-0722-4
"G1,D10",9405,10757,6808,3949,5793,3081,3,3087,2046,1041,1.965417867,1845,1088,321,104,103,1,24,1,0.009708738,0,empty,CD-0722-4
"G1,D11",839933,949880,628955,320925,468156,244204,0,244398,184867,59531,3.105390469,141601,147662,18579,7508,7356,152,1297,8,0.045405111,0,hg38,CD-0722-4
"G1,D12",14169,15653,10653,5000,8365,4104,5,4114,2916,1198,2.434056761,2274,3456,790,336,333,3,95,1,0.03003003,0,empty,CD-0722-4
"G1,E1",20188,22082,15151,6931,11653,5839,0,5847,4017,1830,2.195081967,3283,2254,500,206,202,4,64,2,0.059405941,0,empty,CD-0722-4
"G1,E2",12210,13965,8779,5186,7169,3720,9,3733,2484,1249,1.988791033,2174,2261,504,190,184,6,48,2,0.016304348,0,empty,CD-0722-4
"G1,E3",7711,8583,5820,2763,4462,2179,0,2181,1468,713,2.058906031,1233,2450,742,312,308,4,66,2,0.058441558,0,empty,CD-0722-4
"G1,E4",13549,14857,10094,4763,8049,4149,25,4177,2891,1286,2.248055988,2333,2103,504,193,190,3,62,2,0.078947368,0,empty,CD-0722-4
"G1,E5",8902,9602,6582,3020,5089,2413,0,2421,1602,819,1.956043956,1374,1532,358,125,123,2,27,2,0.016260163,0,empty,CD-0722-4
"G1,E6",18931,20615,14440,6175,10747,5261,6,5271,3599,1672,2.152511962,2879,3415,867,352,343,9,87,2,0.040816327,0,empty,CD-0722-4
"G1,E7",24616,27147,18449,8698,14046,6906,0,6916,4884,2032,2.403543307,3864,5540,869,329,315,14,85,3,0.053968254,0,empty,CD-0722-4
"G1,E8",14637,15754,11196,4558,8388,3976,0,3978,2773,1205,2.301244813,2157,3310,741,255,252,3,61,1,0.142857143,0,empty,CD-0722-4
"G1,E9",9325,10647,6868,3779,5573,2921,0,2921,1988,933,2.130760986,1698,2436,464,213,212,1,57,1,0.070754717,0,empty,CD-0722-4
"G1,E10",9081,9942,6821,3121,5349,2702,8,2716,1790,926,1.933045356,1533,1475,368,163,161,2,48,2,0.00621118,0,empty,CD-0722-4
"G1,E11",11828,13018,8812,4206,6983,3551,0,3556,2344,1212,1.933993399,1976,1919,426,185,181,4,44,1,0.093922652,0,empty,CD-0722-4
"G1,E12",13961,15521,10317,5204,8262,4273,0,4276,2944,1332,2.21021021,2394,1810,455,190,188,2,52,1,0.037234043,0,empty,CD-0722-4
"G1,F1",23353,24548,18051,6497,12745,5426,0,5434,3778,1656,2.281400966,2981,5952,1448,522,510,12,129,2,0.023529412,0,empty,CD-0722-4
"G1,F2",643762,752189,451272,300917,386597,241240,1,241400,148690,92710,1.603818358,146056,5303,1475,445,442,3,105,2,0.07239819,0,hg38,CD-0722-4
"G1,F3",1067146,1244840,779964,464876,613809,342075,20,342394,272557,69837,3.902759282,204687,249058,42206,16517,16216,301,2184,9,0.043907252,0,hg38,CD-0722-4
"G1,F4",16027,17195,11890,5305,9163,4560,1,4562,3100,1462,2.120383037,2501,506,95,39,39,0,21,0,0,0,empty,CD-0722-4
"G1,F5",12490,13505,9425,4080,7107,3301,16,3317,2231,1086,2.054327808,1848,2098,405,174,171,3,50,1,0.023391813,0,empty,CD-0722-4
"G1,F6",991634,1143738,721530,422208,565092,332654,3,332940,224209,108731,2.062052221,196101,34607,3145,1202,1151,51,308,5,0.132927889,0,hg38,CD-0722-4
"G1,F7",14761,16698,11015,5683,8940,4528,0,4530,3088,1442,2.14147018,2591,1075,355,139,139,0,34,0,0,0,empty,CD-0722-4
"G1,F8",11839,13025,8822,4203,6868,3344,0,3348,2354,994,2.368209256,1844,257,89,43,43,0,13,0,0,0,empty,CD-0722-4
"G1,F9",12279,13731,9147,4584,7326,3637,1,3640,2573,1067,2.411433927,2140,3022,693,240,232,8,60,2,0.112068966,0,empty,CD-0722-4
"G1,F10",15372,16564,11747,4817,8841,4232,0,4242,2927,1315,2.225855513,2280,1842,474,171,171,0,58,0,0.01754386,0,empty,CD-0722-4
"G1,F11",11688,12818,8828,3990,6713,3241,0,3245,2206,1039,2.12319538,1792,1218,350,127,125,2,31,1,0,0,empty,CD-0722-4
"G1,F12",12905,14164,9508,4656,7425,3715,0,3717,2505,1212,2.066831683,2122,206,13,10,10,0,8,0,0,0,empty,CD-0722-4
"G1,G1",13930,15521,10390,5131,8295,4091,2,4100,2785,1315,2.117870722,2333,2544,578,200,198,2,59,2,0.03030303,0,empty,CD-0722-4
"G1,G2",7321,7884,5078,2806,4313,2223,24,2251,1473,778,1.893316195,1323,538,138,69,65,4,22,1,0.246153846,0,empty,CD-0722-4
"G1,G3",13639,14684,10105,4579,7721,3740,0,3744,2365,1379,1.715010877,2014,2067,484,210,208,2,59,2,0.110576923,0,empty,CD-0722-4
"G1,G4",24876,27616,17888,9728,14283,7859,1,7869,4876,2993,1.629134648,4517,63,3,2,2,0,2,0,0,0,empty,CD-0722-4
"G1,G5",886290,1027581,657581,370000,506779,275171,1,275407,206058,69349,2.971318981,163294,126206,17378,6832,6680,152,1102,6,0.029640719,0,hg38,CD-0722-4
"G1,G6",12531,13658,9327,4331,7042,3474,0,3474,2388,1086,2.198895028,1929,123,13,9,9,0,4,0,0,0,empty,CD-0722-4
"G1,G7",11486,12757,8738,4019,6862,3284,0,3290,2278,1012,2.250988142,1905,2914,641,270,266,4,70,1,0.071428571,0,empty,CD-0722-4
"G1,G8",8318,8945,6175,2770,4891,2391,1,2393,1647,746,2.207774799,1346,1577,324,132,131,1,35,1,0.13740458,0,empty,CD-0722-4
"G1,G9",978490,1111894,740804,371090,544087,276957,9,277219,214219,63000,3.400301587,160211,104639,18824,6963,6839,124,1129,4,0.046498026,0,hg38,CD-0722-4
"G1,G10",13639,15417,10133,5284,8225,4291,0,4292,2981,1311,2.273836766,2482,2403,441,196,195,1,52,1,0.041025641,0,empty,CD-0722-4
"G1,G11",12600,13685,9519,4166,7285,3500,0,3502,2478,1024,2.419921875,1948,1601,473,163,162,1,37,1,0.111111111,0,empty,CD-0722-4
"G1,G12",9280,10484,6802,3682,5560,2950,22,2972,1921,1051,1.827783064,1761,2489,651,232,231,1,51,1,0.112554113,0,empty,CD-0722-4
"G1,H1",13580,15293,10254,5039,7982,4022,1,4031,2781,1250,2.2248,2315,1354,472,150,147,3,29,1,0.06122449,0,empty,CD-0722-4
"G1,H2",11510,12917,8515,4402,6777,3480,5,3487,2322,1165,1.993133047,1993,2390,555,239,237,2,61,2,0.143459916,0,empty,CD-0722-4
"G1,H3",10830,11836,7995,3841,6306,3285,1,3290,2333,957,2.437826541,1830,1476,466,151,149,2,41,1,0.093959732,0,empty,CD-0722-4
"G1,H4",13338,14456,9991,4465,7526,3632,0,3633,2447,1186,2.063237774,2019,205,25,14,14,0,7,0,0,0,empty,CD-0722-4
"G1,H5",14142,15694,10324,5370,8258,4208,0,4215,2816,1399,2.012866333,2485,1433,407,138,138,0,34,0,0.094202899,0,empty,CD-0722-4
"G1,H6",10730,12141,7905,4236,6395,3353,0,3357,2357,1000,2.357,1933,2232,494,169,169,0,50,0,0.147928994,0,empty,CD-0722-4
"G1,H7",10381,11502,7629,3873,6070,3049,6,3058,2089,969,2.155830753,1761,2311,643,269,268,1,62,1,0.156716418,0,empty,CD-0722-4
"G1,H8",15908,17797,11660,6137,9226,4863,0,4870,3495,1375,2.541818182,2747,2577,618,237,235,2,65,2,0.114893617,0,empty,CD-0722-4
"G1,H9",11491,12345,9030,3315,6538,3121,0,3121,2144,977,2.194472876,1664,1120,326,83,77,6,20,2,0,0,empty,CD-0722-4
"G1,H10",11247,12333,8411,3922,6251,3071,1,3076,2176,900,2.417777778,1726,2166,445,197,195,2,45,1,0.158974359,0,empty,CD-0722-4
"G1,H11",9867,11277,6864,4413,5816,3401,10,3417,1886,1531,1.231874592,2085,61,9,5,5,0,2,0,0,0,empty,CD-0722-4
"G1,H12",11035,12347,8108,4239,6447,3346,0,3357,2386,971,2.457260556,1956,1267,265,102,100,2,27,1,0.05,0,empty,CD-0722-4
"G2,A1",8161,8918,6077,2841,4808,2415,4,2419,1609,810,1.986419753,1339,1761,197,91,89,2,33,2,0.056179775,0,empty,CD-0722-4
"G2,A2",676179,738490,518244,220246,360446,170801,0,170953,128801,42152,3.055631998,95259,151518,15531,6468,6238,230,994,9,0.070054505,0,hg38,CD-0722-4
"G2,A3",7577,8369,5450,2919,4394,2252,0,2252,1543,709,2.176304654,1296,1600,485,168,167,1,38,1,0.089820359,0,empty,CD-0722-4
"G2,A4",12263,13063,9173,3890,7012,3455,0,3459,2211,1248,1.771634615,1887,835,263,92,92,0,23,0,0.130434783,0,empty,CD-0722-4
"G2,A5",687227,785769,502286,283483,388744,212283,2,212451,168542,43909,3.838438589,124510,133588,30093,11550,11426,124,1677,5,0.039033783,0,hg38,CD-0722-4
"G2,A6",10118,11722,7526,4196,6285,3376,0,3383,2302,1081,2.129509713,1967,3493,812,321,319,2,86,1,0.040752351,0,empty,CD-0722-4
"G2,A7",7851,8802,5824,2978,4683,2432,5,2441,1579,862,1.831786543,1412,1267,409,160,160,0,34,0,0.0375,0,empty,CD-0722-4
"G2,A8",5586,6198,4176,2022,3283,1675,0,1675,1194,481,2.482328482,946,2183,702,292,290,2,55,1,0.082758621,0,empty,CD-0722-4
"G2,A9",9975,11102,7459,3643,5808,2846,43,2896,1992,904,2.203539823,1657,1922,304,151,149,2,44,2,0,0,empty,CD-0722-4
"G2,A10",13626,15340,10053,5287,7983,4219,0,4221,2915,1306,2.232006126,2416,474,64,30,28,2,14,2,0.25,0,empty,CD-0722-4
"G2,A11",6804,7409,5270,2139,4009,1887,1,1892,1245,647,1.924265842,1026,1525,371,150,148,2,41,1,0.162162162,0,empty,CD-0722-4
"G2,A12",11854,12691,9007,3684,6726,3231,13,3249,2252,997,2.258776329,1788,3983,1024,407,402,5,97,1,0.10199005,0,empty,CD-0722-4
"G2,B1",8194,9092,6099,2993,4696,2370,0,2370,1585,785,2.01910828,1320,1251,324,155,155,0,40,0,0.064516129,0,empty,CD-0722-4
"G2,B2",8882,9579,6127,3452,5126,2708,15,2725,1747,978,1.786298569,1582,557,141,49,49,0,10,0,0.06122449,0,empty,CD-0722-4
"G2,B3",7762,8817,5581,3236,4741,2464,4,2472,1686,786,2.145038168,1509,1876,488,198,196,2,47,1,0.091836735,0,empty,CD-0722-4
"G2,B4",7940,8869,5873,2996,4748,2524,0,2524,1689,835,2.022754491,1422,1499,345,132,128,4,34,2,0.0859375,0,empty,CD-0722-4
"G2,B5",8710,5272,3287,1985,3479,1830,1,1837,1253,584,2.145547945,1174,1009,162,69,68,1,22,1,0.088235294,0,empty,CD-0722-4
"G2,B6",10286,10993,7562,3431,5830,3114,0,3121,2029,1092,1.858058608,1708,2160,515,171,167,4,50,1,0.215568862,0,empty,CD-0722-4
"G2,B7",9384,10568,7072,3496,5684,2782,0,2785,1841,944,1.950211864,1601,1628,448,172,171,1,40,1,0.040935673,0,empty,CD-0722-4
"G2,B8",7822,8540,5879,2661,4682,2304,0,2304,1640,664,2.469879518,1284,1892,343,156,155,1,43,1,0.012903226,0,empty,CD-0722-4
"G2,B9",12065,13479,8810,4669,6982,3722,0,3723,2346,1377,1.703703704,2167,1042,203,83,82,1,25,1,0.231707317,0,empty,CD-0722-4
"G2,B10",7130,7846,5201,2645,4200,2130,0,2130,1458,672,2.169642857,1198,743,108,56,55,1,20,1,0.090909091,0,empty,CD-0722-4
"G2,B11",16593,17577,12272,5305,9171,4739,0,4746,2871,1875,1.5312,2619,337,97,23,23,0,10,0,0,0,empty,CD-0722-4
"G2,B12",830214,963500,615026,348474,476974,257588,5,257808,198405,59403,3.339982829,153111,140099,21667,8327,8185,142,1287,5,0.038485034,0,hg38,CD-0722-4
"G2,C1",17169,18498,12876,5622,10041,4933,0,4933,3316,1617,2.050711194,2741,1469,380,138,137,1,41,1,0.02189781,0,empty,CD-0722-4
"G2,C2",12411,13588,9065,4523,7199,3665,1,3669,2437,1232,1.978084416,2112,2468,519,204,204,0,52,0,0.117647059,0,empty,CD-0722-4
"G2,C3",12748,14483,9402,5081,7564,3787,0,3790,2514,1276,1.970219436,2223,920,214,65,60,5,21,2,0,0,empty,CD-0722-4
"G2,C4",8836,9583,6651,2932,5111,2453,0,2453,1628,825,1.973333333,1359,2305,527,226,221,5,50,2,0.14479638,0,empty,CD-0722-4
"G2,C5",11625,12777,8519,4258,6862,3469,3,3473,2282,1191,1.916036944,1994,2711,700,260,255,5,52,2,0.043137255,0,empty,CD-0722-4
"G2,C6",9841,10979,7109,3870,5861,3059,2,3069,2081,988,2.106275304,1818,2002,465,186,184,2,53,2,0.059782609,0,empty,CD-0722-4
"G2,C7",12616,14002,9243,4759,7319,3853,12,3866,2397,1469,1.63172226,2223,372,53,30,30,0,10,0,0.5,0,empty,CD-0722-4
"G2,C8",14337,15633,10669,4964,8149,4137,0,4141,2822,1319,2.139499621,2243,3338,869,312,310,2,79,1,0.012903226,0,empty,CD-0722-4
"G2,C9",10854,12215,7970,4245,6371,3285,0,3289,2232,1057,2.111636708,1903,1432,369,186,185,1,44,1,0.086486486,0,empty,CD-0722-4
"G2,C10",11667,12521,8696,3825,6495,3113,0,3117,2045,1072,1.907649254,1706,3296,660,278,278,0,74,0,0.025179856,0,empty,CD-0722-4
"G2,C11",1015255,1176563,743757,432806,576664,320066,27,320386,258344,62042,4.164017923,191154,119643,21103,8218,8097,121,1320,4,0.051624058,0,hg38,CD-0722-4
"G2,C12",15253,16402,11416,4986,8789,4273,3,4294,2890,1404,2.058404558,2366,3133,845,323,319,4,80,2,0.056426332,0,empty,CD-0722-4
"G2,D1",12076,13444,8730,4714,7094,3694,25,3722,2345,1377,1.702977487,2157,929,116,50,49,1,14,1,0,0,empty,CD-0722-4
"G2,D2",10037,11094,7619,3475,5818,2787,0,2787,1798,989,1.817997978,1530,3403,1043,420,419,1,92,1,0.081145585,0,empty,CD-0722-4
"G2,D3",9231,9996,6850,3146,5387,2680,0,2682,1841,841,2.189060642,1495,1793,395,188,188,0,46,0,0.111702128,0,empty,CD-0722-4
"G2,D4",7666,8538,5762,2776,4549,2299,0,2304,1517,787,1.927573062,1310,1895,333,146,146,0,42,0,0.047945205,0,empty,CD-0722-4
"G2,D5",8298,9175,6231,2944,4787,2430,0,2434,1611,823,1.957472661,1371,1783,300,125,124,1,36,1,0.120967742,0,empty,CD-0722-4
"G2,D6",11940,13340,8584,4756,6887,3686,16,3704,2319,1385,1.674368231,2147,1947,519,168,165,3,54,1,0.036363636,0,empty,CD-0722-4
"G2,D7",6877,7433,5129,2304,3956,1947,13,1963,1335,628,2.125796178,1072,2198,424,164,163,1,44,1,0.128834356,0,empty,CD-0722-4
"G2,D8",8531,9431,6265,3166,4898,2462,0,2465,1647,818,2.013447433,1394,2230,419,130,130,0,37,0,0.092307692,0,empty,CD-0722-4
"G2,D9",4839,5312,3673,1639,2808,1370,0,1370,945,425,2.223529412,779,1795,396,129,126,3,36,2,0.03968254,0,empty,CD-0722-4
"G2,D10",9144,10326,6775,3551,5534,2873,10,2884,1886,998,1.889779559,1676,3186,638,255,253,2,49,1,0.102766798,0,empty,CD-0722-4
"G2,D11",9161,9980,6816,3164,5304,2618,1,2621,1737,884,1.964932127,1461,3281,885,376,370,6,91,2,0.056756757,0,empty,CD-0722-4
"G2,D12",13201,14217,9794,4423,7562,3714,0,3716,2613,1103,2.368993654,2044,4128,1079,396,387,9,114,2,0.010335917,0,empty,CD-0722-4
"G2,E1",16898,18818,12460,6358,9846,4968,12,4984,3280,1704,1.924882629,2844,2739,684,248,238,10,74,2,0.025210084,0,empty,CD-0722-4
"G2,E2",954480,1092296,708889,383407,535175,288284,0,288559,231629,56930,4.068663271,169340,161527,20851,8178,8003,175,1225,11,0.075721604,0,hg38,CD-0722-4
"G2,E3",6769,7300,5003,2297,3914,1923,0,1925,1252,673,1.860326895,1053,3139,662,241,239,2,73,2,0.029288703,0,empty,CD-0722-4
"G2,E4",11710,12901,8551,4350,7090,3603,41,3651,2482,1169,2.123182207,2098,3020,628,248,245,3,73,2,0.07755102,0,empty,CD-0722-4
"G2,E5",8360,9153,6334,2819,4876,2305,1,2306,1532,774,1.979328165,1316,1856,729,260,260,0,49,0,0.15,0,empty,CD-0722-4
"G2,E6",15789,17085,11675,5410,8875,4497,0,4502,2964,1538,1.927178153,2529,3871,960,385,380,5,109,2,0.057894737,0,empty,CD-0722-4
"G2,E7",17863,19873,13386,6487,10389,5201,0,5204,3521,1683,2.092097445,2996,5079,1130,453,451,2,92,1,0.148558758,0,empty,CD-0722-4
"G2,E8",12795,13836,9739,4097,7318,3468,6,3476,2389,1087,2.197792088,1866,3184,797,352,350,2,88,1,0.031428571,0,empty,CD-0722-4
"G2,E9",7658,8511,5703,2808,4506,2311,2,2315,1570,745,2.10738255,1296,3386,947,355,353,2,68,1,0.101983003,0,empty,CD-0722-4
"G2,E10",8688,9607,6450,3157,5047,2535,1,2543,1720,823,2.089914945,1419,2169,531,207,207,0,51,0,0.120772947,0,empty,CD-0722-4
"G2,E11",9908,10484,7461,3023,5581,2737,0,2741,1787,954,1.873165618,1376,2223,690,286,284,2,67,1,0.084507042,0,empty,CD-0722-4
"G2,E12",11860,13341,8634,4707,6967,3572,0,3577,2393,1184,2.021114865,2098,2822,557,222,219,3,78,1,0.082191781,0,empty,CD-0722-4
"G2,F1",13145,14100,9812,4288,7379,3549,0,3556,2362,1194,1.978224456,1951,4058,866,334,330,4,87,2,0.072727273,0,empty,CD-0722-4
"G2,F2",9949,10731,7363,3368,5615,2732,0,2738,1785,953,1.873032529,1518,2816,875,346,341,5,74,2,0.108504399,0,empty,CD-0722-4
"G2,F3",9929,10934,7479,3455,5843,2839,0,2842,1976,866,2.281755196,1593,3200,926,332,329,3,89,1,0.085106383,0,empty,CD-0722-4
"G2,F4",15226,16785,11342,5443,8797,4356,7,4370,2804,1566,1.79054917,2424,813,77,38,38,0,14,0,0,0,empty,CD-0722-4
"G2,F5",11687,12692,8805,3887,6707,3162,15,3179,2115,1064,1.987781955,1749,2624,506,214,214,0,65,0,0.014018692,0,empty,CD-0722-4
"G2,F6",15142,17360,10969,6391,9157,4921,7,4930,3417,1513,2.258426966,2916,3482,590,253,251,2,87,1,0.06374502,0,empty,CD-0722-4
"G2,F7",13352,14997,9950,5047,8047,4102,2,4110,2796,1314,2.127853881,2350,1263,315,115,115,0,34,0,0.173913043,0,empty,CD-0722-4
"G2,F8",12043,13294,9063,4231,7066,3474,7,3484,2445,1039,2.353224254,1989,453,109,51,50,1,18,1,0.02,0,empty,CD-0722-4
"G2,F9",2156263,2483549,1586369,897180,1193447,675870,1,676439,552141,124298,4.442074691,394583,307106,55584,21461,21156,305,2684,9,0.05960484,0,hg38,CD-0722-4
"G2,F10",13953,15104,10496,4608,8069,3961,3,3969,2709,1260,2.15,2191,1933,509,196,189,7,52,2,0.021164021,0,empty,CD-0722-4
"G2,F11",9967,10882,7574,3308,5650,2701,12,2719,1871,848,2.206367925,1530,2058,273,124,121,3,44,1,0.05785124,0,empty,CD-0722-4
"G2,F12",11840,12868,8718,4150,6780,3298,0,3302,2254,1048,2.150763359,1851,178,25,11,8,3,6,1,0,0,empty,CD-0722-4
"G2,G1",14785,16591,11220,5371,8547,4059,6,4071,2745,1326,2.070135747,2300,5126,1290,457,450,7,107,2,0.162222222,0,empty,CD-0722-4
"G2,G2",6844,7242,4895,2347,3824,1946,1,1953,1265,688,1.838662791,1096,529,116,50,49,1,16,1,0,0,empty,CD-0722-4
"G2,G3",1113216,1264781,835044,429737,613744,322704,1,323005,246997,76008,3.249618461,188369,142007,19340,7299,7125,174,1189,9,0.049122807,0,hg38,CD-0722-4
"G2,G4",22701,25429,16278,9151,13453,7587,1,7593,4621,2972,1.554845222,4467,67,3,3,2,1,1,1,0,0,empty,CD-0722-4
"G2,G5",7370,8232,5430,2802,4310,2173,0,2175,1369,806,1.698511166,1269,1785,503,194,188,6,43,2,0.085106383,0,empty,CD-0722-4
"G2,G6",11650,12642,8848,3794,6703,3291,0,3295,2248,1047,2.147086915,1798,222,57,24,24,0,6,0,0,0,empty,CD-0722-4
"G2,G7",10001,10982,7526,3456,5881,2882,0,2886,1903,983,1.935910478,1649,3199,910,349,345,4,87,1,0.089855072,0,empty,CD-0722-4
"G2,G8",7461,8044,5463,2581,4375,2127,1,2130,1449,681,2.127753304,1220,1928,368,157,153,4,44,2,0.137254902,0,empty,CD-0722-4
"G2,G9",9637,10831,7144,3687,5783,2929,0,2929,1959,970,2.019587629,1721,3347,731,302,301,1,94,1,0.056478405,0,empty,CD-0722-4
"G2,G10",11324,12447,8532,3915,6700,3367,0,3372,2280,1092,2.087912088,1864,2769,546,277,272,5,66,2,0.077205882,0,empty,CD-0722-4
"G2,G11",10761,11637,8140,3497,6224,3002,1,3003,2055,948,2.167721519,1626,1655,428,177,173,4,44,2,0.115606936,0,empty,CD-0722-4
"G2,G12",7792,8940,5688,3252,4632,2421,0,2424,1502,922,1.629067245,1424,2843,594,210,207,3,44,2,0.072463768,0,empty,CD-0722-4
"G2,H1",10140,11227,7514,3713,6020,3035,6,3047,2078,969,2.144478844,1753,1910,544,219,213,6,46,2,0.023474178,0,empty,CD-0722-4
"G2,H2",13132,14958,9868,5090,7849,3984,0,3993,2694,1299,2.073903002,2358,2413,523,228,227,1,67,1,0.022026432,0,empty,CD-0722-4
"G2,H3",9043,9990,6694,3296,5392,2821,0,2823,1970,853,2.309495897,1672,1692,292,132,132,0,33,0,0.075757576,0,empty,CD-0722-4
"G2,H4",12389,13368,9225,4143,7047,3430,0,3433,2279,1154,1.974870017,1926,210,47,22,21,1,8,1,0.047619048,0,empty,CD-0722-4
"G2,H5",13176,14446,9715,4731,7531,3800,0,3801,2537,1264,2.007120253,2132,3018,607,276,273,3,58,2,0.15018315,0,empty,CD-0722-4
"G2,H6",8883,9649,6579,3070,5143,2609,5,2616,1742,874,1.993135011,1438,2938,614,255,251,4,76,2,0.143426295,0,empty,CD-0722-4
"G2,H7",8784,9599,6536,3063,5091,2448,1,2457,1594,863,1.847045191,1455,2384,630,179,178,1,43,1,0.196629213,0,empty,CD-0722-4
"G2,H8",12907,14933,9395,5538,7846,4164,0,4174,2842,1332,2.133633634,2490,2782,470,196,194,2,75,1,0.051546392,0,empty,CD-0722-4
"G2,H9",1069898,1179821,817952,361869,570493,284203,9,284532,218478,66054,3.307566536,159739,157027,18410,7019,6831,188,1088,7,0.046552481,0,hg38,CD-0722-4
"G2,H10",6858,7325,5179,2146,3877,1866,0,1872,1199,673,1.781575037,996,1696,281,125,123,2,34,2,0.032520325,0,empty,CD-0722-4
"G2,H11",7753,8702,5438,3264,4714,2706,13,2721,1549,1172,1.321672355,1622,18,0,0,0,0,0,0,0,0,empty,CD-0722-4
"G2,H12",8336,9103,6155,2948,4741,2459,0,2463,1661,802,2.071072319,1362,1484,340,125,123,2,37,2,0.024390244,0,empty,CD-0722-4
"G3,A1",7373,8053,5425,2628,4378,2250,7,2260,1515,745,2.033557047,1236,1818,340,131,130,1,40,1,0.053846154,0,empty,CD-0722-4
"G3,A2",13661,14783,10406,4377,7774,3766,0,3773,2557,1216,2.102796053,2042,2511,629,267,266,1,63,1,0.154135338,0,empty,CD-0722-4
"G3,A3",7264,7956,5386,2570,4220,2063,2,2065,1429,636,2.246855346,1163,1309,293,140,140,0,42,0,0.085714286,0,empty,CD-0722-4
"G3,A4",12295,13594,9182,4412,7139,3458,31,3492,2296,1196,1.919732441,1988,876,147,48,48,0,22,0,0.0625,0,empty,CD-0722-4
"G3,A5",11548,12454,8452,4002,6925,3522,0,3524,2254,1270,1.77480315,1981,2638,471,210,204,6,67,2,0.058823529,0,empty,CD-0722-4
"G3,A6",724205,859467,532137,327330,427647,245887,2,246108,195828,50280,3.894749403,146474,90959,14380,5606,5493,113,1001,6,0.017658839,0,hg38,CD-0722-4
"G3,A7",7590,8497,5607,2890,4442,2333,0,2334,1525,809,1.885043263,1331,1792,561,223,223,0,42,0,0.013452915,0,empty,CD-0722-4
"G3,A8",5225,5719,3830,1889,3185,1592,0,1596,1109,487,2.277207392,945,2220,571,208,207,1,57,1,0.149758454,0,empty,CD-0722-4
"G3,A9",925415,1070589,671353,399236,530982,301470,4,301767,264134,37633,7.018680413,177447,112323,25103,9648,9542,106,1419,4,0.056906309,0,hg38,CD-0722-4
"G3,A10",9354,10059,7077,2982,5320,2597,30,2630,1698,932,1.821888412,1400,442,119,46,45,1,18,1,0.088888889,0,empty,CD-0722-4
"G3,A11",6666,7300,5014,2286,3853,1857,1,1860,1254,606,2.069306931,999,2003,307,142,140,2,42,2,0.164285714,0,empty,CD-0722-4
"G3,A12",10790,11689,8002,3687,6245,3085,0,3089,2133,956,2.231171548,1713,4041,926,371,364,7,94,3,0.076923077,0,empty,CD-0722-4
"G3,B1",7735,8435,5756,2679,4520,2339,6,2347,1490,857,1.738623104,1310,1027,178,97,96,1,32,1,0.177083333,0,empty,CD-0722-4
"G3,B2",8789,9481,6004,3477,5148,2790,0,2791,1803,988,1.824898785,1630,556,77,35,35,0,15,0,0,0,empty,CD-0722-4
"G3,B3",7253,8138,5286,2852,4375,2264,0,2269,1493,776,1.923969072,1374,2005,500,197,196,1,56,1,0.076530612,0,empty,CD-0722-4
"G3,B4",7484,8341,5448,2893,4493,2369,1,2372,1548,824,1.878640777,1358,1421,199,104,104,0,33,0,0.067307692,0,empty,CD-0722-4
"G3,B5",8729,5328,3277,2051,3517,1892,0,1901,1334,567,2.352733686,1217,1144,300,133,133,0,38,0,0.218045113,0,empty,CD-0722-4
"G3,B6",723147,816245,543966,272279,403146,206705,1,206900,157269,49631,3.168765489,119672,132720,14229,5725,5561,164,981,8,0.065995325,0,hg38,CD-0722-4
"G3,B7",8756,9668,6652,3016,5215,2592,0,2592,1693,899,1.88320356,1472,1604,378,141,140,1,38,1,0.1,0,empty,CD-0722-4
"G3,B8",7218,7644,5471,2173,4146,1933,0,1933,1355,578,2.344290657,1027,1028,223,100,98,2,37,2,0.020408163,0,empty,CD-0722-4
"G3,B9",36683,39429,28099,11330,19551,9029,0,9036,6566,2470,2.658299595,4880,2449,387,162,161,1,56,1,0.186335404,0,empty,CD-0722-4
"G3,B10",6305,6925,4516,2409,3927,1991,1,2000,1372,628,2.184713376,1201,730,100,55,53,2,18,1,0.113207547,0,empty,CD-0722-4
"G3,B11",11761,13196,8336,4860,6908,3755,12,3771,2195,1576,1.392766497,2220,432,35,15,14,1,10,1,0,0,empty,CD-0722-4
"G3,B12",7898,8831,5775,3056,4704,2409,0,2416,1656,760,2.178947368,1390,2054,300,133,133,0,53,0,0.210526316,0,empty,CD-0722-4
"G3,C1",15338,16480,11495,4985,8986,4358,0,4361,2931,1430,2.04965035,2393,1145,376,143,143,0,31,0,0.020979021,0,empty,CD-0722-4
"G3,C2",11937,12819,8722,4097,6744,3383,3,3392,2205,1187,1.857624263,1862,2790,707,283,280,3,82,2,0.014285714,0,empty,CD-0722-4
"G3,C3",12513,13827,9241,4586,7357,3647,17,3670,2353,1317,1.786636295,2114,1085,162,86,86,0,23,0,0.034883721,0,empty,CD-0722-4
"G3,C4",1169742,1372085,862122,509963,672696,382512,2,382914,310447,72467,4.283977535,224811,176209,22185,8603,8376,227,1513,7,0.040830946,0,hg38,CD-0722-4
"G3,C5",10933,12128,8127,4001,6352,3157,8,3165,2105,1060,1.985849057,1773,2188,629,243,242,1,55,1,0.095041322,0,empty,CD-0722-4
"G3,C6",8957,9631,6637,2994,5294,2613,0,2619,1677,942,1.780254777,1450,2070,599,228,227,1,62,1,0.061674009,0,empty,CD-0722-4
"G3,C7",25887,27258,18602,8656,14669,8070,0,8078,5045,3033,1.663369601,4160,459,146,52,50,2,14,1,0,0,empty,CD-0722-4
"G3,C8",13803,15045,10302,4743,7991,3961,13,3985,2662,1323,2.012093726,2201,3075,738,342,341,1,83,1,0.038123167,0,empty,CD-0722-4
"G3,C9",9796,11276,7246,4030,5953,2991,37,3029,2014,1015,1.984236453,1785,1753,265,114,114,0,36,0,0.026315789,0,empty,CD-0722-4
"G3,C10",11203,12192,8274,3918,6419,3162,4,3169,2078,1091,1.90467461,1746,2099,441,191,188,3,64,2,0,0,empty,CD-0722-4
"G3,C11",12773,13902,9283,4619,7426,3779,0,3783,2536,1247,2.033680834,2187,4500,656,275,273,2,62,2,0.080586081,0,empty,CD-0722-4
"G3,C12",14376,15743,10584,5159,8317,4007,22,4033,2758,1275,2.163137255,2334,2082,576,213,211,2,57,1,0.137440758,0,empty,CD-0722-4
"G3,D1",11548,12959,8166,4793,6801,3676,1,3682,2291,1391,1.647016535,2192,718,162,72,71,1,29,1,0.112676056,0,empty,CD-0722-4
"G3,D2",9457,10338,7094,3244,5577,2708,9,2717,1768,949,1.863013699,1528,3741,1244,431,429,2,99,2,0.121212121,0,empty,CD-0722-4
"G3,D3",8691,9494,6406,3088,5143,2649,0,2653,1730,923,1.87432286,1481,1135,201,89,89,0,33,0,0.02247191,0,empty,CD-0722-4
"G3,D4",7186,8043,5384,2659,4410,2254,0,2256,1552,704,2.204545455,1308,1514,419,156,155,1,39,1,0.2,0,empty,CD-0722-4
"G3,D5",7579,8234,5686,2548,4349,2138,0,2140,1373,767,1.790091265,1181,1831,386,166,166,0,48,0,0.036144578,0,empty,CD-0722-4
"G3,D6",11269,12159,8016,4143,6283,3273,0,3275,2027,1248,1.624198718,1829,1978,648,245,243,2,53,1,0.086419753,0,empty,CD-0722-4
"G3,D7",6961,7355,5104,2251,4087,1961,20,1981,1361,620,2.19516129,1115,2082,604,255,251,4,62,2,0.103585657,0,empty,CD-0722-4
"G3,D8",7892,8861,5780,3081,4634,2320,1,2330,1583,747,2.11914324,1316,1433,334,141,138,3,34,1,0.065217391,0,empty,CD-0722-4
"G3,D9",643217,720105,482599,237506,357183,181115,2,181262,138636,42626,3.252381176,104582,115661,13390,5253,5083,170,904,5,0.043478261,0,hg38,CD-0722-4
"G3,D10",9239,10446,6738,3708,5501,2944,0,2946,1880,1066,1.763602251,1713,809,215,74,74,0,25,0,0.027027027,0,empty,CD-0722-4
"G3,D11",802722,885624,615665,269959,436586,210375,0,210568,159388,51180,3.114263384,117865,173615,27090,10190,10001,189,1492,6,0.052594741,0,hg38,CD-0722-4
"G3,D12",12272,13233,8875,4358,7248,3744,0,3744,2513,1231,2.041429732,2085,3050,870,345,341,4,109,2,0.041055718,0,empty,CD-0722-4
"G3,E1",15519,16862,11457,5405,8865,4460,3,4470,2824,1646,1.715674362,2499,3239,770,310,309,1,92,1,0.103559871,0,empty,CD-0722-4
"G3,E2",10010,10947,7299,3648,5747,2893,27,2922,1940,982,1.975560081,1659,1928,462,204,201,3,62,3,0.044776119,0,empty,CD-0722-4
"G3,E3",6707,7466,4989,2477,4056,2038,0,2038,1283,755,1.699337748,1173,3490,909,330,330,0,79,0,0.072727273,0,empty,CD-0722-4
"G3,E4",11054,12086,7956,4130,6740,3516,0,3517,2366,1151,2.055603823,2004,3147,839,355,350,5,75,2,0.114285714,0,empty,CD-0722-4
"G3,E5",8416,8998,6265,2733,4862,2276,6,2286,1540,746,2.064343164,1254,1476,464,181,180,1,35,1,0.15,0,empty,CD-0722-4
"G3,E6",15008,16551,11088,5463,8751,4457,0,4465,2967,1498,1.980640854,2542,3808,916,314,303,11,88,2,0.052805281,0,empty,CD-0722-4
"G3,E7",15166,16317,11176,5141,8823,4466,0,4469,3056,1413,2.162774239,2519,3746,1049,378,375,3,92,2,0.064,0,empty,CD-0722-4
"G3,E8",11668,12621,8803,3818,6831,3287,0,3290,2278,1012,2.250988142,1764,3586,990,379,374,5,93,2,0.045454545,0,empty,CD-0722-4
"G3,E9",711204,831323,521815,309508,411363,228016,1,228206,181521,46685,3.888208204,135503,134279,18562,7311,7151,160,1233,7,0.034121102,0,hg38,CD-0722-4
"G3,E10",1036876,1211387,746633,464754,598360,344034,15,344376,282560,61816,4.570984858,205973,98099,19538,7782,7666,116,1183,6,0.033524654,0,hg38,CD-0722-4
"G3,E11",9883,10210,7239,2971,5667,2803,0,2808,1855,953,1.946484785,1496,2444,661,274,272,2,62,1,0.117647059,0,empty,CD-0722-4
"G3,E12",12450,13559,8973,4586,7438,3778,0,3779,2569,1210,2.123140496,2182,2137,430,195,194,1,56,1,0.020618557,0,empty,CD-0722-4
"G3,F1",12585,13228,8889,4339,7217,3548,0,3550,2337,1213,1.926628195,1996,2283,643,258,258,0,70,0,0.085271318,0,empty,CD-0722-4
"G3,F2",9042,9625,6596,3029,5138,2504,0,2504,1629,875,1.861714286,1427,3234,934,317,315,2,80,2,0.050793651,0,empty,CD-0722-4
"G3,F3",19818,22205,14863,7342,11226,5559,22,5585,4058,1527,2.657498363,3238,3494,728,287,283,4,87,2,0.056537102,0,empty,CD-0722-4
"G3,F4",14344,15363,10549,4814,8445,4125,2,4127,2788,1339,2.082150859,2321,728,189,90,90,0,25,0,0.233333333,0,empty,CD-0722-4
"G3,F5",11766,12527,8902,3625,6718,3152,2,3161,2083,1078,1.932282004,1752,3220,714,328,324,4,78,2,0.00308642,0,empty,CD-0722-4
"G3,F6",1420084,1626782,1067374,559408,791085,429590,1,429943,356053,73890,4.818689945,250294,101332,20433,7524,7416,108,1303,5,0.022249191,0,hg38,CD-0722-4
"G3,F7",12526,13844,9356,4488,7411,3720,7,3728,2466,1262,1.954041204,2091,1216,289,134,133,1,32,1,0.082706767,0,empty,CD-0722-4
"G3,F8",9522,10324,7049,3275,5760,2809,0,2811,1887,924,2.042207792,1574,343,31,19,19,0,11,0,0,0,empty,CD-0722-4
"G3,F9",1647393,1831810,1199589,632221,901203,512715,4,513124,458399,54725,8.376409319,292784,246122,89030,34304,34122,182,3163,7,0.006828439,0,hg38,CD-0722-4
"G3,F10",836502,995578,581215,414363,496338,320289,2,320530,231588,88942,2.603809224,189695,6647,1097,391,376,15,90,3,0.135638298,0,hg38,CD-0722-4
"G3,F11",8932,9679,6656,3023,5085,2435,0,2435,1589,846,1.878250591,1389,1660,411,166,163,3,47,2,0.104294479,0,empty,CD-0722-4
"G3,F12",10670,11622,7655,3967,6224,3069,8,3079,2063,1016,2.030511811,1799,219,30,19,18,1,7,1,0.388888889,0,empty,CD-0722-4
"G3,G1",12274,13351,9071,4280,7215,3570,12,3584,2353,1231,1.911454102,2004,2891,751,266,265,1,62,1,0.162264151,0,empty,CD-0722-4
"G3,G2",6168,6536,4340,2196,3478,1768,0,1770,1156,614,1.882736156,1001,385,83,28,28,0,17,0,0.071428571,0,empty,CD-0722-4
"G3,G3",1074663,1247590,792482,455108,610269,331974,4,332282,255709,76573,3.339414676,198460,199856,25217,9709,9467,242,1398,4,0.082285835,0,hg38,CD-0722-4
"G3,G4",992229,1075006,759922,315084,526629,255514,1,255746,201476,54270,3.712474664,142011,993,142,45,44,1,15,1,0.136363636,0,empty,CD-0722-4
"G3,G5",7747,8244,5709,2535,4357,2151,0,2153,1350,803,1.681195517,1201,1685,356,146,145,1,42,1,0.020689655,0,empty,CD-0722-4
"G3,G6",11487,12310,8540,3770,6477,3090,14,3106,2086,1020,2.045098039,1712,332,51,40,40,0,11,0,0.125,0,empty,CD-0722-4
"G3,G7",9362,10098,6981,3117,5420,2592,20,2614,1762,852,2.068075117,1440,3173,798,338,331,7,98,2,0.018126888,0,empty,CD-0722-4
"G3,G8",1309391,1478440,988249,490191,715843,377964,3,378289,301632,76657,3.934826565,217334,132536,24394,9206,9039,167,1403,4,0.038389202,0,hg38,CD-0722-4
"G3,G9",9167,9830,6710,3120,5524,2759,12,2773,1875,898,2.087973274,1566,2466,530,240,238,2,79,1,0.008403361,0,empty,CD-0722-4
"G3,G10",1981772,2204493,1492177,712316,1064871,562875,3,563454,456143,107311,4.250663958,319566,192877,22062,8370,8167,203,1586,7,0.029631444,0,hg38,CD-0722-4
"G3,G11",1386700,1636670,994741,641929,808368,484990,5,485396,399071,86325,4.62289024,290859,19117,7968,2583,2578,5,600,2,0.034910784,0,hg38,CD-0722-4
"G3,G12",851556,1054883,569722,485161,534282,364346,5,364587,258128,106459,2.42467053,226308,12408,862,292,275,17,79,3,0.12,0,hg38,CD-0722-4
"G3,H1",9374,10161,6911,3250,5611,2797,1,2801,1884,917,2.054525627,1566,1612,337,112,111,1,36,1,0.027027027,0,empty,CD-0722-4
"G3,H2",10127,11267,7427,3840,5957,2978,1,2984,1998,986,2.026369168,1761,2876,785,294,285,9,73,2,0.098245614,0,empty,CD-0722-4
"G3,H3",8439,9294,6005,3289,5038,2603,0,2603,1742,861,2.023228804,1514,1996,424,173,171,2,58,1,0.023391813,0,empty,CD-0722-4
"G3,H4",11433,12514,8393,4121,6543,3268,1,3274,2081,1193,1.744341995,1824,258,57,30,28,2,11,1,0,0,empty,CD-0722-4
"G3,H5",12255,13638,9000,4638,7130,3590,0,3592,2376,1216,1.953947368,2088,2019,641,261,252,9,62,2,0.162698413,0,empty,CD-0722-4
"G3,H6",904584,1070134,657431,412703,530336,301463,9,301704,242656,59048,4.109470261,182609,157702,19029,7359,7185,174,1334,5,0.031036882,0,hg38,CD-0722-4
"G3,H7",811402,867501,629231,238270,431223,193226,11,193424,155176,38248,4.057101025,105909,52742,11639,4237,4179,58,743,4,0.010768126,0,hg38,CD-0722-4
"G3,H8",1234904,1497781,894607,603174,737927,445324,1,445696,368672,77024,4.78645617,268452,132817,17448,6848,6712,136,1353,6,0.028307509,0,hg38,CD-0722-4
"G3,H9",8698,9526,6661,2865,5078,2441,0,2441,1686,755,2.233112583,1309,1417,306,112,110,2,38,1,0.109090909,0,empty,CD-0722-4
"G3,H10",7733,8268,5745,2523,4363,2116,0,2116,1443,673,2.144130758,1162,1349,191,91,88,3,29,1,0.045454545,0,empty,CD-0722-4
"G3,H11",7772,9165,5466,3699,4783,2890,0,2890,1591,1299,1.224788299,1753,91,3,0,0,0,0,0,0,0,empty,CD-0722-4
"G3,H12",8100,9051,5776,3275,4773,2457,0,2461,1692,769,2.200260078,1482,1952,364,137,135,2,37,1,0.096296296,0,empty,CD-0722-4
"G4,A1",10886,12475,8008,4467,6576,3555,0,3557,2487,1070,2.324299065,2062,2249,563,207,204,3,37,2,0.068627451,0,empty,CD-0722-4
"G4,A2",16586,18735,12558,6177,9734,4987,1,4995,3452,1543,2.237200259,2793,2770,775,263,259,4,59,2,0.061776062,0,empty,CD-0722-4
"G4,A3",21540,23146,15928,7218,11958,5782,14,5806,4336,1470,2.949659864,3234,3083,1162,443,442,1,111,1,0.047511312,0,empty,CD-0722-4
"G4,A4",14002,15471,10591,4880,8239,4131,0,4133,2836,1297,2.186584426,2305,1233,228,96,94,2,32,2,0.117021277,0,empty,CD-0722-4
"G4,A5",1991353,2293648,1471989,821659,1104775,615683,2,616273,491304,124969,3.931406989,362071,383791,51922,19928,19431,497,2626,10,0.05177294,0,hg38,CD-0722-4
"G4,A6",15399,17727,11491,6236,9421,4886,4,4891,3503,1388,2.523775216,2813,3244,774,291,289,2,89,1,0.010380623,0,empty,CD-0722-4
"G4,A7",9401,10714,6875,3839,5770,3159,0,3159,2049,1110,1.845945946,1858,1304,285,116,115,1,28,1,0.113043478,0,empty,CD-0722-4
"G4,A8",7983,8980,5974,3006,4807,2438,0,2438,1790,648,2.762345679,1381,2575,516,190,185,5,49,1,0.005405405,0,empty,CD-0722-4
"G4,A9",14792,16459,11395,5064,8711,4416,17,4433,3236,1197,2.70342523,2420,2513,588,206,200,6,65,2,0.09,0,empty,CD-0722-4
"G4,A10",14021,15677,10542,5135,8198,4198,0,4201,2916,1285,2.2692607,2431,395,106,53,53,0,15,0,0,0,empty,CD-0722-4
"G4,A11",20255,22997,15095,7902,11780,6400,23,6425,4396,2029,2.166584524,3614,2140,449,183,182,1,48,1,0.098901099,0,empty,CD-0722-4
"G4,A12",18660,20870,14105,6765,10839,5416,23,5442,3871,1571,2.464035646,3071,3516,696,271,270,1,74,1,0.085185185,0,empty,CD-0722-4
"G4,B1",10501,11747,7678,4069,6197,3178,0,3182,2136,1046,2.04206501,1852,1210,337,140,139,1,34,1,0.064748201,0,empty,CD-0722-4
"G4,B2",11446,12854,7807,5047,6818,3798,2,3806,2453,1353,1.81300813,2304,1033,271,65,62,3,17,1,0.129032258,0,empty,CD-0722-4
"G4,B3",11648,13379,8685,4694,7007,3639,32,3674,2647,1027,2.577409932,2143,1761,299,121,120,1,33,1,0.108333333,0,empty,CD-0722-4
"G4,B4",11228,13118,8161,4957,6769,3531,24,3556,2357,1199,1.965804837,2137,1576,391,162,162,0,31,0,0.086419753,0,empty,CD-0722-4
"G4,B5",11942,7314,4563,2751,4957,2575,10,2604,1823,781,2.33418694,1678,1281,277,114,112,2,32,1,0.125,0,empty,CD-0722-4
"G4,B6",15124,17176,11248,5928,9089,4865,1,4870,3369,1501,2.244503664,2865,1859,567,254,253,1,48,1,0.166007905,0,empty,CD-0722-4
"G4,B7",12025,13310,9075,4235,7071,3446,0,3447,2365,1082,2.185767098,1909,1498,287,133,129,4,35,2,0.217054264,0,empty,CD-0722-4
"G4,B8",12263,13798,9317,4481,7309,3720,1,3723,2654,1069,2.482694107,2146,1785,583,198,198,0,57,0,0.045454545,0,empty,CD-0722-4
"G4,B9",16520,18341,12241,6100,9928,5139,0,5143,3431,1712,2.004088785,2955,1088,311,122,122,0,40,0,0.024590164,0,empty,CD-0722-4
"G4,B10",10848,11869,7783,4086,6597,3374,0,3377,2323,1054,2.20398482,1959,1033,212,107,103,4,22,2,0.126213592,0,empty,CD-0722-4
"G4,B11",16971,19003,12511,6492,9842,5243,0,5253,3303,1950,1.693846154,2984,443,108,58,58,0,12,0,0,0,empty,CD-0722-4
"G4,B12",12513,13988,9136,4852,7541,3935,1,3939,2823,1116,2.529569892,2274,2714,733,254,252,2,68,1,0.051587302,0,empty,CD-0722-4
"G4,C1",21912,24097,16415,7682,12921,6455,1,6459,4467,1992,2.24246988,3644,1728,523,200,200,0,47,0,0.015,0,empty,CD-0722-4
"G4,C2",14875,16415,11141,5274,8699,4445,0,4449,3022,1427,2.117729502,2466,2546,669,305,302,3,80,2,0.026490066,0,empty,CD-0722-4
"G4,C3",16006,18492,11947,6545,9974,5161,0,5172,3501,1671,2.095152603,3070,1058,312,117,113,4,23,1,0.053097345,0,empty,CD-0722-4
"G4,C4",788662,867720,599813,267907,425904,209087,0,209284,161054,48230,3.339290898,117525,92366,14687,5851,5756,95,933,4,0.032314107,0,hg38,CD-0722-4
"G4,C5",15081,17159,11233,5926,9053,4729,0,4737,3246,1491,2.177062374,2700,1944,560,243,241,2,50,1,0.128630705,0,empty,CD-0722-4
"G4,C6",12683,13918,9385,4533,7566,3975,0,3978,2784,1194,2.331658291,2240,1845,454,189,189,0,44,0,0.148148148,0,empty,CD-0722-4
"G4,C7",16527,19257,12007,7250,10042,5504,3,5514,3563,1951,1.826242952,3314,552,83,42,42,0,18,0,0.095238095,0,empty,CD-0722-4
"G4,C8",20000,22329,15056,7273,11741,6081,0,6090,4177,1913,2.183481443,3376,3697,879,321,319,2,97,1,0.037617555,0,empty,CD-0722-4
"G4,C9",16908,19243,12651,6592,10212,5284,0,5286,3739,1547,2.416936005,3136,3227,728,218,216,2,60,2,0.069444444,0,empty,CD-0722-4
"G4,C10",1076856,1188389,833206,355183,574097,278831,4,279095,204328,74767,2.732863429,155305,122321,21409,8411,8272,139,1211,9,0.034332689,0,hg38,CD-0722-4
"G4,C11",973154,1102333,731201,371132,539863,278902,1,279152,217931,61221,3.559742572,162791,126634,16809,6529,6385,144,1093,6,0.044792482,0,hg38,CD-0722-4
"G4,C12",21150,23867,15789,8078,12500,6253,0,6267,4457,1810,2.462430939,3620,2658,633,239,238,1,66,1,0.016806723,0,empty,CD-0722-4
"G4,D1",14003,15683,10339,5344,8330,4415,0,4415,2909,1506,1.931606906,2518,980,202,74,73,1,20,1,0,0,empty,CD-0722-4
"G4,D2",10603,11321,8104,3217,5906,2732,0,2732,1776,956,1.857740586,1445,3798,1202,505,499,6,94,2,0.066132265,0,empty,CD-0722-4
"G4,D3",12839,14241,9596,4645,7405,3691,0,3692,2540,1152,2.204861111,2101,2023,415,169,167,2,40,2,0.239520958,0,empty,CD-0722-4
"G4,D4",10461,11704,7827,3877,6266,3111,0,3111,2154,957,2.250783699,1767,1721,435,176,175,1,37,1,0.097142857,0,empty,CD-0722-4
"G4,D5",10175,11301,7651,3650,5987,2994,0,2996,2048,948,2.160337553,1733,1694,411,169,169,0,41,0,0.065088757,0,empty,CD-0722-4
"G4,D6",13797,15252,10064,5188,8071,4242,1,4248,2747,1501,1.830113258,2431,2245,518,221,220,1,53,1,0.104545455,0,empty,CD-0722-4
"G4,D7",8970,9986,6623,3363,5147,2496,0,2501,1703,798,2.134085213,1424,2196,474,200,199,1,49,1,0.015075377,0,empty,CD-0722-4
"G4,D8",13633,14946,10374,4572,7858,3775,0,3779,2550,1229,2.074857608,2147,2209,534,224,221,3,52,1,0.095022624,0,empty,CD-0722-4
"G4,D9",6893,7805,5100,2705,4120,2067,0,2069,1495,574,2.604529617,1221,3102,487,198,196,2,49,1,0.204081633,0,empty,CD-0722-4
"G4,D10",12168,13748,8933,4815,7260,3828,0,3833,2591,1242,2.086151369,2182,1055,278,125,123,2,30,1,0.113821138,0,empty,CD-0722-4
"G4,D11",11256,12451,8480,3971,6534,3246,0,3247,2176,1071,2.031746032,1811,3411,841,326,324,2,74,2,0.049382716,0,empty,CD-0722-4
"G4,D12",1151924,1339447,852711,486736,646876,353347,17,353703,281966,71737,3.930551877,210060,176562,22289,8651,8460,191,1602,7,0.039243499,0,hg38,CD-0722-4
"G4,E1",23807,26048,17827,8221,13617,6818,1,6822,4712,2110,2.233175355,3740,3290,554,249,243,6,72,2,0.04526749,0,empty,CD-0722-4
"G4,E2",13695,14908,10219,4689,7864,4007,0,4009,2706,1303,2.076745971,2245,2672,485,218,213,5,60,2,0.009389671,0,empty,CD-0722-4
"G4,E3",8486,9186,6449,2737,4936,2357,3,2362,1562,800,1.9525,1320,2919,658,261,256,5,63,2,0.03515625,0,empty,CD-0722-4
"G4,E4",16014,18270,11807,6463,9710,5138,4,5147,3572,1575,2.267936508,3028,3575,842,308,297,11,75,2,0.249158249,0,empty,CD-0722-4
"G4,E5",11764,13036,8777,4259,6873,3408,0,3414,2311,1103,2.095194923,1945,1342,317,129,127,2,29,1,0.165354331,0,empty,CD-0722-4
"G4,E6",1761008,1884385,1375729,508656,882926,411137,7,411576,328048,83528,3.92740159,220699,188435,40652,14631,14445,186,1890,7,0.013568709,0,hg38,CD-0722-4
"G4,E7",24421,27196,18246,8950,14279,7310,0,7319,5199,2120,2.452358491,4147,3525,999,359,352,7,79,1,0.025568182,0,empty,CD-0722-4
"G4,E8",16887,18387,12945,5442,9764,4642,0,4645,3267,1378,2.370827286,2541,3908,786,298,287,11,71,2,0.156794425,0,empty,CD-0722-4
"G4,E9",11076,12498,8166,4332,6549,3431,0,3431,2433,998,2.437875752,1950,2946,596,247,245,2,70,2,0.016326531,0,empty,CD-0722-4
"G4,E10",12075,13770,8871,4899,7329,3872,0,3876,2598,1278,2.03286385,2262,2656,504,207,204,3,52,2,0.156862745,0,empty,CD-0722-4
"G4,E11",13057,14564,9704,4860,7749,3951,0,3952,2715,1237,2.194826192,2305,2525,700,262,260,2,66,2,0.073076923,0,empty,CD-0722-4
"G4,E12",16753,19429,12418,7011,10425,5527,0,5530,3875,1655,2.341389728,3345,2374,589,220,218,2,52,1,0.027522936,0,empty,CD-0722-4
"G4,F1",15540,17043,11543,5500,8978,4491,0,4493,3053,1440,2.120138889,2565,2589,548,225,224,1,62,1,0.075892857,0,empty,CD-0722-4
"G4,F2",12297,13884,9131,4753,7430,3755,0,3765,2555,1210,2.111570248,2194,3968,1111,409,407,2,86,2,0.049140049,0,empty,CD-0722-4
"G4,F3",82290,95775,61240,34535,47689,25981,0,25998,20276,5722,3.543516253,15322,11465,2196,907,899,8,211,2,0.058954394,0,empty,CD-0722-4
"G4,F4",17960,20037,13348,6689,10674,5293,0,5302,3652,1650,2.213333333,3078,1045,184,65,64,1,23,1,0.046875,0,empty,CD-0722-4
"G4,F5",13626,14754,10173,4581,7887,3737,0,3740,2470,1270,1.94488189,2109,2564,483,228,226,2,51,2,0.057522124,0,empty,CD-0722-4
"G4,F6",24715,28803,18175,10628,15159,8150,11,8169,6056,2113,2.866067203,4848,4224,1035,408,402,6,107,3,0.044776119,0,empty,CD-0722-4
"G4,F7",16482,18736,12299,6437,10077,5103,0,5104,3572,1532,2.331592689,2928,1819,533,208,204,4,45,2,0.078431373,0,empty,CD-0722-4
"G4,F8",13926,15627,10684,4943,8522,4252,0,4261,3023,1238,2.44184168,2458,403,85,39,39,0,9,0,0,0,empty,CD-0722-4
"G4,F9",14718,16521,10964,5557,8607,4298,0,4305,3170,1135,2.792951542,2453,3377,882,320,319,1,81,1,0.053291536,0,empty,CD-0722-4
"G4,F10",17800,19869,13341,6528,10568,5125,0,5132,3695,1437,2.571329158,2924,2569,614,200,198,2,56,2,0.121212121,0,empty,CD-0722-4
"G4,F11",13251,14733,10080,4653,7568,3720,0,3725,2598,1127,2.305235138,2065,2065,443,164,160,4,47,3,0.05,0,empty,CD-0722-4
"G4,F12",1334607,1531434,992440,538994,727523,392657,4,393045,316408,76637,4.128658481,230310,12467,1970,762,747,15,167,2,0.057563588,0,hg38,CD-0722-4
"G4,G1",27433,30934,20729,10205,15795,8015,1,8032,5751,2281,2.521262604,4608,3905,974,390,385,5,109,2,0.054545455,0,empty,CD-0722-4
"G4,G2",21190,24054,15046,9008,11984,6530,0,6539,4376,2163,2.023116043,3907,922,306,149,146,3,39,2,0.047945205,0,empty,CD-0722-4
"G4,G3",16292,18079,12274,5805,9505,4659,10,4672,2990,1682,1.77764566,2620,5517,1225,472,468,4,108,2,0.143162393,0,empty,CD-0722-4
"G4,G4",25628,29160,18479,10681,15272,8399,0,8411,5355,3056,1.752290576,4895,163,14,9,9,0,3,0,0,0,empty,CD-0722-4
"G4,G5",8300,9216,6291,2925,4857,2384,1,2389,1597,792,2.016414141,1334,1774,337,127,126,1,33,1,0,0,empty,CD-0722-4
"G4,G6",14200,15681,10566,5115,8269,4089,17,4115,2824,1291,2.187451588,2292,195,20,11,11,0,5,0,0.545454545,0,empty,CD-0722-4
"G4,G7",12771,13834,9701,4133,7468,3531,24,3556,2485,1071,2.320261438,1912,6933,1609,654,640,14,165,2,0.128125,0,empty,CD-0722-4
"G4,G8",9893,10907,7256,3651,6108,3105,2,3107,2197,910,2.414285714,1795,2256,687,247,247,0,59,0,0.048582996,0,empty,CD-0722-4
"G4,G9",12840,14598,9631,4967,7823,3960,1,3961,2762,1199,2.303586322,2311,3603,893,331,326,5,80,2,0.110429448,0,empty,CD-0722-4
"G4,G10",16608,18743,12543,6200,9947,5127,0,5132,3587,1545,2.321682848,2980,2703,597,265,251,14,72,2,0.071713147,0,empty,CD-0722-4
"G4,G11",14772,16173,11172,5001,8654,4225,0,4227,3046,1181,2.579170195,2314,1599,275,138,136,2,43,2,0.051470588,0,empty,CD-0722-4
"G4,G12",8810,9812,6392,3420,5207,2721,0,2725,1813,912,1.987938596,1573,2228,610,225,219,6,55,2,0.059360731,0,empty,CD-0722-4
"G4,H1",772278,849714,586344,263370,419850,205598,2,205784,154336,51448,2.999844503,117596,77176,9558,3738,3632,106,612,3,0.075165198,0,hg38,CD-0722-4
"G4,H2",11375,12593,8356,4237,6804,3552,0,3557,2389,1168,2.045376712,2052,3243,781,257,251,6,67,2,0.091633466,0,empty,CD-0722-4
"G4,H3",1136129,1305722,841214,464508,628686,331478,19,331829,262022,69807,3.753520421,197244,7939,2867,994,991,3,309,2,0.04641776,0,hg38,CD-0722-4
"G4,H4",14815,16401,11062,5339,8557,4380,0,4384,3047,1337,2.278982797,2501,78,13,10,10,0,9,0,0.1,0,empty,CD-0722-4
"G4,H5",15818,17838,11700,6138,9634,5035,0,5037,3499,1538,2.27503251,2955,2632,781,308,305,3,70,2,0.078688525,0,empty,CD-0722-4
"G4,H6",13195,15254,9605,5649,7977,4225,0,4228,2937,1291,2.274980635,2540,2017,398,168,167,1,55,1,0.131736527,0,empty,CD-0722-4
"G4,H7",11079,12222,8172,4050,6561,3316,0,3317,2262,1055,2.144075829,1921,2636,644,252,251,1,50,1,0.047808765,0,empty,CD-0722-4
"G4,H8",19968,22932,14828,8104,12006,6292,0,6302,4555,1747,2.607326846,3724,3126,686,299,297,2,74,2,0.023569024,0,empty,CD-0722-4
"G4,H9",12672,13814,9778,4036,7107,3323,20,3344,2363,981,2.408766565,1831,1401,411,185,185,0,50,0,0.124324324,0,empty,CD-0722-4
"G4,H10",8790,9837,6417,3420,5247,2718,2,2722,1880,842,2.232779097,1628,1409,176,70,67,3,20,2,0.149253731,0,empty,CD-0722-4
"G4,H11",9017,10346,6289,4057,5378,3185,0,3185,1709,1476,1.157859079,1918,84,49,15,15,0,3,0,0,0,empty,CD-0722-4
"G4,H12",13143,14678,9773,4905,7664,3960,0,3962,2864,1098,2.608378871,2259,2136,372,169,167,2,44,1,0.05988024,0,empty,CD-0722-4
"G5,A1",10081,11333,7504,3829,5998,3189,3,3198,2135,1063,2.008466604,1822,1054,171,77,77,0,26,0,0.012987013,0,empty,CD-0722-4
"G5,A2",16135,17605,12310,5295,9114,4600,0,4601,3212,1389,2.312455004,2534,1865,453,200,199,1,52,1,0.030150754,0,empty,CD-0722-4
"G5,A3",828389,924828,628420,296408,451221,225865,1,226076,169517,56559,2.997171096,129055,97455,11339,4274,4150,124,762,7,0.034457831,0,hg38,CD-0722-4
"G5,A4",14963,16514,11248,5266,8547,4261,0,4267,2864,1403,2.041339986,2373,652,93,46,44,2,18,1,0.090909091,0,empty,CD-0722-4
"G5,A5",16345,17972,12197,5775,9398,4774,0,4778,3340,1438,2.322670376,2668,2516,571,231,229,2,63,2,0.061135371,0,empty,CD-0722-4
"G5,A6",520537,654139,358004,296135,323104,218698,0,218836,158038,60798,2.599394717,133829,8621,1110,324,317,7,90,2,0.1829653,0,hg38,CD-0722-4
"G5,A7",9202,10519,6850,3669,5557,3005,9,3014,2030,984,2.06300813,1751,1654,665,250,249,1,47,1,0.008032129,0,empty,CD-0722-4
"G5,A8",7370,8102,5603,2499,4308,2187,0,2187,1533,654,2.344036697,1194,1809,348,136,135,1,46,1,0.022222222,0,empty,CD-0722-4
"G5,A9",13699,15038,10355,4683,7883,3952,0,3955,2800,1155,2.424242424,2205,1741,452,194,190,4,52,3,0.047368421,0,empty,CD-0722-4
"G5,A10",14284,15812,10862,4950,8021,4021,0,4026,2689,1337,2.011219147,2202,458,92,38,37,1,12,1,0,0,empty,CD-0722-4
"G5,A11",9241,10092,7120,2972,5167,2380,26,2411,1636,775,2.110967742,1287,1411,419,146,146,0,36,0,0.006849315,0,empty,CD-0722-4
"G5,A12",17362,19042,13060,5982,9888,4916,0,4923,3465,1458,2.37654321,2733,3615,768,301,298,3,72,2,0.134228188,0,empty,CD-0722-4
"G5,B1",9877,11147,7392,3755,5872,3022,0,3030,1976,1054,1.874762808,1714,1182,217,100,98,2,36,1,0.051020408,0,empty,CD-0722-4
"G5,B2",10105,11012,6972,4040,5706,3039,24,3065,2025,1040,1.947115385,1833,531,134,40,38,2,9,1,0.184210526,0,empty,CD-0722-4
"G5,B3",10611,12141,7837,4304,6263,3263,0,3269,2278,991,2.298688194,1879,1359,417,136,135,1,26,1,0.059259259,0,empty,CD-0722-4
"G5,B4",10905,12606,8045,4561,6559,3509,0,3510,2361,1149,2.054830287,2098,1532,392,148,146,2,34,1,0.130136986,0,empty,CD-0722-4
"G5,B5",11495,7286,4489,2797,4758,2550,6,2569,1767,802,2.203241895,1609,847,144,67,67,0,24,0,0.014925373,0,empty,CD-0722-4
"G5,B6",14183,16264,10309,5955,8464,4679,0,4685,3183,1502,2.119174434,2719,2347,477,196,195,1,43,1,0.138461538,0,empty,CD-0722-4
"G5,B7",12072,13316,9131,4185,6952,3396,5,3406,2316,1090,2.124770642,1919,2159,616,245,245,0,59,0,0.004081633,0,empty,CD-0722-4
"G5,B8",777388,860709,595621,265088,417231,202368,0,202608,154925,47683,3.24906151,113616,60899,11158,4313,4267,46,779,4,0.042418561,0,hg38,CD-0722-4
"G5,B9",16007,17858,11990,5868,9296,4845,0,4857,3222,1635,1.970642202,2724,1081,216,96,96,0,27,0,0.083333333,0,empty,CD-0722-4
"G5,B10",9727,10467,6839,3628,5764,3002,0,3011,2058,953,2.159496327,1757,780,108,41,41,0,13,0,0.463414634,0,empty,CD-0722-4
"G5,B11",16700,18764,12241,6523,9609,5209,0,5214,3244,1970,1.646700508,2998,263,82,36,36,0,7,0,0,0,empty,CD-0722-4
"G5,B12",862439,1058786,586160,472626,522868,349885,1,350152,254840,95312,2.673745174,214763,13087,1297,438,424,14,96,2,0.103773585,0,hg38,CD-0722-4
"G5,C1",20078,21911,15086,6825,11420,5593,0,5598,3721,1877,1.982418753,3107,1369,321,122,119,3,38,1,0.142857143,0,empty,CD-0722-4
"G5,C2",26403,29705,19715,9990,14569,7429,1,7438,5188,2250,2.305777778,4263,2520,572,209,205,4,67,2,0.004878049,0,empty,CD-0722-4
"G5,C3",15157,16743,11340,5403,8848,4462,27,4500,3051,1449,2.105590062,2571,826,170,62,62,0,14,0,0.516129032,0,empty,CD-0722-4
"G5,C4",11195,12450,8387,4063,6504,3180,13,3199,2208,991,2.228052472,1798,2147,548,207,205,2,45,1,0,0,empty,CD-0722-4
"G5,C5",14664,16893,10792,6101,8601,4503,25,4530,2992,1538,1.945383615,2654,1949,432,190,181,9,39,3,0.226519337,0,empty,CD-0722-4
"G5,C6",12206,13823,8783,5040,7267,3840,15,3861,2613,1248,2.09375,2276,2105,435,156,154,2,40,2,0.103896104,0,empty,CD-0722-4
"G5,C7",16258,18488,11914,6574,9419,5236,1,5245,3207,2038,1.57360157,3043,329,27,9,9,0,4,0,0,0,empty,CD-0722-4
"G5,C8",18216,20239,13509,6730,10489,5313,0,5315,3586,1729,2.074031232,3048,3358,749,315,312,3,72,2,0.070512821,0,empty,CD-0722-4
"G5,C9",14610,16552,10740,5812,8629,4374,0,4381,3083,1298,2.375192604,2554,1886,333,135,129,6,38,2,0.015503876,0,empty,CD-0722-4
"G5,C10",13986,15431,10539,4892,7927,3872,3,3880,2726,1154,2.362218371,2190,3053,771,318,314,4,66,1,0.015923567,0,empty,CD-0722-4
"G5,C11",12734,13883,9352,4531,7240,3673,2,3677,2616,1061,2.465598492,2104,1719,453,179,179,0,56,0,0.100558659,0,empty,CD-0722-4
"G5,C12",19720,21567,14919,6648,11393,5520,0,5522,3830,1692,2.263593381,3036,2593,780,242,240,2,58,1,0.029166667,0,empty,CD-0722-4
"G5,D1",13569,15531,9747,5784,8044,4384,0,4386,2707,1679,1.612269208,2562,615,63,27,27,0,16,0,0.074074074,0,empty,CD-0722-4
"G5,D2",10470,11303,7886,3417,5990,2885,0,2886,1925,961,2.003121748,1637,2645,577,251,248,3,70,2,0.080645161,0,empty,CD-0722-4
"G5,D3",12306,13895,9094,4801,7181,3724,0,3728,2574,1154,2.2305026,2157,1376,262,161,161,0,42,0,0.086956522,0,empty,CD-0722-4
"G5,D4",9900,11857,7210,4647,6107,3298,0,3303,2288,1015,2.254187192,1979,1194,304,125,118,7,37,1,0.06779661,0,empty,CD-0722-4
"G5,D5",9949,11279,7390,3889,5990,3073,0,3075,2133,942,2.26433121,1827,1546,300,120,113,7,36,2,0.203539823,0,empty,CD-0722-4
"G5,D6",13532,14926,9722,5204,7595,3991,0,3993,2456,1537,1.597918022,2318,1843,549,160,159,1,42,1,0.050314465,0,empty,CD-0722-4
"G5,D7",8978,9829,6771,3058,4989,2404,1,2406,1695,711,2.383966245,1336,2364,488,203,201,2,42,1,0.034825871,0,empty,CD-0722-4
"G5,D8",10533,11727,7887,3840,6093,3047,0,3051,2085,966,2.158385093,1756,1096,148,69,68,1,24,1,0.044117647,0,empty,CD-0722-4
"G5,D9",6058,6957,4461,2496,3585,1817,0,1820,1278,542,2.357933579,1080,1474,310,139,138,1,35,1,0.15942029,0,empty,CD-0722-4
"G5,D10",10012,11348,7220,4128,5912,3201,0,3203,2156,1047,2.05921681,1865,951,101,43,42,1,17,1,0.119047619,0,empty,CD-0722-4
"G5,D11",10653,11792,8081,3711,6146,3003,0,3004,2012,992,2.028225806,1634,2840,681,298,293,5,67,3,0.078498294,0,empty,CD-0722-4
"G5,D12",16018,17972,11932,6040,9565,4872,0,4888,3365,1523,2.209455023,2897,3726,967,402,400,2,91,1,0.145,0,empty,CD-0722-4
"G5,E1",21903,24074,16576,7498,12505,6164,2,6168,4210,1958,2.150153218,3407,2916,765,285,283,2,80,2,0.074204947,0,empty,CD-0722-4
"G5,E2",1008513,1215730,726650,489080,594482,346494,2,346770,272428,74342,3.664523419,213166,145517,19291,7738,7575,163,1215,5,0.070627063,0,hg38,CD-0722-4
"G5,E3",7930,8993,6011,2982,4600,2271,0,2276,1499,777,1.929214929,1319,2138,650,270,267,3,61,1,0.071161049,0,empty,CD-0722-4
"G5,E4",1064766,1240769,788156,452613,598574,329994,2,330298,263128,67170,3.917344052,196190,143749,20798,8337,8155,182,1397,6,0.037277744,0,hg38,CD-0722-4
"G5,E5",9418,10253,7088,3165,5416,2571,0,2572,1729,843,2.051008304,1446,1242,292,111,108,3,34,2,0.083333333,0,empty,CD-0722-4
"G5,E6",23144,25498,17360,8138,12894,6442,0,6449,4403,2046,2.15200391,3621,3741,784,299,296,3,85,1,0.016891892,0,empty,CD-0722-4
"G5,E7",22335,24970,16957,8013,12925,6523,0,6533,4536,1997,2.271407111,3620,3054,961,380,378,2,89,1,0.021164021,0,empty,CD-0722-4
"G5,E8",30961,35428,22998,12430,17626,9485,21,9515,6262,3253,1.924992315,5348,3106,681,302,298,4,80,2,0.046979866,0,empty,CD-0722-4
"G5,E9",10249,11778,7459,4319,6053,3221,0,3227,2296,931,2.466165414,1912,2577,725,282,276,6,70,2,0.025362319,0,empty,CD-0722-4
"G5,E10",10019,11145,7461,3684,5832,2953,0,2956,2017,939,2.148029819,1666,1925,583,214,213,1,48,1,0.042253521,0,empty,CD-0722-4
"G5,E11",12180,13476,9125,4351,7133,3652,0,3654,2389,1265,1.888537549,2046,2451,757,333,329,4,67,2,0.14893617,0,empty,CD-0722-4
"G5,E12",15793,17814,11690,6124,9260,4598,20,4630,3220,1410,2.283687943,2702,2584,471,216,213,3,56,1,0.079812207,0,empty,CD-0722-4
"G5,F1",18683,21251,13131,8120,11032,6130,17,6158,3274,2884,1.135228849,3769,1700,333,173,170,3,49,1,0.058823529,0,empty,CD-0722-4
"G5,F2",11751,13021,8822,4199,6626,3205,0,3212,2176,1036,2.1003861,1833,3106,725,271,265,6,64,3,0.064150943,0,empty,CD-0722-4
"G5,F3",13370,15155,9908,5247,7923,4113,5,4122,2944,1178,2.499151104,2464,2928,784,310,303,7,76,2,0.079207921,0,empty,CD-0722-4
"G5,F4",16856,18054,12836,5218,9454,4474,0,4479,3071,1408,2.181107955,2379,501,76,36,33,3,15,2,0.121212121,0,empty,CD-0722-4
"G5,F5",12995,13757,9538,4219,7033,3304,23,3341,2182,1159,1.882657463,1828,1859,519,241,239,2,67,2,0.083682008,0,empty,CD-0722-4
"G5,F6",2090362,2440076,1544802,895274,1160364,647748,19,648325,511787,136538,3.748311825,387719,403100,65931,25997,25529,468,3034,8,0.062517137,0,hg38,CD-0722-4
"G5,F7",15205,16749,11524,5225,8964,4374,0,4383,2989,1394,2.144189383,2443,1128,240,109,108,1,28,1,0.092592593,0,empty,CD-0722-4
"G5,F8",12618,14071,9513,4558,7502,3705,1,3706,2689,1017,2.644051131,2146,217,13,8,7,1,7,1,0.142857143,0,empty,CD-0722-4
"G5,F9",14496,15789,10964,4825,8166,3983,1,3995,2845,1150,2.473913043,2112,3198,898,371,362,9,82,2,0.077348066,0,empty,CD-0722-4
"G5,F10",15895,17677,12161,5516,9335,4601,0,4612,3215,1397,2.301360057,2488,1951,581,254,254,0,49,0,0.031496063,0,empty,CD-0722-4
"G5,F11",12536,13355,9574,3781,6932,3233,3,3240,2302,938,2.454157783,1755,1501,344,116,114,2,31,1,0.087719298,0,empty,CD-0722-4
"G5,F12",13609,15081,10099,4982,7686,3866,7,3877,2673,1204,2.220099668,2150,191,34,10,10,0,6,0,0,0,empty,CD-0722-4
"G5,G1",15063,16745,11246,5499,8956,4524,0,4535,3087,1448,2.131906077,2581,3203,610,261,258,3,88,1,0.031007752,0,empty,CD-0722-4
"G5,G2",7876,9005,5580,3425,4566,2449,0,2449,1551,898,1.727171492,1484,490,122,53,53,0,15,0,0.018867925,0,empty,CD-0722-4
"G5,G3",863733,795604,756808,38796,384472,68901,0,69067,55120,13947,3.952104395,15565,3608,1064,342,342,0,113,0,0.043859649,0,empty,CD-0722-4
"G5,G4",25576,29179,18355,10824,14881,8317,13,8336,5317,3019,1.761179198,4865,18,3,1,1,0,1,0,0,0,empty,CD-0722-4
"G5,G5",8466,9416,6272,3144,4928,2454,0,2457,1573,884,1.779411765,1414,1695,437,155,154,1,44,1,0.045454545,0,empty,CD-0722-4
"G5,G6",13293,14406,10153,4253,7667,3685,0,3691,2628,1063,2.472248354,2034,144,26,15,15,0,9,0,0,0,empty,CD-0722-4
"G5,G7",13159,14598,9952,4646,7765,3663,15,3684,2644,1040,2.542307692,2044,2886,618,259,257,2,76,2,0.073929961,0,empty,CD-0722-4
"G5,G8",9422,10465,6948,3517,5564,2806,1,2808,1880,928,2.025862069,1655,2044,488,176,176,0,56,0,0.034090909,0,empty,CD-0722-4
"G5,G9",11981,13727,8890,4837,7248,3746,0,3748,2573,1175,2.189787234,2218,2351,631,235,232,3,65,1,0.193965517,0,empty,CD-0722-4
"G5,G10",15326,17299,11521,5778,8872,4502,0,4508,3142,1366,2.300146413,2492,2269,534,238,236,2,70,1,0.055084746,0,empty,CD-0722-4
"G5,G11",14361,15992,10912,5080,8367,4166,3,4172,2961,1211,2.445086705,2364,1906,412,157,155,2,39,2,0.070967742,0,empty,CD-0722-4
"G5,G12",8907,9892,6560,3332,5199,2684,0,2692,1775,917,1.93565976,1527,2512,660,223,217,6,46,2,0,0,empty,CD-0722-4
"G5,H1",14777,16324,11037,5287,8504,4273,0,4285,3081,1204,2.5589701,2366,1106,150,77,75,2,27,1,0.08,0,empty,CD-0722-4
"G5,H2",14193,15866,10647,5219,8416,4176,0,4183,2936,1247,2.354450682,2456,2465,556,213,210,3,62,2,0,0,empty,CD-0722-4
"G5,H3",12022,13480,8645,4835,7164,3828,0,3830,2699,1131,2.386383731,2259,1642,433,174,170,4,43,2,0.147058824,0,empty,CD-0722-4
"G5,H4",15021,16687,11252,5435,8392,4094,0,4096,2830,1266,2.235387046,2323,353,34,16,16,0,8,0,0,0,empty,CD-0722-4
"G5,H5",15252,17074,11296,5778,8750,4448,7,4462,3044,1418,2.146685472,2554,1940,528,220,220,0,49,0,0.036363636,0,empty,CD-0722-4
"G5,H6",11976,13331,8835,4496,7035,3767,2,3770,2667,1103,2.417951043,2131,2296,672,221,220,1,54,1,0.131818182,0,empty,CD-0722-4
"G5,H7",10964,11976,8097,3879,6284,3049,3,3057,2117,940,2.25212766,1766,2394,854,330,324,6,55,2,0.040123457,0,empty,CD-0722-4
"G5,H8",18259,21015,13392,7623,10933,5847,0,5855,4166,1689,2.466548253,3502,2648,427,215,208,7,68,2,0.100961538,0,empty,CD-0722-4
"G5,H9",1101608,1212455,846052,366403,582739,284983,2,285279,221552,63727,3.476579786,159422,88723,13957,5439,5325,114,886,4,0.032300469,0,hg38,CD-0722-4
"G5,H10",8501,9362,6211,3151,4714,2370,0,2370,1645,725,2.268965517,1383,1312,329,89,87,2,25,1,0.149425287,0,empty,CD-0722-4
"G5,H11",11119,12645,7681,4964,6491,4030,1,4037,1989,2048,0.971191406,2371,25,16,7,7,0,3,0,0,0,empty,CD-0722-4
"G5,H12",11930,13655,8783,4872,7161,3776,1,3778,2692,1086,2.478821363,2255,1359,288,118,118,0,28,0,0.296610169,0,empty,CD-0722-4
"G6,A1",7708,8682,5680,3002,4661,2398,14,2418,1522,896,1.698660714,1438,1409,180,90,90,0,24,0,0.288888889,0,empty,CD-0722-4
"G6,A2",11077,12013,8155,3858,6316,3141,0,3143,2074,1069,1.940130964,1771,2016,503,178,176,2,38,1,0.164772727,0,empty,CD-0722-4
"G6,A3",785407,862995,599461,263534,421251,205368,5,205586,165441,40145,4.121086063,115759,75705,9928,4030,3951,79,764,6,0.035940268,0,hg38,CD-0722-4
"G6,A4",1314469,1500129,996984,503145,717755,376337,0,376685,306365,70320,4.356726394,214820,76418,9642,3914,3825,89,744,4,0.050718954,0,hg38,CD-0722-4
"G6,A5",10931,11874,8003,3871,6375,3160,11,3175,2145,1030,2.082524272,1772,2127,530,226,225,1,51,1,0.075555556,0,empty,CD-0722-4
"G6,A6",9467,10977,7037,3940,5831,3065,1,3068,2062,1006,2.049701789,1793,2775,823,304,300,4,86,2,0.106666667,0,empty,CD-0722-4
"G6,A7",18658,21097,14160,6937,10468,5122,0,5129,3527,1602,2.201622971,2920,3132,635,276,263,13,65,2,0.125475285,0,empty,CD-0722-4
"G6,A8",5096,5757,3900,1857,3074,1510,0,1516,1036,480,2.158333333,855,2058,557,217,214,3,49,1,0.08411215,0,empty,CD-0722-4
"G6,A9",8753,9786,6669,3117,5214,2618,0,2618,1766,852,2.072769953,1464,1959,496,205,203,2,47,1,0.108374384,0,empty,CD-0722-4
"G6,A10",655341,730932,502401,228531,358568,178121,2,178264,140089,38175,3.669652914,99980,27252,2717,978,952,26,226,3,0.032563025,0,hg38,CD-0722-4
"G6,A11",7007,7689,5289,2400,4092,1992,0,1992,1367,625,2.1872,1147,1778,458,176,174,2,40,1,0.028735632,0,empty,CD-0722-4
"G6,A12",11660,12683,8655,4028,6684,3199,0,3201,2124,1077,1.972144847,1767,5731,1466,625,617,8,140,2,0.113452188,0,empty,CD-0722-4
"G6,B1",7898,8716,5852,2864,4599,2284,1,2289,1486,803,1.850560399,1282,1371,427,157,155,2,45,1,0.077419355,0,empty,CD-0722-4
"G6,B2",8741,9658,6069,3589,5165,2780,1,2781,1752,1029,1.702623907,1655,578,52,24,24,0,9,0,0,0,empty,CD-0722-4
"G6,B3",7306,8070,5319,2751,4307,2216,1,2224,1545,679,2.275405007,1275,1604,314,129,127,2,45,1,0.05511811,0,empty,CD-0722-4
"G6,B4",7835,8858,5762,3096,4729,2421,12,2436,1570,866,1.812933025,1470,1495,286,118,110,8,32,1,0.3,0,empty,CD-0722-4
"G6,B5",8669,5287,3404,1883,3476,1813,0,1828,1165,663,1.757164404,1143,1127,209,83,83,0,24,0,0.084337349,0,empty,CD-0722-4
"G6,B6",9986,11551,7373,4178,6036,3256,0,3262,2148,1114,1.928186715,1920,1958,564,213,213,0,47,0,0.061032864,0,empty,CD-0722-4
"G6,B7",1129916,1264249,871689,392560,615310,301833,2,302101,230181,71920,3.200514461,171442,104662,12555,4927,4814,113,860,6,0.054216867,0,hg38,CD-0722-4
"G6,B8",7135,7959,5349,2610,4228,2119,1,2123,1485,638,2.327586207,1213,986,305,120,118,2,32,1,0.118644068,0,empty,CD-0722-4
"G6,B9",11791,13145,8574,4571,6882,3503,22,3526,2292,1234,1.857374392,2032,1022,224,82,80,2,31,1,0.0125,0,empty,CD-0722-4
"G6,B10",6626,7234,4826,2408,3964,1929,13,1948,1272,676,1.881656805,1134,416,65,26,26,0,13,0,0.461538462,0,empty,CD-0722-4
"G6,B11",12285,13599,8816,4783,7099,3858,1,3869,2352,1517,1.550428477,2246,265,65,35,35,0,8,0,0,0,empty,CD-0722-4
"G6,B12",7818,8530,5728,2802,4557,2283,0,2291,1643,648,2.535493827,1310,1622,363,136,136,0,41,0,0.036764706,0,empty,CD-0722-4
"G6,C1",15540,16470,11766,4704,8905,4249,0,4256,2817,1439,1.957609451,2278,1001,117,68,67,1,30,1,0.119402985,0,empty,CD-0722-4
"G6,C2",918564,1002848,706022,296826,485779,234012,4,234240,179791,54449,3.302007383,130193,64608,12890,4825,4739,86,840,4,0.027009918,0,hg38,CD-0722-4
"G6,C3",1262876,1533224,914082,619142,741725,435783,5,436172,345098,91074,3.789204383,266885,65299,10101,3913,3840,73,697,4,0.06953125,0,hg38,CD-0722-4
"G6,C4",8160,8732,6167,2565,4737,2241,15,2258,1516,742,2.043126685,1234,1998,470,216,211,5,50,1,0.08056872,0,empty,CD-0722-4
"G6,C5",22138,24542,17051,7491,12216,5782,0,5784,4132,1652,2.501210654,3237,2623,625,240,235,5,63,2,0.072340426,0,empty,CD-0722-4
"G6,C6",9323,10314,6828,3486,5388,2748,0,2755,1800,955,1.884816754,1559,2113,416,170,168,2,44,1,0.226190476,0,empty,CD-0722-4
"G6,C7",12024,13732,8932,4800,7266,3894,21,3918,2445,1473,1.6598778,2221,278,109,41,41,0,14,0,0,0,empty,CD-0722-4
"G6,C8",13716,15152,10329,4823,7802,3887,0,3889,2553,1336,1.910928144,2174,3657,790,286,285,1,78,1,0.038596491,0,empty,CD-0722-4
"G6,C9",10073,11360,7406,3954,5965,3033,0,3033,2032,1001,2.02997003,1741,1879,486,188,185,3,52,2,0.037837838,0,empty,CD-0722-4
"G6,C10",2628515,3092746,1944668,1148078,1459428,862601,5,863367,664483,198884,3.341058104,507758,277815,39714,15506,15191,315,2135,8,0.079389112,0,hg38,CD-0722-4
"G6,C11",10140,11270,7531,3739,5895,2997,1,3003,2068,935,2.211764706,1673,1952,421,188,187,1,56,1,0.165775401,0,empty,CD-0722-4
"G6,C12",14499,15954,10776,5178,8510,4203,0,4208,2831,1377,2.055918664,2418,2767,572,222,220,2,50,2,0.022727273,0,empty,CD-0722-4
"G6,D1",11135,12479,8104,4375,6617,3523,0,3525,2182,1343,1.624720774,2065,841,185,46,46,0,11,0,0,0,empty,CD-0722-4
"G6,D2",9161,10032,6982,3050,5180,2459,0,2463,1615,848,1.904481132,1345,2973,1050,384,380,4,78,1,0.031578947,0,empty,CD-0722-4
"G6,D3",10787,11789,8019,3770,6077,3065,10,3075,2032,1043,1.94822627,1737,1672,330,142,140,2,34,1,0.142857143,0,empty,CD-0722-4
"G6,D4",7288,8099,5420,2679,4445,2244,3,2250,1518,732,2.073770492,1294,1538,433,151,145,6,30,1,0,0,empty,CD-0722-4
"G6,D5",1511461,1721574,1139349,582225,832286,433647,7,434095,341186,92909,3.672259953,253872,116991,21350,8194,8084,110,1368,6,0.022884711,0,hg38,CD-0722-4
"G6,D6",876482,927069,695566,231503,448462,185426,17,185662,150261,35401,4.244541115,97381,2807,705,233,232,1,81,1,0.034482759,0,hg38,CD-0722-4
"G6,D7",6630,7176,5117,2059,3908,1802,0,1807,1189,618,1.92394822,1001,1978,442,151,151,0,43,0,0.079470199,0,empty,CD-0722-4
"G6,D8",7920,8512,5832,2680,4440,2169,0,2170,1415,755,1.874172185,1196,1167,225,92,91,1,33,1,0.054945055,0,empty,CD-0722-4
"G6,D9",4665,5024,3535,1489,2639,1246,0,1246,874,372,2.349462366,683,1735,354,144,143,1,42,1,0.097902098,0,empty,CD-0722-4
"G6,D10",8816,10015,6532,3483,5164,2613,0,2613,1779,834,2.133093525,1524,1023,84,33,27,6,14,2,0,0,empty,CD-0722-4
"G6,D11",910739,1033516,689379,344137,500834,261293,1,261563,205560,56003,3.670517651,149562,128205,21365,8104,7995,109,1302,6,0.044027517,0,hg38,CD-0722-4
"G6,D12",11683,12934,8824,4110,6849,3425,0,3427,2387,1040,2.295192308,1907,3228,700,296,295,1,90,1,0.044067797,0,empty,CD-0722-4
"G6,E1",480115,439143,427344,11799,216316,16229,7,16335,11193,5142,2.176779463,5132,3262,752,280,278,2,92,1,0.017985612,0,empty,CD-0722-4
"G6,E2",11071,12094,8080,4014,6319,3165,3,3174,2116,1058,2,1839,2936,595,237,234,3,58,2,0.170940171,0,empty,CD-0722-4
"G6,E3",7050,7779,5256,2523,4152,2037,0,2039,1341,698,1.921203438,1159,3513,837,364,360,4,88,2,0.052777778,0,empty,CD-0722-4
"G6,E4",10305,11412,7611,3801,6224,3252,0,3256,2182,1074,2.031657356,1883,2275,681,237,235,2,66,2,0.14893617,0,empty,CD-0722-4
"G6,E5",7783,8303,5990,2313,4344,1940,0,1942,1282,660,1.942424242,1016,1130,371,124,124,0,30,0,0,0,empty,CD-0722-4
"G6,E6",14987,16797,11240,5557,8648,4400,16,4421,2890,1531,1.887655127,2505,3645,950,371,362,9,91,2,0.066298343,0,empty,CD-0722-4
"G6,E7",14629,16070,11002,5068,8628,4236,2,4244,2819,1425,1.978245614,2390,2864,719,290,277,13,75,3,0.093862816,0,empty,CD-0722-4
"G6,E8",11690,12948,8990,3958,6872,3327,0,3331,2258,1073,2.104380242,1824,3124,706,291,281,10,77,2,0.060498221,0,empty,CD-0722-4
"G6,E9",7047,7885,5199,2686,4272,2235,1,2241,1528,713,2.143057504,1298,2482,475,201,201,0,47,0,0.154228856,0,empty,CD-0722-4
"G6,E10",1566527,1901467,1114669,786798,925265,599639,2,600086,453658,146428,3.098164286,360789,12977,1188,427,421,6,84,2,0.249406176,0,hg38,CD-0722-4
"G6,E11",10449,11426,7637,3789,5986,3016,0,3016,2038,978,2.083844581,1684,2533,484,208,207,1,41,1,0.1352657,0,empty,CD-0722-4
"G6,E12",10932,12125,7992,4133,6404,3203,0,3205,2153,1052,2.046577947,1862,1934,455,206,204,2,48,1,0.083333333,0,empty,CD-0722-4
"G6,F1",11941,12948,8834,4114,6893,3442,0,3443,2216,1227,1.80603097,1940,2360,732,309,309,0,64,0,0.220064725,0,empty,CD-0722-4
"G6,F2",10312,11453,7730,3723,6012,2961,1,2967,2020,947,2.133051742,1687,3051,745,325,325,0,71,0,0.135384615,0,empty,CD-0722-4
"G6,F3",9760,10790,7367,3423,5742,2787,8,2799,1961,838,2.340095465,1591,3867,800,328,321,7,76,1,0.08411215,0,empty,CD-0722-4
"G6,F4",13840,14732,10362,4370,7906,3772,0,3774,2534,1240,2.043548387,2092,606,122,56,52,4,20,2,0.211538462,0,empty,CD-0722-4
"G6,F5",11194,11984,8462,3522,6256,2865,0,2868,1926,942,2.044585987,1545,2480,497,193,187,6,58,2,0.005347594,0,empty,CD-0722-4
"G6,F6",13631,15407,10148,5259,8269,4319,0,4334,3026,1308,2.313455657,2538,3001,657,258,255,3,74,2,0.105882353,0,empty,CD-0722-4
"G6,F7",12496,13688,9316,4372,7424,3697,0,3697,2468,1229,2.008136697,2092,1085,182,68,67,1,32,1,0.059701493,0,empty,CD-0722-4
"G6,F8",1111117,1306695,821302,485393,636291,354981,2,355306,278859,76447,3.647742881,211255,20420,2956,1148,1119,29,228,2,0.071492404,0,hg38,CD-0722-4
"G6,F9",10094,10973,7565,3408,5823,2814,0,2816,1944,872,2.229357798,1557,2239,464,171,166,5,55,1,0.084337349,0,empty,CD-0722-4
"G6,F10",14781,16744,11205,5539,8761,4289,27,4318,2932,1386,2.115440115,2463,2068,525,224,220,4,49,2,0.15,0,empty,CD-0722-4
"G6,F11",9233,10150,6930,3220,5211,2427,0,2433,1665,768,2.16796875,1346,1861,316,134,131,3,36,2,0.030534351,0,empty,CD-0722-4
"G6,F12",10389,11732,7645,4087,5979,2979,0,2984,1972,1012,1.948616601,1744,71,11,9,9,0,5,0,0,0,empty,CD-0722-4
"G6,G1",11840,12959,8950,4009,6796,3305,12,3321,2262,1059,2.135977337,1800,2433,672,333,331,2,72,1,0.105740181,0,empty,CD-0722-4
"G6,G2",6092,6740,4326,2414,3553,1867,2,1870,1176,694,1.694524496,1092,419,66,30,28,2,9,1,0,0,empty,CD-0722-4
"G6,G3",12334,13273,9238,4035,6854,3442,12,3457,2134,1323,1.613000756,1823,2662,541,247,246,1,63,1,0.073170732,0,empty,CD-0722-4
"G6,G4",21733,24146,15574,8572,12657,6995,14,7013,4412,2601,1.696270665,4051,83,52,15,15,0,2,0,0.933333333,0,empty,CD-0722-4
"G6,G5",7011,7761,5155,2606,4168,2118,0,2118,1355,763,1.775884666,1240,1714,329,145,143,2,31,1,0.097902098,0,empty,CD-0722-4
"G6,G6",11064,11939,8342,3597,6199,2983,1,2986,2086,900,2.317777778,1594,178,23,18,16,2,10,1,0.125,0,empty,CD-0722-4
"G6,G7",9692,10422,7563,2859,5501,2545,0,2545,1780,765,2.326797386,1381,3351,994,403,401,2,85,1,0.009975062,0,empty,CD-0722-4
"G6,G8",7127,7848,5136,2712,4291,2100,10,2115,1451,664,2.185240964,1260,1724,436,158,158,0,41,0,0.120253165,0,empty,CD-0722-4
"G6,G9",8992,9961,6815,3146,5400,2685,0,2685,1803,882,2.044217687,1551,1992,315,146,145,1,60,1,0,0,empty,CD-0722-4
"G6,G10",874527,1042554,629405,413149,520260,316229,2,316517,254995,61522,4.144777478,188632,43159,24301,8834,8829,5,1501,2,0.012685468,0,hg38,CD-0722-4
"G6,G11",10307,10956,7721,3235,5919,2798,1,2799,1902,897,2.120401338,1538,1326,291,134,131,3,33,2,0.190839695,0,empty,CD-0722-4
"G6,G12",7301,8282,5365,2917,4354,2263,0,2265,1478,787,1.878017789,1299,2303,636,254,253,1,55,1,0.027667984,0,empty,CD-0722-4
"G6,H1",9772,10889,7284,3605,5763,2852,16,2868,1916,952,2.012605042,1687,1295,312,137,135,2,35,1,0.088888889,0,empty,CD-0722-4
"G6,H2",10109,11366,7440,3926,5924,3066,0,3070,2054,1016,2.021653543,1786,2082,421,170,167,3,50,2,0.053892216,0,empty,CD-0722-4
"G6,H3",8989,10138,6642,3496,5379,2789,11,2804,1885,919,2.051142546,1612,1605,369,139,135,4,35,2,0.02962963,0,empty,CD-0722-4
"G6,H4",12652,13869,9377,4492,7273,3576,13,3592,2326,1266,1.83728278,2011,253,15,8,8,0,7,0,0,0,empty,CD-0722-4
"G6,H5",12655,14257,9258,4999,7505,3866,0,3867,2505,1362,1.839207048,2279,2354,589,230,227,3,48,3,0.004405286,0,empty,CD-0722-4
"G6,H6",7921,9203,5774,3429,4881,2571,0,2573,1749,824,2.122572816,1569,1935,455,224,224,0,62,0,0.040178571,0,empty,CD-0722-4
"G6,H7",8545,9410,6278,3132,4970,2460,0,2465,1693,772,2.193005181,1435,2091,672,245,242,3,54,1,0.090909091,0,empty,CD-0722-4
"G6,H8",11451,13190,8320,4870,6922,3654,0,3661,2443,1218,2.005747126,2167,2227,570,222,219,3,64,3,0.050228311,0,empty,CD-0722-4
"G6,H9",8982,9864,6819,3045,5075,2409,3,2414,1716,698,2.458452722,1325,1083,294,127,122,5,41,2,0.016393443,0,empty,CD-0722-4
"G6,H10",6622,7215,4824,2391,3757,1831,17,1850,1254,596,2.104026846,1059,1253,256,84,84,0,29,0,0.107142857,0,empty,CD-0722-4
"G6,H11",8118,9306,5667,3639,4767,2812,2,2814,1480,1334,1.109445277,1710,13,0,0,0,0,0,0,0,0,empty,CD-0722-4
"G6,H12",7964,8939,5828,3111,4665,2449,0,2451,1657,794,2.086901763,1445,1221,193,82,79,3,24,2,0.113924051,0,empty,CD-0722-4
"G7,A1",6902,7660,5119,2541,4029,2004,62,2066,1344,722,1.861495845,1168,1414,286,105,105,0,31,0,0.028571429,0,empty,CD-0722-4
"G7,A2",9697,10836,7119,3717,5616,2857,0,2859,1873,986,1.89959432,1642,2004,562,243,240,3,62,2,0.0375,0,empty,CD-0722-4
"G7,A3",6428,7206,4707,2499,3873,1946,5,1951,1288,663,1.942684766,1144,1394,375,156,149,7,30,2,0.174496644,0,empty,CD-0722-4
"G7,A4",11124,12196,8309,3887,6324,3148,0,3154,2022,1132,1.786219081,1758,609,82,37,35,2,14,1,0.2,0,empty,CD-0722-4
"G7,A5",10176,11194,7609,3585,5990,3002,0,3002,2042,960,2.127083333,1722,2798,527,209,203,6,55,2,0.024630542,0,empty,CD-0722-4
"G7,A6",9362,10519,7027,3492,5552,2840,0,2843,1874,969,1.933952528,1584,3726,773,323,315,8,70,1,0.082539683,0,empty,CD-0722-4
"G7,A7",6806,7763,5092,2671,4009,2101,2,2107,1315,792,1.660353535,1181,1300,358,132,129,3,26,2,0.046511628,0,empty,CD-0722-4
"G7,A8",4551,5271,3410,1861,2793,1468,0,1468,1029,439,2.343963554,867,2027,548,175,170,5,51,2,0.029411765,0,empty,CD-0722-4
"G7,A9",7777,8608,5837,2771,4684,2355,1,2358,1620,738,2.195121951,1345,1921,455,199,199,0,42,0,0.085427136,0,empty,CD-0722-4
"G7,A10",7742,8260,5973,2287,4226,1949,0,1949,1258,691,1.820549928,992,380,53,30,30,0,15,0,0,0,empty,CD-0722-4
"G7,A11",5752,6468,4442,2026,3411,1587,3,1594,1058,536,1.973880597,913,1854,413,124,114,10,34,2,0.043859649,0,empty,CD-0722-4
"G7,A12",9004,9704,6854,2850,5318,2565,0,2570,1773,797,2.224592221,1400,4073,830,376,375,1,83,1,0.101333333,0,empty,CD-0722-4
"G7,B1",7525,8035,5478,2557,4315,2280,0,2280,1504,776,1.93814433,1263,1257,331,142,139,3,34,1,0.100719424,0,empty,CD-0722-4
"G7,B2",8165,8742,5596,3146,4747,2569,0,2572,1631,941,1.733262487,1464,539,161,54,54,0,8,0,0,0,empty,CD-0722-4
"G7,B3",6246,6922,4641,2281,3657,1839,0,1839,1278,561,2.278074866,1045,1664,455,147,141,6,40,1,0.106382979,0,empty,CD-0722-4
"G7,B4",6518,7338,4814,2524,3831,1974,0,1975,1285,690,1.862318841,1140,1551,454,163,163,0,31,0,0.049079755,0,empty,CD-0722-4
"G7,B5",10485,6986,4398,2588,4374,2317,0,2335,1625,710,2.288732394,1428,1544,334,133,132,1,32,1,0.022727273,0,empty,CD-0722-4
"G7,B6",8387,9420,6050,3370,5044,2715,0,2715,1736,979,1.773237998,1573,1729,527,190,185,5,47,1,0.010810811,0,empty,CD-0722-4
"G7,B7",26505,30431,19621,10810,15230,8470,0,8473,5472,3001,1.823392203,4878,1563,328,113,112,1,23,1,0.169642857,0,empty,CD-0722-4
"G7,B8",6199,6862,4648,2214,3693,1808,1,1821,1209,612,1.975490196,1016,1094,346,132,129,3,33,1,0.007751938,0,empty,CD-0722-4
"G7,B9",10454,11510,7694,3816,6001,3101,1,3104,1997,1107,1.803974706,1726,1002,210,46,45,1,22,1,0.155555556,0,empty,CD-0722-4
"G7,B10",5733,5963,4223,1740,3366,1631,0,1634,1091,543,2.009208103,841,315,28,17,17,0,8,0,0.058823529,0,empty,CD-0722-4
"G7,B11",10780,11889,7891,3998,6156,3346,0,3348,1990,1358,1.46539028,1904,282,85,33,32,1,9,1,0.1875,0,empty,CD-0722-4
"G7,B12",6754,7775,5052,2723,4059,2084,0,2085,1367,718,1.903899721,1185,1397,405,132,131,1,36,1,0.13740458,0,empty,CD-0722-4
"G7,C1",14962,16167,11400,4767,8530,4077,1,4080,2683,1397,1.920544023,2185,977,240,94,94,0,28,0,0.021276596,0,empty,CD-0722-4
"G7,C2",10975,12214,8093,4121,6369,3267,25,3298,2115,1183,1.787827557,1907,2203,547,230,228,2,62,1,0.092105263,0,empty,CD-0722-4
"G7,C3",11190,12168,8372,3796,6478,3246,0,3246,2126,1120,1.898214286,1810,1375,310,120,120,0,25,0,0.108333333,0,empty,CD-0722-4
"G7,C4",7075,7785,5231,2554,4133,1999,15,2015,1365,650,2.1,1164,2061,489,207,205,2,44,2,0.019512195,0,empty,CD-0722-4
"G7,C5",10565,11790,7837,3953,6364,3269,0,3272,2121,1151,1.842745439,1905,1972,487,171,164,7,43,1,0.042682927,0,empty,CD-0722-4
"G7,C6",7829,8425,5738,2687,4646,2304,0,2309,1533,776,1.975515464,1299,1602,473,186,182,4,41,2,0.054945055,0,empty,CD-0722-4
"G7,C7",10978,12722,7848,4874,6679,3705,15,3722,2311,1411,1.6378455,2263,313,46,18,18,0,9,0,0,0,empty,CD-0722-4
"G7,C8",826023,933296,617825,315471,457778,238994,11,239236,182585,56651,3.222979294,138547,201354,29972,11735,11493,242,1625,8,0.055860089,0,hg38,CD-0722-4
"G7,C9",8909,9820,6571,3249,5195,2648,0,2652,1781,871,2.044776119,1489,1572,368,143,142,1,32,1,0.091549296,0,empty,CD-0722-4
"G7,C10",10104,10964,7509,3455,5830,2822,2,2828,1829,999,1.830830831,1586,2453,545,212,212,0,41,0,0.037735849,0,empty,CD-0722-4
"G7,C11",9235,10194,6909,3285,5370,2696,10,2710,1802,908,1.984581498,1473,1759,456,201,201,0,45,0,0.094527363,0,empty,CD-0722-4
"G7,C12",13069,14159,9917,4242,7320,3497,0,3499,2375,1124,2.112989324,1911,2750,775,252,249,3,54,2,0.036144578,0,empty,CD-0722-4
"G7,D1",10568,11980,7840,4140,6340,3314,0,3319,2035,1284,1.584890966,1960,852,114,38,37,1,19,1,0,0,empty,CD-0722-4
"G7,D2",9212,10023,7116,2907,5216,2432,1,2435,1595,840,1.898809524,1311,3392,1034,410,405,5,103,1,0.09382716,0,empty,CD-0722-4
"G7,D3",7809,8916,5628,3288,4724,2503,0,2514,1659,855,1.940350877,1491,1234,332,147,146,1,37,1,0.034246575,0,empty,CD-0722-4
"G7,D4",7129,8056,5283,2773,4282,2164,0,2166,1507,659,2.286798179,1270,1457,371,128,127,1,38,1,0.149606299,0,empty,CD-0722-4
"G7,D5",7083,8012,5177,2835,4219,2186,1,2189,1438,751,1.914780293,1280,1672,353,131,129,2,43,1,0.015503876,0,empty,CD-0722-4
"G7,D6",10361,11713,7323,4390,6040,3322,1,3330,2101,1229,1.709519935,1990,1720,479,192,192,0,42,0,0.140625,0,empty,CD-0722-4
"G7,D7",6258,6767,4759,2008,3494,1656,0,1656,1139,517,2.203094778,886,2061,537,192,190,2,52,1,0.036842105,0,empty,CD-0722-4
"G7,D8",7020,7812,5151,2661,4161,2114,0,2116,1362,754,1.806366048,1197,788,208,96,95,1,23,1,0.031578947,0,empty,CD-0722-4
"G7,D9",3684,4031,2743,1288,2118,995,0,997,648,349,1.856733524,568,1603,421,158,155,3,39,1,0.077419355,0,empty,CD-0722-4
"G7,D10",8452,9376,6148,3228,4838,2449,0,2451,1550,901,1.720310766,1455,1660,214,102,97,5,21,2,0.103092784,0,empty,CD-0722-4
"G7,D11",636045,764029,442599,321430,376775,242333,2,242528,177597,64931,2.735165021,145273,8762,1706,477,461,16,108,3,0.184381779,0,hg38,CD-0722-4
"G7,D12",13738,15147,10094,5053,7912,4086,0,4086,2886,1200,2.405,2284,4354,1159,483,479,4,106,2,0.020876827,0,empty,CD-0722-4
"G7,E1",13957,15239,10327,4912,8130,4096,2,4102,2677,1425,1.878596491,2319,3287,703,244,231,13,69,2,0.108225108,0,empty,CD-0722-4
"G7,E2",9124,10077,6813,3264,5153,2589,1,2592,1634,958,1.705636743,1427,1961,310,114,114,0,38,0,0.00877193,0,empty,CD-0722-4
"G7,E3",6106,6672,4528,2144,3548,1706,11,1718,1150,568,2.024647887,955,2345,643,250,250,0,56,0,0.032,0,empty,CD-0722-4
"G7,E4",9415,10336,7030,3306,5428,2726,2,2731,1821,910,2.001098901,1509,2527,714,284,277,7,69,2,0.111913357,0,empty,CD-0722-4
"G7,E5",7506,8119,5650,2469,4243,2020,0,2023,1278,745,1.715436242,1100,1316,238,98,97,1,27,1,0,0,empty,CD-0722-4
"G7,E6",13034,14307,9680,4627,7631,3939,0,3943,2605,1338,1.946935725,2200,3349,836,336,335,1,91,1,0.074626866,0,empty,CD-0722-4
"G7,E7",12424,13632,9398,4234,7202,3524,0,3531,2441,1090,2.239449541,1921,2785,702,252,250,2,59,1,0.056,0,empty,CD-0722-4
"G7,E8",11107,12089,8494,3595,6409,3049,0,3049,2043,1006,2.030815109,1674,3069,573,234,232,2,57,2,0.060344828,0,empty,CD-0722-4
"G7,E9",6018,6663,4457,2206,3513,1739,0,1741,1150,591,1.945854484,1014,2124,451,223,221,2,56,2,0.031674208,0,empty,CD-0722-4
"G7,E10",7699,8536,5685,2851,4527,2266,9,2277,1475,802,1.83915212,1341,1754,458,181,177,4,43,2,0.062146893,0,empty,CD-0722-4
"G7,E11",1117277,1283682,828846,454836,625325,341135,0,341410,273141,68269,4.000952116,197931,152316,23246,9004,8856,148,1467,6,0.069218609,0,hg38,CD-0722-4
"G7,E12",9490,10431,6976,3455,5665,2842,14,2858,1875,983,1.907426246,1678,1774,413,171,168,3,39,1,0.029761905,0,empty,CD-0722-4
"G7,F1",17663,18893,13285,5608,9474,4452,4,4461,2979,1482,2.010121457,2484,5939,1270,431,431,0,95,0,0.078886311,0,empty,CD-0722-4
"G7,F2",8529,9228,6403,2825,5038,2381,1,2386,1536,850,1.807058824,1334,2737,428,202,195,7,64,2,0.061538462,0,empty,CD-0722-4
"G7,F3",8690,9431,6478,2953,5055,2478,1,2482,1684,798,2.110275689,1406,2846,669,281,277,4,61,3,0.050541516,0,empty,CD-0722-4
"G7,F4",13314,14386,9833,4553,7739,3726,0,3741,2489,1252,1.988019169,2157,697,125,56,56,0,21,0,0.017857143,0,empty,CD-0722-4
"G7,F5",10297,10732,7885,2847,5740,2684,0,2684,1794,890,2.015730337,1400,1962,552,236,231,5,57,1,0.056277056,0,empty,CD-0722-4
"G7,F6",12310,14029,8956,5073,7406,3921,0,3923,2622,1301,2.01537279,2339,2555,601,259,258,1,68,1,0.058139535,0,empty,CD-0722-4
"G7,F7",201010,262566,127015,135551,139122,103797,0,103852,66998,36854,1.817930211,66458,1199,277,123,123,0,41,0,0.024390244,0,hg38,CD-0722-4
"G7,F8",8315,8916,6290,2626,4714,2278,1,2279,1567,712,2.200842697,1219,238,62,23,23,0,10,0,0.130434783,0,empty,CD-0722-4
"G7,F9",8926,9722,6552,3170,5108,2546,0,2553,1777,776,2.289948454,1455,2423,548,218,210,8,63,2,0.123809524,0,empty,CD-0722-4
"G7,F10",11862,12856,9090,3766,6849,3206,30,3238,2259,979,2.307456588,1758,1923,751,337,337,0,56,0,0.06231454,0,empty,CD-0722-4
"G7,F11",8363,8850,6268,2582,4712,2262,0,2264,1534,730,2.101369863,1219,2089,444,180,178,2,40,2,0.162921348,0,empty,CD-0722-4
"G7,F12",10360,11279,7573,3706,5842,2900,0,2900,1944,956,2.033472803,1626,217,65,28,28,0,6,0,0.035714286,0,empty,CD-0722-4
"G7,G1",12436,13923,9392,4531,7354,3568,0,3574,2381,1193,1.995808885,2002,2642,691,257,253,4,73,1,0.059288538,0,empty,CD-0722-4
"G7,G2",5867,6357,4074,2283,3355,1714,41,1755,1161,594,1.954545455,992,378,99,34,34,0,13,0,0.029411765,0,empty,CD-0722-4
"G7,G3",11623,12365,8614,3751,6421,3100,0,3105,1864,1241,1.502014504,1658,2415,711,268,265,3,62,2,0.064150943,0,empty,CD-0722-4
"G7,G4",20253,22320,14399,7921,11657,6482,19,6504,3966,2538,1.562647754,3732,56,1,1,1,0,1,0,0,0,empty,CD-0722-4
"G7,G5",7181,7872,5244,2628,4009,2011,7,2018,1316,702,1.874643875,1155,1835,474,160,157,3,44,1,0.23566879,0,empty,CD-0722-4
"G7,G6",10835,11822,8158,3664,6172,2922,0,2924,1997,927,2.154261057,1602,198,13,7,7,0,5,0,0,0,empty,CD-0722-4
"G7,G7",8490,9478,6430,3048,5055,2496,0,2499,1634,865,1.889017341,1445,2710,600,240,238,2,63,1,0.050420168,0,empty,CD-0722-4
"G7,G8",6412,6894,4637,2257,3681,1797,1,1798,1197,601,1.991680532,1017,1826,478,214,213,1,45,1,0.136150235,0,empty,CD-0722-4
"G7,G9",8384,9147,6211,2936,4858,2405,0,2406,1613,793,2.034047919,1372,2342,606,281,279,2,61,1,0.028673835,0,empty,CD-0722-4
"G7,G10",9525,10580,7175,3405,5513,2702,3,2712,1807,905,1.996685083,1539,4250,828,358,351,7,143,3,0.034188034,0,empty,CD-0722-4
"G7,G11",9119,9974,6877,3097,5296,2536,0,2540,1643,897,1.831661093,1437,1469,327,127,125,2,39,1,0.008,0,empty,CD-0722-4
"G7,G12",6823,7701,4966,2735,4061,2093,23,2116,1300,816,1.593137255,1238,1868,412,182,182,0,48,0,0.027472527,0,empty,CD-0722-4
"G7,H1",8346,8943,6248,2695,4891,2416,1,2417,1650,767,2.151238592,1346,1308,347,136,134,2,34,1,0.044776119,0,empty,CD-0722-4
"G7,H2",1029140,1190926,739520,451406,584315,353595,5,353937,240204,113733,2.111999156,208750,26939,2003,669,636,33,168,3,0.177672956,0,hg38,CD-0722-4
"G7,H3",7400,8682,5384,3298,4596,2459,13,2474,1616,858,1.883449883,1505,1302,366,156,153,3,37,2,0,0,empty,CD-0722-4
"G7,H4",10275,11247,7737,3510,5813,2858,1,2863,1872,991,1.889001009,1605,99,36,22,22,0,6,0,0.045454545,0,empty,CD-0722-4
"G7,H5",11669,13392,8487,4905,6961,3615,0,3618,2338,1280,1.8265625,2196,2315,653,247,243,4,49,2,0.102880658,0,empty,CD-0722-4
"G7,H6",7404,8355,5355,3000,4407,2299,0,2305,1592,713,2.232819074,1318,2796,542,207,205,2,52,2,0.131707317,0,empty,CD-0722-4
"G7,H7",7450,7961,5620,2341,4171,1985,0,1989,1308,681,1.920704846,1034,2130,299,128,126,2,35,2,0.150793651,0,empty,CD-0722-4
"G7,H8",10225,11552,7618,3934,5931,3014,0,3015,2029,986,2.057809331,1691,2235,382,161,161,0,58,0,0.01863354,0,empty,CD-0722-4
"G7,H9",1270460,1434713,960573,474140,686885,350649,4,350973,286939,64034,4.481041322,200344,134011,34648,13578,13450,128,1825,3,0.048475836,0,hg38,CD-0722-4
"G7,H10",6108,6760,4521,2239,3471,1705,0,1706,1089,617,1.764991896,1009,1129,249,105,105,0,28,0,0.123809524,0,empty,CD-0722-4
"G7,H11",7054,7963,5057,2906,4099,2420,0,2420,1324,1096,1.208029197,1393,28,0,0,0,0,0,0,0,0,empty,CD-0722-4
"G7,H12",918315,1037029,682184,354845,506558,266737,3,266963,209412,57551,3.638720439,156324,185487,19224,7486,7262,224,1187,5,0.067887634,0,hg38,CD-0722-4
"G8,A1",7022,7727,5140,2587,4164,2174,0,2176,1461,715,2.043356643,1207,1210,322,141,141,0,40,0,0.035460993,0,empty,CD-0722-4
"G8,A2",10040,10844,7407,3437,5847,2932,0,2937,1980,957,2.068965517,1692,1812,345,178,177,1,49,1,0.203389831,0,empty,CD-0722-4
"G8,A3",6417,6985,4752,2233,3712,1824,0,1824,1226,598,2.050167224,1048,993,270,111,110,1,36,1,0.036363636,0,empty,CD-0722-4
"G8,A4",14589,16016,11106,4910,8328,4036,24,4066,2715,1351,2.009622502,2256,1125,280,113,113,0,33,0,0.123893805,0,empty,CD-0722-4
"G8,A5",10983,11856,7961,3895,6443,3175,0,3176,2183,993,2.198388721,1808,2490,595,222,220,2,69,1,0.009090909,0,empty,CD-0722-4
"G8,A6",9476,10116,6794,3322,5683,2992,0,3004,2035,969,2.100103199,1657,3147,642,267,265,2,77,2,0.075471698,0,empty,CD-0722-4
"G8,A7",6833,7587,5054,2533,4030,2057,3,2062,1325,737,1.797829037,1165,1237,326,133,131,2,29,2,0.091603053,0,empty,CD-0722-4
"G8,A8",4859,5519,3697,1822,2937,1466,0,1466,1010,456,2.214912281,840,1542,232,79,78,1,32,1,0.076923077,0,empty,CD-0722-4
"G8,A9",8310,9383,6115,3268,4999,2507,0,2509,1707,802,2.128428928,1434,2106,443,182,180,2,46,2,0.077777778,0,empty,CD-0722-4
"G8,A10",8576,9290,6506,2784,4874,2415,1,2417,1651,766,2.15535248,1300,464,91,34,33,1,14,1,0.060606061,0,empty,CD-0722-4
"G8,A11",6343,6951,4847,2104,3671,1761,0,1762,1230,532,2.312030075,973,1441,223,79,73,6,31,2,0.02739726,0,empty,CD-0722-4
"G8,A12",10101,11262,7674,3588,5791,2882,0,2886,1929,957,2.015673981,1574,3396,682,250,242,8,70,3,0.041322314,0,empty,CD-0722-4
"G8,B1",8125,9046,5918,3128,4603,2323,0,2327,1504,823,1.82746051,1303,1566,188,76,76,0,25,0,0.105263158,0,empty,CD-0722-4
"G8,B2",8191,8875,5702,3173,4776,2570,6,2577,1643,934,1.759100642,1517,493,67,33,30,3,12,1,0,0,empty,CD-0722-4
"G8,B3",6781,7471,4993,2478,4091,2100,0,2104,1504,600,2.506666667,1218,1580,446,160,159,1,34,1,0.094339623,0,empty,CD-0722-4
"G8,B4",9418,10637,7143,3494,5565,2799,0,2803,1878,925,2.03027027,1641,1473,338,128,122,6,30,2,0.032786885,0,empty,CD-0722-4
"G8,B5",7791,4533,3032,1501,3111,1590,1,1605,1106,499,2.216432866,967,1108,226,101,100,1,34,1,0.02,0,empty,CD-0722-4
"G8,B6",810962,921506,604711,316795,449855,238451,1,238641,188357,50284,3.745863495,139599,90227,12342,4870,4774,96,906,5,0.041265186,0,hg38,CD-0722-4
"G8,B7",8518,9244,6569,2675,4983,2440,6,2451,1625,826,1.967312349,1305,1563,268,102,102,0,30,0,0,0,empty,CD-0722-4
"G8,B8",7296,8182,5320,2862,4405,2307,0,2309,1554,755,2.058278146,1313,1477,248,107,99,8,28,1,0.080808081,0,empty,CD-0722-4
"G8,B9",11691,12658,8603,4055,6667,3413,2,3422,2191,1231,1.779853777,1876,945,168,54,54,0,25,0,0.055555556,0,empty,CD-0722-4
"G8,B10",5931,6403,4194,2209,3655,1831,3,1836,1263,573,2.204188482,1085,520,102,70,68,2,27,1,0.088235294,0,empty,CD-0722-4
"G8,B11",11212,12370,8147,4223,6384,3372,1,3375,2004,1371,1.461706783,1900,245,52,19,18,1,7,1,0,0,empty,CD-0722-4
"G8,B12",7233,7699,5341,2358,4283,2177,0,2177,1530,647,2.364760433,1196,1663,391,167,166,1,49,1,0.012048193,0,empty,CD-0722-4
"G8,C1",16326,17483,12307,5176,9419,4657,1,4658,3141,1517,2.070533949,2582,1576,348,134,133,1,39,1,0.022556391,0,empty,CD-0722-4
"G8,C2",2666341,3059625,1983768,1075857,1426249,781221,1,781980,641377,140603,4.561616751,458266,352873,60845,24133,23711,422,2893,10,0.051790308,0,hg38,CD-0722-4
"G8,C3",14143,15609,10589,5020,8301,4155,0,4162,2768,1394,1.985652798,2359,888,213,105,105,0,23,0,0.028571429,0,empty,CD-0722-4
"G8,C4",7657,8065,5780,2285,4405,2078,0,2083,1417,666,2.127627628,1111,1811,387,170,169,1,50,1,0.100591716,0,empty,CD-0722-4
"G8,C5",10634,11763,7878,3885,6209,3054,0,3056,2060,996,2.068273092,1750,1465,307,89,89,0,27,0,0,0,empty,CD-0722-4
"G8,C6",9171,9972,6728,3244,5470,2826,3,2833,1915,918,2.086056645,1588,2157,471,153,151,2,41,1,0.006622517,0,empty,CD-0722-4
"G8,C7",11631,13226,8366,4860,6833,3779,0,3781,2372,1409,1.683463449,2201,320,53,25,25,0,8,0,0.04,0,empty,CD-0722-4
"G8,C8",946750,1062819,717351,345468,517566,262322,36,262603,204640,57963,3.530528096,149410,174043,27205,10493,10295,198,1567,8,0.060126275,0,hg38,CD-0722-4
"G8,C9",9236,10602,6702,3900,5644,2901,0,2904,1921,983,1.95422177,1715,1785,292,145,139,6,41,1,0,0,empty,CD-0722-4
"G8,C10",10655,11680,8175,3505,6010,2928,1,2932,1946,986,1.973630832,1561,1527,347,145,143,2,42,2,0.146853147,0,empty,CD-0722-4
"G8,C11",9612,10708,7153,3555,5694,2874,7,2882,1848,1034,1.787234043,1651,1597,415,173,172,1,47,1,0.011627907,0,empty,CD-0722-4
"G8,C12",20249,22255,15183,7072,11388,5736,1,5748,3785,1963,1.928171167,3220,2400,617,234,230,4,59,2,0.104347826,0,empty,CD-0722-4
"G8,D1",1103522,1300142,787796,512346,638535,385975,0,386246,292586,93660,3.123916293,231139,16060,5282,1988,1976,12,397,3,0.015688259,0,hg38,CD-0722-4
"G8,D2",9358,10132,7150,2982,5315,2474,0,2476,1590,886,1.794582393,1360,2960,882,331,326,5,82,2,0.049079755,0,empty,CD-0722-4
"G8,D3",7686,8490,5703,2787,4575,2327,2,2331,1566,765,2.047058824,1337,1577,385,139,138,1,31,1,0.130434783,0,empty,CD-0722-4
"G8,D4",7157,7928,5332,2596,4314,2139,1,2140,1473,667,2.208395802,1225,1028,251,131,131,0,34,0,0.099236641,0,empty,CD-0722-4
"G8,D5",7045,7808,5235,2573,4139,2088,0,2090,1343,747,1.797858099,1214,1474,423,158,157,1,31,1,0.01910828,0,empty,CD-0722-4
"G8,D6",10658,12093,7691,4402,6177,3328,0,3332,2031,1301,1.561106841,1983,2467,554,229,228,1,57,1,0.00877193,0,empty,CD-0722-4
"G8,D7",6188,6676,4506,2170,3553,1719,0,1726,1157,569,2.033391916,986,2324,539,226,215,11,60,2,0.102325581,0,empty,CD-0722-4
"G8,D8",7883,8710,5891,2819,4714,2328,0,2330,1500,830,1.807228916,1360,1172,314,129,129,0,35,0,0.007751938,0,empty,CD-0722-4
"G8,D9",4195,4551,3067,1484,2432,1178,0,1181,799,382,2.091623037,681,1004,232,95,93,2,34,2,0.032258065,0,empty,CD-0722-4
"G8,D10",9219,10408,6795,3613,5506,2858,0,2860,1867,993,1.880161128,1679,858,112,51,42,9,18,2,0.071428571,0,empty,CD-0722-4
"G8,D11",8770,9538,6535,3003,5047,2523,5,2530,1686,844,1.997630332,1386,2598,551,223,222,1,54,1,0.009009009,0,empty,CD-0722-4
"G8,D12",11180,12365,8369,3996,6559,3292,0,3292,2263,1029,2.199222546,1868,2734,793,321,319,2,81,2,0.112852665,0,empty,CD-0722-4
"G8,E1",14523,15698,10813,4885,8223,4105,1,4108,2777,1331,2.086401202,2254,2921,624,212,210,2,74,1,0.019047619,0,empty,CD-0722-4
"G8,E2",9563,10591,6941,3650,5673,2950,0,2950,1911,1039,1.839268527,1670,1897,425,159,156,3,40,2,0.166666667,0,empty,CD-0722-4
"G8,E3",8011,9065,6046,3019,4795,2431,1,2432,1718,714,2.406162465,1381,2491,572,217,217,0,55,0,0.165898618,0,empty,CD-0722-4
"G8,E4",10173,11409,7555,3854,5998,2998,0,2998,2034,964,2.109958506,1689,2284,467,205,204,1,65,1,0.039215686,0,empty,CD-0722-4
"G8,E5",9352,10233,7171,3062,5366,2452,0,2456,1646,810,2.032098765,1315,2681,761,322,319,3,56,2,0.090909091,0,empty,CD-0722-4
"G8,E6",14688,16111,10940,5171,8322,4119,0,4127,2772,1355,2.045756458,2316,4215,1024,417,408,9,96,2,0.093137255,0,empty,CD-0722-4
"G8,E7",14119,15647,10480,5167,8329,4057,49,4108,2818,1290,2.184496124,2414,3113,676,305,304,1,81,1,0.085526316,0,empty,CD-0722-4
"G8,E8",13204,14464,9997,4467,7697,3790,0,3794,2654,1140,2.328070175,2111,3504,712,301,299,2,74,1,0.030100334,0,empty,CD-0722-4
"G8,E9",6624,7534,4876,2658,4024,2079,0,2080,1420,660,2.151515152,1224,2676,669,288,288,0,71,0,0.09375,0,empty,CD-0722-4
"G8,E10",922262,1046083,688339,357744,510257,265948,0,266181,202758,63423,3.196915945,156208,162259,21476,8650,8420,230,1262,6,0.051543943,0,hg38,CD-0722-4
"G8,E11",8871,9741,6584,3157,5158,2600,0,2602,1758,844,2.082938389,1459,2252,361,155,149,6,46,2,0.127516779,0,empty,CD-0722-4
"G8,E12",10082,11191,7523,3668,6085,3088,1,3096,2068,1028,2.011673152,1802,2304,510,182,178,4,49,2,0.084269663,0,empty,CD-0722-4
"G8,F1",980950,1060623,758300,302323,513873,239708,32,240004,190659,49345,3.863795724,131565,148295,14108,5724,5532,192,1087,6,0.033984093,0,hg38,CD-0722-4
"G8,F2",996445,1093899,754007,339892,531447,261938,9,262198,198317,63881,3.104475509,149258,117942,15724,6192,6039,153,1063,5,0.042887895,0,hg38,CD-0722-4
"G8,F3",8868,9834,6631,3203,5256,2585,0,2585,1723,862,1.998839907,1493,2752,627,225,223,2,64,2,0.076233184,0,empty,CD-0722-4
"G8,F4",12698,13530,9631,3899,7261,3346,0,3352,2229,1123,1.984861977,1828,891,172,65,65,0,21,0,0.046153846,0,empty,CD-0722-4
"G8,F5",10648,11459,7992,3467,6085,2834,0,2834,1818,1016,1.789370079,1587,2346,439,189,189,0,61,0,0.079365079,0,empty,CD-0722-4
"G8,F6",12779,14780,9203,5577,7611,4073,1,4078,2890,1188,2.432659933,2439,3001,610,240,234,6,72,2,0.08974359,0,empty,CD-0722-4
"G8,F7",11743,13010,8806,4204,7180,3564,0,3566,2450,1116,2.195340502,2058,987,155,78,78,0,34,0,0,0,empty,CD-0722-4
"G8,F8",8920,9924,6647,3277,5388,2717,1,2726,1772,954,1.857442348,1584,329,52,27,27,0,13,0,0.074074074,0,empty,CD-0722-4
"G8,F9",10489,11486,7642,3844,6074,3050,4,3057,2047,1010,2.026732673,1736,2580,766,333,328,5,75,2,0.088414634,0,empty,CD-0722-4
"G8,F10",1538966,1710903,1181339,529564,817362,417667,26,418100,332794,85306,3.901179284,233837,58140,11309,4335,4267,68,854,5,0.014530115,0,hg38,CD-0722-4
"G8,F11",765303,845630,585096,260534,413445,202008,1,202213,153701,48512,3.168308872,113685,107665,9625,3971,3823,148,711,7,0.079780277,0,hg38,CD-0722-4
"G8,F12",10026,10642,7475,3167,5594,2699,0,2703,1828,875,2.089142857,1498,214,47,24,24,0,10,0,0.083333333,0,empty,CD-0722-4
"G8,G1",936055,1019270,720598,298672,497070,236666,2,236930,189400,47530,3.984851673,132405,52771,10689,4043,3978,65,726,2,0.031674208,0,hg38,CD-0722-4
"G8,G2",11159,12492,7632,4860,6390,3721,0,3722,2313,1409,1.64158978,2192,546,68,33,33,0,13,0,0.060606061,0,empty,CD-0722-4
"G8,G3",11922,12651,8866,3785,6655,3278,11,3292,2022,1270,1.592125984,1766,1958,542,228,228,0,61,0,0.013157895,0,empty,CD-0722-4
"G8,G4",20329,22749,14615,8134,11737,6359,0,6370,3941,2429,1.622478386,3681,86,24,5,5,0,3,0,0,0,empty,CD-0722-4
"G8,G5",7078,7620,5318,2302,4015,1944,4,1951,1304,647,2.015455951,1055,1569,262,114,108,6,36,2,0.231481481,0,empty,CD-0722-4
"G8,G6",11066,12128,8395,3733,6319,3041,0,3045,2086,959,2.175182482,1696,201,48,15,15,0,7,0,0,0,empty,CD-0722-4
"G8,G7",8844,9614,6691,2923,5107,2401,0,2404,1661,743,2.235531629,1332,2839,696,309,307,2,92,2,0.013029316,0,empty,CD-0722-4
"G8,G8",6292,6886,4580,2306,3773,1860,0,1860,1250,610,2.049180328,1069,2396,566,209,208,1,56,1,0.009615385,0,empty,CD-0722-4
"G8,G9",796452,892195,604236,287959,436454,220170,1,220374,162256,58118,2.791837297,126208,124730,19428,7460,7324,136,1226,5,0.034407428,0,hg38,CD-0722-4
"G8,G10",9730,10729,7318,3411,5789,2914,0,2916,1974,942,2.095541401,1621,2239,521,175,174,1,56,1,0.057471264,0,empty,CD-0722-4
"G8,G11",10348,11182,7777,3405,5870,2741,9,2754,1865,889,2.097862767,1512,2026,605,259,259,0,47,0,0.154440154,0,empty,CD-0722-4
"G8,G12",7004,7462,5178,2284,4031,2067,1,2070,1349,721,1.871012483,1098,1846,482,196,194,2,58,1,0.046391753,0,empty,CD-0722-4
"G8,H1",831529,957683,607689,349994,471509,260720,3,260980,206976,54004,3.832604992,154533,75899,11521,4402,4308,94,795,6,0.038765088,0,hg38,CD-0722-4
"G8,H2",8722,9600,6350,3250,5010,2542,1,2545,1571,974,1.612936345,1457,2152,620,268,268,0,53,0,0.093283582,0,empty,CD-0722-4
"G8,H3",8084,8990,5896,3094,4851,2525,0,2527,1680,847,1.983471074,1506,1224,254,64,63,1,30,1,0.095238095,0,empty,CD-0722-4
"G8,H4",10619,11410,7921,3489,6009,2921,1,2929,1967,962,2.044698545,1603,227,19,13,13,0,5,0,0,0,empty,CD-0722-4
"G8,H5",65108,75965,45339,30626,37342,22718,29,22768,15370,7398,2.077588537,13678,2675,640,285,285,0,61,0,0.077192982,0,empty,CD-0722-4
"G8,H6",7832,8367,5740,2627,4470,2283,1,2288,1535,753,2.038512616,1318,4116,666,248,244,4,70,2,0.090163934,0,empty,CD-0722-4
"G8,H7",8110,8909,5997,2912,4663,2290,0,2294,1508,786,1.918575064,1293,1591,549,163,163,0,39,0,0.165644172,0,empty,CD-0722-4
"G8,H8",868376,1014505,633007,381498,494177,276437,0,276646,220224,56422,3.903158342,165830,157074,25522,10244,10079,165,1552,8,0.063498363,0,hg38,CD-0722-4
"G8,H9",7830,8268,5832,2436,4443,2104,0,2104,1449,655,2.21221374,1184,1152,307,126,124,2,40,1,0,0,empty,CD-0722-4
"G8,H10",13793,15045,10163,4882,7703,3815,0,3817,2853,964,2.959543568,2213,3209,859,281,280,1,51,1,0.042857143,0,empty,CD-0722-4
"G8,H11",7142,7713,4982,2731,3983,2298,0,2301,1266,1035,1.223188406,1282,45,1,1,1,0,1,0,0,0,empty,CD-0722-4
"G8,H12",7317,8297,5356,2941,4264,2192,0,2202,1492,710,2.101408451,1283,1509,287,145,141,4,36,2,0.127659574,0,empty,CD-0722-4
"G9,A1",7418,7923,5450,2473,4344,2189,0,2191,1482,709,2.090267983,1223,1433,268,122,119,3,37,2,0.142857143,0,empty,CD-0722-4
"G9,A2",10710,11584,7919,3665,6122,3038,10,3053,2001,1052,1.902091255,1715,1928,404,167,166,1,53,1,0.024096386,0,empty,CD-0722-4
"G9,A3",671367,735037,515033,220004,362983,174651,17,174841,131007,43834,2.988707396,98610,30814,5598,2352,2307,45,496,3,0.015604681,0,hg38,CD-0722-4
"G9,A4",11459,12890,8667,4223,6586,3253,0,3255,2122,1133,1.872903795,1813,1120,242,92,92,0,29,0,0.010869565,0,empty,CD-0722-4
"G9,A5",10736,11679,7932,3747,6365,3119,17,3143,2127,1016,2.093503937,1751,3742,577,263,253,10,77,2,0.019762846,0,empty,CD-0722-4
"G9,A6",15209,17453,10934,6519,9126,5154,0,5162,3550,1612,2.202233251,2958,3902,778,350,345,5,116,1,0.055072464,0,empty,CD-0722-4
"G9,A7",7289,8144,5357,2787,4325,2318,2,2321,1456,865,1.683236994,1373,2119,350,151,149,2,45,1,0.11409396,0,empty,CD-0722-4
"G9,A8",5071,5835,3721,2114,3045,1553,0,1556,1103,453,2.434878587,916,2176,412,200,194,6,61,2,0.067010309,0,empty,CD-0722-4
"G9,A9",12432,13969,9245,4724,7397,3768,11,3785,2766,1019,2.714425908,2110,2127,378,172,170,2,60,2,0.029411765,0,empty,CD-0722-4
"G9,A10",8454,9317,6448,2869,4902,2417,0,2417,1624,793,2.047919294,1376,430,85,42,42,0,16,0,0,0,empty,CD-0722-4
"G9,A11",6573,7309,4917,2392,3956,1936,0,1936,1287,649,1.983050847,1141,1798,455,228,224,4,50,1,0.049107143,0,empty,CD-0722-4
"G9,A12",9714,10642,7358,3284,5676,2728,3,2732,1862,870,2.140229885,1496,3469,781,375,373,2,106,1,0.104557641,0,empty,CD-0722-4
"G9,B1",1010226,1137729,761046,376683,551848,285775,1,286030,228740,57290,3.992668878,163778,114945,15842,6871,6705,166,1216,5,0.04966443,0,hg38,CD-0722-4
"G9,B2",10616,12152,7153,4999,6492,3852,1,3859,2383,1476,1.614498645,2400,819,163,81,81,0,35,0,0.098765432,0,empty,CD-0722-4
"G9,B3",9604,10867,7104,3763,5779,3023,18,3041,2166,875,2.475428571,1778,1311,313,185,185,0,62,0,0.145945946,0,empty,CD-0722-4
"G9,B4",7206,8282,5298,2984,4407,2331,0,2331,1522,809,1.881334981,1371,1111,303,117,115,2,36,2,0.208695652,0,empty,CD-0722-4
"G9,B5",881197,491935,326752,165183,316904,157160,16,158186,121894,36292,3.358701642,96569,84018,8468,3630,3536,94,689,3,0.07861991,0,hg38,CD-0722-4
"G9,B6",8968,9963,6572,3391,5328,2850,0,2851,1880,971,1.936148301,1646,2194,543,200,200,0,49,0,0.005,0,empty,CD-0722-4
"G9,B7",8777,9561,6504,3057,5149,2497,1,2498,1730,768,2.252604167,1413,1475,288,126,126,0,42,0,0.071428571,0,empty,CD-0722-4
"G9,B8",6606,7206,4999,2207,3902,1930,0,1933,1337,596,2.243288591,1064,1976,223,96,92,4,44,2,0.010869565,0,empty,CD-0722-4
"G9,B9",921428,1051365,685868,365497,509543,273095,1,273334,213315,60019,3.554124527,158825,70849,11318,4743,4646,97,940,5,0.035299182,0,hg38,CD-0722-4
"G9,B10",5959,6365,4207,2158,3568,1742,0,1750,1183,567,2.086419753,1008,732,155,65,63,2,31,1,0.031746032,0,empty,CD-0722-4
"G9,B11",16799,18975,12493,6482,9714,5128,1,5136,3313,1823,1.817334065,2919,252,72,17,16,1,7,1,0,0,empty,CD-0722-4
"G9,B12",7747,8547,5704,2843,4552,2253,0,2255,1607,648,2.479938272,1287,1998,506,208,206,2,53,2,0.101941748,0,empty,CD-0722-4
"G9,C1",24012,25329,18686,6643,13015,5610,0,5613,3664,1949,1.87993843,2974,1479,334,157,156,1,41,1,0.076923077,0,empty,CD-0722-4
"G9,C2",11316,12525,8357,4168,6561,3329,1,3332,2218,1114,1.991023339,1878,2486,651,281,277,4,70,2,0.050541516,0,empty,CD-0722-4
"G9,C3",11701,13034,8686,4348,6926,3447,14,3463,2267,1196,1.89548495,1952,1249,250,110,109,1,29,1,0.110091743,0,empty,CD-0722-4
"G9,C4",7564,8034,5792,2242,4378,1973,1,1974,1341,633,2.118483412,1067,2023,393,195,192,3,62,2,0.057291667,0,empty,CD-0722-4
"G9,C5",10786,12211,7987,4224,6409,3319,0,3320,2254,1066,2.114446529,1945,2104,361,184,184,0,46,0,0.108695652,0,empty,CD-0722-4
"G9,C6",8810,9680,6431,3249,5236,2663,31,2696,1806,890,2.029213483,1542,1622,329,166,165,1,51,1,0.024242424,0,empty,CD-0722-4
"G9,C7",13650,15537,9618,5919,8277,4617,1,4620,2857,1763,1.620533182,2837,295,54,32,32,0,13,0,0,0,empty,CD-0722-4
"G9,C8",13387,14370,10044,4326,7496,3639,14,3656,2368,1288,1.838509317,1964,3846,1062,448,447,1,97,1,0.14541387,0,empty,CD-0722-4
"G9,C9",9977,11290,7525,3765,5923,3021,0,3023,2011,1012,1.98715415,1690,1751,291,141,137,4,47,2,0.02189781,0,empty,CD-0722-4
"G9,C10",10273,11308,7636,3672,6046,2982,1,2986,1928,1058,1.822306238,1668,1845,407,190,186,4,61,2,0.096774194,0,empty,CD-0722-4
"G9,C11",1103358,1309268,800396,508872,638521,366285,1,366615,291578,75037,3.885789677,222773,67818,12859,5437,5381,56,1159,2,0.020628136,0,hg38,CD-0722-4
"G9,C12",13748,14885,10116,4769,8029,3976,0,3978,2681,1297,2.067077872,2290,2118,585,264,262,2,76,2,0.072519084,0,empty,CD-0722-4
"G9,D1",10628,11736,7857,3879,6283,3267,0,3269,2085,1184,1.76097973,1847,905,162,75,75,0,26,0,0.12,0,empty,CD-0722-4
"G9,D2",897942,990102,694505,295597,483566,233766,18,234018,176747,57271,3.086151805,128195,136004,19660,8668,8535,133,1439,6,0.071236087,0,hg38,CD-0722-4
"G9,D3",8630,9623,6356,3267,5191,2655,3,2662,1808,854,2.117096019,1540,1884,449,226,221,5,65,1,0.076923077,0,empty,CD-0722-4
"G9,D4",6809,7625,5079,2546,4078,2032,0,2034,1376,658,2.09118541,1161,1811,363,179,178,1,59,1,0.08988764,0,empty,CD-0722-4
"G9,D5",7108,7577,5428,2149,4022,1876,1,1882,1228,654,1.877675841,984,1728,333,159,157,2,47,1,0.050955414,0,empty,CD-0722-4
"G9,D6",11156,12189,8064,4125,6411,3412,2,3422,2089,1333,1.567141785,1936,2661,414,194,194,0,57,0,0.056701031,0,empty,CD-0722-4
"G9,D7",6155,6682,4629,2053,3542,1664,2,1666,1156,510,2.266666667,946,2674,596,250,247,3,67,1,0.028340081,0,empty,CD-0722-4
"G9,D8",7349,8091,5352,2739,4422,2266,0,2269,1486,783,1.897828863,1312,1569,280,132,129,3,39,2,0.085271318,0,empty,CD-0722-4
"G9,D9",5926,6453,4474,1979,3400,1610,0,1613,1149,464,2.476293103,902,1749,393,161,159,2,43,1,0.220125786,0,empty,CD-0722-4
"G9,D10",8343,9574,6037,3537,4973,2565,1,2566,1653,913,1.810514786,1530,1028,217,104,102,2,28,2,0.009803922,0,empty,CD-0722-4
"G9,D11",8064,8537,5990,2547,4671,2292,0,2293,1435,858,1.672494172,1299,2448,777,314,311,3,77,2,0.093247588,0,empty,CD-0722-4
"G9,D12",1172540,1345233,874254,470979,648325,347535,0,347913,278032,69881,3.978649418,202611,246713,45255,20002,19729,273,2621,12,0.078209742,0,hg38,CD-0722-4
"G9,E1",14451,15918,10742,5176,8388,4211,18,4234,2637,1597,1.651221039,2380,3022,670,299,289,10,93,1,0.138408304,0,empty,CD-0722-4
"G9,E2",9623,10826,7140,3686,5807,3010,0,3012,1961,1051,1.865842055,1752,2194,416,180,176,4,49,2,0.005681818,0,empty,CD-0722-4
"G9,E3",6827,7527,5087,2440,4050,1981,13,1994,1301,693,1.877344877,1164,3699,1078,447,437,10,116,2,0.057208238,0,empty,CD-0722-4
"G9,E4",1879587,2145074,1410923,734151,1025301,546041,1,546534,433537,112997,3.836712479,320565,211180,33451,14266,14023,243,2093,6,0.054553234,0,hg38,CD-0722-4
"G9,E5",7883,8607,5864,2743,4554,2166,0,2166,1400,766,1.82767624,1252,1456,275,115,107,8,44,2,0,0,empty,CD-0722-4
"G9,E6",14498,16030,10777,5253,8402,4278,17,4298,2768,1530,1.809150327,2475,4508,936,404,395,9,121,3,0.073417722,0,empty,CD-0722-4
"G9,E7",718055,866053,491785,374268,429651,284341,2,284569,208884,75685,2.759912796,171118,9011,1317,570,557,13,127,3,0.254937163,0,hg38,CD-0722-4
"G9,E8",11204,12069,8612,3457,6643,3139,16,3157,2168,989,2.192113246,1734,3390,600,285,281,4,94,3,0.028469751,0,empty,CD-0722-4
"G9,E9",7043,7908,5048,2860,4207,2248,6,2256,1484,772,1.922279793,1371,2601,762,307,307,0,79,0,0.045602606,0,empty,CD-0722-4
"G9,E10",8158,8904,6072,2832,4763,2351,3,2357,1576,781,2.017925736,1354,2033,597,241,240,1,67,1,0.079166667,0,empty,CD-0722-4
"G9,E11",9061,9937,6774,3163,5325,2671,0,2677,1727,950,1.817894737,1479,2393,732,316,314,2,71,1,0.121019108,0,empty,CD-0722-4
"G9,E12",10486,11997,7758,4239,6383,3294,4,3303,2180,1123,1.941228851,1935,2310,553,262,254,8,69,2,0.051181102,0,empty,CD-0722-4
"G9,F1",11674,12722,8635,4087,6701,3275,0,3275,2109,1166,1.808747856,1836,2031,360,181,180,1,61,1,0.05,0,empty,CD-0722-4
"G9,F2",9447,10299,6928,3371,5474,2689,0,2691,1783,908,1.963656388,1550,3376,762,353,352,1,94,1,0.022727273,0,empty,CD-0722-4
"G9,F3",1844781,2105972,1376218,729754,1010975,541533,3,541996,418381,123615,3.384548801,319178,308856,43096,18956,18516,440,2470,9,0.044286023,0,hg38,CD-0722-4
"G9,F4",13586,14689,10145,4544,7735,3656,0,3657,2381,1276,1.865987461,2000,846,184,94,93,1,36,1,0.021505376,0,empty,CD-0722-4
"G9,F5",10676,11309,8028,3281,5925,2737,20,2757,1847,910,2.02967033,1464,2651,454,234,232,2,77,1,0.13362069,0,empty,CD-0722-4
"G9,F6",1024840,1188548,762139,426409,581182,315144,35,315414,252420,62994,4.00704829,185417,191976,24050,10851,10624,227,1904,7,0.031155873,0,hg38,CD-0722-4
"G9,F7",12225,13649,9041,4608,7342,3640,0,3646,2412,1234,1.954619125,2088,1599,347,156,156,0,49,0,0.051282051,0,empty,CD-0722-4
"G9,F8",8961,9905,6620,3285,5393,2714,1,2717,1872,845,2.215384615,1552,458,132,73,73,0,27,0,0.01369863,0,empty,CD-0722-4
"G9,F9",865704,975440,648636,326804,478772,247987,1,248229,196836,51393,3.830015761,142819,207655,29769,13082,12781,301,1901,8,0.059150301,0,hg38,CD-0722-4
"G9,F10",12463,13708,9367,4341,7410,3631,0,3635,2505,1130,2.216814159,2050,2331,579,235,233,2,70,2,0.0472103,0,empty,CD-0722-4
"G9,F11",896206,1002305,678834,323471,489287,249370,0,249647,193865,55782,3.475404252,141894,117657,13690,5961,5815,146,1056,6,0.05950129,0,hg38,CD-0722-4
"G9,F12",1106971,1292795,789482,503313,629442,380637,3,381000,267898,113102,2.368640696,227889,4270,1473,653,643,10,151,2,0.018662519,0,hg38,CD-0722-4
"G9,G1",17348,19027,13333,5694,9695,4459,1,4467,3073,1394,2.204447633,2522,4952,1233,508,503,5,111,2,0.161033797,0,empty,CD-0722-4
"G9,G2",6216,6682,4346,2336,3551,1893,0,1895,1220,675,1.807407407,1122,556,54,31,31,0,14,0,0,0,empty,CD-0722-4
"G9,G3",29271,32525,22733,9792,16119,7868,15,7894,5563,2331,2.386529387,4361,3067,715,325,325,0,87,0,0.018461538,0,empty,CD-0722-4
"G9,G4",21783,24849,15568,9281,13054,7377,14,7398,4521,2877,1.571428571,4395,125,20,12,12,0,6,0,0,0,empty,CD-0722-4
"G9,G5",2093176,2460495,1548312,912183,1170191,657136,32,657777,514663,143114,3.596175077,394573,177286,28767,12578,12351,227,1949,6,0.034572099,0,hg38,CD-0722-4
"G9,G6",11085,11952,8205,3747,6450,3170,0,3174,2142,1032,2.075581395,1806,265,43,23,22,1,8,1,0.045454545,0,empty,CD-0722-4
"G9,G7",9017,10127,6859,3268,5232,2529,0,2531,1763,768,2.295572917,1406,3259,549,245,241,4,83,1,0.095435685,0,empty,CD-0722-4
"G9,G8",7091,7536,5135,2401,4232,2173,2,2176,1502,674,2.228486647,1214,1808,405,181,179,2,59,2,0.011173184,0,empty,CD-0722-4
"G9,G9",8433,9228,6302,2926,5098,2605,1,2606,1764,842,2.095011876,1486,2688,639,304,302,2,78,1,0.023178808,0,empty,CD-0722-4
"G9,G10",10249,11525,7640,3885,6121,3139,1,3143,2125,1018,2.087426326,1785,2597,704,313,310,3,82,2,0.119354839,0,empty,CD-0722-4
"G9,G11",9622,10419,7202,3217,5586,2630,19,2651,1789,862,2.075406032,1460,1914,729,307,305,2,67,2,0.032786885,0,empty,CD-0722-4
"G9,G12",6868,7571,5078,2493,4063,2103,1,2107,1328,779,1.704749679,1223,2127,664,288,288,0,68,0,0.010416667,0,empty,CD-0722-4
"G9,H1",8987,9820,6670,3150,5341,2628,15,2645,1758,887,1.981961669,1492,1567,364,179,179,0,57,0,0.078212291,0,empty,CD-0722-4
"G9,H2",8642,9690,6228,3462,5137,2722,1,2726,1804,922,1.956616052,1565,2209,487,228,228,0,68,0,0.140350877,0,empty,CD-0722-4
"G9,H3",14482,16100,10987,5113,8245,4059,0,4063,2832,1231,2.300568643,2276,3578,835,340,337,3,84,1,0.163204748,0,empty,CD-0722-4
"G9,H4",1188584,1324151,905132,419019,636624,322299,1,322601,246857,75744,3.25909643,184197,4075,360,151,147,4,51,2,0.020408163,0,hg38,CD-0722-4
"G9,H5",13347,14761,9747,5014,7747,3959,18,3981,2620,1361,1.925055107,2281,2580,785,361,361,0,80,0,0.013850416,0,empty,CD-0722-4
"G9,H6",8098,9062,5915,3147,4870,2606,0,2607,1773,834,2.125899281,1491,2462,634,275,271,4,79,3,0.136531365,0,empty,CD-0722-4
"G9,H7",8229,9135,6065,3070,4853,2429,0,2430,1579,851,1.85546416,1441,2255,537,243,237,6,64,1,0.080168776,0,empty,CD-0722-4
"G9,H8",964168,1139601,710072,429529,555332,322705,43,323028,223304,99724,2.239220248,193395,26843,10038,4237,4220,17,820,3,0.023933649,0,hg38,CD-0722-4
"G9,H9",7857,8506,6035,2471,4520,2145,0,2145,1425,720,1.979166667,1186,1994,553,207,207,0,52,0,0.019323671,0,empty,CD-0722-4
"G9,H10",6550,7283,4852,2431,3794,1885,0,1889,1236,653,1.89280245,1069,1779,425,173,166,7,53,2,0.054216867,0,empty,CD-0722-4
"G9,H11",7574,8549,5381,3168,4594,2718,0,2723,1524,1199,1.271059216,1601,53,3,3,3,0,3,0,0,0,empty,CD-0722-4
"G9,H12",7212,8030,5231,2799,4254,2221,0,2226,1577,649,2.429892142,1274,1440,239,124,124,0,32,0,0.161290323,0,empty,CD-0722-4
"G10,A1",8455,9112,6263,2849,4788,2454,0,2461,1683,778,2.163239075,1346,1173,182,85,83,2,26,1,0.409638554,0,empty,CD-0722-4
"G10,A2",12152,13149,9073,4076,6896,3431,0,3433,2247,1186,1.89460371,1888,2059,428,190,190,0,46,0,0.078947368,0,empty,CD-0722-4
"G10,A3",8036,8727,5910,2817,4544,2246,0,2247,1505,742,2.028301887,1290,1241,270,115,114,1,33,1,0.078947368,0,empty,CD-0722-4
"G10,A4",12338,13573,9138,4435,7011,3416,27,3446,2326,1120,2.076785714,1972,957,194,54,51,3,20,1,0,0,empty,CD-0722-4
"G10,A5",894803,1014089,664922,349167,495110,262989,9,263283,195890,67393,2.906681703,153639,121088,18741,7147,6980,167,1120,5,0.045702006,0,hg38,CD-0722-4
"G10,A6",17348,19818,12892,6926,10190,5137,11,5156,3557,1599,2.224515322,3001,2477,567,240,240,0,78,0,0.079166667,0,empty,CD-0722-4
"G10,A7",7544,8576,5503,3073,4609,2421,0,2427,1639,788,2.079949239,1430,1225,254,100,99,1,28,1,0,0,empty,CD-0722-4
"G10,A8",5783,6465,4314,2151,3489,1823,11,1834,1353,481,2.812889813,1049,2305,494,182,179,3,43,1,0.150837989,0,empty,CD-0722-4
"G10,A9",715394,808960,542444,266516,396205,200206,1,200370,152824,47546,3.214234636,115372,151290,19248,7565,7389,176,1179,6,0.054540533,0,hg38,CD-0722-4
"G10,A10",9375,10289,7129,3160,5364,2635,0,2642,1759,883,1.99207248,1438,397,87,33,33,0,12,0,0.090909091,0,empty,CD-0722-4
"G10,A11",832436,961338,623987,337351,470453,252285,3,252531,203690,48841,4.17047153,146105,115655,22819,8712,8592,120,1259,7,0.057728119,0,hg38,CD-0722-4
"G10,A12",11778,12848,8983,3865,6791,3271,6,3282,2339,943,2.48038176,1818,4150,1162,534,519,15,99,2,0.069364162,0,empty,CD-0722-4
"G10,B1",8266,8821,6237,2584,4644,2293,3,2296,1471,825,1.783030303,1228,1364,402,146,145,1,32,1,0.062068966,0,empty,CD-0722-4
"G10,B2",1059016,1196282,754335,441947,591528,325220,15,325501,248510,76991,3.22777987,194618,60748,7592,3058,2988,70,531,4,0.060240964,0,hg38,CD-0722-4
"G10,B3",1396801,1666271,1016496,649775,803613,464877,40,465325,372844,92481,4.031574053,280814,141949,20233,8017,7853,164,1264,6,0.075130523,0,hg38,CD-0722-4
"G10,B4",8506,9746,6178,3568,5144,2747,0,2751,1801,950,1.895789474,1601,1548,279,107,107,0,32,0,0.065420561,0,empty,CD-0722-4
"G10,B5",943734,529286,338414,190872,342519,173853,19,174932,132449,42483,3.117694136,110373,126758,13498,5312,5151,161,899,8,0.055329062,0,hg38,CD-0722-4
"G10,B6",11769,13079,8651,4428,6741,3455,38,3497,2295,1202,1.909317804,2005,1881,577,205,205,0,44,0,0.048780488,0,empty,CD-0722-4
"G10,B7",9385,10276,7166,3110,5455,2594,31,2625,1748,877,1.993158495,1431,1119,355,141,141,0,37,0,0.035460993,0,empty,CD-0722-4
"G10,B8",7373,8094,5540,2554,4454,2257,0,2260,1512,748,2.021390374,1264,1258,350,136,136,0,32,0,0.007352941,0,empty,CD-0722-4
"G10,B9",12285,13841,9033,4808,7244,3739,0,3744,2488,1256,1.98089172,2203,1367,331,119,119,0,30,0,0.050420168,0,empty,CD-0722-4
"G10,B10",6979,7466,5060,2406,4194,2089,0,2095,1357,738,1.838753388,1220,595,145,50,50,0,16,0,0,0,empty,CD-0722-4
"G10,B11",13004,14137,9416,4721,7301,3907,0,3909,2291,1618,1.415945612,2182,161,29,22,22,0,11,0,0.136363636,0,empty,CD-0722-4
"G10,B12",8670,9593,6446,3147,5032,2569,0,2571,1759,812,2.166256158,1477,2047,517,171,168,3,40,2,0.011904762,0,empty,CD-0722-4
"G10,C1",16276,17151,12245,4906,9375,4518,0,4527,3087,1440,2.14375,2443,993,316,131,130,1,32,1,0,0,empty,CD-0722-4
"G10,C2",12103,13792,8809,4983,7317,3857,0,3859,2496,1363,1.831254585,2283,3314,831,316,314,2,96,2,0.060509554,0,empty,CD-0722-4
"G10,C3",12981,14053,9795,4258,7526,3684,12,3699,2424,1275,1.901176471,2017,1007,228,116,116,0,30,0,0.155172414,0,empty,CD-0722-4
"G10,C4",8923,9670,6704,2966,5184,2514,0,2516,1746,770,2.267532468,1398,1996,506,190,190,0,43,0,0.015789474,0,empty,CD-0722-4
"G10,C5",12562,14459,9197,5262,7521,3968,6,3976,2707,1269,2.133175729,2329,1998,487,186,184,2,47,2,0.10326087,0,empty,CD-0722-4
"G10,C6",9644,10795,7102,3693,5870,2976,1,2984,1992,992,2.008064516,1753,1822,563,204,204,0,45,0,0.102941176,0,empty,CD-0722-4
"G10,C7",13257,15165,9617,5548,7888,4278,6,4284,2658,1626,1.634686347,2519,425,91,35,35,0,11,0,0.057142857,0,empty,CD-0722-4
"G10,C8",14443,15920,10540,5380,8392,4235,0,4242,2777,1465,1.89556314,2431,3330,850,365,353,12,86,2,0.04815864,0,empty,CD-0722-4
"G10,C9",12195,13943,8928,5015,7093,3656,0,3662,2494,1168,2.135273973,2132,1844,427,143,139,4,36,2,0.028776978,0,empty,CD-0722-4
"G10,C10",11703,12851,8742,4109,6744,3325,1,3330,2187,1143,1.913385827,1846,2129,477,145,143,2,48,1,0.006993007,0,empty,CD-0722-4
"G10,C11",10502,11514,7783,3731,6144,3046,0,3048,2041,1007,2.026812314,1696,2760,745,247,246,1,58,1,0.146341463,0,empty,CD-0722-4
"G10,C12",15960,17353,11915,5438,8989,4322,6,4342,3034,1308,2.319571865,2396,2356,750,293,292,1,50,1,0.058219178,0,empty,CD-0722-4
"G10,D1",12209,13750,8875,4875,7160,3818,6,3833,2292,1541,1.487345879,2217,1063,180,68,67,1,16,1,0.119402985,0,empty,CD-0722-4
"G10,D2",10031,11119,7683,3436,5852,2763,1,2766,1847,919,2.009793254,1547,2941,943,361,360,1,87,1,0.033333333,0,empty,CD-0722-4
"G10,D3",858830,977261,644001,333260,479513,249727,1,249992,190837,59155,3.226050207,146417,111620,13546,5149,5032,117,851,5,0.063394277,0,hg38,CD-0722-4
"G10,D4",7648,8525,5711,2814,4532,2258,9,2271,1523,748,2.036096257,1335,1498,433,190,188,2,44,1,0.170212766,0,empty,CD-0722-4
"G10,D5",8496,9376,6390,2986,4944,2449,11,2468,1598,870,1.836781609,1387,2283,553,207,206,1,48,1,0.184466019,0,empty,CD-0722-4
"G10,D6",11733,12954,8564,4390,6679,3580,0,3582,2258,1324,1.705438066,2075,2126,514,190,186,4,46,2,0.080645161,0,empty,CD-0722-4
"G10,D7",7039,7412,5290,2122,3956,1839,0,1840,1241,599,2.071786311,983,2386,494,226,220,6,51,1,0.095454545,0,empty,CD-0722-4
"G10,D8",46325,55295,35256,20039,27361,14585,0,14594,11571,3023,3.827654648,8715,10282,963,418,399,19,104,2,0.022556391,0,empty,CD-0722-4
"G10,D9",4765,5078,3538,1540,2620,1228,1,1229,833,396,2.103535354,637,1500,342,155,154,1,39,1,0,0,empty,CD-0722-4
"G10,D10",8234,9279,6094,3185,5041,2667,0,2669,1629,1040,1.566346154,1516,1368,282,97,97,0,21,0,0.154639175,0,empty,CD-0722-4
"G10,D11",8855,9947,6653,3294,5301,2655,0,2658,1761,897,1.963210702,1517,3155,785,306,304,2,77,2,0.023026316,0,empty,CD-0722-4
"G10,D12",12662,14157,9563,4594,7520,3759,0,3761,2470,1291,1.913245546,2154,3808,1051,390,387,3,99,2,0.093023256,0,empty,CD-0722-4
"G10,E1",16636,18174,12319,5855,9473,4751,0,4758,3136,1622,1.933415536,2663,2827,674,276,270,6,76,2,0.07037037,0,empty,CD-0722-4
"G10,E2",10905,12379,7952,4427,6548,3380,0,3387,2082,1305,1.595402299,2042,2513,685,273,271,2,66,1,0.132841328,0,empty,CD-0722-4
"G10,E3",6914,7904,5260,2644,4080,2019,6,2027,1325,702,1.887464387,1155,2159,426,208,207,1,54,1,0.111111111,0,empty,CD-0722-4
"G10,E4",11602,12974,8608,4366,6750,3410,0,3411,2267,1144,1.981643357,1922,3413,795,342,325,17,77,2,0.126153846,0,empty,CD-0722-4
"G10,E5",8655,9438,6526,2912,4985,2340,12,2357,1523,834,1.826139089,1320,1549,388,139,136,3,35,2,0.102941176,0,empty,CD-0722-4
"G10,E6",15711,17476,11795,5681,8923,4416,13,4434,2877,1557,1.8477842,2495,4310,985,385,380,5,91,2,0.086842105,0,empty,CD-0722-4
"G10,E7",760505,836060,577956,258104,405862,198665,11,198873,151673,47200,3.213411017,111962,161315,14693,5860,5637,223,973,6,0.057654781,0,hg38,CD-0722-4
"G10,E8",12339,13561,9450,4111,7239,3416,0,3417,2345,1072,2.1875,1888,3716,891,334,330,4,84,2,0.024242424,0,empty,CD-0722-4
"G10,E9",7647,8798,5609,3189,4517,2314,0,2314,1593,721,2.209431345,1368,3138,804,298,298,0,76,0,0.124161074,0,empty,CD-0722-4
"G10,E10",8639,9824,6455,3369,5151,2564,0,2564,1741,823,2.115431349,1515,1881,614,263,261,2,60,1,0.022988506,0,empty,CD-0722-4
"G10,E11",10069,10970,7437,3533,5723,2834,0,2834,1835,999,1.836836837,1582,2279,472,174,174,0,50,0,0.045977011,0,empty,CD-0722-4
"G10,E12",11599,12986,8532,4454,6864,3493,0,3494,2374,1120,2.119642857,2030,2037,446,188,178,10,47,2,0.117977528,0,empty,CD-0722-4
"G10,F1",12377,13394,9059,4335,7048,3500,0,3506,2226,1280,1.7390625,1961,2782,619,235,233,2,44,2,0.0472103,0,empty,CD-0722-4
"G10,F2",10269,11501,7552,3949,5952,2949,0,2954,1988,966,2.057971014,1722,3051,511,201,198,3,65,2,0.050505051,0,empty,CD-0722-4
"G10,F3",10139,11306,7598,3708,6005,3005,0,3005,2070,935,2.213903743,1698,3089,748,274,269,5,69,2,0.033457249,0,empty,CD-0722-4
"G10,F4",14819,15600,10934,4666,8236,3990,1,3999,2753,1246,2.209470305,2142,751,123,55,55,0,18,0,0.163636364,0,empty,CD-0722-4
"G10,F5",11392,12266,8490,3776,6512,3127,3,3133,2065,1068,1.933520599,1769,2422,448,171,164,7,45,2,0.018292683,0,empty,CD-0722-4
"G10,F6",15051,17102,11207,5895,9225,4924,0,4932,3419,1513,2.259748843,2896,3062,805,347,338,9,101,2,0.100591716,0,empty,CD-0722-4
"G10,F7",12860,14298,9613,4685,7734,3789,0,3792,2543,1249,2.036028823,2128,1380,315,94,91,3,26,2,0.164835165,0,empty,CD-0722-4
"G10,F8",9949,10805,7553,3252,5765,2782,0,2786,1931,855,2.258479532,1498,259,11,8,8,0,7,0,0,0,empty,CD-0722-4
"G10,F9",11967,13087,8969,4118,6928,3355,0,3358,2284,1074,2.126629423,1881,5162,902,358,356,2,93,1,0.070224719,0,empty,CD-0722-4
"G10,F10",13611,15226,10212,5014,7972,3901,0,3903,2590,1313,1.972581874,2215,2254,472,184,178,6,57,2,0.016853933,0,empty,CD-0722-4
"G10,F11",10444,11358,7995,3363,5760,2651,0,2656,1820,836,2.177033493,1423,1827,330,155,155,0,36,0,0.051612903,0,empty,CD-0722-4
"G10,F12",11306,12499,8253,4246,6528,3282,0,3287,2234,1053,2.121557455,1938,235,89,24,24,0,9,0,0,0,empty,CD-0722-4
"G10,G1",12513,13788,9401,4387,7366,3565,0,3572,2376,1196,1.986622074,2087,3003,636,242,236,6,64,2,0.038135593,0,empty,CD-0722-4
"G10,G2",6955,7394,4864,2530,3843,1955,10,1967,1303,664,1.962349398,1114,508,129,46,45,1,12,1,0.022222222,0,empty,CD-0722-4
"G10,G3",13107,14217,9754,4463,7495,3712,0,3719,2285,1434,1.593444909,2074,3054,839,289,282,7,68,2,0.113475177,0,empty,CD-0722-4
"G10,G4",23734,26842,16868,9974,13751,7753,14,7773,4613,3160,1.459810127,4571,139,18,9,9,0,4,0,0,0,empty,CD-0722-4
"G10,G5",7747,8519,5733,2786,4497,2239,0,2241,1462,779,1.876765083,1287,1930,352,152,149,3,45,2,0.087248322,0,empty,CD-0722-4
"G10,G6",11696,12694,8969,3725,6755,3285,0,3286,2268,1018,2.227897839,1801,139,28,14,13,1,5,1,0,0,empty,CD-0722-4
"G10,G7",10290,11236,7839,3397,6037,2838,0,2843,1958,885,2.212429379,1543,2298,394,160,157,3,50,2,0.025477707,0,empty,CD-0722-4
"G10,G8",7232,8014,5387,2627,4303,2121,0,2124,1421,703,2.021337127,1242,2302,385,181,177,4,51,1,0.073446328,0,empty,CD-0722-4
"G10,G9",17875,20503,12666,7837,10372,5941,0,5952,3829,2123,1.80357984,3456,2945,970,398,395,3,101,1,0.012658228,0,empty,CD-0722-4
"G10,G10",14110,15785,10650,5135,8110,3980,0,3981,2754,1227,2.244498778,2245,3862,1077,400,397,3,93,1,0.052896725,0,empty,CD-0722-4
"G10,G11",10964,12169,8228,3941,6366,3127,0,3128,2141,987,2.169199595,1788,1413,362,124,120,4,33,2,0.058333333,0,empty,CD-0722-4
"G10,G12",7561,8844,5425,3419,4502,2432,0,2436,1568,868,1.806451613,1430,1911,543,187,184,3,42,1,0.119565217,0,empty,CD-0722-4
"G10,H1",10444,11404,7745,3659,6037,2996,0,3000,2087,913,2.285870756,1696,1490,419,177,176,1,39,1,0.079545455,0,empty,CD-0722-4
"G10,H2",9349,10288,6909,3379,5407,2731,6,2739,1823,916,1.990174672,1557,2696,773,318,311,7,59,2,0.128617363,0,empty,CD-0722-4
"G10,H3",9728,10624,7167,3457,5645,2777,120,2897,2010,887,2.266065389,1677,1489,337,156,155,1,44,1,0.064516129,0,empty,CD-0722-4
"G10,H4",11837,12836,8764,4072,6620,3196,0,3202,2193,1009,2.173439049,1810,230,33,15,14,1,3,1,0,0,empty,CD-0722-4
"G10,H5",13214,14437,9698,4739,7482,3780,0,3782,2525,1257,2.008750994,2128,1783,335,154,147,7,48,2,0.06122449,0,empty,CD-0722-4
"G10,H6",9073,10047,6655,3392,5260,2742,0,2745,1888,857,2.203033839,1559,2456,547,214,211,3,59,1,0.028436019,0,empty,CD-0722-4
"G10,H7",9472,10453,6882,3571,5488,2738,13,2756,1865,891,2.09315376,1566,2211,645,233,228,5,46,2,0.043859649,0,empty,CD-0722-4
"G10,H8",13546,15125,9917,5208,7921,4180,14,4196,2902,1294,2.242658423,2410,2612,654,267,263,4,70,3,0.076045627,0,empty,CD-0722-4
"G10,H9",8954,9749,6811,2938,5129,2380,13,2396,1673,723,2.313969571,1347,1303,386,136,136,0,40,0,0.139705882,0,empty,CD-0722-4
"G10,H10",7016,7863,5332,2531,4049,1930,0,1930,1285,645,1.992248062,1092,1190,244,121,120,1,32,1,0.083333333,0,empty,CD-0722-4
"G10,H11",8353,9582,5851,3731,5014,2945,0,2948,1626,1322,1.229954614,1743,62,51,12,12,0,2,0,0,0,empty,CD-0722-4
"G10,H12",8678,9620,6335,3285,5129,2712,0,2713,1898,815,2.328834356,1566,1490,332,138,138,0,35,0,0.144927536,0,empty,CD-0722-4
"G11,A1",7611,8759,5657,3102,4563,2376,0,2376,1573,803,1.95890411,1364,1352,298,115,115,0,39,0,0.12173913,0,empty,CD-0722-4
"G11,A2",13437,15058,10197,4861,7690,3810,0,3813,2634,1179,2.234096692,2132,3127,531,253,252,1,64,1,0.115079365,0,empty,CD-0722-4
"G11,A3",7348,8147,5440,2707,4399,2237,0,2239,1461,778,1.877892031,1269,1855,405,109,109,0,26,0,0.055045872,0,empty,CD-0722-4
"G11,A4",12012,13270,9072,4198,6924,3462,1,3465,2288,1177,1.943925234,1905,896,162,66,63,3,23,1,0.031746032,0,empty,CD-0722-4
"G11,A5",15400,16823,11622,5201,8648,4164,0,4166,2830,1336,2.118263473,2297,4804,700,264,257,7,74,2,0.070038911,0,empty,CD-0722-4
"G11,A6",16098,18227,11736,6491,9565,5302,11,5315,3348,1967,1.702084392,3073,2621,602,241,236,5,85,2,0.059322034,0,empty,CD-0722-4
"G11,A7",22634,26456,16138,10318,13278,7820,0,7831,5583,2248,2.483540925,4517,2090,440,170,169,1,51,1,0.029585799,0,empty,CD-0722-4
"G11,A8",5370,6010,4027,1983,3241,1632,0,1633,1115,518,2.152509653,938,2751,494,204,202,2,58,2,0.024752475,0,empty,CD-0722-4
"G11,A9",1982619,2329730,1467994,861736,1113643,630399,2,630946,548096,82850,6.615522028,373616,263209,41559,16241,15949,292,2254,10,0.066022948,0,hg38,CD-0722-4
"G11,A10",8729,9539,6688,2851,4903,2403,0,2405,1557,848,1.836084906,1292,331,43,24,24,0,16,0,0.041666667,0,empty,CD-0722-4
"G11,A11",6879,7230,5222,2008,3824,1761,0,1762,1182,580,2.037931034,918,1470,306,120,120,0,36,0,0.025,0,empty,CD-0722-4
"G11,A12",780845,844374,605835,238539,408188,191651,3,191833,143138,48695,2.939480439,104605,90443,16039,5913,5814,99,936,3,0.012727898,0,hg38,CD-0722-4
"G11,B1",7834,8559,5802,2757,4490,2245,0,2247,1478,769,1.921976593,1279,1261,358,119,116,3,27,1,0.155172414,0,empty,CD-0722-4
"G11,B2",9493,10169,6481,3688,5333,2797,2,2806,1790,1016,1.761811024,1697,865,165,74,73,1,24,1,0,0,empty,CD-0722-4
"G11,B3",7130,7662,5240,2422,4155,2067,0,2070,1410,660,2.136363636,1162,1486,277,95,93,2,35,1,0.043010753,0,empty,CD-0722-4
"G11,B4",7390,8408,5329,3079,4414,2356,0,2360,1548,812,1.906403941,1367,1681,451,172,170,2,41,2,0.017647059,0,empty,CD-0722-4
"G11,B5",16070,13543,8761,4782,7678,4011,11,4034,2938,1096,2.680656934,2419,1100,193,71,71,0,26,0,0,0,empty,CD-0722-4
"G11,B6",9616,10773,6933,3840,5686,3073,0,3075,2088,987,2.11550152,1795,2180,574,253,251,2,67,1,0.135458167,0,empty,CD-0722-4
"G11,B7",14035,15619,10350,5269,8208,4306,0,4311,2734,1577,1.733671528,2428,1166,270,124,122,2,37,2,0.098360656,0,empty,CD-0722-4
"G11,B8",7442,8613,5689,2924,4472,2209,0,2210,1484,726,2.044077135,1295,2013,471,204,200,4,59,1,0.04,0,empty,CD-0722-4
"G11,B9",721156,768356,558517,209839,373107,169056,1,169230,128570,40660,3.16207575,91683,21667,4821,1846,1819,27,335,4,0.019791094,0,hg38,CD-0722-4
"G11,B10",6606,6949,4813,2136,3984,1946,1,1949,1308,641,2.040561622,1126,745,130,48,47,1,19,1,0.319148936,0,empty,CD-0722-4
"G11,B11",12641,13874,9147,4727,7063,3868,0,3868,2274,1594,1.426599749,2164,300,73,36,36,0,12,0,0.083333333,0,empty,CD-0722-4
"G11,B12",8088,9084,5872,3212,4879,2522,1,2526,1759,767,2.293350717,1492,3168,826,307,306,1,67,1,0.049019608,0,empty,CD-0722-4
"G11,C1",25498,27735,19284,8451,14297,6986,0,6994,4882,2112,2.31155303,3883,1527,414,145,145,0,37,0,0.068965517,0,empty,CD-0722-4
"G11,C2",12432,13378,9262,4116,6974,3521,0,3524,2358,1166,2.022298456,1887,3425,763,302,298,4,81,2,0.05704698,0,empty,CD-0722-4
"G11,C3",12345,13765,9109,4656,7269,3647,13,3662,2371,1291,1.836560806,2121,1327,231,93,91,2,21,2,0.230769231,0,empty,CD-0722-4
"G11,C4",960187,1112333,708643,403690,545450,300992,8,301252,251179,50073,5.016256266,175956,211688,30390,12470,12248,222,1797,4,0.059519922,0,hg38,CD-0722-4
"G11,C5",11406,12831,8386,4445,6592,3386,0,3386,2226,1160,1.918965517,1965,2087,391,179,179,0,58,0,0.067039106,0,empty,CD-0722-4
"G11,C6",8976,10012,6498,3514,5356,2771,5,2783,1834,949,1.93256059,1623,1732,495,165,165,0,38,0,0.018181818,0,empty,CD-0722-4
"G11,C7",13031,14853,9408,5445,7649,4141,0,4143,2573,1570,1.638853503,2461,709,83,40,39,1,18,1,0.128205128,0,empty,CD-0722-4
"G11,C8",13699,15407,10074,5333,8044,4188,0,4191,2777,1414,1.963932107,2383,3110,682,285,279,6,86,1,0.014336918,0,empty,CD-0722-4
"G11,C9",916918,1057556,689976,367580,514240,271603,15,271887,208795,63092,3.309373613,159140,96806,12624,5063,4967,96,881,5,0.03764848,0,hg38,CD-0722-4
"G11,C10",18935,21455,14037,7418,10896,5747,0,5749,4163,1586,2.624842371,3322,2433,594,263,263,0,66,0,0.125475285,0,empty,CD-0722-4
"G11,C11",10450,11894,7527,4367,6290,3260,0,3264,2187,1077,2.030640669,1967,2128,481,176,176,0,50,0,0.039772727,0,empty,CD-0722-4
"G11,C12",888381,979409,675298,304111,471263,231669,2,231923,177138,54785,3.233330291,131792,164353,19794,7781,7576,205,1239,5,0.039730729,0,hg38,CD-0722-4
"G11,D1",11403,12895,8381,4514,6634,3470,0,3470,2120,1350,1.57037037,1987,903,195,82,82,0,17,0,0.195121951,0,empty,CD-0722-4
"G11,D2",10828,11832,8274,3558,6140,2881,0,2882,1894,988,1.917004049,1584,3764,1093,379,372,7,84,2,0.086021505,0,empty,CD-0722-4
"G11,D3",8949,10233,6595,3638,5352,2782,3,2785,1874,911,2.057080132,1624,2007,422,151,147,4,49,2,0.013605442,0,empty,CD-0722-4
"G11,D4",7322,8103,5473,2630,4247,2078,5,2092,1413,679,2.081001473,1157,1450,285,107,107,0,36,0,0.009345794,0,empty,CD-0722-4
"G11,D5",1139324,1393714,812123,581591,683851,426356,5,426689,328513,98176,3.346164032,260282,5897,2167,641,640,1,230,1,0.03125,0,hg38,CD-0722-4
"G11,D6",11463,12742,8253,4489,6572,3476,0,3481,2183,1298,1.681818182,1995,1566,418,159,158,1,44,1,0.170886076,0,empty,CD-0722-4
"G11,D7",6625,7435,4974,2461,3838,1838,1,1841,1253,588,2.130952381,1056,2400,571,205,204,1,57,1,0.073529412,0,empty,CD-0722-4
"G11,D8",8046,8542,6120,2422,4472,2142,6,2150,1410,740,1.905405405,1139,1207,289,141,140,1,49,1,0,0,empty,CD-0722-4
"G11,D9",504445,567612,380388,187224,279529,144586,1,144718,109468,35250,3.105475177,83222,192339,29550,11690,11452,238,1710,4,0.043398533,0,hg38,CD-0722-4
"G11,D10",8164,9201,5897,3304,4895,2521,2,2526,1660,866,1.916859122,1491,1228,145,67,65,2,29,2,0.061538462,0,empty,CD-0722-4
"G11,D11",17764,20014,12847,7167,10299,5900,0,5905,3773,2132,1.769699812,3324,3086,708,297,294,3,69,2,0.006802721,0,empty,CD-0722-4
"G11,D12",12636,13919,9562,4357,7272,3590,0,3592,2433,1159,2.099223469,1965,5632,1598,637,621,16,121,2,0.066022544,0,empty,CD-0722-4
"G11,E1",15410,16917,11454,5463,8855,4354,0,4357,2891,1466,1.972032742,2452,2805,693,280,276,4,79,2,0.057971014,0,empty,CD-0722-4
"G11,E2",10127,11303,7432,3871,5906,3021,0,3022,1988,1034,1.922630561,1753,2978,400,196,191,5,48,1,0.062827225,0,empty,CD-0722-4
"G11,E3",11167,12385,8860,3525,6362,2840,0,2840,1875,965,1.943005181,1571,4251,1023,401,396,5,90,2,0.065656566,0,empty,CD-0722-4
"G11,E4",10745,12100,7966,4134,6474,3397,0,3400,2320,1080,2.148148148,1923,3077,698,295,288,7,85,2,0.083333333,0,empty,CD-0722-4
"G11,E5",8123,8719,6251,2468,4608,2188,1,2189,1436,753,1.907038513,1158,1208,397,127,125,2,36,2,0.056,0,empty,CD-0722-4
"G11,E6",15439,16889,11541,5348,8815,4386,0,4390,2919,1471,1.984364378,2454,5420,1357,486,483,3,112,1,0.136645963,0,empty,CD-0722-4
"G11,E7",881874,1026443,635674,390769,500333,301294,1,301539,184434,117105,1.574945562,176630,6764,1870,661,660,1,132,1,0.287878788,0,hg38,CD-0722-4
"G11,E8",2809488,3218752,2124392,1094360,1499759,823411,7,824231,670074,154157,4.346698496,471589,434712,75576,29539,29052,487,3230,9,0.045057139,0,hg38,CD-0722-4
"G11,E9",633935,762863,453768,309095,376651,223835,0,223996,175559,48437,3.624481285,137105,73464,11762,4539,4463,76,939,5,0.036746583,0,hg38,CD-0722-4
"G11,E10",8302,9067,6330,2737,4859,2367,0,2373,1605,768,2.08984375,1314,1705,418,185,185,0,55,0,0.081081081,0,empty,CD-0722-4
"G11,E11",9515,10339,6984,3355,5379,2695,0,2695,1758,937,1.87620064,1501,2181,504,226,224,2,57,2,0.035714286,0,empty,CD-0722-4
"G11,E12",763006,819806,596064,223742,403155,176916,0,177127,135040,42087,3.208591727,97438,47274,8869,3175,3112,63,537,2,0.040167095,0,hg38,CD-0722-4
"G11,F1",12252,13309,9150,4159,6960,3431,1,3434,2206,1228,1.796416938,1905,2216,501,217,215,2,61,1,0.125581395,0,empty,CD-0722-4
"G11,F2",9729,10869,7199,3670,5699,2841,1,2842,1917,925,2.072432432,1672,3788,1010,381,380,1,85,1,0.107894737,0,empty,CD-0722-4
"G11,F3",9984,11130,7473,3657,5849,2901,9,2914,1937,977,1.982599795,1644,2542,725,303,303,0,75,0,0.052805281,0,empty,CD-0722-4
"G11,F4",14014,15070,10392,4678,8074,3927,6,3934,2618,1316,1.989361702,2199,568,103,49,49,0,22,0,0.102040816,0,empty,CD-0722-4
"G11,F5",11092,11809,8360,3449,6315,2952,0,2960,1936,1024,1.890625,1632,2553,642,250,246,4,61,1,0.056910569,0,empty,CD-0722-4
"G11,F6",13834,15926,10155,5771,8278,4414,0,4416,3032,1384,2.190751445,2604,3580,609,274,270,4,91,2,0.118518519,0,empty,CD-0722-4
"G11,F7",12730,13740,9436,4304,7482,3690,2,3696,2412,1284,1.878504673,2060,1165,293,126,125,1,33,1,0.008,0,empty,CD-0722-4
"G11,F8",9536,10642,7136,3506,5687,2825,0,2829,1939,890,2.178651685,1630,394,106,17,17,0,7,0,0,0,empty,CD-0722-4
"G11,F9",10209,10913,7752,3161,5845,2812,0,2815,1959,856,2.288551402,1515,3808,772,306,298,8,83,3,0.020134228,0,empty,CD-0722-4
"G11,F10",13388,14517,10261,4256,7731,3669,0,3673,2468,1205,2.04813278,1980,2593,621,262,259,3,79,1,0.015444015,0,empty,CD-0722-4
"G11,F11",9369,10102,7218,2884,5148,2389,0,2390,1603,787,2.036848793,1287,1521,267,112,109,3,32,2,0.137614679,0,empty,CD-0722-4
"G11,F12",14363,15491,10667,4824,8141,4003,0,4011,2814,1197,2.350877193,2295,286,18,10,9,1,7,1,0,0,empty,CD-0722-4
"G11,G1",12029,13502,9061,4441,7112,3514,1,3515,2292,1223,1.874080131,2027,2968,787,274,266,8,77,2,0.052631579,0,empty,CD-0722-4
"G11,G2",6440,6826,4611,2215,3632,1853,0,1859,1181,678,1.741887906,1046,603,200,84,82,2,18,1,0.134146341,0,empty,CD-0722-4
"G11,G3",12419,13445,9219,4226,7068,3524,0,3534,2284,1250,1.8272,1950,2885,629,255,249,6,64,2,0.084337349,0,empty,CD-0722-4
"G11,G4",21534,23813,15660,8153,12252,6517,19,6546,4004,2542,1.575137687,3674,152,36,20,20,0,5,0,0,0,empty,CD-0722-4
"G11,G5",7925,8585,5818,2767,4448,2201,0,2203,1387,816,1.699754902,1252,2526,471,207,203,4,47,2,0.157635468,0,empty,CD-0722-4
"G11,G6",11720,12536,8819,3717,6620,3242,0,3247,2187,1060,2.063207547,1757,223,55,26,26,0,12,0,0.192307692,0,empty,CD-0722-4
"G11,G7",9901,10545,7645,2900,5557,2517,1,2521,1701,820,2.074390244,1318,2888,678,257,256,1,81,1,0.0546875,0,empty,CD-0722-4
"G11,G8",6807,7319,4999,2320,3933,1940,1,1941,1305,636,2.051886792,1094,2148,425,189,186,3,49,3,0.075268817,0,empty,CD-0722-4
"G11,G9",9181,10338,6692,3646,5499,2861,0,2863,1962,901,2.177580466,1688,3025,730,246,242,4,74,2,0.02892562,0,empty,CD-0722-4
"G11,G10",10636,11885,7863,4022,6101,3057,0,3060,2007,1053,1.905982906,1744,2528,605,260,256,4,75,1,0.01953125,0,empty,CD-0722-4
"G11,G11",10430,11483,7709,3774,6049,3005,0,3007,2115,892,2.371076233,1695,2131,473,194,193,1,49,1,0.191709845,0,empty,CD-0722-4
"G11,G12",7457,8551,5449,3102,4444,2288,29,2317,1458,859,1.697322468,1349,2419,677,289,286,3,58,2,0.090909091,0,empty,CD-0722-4
"G11,H1",9351,10466,6956,3510,5584,2862,1,2865,1897,968,1.959710744,1669,1730,456,213,213,0,53,0,0.103286385,0,empty,CD-0722-4
"G11,H2",9605,10719,7132,3587,5536,2790,1,2796,1771,1025,1.727804878,1637,2840,780,293,289,4,64,2,0.107266436,0,empty,CD-0722-4
"G11,H3",9193,10413,6646,3767,5457,2821,0,2823,1892,931,2.032223416,1669,3327,669,243,239,4,68,1,0.087866109,0,empty,CD-0722-4
"G11,H4",11098,12016,8265,3751,6266,3057,1,3061,2019,1042,1.937619962,1678,105,28,14,14,0,8,0,0,0,empty,CD-0722-4
"G11,H5",12734,14135,9309,4826,7409,3807,1,3811,2481,1330,1.865413534,2246,2838,743,281,277,4,49,2,0.0433213,0,empty,CD-0722-4
"G11,H6",9119,10273,6582,3691,5315,2834,0,2841,1896,945,2.006349206,1679,3037,609,238,236,2,63,1,0.11440678,0,empty,CD-0722-4
"G11,H7",8460,9267,6200,3067,4993,2507,0,2510,1700,810,2.098765432,1450,2047,485,171,170,1,39,1,0.129411765,0,empty,CD-0722-4
"G11,H8",20497,23672,15109,8563,12477,6833,0,6841,4901,1940,2.52628866,4080,2741,579,235,233,2,72,1,0.017167382,0,empty,CD-0722-4
"G11,H9",8193,8708,6239,2469,4627,2120,1,2125,1448,677,2.138847858,1127,1618,307,129,129,0,43,0,0.100775194,0,empty,CD-0722-4
"G11,H10",6722,7550,4993,2557,3890,1953,3,1958,1245,713,1.746143058,1161,1468,370,135,134,1,36,1,0.044776119,0,empty,CD-0722-4
"G11,H11",7849,8977,5475,3502,4667,2731,14,2745,1510,1235,1.222672065,1677,50,21,11,11,0,2,0,0,0,empty,CD-0722-4
"G11,H12",7851,8562,5741,2821,4601,2352,0,2354,1637,717,2.283124128,1359,2183,348,145,145,0,36,0,0.055172414,0,empty,CD-0722-4
"G12,A1",8561,9739,6259,3480,5151,2724,0,2726,1791,935,1.915508021,1582,1492,501,184,184,0,40,0,0.108695652,0,empty,CD-0722-4
"G12,A2",14953,16380,11347,5033,8551,4255,7,4262,2892,1370,2.110948905,2322,2217,658,267,266,1,61,1,0.097744361,0,empty,CD-0722-4
"G12,A3",7872,8706,5745,2961,4765,2467,5,2474,1700,774,2.196382429,1434,1688,476,200,196,4,50,1,0.040816327,0,empty,CD-0722-4
"G12,A4",11821,12930,8879,4051,6895,3381,0,3388,2237,1151,1.943527368,1889,704,129,52,52,0,21,0,0.019230769,0,empty,CD-0722-4
"G12,A5",13321,14615,9912,4703,7988,4088,10,4107,2919,1188,2.457070707,2290,2362,463,169,167,2,50,1,0.05988024,0,empty,CD-0722-4
"G12,A6",437386,481914,342056,139858,238221,112050,1,112167,87009,25158,3.458502266,61637,101418,18177,6756,6667,89,1021,4,0.022948853,0,hg38,CD-0722-4
"G12,A7",7813,8776,5724,3052,4728,2520,0,2523,1690,833,2.028811525,1473,1468,353,144,144,0,32,0,0,0,empty,CD-0722-4
"G12,A8",6503,7432,4865,2567,4027,2023,1,2027,1458,569,2.562390158,1207,2354,457,205,192,13,53,2,0.0625,0,empty,CD-0722-4
"G12,A9",728754,787159,580837,206322,383831,165957,1,166156,128226,37930,3.380595834,88787,99248,13308,5157,5026,131,855,8,0.058495822,0,hg38,CD-0722-4
"G12,A10",11812,12703,8984,3719,6589,3103,0,3114,2128,986,2.15821501,1751,423,106,36,35,1,9,1,0,0,empty,CD-0722-4
"G12,A11",7607,8381,5735,2646,4500,2195,0,2197,1469,728,2.017857143,1234,1566,405,161,159,2,40,1,0.031446541,0,empty,CD-0722-4
"G12,A12",13342,14562,10023,4539,7741,3773,0,3780,2612,1168,2.23630137,2112,3325,818,322,321,1,77,1,0.124610592,0,empty,CD-0722-4
"G12,B1",8716,9772,6494,3278,5190,2647,8,2655,1734,921,1.882736156,1556,1368,253,123,118,5,37,2,0.042372881,0,empty,CD-0722-4
"G12,B2",8934,9735,6085,3650,5174,2782,18,2800,1791,1009,1.775024777,1635,507,74,27,27,0,9,0,0,0,empty,CD-0722-4
"G12,B3",8734,10004,6423,3581,5417,2815,0,2819,2003,816,2.454656863,1634,1440,265,104,103,1,27,1,0.019417476,0,empty,CD-0722-4
"G12,B4",8754,10101,6396,3705,5317,2818,0,2821,1873,948,1.975738397,1665,1270,255,105,105,0,43,0,0.095238095,0,empty,CD-0722-4
"G12,B5",9316,5392,3514,1878,3696,1896,0,1914,1350,564,2.393617021,1172,1053,193,87,86,1,26,1,0.255813953,0,empty,CD-0722-4
"G12,B6",11883,13509,8600,4909,7132,3823,20,3844,2633,1211,2.174236168,2192,1785,505,168,165,3,45,1,0.03030303,0,empty,CD-0722-4
"G12,B7",9907,11184,7520,3664,5883,2891,0,2892,1951,941,2.073326249,1639,1201,275,126,124,2,27,1,0.024193548,0,empty,CD-0722-4
"G12,B8",9047,9831,6786,3045,5330,2635,0,2637,1924,713,2.698457223,1462,1718,241,117,116,1,35,1,0.172413793,0,empty,CD-0722-4
"G12,B9",13128,14641,9697,4944,7844,4028,0,4033,2680,1353,1.980783444,2337,1093,159,64,61,3,23,2,0.131147541,0,empty,CD-0722-4
"G12,B10",8022,8494,5831,2663,4841,2397,1,2403,1618,785,2.061146497,1363,528,83,41,41,0,19,0,0.097560976,0,empty,CD-0722-4
"G12,B11",15092,17142,11206,5936,8692,4706,0,4710,3087,1623,1.902033272,2673,187,52,29,29,0,6,0,0,0,empty,CD-0722-4
"G12,B12",9603,10729,7087,3642,5733,2950,0,2956,2053,903,2.273532669,1677,2104,543,215,206,9,46,2,0.067961165,0,empty,CD-0722-4
"G12,C1",18142,19907,13644,6263,10762,5332,0,5338,3732,1606,2.323785803,2940,1032,217,82,82,0,26,0,0.06097561,0,empty,CD-0722-4
"G12,C2",12793,14325,9479,4846,7558,3934,10,3949,2655,1294,2.051777434,2307,2558,520,227,226,1,64,1,0.048672566,0,empty,CD-0722-4
"G12,C3",13349,15142,10030,5112,8094,4172,0,4172,2842,1330,2.136842105,2367,677,55,24,23,1,11,1,0,0,empty,CD-0722-4
"G12,C4",9870,11032,7430,3602,5867,2970,0,2974,2014,960,2.097916667,1682,2379,499,189,188,1,61,1,0.063829787,0,empty,CD-0722-4
"G12,C5",12504,14076,9286,4790,7558,3946,1,3955,2678,1277,2.097102584,2287,1624,402,177,174,3,49,2,0.155172414,0,empty,CD-0722-4
"G12,C6",10180,11655,7560,4095,6108,3188,0,3193,2208,985,2.241624365,1879,2101,596,250,249,1,57,1,0.076305221,0,empty,CD-0722-4
"G12,C7",17559,20227,12943,7284,10313,5481,6,5491,3561,1930,1.84507772,3235,643,73,44,43,1,11,1,0.209302326,0,empty,CD-0722-4
"G12,C8",14892,16489,11033,5456,8797,4490,0,4496,3047,1449,2.102829538,2618,2551,576,223,222,1,50,1,0.081081081,0,empty,CD-0722-4
"G12,C9",11993,13672,8981,4691,7294,3732,2,3735,2555,1180,2.165254237,2194,1605,283,123,122,1,38,1,0.057377049,0,empty,CD-0722-4
"G12,C10",12120,13392,9335,4057,7153,3508,14,3522,2331,1191,1.957178841,1954,2359,681,253,253,0,53,0,0.067193676,0,empty,CD-0722-4
"G12,C11",10911,12085,8136,3949,6605,3400,0,3404,2334,1070,2.181308411,1936,2393,665,275,271,4,62,2,0.162361624,0,empty,CD-0722-4
"G12,C12",16635,18535,12487,6048,9753,4727,0,4739,3336,1403,2.377761939,2662,1997,502,195,195,0,47,0,0.020512821,0,empty,CD-0722-4
"G12,D1",11959,13271,8713,4558,7252,3909,0,3914,2490,1424,1.748595506,2308,822,115,57,57,0,14,0,0.052631579,0,empty,CD-0722-4
"G12,D2",9555,10295,7322,2973,5504,2552,0,2552,1688,864,1.953703704,1354,2891,697,273,269,4,64,2,0.115241636,0,empty,CD-0722-4
"G12,D3",10080,11522,7345,4177,6126,3156,0,3158,2180,978,2.229038855,1895,2070,513,194,192,2,32,1,0.114583333,0,empty,CD-0722-4
"G12,D4",8462,9463,6398,3065,5040,2562,0,2563,1786,777,2.298584299,1396,1403,243,117,116,1,40,1,0.017241379,0,empty,CD-0722-4
"G12,D5",9269,10401,6962,3439,5368,2772,0,2775,1941,834,2.327338129,1608,1596,326,145,144,1,35,1,0.111111111,0,empty,CD-0722-4
"G12,D6",11738,12701,8451,4250,6691,3477,0,3477,2225,1252,1.77715655,1987,2521,681,249,246,3,60,1,0.117886179,0,empty,CD-0722-4
"G12,D7",859967,968024,646933,321091,471230,244480,0,244692,194441,50251,3.869395634,139823,14852,2262,739,726,13,248,2,0.046831956,0,hg38,CD-0722-4
"G12,D8",8991,10062,6727,3335,5286,2638,0,2644,1852,792,2.338383838,1496,1122,332,130,129,1,35,1,0.015503876,0,empty,CD-0722-4
"G12,D9",5006,5377,3757,1620,2894,1362,0,1362,933,429,2.174825175,754,1763,341,110,109,1,38,1,0.018348624,0,empty,CD-0722-4
"G12,D10",8855,9874,6503,3371,5294,2753,0,2757,1838,919,2,1578,876,212,77,77,0,29,0,0,0,empty,CD-0722-4
"G12,D11",9306,10289,6986,3303,5560,2742,40,2789,1848,941,1.963868225,1583,2729,607,224,221,3,56,1,0.036199095,0,empty,CD-0722-4
"G12,D12",13655,15494,10164,5330,8279,4273,0,4275,2950,1325,2.226415094,2453,4113,966,385,384,1,95,1,0.028645833,0,empty,CD-0722-4
"G12,E1",18298,20148,13549,6599,10498,5243,0,5245,3605,1640,2.198170732,2893,2666,479,212,204,8,61,2,0,0,empty,CD-0722-4
"G12,E2",11151,12602,8140,4462,6786,3534,34,3572,2359,1213,1.944765045,2149,2023,570,230,230,0,52,0,0.091304348,0,empty,CD-0722-4
"G12,E3",6817,7649,5119,2530,4080,2001,1,2005,1369,636,2.152515723,1164,2086,572,246,245,1,54,1,0.216326531,0,empty,CD-0722-4
"G12,E4",1022208,1252387,695529,556858,613041,414480,4,414813,296662,118151,2.510871681,252960,6308,1018,324,315,9,75,2,0.022222222,0,hg38,CD-0722-4
"G12,E5",1137958,1299715,852904,446811,627495,335671,2,336004,274883,61121,4.4973577,194091,83474,11678,4654,4569,85,908,5,0.027358284,0,hg38,CD-0722-4
"G12,E6",18475,19864,13129,6735,10447,5535,1,5539,3570,1969,1.813103098,3219,3657,872,340,332,8,80,3,0.084337349,0,empty,CD-0722-4
"G12,E7",18134,20172,13559,6613,10822,5503,0,5507,3901,1606,2.429016189,3176,2853,690,295,295,0,85,0,0.050847458,0,empty,CD-0722-4
"G12,E8",13276,14657,10172,4485,7982,3724,1,3728,2643,1085,2.4359447,2092,2768,820,302,301,1,74,1,0.122923588,0,empty,CD-0722-4
"G12,E9",8842,10202,6564,3638,5418,2814,0,2819,2045,774,2.642118863,1635,3660,809,342,341,1,75,1,0.070381232,0,empty,CD-0722-4
"G12,E10",1093692,1254582,810609,443973,605903,332410,2,332692,257413,75279,3.419452968,194688,124089,21808,8229,8117,112,1379,4,0.039300234,0,hg38,CD-0722-4
"G12,E11",860830,952278,657306,294972,468608,233296,4,233487,185502,47985,3.865833073,131500,44312,10367,4004,3953,51,667,4,0.02403238,0,hg38,CD-0722-4
"G12,E12",13086,14637,9678,4959,7951,4097,0,4101,2842,1259,2.257347101,2375,2339,604,209,208,1,48,1,0.038461538,0,empty,CD-0722-4
"G12,F1",1119275,1233256,853191,380065,594332,297202,20,297475,235885,61590,3.829923689,166358,41893,10414,3911,3874,37,668,3,0.021424884,0,hg38,CD-0722-4
"G12,F2",9850,10951,7358,3593,5704,2871,0,2872,1900,972,1.95473251,1625,2845,709,252,250,2,55,1,0.056,0,empty,CD-0722-4
"G12,F3",11311,12487,8483,4004,6699,3362,1,3367,2333,1034,2.256286267,1952,2392,362,158,152,6,64,2,0.026315789,0,empty,CD-0722-4
"G12,F4",864928,961094,633626,327468,482009,275220,9,275468,182986,92482,1.978612054,156286,890,203,76,76,0,19,0,0.210526316,0,empty,CD-0722-4
"G12,F5",11616,12351,8736,3615,6601,3115,0,3116,2123,993,2.13796576,1637,2265,452,188,184,4,50,2,0.157608696,0,empty,CD-0722-4
"G12,F6",18661,21511,13679,7832,11325,5986,0,5996,4213,1783,2.362871565,3570,3779,791,335,335,0,99,0,0.047761194,0,empty,CD-0722-4
"G12,F7",13421,14690,10160,4530,8069,3942,0,3946,2713,1233,2.200324412,2159,1327,315,144,144,0,35,0,0.027777778,0,empty,CD-0722-4
"G12,F8",855070,787444,736543,50901,367634,70728,0,70908,51307,19601,2.617570532,23454,14565,1786,645,625,20,129,2,0.0736,0,empty,CD-0722-4
"G12,F9",11810,13210,8783,4427,7174,3562,0,3567,2507,1060,2.36509434,2083,2590,368,172,170,2,63,1,0.052941176,0,empty,CD-0722-4
"G12,F10",14308,15459,10968,4491,8398,4081,0,4085,2811,1274,2.206436421,2151,2116,471,193,193,0,52,0,0.119170984,0,empty,CD-0722-4
"G12,F11",10765,11788,8174,3614,6100,2949,2,2954,2113,841,2.512485137,1578,1691,442,194,192,2,37,1,0.078125,0,empty,CD-0722-4
"G12,F12",11871,13188,8824,4364,7011,3518,18,3544,2472,1072,2.305970149,2031,145,15,4,4,0,4,0,0,0,empty,CD-0722-4
"G12,G1",14085,15712,10497,5215,8396,4307,0,4310,2953,1357,2.176123803,2480,2970,627,266,265,1,68,1,0.049056604,0,empty,CD-0722-4
"G12,G2",6657,7449,4711,2738,3991,2124,0,2124,1402,722,1.941828255,1265,423,98,42,42,0,13,0,0,0,empty,CD-0722-4
"G12,G3",13023,13966,9580,4386,7658,3862,0,3868,2424,1444,1.67867036,2173,3134,1098,421,416,5,82,2,0.055288462,0,empty,CD-0722-4
"G12,G4",1553097,1778885,1153656,625229,847435,464849,8,465268,367762,97506,3.771685845,270406,1808,336,112,110,2,25,2,0.009090909,0,hg38,CD-0722-4
"G12,G5",7173,8053,5235,2818,4235,2178,0,2178,1438,740,1.943243243,1286,1474,346,144,143,1,39,1,0.055944056,0,empty,CD-0722-4
"G12,G6",12310,13615,9205,4410,7347,3592,0,3596,2560,1036,2.471042471,2057,145,26,6,5,1,4,1,0,0,empty,CD-0722-4
"G12,G7",10729,11538,8052,3486,6295,3021,0,3028,2070,958,2.160751566,1683,2496,720,306,306,0,70,0,0.045751634,0,empty,CD-0722-4
"G12,G8",7780,8503,5815,2688,4611,2285,0,2285,1574,711,2.213783404,1274,1347,299,135,130,5,36,1,0.007692308,0,empty,CD-0722-4
"G12,G9",744465,810963,574451,236512,396579,185934,1,186116,143412,42704,3.358280255,104200,63601,12544,4612,4522,90,776,5,0.032950022,0,hg38,CD-0722-4
"G12,G10",12861,14296,9591,4705,7609,3793,31,3824,2743,1081,2.53746531,2144,2417,615,246,245,1,62,1,0.069387755,0,empty,CD-0722-4
"G12,G11",11625,12760,8781,3979,6871,3354,0,3368,2405,963,2.497403946,1861,1252,330,156,155,1,50,1,0.04516129,0,empty,CD-0722-4
"G12,G12",7315,8198,5361,2837,4399,2260,0,2265,1450,815,1.779141104,1314,1913,416,188,181,7,43,3,0.198895028,0,empty,CD-0722-4
"G12,H1",12483,14023,9181,4842,7464,3827,1,3833,2680,1153,2.324371206,2256,1618,468,170,169,1,39,1,0.017751479,0,empty,CD-0722-4
"G12,H2",9668,11044,7120,3924,5876,3078,0,3082,2024,1058,1.913043478,1791,2537,633,228,221,7,52,2,0.158371041,0,empty,CD-0722-4
"G12,H3",10228,11404,7441,3963,6216,3172,2,3186,2216,970,2.284536082,1904,1580,361,145,142,3,42,1,0.169014085,0,empty,CD-0722-4
"G12,H4",11980,13102,8774,4328,6921,3443,1,3449,2255,1194,1.888609715,1983,174,12,10,10,0,5,0,0,0,empty,CD-0722-4
"G12,H5",14709,16461,10986,5475,8612,4388,0,4392,2984,1408,2.119318182,2502,3255,589,211,209,2,52,2,0.066985646,0,empty,CD-0722-4
"G12,H6",10292,11392,7579,3813,6034,3029,34,3065,2139,926,2.309935205,1723,2152,483,189,188,1,47,1,0.031914894,0,empty,CD-0722-4
"G12,H7",9459,10383,6990,3393,5611,2788,0,2791,1880,911,2.063666301,1639,1624,423,181,180,1,39,1,0.005555556,0,empty,CD-0722-4
"G12,H8",928380,1094004,674160,419844,529323,299015,2,299282,245665,53617,4.58184904,180964,196182,36179,14233,14060,173,1937,7,0.050426743,0,hg38,CD-0722-4
"G12,H9",9912,11060,7519,3541,5713,2788,7,2797,1925,872,2.207568807,1631,906,167,66,64,2,24,1,0.0625,0,empty,CD-0722-4
"G12,H10",8091,8797,5977,2820,4647,2329,0,2332,1600,732,2.18579235,1301,1254,482,155,153,2,40,1,0.006535948,0,empty,CD-0722-4
"G12,H11",7583,8654,5327,3327,4566,2693,0,2693,1516,1177,1.288020391,1600,51,2,2,2,0,2,0,0,0,empty,CD-0722-4
"G12,H12",9409,10526,6883,3643,5631,2958,0,2958,2095,863,2.427578216,1713,1412,173,91,88,3,36,1,0.011363636,0,empty,CD-0722-4
"H1,A1",6754,7770,4960,2810,4123,2198,0,2202,1546,656,2.356707317,1306,927,190,49,49,0,19,0,0.142857143,0,empty,CD-0722-4
"H1,A2",10406,11453,7655,3798,6142,3155,15,3172,2228,944,2.360169492,1836,1073,331,110,110,0,22,0,0.118181818,0,empty,CD-0722-4
"H1,A3",5868,6535,4356,2179,3527,1785,0,1788,1265,523,2.41873805,1020,800,125,63,62,1,24,1,0,0,empty,CD-0722-4
"H1,A4",7986,8671,6039,2632,4732,2309,19,2329,1601,728,2.199175824,1288,483,116,37,36,1,15,1,0.055555556,0,empty,CD-0722-4
"H1,A5",1049504,1196911,768268,428643,583902,320575,30,320921,263019,57902,4.542485579,188277,178716,22671,8915,8699,216,1440,7,0.04184389,0,hg38,CD-0722-4
"H1,A6",9220,10703,6867,3836,5586,2992,16,3012,2122,890,2.384269663,1740,1562,504,172,171,1,47,1,0.011695906,0,empty,CD-0722-4
"H1,A7",5604,6445,4118,2327,3375,1782,9,1793,1115,678,1.644542773,1022,891,166,60,59,1,24,1,0.033898305,0,empty,CD-0722-4
"H1,A8",4777,5299,3561,1738,2885,1453,10,1465,1069,396,2.699494949,834,1202,330,134,130,4,34,2,0.107692308,0,empty,CD-0722-4
"H1,A9",8587,9571,6419,3152,5233,2660,0,2665,1873,792,2.36489899,1536,980,202,92,90,2,31,1,0.077777778,0,empty,CD-0722-4
"H1,A10",8572,9439,6498,2941,4996,2534,0,2534,1780,754,2.360742706,1411,178,24,14,14,0,9,0,0,0,empty,CD-0722-4
"H1,A11",5982,6625,4643,1982,3621,1755,5,1762,1231,531,2.31826742,994,996,175,76,73,3,23,1,0.232876712,0,empty,CD-0722-4
"H1,A12",12002,12706,8743,3963,7071,3638,0,3642,2612,1030,2.53592233,2004,1661,461,182,180,2,40,2,0.222222222,0,empty,CD-0722-4
"H1,B1",6240,6848,4534,2314,3709,1928,0,1928,1344,584,2.301369863,1088,793,209,91,91,0,19,0,0.021978022,0,empty,CD-0722-4
"H1,B2",5725,6291,3909,2382,3383,1780,0,1788,1138,650,1.750769231,1061,433,77,41,41,0,8,0,0.463414634,0,empty,CD-0722-4
"H1,B3",6687,7647,4944,2703,4096,2140,1,2141,1499,642,2.334890966,1237,1047,250,121,121,0,35,0,0.066115702,0,empty,CD-0722-4
"H1,B4",6882,7597,5047,2550,4124,2155,0,2156,1479,677,2.184638109,1232,1115,155,84,83,1,22,1,0.301204819,0,empty,CD-0722-4
"H1,B5",6837,4139,2599,1540,2791,1460,0,1466,1011,455,2.221978022,910,500,86,40,40,0,18,0,0,0,empty,CD-0722-4
"H1,B6",8511,9596,6150,3446,5091,2668,0,2670,1811,859,2.108265425,1591,848,111,49,48,1,19,1,0,0,empty,CD-0722-4
"H1,B7",6691,7407,5047,2360,4151,1997,2,2001,1398,603,2.31840796,1144,621,187,78,78,0,25,0,0.051282051,0,empty,CD-0722-4
"H1,B8",7364,8337,5496,2841,4476,2272,0,2274,1636,638,2.564263323,1294,884,178,71,71,0,17,0,0,0,empty,CD-0722-4
"H1,B9",10185,11525,7413,4112,5952,3074,6,3086,2110,976,2.161885246,1846,575,96,40,39,1,16,1,0,0,empty,CD-0722-4
"H1,B10",6057,6603,4259,2344,3809,2037,0,2042,1439,603,2.386401327,1196,416,52,20,20,0,10,0,0.25,0,empty,CD-0722-4
"H1,B11",1054041,1163979,800599,363380,559336,276957,1,277227,220214,57013,3.862522583,156313,37881,5532,2193,2161,32,369,2,0.060620083,0,hg38,CD-0722-4
"H1,B12",7690,8427,5739,2688,4583,2353,0,2353,1704,649,2.625577812,1325,1091,303,98,98,0,25,0,0.010204082,0,empty,CD-0722-4
"H1,C1",21677313,24935561,15779930,9155631,9529446,7023224,48,7029072,5589389,1439683,3.882374801,4105812,184625,27637,10343,10132,211,1841,5,0.028030004,0,hg38,CD-0722-4
"H1,C2",8921,10039,6556,3483,5276,2789,1,2790,1930,860,2.244186047,1556,1444,479,170,168,2,33,1,0.125,0,empty,CD-0722-4
"H1,C3",9155,10349,6645,3704,5585,2901,0,2901,1992,909,2.191419142,1728,563,88,27,27,0,16,0,0.222222222,0,empty,CD-0722-4
"H1,C4",784969,905849,572602,333247,459420,274351,3,274514,169157,105357,1.605560143,160622,1895,836,192,191,1,52,1,0.172774869,0,hg38,CD-0722-4
"H1,C5",10685,12062,7841,4221,6522,3458,0,3458,2452,1006,2.437375746,1986,1263,286,118,110,8,36,2,0.145454545,0,empty,CD-0722-4
"H1,C6",7416,8030,5378,2652,4465,2332,14,2348,1668,680,2.452941176,1328,1071,272,120,115,5,32,1,0.017391304,0,empty,CD-0722-4
"H1,C7",9125,10175,6651,3524,5480,3009,3,3015,1959,1056,1.855113636,1750,266,35,18,18,0,8,0,0,0,empty,CD-0722-4
"H1,C8",1085467,1245481,794107,451374,606653,338963,9,339307,291952,47355,6.165177912,197437,98722,18211,6972,6857,115,1253,6,0.028583929,0,hg38,CD-0722-4
"H1,C9",8795,9886,6599,3287,5357,2718,0,2720,1937,783,2.473818646,1587,854,177,80,79,1,25,1,0,0,empty,CD-0722-4
"H1,C10",8049,8783,6108,2675,4717,2325,0,2325,1603,722,2.220221607,1291,1358,293,142,142,0,41,0,0.126760563,0,empty,CD-0722-4
"H1,C11",8139,9139,5992,3147,5003,2520,4,2527,1774,753,2.355909695,1488,1380,308,151,150,1,36,1,0.1,0,empty,CD-0722-4
"H1,C12",17954,19908,13313,6595,10357,5105,0,5110,3670,1440,2.548611111,2875,10104,1377,580,569,11,135,2,0.105448155,0,empty,CD-0722-4
"H1,D1",1339049,1585950,977452,608498,768045,438979,4,439417,350278,89139,3.929570671,264896,55363,7067,2979,2912,67,548,5,0.088598901,0,hg38,CD-0722-4
"H1,D2",726005,766411,570256,196155,374379,162100,2,162287,128305,33982,3.775675358,85739,76209,14427,5279,5201,78,852,3,0.011728514,0,hg38,CD-0722-4
"H1,D3",7339,8478,5404,3074,4543,2448,0,2448,1620,828,1.956521739,1473,914,213,82,78,4,14,1,0.256410256,0,empty,CD-0722-4
"H1,D4",7096,8154,5235,2919,4409,2279,1,2285,1648,637,2.587127159,1314,1829,341,118,117,1,27,1,0.111111111,0,empty,CD-0722-4
"H1,D5",5984,6850,4339,2511,3668,1907,0,1912,1314,598,2.197324415,1163,1023,253,105,104,1,25,1,0,0,empty,CD-0722-4
"H1,D6",8363,9073,6015,3058,4822,2531,1,2533,1638,895,1.830167598,1440,900,255,112,112,0,28,0,0.0625,0,empty,CD-0722-4
"H1,D7",5305,5749,3888,1861,3057,1497,0,1499,1054,445,2.368539326,868,1089,277,113,110,3,24,1,0.018181818,0,empty,CD-0722-4
"H1,D8",1019624,1223871,710443,513428,603519,387550,3,387875,292267,95608,3.056930382,232361,43646,27933,10426,10418,8,1338,2,0.012766366,0,hg38,CD-0722-4
"H1,D9",4005,4467,2951,1516,2459,1249,2,1255,923,332,2.780120482,736,844,190,74,74,0,25,0,0,0,empty,CD-0722-4
"H1,D10",6242,7053,4528,2525,3827,2067,10,2078,1338,740,1.808108108,1241,549,96,42,41,1,10,1,0.024390244,0,empty,CD-0722-4
"H1,D11",6752,7529,5081,2448,3982,1995,2,1997,1397,600,2.328333333,1137,1438,382,148,144,4,39,2,0.076388889,0,empty,CD-0722-4
"H1,D12",9750,10823,7214,3609,5883,2986,0,2988,2107,881,2.391600454,1696,2427,621,289,288,1,80,1,0.055555556,0,empty,CD-0722-4
"H1,E1",13968,15263,10279,4984,8259,4191,0,4191,2828,1363,2.074834923,2344,1520,246,90,89,1,34,1,0.056179775,0,empty,CD-0722-4
"H1,E2",8184,9049,5741,3308,4848,2569,0,2575,1714,861,1.990708479,1522,1185,129,74,73,1,23,1,0,0,empty,CD-0722-4
"H1,E3",4652,5139,3586,1553,2811,1389,0,1391,961,430,2.234883721,758,1298,389,162,161,1,34,1,0,0,empty,CD-0722-4
"H1,E4",11489,12949,8327,4622,7040,3785,0,3793,2657,1136,2.338908451,2229,1396,309,147,147,0,38,0,0.034013605,0,empty,CD-0722-4
"H1,E5",6123,6568,4443,2125,3782,1919,0,1922,1315,607,2.166392092,1098,1266,257,110,108,2,25,1,0.148148148,0,empty,CD-0722-4
"H1,E6",1281580,1426247,963965,462282,681720,356022,2,356364,295127,61237,4.819422898,202234,107330,14118,5266,5148,118,971,3,0.052059052,0,hg38,CD-0722-4
"H1,E7",17181,19674,12775,6899,10242,5121,0,5125,3689,1436,2.568941504,2980,3619,833,310,302,8,56,2,0.149006623,0,empty,CD-0722-4
"H1,E8",9864,10503,7508,2995,5730,2719,0,2720,1915,805,2.378881988,1453,2354,600,240,232,8,61,2,0.021551724,0,empty,CD-0722-4
"H1,E9",6406,7192,4931,2261,3775,1882,0,1882,1349,533,2.530956848,1035,1560,288,121,121,0,38,0,0.074380165,0,empty,CD-0722-4
"H1,E10",5505,6145,4018,2127,3367,1692,33,1727,1205,522,2.308429119,995,908,156,63,63,0,21,0,0.015873016,0,empty,CD-0722-4
"H1,E11",7345,8234,5528,2706,4329,2216,1,2219,1498,721,2.077669903,1277,1257,423,164,160,4,49,2,0.01875,0,empty,CD-0722-4
"H1,E12",9763,11277,7082,4195,6095,3221,0,3223,2208,1015,2.175369458,1961,1197,244,108,107,1,34,1,0.037383178,0,empty,CD-0722-4
"H1,F1",20720,21931,16163,5768,10993,4569,0,4569,3220,1349,2.386953299,2490,3698,852,356,353,3,95,2,0.028328612,0,empty,CD-0722-4
"H1,F2",11443,12936,8686,4250,6643,3337,0,3341,2384,957,2.491118077,1904,2365,433,175,174,1,48,1,0.126436782,0,empty,CD-0722-4
"H1,F3",14913,16902,11048,5854,8721,4701,16,4718,3395,1323,2.566137566,2701,2718,446,187,185,2,55,2,0.075675676,0,empty,CD-0722-4
"H1,F4",10202,11005,7561,3444,5983,2881,7,2891,1980,911,2.173435785,1604,447,85,27,27,0,6,0,0,0,empty,CD-0722-4
"H1,F5",7787,8329,5763,2566,4449,2089,0,2089,1382,707,1.954738331,1171,1355,399,129,124,5,32,1,0.14516129,0,empty,CD-0722-4
"H1,F6",14597,16864,10691,6173,9091,4801,1,4805,3503,1302,2.69047619,2927,1777,404,173,171,2,51,1,0.011695906,0,empty,CD-0722-4
"H1,F7",9262,10502,6809,3693,5714,2918,2,2920,2056,864,2.37962963,1676,512,161,61,61,0,19,0,0.016393443,0,empty,CD-0722-4
"H1,F8",8437,9286,6219,3067,5195,2593,19,2614,1875,739,2.537212449,1534,128,9,4,4,0,4,0,0,0,empty,CD-0722-4
"H1,F9",8521,9316,6548,2768,5000,2431,0,2431,1782,649,2.745762712,1274,1741,400,147,140,7,36,2,0.078571429,0,empty,CD-0722-4
"H1,F10",9873,10894,7459,3435,5941,2893,0,2894,2076,818,2.537897311,1587,971,153,78,76,2,20,1,0.184210526,0,empty,CD-0722-4
"H1,F11",7643,8328,5830,2498,4330,2066,0,2068,1453,615,2.362601626,1126,993,156,84,81,3,32,1,0.098765432,0,empty,CD-0722-4
"H1,F12",10167,10948,6918,4030,6079,3190,23,3218,2344,874,2.681922197,1909,121,35,6,6,0,4,0,0,0,empty,CD-0722-4
"H1,G1",8820,9914,6769,3145,5421,2727,0,2729,1932,797,2.424090339,1479,1669,437,156,153,3,33,2,0.117647059,0,empty,CD-0722-4
"H1,G2",1215060,1377419,867418,510001,674532,374329,4,374691,285401,89290,3.196337776,223759,43939,10768,4068,4033,35,689,4,0.081329035,0,hg38,CD-0722-4
"H1,G3",11982,13208,8752,4456,7069,3696,0,3697,2584,1113,2.32165319,2117,1230,257,101,96,5,31,2,0.03125,0,empty,CD-0722-4
"H1,G4",15402,17598,11068,6530,9396,5229,0,5229,3376,1853,1.821910416,3031,20,0,0,0,0,0,0,0,0,empty,CD-0722-4
"H1,G5",5010,5529,3672,1857,2888,1430,1,1432,956,476,2.008403361,813,1145,384,150,149,1,31,1,0.006711409,0,empty,CD-0722-4
"H1,G6",8197,8776,6043,2733,4844,2402,28,2432,1734,698,2.484240688,1324,115,9,6,6,0,4,0,0,0,empty,CD-0722-4
"H1,G7",7483,8380,5707,2673,4582,2248,3,2254,1504,750,2.005333333,1285,1916,548,213,205,8,43,2,0.097560976,0,empty,CD-0722-4
"H1,G8",5611,6219,4165,2054,3403,1709,1,1710,1188,522,2.275862069,987,1032,266,107,107,0,35,0,0.14953271,0,empty,CD-0722-4
"H1,G9",7893,8755,5830,2925,4904,2574,0,2577,1823,754,2.417771883,1485,1567,386,187,183,4,50,1,0.005464481,0,empty,CD-0722-4
"H1,G10",9663,10948,7296,3652,5794,2960,0,2966,2101,865,2.428901734,1703,1213,273,100,98,2,38,1,0.030612245,0,empty,CD-0722-4
"H1,G11",8952,9539,6706,2833,5144,2497,0,2500,1786,714,2.50140056,1351,992,178,92,91,1,24,1,0.10989011,0,empty,CD-0722-4
"H1,G12",5412,6183,3896,2287,3464,1890,0,1893,1291,602,2.144518272,1173,1549,286,102,100,2,28,2,0.01,0,empty,CD-0722-4
"H1,H1",9702,10440,7297,3143,5643,2749,0,2754,1949,805,2.421118012,1539,791,117,50,50,0,18,0,0.02,0,empty,CD-0722-4
"H1,H2",6694,7388,4989,2399,4015,2035,31,2073,1387,686,2.021865889,1179,1994,442,199,197,2,49,1,0.015228426,0,empty,CD-0722-4
"H1,H3",7758,8694,5708,2986,4702,2504,5,2511,1777,734,2.420980926,1466,1045,172,70,70,0,21,0,0.071428571,0,empty,CD-0722-4
"H1,H4",8472,9179,6343,2836,5038,2473,27,2501,1708,793,2.153846154,1416,80,13,7,7,0,2,0,0,0,empty,CD-0722-4
"H1,H5",9343,10428,6878,3550,5594,2958,0,2961,2027,934,2.170235546,1718,1036,222,52,52,0,21,0,0,0,empty,CD-0722-4
"H1,H6",8051,9068,5897,3171,5000,2687,0,2689,1861,828,2.247584541,1594,918,254,89,89,0,24,0,0.078651685,0,empty,CD-0722-4
"H1,H7",6787,7745,5021,2724,4101,2145,0,2148,1463,685,2.135766423,1261,1273,257,115,115,0,30,0,0.052173913,0,empty,CD-0722-4
"H1,H8",11588,13084,8592,4492,6948,3677,0,3682,2654,1028,2.581712062,2100,1348,193,99,98,1,37,1,0.040816327,0,empty,CD-0722-4
"H1,H9",7235,7868,5378,2490,4059,1940,0,1944,1429,515,2.774757282,1074,621,142,61,61,0,24,0,0.016393443,0,empty,CD-0722-4
"H1,H10",6559,7443,4880,2563,3850,1926,1,1929,1352,577,2.343154246,1143,1345,397,143,139,4,37,2,0.028776978,0,empty,CD-0722-4
"H1,H11",5703,6274,4130,2144,3248,1852,0,1854,997,857,1.16336056,987,20,2,1,1,0,1,0,0,0,empty,CD-0722-4
"H1,H12",7488,8563,5382,3181,4572,2464,0,2466,1739,727,2.392022008,1460,574,75,28,27,1,15,1,0,0,empty,CD-0722-4
"H2,A1",9328,10644,6896,3748,5776,3054,0,3054,2044,1010,2.023762376,1801,1351,211,97,96,1,33,1,0.21875,0,empty,CD-0722-4
"H2,A2",13925,15342,10326,5016,8014,4048,0,4050,2748,1302,2.110599078,2298,2307,487,222,217,5,53,2,0.064516129,0,empty,CD-0722-4
"H2,A3",9090,10062,6725,3337,5592,2887,1,2888,2084,804,2.592039801,1602,1851,487,188,182,6,49,2,0.043956044,0,empty,CD-0722-4
"H2,A4",13028,14234,9683,4551,7523,3771,1,3776,2521,1255,2.00876494,2076,939,311,108,107,1,25,1,0.112149533,0,empty,CD-0722-4
"H2,A5",14384,15930,10491,5439,8606,4392,0,4392,3064,1328,2.307228916,2557,2959,637,300,293,7,73,2,0.037542662,0,empty,CD-0722-4
"H2,A6",17574,20045,12956,7089,10733,5985,0,5989,3976,2013,1.975161451,3424,4650,1012,360,359,1,86,1,0.08913649,0,empty,CD-0722-4
"H2,A7",9191,10224,6804,3420,5469,2831,0,2837,1850,987,1.874366768,1621,1742,409,154,153,1,47,1,0.026143791,0,empty,CD-0722-4
"H2,A8",6976,7795,5012,2783,4350,2277,6,2289,1673,616,2.715909091,1356,2488,636,256,250,6,59,3,0.084,0,empty,CD-0722-4
"H2,A9",12172,13266,9205,4061,7300,3602,1,3605,2553,1052,2.426806084,1990,2239,487,180,180,0,47,0,0.033333333,0,empty,CD-0722-4
"H2,A10",16188,18304,12120,6184,9489,4947,4,4954,3459,1495,2.313712375,2807,457,123,56,56,0,16,0,0.392857143,0,empty,CD-0722-4
"H2,A11",8329,8917,6297,2620,4814,2306,0,2307,1591,716,2.222067039,1230,1852,296,129,128,1,39,1,0,0,empty,CD-0722-4
"H2,A12",14452,15580,10891,4689,8238,3988,1,3994,2754,1240,2.220967742,2196,4385,1182,436,433,3,101,1,0.080831409,0,empty,CD-0722-4
"H2,B1",1245398,1372755,951493,421262,665484,335205,2,335532,273314,62218,4.392844514,186857,61623,5636,2156,2084,72,505,3,0.017754319,0,hg38,CD-0722-4
"H2,B2",9079,9768,6179,3589,5259,2840,0,2844,1784,1060,1.683018868,1676,708,138,60,59,1,13,1,0.203389831,0,empty,CD-0722-4
"H2,B3",9048,10096,6768,3328,5473,2756,0,2758,1815,943,1.924708378,1574,1891,392,167,165,2,45,2,0.2,0,empty,CD-0722-4
"H2,B4",9811,11201,7083,4118,5990,3240,1,3249,2143,1106,1.93761302,1884,1572,270,125,118,7,39,2,0.050847458,0,empty,CD-0722-4
"H2,B5",10551,6212,3958,2254,4112,2144,0,2153,1461,692,2.111271676,1328,1359,229,88,87,1,33,1,0,0,empty,CD-0722-4
"H2,B6",12255,13881,8920,4961,7480,3991,0,3994,2691,1303,2.065234075,2353,2090,496,193,191,2,51,1,0.104712042,0,empty,CD-0722-4
"H2,B7",10197,11178,7817,3361,6126,3009,3,3016,2027,989,2.049544995,1671,1348,349,99,99,0,31,0,0.03030303,0,empty,CD-0722-4
"H2,B8",9361,10280,6988,3292,5488,2779,0,2780,1909,871,2.191733639,1571,1614,345,150,149,1,46,1,0.006711409,0,empty,CD-0722-4
"H2,B9",14387,15756,10363,5393,8397,4366,0,4368,2809,1559,1.801796023,2514,1342,265,128,127,1,34,1,0.141732283,0,empty,CD-0722-4
"H2,B10",8627,9191,6125,3066,5260,2670,31,2710,1867,843,2.214709371,1562,1260,123,60,58,2,17,1,0.086206897,0,empty,CD-0722-4
"H2,B11",23093,25298,17234,8064,13085,6879,1,6886,4325,2561,1.68879344,3842,448,62,28,26,2,10,1,0,0,empty,CD-0722-4
"H2,B12",1020254,1194768,754790,439978,593692,325975,4,326252,259283,66969,3.8716869,194830,169414,27175,10048,9890,158,1482,6,0.048028311,0,hg38,CD-0722-4
"H2,C1",72505,86403,48326,38077,47790,32252,4,32286,15276,17010,0.898059965,19916,1572,273,105,102,3,36,2,0.18627451,0,empty,CD-0722-4
"H2,C2",14103,15680,10190,5490,8319,4371,2,4381,2997,1384,2.165462428,2537,2694,667,254,247,7,75,2,0.052631579,0,empty,CD-0722-4
"H2,C3",13820,15388,10213,5175,8159,4160,5,4166,2712,1454,1.86519945,2362,973,127,61,60,1,22,1,0.1,0,empty,CD-0722-4
"H2,C4",10500,11541,7749,3792,6322,3114,3,3120,2166,954,2.270440252,1818,2053,541,221,221,0,54,0,0.171945701,0,empty,CD-0722-4
"H2,C5",13596,15571,10128,5443,8348,4358,0,4360,2862,1498,1.910547397,2543,2708,571,248,246,2,46,2,0.036585366,0,empty,CD-0722-4
"H2,C6",11453,12863,8358,4505,7054,3717,0,3719,2512,1207,2.081193041,2192,2433,662,266,263,3,49,2,0.121673004,0,empty,CD-0722-4
"H2,C7",14383,16472,10442,6030,8939,4867,1,4873,3002,1871,1.604489578,2931,492,79,51,51,0,24,0,0.019607843,0,empty,CD-0722-4
"H2,C8",17018,18695,12538,6157,9897,5064,1,5068,3532,1536,2.299479167,2834,3697,962,406,400,6,89,2,0.0575,0,empty,CD-0722-4
"H2,C9",12890,14181,9631,4550,7701,3849,0,3853,2676,1177,2.27357689,2133,1945,440,164,163,1,40,1,0.18404908,0,empty,CD-0722-4
"H2,C10",13312,14440,9869,4571,7646,3704,19,3726,2496,1230,2.029268293,2110,3136,1000,323,323,0,65,0,0.00619195,0,empty,CD-0722-4
"H2,C11",11484,12981,8423,4558,6907,3485,0,3490,2331,1159,2.011216566,2014,2490,820,314,313,1,67,1,0.063897764,0,empty,CD-0722-4
"H2,C12",17917,19670,13311,6359,10449,5115,1,5120,3554,1566,2.269476373,2895,2627,690,269,264,5,56,2,0.022727273,0,empty,CD-0722-4
"H2,D1",931134,1020804,708279,312525,505503,249418,0,249634,194851,54783,3.556778563,140826,28370,4673,1739,1700,39,323,2,0.021764706,0,hg38,CD-0722-4
"H2,D2",10892,11693,8188,3505,6235,2917,16,2935,1933,1002,1.929141717,1628,3282,1117,403,401,2,88,1,0.082294264,0,empty,CD-0722-4
"H2,D3",11206,12862,8315,4547,6727,3407,2,3412,2429,983,2.471007121,2027,1945,346,134,134,0,32,0,0.037313433,0,empty,CD-0722-4
"H2,D4",9117,10380,6679,3701,5651,2943,0,2947,2044,903,2.263565891,1775,1859,424,219,218,1,51,1,0.064220183,0,empty,CD-0722-4
"H2,D5",9587,10732,7186,3546,5710,2916,0,2919,1924,995,1.933668342,1639,2491,410,146,144,2,34,1,0.215277778,0,empty,CD-0722-4
"H2,D6",13217,14485,9637,4848,7537,3958,0,3968,2519,1449,1.738440304,2188,2199,436,193,191,2,52,1,0.010471204,0,empty,CD-0722-4
"H2,D7",898883,1009325,674919,334406,497219,254127,3,254346,200136,54210,3.69186497,146075,323062,43994,16783,16412,371,2105,14,0.086400195,0,hg38,CD-0722-4
"H2,D8",1087843,1263506,805519,457987,622652,341753,14,342077,264535,77542,3.411506023,203065,77995,15791,5896,5832,64,955,4,0.040809328,0,hg38,CD-0722-4
"H2,D9",5460,5920,4026,1894,3168,1555,0,1555,1047,508,2.061023622,893,2046,417,141,140,1,40,1,0.007142857,0,empty,CD-0722-4
"H2,D10",11270,12549,8246,4303,6806,3459,0,3461,2323,1138,2.041300527,2065,3906,839,305,299,6,68,2,0.143812709,0,empty,CD-0722-4
"H2,D11",10479,11795,7737,4058,6231,3134,0,3137,2092,1045,2.001913876,1831,3897,955,338,336,2,80,2,0.080357143,0,empty,CD-0722-4
"H2,D12",14723,16679,11093,5586,8844,4442,0,4447,3058,1389,2.201583873,2565,4656,871,349,346,3,103,3,0.115606936,0,empty,CD-0722-4
"H2,E1",4074391,4726235,3020734,1705501,2195186,1328359,7,1329472,1013914,315558,3.213082856,774526,256980,33636,12760,12430,330,2038,8,0.043845535,0,hg38,CD-0722-4
"H2,E2",12043,13503,8859,4644,7143,3675,0,3675,2453,1222,2.007364975,2108,2979,687,251,247,4,53,3,0.076923077,0,empty,CD-0722-4
"H2,E3",7798,8603,6089,2514,4648,2220,18,2244,1496,748,2,1197,2932,967,412,411,1,77,1,0.143552311,0,empty,CD-0722-4
"H2,E4",13234,14322,9587,4735,7844,3985,10,4001,2760,1241,2.224012893,2270,3826,895,395,392,3,89,2,0.094387755,0,empty,CD-0722-4
"H2,E5",1457963,1683226,1098219,585007,816617,424438,3,424833,344073,80760,4.260438336,248582,4631,1649,474,474,0,149,0,0.023206751,0,hg38,CD-0722-4
"H2,E6",802368,928540,569493,359047,459639,274248,0,274477,220374,54103,4.07323069,161692,62792,29039,10883,10844,39,1609,4,0.015215788,0,hg38,CD-0722-4
"H2,E7",643794,763640,447317,316323,381705,246333,3,246520,161431,85089,1.897201753,145839,7053,1648,500,490,10,140,2,0.126530612,0,hg38,CD-0722-4
"H2,E8",14177,15426,10852,4574,8265,3881,6,3887,2723,1164,2.339347079,2110,3376,863,328,327,1,76,1,0.06116208,0,empty,CD-0722-4
"H2,E9",8919,9918,6742,3176,5291,2625,0,2627,1795,832,2.157451923,1486,4501,1118,365,361,4,85,2,0.016620499,0,empty,CD-0722-4
"H2,E10",9251,9952,6892,3060,5378,2624,41,2666,1821,845,2.155029586,1491,2362,529,212,210,2,53,1,0.142857143,0,empty,CD-0722-4
"H2,E11",11877,13436,8763,4673,7164,3758,0,3758,2485,1273,1.952081697,2211,2714,774,272,267,5,74,2,0.08988764,0,empty,CD-0722-4
"H2,E12",13652,15198,10222,4976,8261,4207,10,4217,2872,1345,2.135315985,2421,2990,605,214,209,5,64,2,0.033492823,0,empty,CD-0722-4
"H2,F1",14395,15549,10622,4927,8321,4116,0,4120,2723,1397,1.949176807,2275,3428,607,269,266,3,78,1,0.007518797,0,empty,CD-0722-4
"H2,F2",11087,12406,8191,4215,6681,3367,1,3373,2226,1147,1.940714908,1968,3617,825,314,308,6,78,2,0.035714286,0,empty,CD-0722-4
"H2,F3",11900,13130,8700,4430,7038,3534,0,3545,2464,1081,2.279370953,2048,4027,1061,419,415,4,89,2,0.045783133,0,empty,CD-0722-4
"H2,F4",1356785,1533778,1008392,525386,754634,407770,5,408181,326264,81917,3.9828607,234278,30528,5644,2190,2160,30,407,4,0.024074074,0,hg38,CD-0722-4
"H2,F5",12805,14063,9443,4620,7417,3630,0,3633,2427,1206,2.012437811,2095,2483,531,204,201,3,68,1,0.069651741,0,empty,CD-0722-4
"H2,F6",18653,21364,13658,7706,11480,6175,9,6188,4351,1837,2.368535656,3702,3962,905,393,389,4,108,2,0.11311054,0,empty,CD-0722-4
"H2,F7",14460,15881,10826,5055,8730,4367,1,4374,2972,1402,2.119828816,2492,1831,439,160,159,1,41,1,0.163522013,0,empty,CD-0722-4
"H2,F8",2658734,3072941,1993697,1079244,1464852,814045,4,814763,641778,172985,3.7100211,475211,39492,5070,2076,2038,38,405,3,0.034838077,0,hg38,CD-0722-4
"H2,F9",13138,14621,9911,4710,7710,3827,1,3829,2656,1173,2.264279625,2141,3745,1112,371,367,4,87,1,0.095367847,0,empty,CD-0722-4
"H2,F10",15575,17054,11846,5208,9121,4375,0,4378,2976,1402,2.122681883,2439,2937,741,264,259,5,55,2,0.1003861,0,empty,CD-0722-4
"H2,F11",12088,13360,9128,4232,6857,3300,0,3300,2238,1062,2.107344633,1834,2168,472,192,191,1,48,1,0.052356021,0,empty,CD-0722-4
"H2,F12",12691,14154,9441,4713,7436,3768,0,3774,2494,1280,1.9484375,2150,305,16,15,14,1,8,1,0,0,empty,CD-0722-4
"H2,G1",15695,17484,11821,5663,9282,4577,1,4586,3064,1522,2.013140604,2644,5612,1284,463,457,6,110,2,0.035010941,0,empty,CD-0722-4
"H2,G2",7745,8196,5429,2767,4361,2258,0,2259,1490,769,1.937581274,1266,532,128,35,35,0,12,0,0.085714286,0,empty,CD-0722-4
"H2,G3",15120,16123,11151,4972,8656,4356,0,4361,2683,1678,1.598927294,2413,3117,814,330,329,1,76,1,0.027355623,0,empty,CD-0722-4
"H2,G4",24793,27724,17590,10134,14524,8125,0,8137,5150,2987,1.724137931,4714,92,14,11,11,0,6,0,0,0,empty,CD-0722-4
"H2,G5",8007,8890,5905,2985,4749,2426,0,2426,1519,907,1.674751929,1431,2017,387,154,153,1,41,1,0.104575163,0,empty,CD-0722-4
"H2,G6",12795,14095,9634,4461,7460,3714,7,3721,2576,1145,2.249781659,2067,298,85,44,44,0,12,0,0,0,empty,CD-0722-4
"H2,G7",11447,12609,8682,3927,6796,3245,0,3253,2165,1088,1.989889706,1853,3254,742,322,320,2,95,2,0.01875,0,empty,CD-0722-4
"H2,G8",8163,9126,5983,3143,5056,2538,15,2554,1727,827,2.088270859,1563,1938,479,180,177,3,52,2,0.005649718,0,empty,CD-0722-4
"H2,G9",2075751,2413293,1540644,872649,1166220,652371,6,652992,520382,132610,3.924153533,385673,348326,63852,24685,24271,414,2984,9,0.035144823,0,hg38,CD-0722-4
"H2,G10",13609,14708,10138,4570,7942,4067,4,4071,2859,1212,2.358910891,2268,3305,817,315,309,6,87,2,0.051779935,0,empty,CD-0722-4
"H2,G11",12841,14074,9536,4538,7642,3765,1,3766,2640,1126,2.344582593,2141,1841,474,147,145,2,48,1,0.013793103,0,empty,CD-0722-4
"H2,G12",8342,9499,6022,3477,5076,2662,1,2668,1748,920,1.9,1578,3019,687,264,263,1,54,1,0.076045627,0,empty,CD-0722-4
"H2,H1",704483,723250,558980,164270,359121,142190,0,142366,109393,32973,3.317653838,73440,34945,6525,2434,2406,28,434,2,0.016625104,0,hg38,CD-0722-4
"H2,H2",10981,12024,7944,4080,6467,3349,3,3354,2215,1139,1.944688323,1970,2740,766,267,264,3,65,2,0.121212121,0,empty,CD-0722-4
"H2,H3",10719,12400,7890,4510,6685,3477,3,3482,2351,1131,2.078691424,2104,1843,327,127,123,4,35,1,0.032520325,0,empty,CD-0722-4
"H2,H4",13547,14870,10009,4861,7896,3977,3,3988,2674,1314,2.03500761,2314,195,21,12,12,0,6,0,0,0,empty,CD-0722-4
"H2,H5",1126493,1408679,750359,658320,699356,485030,2,485377,352524,132853,2.653489195,303019,8928,1374,538,522,16,98,2,0.233716475,0,hg38,CD-0722-4
"H2,H6",993090,1179933,712385,467548,588088,349842,2,350107,241034,109073,2.209841116,213311,67055,13506,4871,4819,52,895,4,0.020543681,0,hg38,CD-0722-4
"H2,H7",10490,11375,7700,3675,6116,3100,1,3103,2105,998,2.109218437,1747,2492,607,253,251,2,56,2,0.043824701,0,empty,CD-0722-4
"H2,H8",15268,17376,11147,6229,9259,4898,0,4902,3434,1468,2.339237057,2929,2452,526,219,218,1,68,1,0.128440367,0,empty,CD-0722-4
"H2,H9",10575,11638,7910,3728,6012,2858,5,2865,1942,923,2.104008667,1645,2007,238,120,117,3,41,2,0.025641026,0,empty,CD-0722-4
"H2,H10",8176,9287,6022,3265,4789,2498,1,2500,1645,855,1.923976608,1437,1459,375,102,100,2,29,1,0.01,0,empty,CD-0722-4
"H2,H11",9853,11188,6828,4360,5778,3488,3,3491,1855,1636,1.133863081,2109,14,2,2,2,0,2,0,0,0,empty,CD-0722-4
"H2,H12",10546,11970,7675,4295,6275,3334,0,3334,2308,1026,2.249512671,2007,1900,519,210,210,0,45,0,0.057142857,0,empty,CD-0722-4
"H3,A1",7733,8407,5675,2732,4536,2312,0,2314,1540,774,1.989664083,1265,2640,534,191,188,3,43,2,0,0,empty,CD-0722-4
"H3,A2",12086,13455,8918,4537,6831,3459,19,3479,2241,1238,1.810177706,1991,2801,584,213,211,2,62,2,0.071090047,0,empty,CD-0722-4
"H3,A3",1078467,1228867,806420,422447,603029,319176,4,319499,247796,71703,3.455866561,185921,145601,20193,8095,7911,184,1266,7,0.065984073,0,hg38,CD-0722-4
"H3,A4",11748,12994,8705,4289,6888,3415,6,3424,2224,1200,1.853333333,1924,1011,190,101,96,5,30,2,0.0625,0,empty,CD-0722-4
"H3,A5",1124240,1399500,728367,671133,709072,492307,2,492668,334837,157831,2.121490708,315378,5468,2027,437,436,1,122,1,0.004587156,0,hg38,CD-0722-4
"H3,A6",9343,10425,6907,3518,5475,2839,18,2857,1966,891,2.20650954,1630,3618,891,362,360,2,92,1,0.063888889,0,empty,CD-0722-4
"H3,A7",1343882,1513436,1027691,485745,736650,380671,0,381027,311812,69215,4.504977245,216702,116128,17388,6725,6609,116,1116,5,0.026781661,0,hg38,CD-0722-4
"H3,A8",4930,5429,3708,1721,2926,1479,0,1479,1055,424,2.488207547,811,2445,494,206,199,7,62,1,0.055276382,0,empty,CD-0722-4
"H3,A9",8382,9504,6353,3151,5129,2627,0,2631,1836,795,2.309433962,1507,2486,701,303,301,2,72,2,0.126245847,0,empty,CD-0722-4
"H3,A10",8670,9370,6574,2796,4957,2453,0,2453,1603,850,1.885882353,1302,573,81,33,33,0,15,0,0.060606061,0,empty,CD-0722-4
"H3,A11",679693,754679,520322,234357,372976,183078,1,183269,139122,44147,3.151335312,102897,169942,17242,6599,6368,231,1042,6,0.052292714,0,hg38,CD-0722-4
"H3,A12",870093,981285,648324,332961,478790,252938,2,253208,200944,52264,3.844787999,145665,315924,45381,18022,17693,329,2212,8,0.060758492,0,hg38,CD-0722-4
"H3,B1",7543,7951,5593,2358,4317,2128,0,2128,1349,779,1.731707317,1189,1314,239,110,108,2,34,1,0.055555556,0,empty,CD-0722-4
"H3,B2",9564,10464,6537,3927,5635,3056,7,3063,1956,1107,1.766937669,1853,777,88,33,31,2,12,2,0,0,empty,CD-0722-4
"H3,B3",1114848,1359307,793461,565846,672173,401633,0,401935,326948,74987,4.360062411,249313,211935,37111,14950,14706,244,2017,6,0.05875153,0,hg38,CD-0722-4
"H3,B4",7123,7950,5150,2800,4244,2209,0,2213,1473,740,1.990540541,1286,1523,426,180,175,5,42,2,0.154285714,0,empty,CD-0722-4
"H3,B5",8516,4919,3058,1861,3297,1730,0,1743,1145,598,1.914715719,1092,1317,281,130,130,0,30,0,0.169230769,0,empty,CD-0722-4
"H3,B6",9483,10592,6853,3739,5693,3063,0,3067,1984,1083,1.831948292,1814,2470,652,292,287,5,67,2,0.052264808,0,empty,CD-0722-4
"H3,B7",8529,9272,6386,2886,5056,2463,0,2464,1637,827,1.979443773,1371,1579,452,184,184,0,45,0,0.065217391,0,empty,CD-0722-4
"H3,B8",6833,7527,5127,2400,4071,2055,0,2057,1373,684,2.007309942,1157,1143,280,124,124,0,38,0,0.169354839,0,empty,CD-0722-4
"H3,B9",38627,42060,29625,12435,20459,9447,0,9475,6858,2617,2.620557891,5196,3435,378,155,150,5,45,2,0.146666667,0,empty,CD-0722-4
"H3,B10",6167,6533,4301,2232,3700,1916,1,1923,1285,638,2.014106583,1094,425,73,34,34,0,13,0,0,0,empty,CD-0722-4
"H3,B11",16565,19244,12003,7241,9987,5484,7,5495,3543,1952,1.815061475,3347,289,44,21,20,1,11,1,0.05,0,empty,CD-0722-4
"H3,B12",7642,8648,5649,2999,4642,2366,0,2371,1608,763,2.107470511,1406,1986,593,208,206,2,53,2,0.019417476,0,empty,CD-0722-4
"H3,C1",15555,16641,11583,5058,9089,4468,0,4470,2909,1561,1.863549007,2420,1660,479,187,184,3,44,2,0.092391304,0,empty,CD-0722-4
"H3,C2",11475,12463,8295,4168,6530,3340,0,3347,2150,1197,1.796157059,1875,2250,541,252,249,3,73,1,0.128514056,0,empty,CD-0722-4
"H3,C3",12043,13298,8886,4412,7067,3506,14,3527,2278,1249,1.823859087,2035,1259,318,143,143,0,28,0,0.251748252,0,empty,CD-0722-4
"H3,C4",7508,8066,5525,2541,4439,2195,0,2200,1512,688,2.197674419,1222,2444,551,200,197,3,50,2,0.233502538,0,empty,CD-0722-4
"H3,C5",1256931,1486053,914240,571813,730057,416668,2,417024,330881,86143,3.841066599,250951,127433,24750,10119,10001,118,1455,6,0.067293271,0,hg38,CD-0722-4
"H3,C6",9081,10068,6558,3510,5320,2746,0,2746,1771,975,1.816410256,1584,2121,522,216,209,7,46,2,0.09569378,0,empty,CD-0722-4
"H3,C7",11893,13934,8545,5389,7332,4077,42,4127,2539,1588,1.598866499,2535,538,100,38,38,0,16,0,0.105263158,0,empty,CD-0722-4
"H3,C8",12836,13975,9650,4325,7432,3718,1,3727,2449,1278,1.91627543,2066,3526,756,288,288,0,91,0,0.059027778,0,empty,CD-0722-4
"H3,C9",9746,10804,7267,3537,5799,2965,1,2968,2002,966,2.072463768,1743,2109,265,115,114,1,37,1,0.166666667,0,empty,CD-0722-4
"H3,C10",10888,11830,8285,3545,6253,2978,0,2982,1962,1020,1.923529412,1641,2358,709,254,253,1,59,1,0.043478261,0,empty,CD-0722-4
"H3,C11",14182,15679,10646,5033,8140,4072,0,4081,2707,1374,1.970160116,2315,4728,1190,485,480,5,89,2,0.116666667,0,empty,CD-0722-4
"H3,C12",13682,14998,10036,4962,8064,4048,0,4050,2857,1193,2.394803018,2309,2117,513,197,197,0,54,0,0.07106599,0,empty,CD-0722-4
"H3,D1",10993,12374,8001,4373,6447,3386,1,3387,2140,1247,1.716118685,1972,1081,236,81,78,3,17,1,0.076923077,0,empty,CD-0722-4
"H3,D2",8926,9734,6705,3029,5202,2383,19,2408,1553,855,1.816374269,1349,3577,764,270,265,5,82,2,0.075471698,0,empty,CD-0722-4
"H3,D3",8575,9275,6232,3043,4906,2442,0,2443,1654,789,2.096324461,1375,1462,336,136,136,0,33,0,0.235294118,0,empty,CD-0722-4
"H3,D4",7259,7868,5411,2457,4208,2080,30,2112,1373,739,1.857916103,1193,1439,252,128,124,4,44,1,0.040322581,0,empty,CD-0722-4
"H3,D5",7189,7810,5383,2427,4158,2068,0,2068,1389,679,2.045655376,1145,1787,429,176,174,2,52,2,0.040229885,0,empty,CD-0722-4
"H3,D6",11051,12275,7812,4463,6484,3509,0,3512,2173,1339,1.622852875,2066,2247,634,218,214,4,60,2,0.126168224,0,empty,CD-0722-4
"H3,D7",6396,6821,4784,2037,3609,1755,1,1759,1175,584,2.011986301,945,2160,410,191,189,2,55,2,0.042328042,0,empty,CD-0722-4
"H3,D8",8185,8897,6054,2843,4863,2411,1,2414,1631,783,2.083014049,1377,1845,421,196,190,6,53,1,0.015789474,0,empty,CD-0722-4
"H3,D9",6419,6714,4802,1912,3607,1717,2,1723,1192,531,2.244821092,930,1899,423,148,144,4,36,3,0.194444444,0,empty,CD-0722-4
"H3,D10",8810,10049,6335,3714,5332,2850,0,2853,1838,1015,1.810837438,1664,1008,186,91,90,1,26,1,0.266666667,0,empty,CD-0722-4
"H3,D11",1599720,1878327,1138287,740040,918928,561321,2,561767,427715,134052,3.190664817,332405,216208,37061,14417,14145,272,1992,7,0.035489572,0,hg38,CD-0722-4
"H3,D12",11782,12828,8621,4207,6919,3522,0,3529,2389,1140,2.095614035,2034,3776,861,348,347,1,103,1,0.083573487,0,empty,CD-0722-4
"H3,E1",16169,17760,11687,6073,9523,4867,3,4874,3245,1629,1.992019644,2740,3242,807,317,315,2,85,1,0.038095238,0,empty,CD-0722-4
"H3,E2",9509,10362,6920,3442,5533,2797,1,2799,1819,980,1.856122449,1597,2181,401,158,158,0,47,0,0.056962025,0,empty,CD-0722-4
"H3,E3",6417,7163,4767,2396,3861,1923,0,1925,1229,696,1.765804598,1123,3247,1104,397,394,3,82,2,0.068527919,0,empty,CD-0722-4
"H3,E4",10322,11510,7617,3893,6347,3297,3,3309,2182,1127,1.936113576,1918,3052,741,292,290,2,89,1,0.096551724,0,empty,CD-0722-4
"H3,E5",7850,8423,5911,2512,4457,2062,0,2063,1404,659,2.130500759,1146,1459,456,216,216,0,44,0,0.009259259,0,empty,CD-0722-4
"H3,E6",14973,16296,10823,5473,8776,4499,18,4519,3085,1434,2.151324965,2588,4091,847,361,348,13,102,3,0.120689655,0,empty,CD-0722-4
"H3,E7",14037,15671,10450,5221,8234,4201,1,4202,2878,1324,2.173716012,2328,3416,613,275,272,3,93,1,0.029411765,0,empty,CD-0722-4
"H3,E8",11929,12556,9103,3453,6935,3276,2,3285,2205,1080,2.041666667,1688,4029,950,414,409,5,108,2,0.024449878,0,empty,CD-0722-4
"H3,E9",6569,7402,4833,2569,3899,1996,0,2005,1364,641,2.127925117,1149,2885,680,311,306,5,77,3,0.120915033,0,empty,CD-0722-4
"H3,E10",7794,8523,5731,2792,4430,2117,0,2121,1410,711,1.983122363,1191,2221,564,208,206,2,61,2,0,0,empty,CD-0722-4
"H3,E11",8905,9438,6667,2771,5063,2548,1,2549,1653,896,1.844866071,1359,2324,720,269,268,1,69,1,0.029850746,0,empty,CD-0722-4
"H3,E12",10351,11300,7580,3720,6184,3094,0,3094,2174,920,2.363043478,1779,1963,320,135,131,4,46,1,0.015267176,0,empty,CD-0722-4
"H3,F1",11461,12413,8430,3983,6592,3274,0,3282,2185,1097,1.991795807,1860,2522,543,271,269,2,68,2,0.059479554,0,empty,CD-0722-4
"H3,F2",8930,9513,6508,3005,5136,2565,29,2597,1671,926,1.804535637,1448,3324,958,348,344,4,87,1,0.066860465,0,empty,CD-0722-4
"H3,F3",19164,21338,14526,6812,10785,5144,25,5176,3651,1525,2.394098361,2952,5673,1038,394,390,4,111,2,0.071794872,0,empty,CD-0722-4
"H3,F4",2859346,3181295,2145989,1035306,1513232,813887,16,814644,606223,208421,2.908646442,462779,36690,4023,1513,1478,35,332,4,0.100811908,0,hg38,CD-0722-4
"H3,F5",1084516,1190302,816504,373798,577833,291425,0,291743,234850,56893,4.127924349,163536,184077,27573,11044,10804,240,1677,7,0.055164754,0,hg38,CD-0722-4
"H3,F6",12994,14706,9449,5257,7908,4179,0,4179,2962,1217,2.433853739,2431,4002,931,370,369,1,120,1,0.070460705,0,empty,CD-0722-4
"H3,F7",1276735,1437022,973193,463829,712509,359872,4,360220,275124,85096,3.233101438,206115,85890,12145,4737,4619,118,771,5,0.078155445,0,hg38,CD-0722-4
"H3,F8",9052,9847,6596,3251,5456,2725,0,2729,1815,914,1.985776805,1575,323,92,51,50,1,14,1,0.1,0,empty,CD-0722-4
"H3,F9",10029,10982,7604,3378,5858,2870,0,2870,2044,826,2.474576271,1632,3507,906,350,344,6,89,3,0.049418605,0,empty,CD-0722-4
"H3,F10",1268532,1411833,961192,450641,684515,348102,2,348449,273402,75047,3.643077005,196301,105196,18454,7106,6988,118,1191,4,0.047939325,0,hg38,CD-0722-4
"H3,F11",8661,9462,6440,3022,4967,2378,0,2378,1604,774,2.072351421,1354,1971,454,196,194,2,49,2,0.118556701,0,empty,CD-0722-4
"H3,F12",10449,11426,7647,3779,6071,3042,0,3043,2115,928,2.279094828,1723,264,17,10,8,2,6,1,0,0,empty,CD-0722-4
"H3,G1",643783,746157,466519,279638,378281,217214,0,217390,170888,46502,3.674852695,129479,5879,1571,470,467,3,142,3,0.066381156,0,hg38,CD-0722-4
"H3,G2",6176,6685,4419,2266,3491,1802,1,1805,1107,698,1.585959885,1040,668,159,67,67,0,24,0,0.029850746,0,empty,CD-0722-4
"H3,G3",15112,16596,11034,5562,8631,4456,0,4464,2846,1618,1.758961681,2488,3201,747,275,271,4,79,2,0.092250923,0,empty,CD-0722-4
"H3,G4",21027,23264,15107,8157,12170,6803,0,6816,4281,2535,1.688757396,3887,166,8,5,5,0,5,0,0,0,empty,CD-0722-4
"H3,G5",7149,7987,5160,2827,4141,2093,13,2106,1392,714,1.949579832,1237,2170,594,195,194,1,52,1,0.030927835,0,empty,CD-0722-4
"H3,G6",11017,12191,8316,3875,6303,3083,0,3088,2027,1061,1.910461828,1693,326,110,32,32,0,12,0,0,0,empty,CD-0722-4
"H3,G7",9092,9901,6941,2960,5356,2476,0,2482,1700,782,2.173913043,1389,2826,625,233,223,10,66,3,0.058295964,0,empty,CD-0722-4
"H3,G8",6698,7364,4931,2433,3929,1892,1,1893,1202,691,1.739507959,1121,2249,402,199,194,5,61,2,0.082474227,0,empty,CD-0722-4
"H3,G9",8522,9460,6306,3154,5025,2501,12,2518,1695,823,2.059538275,1385,2554,607,222,219,3,81,2,0.03652968,0,empty,CD-0722-4
"H3,G10",10159,11149,7714,3435,6093,3033,3,3038,2047,991,2.065590313,1695,3263,814,339,334,5,82,1,0.071856287,0,empty,CD-0722-4
"H3,G11",9865,10553,7456,3097,5641,2715,0,2718,1890,828,2.282608696,1490,1267,244,121,120,1,50,1,0.025,0,empty,CD-0722-4
"H3,G12",7329,8248,5329,2919,4416,2300,0,2302,1519,783,1.939974457,1325,2555,578,250,250,0,56,0,0.008,0,empty,CD-0722-4
"H3,H1",9069,9942,6760,3182,5324,2628,0,2633,1767,866,2.040415704,1473,1301,216,93,91,2,35,1,0.021978022,0,empty,CD-0722-4
"H3,H2",10498,11619,7660,3959,6080,3135,2,3141,2052,1089,1.884297521,1789,2631,579,238,233,5,74,2,0.111587983,0,empty,CD-0722-4
"H3,H3",7974,8973,5900,3073,4716,2488,0,2488,1739,749,2.32176235,1430,1858,527,201,198,3,55,2,0.106060606,0,empty,CD-0722-4
"H3,H4",1138476,1300399,851936,448463,632023,333261,3,333578,257192,76386,3.367004425,195500,7878,1375,564,552,12,103,2,0.05615942,0,hg38,CD-0722-4
"H3,H5",11863,13102,8785,4317,7028,3672,0,3679,2407,1272,1.892295597,2061,2357,424,166,165,1,51,1,0.024242424,0,empty,CD-0722-4
"H3,H6",7974,8865,5695,3170,4693,2442,1,2443,1600,843,1.897983393,1427,1983,522,239,239,0,69,0,0.125523013,0,empty,CD-0722-4
"H3,H7",8333,8974,5939,3035,4871,2398,7,2405,1590,815,1.950920245,1363,2009,528,208,208,0,50,0,0.048076923,0,empty,CD-0722-4
"H3,H8",11857,13177,8795,4382,7096,3707,0,3715,2519,1196,2.106187291,2097,3988,804,375,374,1,92,1,0.090909091,0,empty,CD-0722-4
"H3,H9",9308,10181,6887,3294,5420,2636,0,2642,1794,848,2.115566038,1487,1243,350,111,109,2,31,1,0.119266055,0,empty,CD-0722-4
"H3,H10",6036,6724,4442,2282,3609,1851,2,1853,1231,622,1.979099678,1053,1227,383,152,151,1,35,1,0.152317881,0,empty,CD-0722-4
"H3,H11",7317,8177,5193,2984,4336,2539,0,2540,1405,1135,1.237885463,1474,12,3,3,3,0,2,0,0,0,empty,CD-0722-4
"H3,H12",7683,8437,5641,2796,4570,2394,0,2395,1640,755,2.17218543,1380,2650,524,232,230,2,46,1,0.165217391,0,empty,CD-0722-4
"H4,A1",12647,14720,9246,5474,7824,4211,1,4222,2920,1302,2.242703533,2482,1016,322,87,85,2,29,2,0.023529412,0,empty,CD-0722-4
"H4,A2",22341,24926,16587,8339,12806,6470,1,6479,4495,1984,2.265625,3655,1351,342,160,160,0,43,0,0.10625,0,empty,CD-0722-4
"H4,A3",27121,30213,20054,10159,15232,7543,1,7546,5827,1719,3.389761489,4356,2501,1035,400,397,3,94,1,0.037783375,0,empty,CD-0722-4
"H4,A4",15268,16700,11291,5409,8926,4451,0,4454,3029,1425,2.125614035,2478,584,193,82,82,0,23,0,0.170731707,0,empty,CD-0722-4
"H4,A5",21463,24235,16031,8204,12814,6627,1,6637,4730,1907,2.480335606,3761,1768,325,125,120,5,37,1,0.116666667,0,empty,CD-0722-4
"H4,A6",993942,1166305,752309,413996,570690,304229,1,304517,233501,71016,3.28800552,178689,103504,17586,6812,6710,102,1130,4,0.052011923,0,hg38,CD-0722-4
"H4,A7",11666,12906,8611,4295,6892,3674,7,3686,2430,1256,1.934713376,2093,1185,370,132,132,0,25,0,0.060606061,0,empty,CD-0722-4
"H4,A8",9441,10681,7163,3518,5731,2885,4,2889,2166,723,2.995850622,1628,1762,437,215,215,0,49,0,0.106976744,0,empty,CD-0722-4
"H4,A9",19037,21416,14339,7077,11271,5738,20,5762,4197,1565,2.681789137,3335,1541,348,120,119,1,34,1,0.134453782,0,empty,CD-0722-4
"H4,A10",19238,21443,14522,6921,11160,5667,0,5681,3939,1742,2.26119403,3229,324,55,33,33,0,8,0,0.363636364,0,empty,CD-0722-4
"H4,A11",25421,29196,18886,10310,14784,8087,0,8099,5530,2569,2.152588556,4627,1031,189,101,99,2,24,1,0.303030303,0,empty,CD-0722-4
"H4,A12",25209,27575,18886,8689,14384,7056,1,7065,5102,1963,2.599083036,3897,2752,518,213,211,2,59,1,0.090047393,0,empty,CD-0722-4
"H4,B1",12960,14098,9631,4467,7405,3768,4,3777,2588,1189,2.176619008,2084,895,175,67,67,0,26,0,0.029850746,0,empty,CD-0722-4
"H4,B2",11707,12659,8156,4503,6661,3697,3,3705,2475,1230,2.012195122,2065,437,82,35,34,1,11,1,0,0,empty,CD-0722-4
"H4,B3",16795,19342,12381,6961,10050,5197,5,5204,3709,1495,2.480936455,3101,1016,223,89,88,1,26,1,0.147727273,0,empty,CD-0722-4
"H4,B4",15283,17888,11188,6700,9351,5094,0,5103,3360,1743,1.927710843,3065,1142,406,149,149,0,44,0,0.013422819,0,empty,CD-0722-4
"H4,B5",18055,12634,8002,4632,7712,4018,0,4042,2903,1139,2.548726953,2493,871,238,98,98,0,25,0,0.020408163,0,empty,CD-0722-4
"H4,B6",19043,21757,14049,7708,11438,6151,0,6160,4199,1961,2.141254462,3623,1545,447,181,180,1,42,1,0.022222222,0,empty,CD-0722-4
"H4,B7",13785,15585,10461,5124,8245,4081,0,4089,2824,1265,2.232411067,2362,1324,269,108,108,0,37,0,0.055555556,0,empty,CD-0722-4
"H4,B8",15865,18140,11970,6170,9373,4883,0,4891,3498,1393,2.511127064,2789,893,191,87,86,1,26,1,0.046511628,0,empty,CD-0722-4
"H4,B9",22268,24917,16549,8368,13010,6740,0,6749,4504,2245,2.00623608,3932,688,140,81,80,1,29,1,0.025,0,empty,CD-0722-4
"H4,B10",1055312,1148974,757237,391737,590904,304233,12,304849,233223,71626,3.256122079,178583,31997,3987,1636,1589,47,294,4,0.04090623,0,hg38,CD-0722-4
"H4,B11",21658,24398,15724,8674,12751,7043,3,7050,4292,2758,1.556200145,4098,162,15,6,6,0,4,0,0,0,empty,CD-0722-4
"H4,B12",16482,18487,12296,6191,9887,5172,1,5177,3763,1414,2.661244696,3017,1741,338,133,133,0,41,0,0.060150376,0,empty,CD-0722-4
"H4,C1",24485,26866,18655,8211,14325,7114,1,7118,4868,2250,2.163555556,3869,1342,462,164,161,3,29,2,0.031055901,0,empty,CD-0722-4
"H4,C2",1127984,1355264,795109,560155,665518,410939,18,411303,323813,87490,3.701142988,250671,14594,6293,2279,2275,4,535,2,0.032527473,0,hg38,CD-0722-4
"H4,C3",18971,21663,14035,7628,11367,5877,21,5901,4060,1841,2.205323194,3410,659,147,65,65,0,24,0,0,0,empty,CD-0722-4
"H4,C4",15715,17559,11835,5724,9101,4493,0,4497,3142,1355,2.318819188,2529,1781,400,165,165,0,45,0,0.072727273,0,empty,CD-0722-4
"H4,C5",21132,23773,15817,7956,12642,6653,0,6655,4673,1982,2.357719475,3830,1261,371,118,117,1,24,1,0.153846154,0,empty,CD-0722-4
"H4,C6",16602,19116,12180,6936,10132,5529,7,5551,3744,1807,2.071942446,3291,1038,289,125,123,2,33,1,0.06504065,0,empty,CD-0722-4
"H4,C7",20003,23241,14605,8636,12156,6731,25,6764,4245,2519,1.685192537,3963,572,165,31,31,0,8,0,0,0,empty,CD-0722-4
"H4,C8",1387626,1674354,980201,694153,816090,519429,0,519846,356289,163557,2.17837818,313479,9814,1722,533,513,20,76,3,0.401559454,0,hg38,CD-0722-4
"H4,C9",22195,25441,16644,8797,12988,6649,11,6665,4761,1904,2.50052521,3859,1691,297,136,134,2,27,2,0.089552239,0,empty,CD-0722-4
"H4,C10",16381,17713,12449,5264,9453,4590,0,4595,3135,1460,2.147260274,2520,1977,500,242,239,3,46,2,0.025104603,0,empty,CD-0722-4
"H4,C11",15592,17733,11491,6242,9507,4886,19,4909,3387,1522,2.225361367,2884,1561,413,160,159,1,43,1,0.031446541,0,empty,CD-0722-4
"H4,C12",26940,29886,19977,9909,15421,7681,0,7688,5448,2240,2.432142857,4398,2036,589,209,208,1,63,1,0.014423077,0,empty,CD-0722-4
"H4,D1",17221,19204,12279,6925,10176,5559,0,5566,3511,2055,1.708515815,3248,561,114,62,62,0,17,0,0.225806452,0,empty,CD-0722-4
"H4,D2",11103,12393,8524,3869,6439,3096,1,3101,2046,1055,1.939336493,1755,2108,622,250,240,10,74,1,0.029166667,0,empty,CD-0722-4
"H4,D3",15950,17717,11842,5875,9280,4649,21,4671,3219,1452,2.216942149,2684,1501,206,88,88,0,26,0,0,0,empty,CD-0722-4
"H4,D4",13953,15718,10489,5229,8223,4260,0,4265,3010,1255,2.398406375,2439,975,263,109,108,1,24,1,0.009259259,0,empty,CD-0722-4
"H4,D5",12018,13664,8968,4696,7197,3719,1,3722,2492,1230,2.02601626,2146,1450,225,91,91,0,33,0,0.065934066,0,empty,CD-0722-4
"H4,D6",1042176,1184953,774237,410716,579417,305497,0,305796,244533,61263,3.991528329,178551,146200,21668,8627,8475,152,1353,6,0.060648968,0,hg38,CD-0722-4
"H4,D7",10636,11875,7959,3916,6115,3089,0,3093,2171,922,2.354663774,1768,1677,474,210,209,1,49,1,0,0,empty,CD-0722-4
"H4,D8",16132,18088,12117,5971,9346,4645,0,4654,3185,1469,2.168141593,2616,1547,379,132,132,0,35,0,0.060606061,0,empty,CD-0722-4
"H4,D9",8234,9221,6085,3136,4801,2411,27,2439,1722,717,2.40167364,1386,3187,521,191,185,6,37,2,0.081081081,0,empty,CD-0722-4
"H4,D10",728620,907649,494077,413572,462102,310898,0,311125,203476,107649,1.890180122,197297,1243,281,81,79,2,27,2,0.025316456,0,empty,CD-0722-4
"H4,D11",13768,15324,10450,4874,8001,3941,1,3945,2689,1256,2.140923567,2226,2258,491,199,193,6,44,3,0.124352332,0,empty,CD-0722-4
"H4,D12",18864,21479,14057,7422,11494,5869,2,5879,4092,1787,2.289871293,3452,2992,711,336,336,0,88,0,0.0625,0,empty,CD-0722-4
"H4,E1",30126,33563,22774,10789,17463,8663,0,8671,5922,2749,2.154237905,4890,2463,484,183,180,3,44,2,0.116666667,0,empty,CD-0722-4
"H4,E2",15688,17577,11569,6008,9333,4882,0,4886,3291,1595,2.063322884,2803,1795,381,130,127,3,34,1,0.102362205,0,empty,CD-0722-4
"H4,E3",10112,11183,7570,3613,5841,2878,0,2881,1914,967,1.979317477,1639,1898,592,259,258,1,52,1,0.046511628,0,empty,CD-0722-4
"H4,E4",19503,22110,14604,7506,11681,6110,0,6121,4205,1916,2.194676409,3564,2167,602,249,246,3,59,1,0.146341463,0,empty,CD-0722-4
"H4,E5",12680,13765,9720,4045,7270,3518,1,3524,2257,1267,1.781373323,1893,845,201,90,90,0,21,0,0.011111111,0,empty,CD-0722-4
"H4,E6",28442,31725,21376,10349,16370,8249,0,8251,5699,2552,2.23315047,4669,3700,1074,399,397,2,72,2,0.125944584,0,empty,CD-0722-4
"H4,E7",31658,35746,23842,11904,18727,9576,1,9595,6657,2938,2.265827093,5504,2491,620,258,256,2,63,2,0.0546875,0,empty,CD-0722-4
"H4,E8",19879,21996,15158,6838,11608,5572,0,5575,3913,1662,2.354392298,3147,2849,760,319,319,0,74,0,0.05015674,0,empty,CD-0722-4
"H4,E9",15143,17462,11326,6136,8958,4654,5,4659,3319,1340,2.476865672,2651,2023,459,203,202,1,44,1,0.069306931,0,empty,CD-0722-4
"H4,E10",3499999,4272569,2355306,1917263,2084746,1454966,11,1456074,1052933,403141,2.611823159,899222,5927,2427,509,502,7,170,2,0.047808765,0,hg38,CD-0722-4
"H4,E11",15181,17298,11305,5993,9087,4865,5,4870,3310,1560,2.121794872,2808,1715,415,132,131,1,35,1,0.129770992,0,empty,CD-0722-4
"H4,E12",1994303,2514383,1410889,1103494,1221997,778458,1,779037,625395,153642,4.070469012,492919,16691,8035,3055,3049,6,692,2,0.020662512,0,hg38,CD-0722-4
"H4,F1",1441126,1625710,1075071,550639,782601,415689,14,416133,332549,83584,3.97862031,238568,143588,21912,8720,8537,183,1386,6,0.055171606,0,hg38,CD-0722-4
"H4,F2",14995,16373,11151,5222,8798,4419,0,4421,2971,1450,2.048965517,2501,3922,923,320,319,1,57,1,0.213166144,0,empty,CD-0722-4
"H4,F3",1195899,1351767,894733,457034,659507,348555,3,348828,263384,85444,3.082533589,204527,33734,5236,2002,1967,35,458,2,0.038637519,0,hg38,CD-0722-4
"H4,F4",19360,21165,14544,6621,11322,5479,2,5486,3794,1692,2.242316785,3027,528,75,44,42,2,18,2,0,0,empty,CD-0722-4
"H4,F5",14813,15798,11226,4572,8411,3936,0,3942,2653,1289,2.058184639,2126,1765,525,204,200,4,47,1,0.135,0,empty,CD-0722-4
"H4,F6",32632,38061,24011,14050,19879,10730,0,10745,7785,2960,2.630067568,6396,2739,684,236,235,1,65,1,0.204255319,0,empty,CD-0722-4
"H4,F7",1576293,1834214,1175730,658484,898798,489011,4,489419,394148,95271,4.137124623,287544,108764,12797,5141,4998,143,935,5,0.049019608,0,hg38,CD-0722-4
"H4,F8",16591,18791,12543,6248,9984,5012,5,5020,3630,1390,2.611510791,2932,143,16,9,9,0,6,0,0,0,empty,CD-0722-4
"H4,F9",19458,21474,14666,6808,11163,5628,0,5631,4172,1459,2.859492803,3130,2188,578,206,205,1,50,1,0.048780488,0,empty,CD-0722-4
"H4,F10",19832,21882,15119,6763,11618,5599,0,5601,3952,1649,2.396604002,3152,1798,396,130,128,2,39,2,0.015625,0,empty,CD-0722-4
"H4,F11",16815,18282,12846,5436,9582,4530,1,4537,3147,1390,2.264028777,2469,1330,189,83,82,1,23,1,0.048780488,0,empty,CD-0722-4
"H4,F12",1037940,1149242,784095,365147,557313,277263,2,277507,211108,66399,3.179385232,159390,10885,1232,466,455,11,111,2,0.081318681,0,hg38,CD-0722-4
"H4,G1",29544,33512,22246,11266,17220,8953,0,8957,6376,2581,2.470360325,5087,2197,481,227,224,3,64,2,0.035714286,0,empty,CD-0722-4
"H4,G2",20474,23258,14434,8824,11493,6212,17,6237,4250,1987,2.138902869,3688,644,184,70,70,0,23,0,0,0,empty,CD-0722-4
"H4,G3",1309654,1523622,970512,553110,740133,406829,0,407192,315579,91613,3.444696713,242720,98204,13952,5463,5349,114,1006,7,0.033090297,0,hg38,CD-0722-4
"H4,G4",30560,34867,22161,12706,17974,9926,0,9933,6523,3410,1.912903226,5764,71,18,9,9,0,3,0,0,0,empty,CD-0722-4
"H4,G5",10307,11813,7597,4216,6049,3157,6,3165,2089,1076,1.941449814,1802,1135,206,99,99,0,20,0,0.161616162,0,empty,CD-0722-4
"H4,G6",15433,17219,11520,5699,9078,4565,0,4569,3242,1327,2.443104748,2653,55,1,0,0,0,0,0,0,0,empty,CD-0722-4
"H4,G7",15754,17046,11977,5069,9039,4297,1,4298,3076,1222,2.517184943,2325,5486,1269,499,491,8,129,2,0.107942974,0,empty,CD-0722-4
"H4,G8",11838,12959,8828,4131,6991,3445,0,3450,2475,975,2.538461538,1978,1300,362,159,157,2,40,2,0.063694268,0,empty,CD-0722-4
"H4,G9",15890,17776,11910,5866,9629,4953,0,4955,3487,1468,2.375340599,2807,2502,574,257,248,9,56,2,0.048387097,0,empty,CD-0722-4
"H4,G10",20849,23744,15750,7994,12408,6406,22,6435,4514,1921,2.349817803,3656,2058,522,228,228,0,60,0,0.114035088,0,empty,CD-0722-4
"H4,G11",1195029,1301323,933600,367723,628244,293874,2,294171,228966,65205,3.511479181,160703,18976,3996,1519,1501,18,323,2,0.026648901,0,hg38,CD-0722-4
"H4,G12",10104,11418,7394,4024,6083,3193,0,3201,2143,1058,2.025519849,1858,1341,257,121,121,0,38,0,0.123966942,0,empty,CD-0722-4
"H4,H1",21002,24134,15748,8386,12496,6345,0,6347,4484,1863,2.406870639,3683,1123,312,108,103,5,27,1,0.029126214,0,empty,CD-0722-4
"H4,H2",1406442,1652539,1034682,617857,806715,448814,4,449178,347058,102120,3.39853114,270879,54714,8623,3365,3270,95,667,3,0.017125382,0,hg38,CD-0722-4
"H4,H3",16638,18535,12207,6328,9862,5244,0,5251,3642,1609,2.263517713,3044,1282,268,136,134,2,36,1,0.044776119,0,empty,CD-0722-4
"H4,H4",18847,21571,14045,7526,11055,5812,0,5814,4179,1635,2.555963303,3353,138,8,6,4,2,3,1,0,0,empty,CD-0722-4
"H4,H5",17952,20309,13266,7043,10650,5493,0,5496,3698,1798,2.0567297,3225,1549,504,190,189,1,53,1,0.015873016,0,empty,CD-0722-4
"H4,H6",16950,19424,12508,6916,10173,5369,3,5376,3673,1703,2.156782149,3190,1555,398,141,140,1,43,1,0.078571429,0,empty,CD-0722-4
"H4,H7",13663,15155,10204,4951,7976,4057,0,4060,2790,1270,2.196850394,2271,1601,401,158,153,5,41,2,0.006535948,0,empty,CD-0722-4
"H4,H8",26053,29825,19405,10420,15598,8294,4,8308,6009,2299,2.613745107,4779,2210,594,200,197,3,51,1,0.157360406,0,empty,CD-0722-4
"H4,H9",16798,18592,12920,5672,9730,4659,0,4666,3313,1353,2.448632668,2642,1171,334,124,122,2,29,1,0,0,empty,CD-0722-4
"H4,H10",10597,12157,7791,4366,6367,3405,3,3410,2320,1090,2.128440367,2079,1195,214,108,107,1,20,1,0.14953271,0,empty,CD-0722-4
"H4,H11",12766,14209,8986,5223,7427,4355,1,4356,2312,2044,1.13111546,2578,37,0,0,0,0,0,0,0,0,empty,CD-0722-4
"H4,H12",17799,19878,13163,6715,10251,5342,0,5342,3747,1595,2.349216301,3085,1697,333,133,126,7,28,2,0,0,empty,CD-0722-4
"H5,A1",8749,9885,6321,3564,5313,2800,5,2812,1882,930,2.023655914,1637,1739,216,94,92,2,32,2,0.02173913,0,empty,CD-0722-4
"H5,A2",12957,14186,9576,4610,7594,3932,0,3937,2559,1378,1.857039187,2188,2323,719,212,208,4,62,1,0.043269231,0,empty,CD-0722-4
"H5,A3",11003,12069,8318,3751,6224,2943,33,2987,2088,899,2.322580645,1622,2391,628,259,253,6,59,1,0.04743083,0,empty,CD-0722-4
"H5,A4",11390,12429,8520,3909,6740,3350,0,3353,2228,1125,1.980444444,1898,886,277,82,82,0,20,0,0.097560976,0,empty,CD-0722-4
"H5,A5",12506,13633,9243,4390,7298,3651,0,3651,2514,1137,2.211081794,2076,2492,486,202,198,4,53,2,0.141414141,0,empty,CD-0722-4
"H5,A6",11022,12918,8149,4769,6935,3682,0,3688,2406,1282,1.87675507,2197,3968,1086,403,400,3,96,2,0.1675,0,empty,CD-0722-4
"H5,A7",7909,9081,5775,3306,4947,2666,0,2668,1680,988,1.700404858,1575,1642,273,102,98,4,33,2,0.153061224,0,empty,CD-0722-4
"H5,A8",6026,6585,4404,2181,3705,1945,0,1945,1387,558,2.485663082,1102,2705,516,209,201,8,60,3,0.039800995,0,empty,CD-0722-4
"H5,A9",10393,11625,7910,3715,6150,3168,0,3168,2166,1002,2.161676647,1731,2161,316,141,139,2,41,1,0.09352518,0,empty,CD-0722-4
"H5,A10",13636,14524,10339,4185,7557,3680,0,3683,2435,1248,1.951121795,1959,571,150,42,42,0,12,0,0,0,empty,CD-0722-4
"H5,A11",7680,8380,5794,2586,4521,2152,0,2155,1474,681,2.164464023,1185,1614,287,123,122,1,36,1,0.172131148,0,empty,CD-0722-4
"H5,A12",12684,13741,9542,4199,7350,3505,0,3505,2390,1115,2.143497758,1927,4604,1117,439,437,2,97,1,0.070938215,0,empty,CD-0722-4
"H5,B1",1277182,1462068,956585,505483,709732,374817,1,375162,297662,77500,3.8408,219009,190455,24070,9369,9137,232,1437,8,0.037101893,0,hg38,CD-0722-4
"H5,B2",8641,9607,5798,3809,5199,2888,1,2893,1822,1071,1.701213819,1793,478,184,56,56,0,17,0,0.214285714,0,empty,CD-0722-4
"H5,B3",11497,13284,8398,4886,7172,3787,1,3789,2683,1106,2.425858951,2304,1578,497,183,183,0,42,0,0,0,empty,CD-0722-4
"H5,B4",10248,11552,7499,4053,6143,3401,1,3403,2131,1272,1.675314465,1901,2027,567,191,189,2,46,1,0.153439153,0,empty,CD-0722-4
"H5,B5",17846,15160,10165,4995,8584,4301,1,4313,3209,1104,2.906702899,2566,1317,307,112,109,3,31,2,0.064220183,0,empty,CD-0722-4
"H5,B6",11804,13405,8633,4772,6989,3676,32,3711,2369,1342,1.765275708,2180,3164,618,261,259,2,57,1,0.061776062,0,empty,CD-0722-4
"H5,B7",10042,10940,7738,3202,5920,2800,39,2843,1877,966,1.943064182,1564,2850,673,224,221,3,46,2,0.058823529,0,empty,CD-0722-4
"H5,B8",7967,8694,6074,2620,4746,2321,0,2325,1584,741,2.137651822,1290,1590,323,99,96,3,34,2,0.104166667,0,empty,CD-0722-4
"H5,B9",13465,15318,9822,5496,8006,4305,0,4315,2727,1588,1.717254408,2534,1114,254,101,101,0,29,0,0,0,empty,CD-0722-4
"H5,B10",7949,8808,5662,3146,4898,2616,8,2628,1732,896,1.933035714,1519,507,145,63,63,0,18,0,0.206349206,0,empty,CD-0722-4
"H5,B11",14635,16289,10570,5719,8347,4543,0,4553,2688,1865,1.441286863,2602,224,17,10,7,3,6,1,0,0,empty,CD-0722-4
"H5,B12",18279,21175,13647,7528,10522,5410,0,5417,3808,1609,2.366687383,3112,3319,874,286,284,2,69,1,0.077464789,0,empty,CD-0722-4
"H5,C1",17124,18696,12959,5737,10129,5014,30,5045,3357,1688,1.988744076,2696,1369,392,135,132,3,36,1,0,0,empty,CD-0722-4
"H5,C2",26913,31140,19920,11220,15312,8053,5,8074,5454,2620,2.081679389,4808,3062,804,310,309,1,93,1,0.01618123,0,empty,CD-0722-4
"H5,C3",12788,14156,9536,4620,7449,3778,9,3796,2460,1336,1.841317365,2074,924,221,89,89,0,27,0,0.213483146,0,empty,CD-0722-4
"H5,C4",9344,10538,7050,3488,5715,2822,0,2826,1910,916,2.085152838,1615,2013,451,212,209,3,58,2,0.138755981,0,empty,CD-0722-4
"H5,C5",1463847,1753444,1059477,693967,854756,497326,6,497719,419817,77902,5.389040076,302515,141267,26741,10744,10632,112,1635,7,0.061700527,0,hg38,CD-0722-4
"H5,C6",10373,11408,7601,3807,6304,3261,1,3265,2165,1100,1.968181818,1917,2701,644,262,258,4,54,1,0.162790698,0,empty,CD-0722-4
"H5,C7",875254,1163378,541712,621666,597605,449078,1,449365,292682,156683,1.867988231,296959,1159,569,120,118,2,30,1,0,0,hg38,CD-0722-4
"H5,C8",18202,20761,13324,7437,10803,5778,8,5789,3958,1831,2.161660295,3362,4000,823,339,339,0,86,0,0.061946903,0,empty,CD-0722-4
"H5,C9",1005062,1112495,757606,354889,544184,270865,14,271151,215433,55718,3.866488388,154188,5714,2285,600,598,2,205,1,0.04180602,0,hg38,CD-0722-4
"H5,C10",11814,12767,8802,3965,6661,3267,0,3268,2167,1101,1.968210718,1830,3024,766,327,316,11,65,2,0.009493671,0,empty,CD-0722-4
"H5,C11",10563,11936,7937,3999,6304,3175,0,3181,2122,1059,2.003777148,1798,2769,734,255,254,1,62,1,0.066929134,0,empty,CD-0722-4
"H5,C12",18028,20248,13385,6863,10586,5408,0,5415,3710,1705,2.175953079,3140,3473,967,364,357,7,85,3,0.070028011,0,empty,CD-0722-4
"H5,D1",13591,15485,9672,5813,8184,4520,0,4525,2724,1801,1.512493059,2722,1176,214,78,77,1,20,1,0.12987013,0,empty,CD-0722-4
"H5,D2",10128,11118,7643,3475,5872,2816,0,2820,1832,988,1.854251012,1576,3840,986,338,334,4,72,2,0.098802395,0,empty,CD-0722-4
"H5,D3",935038,1047384,709219,338165,517738,261853,2,262143,197347,64796,3.045666399,149921,110608,9286,3834,3691,143,664,5,0.073421837,0,hg38,CD-0722-4
"H5,D4",7866,9140,5989,3151,4792,2460,0,2462,1659,803,2.066002491,1395,1644,389,161,160,1,39,1,0.025,0,empty,CD-0722-4
"H5,D5",8100,9156,6033,3123,4870,2492,0,2496,1596,900,1.773333333,1451,2362,638,226,222,4,57,1,0.09009009,0,empty,CD-0722-4
"H5,D6",12708,14305,9168,5137,7366,4026,8,4035,2478,1557,1.591522158,2317,2024,370,177,174,3,53,2,0.011494253,0,empty,CD-0722-4
"H5,D7",7602,8356,5588,2768,4462,2213,0,2217,1414,803,1.760896638,1330,3040,861,316,309,7,71,2,0.145631068,0,empty,CD-0722-4
"H5,D8",9071,10353,6803,3550,5436,2779,0,2783,1809,974,1.857289528,1599,1843,621,244,243,1,45,1,0.028806584,0,empty,CD-0722-4
"H5,D9",5175,5676,3917,1759,2954,1402,0,1402,922,480,1.920833333,796,1881,498,194,194,0,47,0,0.072164948,0,empty,CD-0722-4
"H5,D10",8902,10158,6434,3724,5382,2876,0,2878,1821,1057,1.722800378,1703,1149,271,81,80,1,26,1,0.1125,0,empty,CD-0722-4
"H5,D11",9714,10772,7301,3471,5675,2781,0,2783,1748,1035,1.688888889,1585,3330,741,310,308,2,87,1,0.061688312,0,empty,CD-0722-4
"H5,D12",13133,14997,9669,5328,7776,3960,14,3976,2685,1291,2.079783114,2331,5084,1264,461,457,4,110,2,0.085339168,0,empty,CD-0722-4
"H5,E1",2151790,2272588,1704104,568484,1066946,469899,13,470456,367198,103258,3.55612156,247916,223201,36078,13839,13581,258,1868,6,0.027317576,0,hg38,CD-0722-4
"H5,E2",10829,12175,7828,4347,6566,3442,1,3444,2165,1279,1.692728694,2035,2035,427,217,216,1,50,1,0.083333333,0,empty,CD-0722-4
"H5,E3",7203,7914,5458,2456,4242,2121,1,2123,1358,765,1.775163399,1165,2939,620,257,253,4,65,1,0.023715415,0,empty,CD-0722-4
"H5,E4",11086,12857,8265,4592,6890,3586,5,3595,2314,1281,1.806401249,2107,2798,527,187,180,7,59,2,0.083333333,0,empty,CD-0722-4
"H5,E5",21146,22806,16571,6235,11313,4911,0,4922,3322,1600,2.07625,2656,2983,720,285,283,2,61,1,0.045936396,0,empty,CD-0722-4
"H5,E6",1042944,1122239,812858,309381,542525,250673,1,250925,201640,49285,4.091305671,135914,115248,20822,7763,7597,166,1131,2,0.04212189,0,hg38,CD-0722-4
"H5,E7",17496,19550,12871,6679,10243,5142,2,5145,3499,1646,2.125759417,3025,3545,699,236,235,1,79,1,0.089361702,0,empty,CD-0722-4
"H5,E8",32910,36994,24255,12739,18615,10289,0,10295,6584,3711,1.774184856,5633,3880,807,335,335,0,93,0,0.041791045,0,empty,CD-0722-4
"H5,E9",8562,9789,6375,3414,5037,2617,5,2624,1694,930,1.821505376,1520,2703,672,285,283,2,63,1,0.028268551,0,empty,CD-0722-4
"H5,E10",8432,9734,6216,3518,5050,2554,1,2556,1663,893,1.862262038,1479,2045,627,229,227,2,54,2,0.057268722,0,empty,CD-0722-4
"H5,E11",10613,11803,7897,3906,6399,3356,1,3358,2184,1174,1.860306644,1902,3259,811,325,323,2,67,2,0.015479876,0,empty,CD-0722-4
"H5,E12",12971,14655,9637,5018,7772,3954,0,3957,2592,1365,1.898901099,2350,2603,508,222,221,1,47,1,0.040723982,0,empty,CD-0722-4
"H5,F1",13425,14602,10064,4538,7569,3725,13,3741,2441,1300,1.877692308,2022,2475,667,296,293,3,67,1,0.105802048,0,empty,CD-0722-4
"H5,F2",10829,11836,7973,3863,6293,3086,0,3094,2055,1039,1.97786333,1746,3859,882,357,355,2,88,1,0.135211268,0,empty,CD-0722-4
"H5,F3",2202323,2535110,1638710,896400,1218495,678394,1,678960,560608,118352,4.736785183,399997,561565,87496,35395,34735,660,3533,13,0.073959983,0,hg38,CD-0722-4
"H5,F4",15090,16389,11208,5181,8785,4307,3,4319,2912,1407,2.069651741,2407,785,171,66,66,0,21,0,0,0,empty,CD-0722-4
"H5,F5",1180109,1333586,876849,456737,653739,358917,23,359246,259933,99313,2.617310926,209310,26532,5916,2119,2091,28,411,2,0.028216165,0,hg38,CD-0722-4
"H5,F6",16694,19300,12183,7117,10139,5336,0,5340,3615,1725,2.095652174,3208,5101,1029,407,405,2,120,1,0.071604938,0,empty,CD-0722-4
"H5,F7",13461,15269,9957,5312,8200,4164,0,4176,2685,1491,1.800804829,2458,1541,294,153,150,3,40,2,0.086666667,0,empty,CD-0722-4
"H5,F8",10088,11315,7588,3727,6084,3003,15,3026,2084,942,2.212314225,1727,180,25,15,14,1,12,1,0.142857143,0,empty,CD-0722-4
"H5,F9",11435,12509,8670,3839,6680,3230,9,3240,2191,1049,2.088655863,1816,4399,1205,514,513,1,109,1,0.118908382,0,empty,CD-0722-4
"H5,F10",13278,14621,10029,4592,7820,3831,2,3837,2545,1292,1.969814241,2121,2053,585,220,220,0,58,0,0.036363636,0,empty,CD-0722-4
"H5,F11",11466,12485,8725,3760,6352,3036,7,3049,2068,981,2.108053007,1615,2222,505,204,203,1,31,1,0.123152709,0,empty,CD-0722-4
"H5,F12",11484,12543,8461,4082,6471,3245,0,3245,2168,1077,2.012999071,1778,225,70,25,23,2,10,1,0.130434783,0,empty,CD-0722-4
"H5,G1",12694,14196,9498,4698,7580,3748,0,3753,2463,1290,1.909302326,2165,3910,918,367,363,4,87,2,0.071625344,0,empty,CD-0722-4
"H5,G2",6861,7608,4927,2681,3987,2112,0,2115,1305,810,1.611111111,1233,515,143,54,54,0,9,0,0,0,empty,CD-0722-4
"H5,G3",15688,16967,11799,5168,8900,4466,0,4477,2837,1640,1.729878049,2441,3231,828,320,319,1,80,1,0.07523511,0,empty,CD-0722-4
"H5,G4",24096,26680,17278,9402,13957,7724,4,7733,4787,2946,1.624915139,4401,159,47,11,11,0,5,0,0,0,empty,CD-0722-4
"H5,G5",8040,8817,5976,2841,4660,2375,2,2379,1513,866,1.747113164,1328,2150,390,152,151,1,41,1,0.092715232,0,empty,CD-0722-4
"H5,G6",11751,12655,8822,3833,6636,3279,0,3282,2172,1110,1.956756757,1793,200,77,16,16,0,12,0,0.0625,0,empty,CD-0722-4
"H5,G7",17228,19280,13287,5993,9875,4835,0,4842,3495,1347,2.594654788,2713,3644,941,389,379,10,99,2,0.047493404,0,empty,CD-0722-4
"H5,G8",7649,8559,5647,2912,4476,2280,0,2283,1522,761,2,1326,2419,672,275,270,5,59,3,0.174074074,0,empty,CD-0722-4
"H5,G9",9489,10648,7053,3595,5759,2966,1,2970,1983,987,2.009118541,1715,2838,697,227,225,2,70,1,0.164444444,0,empty,CD-0722-4
"H5,G10",12373,14071,9228,4843,7513,3883,0,3883,2564,1319,1.943896892,2242,3112,800,394,391,3,74,1,0.084398977,0,empty,CD-0722-4
"H5,G11",11700,12769,8932,3837,6679,3218,1,3222,2195,1027,2.137293087,1764,2382,480,198,193,5,40,2,0.062176166,0,empty,CD-0722-4
"H5,G12",2131676,2630715,1438377,1192338,1318542,908171,3,908853,696298,212555,3.275848604,565527,22478,2268,629,597,32,104,2,0.361809045,0,hg38,CD-0722-4
"H5,H1",11636,13012,8637,4375,6922,3556,2,3561,2316,1245,1.860240964,2072,1708,506,178,176,2,45,2,0.107954545,0,empty,CD-0722-4
"H5,H2",9849,10915,7377,3538,5802,2878,0,2882,1920,962,1.995841996,1638,2618,647,273,266,7,54,2,0.041353383,0,empty,CD-0722-4
"H5,H3",9922,11139,7292,3847,5940,3137,9,3152,2117,1035,2.045410628,1815,2501,412,163,163,0,55,0,0.024539877,0,empty,CD-0722-4
"H5,H4",13714,14969,10290,4679,7761,3846,1,3849,2546,1303,1.953952417,2144,694,102,42,39,3,10,2,0,0,empty,CD-0722-4
"H5,H5",13278,15049,9774,5275,7932,4078,11,4091,2745,1346,2.039375929,2409,2349,678,280,278,2,64,1,0.079136691,0,empty,CD-0722-4
"H5,H6",9618,10702,7066,3636,5640,2942,6,2949,1963,986,1.990872211,1726,2832,631,251,249,2,73,2,0.020080321,0,empty,CD-0722-4
"H5,H7",9743,10685,7235,3450,5699,2768,39,2812,1837,975,1.884102564,1599,3035,608,236,236,0,64,0,0.012711864,0,empty,CD-0722-4
"H5,H8",13615,15219,10072,5147,7999,4172,20,4195,2884,1311,2.199847445,2410,2761,705,247,243,4,70,2,0.041152263,0,empty,CD-0722-4
"H5,H9",9463,10491,7225,3266,5454,2655,0,2656,1780,876,2.03196347,1476,1515,279,97,96,1,24,1,0.03125,0,empty,CD-0722-4
"H5,H10",7540,8514,5617,2897,4369,2192,2,2194,1442,752,1.917553191,1241,1415,259,132,130,2,35,2,0.038461538,0,empty,CD-0722-4
"H5,H11",10194,11529,7248,4281,6007,3635,0,3635,2034,1601,1.270455965,2108,63,26,11,11,0,4,0,0.090909091,0,empty,CD-0722-4
"H5,H12",9444,10586,6940,3646,5576,2906,0,2909,1943,966,2.011387164,1686,1830,473,154,153,1,29,1,0.091503268,0,empty,CD-0722-4
"H6,A1",6607,7354,4861,2493,4051,2155,0,2158,1465,693,2.113997114,1250,997,222,76,75,1,21,1,0.04,0,empty,CD-0722-4
"H6,A2",10166,11396,7364,4032,5960,3109,0,3118,2127,991,2.146316852,1769,1421,351,130,130,0,36,0,0.092307692,0,empty,CD-0722-4
"H6,A3",6253,6886,4621,2265,3672,1904,1,1905,1367,538,2.540892193,1060,1045,225,91,89,2,24,1,0.08988764,0,empty,CD-0722-4
"H6,A4",8639,9738,6584,3154,5189,2568,3,2575,1737,838,2.072792363,1419,859,167,75,73,2,23,2,0,0,empty,CD-0722-4
"H6,A5",10733,11661,7794,3867,6521,3384,10,3401,2398,1003,2.390827517,1888,1719,412,154,154,0,48,0,0.006493506,0,empty,CD-0722-4
"H6,A6",9576,10919,6971,3948,5802,3115,10,3128,2185,943,2.317073171,1832,2158,488,194,194,0,54,0,0.036082474,0,empty,CD-0722-4
"H6,A7",13136,14391,10144,4247,7301,3635,0,3642,2529,1113,2.272237197,1975,3117,480,198,191,7,46,2,0.104712042,0,empty,CD-0722-4
"H6,A8",4817,5418,3537,1881,2936,1477,0,1477,1087,390,2.787179487,876,1361,281,114,111,3,38,1,0.027027027,0,empty,CD-0722-4
"H6,A9",8802,9584,6440,3144,5188,2639,6,2646,1962,684,2.868421053,1503,1212,192,103,102,1,33,1,0.196078431,0,empty,CD-0722-4
"H6,A10",8803,9646,6543,3103,5135,2576,24,2600,1815,785,2.312101911,1434,359,18,9,9,0,7,0,0,0,empty,CD-0722-4
"H6,A11",5787,6331,4387,1944,3378,1603,0,1606,1117,489,2.284253579,880,1187,313,146,146,0,30,0,0,0,empty,CD-0722-4
"H6,A12",2657749,3019104,2008031,1011073,1400352,755066,8,755827,621026,134801,4.606983628,432879,767503,112469,43828,42979,849,4415,10,0.073547546,0,hg38,CD-0722-4
"H6,B1",6405,6969,4812,2157,3792,1903,2,1905,1301,604,2.15397351,1069,1014,231,81,81,0,29,0,0.061728395,0,empty,CD-0722-4
"H6,B2",6054,6733,4145,2588,3588,1953,0,1953,1232,721,1.708737864,1193,440,44,24,24,0,10,0,0,0,empty,CD-0722-4
"H6,B3",7367,8279,5372,2907,4433,2329,8,2337,1646,691,2.382054993,1332,1594,391,115,115,0,30,0,0.008695652,0,empty,CD-0722-4
"H6,B4",7014,8003,5204,2799,4278,2284,0,2287,1498,789,1.89860583,1362,1045,195,90,89,1,27,1,0,0,empty,CD-0722-4
"H6,B5",7198,4362,2862,1500,2932,1532,0,1538,1096,442,2.479638009,920,621,150,46,44,2,16,1,0.113636364,0,empty,CD-0722-4
"H6,B6",9661,10852,7039,3813,5614,3043,0,3045,2101,944,2.225635593,1758,2006,506,196,196,0,47,0,0.035714286,0,empty,CD-0722-4
"H6,B7",7562,8429,5708,2721,4542,2181,1,2185,1519,666,2.280780781,1263,1693,417,157,155,2,29,1,0.096774194,0,empty,CD-0722-4
"H6,B8",7218,7996,5480,2516,4326,2132,0,2132,1536,596,2.577181208,1205,961,221,96,93,3,28,2,0.096774194,0,empty,CD-0722-4
"H6,B9",10772,11714,7983,3731,6321,3205,0,3210,2167,1043,2.077660594,1768,735,154,57,57,0,23,0,0.070175439,0,empty,CD-0722-4
"H6,B10",6510,6989,4511,2478,3963,2020,23,2049,1474,575,2.563478261,1189,272,42,22,21,1,7,1,0.095238095,0,empty,CD-0722-4
"H6,B11",10626,11616,7712,3904,6207,3283,3,3293,2077,1216,1.708059211,1897,170,38,20,19,1,7,1,0,0,empty,CD-0722-4
"H6,B12",7981,8926,5817,3109,4811,2531,0,2535,1847,688,2.684593023,1440,1085,201,72,72,0,29,0,0.041666667,0,empty,CD-0722-4
"H6,C1",13510,14728,9948,4780,8007,4057,5,4064,2795,1269,2.202521671,2291,914,195,82,81,1,32,1,0,0,empty,CD-0722-4
"H6,C2",9217,10245,6790,3455,5414,2775,1,2776,1835,941,1.950053135,1634,2391,533,239,238,1,60,1,0.155462185,0,empty,CD-0722-4
"H6,C3",9889,11039,7343,3696,6006,3025,0,3030,2039,991,2.057517659,1773,806,111,39,38,1,14,1,0.052631579,0,empty,CD-0722-4
"H6,C4",7643,8489,5682,2807,4551,2268,0,2270,1574,696,2.261494253,1292,1408,228,101,101,0,37,0,0.059405941,0,empty,CD-0722-4
"H6,C5",14926,16927,11209,5718,8615,4374,0,4380,3117,1263,2.467933492,2574,1967,356,139,135,4,39,2,0.02962963,0,empty,CD-0722-4
"H6,C6",7840,8691,5708,2983,4680,2458,36,2500,1714,786,2.180661578,1455,1558,225,83,83,0,29,0,0.012048193,0,empty,CD-0722-4
"H6,C7",10261,11868,7449,4419,6213,3426,50,3478,2179,1299,1.677444188,2097,270,89,32,32,0,9,0,0.0625,0,empty,CD-0722-4
"H6,C8",11488,12772,8379,4393,6739,3507,0,3507,2398,1109,2.162308386,2086,2685,687,257,254,3,62,3,0.094488189,0,empty,CD-0722-4
"H6,C9",9672,10985,7107,3878,5831,3003,1,3006,2110,896,2.354910714,1749,1141,265,97,97,0,26,0,0.103092784,0,empty,CD-0722-4
"H6,C10",9387,9980,6987,2993,5437,2592,11,2607,1771,836,2.118421053,1434,1829,389,136,136,0,39,0,0.044117647,0,empty,CD-0722-4
"H6,C11",983051,1107985,737440,370545,540612,279225,1,279492,213278,66214,3.221040867,163178,127214,14477,5696,5547,149,936,5,0.073012439,0,hg38,CD-0722-4
"H6,C12",12945,14289,9700,4589,7632,3757,1,3760,2659,1101,2.415077203,2130,1685,513,175,174,1,45,1,0.074712644,0,empty,CD-0722-4
"H6,D1",8662,9823,6329,3494,5104,2762,0,2762,1725,1037,1.663452266,1561,590,182,72,72,0,16,0,0,0,empty,CD-0722-4
"H6,D2",6458,6859,4821,2038,3700,1709,21,1731,1137,594,1.914141414,951,2047,504,173,171,2,53,1,0.046783626,0,empty,CD-0722-4
"H6,D3",9760,11043,7242,3801,5647,2852,0,2858,1978,880,2.247727273,1638,1763,426,177,173,4,42,2,0.080924855,0,empty,CD-0722-4
"H6,D4",7058,7863,5169,2694,4324,2207,62,2269,1611,658,2.448328267,1347,1126,252,99,97,2,31,2,0.103092784,0,empty,CD-0722-4
"H6,D5",7457,8351,5443,2908,4478,2259,0,2259,1586,673,2.356612184,1318,1809,216,90,88,2,31,2,0.022727273,0,empty,CD-0722-4
"H6,D6",8509,9356,6097,3259,4834,2563,6,2572,1700,872,1.949541284,1433,3101,686,242,232,10,45,3,0.189655172,0,empty,CD-0722-4
"H6,D7",5784,6163,4272,1891,3246,1605,0,1605,1132,473,2.393234672,912,1642,368,164,161,3,40,2,0.105590062,0,empty,CD-0722-4
"H6,D8",6512,7242,4819,2423,3877,1964,0,1964,1331,633,2.102685624,1089,1073,225,98,98,0,30,0,0.051020408,0,empty,CD-0722-4
"H6,D9",3983,4508,2963,1545,2387,1203,9,1212,816,396,2.060606061,703,1658,301,129,127,2,31,1,0.078740157,0,empty,CD-0722-4
"H6,D10",6499,7541,4693,2848,4010,2111,1,2117,1437,680,2.113235294,1276,999,159,66,66,0,14,0,0.060606061,0,empty,CD-0722-4
"H6,D11",6916,7493,5229,2264,3959,1961,0,1963,1328,635,2.091338583,1017,2294,612,252,251,1,54,1,0.071713147,0,empty,CD-0722-4
"H6,D12",10286,11576,7641,3935,6318,3267,1,3276,2262,1014,2.230769231,1906,2353,578,178,174,4,51,3,0.011494253,0,empty,CD-0722-4
"H6,E1",14234,16044,10714,5330,8389,4131,20,4154,2929,1225,2.391020408,2357,1762,377,168,166,2,58,2,0.096385542,0,empty,CD-0722-4
"H6,E2",11305,12401,8112,4289,6379,3250,2,3256,2170,1086,1.998158379,1881,3988,824,355,352,3,58,2,0.232954545,0,empty,CD-0722-4
"H6,E3",748439,838189,572951,265238,412602,204678,0,204851,152721,52130,2.929618262,116470,184575,32233,12655,12439,216,1654,8,0.036176542,0,hg38,CD-0722-4
"H6,E4",10059,11124,7232,3892,5963,3145,0,3145,2145,1000,2.145,1821,1875,330,119,117,2,54,2,0.042735043,0,empty,CD-0722-4
"H6,E5",5769,6432,4282,2150,3443,1665,18,1685,1123,562,1.998220641,953,972,357,107,107,0,27,0,0.056074766,0,empty,CD-0722-4
"H6,E6",12765,14407,9492,4915,7548,3812,6,3829,2685,1144,2.347027972,2254,3030,702,231,226,5,51,1,0.066371681,0,empty,CD-0722-4
"H6,E7",15626,16685,11383,5302,9150,4611,22,4635,3246,1389,2.336933045,2628,2199,555,240,235,5,65,2,0.072340426,0,empty,CD-0722-4
"H6,E8",10728,11668,8132,3536,6139,2907,0,2908,2057,851,2.417156287,1585,2334,508,208,207,1,62,1,0.033816425,0,empty,CD-0722-4
"H6,E9",6762,7815,5030,2785,4150,2157,0,2159,1526,633,2.410742496,1259,1747,356,134,133,1,41,1,0.097744361,0,empty,CD-0722-4
"H6,E10",6944,7704,5112,2592,4162,2150,2,2156,1454,702,2.071225071,1247,1332,243,93,92,1,32,1,0.010869565,0,empty,CD-0722-4
"H6,E11",994990,1188224,696217,492007,588880,379548,0,379803,274017,105786,2.590295502,227363,4906,786,239,228,11,68,1,0.122807018,0,hg38,CD-0722-4
"H6,E12",10775,11883,7867,4016,6469,3304,0,3307,2315,992,2.333669355,1888,1381,282,123,120,3,35,2,0.075,0,empty,CD-0722-4
"H6,F1",9341,10368,6965,3403,5561,2801,2,2811,1855,956,1.940376569,1647,1535,310,121,119,2,41,1,0.050420168,0,empty,CD-0722-4
"H6,F2",7728,8459,5735,2724,4466,2254,0,2259,1508,751,2.007989348,1282,1888,553,199,198,1,51,1,0.01010101,0,empty,CD-0722-4
"H6,F3",8844,10291,6402,3889,5464,2843,1,2855,2041,814,2.507371007,1744,3150,684,242,235,7,63,1,0.114893617,0,empty,CD-0722-4
"H6,F4",10993,11860,8255,3605,6291,3016,1,3025,2041,984,2.074186992,1656,662,83,42,42,0,14,0,0.19047619,0,empty,CD-0722-4
"H6,F5",8838,9358,6493,2865,4989,2368,1,2369,1626,743,2.188425303,1311,2413,505,171,170,1,46,1,0.064705882,0,empty,CD-0722-4
"H6,F6",15338,17373,11420,5953,9329,4973,1,4982,3619,1363,2.655172414,2812,2368,578,245,239,6,78,2,0.071129707,0,empty,CD-0722-4
"H6,F7",10183,11220,7597,3623,6206,3097,0,3097,2157,940,2.294680851,1741,1014,164,59,55,4,18,2,0.218181818,0,empty,CD-0722-4
"H6,F8",8550,9825,6488,3337,5211,2679,0,2686,1908,778,2.452442159,1569,225,17,13,13,0,8,0,0,0,empty,CD-0722-4
"H6,F9",9235,9992,6908,3084,5369,2637,1,2642,1937,705,2.74751773,1457,2194,392,151,150,1,50,1,0.02,0,empty,CD-0722-4
"H6,F10",12517,13827,9428,4399,7394,3750,0,3750,2676,1074,2.491620112,2106,1585,277,134,132,2,46,1,0.007575758,0,empty,CD-0722-4
"H6,F11",8274,8979,6347,2632,4674,2188,0,2189,1479,710,2.083098592,1183,1238,225,55,52,3,20,1,0.096153846,0,empty,CD-0722-4
"H6,F12",9323,9680,6786,2894,5345,2643,6,2651,1896,755,2.511258278,1445,167,8,5,5,0,3,0,0,0,empty,CD-0722-4
"H6,G1",9854,10640,7256,3384,5886,2945,0,2951,2022,929,2.176533907,1660,1544,345,151,151,0,44,0,0.013245033,0,empty,CD-0722-4
"H6,G2",4752,5234,3358,1876,2736,1454,0,1458,921,537,1.715083799,827,260,57,27,27,0,11,0,0,0,empty,CD-0722-4
"H6,G3",9513,10301,7058,3243,5660,2827,0,2829,1802,1027,1.754625122,1554,2068,686,303,300,3,52,2,0.143333333,0,empty,CD-0722-4
"H6,G4",1277897,1526797,885169,641628,744357,486516,2,486888,357375,129513,2.759375507,290167,206,6,3,3,0,3,0,0,0,empty,CD-0722-4
"H6,G5",5145,5898,3817,2081,3096,1610,0,1610,1089,521,2.090211132,946,1185,257,94,94,0,23,0,0.14893617,0,empty,CD-0722-4
"H6,G6",9010,9443,6493,2950,5169,2508,0,2514,1753,761,2.303547963,1395,92,8,6,6,0,4,0,0,0,empty,CD-0722-4
"H6,G7",8067,8812,6071,2741,4645,2279,0,2283,1566,717,2.184100418,1253,2333,539,194,194,0,45,0,0.092783505,0,empty,CD-0722-4
"H6,G8",7040,7201,4995,2206,4079,1996,0,2001,1437,564,2.54787234,1089,1229,164,75,73,2,26,2,0.095890411,0,empty,CD-0722-4
"H6,G9",8745,9776,6361,3415,5366,2874,14,2888,1992,896,2.223214286,1659,1573,293,136,135,1,52,1,0.037037037,0,empty,CD-0722-4
"H6,G10",10487,11528,7792,3736,6243,3156,0,3158,2297,861,2.667828107,1773,2307,568,169,168,1,53,1,0.05952381,0,empty,CD-0722-4
"H6,G11",9626,10408,7155,3253,5599,2763,1,2768,1967,801,2.4556804,1574,976,145,75,73,2,23,1,0,0,empty,CD-0722-4
"H6,G12",5546,6212,4011,2201,3291,1825,0,1827,1240,587,2.112436116,1013,1366,296,111,108,3,23,1,0.037037037,0,empty,CD-0722-4
"H6,H1",10230,11462,7689,3773,6132,3158,0,3162,2232,930,2.4,1854,861,126,68,67,1,25,1,0.029850746,0,empty,CD-0722-4
"H6,H2",6964,7815,5100,2715,4204,2186,0,2187,1452,735,1.975510204,1282,1799,404,167,165,2,43,2,0.127272727,0,empty,CD-0722-4
"H6,H3",1057274,1221762,763903,457859,597768,358156,2,358425,271287,87138,3.113303037,210315,27313,17578,6142,6139,3,869,2,0.005701254,0,hg38,CD-0722-4
"H6,H4",10987,12226,8185,4041,6278,3064,1,3068,2087,981,2.127420999,1711,96,7,5,5,0,4,0,0,0,empty,CD-0722-4
"H6,H5",9771,10941,7188,3753,5939,3067,25,3097,2087,1010,2.066336634,1810,1587,479,200,200,0,42,0,0.025,0,empty,CD-0722-4
"H6,H6",7895,8887,5840,3047,4749,2495,0,2495,1723,772,2.231865285,1416,1686,366,144,143,1,47,1,0.104895105,0,empty,CD-0722-4
"H6,H7",7255,7944,5396,2548,4172,2075,32,2110,1450,660,2.196969697,1196,1716,402,139,139,0,34,0,0.079136691,0,empty,CD-0722-4
"H6,H8",12225,13949,9009,4940,7367,3921,6,3929,2869,1060,2.706603774,2299,1760,357,169,168,1,46,1,0.261904762,0,empty,CD-0722-4
"H6,H9",7895,8301,5991,2310,4457,2089,0,2089,1469,620,2.369354839,1155,1381,238,91,87,4,34,1,0.103448276,0,empty,CD-0722-4
"H6,H10",6128,6755,4396,2359,3547,1868,3,1874,1321,553,2.388788427,1068,840,226,93,93,0,27,0,0.11827957,0,empty,CD-0722-4
"H6,H11",6090,6807,4145,2662,3449,2042,0,2044,1076,968,1.111570248,1183,106,53,26,26,0,2,0,0,0,empty,CD-0722-4
"H6,H12",8532,9399,6236,3163,4939,2604,1,2612,1839,773,2.379042691,1498,905,189,89,88,1,19,1,0.045454545,0,empty,CD-0722-4
"H7,A1",6065,6587,4358,2229,3460,1847,0,1852,1221,631,1.935023772,1043,730,134,64,63,1,22,1,0.079365079,0,empty,CD-0722-4
"H7,A2",9115,10174,6581,3593,5220,2742,1,2744,1808,936,1.931623932,1582,1357,364,143,143,0,35,0,0.076923077,0,empty,CD-0722-4
"H7,A3",5318,5933,3943,1990,3171,1631,0,1631,1070,561,1.907308378,956,1018,251,94,93,1,25,1,0.086021505,0,empty,CD-0722-4
"H7,A4",8130,9028,5966,3062,4860,2447,5,2453,1588,865,1.83583815,1409,481,84,33,32,1,19,1,0,0,empty,CD-0722-4
"H7,A5",8773,9796,6373,3423,5145,2552,20,2572,1727,845,2.043786982,1479,1890,399,192,192,0,50,0,0.010416667,0,empty,CD-0722-4
"H7,A6",8707,9864,6358,3506,5267,2708,0,2708,1783,925,1.927567568,1575,3316,612,269,266,3,71,2,0.105263158,0,empty,CD-0722-4
"H7,A7",5781,6462,4328,2134,3380,1797,0,1797,1116,681,1.63876652,969,902,257,95,94,1,27,1,0.127659574,0,empty,CD-0722-4
"H7,A8",3823,4289,2850,1439,2285,1192,0,1193,824,369,2.233062331,670,1479,314,137,137,0,41,0,0.01459854,0,empty,CD-0722-4
"H7,A9",7173,8130,5341,2789,4178,2112,0,2112,1402,710,1.974647887,1212,1526,324,128,125,3,32,1,0.104,0,empty,CD-0722-4
"H7,A10",7907,8877,5933,2944,4575,2301,1,2304,1459,845,1.726627219,1342,334,98,35,35,0,11,0,0.028571429,0,empty,CD-0722-4
"H7,A11",5605,6201,4222,1979,3206,1516,11,1531,1034,497,2.080482897,872,1062,205,79,79,0,26,0,0.101265823,0,empty,CD-0722-4
"H7,A12",9035,10009,6708,3301,5186,2527,0,2529,1715,814,2.106879607,1444,2604,567,247,245,2,69,2,0.085714286,0,empty,CD-0722-4
"H7,B1",5811,6364,4401,1963,3250,1639,0,1640,1054,586,1.798634812,885,1130,167,69,66,3,25,1,0.151515152,0,empty,CD-0722-4
"H7,B2",5909,6410,4064,2346,3329,1801,5,1808,1165,643,1.811819596,1066,344,119,45,45,0,6,0,0,0,empty,CD-0722-4
"H7,B3",6105,6826,4448,2378,3608,1870,0,1870,1232,638,1.931034483,1069,1112,311,111,110,1,28,1,0.154545455,0,empty,CD-0722-4
"H7,B4",6536,7225,4740,2485,3860,2103,6,2114,1326,788,1.682741117,1211,752,236,99,98,1,31,1,0.040816327,0,empty,CD-0722-4
"H7,B5",9190,5401,3446,1955,3521,1771,0,1785,1254,531,2.361581921,1129,1308,309,112,111,1,28,1,0.558558559,0,empty,CD-0722-4
"H7,B6",7503,8256,5461,2795,4268,2202,7,2209,1429,780,1.832051282,1293,985,126,52,52,0,24,0,0.019230769,0,empty,CD-0722-4
"H7,B7",34356,39867,25314,14553,19769,11422,10,11445,7511,3934,1.909252669,6615,895,214,71,71,0,30,0,0.070422535,0,empty,CD-0722-4
"H7,B8",5849,6450,4390,2060,3302,1642,0,1642,1125,517,2.176015474,902,892,233,106,106,0,25,0,0.141509434,0,empty,CD-0722-4
"H7,B9",9620,10608,6976,3632,5436,2885,0,2891,1887,1004,1.879482072,1657,871,164,81,80,1,26,1,0.025,0,empty,CD-0722-4
"H7,B10",5276,5793,3717,2076,3156,1645,1,1649,1095,554,1.976534296,990,318,50,23,23,0,9,0,0,0,empty,CD-0722-4
"H7,B11",10331,11462,7538,3924,5880,3186,17,3208,1900,1308,1.452599388,1845,299,143,56,56,0,13,0,0.357142857,0,empty,CD-0722-4
"H7,B12",6466,7259,4800,2459,3765,1878,0,1878,1297,581,2.232358003,1090,1185,285,115,113,2,30,2,0.008849558,0,empty,CD-0722-4
"H7,C1",10851,11631,8213,3418,6013,2873,0,2875,1892,983,1.924720244,1561,739,178,64,61,3,23,1,0.016393443,0,empty,CD-0722-4
"H7,C2",8375,9328,6223,3105,4829,2426,17,2445,1646,799,2.060075094,1345,1511,259,119,116,3,35,1,0.00862069,0,empty,CD-0722-4
"H7,C3",9517,10343,6913,3430,5500,2761,0,2762,1765,997,1.770310933,1567,1134,363,146,146,0,25,0,0.061643836,0,empty,CD-0722-4
"H7,C4",6559,7246,4848,2398,3816,1865,0,1869,1294,575,2.250434783,1072,1286,311,116,116,0,38,0,0.051724138,0,empty,CD-0722-4
"H7,C5",2635573,3206572,1904528,1302044,1551891,984399,2,985106,680235,304871,2.231222386,604812,64182,19763,7637,7588,49,1272,5,0.034001054,0,hg38,CD-0722-4
"H7,C6",6986,7744,5093,2651,4196,2188,2,2192,1408,784,1.795918367,1262,1004,294,110,109,1,26,1,0.091743119,0,empty,CD-0722-4
"H7,C7",9270,10612,6633,3979,5519,3097,1,3104,1846,1258,1.467408585,1846,306,87,37,37,0,11,0,0,0,empty,CD-0722-4
"H7,C8",23234,25559,17767,7792,12714,6120,0,6131,4441,1690,2.627810651,3405,3996,1104,433,431,2,97,1,0.143851508,0,empty,CD-0722-4
"H7,C9",8554,9643,6163,3480,5003,2565,49,2619,1756,863,2.034762457,1516,1038,248,78,78,0,24,0,0.076923077,0,empty,CD-0722-4
"H7,C10",7802,8620,6061,2559,4396,2130,1,2134,1346,788,1.708121827,1149,1364,390,156,155,1,40,1,0,0,empty,CD-0722-4
"H7,C11",7244,8117,5447,2670,4217,2058,0,2062,1354,708,1.912429379,1169,1351,456,182,180,2,42,1,0.038888889,0,empty,CD-0722-4
"H7,C12",983808,1060257,767012,293245,514198,229000,3,229279,169053,60226,2.806977053,126239,140429,18226,6968,6806,162,1159,5,0.045694975,0,hg38,CD-0722-4
"H7,D1",1153249,1342832,842212,500620,662337,390377,5,390639,253836,136803,1.855485625,234084,5469,1062,381,378,3,83,1,0.015873016,0,hg38,CD-0722-4
"H7,D2",6694,7303,5158,2145,3767,1758,2,1765,1125,640,1.7578125,970,1854,380,189,187,2,54,1,0.085561497,0,empty,CD-0722-4
"H7,D3",7113,7956,5147,2809,4164,2191,1,2192,1499,693,2.163059163,1246,823,232,114,114,0,25,0,0.114035088,0,empty,CD-0722-4
"H7,D4",5527,6194,4147,2047,3199,1634,1,1635,1055,580,1.818965517,939,1268,282,113,110,3,28,2,0,0,empty,CD-0722-4
"H7,D5",6103,6817,4563,2254,3517,1753,0,1755,1098,657,1.671232877,1004,1747,418,167,166,1,34,1,0.265060241,0,empty,CD-0722-4
"H7,D6",8614,9540,6028,3512,4802,2606,0,2615,1559,1056,1.476325758,1539,1027,359,127,125,2,40,1,0.096,0,empty,CD-0722-4
"H7,D7",5133,5658,3861,1797,3003,1447,1,1451,943,508,1.856299213,831,1070,237,116,116,0,38,0,0.00862069,0,empty,CD-0722-4
"H7,D8",6243,6887,4609,2278,3634,1851,0,1851,1207,644,1.874223602,1090,998,295,97,97,0,29,0,0.18556701,0,empty,CD-0722-4
"H7,D9",3611,3880,2704,1176,1999,905,5,914,629,285,2.207017544,486,1038,241,112,111,1,30,1,0.126126126,0,empty,CD-0722-4
"H7,D10",6641,7492,4788,2704,3811,1979,0,1982,1237,745,1.660402685,1156,1252,119,63,62,1,21,1,0,0,empty,CD-0722-4
"H7,D11",6940,7556,5089,2467,3949,1982,0,1982,1215,767,1.584093872,1119,2870,431,187,180,7,36,2,0.261111111,0,empty,CD-0722-4
"H7,D12",1420158,1645076,1052431,592645,792648,445529,4,445926,348543,97383,3.579094914,261986,291095,48381,19142,18821,321,2363,7,0.034748419,0,hg38,CD-0722-4
"H7,E1",12838,14632,9430,5202,7392,3809,0,3814,2481,1333,1.861215304,2216,2211,471,208,204,4,61,2,0.166666667,0,empty,CD-0722-4
"H7,E2",7449,8488,5514,2974,4427,2300,0,2302,1431,871,1.64293915,1371,1600,365,148,147,1,47,1,0.027210884,0,empty,CD-0722-4
"H7,E3",4965,5406,3781,1625,2896,1386,12,1403,922,481,1.916839917,770,1550,427,164,164,0,39,0,0.012195122,0,empty,CD-0722-4
"H7,E4",1098381,1222051,834108,387943,593559,299069,4,299362,233222,66140,3.526186876,169888,174916,25583,10108,9889,219,1460,6,0.026898574,0,hg38,CD-0722-4
"H7,E5",891248,946424,704694,241730,461535,197662,5,197889,150510,47379,3.176723865,105007,49282,9838,3442,3398,44,584,4,0.01559741,0,hg38,CD-0722-4
"H7,E6",12001,13403,8871,4532,6824,3401,72,3474,2316,1158,2,1950,1930,389,177,177,0,53,0,0.163841808,0,empty,CD-0722-4
"H7,E7",11769,13213,8827,4386,6822,3334,1,3337,2280,1057,2.15704825,1912,2227,505,236,233,3,67,1,0.111587983,0,empty,CD-0722-4
"H7,E8",8628,9306,6617,2689,4960,2367,0,2367,1588,779,2.038510911,1296,2041,574,255,250,5,66,1,0.072,0,empty,CD-0722-4
"H7,E9",5834,6418,4363,2055,3338,1638,0,1639,1137,502,2.264940239,934,1461,460,197,196,1,50,1,0.051020408,0,empty,CD-0722-4
"H7,E10",6086,6646,4497,2149,3455,1737,0,1738,1122,616,1.821428571,991,1657,447,166,166,0,38,0,0.042168675,0,empty,CD-0722-4
"H7,E11",7153,7966,5288,2678,4183,2108,0,2110,1365,745,1.832214765,1190,1797,413,132,131,1,35,1,0,0,empty,CD-0722-4
"H7,E12",2156800,2530520,1577950,952570,1215107,692564,5,693184,559477,133707,4.184350857,414963,112324,21934,8842,8724,118,1463,8,0.033470885,0,hg38,CD-0722-4
"H7,F1",14762,16071,11039,5032,8048,3775,1,3777,2526,1251,2.019184652,2170,5501,1284,545,543,2,112,1,0.106813996,0,empty,CD-0722-4
"H7,F2",7376,7935,5384,2551,4092,2012,8,2022,1343,679,1.977908689,1139,1535,311,137,137,0,45,0,0.102189781,0,empty,CD-0722-4
"H7,F3",7740,8253,5829,2424,4318,2076,1,2078,1414,664,2.129518072,1128,1797,416,163,162,1,54,1,0.00617284,0,empty,CD-0722-4
"H7,F4",1413687,1695295,984526,710769,839885,543648,9,544060,379320,164740,2.302537332,330185,2584,151,88,85,3,34,1,0.047058824,0,empty,CD-0722-4
"H7,F5",8081,8542,6068,2474,4379,1932,1,1936,1240,696,1.781609195,1038,1602,334,151,151,0,44,0,0.026490066,0,empty,CD-0722-4
"H7,F6",12292,14077,9028,5049,7214,3786,1,3795,2604,1191,2.186397985,2233,2721,617,252,250,2,70,2,0.016,0,empty,CD-0722-4
"H7,F7",9136,10078,6699,3379,5334,2702,0,2711,1722,989,1.741152679,1565,1061,199,89,83,6,20,1,0.024096386,0,empty,CD-0722-4
"H7,F8",6990,7490,5127,2363,3975,1958,1,1961,1295,666,1.944444444,1104,214,56,17,17,0,7,0,0,0,empty,CD-0722-4
"H7,F9",7598,8608,5664,2944,4461,2209,3,2212,1510,702,2.150997151,1273,1670,418,168,168,0,49,0,0.071428571,0,empty,CD-0722-4
"H7,F10",9200,9960,7033,2927,5162,2515,7,2522,1667,855,1.949707602,1386,1185,347,109,101,8,35,2,0.158415842,0,empty,CD-0722-4
"H7,F11",1105263,1301925,793722,508203,636643,393277,4,393622,287445,106177,2.707224729,231386,28812,1202,502,465,37,105,3,0.275268817,0,hg38,CD-0722-4
"H7,F12",8276,8859,6099,2760,4616,2275,0,2277,1519,758,2.003957784,1256,162,11,7,7,0,7,0,0,0,empty,CD-0722-4
"H7,G1",9083,9885,6925,2960,5168,2480,5,2485,1700,785,2.165605096,1354,1932,401,162,161,1,45,1,0.074534161,0,empty,CD-0722-4
"H7,G2",4523,4928,3271,1657,2500,1304,1,1305,839,466,1.800429185,738,263,52,30,30,0,8,0,0.2,0,empty,CD-0722-4
"H7,G3",9182,9854,6813,3041,5319,2705,0,2710,1613,1097,1.470373747,1483,1645,356,155,153,2,34,2,0.032679739,0,empty,CD-0722-4
"H7,G4",15917,17888,11517,6371,9236,5070,17,5096,3182,1914,1.662486938,2936,50,7,3,3,0,2,0,0,0,empty,CD-0722-4
"H7,G5",8447,7261,4630,2631,3645,1834,21,1856,1221,635,1.922834646,1109,1229,318,148,148,0,33,0,0.114864865,0,empty,CD-0722-4
"H7,G6",8372,9171,6161,3010,4632,2236,48,2286,1525,761,2.003942181,1251,123,17,13,13,0,8,0,0,0,empty,CD-0722-4
"H7,G7",7189,7883,5538,2345,4037,1918,0,1920,1258,662,1.900302115,1035,1805,432,152,150,2,54,1,0.2,0,empty,CD-0722-4
"H7,G8",5050,5654,3706,1948,2889,1463,0,1464,971,493,1.969574037,842,1601,206,108,107,1,43,1,0.074766355,0,empty,CD-0722-4
"H7,G9",6545,7382,4900,2482,3796,1880,0,1881,1266,615,2.058536585,1085,1832,499,213,210,3,59,3,0.00952381,0,empty,CD-0722-4
"H7,G10",8311,9411,6294,3117,4935,2462,0,2469,1601,868,1.844470046,1425,2051,477,215,209,6,57,1,0.100478469,0,empty,CD-0722-4
"H7,G11",7771,8592,5959,2633,4426,2166,0,2168,1426,742,1.921832884,1182,1206,237,95,95,0,37,0,0.052631579,0,empty,CD-0722-4
"H7,G12",5580,6013,4080,1933,3210,1646,0,1646,1044,602,1.734219269,939,1416,289,99,98,1,31,1,0.030612245,0,empty,CD-0722-4
"H7,H1",8012,8934,5869,3065,4604,2286,27,2314,1597,717,2.227336123,1358,833,141,62,60,2,24,1,0.033333333,0,empty,CD-0722-4
"H7,H2",7127,7897,5145,2752,4157,2082,16,2100,1346,754,1.785145889,1226,1675,447,164,163,1,45,1,0.079754601,0,empty,CD-0722-4
"H7,H3",6627,7573,4868,2705,3873,1999,0,1999,1379,620,2.224193548,1160,1248,258,110,108,2,24,1,0.203703704,0,empty,CD-0722-4
"H7,H4",8437,9341,6186,3155,4793,2335,29,2365,1602,763,2.099606815,1340,48,7,4,4,0,4,0,0,0,empty,CD-0722-4
"H7,H5",8908,9903,6596,3307,5125,2642,0,2644,1725,919,1.877040261,1531,1684,511,201,200,1,43,1,0.06,0,empty,CD-0722-4
"H7,H6",6862,7656,4967,2689,4017,2120,0,2125,1400,725,1.931034483,1247,1549,184,102,99,3,39,2,0.151515152,0,empty,CD-0722-4
"H7,H7",6962,7598,5063,2535,4062,2092,0,2093,1362,731,1.863201094,1198,1589,582,179,179,0,38,0,0.162011173,0,empty,CD-0722-4
"H7,H8",9451,10543,6904,3639,5462,2889,0,2890,1999,891,2.243546577,1673,1575,299,149,147,2,56,1,0.013605442,0,empty,CD-0722-4
"H7,H9",6462,6990,4980,2010,3653,1654,7,1661,1116,545,2.047706422,915,1002,198,83,79,4,26,3,0.012658228,0,empty,CD-0722-4
"H7,H10",5144,5583,3771,1812,2853,1401,0,1401,930,471,1.974522293,780,1172,330,110,108,2,24,1,0.101851852,0,empty,CD-0722-4
"H7,H11",6686,7605,4766,2839,3919,2298,0,2298,1341,957,1.401253918,1341,47,0,0,0,0,0,0,0,0,empty,CD-0722-4
"H7,H12",985520,1074170,744030,330140,527295,259701,0,259953,201478,58475,3.445540829,148493,73243,10950,4002,3911,91,715,3,0.021733572,0,hg38,CD-0722-4
"H8,A1",9918,11220,7259,3961,6062,3199,0,3199,2104,1095,1.921461187,1908,1473,165,65,65,0,22,0,0.076923077,0,empty,CD-0722-4
"H8,A2",14750,16201,11050,5151,8328,4160,0,4167,2709,1458,1.858024691,2268,2679,642,255,249,6,66,1,0.088353414,0,empty,CD-0722-4
"H8,A3",10698,11994,7860,4134,6331,3176,0,3183,2198,985,2.231472081,1863,2655,624,242,238,4,51,2,0.050420168,0,empty,CD-0722-4
"H8,A4",33365,37291,25461,11830,18569,8888,4,8901,5980,2921,2.047244094,4978,2696,668,250,248,2,54,1,0.116935484,0,empty,CD-0722-4
"H8,A5",630347,753719,433253,320466,375605,242241,2,242387,181829,60558,3.00255953,147125,7669,1339,435,421,14,106,2,0.083135392,0,hg38,CD-0722-4
"H8,A6",376990,461537,269277,192260,232751,140959,5,141071,106201,34870,3.045626613,86109,74649,12561,4927,4843,84,857,3,0.073095189,0,hg38,CD-0722-4
"H8,A7",9562,10834,7060,3774,5701,2954,1,2956,1931,1025,1.883902439,1720,1481,350,144,144,0,32,0,0.097222222,0,empty,CD-0722-4
"H8,A8",7136,7847,5177,2670,4267,2178,0,2178,1543,635,2.42992126,1240,1967,494,200,200,0,52,0,0.02,0,empty,CD-0722-4
"H8,A9",10826,11888,8334,3554,6290,3042,0,3051,2017,1034,1.950676983,1644,2215,480,186,184,2,51,1,0.081521739,0,empty,CD-0722-4
"H8,A10",11837,12858,9094,3764,6593,3136,1,3139,2078,1061,1.958529689,1743,866,389,121,121,0,19,0,0.024793388,0,empty,CD-0722-4
"H8,A11",76981,92924,54710,38214,47119,30578,0,30593,17386,13207,1.316423109,17747,2199,530,196,195,1,47,1,0.158974359,0,empty,CD-0722-4
"H8,A12",13746,14980,10400,4580,7907,3887,6,3902,2659,1243,2.139179405,2166,5840,1183,486,482,4,119,2,0.072614108,0,empty,CD-0722-4
"H8,B1",10850,11974,7960,4014,6202,3085,0,3086,1878,1208,1.554635762,1759,1659,561,199,199,0,46,0,0.020100503,0,empty,CD-0722-4
"H8,B2",11231,11993,7851,4142,6377,3369,2,3373,2154,1219,1.767022149,1942,705,246,86,85,1,20,1,0,0,empty,CD-0722-4
"H8,B3",9222,10424,6554,3870,5585,2930,0,2935,1979,956,2.070083682,1730,1846,438,191,191,0,36,0,0.120418848,0,empty,CD-0722-4
"H8,B4",11191,12704,8155,4549,6605,3520,0,3523,2202,1321,1.666919001,2059,1309,379,147,143,4,39,1,0,0,empty,CD-0722-4
"H8,B5",16963,13373,9103,4270,7831,3829,1,3846,2743,1103,2.486854034,2257,1105,179,58,58,0,18,0,0.017241379,0,empty,CD-0722-4
"H8,B6",12240,13798,8864,4934,7212,3967,3,3971,2501,1470,1.701360544,2348,1915,527,224,222,2,62,2,0.144144144,0,empty,CD-0722-4
"H8,B7",47811,55519,36079,19440,27758,14905,0,14921,11726,3195,3.670109546,8551,1863,504,156,155,1,39,1,0.161290323,0,empty,CD-0722-4
"H8,B8",9276,10489,6992,3497,5630,2862,0,2866,1906,960,1.985416667,1656,1371,300,115,110,5,29,1,0,0,empty,CD-0722-4
"H8,B9",557003,657071,396690,260381,335151,207285,0,207432,139447,67985,2.051143635,126317,2526,811,279,274,5,80,2,0.102189781,0,hg38,CD-0722-4
"H8,B10",8008,8587,5768,2819,4827,2362,25,2392,1609,783,2.054916986,1348,729,59,25,21,4,10,1,0.095238095,0,empty,CD-0722-4
"H8,B11",439626,555637,287091,268546,277127,197135,10,197256,128504,68752,1.869094717,123946,265,84,40,40,0,12,0,0,0,empty,CD-0722-4
"H8,B12",9716,10845,7207,3638,5836,2970,0,2971,2081,890,2.338202247,1736,2173,529,214,209,5,42,1,0.119617225,0,empty,CD-0722-4
"H8,C1",19643,20858,14863,5995,11138,5332,0,5337,3568,1769,2.016958734,2832,1650,344,140,140,0,45,0,0.157142857,0,empty,CD-0722-4
"H8,C2",15231,16681,11112,5569,8761,4416,22,4442,2923,1519,1.924292298,2538,3189,805,335,332,3,74,1,0.051204819,0,empty,CD-0722-4
"H8,C3",15978,17110,11841,5269,9161,4432,0,4433,2834,1599,1.772357724,2447,1696,440,193,193,0,36,0,0.139896373,0,empty,CD-0722-4
"H8,C4",10718,11526,8065,3461,6059,2864,2,2878,1913,965,1.98238342,1556,2064,516,199,199,0,51,0,0.130653266,0,empty,CD-0722-4
"H8,C5",14498,15998,10736,5262,8395,4318,0,4324,2859,1465,1.951535836,2445,1763,382,153,151,2,50,1,0.066225166,0,empty,CD-0722-4
"H8,C6",12446,13623,9283,4340,7225,3630,0,3632,2381,1251,1.903277378,1989,2890,693,293,292,1,63,1,0.102739726,0,empty,CD-0722-4
"H8,C7",16433,18754,11780,6974,9867,5474,0,5483,3466,2017,1.718393654,3323,655,137,38,38,0,11,0,0.263157895,0,empty,CD-0722-4
"H8,C8",17609,19295,13070,6225,10050,5092,0,5092,3425,1667,2.054589082,2866,4113,1005,362,358,4,81,2,0.055865922,0,empty,CD-0722-4
"H8,C9",814380,886354,632233,254121,432101,199975,2,200198,160142,40056,3.997952866,110917,28441,5663,2070,2036,34,383,5,0.008840864,0,hg38,CD-0722-4
"H8,C10",14101,15652,10722,4930,8039,4021,0,4022,2640,1382,1.910274964,2194,2137,452,190,186,4,49,3,0.107526882,0,empty,CD-0722-4
"H8,C11",12691,13736,9507,4229,7388,3600,0,3602,2346,1256,1.867834395,2034,2343,514,194,193,1,49,1,0.07253886,0,empty,CD-0722-4
"H8,C12",1148237,1307879,851925,455954,631231,341640,29,341982,266392,75590,3.524169864,200767,12666,1724,605,595,10,176,3,0.040336134,0,hg38,CD-0722-4
"H8,D1",19884,22593,14680,7913,11493,5931,0,5939,3664,2275,1.610549451,3499,1416,184,79,79,0,28,0,0.164556962,0,empty,CD-0722-4
"H8,D2",12998,13718,9887,3831,7197,3348,3,3359,2128,1231,1.728675873,1769,3449,882,379,373,6,90,1,0.080428954,0,empty,CD-0722-4
"H8,D3",11519,12701,8350,4351,6576,3276,38,3319,2294,1025,2.23804878,1868,1353,363,135,133,2,33,2,0.015037594,0,empty,CD-0722-4
"H8,D4",8894,10185,6640,3545,5485,2820,0,2820,1913,907,2.109151047,1632,1612,394,177,174,3,45,1,0.149425287,0,empty,CD-0722-4
"H8,D5",9840,11348,7295,4053,5889,2932,16,2950,1890,1060,1.783018868,1796,1487,253,120,120,0,37,0,0.216666667,0,empty,CD-0722-4
"H8,D6",16433,18361,11971,6390,9503,5093,0,5094,3079,2015,1.528039702,2959,2937,732,277,276,1,70,1,0.086956522,0,empty,CD-0722-4
"H8,D7",8384,9042,6432,2610,4741,2204,0,2204,1478,726,2.035812672,1192,2310,585,199,199,0,53,0,0.150753769,0,empty,CD-0722-4
"H8,D8",10359,11084,7686,3398,5960,2930,0,2936,1902,1034,1.839458414,1641,1148,304,125,121,4,35,1,0.066115702,0,empty,CD-0722-4
"H8,D9",5778,6403,4421,1982,3369,1685,0,1687,1114,573,1.944153578,942,1557,286,128,128,0,38,0,0.046875,0,empty,CD-0722-4
"H8,D10",10168,11344,7467,3877,6037,3111,0,3115,1938,1177,1.646559048,1808,1042,173,76,76,0,19,0,0.078947368,0,empty,CD-0722-4
"H8,D11",11800,12905,8895,4010,6818,3386,0,3390,2162,1228,1.760586319,1896,3670,996,366,361,5,72,2,0.099722992,0,empty,CD-0722-4
"H8,D12",15640,17244,11660,5584,9079,4454,19,4473,3065,1408,2.176846591,2549,4230,1052,410,409,1,106,1,0.007334963,0,empty,CD-0722-4
"H8,E1",19505,21102,14592,6510,10778,5273,0,5273,3440,1833,1.876704855,2889,2582,567,243,240,3,73,2,0.045833333,0,empty,CD-0722-4
"H8,E2",13659,15208,9938,5270,7864,3993,15,4010,2618,1392,1.880747126,2303,2286,406,194,188,6,58,2,0.138297872,0,empty,CD-0722-4
"H8,E3",8761,9889,6608,3281,5086,2502,0,2507,1628,879,1.852104664,1402,2492,724,317,314,3,80,2,0.015923567,0,empty,CD-0722-4
"H8,E4",12744,14148,9482,4666,7436,3742,2,3747,2528,1219,2.073831009,2112,2469,546,229,224,5,50,2,0.147321429,0,empty,CD-0722-4
"H8,E5",16977,18652,12965,5687,9454,4367,11,4378,2992,1386,2.158730159,2395,4375,835,327,324,3,67,1,0.067901235,0,empty,CD-0722-4
"H8,E6",1969176,2269881,1430538,839343,1076614,621269,5,621852,505441,116411,4.341866318,364884,147172,28093,9485,9379,106,1750,6,0.028041369,0,hg38,CD-0722-4
"H8,E7",19669,21335,14561,6774,11320,5603,9,5613,3802,1811,2.099392601,3144,3423,829,312,311,1,87,1,0.01607717,0,empty,CD-0722-4
"H8,E8",16033,17213,12203,5010,9165,4299,0,4302,2911,1391,2.092739037,2358,3526,791,344,343,1,85,1,0.040816327,0,empty,CD-0722-4
"H8,E9",9043,9978,6800,3178,5312,2675,0,2680,1778,902,1.971175166,1532,3389,724,276,272,4,63,2,0.069852941,0,empty,CD-0722-4
"H8,E10",10501,11539,7791,3748,6093,2943,0,2945,2008,937,2.143009605,1684,2877,524,236,231,5,56,2,0.034632035,0,empty,CD-0722-4
"H8,E11",963914,1077933,733653,344280,527647,264097,5,264376,202087,62289,3.244344908,151443,146722,15628,5928,5746,182,956,9,0.092586147,0,hg38,CD-0722-4
"H8,E12",14028,15398,10307,5091,8053,4013,2,4019,2664,1355,1.966051661,2302,2124,350,126,125,1,38,1,0.056,0,empty,CD-0722-4
"H8,F1",15633,16773,11607,5166,8901,4469,5,4480,2872,1608,1.786069652,2496,2480,540,225,222,3,49,1,0.072072072,0,empty,CD-0722-4
"H8,F2",12145,13450,8868,4582,6983,3345,41,3388,2201,1187,1.854254423,1914,3252,661,266,264,2,74,2,0.068181818,0,empty,CD-0722-4
"H8,F3",12284,13582,9201,4381,7198,3643,6,3650,2413,1237,1.950687146,2050,2951,648,218,217,1,57,1,0.064516129,0,empty,CD-0722-4
"H8,F4",1252499,1392908,944519,448389,676778,346330,21,346723,278775,67948,4.102769765,197075,34977,5106,2033,1993,40,413,2,0.053186152,0,hg38,CD-0722-4
"H8,F5",14123,15130,10662,4468,8026,3690,0,3695,2437,1258,1.937201908,2027,2434,467,198,196,2,57,2,0.076530612,0,empty,CD-0722-4
"H8,F6",16298,18519,11974,6545,9848,5201,9,5212,3544,1668,2.12470024,3090,3594,727,305,304,1,92,1,0.006578947,0,empty,CD-0722-4
"H8,F7",16125,17606,11833,5773,9587,4854,0,4856,3238,1618,2.001236094,2805,1517,421,147,147,0,37,0,0.136054422,0,empty,CD-0722-4
"H8,F8",12636,13653,9380,4273,7443,3647,17,3667,2452,1215,2.018106996,2038,547,140,51,51,0,17,0,0.039215686,0,empty,CD-0722-4
"H8,F9",1814599,2097379,1368399,728980,999612,546051,3,546525,451868,94657,4.773740981,316458,263072,33623,13548,13228,320,2093,10,0.058890233,0,hg38,CD-0722-4
"H8,F10",16843,18608,12772,5836,9761,4651,14,4677,3082,1595,1.932288401,2618,2186,492,197,197,0,51,0,0.111675127,0,empty,CD-0722-4
"H8,F11",12304,13198,9431,3767,6881,3222,10,3234,2244,990,2.266666667,1766,1976,578,241,240,1,42,1,0.1125,0,empty,CD-0722-4
"H8,F12",12985,14360,9602,4758,7549,3735,0,3736,2570,1166,2.204116638,2163,362,101,39,38,1,13,1,0.315789474,0,empty,CD-0722-4
"H8,G1",15019,16638,11214,5424,8900,4378,0,4382,2844,1538,1.849154746,2519,3190,920,362,355,7,77,2,0.076056338,0,empty,CD-0722-4
"H8,G2",1251265,1424452,914653,509799,694277,387087,3,387399,314466,72933,4.311710748,226532,31820,4924,1957,1920,37,430,3,0.042708333,0,hg38,CD-0722-4
"H8,G3",15616,16776,11684,5092,8739,4315,0,4316,2715,1601,1.695815116,2250,2681,760,273,271,2,53,2,0.088560886,0,empty,CD-0722-4
"H8,G4",27074,30477,19572,10905,15478,8490,0,8494,5306,3188,1.664366374,4822,45,4,3,3,0,2,0,0,0,empty,CD-0722-4
"H8,G5",9523,10349,7096,3253,5400,2712,0,2715,1747,968,1.804752066,1504,1824,468,200,199,1,46,1,0.155778894,0,empty,CD-0722-4
"H8,G6",14238,15598,10990,4608,8063,3830,5,3842,2569,1273,2.018067557,2003,261,92,42,41,1,10,1,0,0,empty,CD-0722-4
"H8,G7",12069,13047,9169,3878,6922,3248,18,3269,2195,1074,2.043761639,1766,3168,690,295,293,2,77,1,0.075085324,0,empty,CD-0722-4
"H8,G8",8782,9435,6459,2976,5006,2505,0,2510,1637,873,1.875143184,1406,2630,658,247,245,2,57,1,0.081632653,0,empty,CD-0722-4
"H8,G9",15824,18276,11396,6880,9643,5284,0,5290,3555,1735,2.048991354,3143,3474,742,314,309,5,81,2,0.126213592,0,empty,CD-0722-4
"H8,G10",13108,14426,9807,4619,7693,3868,0,3872,2571,1301,1.976172175,2170,3131,761,325,321,4,85,2,0.00623053,0,empty,CD-0722-4
"H8,G11",13402,14803,10173,4630,7687,3639,0,3642,2425,1217,1.992604766,2012,1947,498,187,187,0,54,0,0.005347594,0,empty,CD-0722-4
"H8,G12",2020164,2295946,1513490,782456,1110496,590328,19,590823,446003,144820,3.079705842,347945,214064,37732,14171,13952,219,1913,7,0.036983945,0,hg38,CD-0722-4
"H8,H1",26397,29160,19848,9312,14678,7055,12,7075,5173,1902,2.719768665,3997,4948,771,347,340,7,70,3,0.070588235,0,empty,CD-0722-4
"H8,H2",11848,12974,8750,4224,6812,3334,0,3341,2137,1204,1.774916944,1911,3225,595,260,257,3,63,1,0.058365759,0,empty,CD-0722-4
"H8,H3",751057,958680,490372,468308,479112,341506,3,341740,249316,92424,2.697524453,216263,3644,691,234,230,4,65,2,0.1,0,hg38,CD-0722-4
"H8,H4",14511,15819,10768,5051,8155,4002,4,4010,2623,1387,1.891131939,2259,134,11,9,9,0,4,0,0.444444444,0,empty,CD-0722-4
"H8,H5",63366,72949,44201,28748,35899,21711,4,21727,14389,7338,1.960888525,12761,3027,563,228,223,5,57,1,0.116591928,0,empty,CD-0722-4
"H8,H6",10700,12338,7747,4591,6372,3400,0,3405,2330,1075,2.16744186,2012,3891,446,208,203,5,65,2,0.123152709,0,empty,CD-0722-4
"H8,H7",11738,12701,8600,4101,6721,3280,0,3284,2204,1080,2.040740741,1856,2224,433,160,159,1,49,1,0.150943396,0,empty,CD-0722-4
"H8,H8",15151,16654,11093,5561,8858,4554,0,4561,3207,1354,2.368537666,2617,3248,753,290,286,4,74,2,0.129370629,0,empty,CD-0722-4
"H8,H9",13092,14078,9921,4157,7331,3438,2,3440,2305,1135,2.030837004,1884,1743,485,209,208,1,39,1,0.163461538,0,empty,CD-0722-4
"H8,H10",13362,14722,10026,4696,7528,3715,0,3724,2611,1113,2.34591195,2137,2721,471,192,185,7,52,1,0.054054054,0,empty,CD-0722-4
"H8,H11",11080,12862,7714,5148,6555,3888,0,3888,2080,1808,1.150442478,2331,31,0,0,0,0,0,0,0,0,empty,CD-0722-4
"H8,H12",10511,11482,7802,3680,5938,3035,0,3038,2109,929,2.270182992,1652,2058,498,206,203,3,37,2,0.206896552,0,empty,CD-0722-4
"H9,A1",10820,11841,7871,3970,6316,3290,0,3292,2208,1084,2.036900369,1884,1890,303,143,141,2,44,1,0.04964539,0,empty,CD-0722-4
"H9,A2",16162,18157,11790,6367,9373,4863,1,4865,3145,1720,1.828488372,2884,3142,874,370,370,0,72,0,0.197297297,0,empty,CD-0722-4
"H9,A3",944738,1064378,711288,353090,521473,266417,5,266661,210948,55713,3.786333531,153887,88606,11393,4681,4566,115,805,7,0.037888743,0,hg38,CD-0722-4
"H9,A4",18098,19852,13137,6715,10786,5440,0,5446,3612,1834,1.969465649,3108,1335,307,126,125,1,35,1,0.176,0,empty,CD-0722-4
"H9,A5",765284,842902,584183,258719,415661,200860,15,201080,149795,51285,2.920834552,113224,153814,18999,7639,7473,166,1264,7,0.043356082,0,hg38,CD-0722-4
"H9,A6",620516,726043,467825,258218,359324,193101,2,193266,152127,41139,3.697877926,113563,73723,12340,4931,4854,77,921,6,0.033374536,0,hg38,CD-0722-4
"H9,A7",778391,951793,548915,402878,474993,296872,0,297087,231953,65134,3.561166211,182987,12532,5952,2079,2077,2,494,1,0.031295137,0,hg38,CD-0722-4
"H9,A8",647731,780790,472567,308223,388827,222870,7,223058,175148,47910,3.655771238,135539,134517,28902,11334,11175,159,1651,9,0.053870246,0,hg38,CD-0722-4
"H9,A9",12435,13592,9169,4423,7216,3642,17,3663,2500,1163,2.14961307,2010,2692,509,166,165,1,60,1,0.109090909,0,empty,CD-0722-4
"H9,A10",13181,14603,9907,4696,7674,3849,26,3878,2574,1304,1.97392638,2180,743,132,49,49,0,19,0,0.040816327,0,empty,CD-0722-4
"H9,A11",898881,986919,699489,287430,479893,231579,5,231851,185803,46048,4.034985233,127222,88240,11158,4069,3979,90,763,4,0.01759236,0,hg38,CD-0722-4
"H9,A12",15116,16383,11369,5014,8507,4079,0,4082,2727,1355,2.012546125,2223,5320,941,370,370,0,107,0,0.064864865,0,empty,CD-0722-4
"H9,B1",14944,16475,10965,5510,8588,4399,0,4406,2799,1607,1.741754823,2483,3036,1079,344,340,4,70,2,0.129411765,0,empty,CD-0722-4
"H9,B2",12835,14093,8785,5308,7404,3917,26,3953,2447,1506,1.624833997,2397,917,176,73,69,4,21,2,0.086956522,0,empty,CD-0722-4
"H9,B3",10124,11395,7436,3959,6085,3080,23,3106,2055,1051,1.955280685,1797,2057,430,169,166,3,53,1,0.114457831,0,empty,CD-0722-4
"H9,B4",11233,12766,8060,4706,6747,3654,0,3655,2297,1358,1.691458027,2122,2176,581,238,236,2,59,2,0.203389831,0,empty,CD-0722-4
"H9,B5",15758,9290,5925,3365,6070,3221,0,3242,2168,1074,2.018621974,1968,1778,383,161,161,0,36,0,0.049689441,0,empty,CD-0722-4
"H9,B6",13353,15002,9750,5252,7945,4129,0,4131,2705,1426,1.896914446,2397,2823,534,209,208,1,55,1,0.057692308,0,empty,CD-0722-4
"H9,B7",1453150,1695078,1082674,612404,817820,455409,3,455801,372745,83056,4.48787565,265609,102464,15057,5649,5536,113,1046,4,0.029804913,0,hg38,CD-0722-4
"H9,B8",10141,11072,7560,3512,5782,2825,0,2827,1927,900,2.141111111,1529,1911,408,172,172,0,52,0,0.046511628,0,empty,CD-0722-4
"H9,B9",17431,19144,12842,6302,9918,5029,0,5032,3256,1776,1.833333333,2896,2103,438,198,195,3,56,1,0.051282051,0,empty,CD-0722-4
"H9,B10",8831,9732,6333,3399,5409,2767,2,2785,1776,1009,1.760158573,1674,706,105,42,42,0,13,0,0.047619048,0,empty,CD-0722-4
"H9,B11",18438,20397,13296,7101,10710,5860,0,5863,3437,2426,1.416735367,3350,624,163,60,59,1,20,1,0.13559322,0,empty,CD-0722-4
"H9,B12",11341,12700,8292,4408,6684,3370,1,3374,2301,1073,2.1444548,1999,3118,808,332,331,1,79,1,0.006042296,0,empty,CD-0722-4
"H9,C1",1445355,1573206,1115942,457264,747907,368526,1,368908,286425,82483,3.472533734,201996,53467,7952,3087,3027,60,582,4,0.030393129,0,hg38,CD-0722-4
"H9,C2",17256,19398,12350,7048,10135,5229,0,5238,3383,1855,1.823719677,3068,3860,1074,429,426,3,103,2,0.046948357,0,empty,CD-0722-4
"H9,C3",17229,18964,12671,6293,10029,5024,0,5030,3245,1785,1.817927171,2877,1132,95,47,46,1,21,1,0.02173913,0,empty,CD-0722-4
"H9,C4",1948253,2094859,1509170,585689,999481,475932,2,476418,388222,88196,4.401809606,261375,45288,8724,3106,3053,53,642,3,0.026858827,0,hg38,CD-0722-4
"H9,C5",16218,17938,11861,6077,9636,4920,0,4926,3291,1635,2.012844037,2836,2896,543,224,223,1,60,1,0.044843049,0,empty,CD-0722-4
"H9,C6",13407,14557,10017,4540,7949,4053,0,4059,2668,1391,1.918044572,2291,3166,899,362,361,1,73,1,0.108033241,0,empty,CD-0722-4
"H9,C7",18373,21499,12987,8512,11028,6220,0,6222,3722,2500,1.4888,3752,456,143,60,60,0,14,0,0,0,empty,CD-0722-4
"H9,C8",19739,21560,14769,6791,11194,5530,0,5533,3669,1864,1.968347639,3032,5173,1018,390,381,9,95,2,0.115485564,0,empty,CD-0722-4
"H9,C9",14801,16241,10916,5325,8586,4316,0,4316,2840,1476,1.924119241,2493,2795,404,167,161,6,48,1,0.00621118,0,empty,CD-0722-4
"H9,C10",15613,17327,11659,5668,8982,4479,0,4488,2892,1596,1.812030075,2488,3029,611,288,280,8,79,1,0.067857143,0,empty,CD-0722-4
"H9,C11",15105,16521,11206,5315,8651,4289,0,4298,2799,1499,1.86724483,2401,3435,824,318,313,5,81,1,0.089456869,0,empty,CD-0722-4
"H9,C12",20972,22501,15578,6923,12072,5857,21,5884,3969,1915,2.072584856,3272,3467,872,322,322,0,89,0,0.114906832,0,empty,CD-0722-4
"H9,D1",18170,20751,13131,7620,10840,5854,12,5874,3486,2388,1.459798995,3430,1050,259,109,108,1,28,1,0.166666667,0,empty,CD-0722-4
"H9,D2",860122,1015567,599363,416204,503960,322366,3,322629,229289,93340,2.456492393,190195,24543,2557,791,759,32,179,3,0.109354414,0,hg38,CD-0722-4
"H9,D3",12954,14299,9637,4662,7481,3744,0,3748,2501,1247,2.005613472,2105,2337,476,188,185,3,47,2,0.178378378,0,empty,CD-0722-4
"H9,D4",10680,11999,7913,4086,6379,3301,19,3323,2132,1191,1.790092359,1944,2416,547,245,245,0,63,0,0.06122449,0,empty,CD-0722-4
"H9,D5",11383,12832,8595,4237,6576,3316,0,3318,2143,1175,1.823829787,1866,2555,500,227,225,2,67,2,0.111111111,0,empty,CD-0722-4
"H9,D6",18097,20239,12838,7401,10423,5685,0,5694,3494,2200,1.588181818,3348,3293,776,324,321,3,71,2,0.08411215,0,empty,CD-0722-4
"H9,D7",9179,10088,6944,3144,5309,2561,0,2561,1669,892,1.871076233,1439,3532,1054,399,399,0,98,0,0.042606516,0,empty,CD-0722-4
"H9,D8",11707,12890,8609,4281,6921,3468,10,3481,2303,1178,1.955008489,1985,1689,326,137,136,1,54,1,0.036764706,0,empty,CD-0722-4
"H9,D9",6580,7099,4754,2345,3920,1945,0,1949,1293,656,1.971036585,1137,2163,546,217,217,0,53,0,0.004608295,0,empty,CD-0722-4
"H9,D10",12586,13902,9057,4845,7388,3843,2,3861,2428,1433,1.694347523,2254,2265,299,115,111,4,33,2,0.054054054,0,empty,CD-0722-4
"H9,D11",840267,987965,610877,377088,485117,275722,1,275950,221283,54667,4.047835074,166055,73680,23816,8713,8664,49,1423,3,0.04501385,0,hg38,CD-0722-4
"H9,D12",17654,19191,12939,6252,10162,5004,0,5007,3337,1670,1.998203593,2770,5748,1571,647,636,11,158,2,0.067610063,0,empty,CD-0722-4
"H9,E1",21671,23703,16013,7690,12431,6264,19,6298,4011,2287,1.753825973,3602,4275,1098,418,408,10,86,3,0.142156863,0,empty,CD-0722-4
"H9,E2",14338,15792,10523,5269,8303,4272,0,4278,2636,1642,1.605359318,2465,2785,495,224,211,13,62,2,0.170616114,0,empty,CD-0722-4
"H9,E3",10244,11116,7671,3445,5880,2854,0,2854,1901,953,1.99475341,1592,3856,925,408,405,3,107,2,0.118518519,0,empty,CD-0722-4
"H9,E4",14417,16198,10622,5576,8705,4485,0,4487,2869,1618,1.773176761,2650,4029,1011,424,423,1,97,1,0.085106383,0,empty,CD-0722-4
"H9,E5",12022,12834,9271,3563,6727,3022,0,3025,2034,991,2.05247225,1557,1784,387,168,166,2,32,1,0.06626506,0,empty,CD-0722-4
"H9,E6",21268,23378,15809,7569,12298,6153,0,6158,3912,2246,1.741763134,3578,5205,1384,504,493,11,108,2,0.070993915,0,empty,CD-0722-4
"H9,E7",24511,26702,18085,8617,14046,6855,0,6862,4524,2338,1.934987169,3915,4987,1254,529,520,9,128,2,0.086538462,0,empty,CD-0722-4
"H9,E8",17059,18446,12955,5491,9758,4648,0,4651,3034,1617,1.876314162,2524,4174,1028,435,431,4,110,3,0.039443155,0,empty,CD-0722-4
"H9,E9",10305,11403,7604,3799,6014,3033,0,3039,2019,1020,1.979411765,1754,3928,1072,423,420,3,107,1,0.135714286,0,empty,CD-0722-4
"H9,E10",957401,1048611,740455,308156,510278,240562,22,240835,181815,59020,3.08056591,134637,69641,15544,5857,5783,74,913,5,0.018502507,0,hg38,CD-0722-4
"H9,E11",13950,15239,10313,4926,8055,4090,0,4094,2679,1415,1.893286219,2332,2973,512,201,199,2,57,1,0.090452261,0,empty,CD-0722-4
"H9,E12",15260,16744,11254,5490,9020,4593,0,4595,3078,1517,2.029004614,2586,2808,585,262,260,2,66,2,0.107692308,0,empty,CD-0722-4
"H9,F1",17311,18764,12719,6045,9743,4796,0,4801,3098,1703,1.819142689,2694,3271,941,363,359,4,80,2,0.061281337,0,empty,CD-0722-4
"H9,F2",13945,15267,10246,5021,8157,4092,2,4096,2670,1426,1.872370266,2376,4518,963,400,388,12,101,2,0.06185567,0,empty,CD-0722-4
"H9,F3",29032,33286,21088,12198,16685,9095,0,9103,5804,3299,1.759321006,5319,4729,1379,538,536,2,110,2,0.108208955,0,empty,CD-0722-4
"H9,F4",25228,27945,17755,10190,14604,8107,0,8109,5708,2401,2.377342774,4791,1271,297,132,128,4,32,2,0.046875,0,empty,CD-0722-4
"H9,F5",984694,1046355,767214,279141,505707,226416,3,226654,170672,55982,3.048694223,120730,99773,18526,7309,7198,111,1152,4,0.017921645,0,hg38,CD-0722-4
"H9,F6",18151,19885,13188,6697,10735,5595,1,5619,3846,1773,2.169204738,3274,5600,1099,448,436,12,132,2,0.082568807,0,empty,CD-0722-4
"H9,F7",2281703,2516374,1729005,787369,1205660,618211,4,618834,508309,110525,4.599040941,352362,61345,11130,4278,4200,78,733,3,0.009761905,0,hg38,CD-0722-4
"H9,F8",13376,14471,9913,4558,7672,3759,0,3764,2502,1262,1.982567353,2122,452,52,27,26,1,16,1,0.038461538,0,empty,CD-0722-4
"H9,F9",14502,15746,10897,4849,8268,3975,0,3975,2702,1273,2.122545169,2156,4308,686,310,305,5,97,3,0.009836066,0,empty,CD-0722-4
"H9,F10",1630776,1830931,1243585,587346,871775,448108,2,448499,354947,93552,3.794114503,252913,146418,23157,8981,8794,187,1412,8,0.050943825,0,hg38,CD-0722-4
"H9,F11",13686,14710,10356,4354,7632,3549,0,3551,2323,1228,1.891693811,1909,3126,661,260,253,7,59,2,0.015810277,0,empty,CD-0722-4
"H9,F12",15965,17086,11610,5476,9078,4551,0,4552,3020,1532,1.971279373,2556,314,21,15,15,0,14,0,0.066666667,0,empty,CD-0722-4
"H9,G1",20456,22107,15296,6811,11448,5344,1,5360,3593,1767,2.033389926,2983,5291,1218,456,448,8,124,2,0.055803571,0,empty,CD-0722-4
"H9,G2",9299,10144,6591,3553,5348,2782,0,2782,1782,1000,1.782,1625,888,296,150,147,3,28,2,0.258503401,0,empty,CD-0722-4
"H9,G3",19438,21035,14231,6804,11063,5556,0,5561,3471,2090,1.66076555,3143,3748,1026,422,413,9,99,2,0.133171913,0,empty,CD-0722-4
"H9,G4",31769,35809,22627,13182,18439,10340,0,10346,6319,4027,1.569158182,6072,154,62,22,22,0,9,0,0,0,empty,CD-0722-4
"H9,G5",11058,12224,8152,4072,6430,3243,0,3248,2021,1227,1.647106764,1900,2668,516,179,174,5,58,2,0.040229885,0,empty,CD-0722-4
"H9,G6",18759,20115,14111,6004,10412,5057,21,5081,3553,1528,2.32526178,2744,434,18,12,11,1,7,1,0.090909091,0,empty,CD-0722-4
"H9,G7",14459,15314,10855,4459,8385,3830,18,3849,2583,1266,2.04028436,2125,4276,927,417,414,3,109,2,0.11352657,0,empty,CD-0722-4
"H9,G8",10515,11414,7846,3568,6021,2907,1,2911,1888,1023,1.845552297,1635,2552,586,229,225,4,71,3,0.08,0,empty,CD-0722-4
"H9,G9",14160,15680,10458,5222,8391,4346,0,4349,2901,1448,2.003453039,2517,3254,763,333,328,5,96,2,0.033536585,0,empty,CD-0722-4
"H9,G10",15393,17027,11333,5694,8915,4472,3,4480,2966,1514,1.959048877,2536,4020,994,398,386,12,110,2,0.062176166,0,empty,CD-0722-4
"H9,G11",1100382,1252616,822242,430374,609555,325124,11,325441,256927,68514,3.749992702,187434,105266,23365,9075,8988,87,1350,4,0.045282599,0,hg38,CD-0722-4
"H9,G12",11433,12984,8314,4670,6707,3505,0,3508,2289,1219,1.877768663,2061,3055,711,285,282,3,70,2,0.031914894,0,empty,CD-0722-4
"H9,H1",13387,14418,9714,4704,7718,3765,0,3767,2493,1274,1.956828885,2145,2370,574,201,198,3,54,2,0.075757576,0,empty,CD-0722-4
"H9,H2",20888,23421,15713,7708,12044,5953,15,5970,4174,1796,2.324053452,3438,6180,1443,547,542,5,116,2,0.060885609,0,empty,CD-0722-4
"H9,H3",26438,30309,19867,10442,15176,7658,0,7664,5386,2278,2.364354697,4487,4869,1202,492,485,7,107,2,0.107216495,0,empty,CD-0722-4
"H9,H4",15955,17414,11934,5480,9053,4426,0,4428,2896,1532,1.890339426,2461,297,63,32,32,0,16,0,0.25,0,empty,CD-0722-4
"H9,H5",3121392,3726240,2226808,1499432,1752977,1104196,44,1105205,863450,241755,3.571591074,664648,161802,31364,12178,12008,170,1776,9,0.048134577,0,hg38,CD-0722-4
"H9,H6",13069,14106,9510,4596,7492,3799,0,3801,2539,1262,2.011885895,2172,3333,690,247,241,6,80,2,0.174273859,0,empty,CD-0722-4
"H9,H7",14117,15263,10592,4671,8109,3818,1,3823,2563,1260,2.034126984,2144,5031,798,342,332,10,96,2,0.06626506,0,empty,CD-0722-4
"H9,H8",1002891,1174284,731023,443261,569223,319128,3,319413,257752,61661,4.180146284,190928,398362,44262,17805,17301,504,2229,11,0.066123345,0,hg38,CD-0722-4
"H9,H9",1103226,1262866,805343,457523,613256,338217,0,338493,294253,44240,6.651288427,198921,123329,30989,11029,10919,110,1690,8,0.030863632,0,hg38,CD-0722-4
"H9,H10",9839,10992,7199,3793,5750,2934,0,2936,1900,1036,1.833976834,1727,2571,425,200,199,1,54,1,0.065326633,0,empty,CD-0722-4
"H9,H11",12943,14914,9147,5767,7714,4566,1,4570,2470,2100,1.176190476,2706,39,0,0,0,0,0,0,0,0,empty,CD-0722-4
"H9,H12",11174,12274,8115,4159,6467,3403,0,3404,2273,1131,2.009725906,1946,2195,544,185,185,0,44,0,0.140540541,0,empty,CD-0722-4
"H10,A1",14248,15788,10602,5186,8230,4166,0,4176,2816,1360,2.070588235,2359,3917,751,286,284,2,73,2,0.042253521,0,empty,CD-0722-4
"H10,A2",15051,16495,11055,5440,8530,4340,0,4346,2807,1539,1.823911631,2444,2827,605,258,257,1,78,1,0.058365759,0,empty,CD-0722-4
"H10,A3",429238,533956,281443,252513,269755,188298,0,188438,115881,72557,1.597102967,117139,2361,586,227,226,1,66,1,0.199115044,0,hg38,CD-0722-4
"H10,A4",17299,18501,12772,5729,9700,4637,22,4661,3051,1610,1.895031056,2502,1349,238,111,111,0,44,0,0.162162162,0,empty,CD-0722-4
"H10,A5",759387,850036,566732,283304,421504,217196,29,217453,160099,57354,2.79141821,125925,117586,15071,5762,5645,117,1000,7,0.050132861,0,hg38,CD-0722-4
"H10,A6",30157,33537,22642,10895,17289,8766,11,8789,6462,2327,2.776966051,4921,5076,1095,450,447,3,130,2,0.089485459,0,empty,CD-0722-4
"H10,A7",1710624,2155088,1116545,1038543,1071606,765435,3,765985,445532,320453,1.390319329,478689,4263,1365,440,439,1,121,1,0.118451025,0,hg38,CD-0722-4
"H10,A8",6395,7075,4822,2253,3716,1791,0,1793,1215,578,2.102076125,1004,3178,578,260,257,3,87,1,0.070038911,0,empty,CD-0722-4
"H10,A9",11100,12045,8470,3575,6195,2966,1,2969,2046,923,2.216684724,1580,3242,948,355,354,1,87,1,0.04519774,0,empty,CD-0722-4
"H10,A10",12112,13246,9092,4154,7006,3600,0,3602,2275,1327,1.714393369,2011,578,83,36,35,1,19,1,0.028571429,0,empty,CD-0722-4
"H10,A11",9694,9886,7342,2544,5440,2565,0,2567,1704,863,1.974507532,1301,2883,742,281,279,2,60,1,0.0609319,0,empty,CD-0722-4
"H10,A12",13739,15091,10121,4970,7942,3891,0,3903,2623,1280,2.04921875,2181,7105,1752,621,617,4,125,2,0.084278768,0,empty,CD-0722-4
"H10,B1",10606,11455,7751,3704,5917,2935,0,2941,1853,1088,1.703125,1660,1926,497,195,194,1,59,1,0.020618557,0,empty,CD-0722-4
"H10,B2",12139,13146,8377,4769,6978,3686,12,3703,2291,1412,1.622521246,2149,1135,256,126,126,0,35,0,0.031746032,0,empty,CD-0722-4
"H10,B3",939469,1163928,661129,502799,579051,358282,1,358547,284366,74181,3.833407476,225419,11365,3966,1362,1358,4,366,2,0.024300442,0,hg38,CD-0722-4
"H10,B4",10157,11140,7676,3464,5949,3177,0,3180,2003,1177,1.701784197,1761,2924,789,307,306,1,74,1,0.052287582,0,empty,CD-0722-4
"H10,B5",917672,504161,327449,176712,328136,162720,11,163644,122513,41131,2.978604945,102652,90413,10060,3921,3805,116,672,8,0.080946124,0,hg38,CD-0722-4
"H10,B6",12302,13551,8935,4616,7127,3747,0,3753,2381,1372,1.735422741,2161,3247,770,334,332,2,98,2,0.168674699,0,empty,CD-0722-4
"H10,B7",11779,12683,8922,3761,6708,3244,0,3245,2142,1103,1.941976428,1774,2185,647,249,247,2,56,2,0.101214575,0,empty,CD-0722-4
"H10,B8",8716,9227,6571,2656,4906,2281,0,2281,1523,758,2.009234828,1209,2101,360,163,162,1,66,1,0.135802469,0,empty,CD-0722-4
"H10,B9",15862,17248,11634,5614,9277,4729,9,4742,3061,1681,1.820939917,2640,2119,606,261,255,6,73,2,0.11372549,0,empty,CD-0722-4
"H10,B10",8428,9143,6060,3083,4897,2384,1,2392,1556,836,1.861244019,1369,1054,336,135,134,1,31,1,0.156716418,0,empty,CD-0722-4
"H10,B11",17925,20138,13003,7135,10354,5638,0,5643,3379,2264,1.492491166,3254,394,62,18,17,1,7,1,0,0,empty,CD-0722-4
"H10,B12",17678,19374,13056,6318,9804,4743,0,4743,3318,1425,2.328421053,2711,8135,750,310,298,12,88,2,0.053691275,0,empty,CD-0722-4
"H10,C1",21958,23529,16784,6745,12311,5797,0,5802,3852,1950,1.975384615,3098,2550,304,143,139,4,62,1,0.115107914,0,empty,CD-0722-4
"H10,C2",16934,18345,12460,5885,9441,4756,0,4763,3122,1641,1.902498477,2639,3899,1138,469,469,0,115,0,0.040511727,0,empty,CD-0722-4
"H10,C3",1160305,1338243,863669,474574,653976,353906,19,354255,277551,76704,3.618468398,209690,89452,10172,4027,3910,117,668,5,0.04859335,0,hg38,CD-0722-4
"H10,C4",10790,11715,8043,3672,6209,2959,7,2966,2015,951,2.118822292,1691,3380,741,321,312,9,79,2,0.108974359,0,empty,CD-0722-4
"H10,C5",15285,16505,11218,5287,8774,4265,0,4269,2838,1431,1.983228512,2458,3015,659,233,231,2,70,2,0.034632035,0,empty,CD-0722-4
"H10,C6",2154780,2518123,1544367,973756,1236831,753048,3,753691,589211,164480,3.582265321,447288,127931,22970,8608,8455,153,1370,5,0.02909521,0,hg38,CD-0722-4
"H10,C7",20248,23223,14638,8585,11883,6491,0,6500,4068,2432,1.672697368,3902,730,143,44,44,0,18,0,0.181818182,0,empty,CD-0722-4
"H10,C8",483311,561817,341338,220479,290065,177242,1,177351,134620,42731,3.150406028,104352,14017,4419,1641,1626,15,347,2,0.040590406,0,hg38,CD-0722-4
"H10,C9",14975,16671,11146,5525,8646,4323,1,4331,2827,1504,1.879654255,2510,3463,652,276,275,1,75,1,0.167272727,0,empty,CD-0722-4
"H10,C10",15470,16911,11672,5239,8606,4183,6,4191,2713,1478,1.835588633,2249,3372,821,355,347,8,82,2,0.213256484,0,empty,CD-0722-4
"H10,C11",1211136,1441965,872531,569434,704441,409287,13,409675,335062,74613,4.490665166,249420,115084,26694,10527,10409,118,1552,5,0.049860697,0,hg38,CD-0722-4
"H10,C12",18959,20638,13889,6749,10891,5262,0,5266,3454,1812,1.906181015,3049,3564,847,358,356,2,94,1,0.08988764,0,empty,CD-0722-4
"H10,D1",16484,18470,11976,6494,9639,5118,0,5125,3164,1961,1.613462519,2942,1434,282,103,102,1,29,1,0.009803922,0,empty,CD-0722-4
"H10,D2",13913,14783,10548,4235,7807,3581,21,3605,2374,1231,1.928513404,1949,5118,1266,490,486,4,124,2,0.115226337,0,empty,CD-0722-4
"H10,D3",12101,13245,8928,4317,6992,3519,5,3530,2355,1175,2.004255319,2000,2531,499,189,185,4,58,2,0.027027027,0,empty,CD-0722-4
"H10,D4",1086300,1306175,786105,520070,641431,374198,1,374481,298557,75924,3.932313893,227286,127751,18650,7219,7080,139,1202,6,0.034039548,0,hg38,CD-0722-4
"H10,D5",10443,11706,7761,3945,6051,3017,3,3022,1961,1061,1.848256362,1733,2998,796,306,305,1,75,1,0.104918033,0,empty,CD-0722-4
"H10,D6",16857,18989,12122,6867,9741,5317,3,5324,3204,2120,1.511320755,3102,3169,743,276,276,0,79,0,0.028985507,0,empty,CD-0722-4
"H10,D7",827790,936763,612010,324753,457004,243912,6,244133,187581,56552,3.316964917,141358,217127,40746,15776,15545,231,2057,8,0.050048247,0,hg38,CD-0722-4
"H10,D8",18369,19876,13855,6021,10130,4905,1,4908,3376,1532,2.203655352,2745,3137,641,273,272,1,69,1,0.113970588,0,empty,CD-0722-4
"H10,D9",6007,6612,4459,2153,3472,1656,1,1659,1090,569,1.915641476,959,2616,521,230,226,4,70,3,0.03539823,0,empty,CD-0722-4
"H10,D10",11629,12846,8459,4387,6700,3468,0,3470,2278,1192,1.911073826,2026,1996,432,158,158,0,43,0,0.094936709,0,empty,CD-0722-4
"H10,D11",11896,12915,9011,3904,6731,3131,11,3147,2001,1146,1.746073298,1723,5232,1646,550,540,10,129,2,0.046296296,0,empty,CD-0722-4
"H10,D12",16559,17828,12259,5569,9372,4637,9,4651,2987,1664,1.795072115,2573,7082,1593,631,615,16,172,2,0.089430894,0,empty,CD-0722-4
"H10,E1",993262,1118995,742341,376654,543719,284517,0,284752,230188,54564,4.218678982,163215,229148,39907,15779,15524,255,2069,7,0.0691832,0,hg38,CD-0722-4
"H10,E2",1002880,1160096,742017,418079,567718,309871,1,310147,245287,64860,3.781791551,183123,80915,9720,3852,3786,66,801,5,0.058372953,0,hg38,CD-0722-4
"H10,E3",9348,10257,7066,3191,5509,2669,0,2671,1735,936,1.853632479,1491,4734,992,404,402,2,113,2,0.067164179,0,empty,CD-0722-4
"H10,E4",13840,15584,10179,5405,8034,4034,24,4062,2603,1459,1.784098698,2328,5368,1097,479,476,3,121,2,0.102941176,0,empty,CD-0722-4
"H10,E5",11849,13048,9099,3949,6629,3113,0,3119,2034,1085,1.874654378,1733,2259,550,229,228,1,54,1,0.030701754,0,empty,CD-0722-4
"H10,E6",20004,21901,14896,7005,11217,5595,7,5602,3655,1947,1.877247047,3073,5999,1638,601,599,2,150,1,0.033388982,0,empty,CD-0722-4
"H10,E7",1997289,2269618,1487857,781761,1082618,588773,4,589316,476728,112588,4.234270082,339304,330721,52911,20559,20177,382,2593,10,0.057540764,0,hg38,CD-0722-4
"H10,E8",1022918,1145422,775740,369682,555053,284025,2,284268,223694,60574,3.692904547,160408,195520,30427,11700,11518,182,1826,8,0.041673902,0,hg38,CD-0722-4
"H10,E9",9533,10548,7015,3533,5499,2804,1,2806,1863,943,1.975609756,1641,4266,940,333,330,3,94,2,0.096969697,0,empty,CD-0722-4
"H10,E10",11278,12299,8377,3922,6447,3120,0,3121,1993,1128,1.766843972,1775,3250,905,329,320,9,74,2,0.15,0,empty,CD-0722-4
"H10,E11",1050881,1189649,791237,398412,583790,305313,1,305571,237804,67767,3.509141618,175762,151461,21528,8135,7988,147,1435,6,0.049574362,0,hg38,CD-0722-4
"H10,E12",1279090,1510330,934315,576015,736694,420018,1,420365,334532,85833,3.89747533,252862,161417,22953,8845,8647,198,1442,7,0.046721406,0,hg38,CD-0722-4
"H10,F1",16442,17364,12139,5225,9353,4541,0,4547,2930,1617,1.811997526,2492,3325,894,389,385,4,86,2,0.179220779,0,empty,CD-0722-4
"H10,F2",13984,15176,10374,4802,7895,3876,0,3882,2551,1331,1.916604057,2192,5491,1470,551,543,8,134,2,0.064456722,0,empty,CD-0722-4
"H10,F3",1104313,1332945,780629,552316,653266,409766,17,410108,297158,112950,2.630880921,249328,86062,26110,9629,9546,83,1368,6,0.061177457,0,hg38,CD-0722-4
"H10,F4",18909,20557,14156,6401,10555,5066,1,5068,3333,1735,1.921037464,2802,1208,260,116,113,3,38,2,0.03539823,0,empty,CD-0722-4
"H10,F5",15185,16074,11478,4596,8577,3986,0,3994,2572,1422,1.808720113,2166,3602,766,321,305,16,94,3,0.062295082,0,empty,CD-0722-4
"H10,F6",16180,18382,11797,6585,9810,5224,0,5226,3511,1715,2.047230321,3088,5161,1280,549,541,8,156,2,0.107208872,0,empty,CD-0722-4
"H10,F7",16972,18535,12683,5852,9820,4866,3,4871,3214,1657,1.93964997,2716,2968,650,262,261,1,75,1,0.076628352,0,empty,CD-0722-4
"H10,F8",899052,974372,704468,269904,476436,214164,1,214360,157650,56710,2.779932992,117205,9530,1114,407,401,6,88,2,0.097256858,0,hg38,CD-0722-4
"H10,F9",13986,15278,10569,4709,8162,3935,0,3940,2635,1305,2.019157088,2208,8037,1302,562,558,4,149,2,0.068100358,0,empty,CD-0722-4
"H10,F10",17451,18803,13329,5474,9757,4495,0,4507,3003,1504,1.996675532,2479,3080,668,270,267,3,78,2,0.06741573,0,empty,CD-0722-4
"H10,F11",13238,13907,10073,3834,7148,3271,5,3281,2314,967,2.392967942,1727,3393,618,242,242,0,66,0,0.111570248,0,empty,CD-0722-4
"H10,F12",14910,16320,10877,5443,8463,4151,16,4167,2765,1402,1.972182596,2388,417,54,30,30,0,17,0,0.033333333,0,empty,CD-0722-4
"H10,G1",15894,17426,11951,5475,9019,4398,0,4403,2905,1498,1.939252336,2389,4542,1157,443,439,4,116,3,0.06833713,0,empty,CD-0722-4
"H10,G2",8836,9559,6362,3197,4998,2536,9,2548,1612,936,1.722222222,1473,877,252,76,76,0,23,0,0,0,empty,CD-0722-4
"H10,G3",1120008,1252732,852221,400511,604412,299490,1,299759,233426,66333,3.519002608,171368,166981,22409,8380,8126,254,1326,6,0.027196653,0,hg38,CD-0722-4
"H10,G4",1152619,1362723,814868,547855,672529,422979,0,423340,298614,124726,2.394159999,252893,250,40,28,28,0,10,0,0,0,empty,CD-0722-4
"H10,G5",10406,11648,7695,3953,6006,3015,0,3017,1944,1073,1.811742777,1751,3654,1275,462,460,2,78,1,0.082608696,0,empty,CD-0722-4
"H10,G6",15398,16557,11611,4946,8598,4210,0,4219,2798,1421,1.96903589,2300,192,24,16,16,0,11,0,0,0,empty,CD-0722-4
"H10,G7",12903,13954,9845,4109,7358,3406,0,3408,2255,1153,1.955767563,1877,4454,850,344,340,4,117,2,0.064705882,0,empty,CD-0722-4
"H10,G8",9941,10635,7236,3399,5752,2800,0,2804,1833,971,1.887744593,1547,3278,889,340,336,4,94,2,0.086309524,0,empty,CD-0722-4
"H10,G9",846308,942343,643788,298555,460071,227505,1,227746,167192,60554,2.761039733,130395,280618,34321,13462,13135,327,1850,8,0.044309098,0,hg38,CD-0722-4
"H10,G10",17095,18296,12891,5405,9639,4598,0,4600,3143,1457,2.157172272,2481,6596,1263,570,562,8,147,1,0.055160142,0,empty,CD-0722-4
"H10,G11",13097,13909,9902,4007,7310,3439,0,3440,2310,1130,2.044247788,1825,2753,448,192,190,2,62,2,0.1,0,empty,CD-0722-4
"H10,G12",10606,11948,7621,4327,6148,3193,0,3194,1959,1235,1.586234818,1913,3531,929,299,299,0,77,0,0.043478261,0,empty,CD-0722-4
"H10,H1",11545,12625,8546,4079,6670,3209,0,3212,2141,1071,1.999066293,1876,2030,346,142,139,3,42,1,0.035971223,0,empty,CD-0722-4
"H10,H2",13027,14478,9369,5109,7836,4071,0,4073,2640,1433,1.842288904,2423,3790,857,336,335,1,98,1,0.074626866,0,empty,CD-0722-4
"H10,H3",1092551,1315900,775279,540621,643923,383734,3,384053,292116,91937,3.177349707,236876,173086,24811,9750,9541,209,1509,7,0.03846557,0,hg38,CD-0722-4
"H10,H4",15721,17130,11620,5510,8872,4422,0,4427,2850,1577,1.807228916,2475,406,75,37,37,0,16,0,0.108108108,0,empty,CD-0722-4
"H10,H5",1258415,1437440,935744,501696,694597,370955,2,371290,283866,87424,3.247003111,218731,160363,29877,11061,10894,167,1588,6,0.043601983,0,hg38,CD-0722-4
"H10,H6",10814,11971,7927,4044,6220,3223,0,3227,2178,1049,2.076263108,1868,3480,800,352,339,13,93,2,0.091445428,0,empty,CD-0722-4
"H10,H7",12339,13293,8890,4403,7282,3602,1,3605,2416,1189,2.03195963,2076,2679,613,262,260,2,72,2,0.080769231,0,empty,CD-0722-4
"H10,H8",15712,17250,11467,5783,9190,4655,0,4662,3062,1600,1.91375,2692,3895,937,417,412,5,112,1,0.133495146,0,empty,CD-0722-4
"H10,H9",10905,11405,8267,3138,5990,2687,0,2689,1840,849,2.167255595,1477,2057,430,179,177,2,52,1,0.101694915,0,empty,CD-0722-4
"H10,H10",10031,10870,7405,3465,5559,2741,0,2743,1771,972,1.822016461,1519,2014,237,117,114,3,47,2,0.043859649,0,empty,CD-0722-4
"H10,H11",11449,12935,7873,5062,6747,4086,8,4097,2236,1861,1.201504567,2445,120,12,6,6,0,5,0,0.166666667,0,empty,CD-0722-4
"H10,H12",787153,936369,557360,379009,465666,276818,3,277061,220029,57032,3.857992004,168811,48383,10860,3970,3939,31,810,3,0.066006601,0,hg38,CD-0722-4
"H11,A1",11441,12793,8259,4534,6753,3494,12,3506,2282,1224,1.864379085,1999,1880,319,111,108,3,32,1,0.092592593,0,empty,CD-0722-4
"H11,A2",1010854,1107801,781875,325926,538054,255656,3,255951,192727,63224,3.048320258,141037,89082,10186,3949,3822,127,771,7,0.042647828,0,hg38,CD-0722-4
"H11,A3",10447,11817,7771,4046,6143,3089,0,3089,2034,1055,1.927962085,1793,1525,372,180,180,0,45,0,0.127777778,0,empty,CD-0722-4
"H11,A4",14616,16541,10944,5597,8756,4460,36,4499,3029,1470,2.060544218,2531,1215,217,72,71,1,18,1,0,0,empty,CD-0722-4
"H11,A5",21385,23602,16333,7269,12331,5901,0,5905,4068,1837,2.214480131,3354,5408,844,304,302,2,93,1,0.052980132,0,empty,CD-0722-4
"H11,A6",27629,30657,20616,10041,16299,8518,0,8529,6198,2331,2.658944659,4806,4117,985,400,400,0,101,0,0.025,0,empty,CD-0722-4
"H11,A7",27409,32170,19482,12688,16617,9838,0,9853,6940,2913,2.382423618,5867,2205,412,178,176,2,43,1,0.039772727,0,empty,CD-0722-4
"H11,A8",7718,8687,5844,2843,4559,2276,9,2285,1651,634,2.604100946,1262,2513,439,168,165,3,59,1,0.036363636,0,empty,CD-0722-4
"H11,A9",353088,389287,272939,116348,188864,88923,1,89035,69522,19513,3.562855532,49134,73598,11833,4752,4661,91,811,4,0.121862261,0,empty,CD-0722-4
"H11,A10",15444,17132,11838,5294,8828,4313,5,4325,2891,1434,2.016039052,2419,398,57,35,34,1,14,1,0.058823529,0,empty,CD-0722-4
"H11,A11",10385,11403,7861,3542,6087,2953,0,2955,1989,966,2.059006211,1638,2193,474,216,214,2,49,1,0.079439252,0,empty,CD-0722-4
"H11,A12",18051,19744,13495,6249,10291,5035,5,5045,3429,1616,2.121905941,2780,11524,1392,583,564,19,126,3,0.118794326,0,empty,CD-0722-4
"H11,B1",10925,12175,8058,4117,6430,3231,1,3250,2042,1208,1.690397351,1878,1629,427,153,153,0,38,0,0.130718954,0,empty,CD-0722-4
"H11,B2",2084173,2360069,1421842,938227,1162066,675157,1,675680,525702,149978,3.505194095,412650,124459,15289,5996,5888,108,1042,5,0.062669837,0,hg38,CD-0722-4
"H11,B3",10980,12413,8051,4362,6624,3392,0,3393,2212,1181,1.872988992,1997,1981,564,240,240,0,56,0,0.129166667,0,empty,CD-0722-4
"H11,B4",13155,14823,9611,5212,7737,4071,23,4099,2633,1466,1.796043656,2378,2145,482,197,196,1,50,1,0.071428571,0,empty,CD-0722-4
"H11,B5",11949,7229,4576,2653,4791,2493,24,2535,1717,818,2.099022005,1566,1387,312,99,97,2,32,1,0.030927835,0,empty,CD-0722-4
"H11,B6",14800,16255,10789,5466,8826,4642,1,4649,3086,1563,1.974408189,2608,2374,467,204,200,4,56,3,0.1,0,empty,CD-0722-4
"H11,B7",18633,20840,13611,7229,10997,5863,1,5872,3714,2158,1.721037998,3348,1825,440,129,126,3,42,2,0.079365079,0,empty,CD-0722-4
"H11,B8",471309,584750,323668,261082,302086,201753,23,201888,128632,73256,1.755924429,125618,2551,662,216,214,2,61,1,0.009345794,0,hg38,CD-0722-4
"H11,B9",17724,19677,13152,6525,10290,5300,12,5316,3460,1856,1.864224138,2974,1392,279,132,129,3,45,2,0.162790698,0,empty,CD-0722-4
"H11,B10",9949,10767,7042,3725,5959,3007,1,3023,2000,1023,1.955034213,1769,715,104,47,46,1,16,1,0.086956522,0,empty,CD-0722-4
"H11,B11",19584,22465,14075,8390,11629,6454,5,6465,3808,2657,1.433195333,3858,350,32,20,20,0,12,0,0,0,empty,CD-0722-4
"H11,B12",12357,13958,9007,4951,7488,3856,1,3861,2702,1159,2.331320104,2271,5609,788,319,317,2,80,1,0.012618297,0,empty,CD-0722-4
"H11,C1",33390,35908,25158,10750,18489,9113,0,9121,6434,2687,2.394491999,4966,2285,569,249,248,1,61,1,0.076612903,0,empty,CD-0722-4
"H11,C2",1550749,1805764,1150798,654966,866425,478535,11,478974,385430,93544,4.120307021,282159,142022,26932,10432,10290,142,1569,3,0.063168124,0,hg38,CD-0722-4
"H11,C3",17122,18809,12841,5968,10020,4995,14,5013,3345,1668,2.005395683,2853,1144,263,115,112,3,32,2,0.0625,0,empty,CD-0722-4
"H11,C4",13408,14441,9905,4536,7558,3694,1,3695,2575,1120,2.299107143,2059,2884,557,234,233,1,66,1,0.094420601,0,empty,CD-0722-4
"H11,C5",16656,18388,12221,6167,9763,5044,6,5051,3329,1722,1.933217189,2930,2554,581,245,244,1,61,1,0.012295082,0,empty,CD-0722-4
"H11,C6",13392,14610,9861,4749,7870,4008,1,4014,2719,1295,2.0996139,2303,1822,420,183,183,0,48,0,0.06010929,0,empty,CD-0722-4
"H11,C7",19333,21970,13775,8195,11421,6337,3,6348,3898,2450,1.591020408,3716,994,240,94,93,1,23,1,0,0,empty,CD-0722-4
"H11,C8",21121,23541,15690,7851,12272,6251,0,6258,4164,2094,1.988538682,3510,5340,1200,425,422,3,95,1,0.045023697,0,empty,CD-0722-4
"H11,C9",16321,17972,12089,5883,9524,4743,1,4744,3229,1515,2.131353135,2683,4372,758,309,299,10,68,1,0.153846154,0,empty,CD-0722-4
"H11,C10",15460,17088,11683,5405,8887,4372,0,4375,2985,1390,2.147482014,2406,2825,703,241,230,11,68,2,0.060869565,0,empty,CD-0722-4
"H11,C11",13831,15249,10315,4934,8116,4034,9,4051,2739,1312,2.087652439,2310,2975,722,283,279,4,62,2,0.035842294,0,empty,CD-0722-4
"H11,C12",26556,28668,20026,8642,14948,7126,0,7140,4916,2224,2.210431655,3926,8476,1366,488,478,10,117,2,0.127615063,0,empty,CD-0722-4
"H11,D1",16980,19442,12314,7128,10182,5625,2,5640,3433,2207,1.555505211,3340,1326,248,86,86,0,24,0,0.093023256,0,empty,CD-0722-4
"H11,D2",13198,14356,10113,4243,7502,3534,11,3545,2346,1199,1.956630525,1920,4732,1597,564,561,3,119,1,0.032085561,0,empty,CD-0722-4
"H11,D3",15042,16531,11139,5392,8657,4478,0,4487,3079,1408,2.186789773,2516,2277,468,179,175,4,49,2,0.068571429,0,empty,CD-0722-4
"H11,D4",2147965,2502937,1592023,910914,1206861,672301,5,672869,554147,118722,4.667601624,401105,270816,36431,14086,13743,343,1943,7,0.064469184,0,hg38,CD-0722-4
"H11,D5",11293,12574,8378,4196,6657,3414,1,3416,2256,1160,1.944827586,1970,2158,450,181,178,3,54,1,0.039325843,0,empty,CD-0722-4
"H11,D6",17006,19070,12248,6822,9887,5408,1,5415,3274,2141,1.529191966,3142,2439,831,311,311,0,77,0,0.009646302,0,empty,CD-0722-4
"H11,D7",9630,10435,7162,3273,5518,2709,0,2709,1788,921,1.941368078,1526,2125,545,226,226,0,69,0,0.061946903,0,empty,CD-0722-4
"H11,D8",11459,12656,8413,4243,6683,3359,0,3360,2282,1078,2.116883117,1917,1887,474,184,176,8,49,3,0.085227273,0,empty,CD-0722-4
"H11,D9",6781,7299,5046,2253,3910,1948,1,1953,1336,617,2.165316045,1079,2575,641,202,197,5,56,2,0.065989848,0,empty,CD-0722-4
"H11,D10",11199,12863,8076,4787,6831,3603,1,3607,2384,1223,1.949304988,2183,1939,383,153,148,5,34,2,0,0,empty,CD-0722-4
"H11,D11",23172,26637,16764,9873,13633,7680,0,7687,4938,2749,1.79628956,4520,4001,926,377,372,5,79,1,0.080645161,0,empty,CD-0722-4
"H11,D12",1066618,1317427,737471,579956,655873,419569,3,419888,327683,92205,3.553852828,263058,38218,16762,6330,6313,17,1265,2,0.016315539,0,hg38,CD-0722-4
"H11,E1",23852,25952,17802,8150,13497,6775,0,6780,4500,2280,1.973684211,3710,4070,943,357,352,5,95,2,0.036931818,0,empty,CD-0722-4
"H11,E2",14624,15935,10751,5184,8474,4287,13,4309,2722,1587,1.715185885,2438,2660,577,257,253,4,64,2,0.241106719,0,empty,CD-0722-4
"H11,E3",12255,13607,9404,4203,7024,3391,0,3397,2272,1125,2.019555556,1955,5303,1231,468,464,4,103,2,0.034482759,0,empty,CD-0722-4
"H11,E4",14419,16301,10689,5612,8593,4362,1,4372,2900,1472,1.970108696,2547,3421,752,312,311,1,80,1,0.080385852,0,empty,CD-0722-4
"H11,E5",10581,11638,7994,3644,6154,2913,14,2933,1860,1073,1.733457596,1623,1796,583,170,168,2,44,1,0.05952381,0,empty,CD-0722-4
"H11,E6",22369,24822,16765,8057,13057,6568,0,6572,4324,2248,1.923487544,3806,5975,1442,623,619,4,128,3,0.037156704,0,empty,CD-0722-4
"H11,E7",1079809,1213850,802058,411792,591819,314944,2,315230,269598,45632,5.908090813,179394,125871,30901,10196,10088,108,1588,5,0.022303727,0,hg38,CD-0722-4
"H11,E8",17596,19335,13450,5885,10121,4752,33,4791,3350,1441,2.324774462,2673,4231,942,404,394,10,102,2,0.010152284,0,empty,CD-0722-4
"H11,E9",11651,12589,8705,3884,6576,3291,0,3293,2301,992,2.319556452,1762,3464,503,224,220,4,60,2,0.059090909,0,empty,CD-0722-4
"H11,E10",11211,12106,8328,3778,6440,3171,0,3175,2156,1019,2.115799804,1750,2548,679,289,288,1,74,1,0.041666667,0,empty,CD-0722-4
"H11,E11",13943,15343,10428,4915,8054,4012,26,4040,2664,1376,1.936046512,2234,3172,717,281,278,3,61,1,0.129496403,0,empty,CD-0722-4
"H11,E12",16794,18692,12411,6281,9844,4922,7,4935,3310,1625,2.036923077,2807,3589,602,278,263,15,69,3,0.102661597,0,empty,CD-0722-4
"H11,F1",16854,18622,12485,6137,9746,4871,0,4878,3163,1715,1.844314869,2783,3224,899,314,308,6,72,2,0.11038961,0,empty,CD-0722-4
"H11,F2",13831,14900,10289,4611,7918,3837,0,3838,2525,1313,1.923076923,2144,4471,1002,342,338,4,93,2,0.032544379,0,empty,CD-0722-4
"H11,F3",15793,17248,11816,5432,8987,4211,0,4223,2877,1346,2.137444279,2385,5578,929,389,387,2,101,1,0.051679587,0,empty,CD-0722-4
"H11,F4",18470,20082,13832,6250,10653,5204,0,5205,3411,1794,1.901337793,2910,867,194,80,79,1,19,1,0.17721519,0,empty,CD-0722-4
"H11,F5",1016422,1107611,771136,336475,538711,262647,2,262871,202393,60478,3.346555772,147360,128511,18753,7369,7208,161,1212,7,0.049389567,0,hg38,CD-0722-4
"H11,F6",22310,24942,16268,8674,13174,6956,0,6959,4796,2163,2.2172908,4089,3958,1138,472,471,1,121,1,0.087048832,0,empty,CD-0722-4
"H11,F7",16372,18040,12099,5941,9767,4914,35,4956,3306,1650,2.003636364,2840,1319,296,134,131,3,42,2,0.030534351,0,empty,CD-0722-4
"H11,F8",15127,16856,11337,5519,8792,4345,30,4379,2950,1429,2.064380686,2507,400,25,17,17,0,9,0,0,0,empty,CD-0722-4
"H11,F9",15151,16305,11407,4898,8815,4322,0,4337,3028,1309,2.313216196,2398,4157,1084,429,425,4,94,1,0.044705882,0,empty,CD-0722-4
"H11,F10",2320051,2759732,1627012,1132720,1349039,884916,4,885590,711646,173944,4.09123626,519367,29159,2081,730,655,75,163,5,0.151145038,0,hg38,CD-0722-4
"H11,F11",14957,16218,11489,4729,8498,3978,0,3978,2670,1308,2.041284404,2195,3252,700,225,220,5,56,2,0.063636364,0,empty,CD-0722-4
"H11,F12",20711,22606,15307,7299,11737,5796,0,5801,4034,1767,2.282965478,3305,436,76,44,44,0,18,0,0.272727273,0,empty,CD-0722-4
"H11,G1",17451,19521,13170,6351,10408,5285,2,5298,3578,1720,2.080232558,2951,4555,1001,382,378,4,82,1,0.108465608,0,empty,CD-0722-4
"H11,G2",8783,9691,6113,3578,5065,2613,26,2643,1692,951,1.779179811,1604,533,77,43,43,0,14,0,0,0,empty,CD-0722-4
"H11,G3",19120,20240,14108,6132,10622,5214,11,5232,3264,1968,1.658536585,2804,3418,653,282,273,9,80,2,0.087912088,0,empty,CD-0722-4
"H11,G4",39658,44528,29182,15346,22506,11891,1,11897,7735,4162,1.858481499,6870,144,5,4,4,0,4,0,0,0,empty,CD-0722-4
"H11,G5",10051,11270,7431,3839,5885,2960,6,2967,1927,1040,1.852884615,1742,2718,523,224,223,1,62,1,0.049327354,0,empty,CD-0722-4
"H11,G6",16164,17337,12201,5136,9157,4482,0,4490,3008,1482,2.029689609,2426,372,55,26,26,0,9,0,0,0,empty,CD-0722-4
"H11,G7",14825,16194,11376,4818,8614,4051,0,4051,2740,1311,2.090007628,2247,5768,1037,355,349,6,104,2,0.06017192,0,empty,CD-0722-4
"H11,G8",797124,979939,531614,448325,490580,332672,4,332892,241548,91344,2.644377299,207343,9704,981,352,322,30,86,2,0.086956522,0,hg38,CD-0722-4
"H11,G9",12738,13979,9503,4476,7498,3756,0,3763,2597,1166,2.227272727,2132,3574,712,278,278,0,90,0,0.039568345,0,empty,CD-0722-4
"H11,G10",16303,18160,12138,6022,9676,4925,0,4931,3314,1617,2.049474335,2746,3033,794,335,334,1,78,1,0.074850299,0,empty,CD-0722-4
"H11,G11",15606,16941,11750,5191,8945,4337,0,4342,2979,1363,2.185619956,2431,2363,685,240,239,1,54,1,0.016736402,0,empty,CD-0722-4
"H11,G12",10754,12146,7732,4414,6407,3335,0,3337,2126,1211,1.755573906,2005,6056,830,362,359,3,95,1,0.052924791,0,empty,CD-0722-4
"H11,H1",15130,16768,11215,5553,8838,4369,0,4373,2930,1443,2.03049203,2521,1710,581,220,220,0,44,0,0.277272727,0,empty,CD-0722-4
"H11,H2",13237,15007,9558,5449,7846,4104,18,4123,2642,1481,1.783929777,2461,4123,1167,424,420,4,81,2,0.054761905,0,empty,CD-0722-4
"H11,H3",1613966,1872491,1198961,673530,897852,499904,2,500414,399314,101100,3.949693373,294992,187808,29579,11539,11360,179,1689,5,0.07068662,0,hg38,CD-0722-4
"H11,H4",16341,17548,12247,5301,9089,4411,0,4418,2912,1506,1.933598938,2414,232,59,16,16,0,7,0,0,0,empty,CD-0722-4
"H11,H5",16842,18779,12204,6575,9798,5073,0,5083,3292,1791,1.838079285,2939,3033,741,285,282,3,63,1,0.180851064,0,empty,CD-0722-4
"H11,H6",918575,1046739,691896,354843,519063,266004,2,266251,199418,66833,2.983825356,157075,205774,28403,10990,10698,292,1503,8,0.072443447,0,hg38,CD-0722-4
"H11,H7",12423,13689,9244,4445,7289,3562,1,3573,2325,1248,1.862980769,2046,2547,578,187,186,1,49,1,0.053763441,0,empty,CD-0722-4
"H11,H8",19313,22029,14094,7935,11471,6066,0,6075,4144,1931,2.146038322,3551,4312,861,367,360,7,98,2,0.066666667,0,empty,CD-0722-4
"H11,H9",13051,14024,9998,4026,7376,3444,0,3445,2330,1115,2.089686099,1883,1721,481,189,187,2,47,1,0.048128342,0,empty,CD-0722-4
"H11,H10",9866,11247,7344,3903,5772,2900,0,2903,1855,1048,1.770038168,1691,2100,376,150,145,5,46,2,0.013793103,0,empty,CD-0722-4
"H11,H11",13202,14811,9125,5686,7715,4609,1,4619,2430,2189,1.110095934,2788,16,5,3,3,0,1,0,0,0,empty,CD-0722-4
"H11,H12",13656,15151,10055,5096,7791,3914,0,3918,2660,1258,2.114467409,2248,4230,582,244,241,3,61,2,0.066390041,0,empty,CD-0722-4
"H12,A1",867411,1046684,632758,413926,609140,351912,1,352179,276772,75407,3.670375429,215928,50333,11234,4296,4245,51,728,4,0.066902238,0,hg38,CD-0722-4
"H12,A2",30831,34821,23127,11694,19835,10305,6,10320,7083,3237,2.188137164,5886,3889,1020,388,383,5,98,3,0.114882507,0,empty,CD-0722-4
"H12,A3",865001,1023980,632575,391405,574219,322548,12,322808,255527,67281,3.797907284,195823,129505,23007,9256,9096,160,1343,7,0.058157432,0,hg38,CD-0722-4
"H12,A4",10572,11358,7920,3438,7030,3446,3,3452,2259,1193,1.893545683,1935,644,107,40,39,1,16,1,0.051282051,0,empty,CD-0722-4
"H12,A5",779360,906438,574279,332159,526408,290444,3,290638,234662,55976,4.19218951,171437,130686,16281,6085,5926,159,1044,6,0.055686804,0,hg38,CD-0722-4
"H12,A6",17297,19749,12808,6941,11906,6140,14,6158,4311,1847,2.334055225,3652,2899,745,331,326,5,88,1,0.141104294,0,empty,CD-0722-4
"H12,A7",6701,7639,4937,2702,4815,2632,0,2635,1652,983,1.680569685,1531,2350,435,145,143,2,39,2,0.118881119,0,empty,CD-0722-4
"H12,A8",462918,535836,349623,186213,315000,165674,0,165797,129196,36601,3.529848911,97178,88170,11792,4700,4621,79,882,5,0.028565246,0,hg38,CD-0722-4
"H12,A9",8440,9240,6296,2944,5862,2978,0,2981,1928,1053,1.830959164,1684,2076,430,185,179,6,53,2,0.011173184,0,empty,CD-0722-4
"H12,A10",558262,660994,407308,253686,383802,219251,0,219430,180031,39399,4.569430696,130432,7089,1864,658,653,5,150,2,0.059724349,0,hg38,CD-0722-4
"H12,A11",9435,10698,7180,3518,6469,3297,6,3303,2361,942,2.506369427,1848,1847,327,138,137,1,48,1,0.109489051,0,empty,CD-0722-4
"H12,A12",11233,12316,8415,3901,7343,3552,0,3555,2386,1169,2.041060736,2021,9294,1508,589,577,12,142,3,0.027729636,0,empty,CD-0722-4
"H12,B1",338855,396388,228602,167786,238156,156585,26,156724,119161,37563,3.172297207,94421,3856,1125,353,351,2,100,2,0.068376068,0,hg38,CD-0722-4
"H12,B2",8163,8816,5686,3130,5410,2941,0,2943,1935,1008,1.919642857,1693,789,122,55,55,0,14,0,0.109090909,0,empty,CD-0722-4
"H12,B3",7671,8707,5712,2995,5400,2766,0,2769,1852,917,2.019629226,1637,1770,360,155,153,2,45,1,0.078431373,0,empty,CD-0722-4
"H12,B4",775261,881633,588843,292790,506330,258664,2,258898,198874,60024,3.31324137,150131,80174,11357,4374,4304,70,758,6,0.05436803,0,hg38,CD-0722-4
"H12,B5",7799,5061,3165,1896,3672,1926,4,1933,1274,659,1.93323217,1251,1246,303,98,97,1,32,1,0.082474227,0,empty,CD-0722-4
"H12,B6",11179,12355,7973,4382,7592,4230,13,4243,2595,1648,1.574635922,2448,2256,459,194,194,0,55,0,0.015463918,0,empty,CD-0722-4
"H12,B7",8580,9047,6564,2483,5470,2590,19,2610,1761,849,2.074204947,1381,1466,338,137,134,3,38,2,0.014925373,0,empty,CD-0722-4
"H12,B8",86707,93461,69047,24414,54438,23776,1,23789,16897,6892,2.451683111,12567,3031,879,308,307,1,84,1,0.016286645,0,empty,CD-0722-4
"H12,B9",11677,12890,8511,4379,7869,4098,0,4103,2586,1517,1.70468029,2355,1409,213,92,92,0,37,0,0,0,empty,CD-0722-4
"H12,B10",6287,6938,4573,2365,4265,2146,16,2165,1418,747,1.898259705,1229,649,148,57,57,0,17,0,0,0,empty,CD-0722-4
"H12,B11",847845,978734,627690,351044,557194,305752,3,306009,243325,62684,3.881772063,179158,8527,1085,392,387,5,95,2,0,0,hg38,CD-0722-4
"H12,B12",7760,8730,5687,3043,5307,2683,0,2685,1769,916,1.931222707,1573,4085,722,270,264,6,67,2,0.087121212,0,empty,CD-0722-4
"H12,C1",14541,15988,11024,4964,9735,4810,1,4816,3178,1638,1.94017094,2664,1418,241,106,105,1,34,1,0,0,empty,CD-0722-4
"H12,C2",11198,12597,8137,4460,7665,4046,0,4046,2629,1417,1.855328158,2362,2490,590,231,230,1,68,1,0.073913043,0,empty,CD-0722-4
"H12,C3",11299,12445,8417,4028,7704,3829,1,3839,2450,1389,1.763858891,2198,909,215,100,100,0,29,0,0.05,0,empty,CD-0722-4
"H12,C4",932016,1093838,687617,406221,629101,351557,1,351818,266229,85589,3.11055159,210577,137789,21971,8376,8226,150,1295,5,0.037077559,0,hg38,CD-0722-4
"H12,C5",11641,13226,8610,4616,7867,4094,1,4096,2769,1327,2.086661643,2369,1740,375,156,156,0,45,0,0.121794872,0,empty,CD-0722-4
"H12,C6",9497,10522,6862,3660,6551,3393,22,3416,2282,1134,2.012345679,2018,2149,436,192,188,4,56,2,0.042553191,0,empty,CD-0722-4
"H12,C7",15984,18471,11519,6952,10742,5939,1,5944,3607,2337,1.54343175,3546,1028,200,44,44,0,23,0,0.25,0,empty,CD-0722-4
"H12,C8",13970,15321,10395,4926,9235,4634,7,4644,3039,1605,1.893457944,2591,3825,920,384,378,6,69,2,0.150793651,0,empty,CD-0722-4
"H12,C9",10315,11688,7581,4107,7257,3736,0,3737,2457,1280,1.91953125,2246,1788,399,154,153,1,42,1,0.078431373,0,empty,CD-0722-4
"H12,C10",10213,11122,7663,3459,6782,3296,0,3298,2146,1152,1.862847222,1851,2712,460,196,192,4,50,2,0.020833333,0,empty,CD-0722-4
"H12,C11",719474,812840,540115,272725,471369,244639,0,244845,194226,50619,3.837017721,143243,54432,9120,3560,3510,50,639,2,0.029344729,0,hg38,CD-0722-4
"H12,C12",14275,15680,10508,5172,9546,4805,1,4812,3236,1576,2.053299492,2753,3914,524,235,235,0,70,0,0.038297872,0,empty,CD-0722-4
"H12,D1",13945,15769,10160,5609,9436,5078,0,5092,3231,1861,1.736163353,2946,4725,528,214,210,4,39,2,0.104761905,0,empty,CD-0722-4
"H12,D2",719047,813015,547313,265702,471203,240694,14,240908,187404,53504,3.502616627,137841,143349,24683,9515,9382,133,1410,4,0.043380942,0,hg38,CD-0722-4
"H12,D3",9293,10456,6725,3731,6357,3293,0,3297,2218,1079,2.055607044,1958,1516,325,148,148,0,41,0,0.141891892,0,empty,CD-0722-4
"H12,D4",585485,649249,447210,202039,378245,184756,19,184935,137041,47894,2.861339625,105011,27480,4280,1466,1432,34,336,3,0.025837989,0,hg38,CD-0722-4
"H12,D5",9968,10905,7343,3562,6628,3410,1,3416,2257,1159,1.947368421,1910,2103,599,264,261,3,59,2,0.076628352,0,empty,CD-0722-4
"H12,D6",12473,13826,8900,4926,8327,4592,0,4592,2776,1816,1.528634361,2726,2603,458,216,213,3,61,2,0.0657277,0,empty,CD-0722-4
"H12,D7",6447,7042,4867,2175,4299,2080,1,2085,1286,799,1.60951189,1175,2073,640,228,226,2,56,2,0.004424779,0,empty,CD-0722-4
"H12,D8",1045754,1225423,768338,457085,703738,397695,4,398029,331448,66581,4.97811688,238970,6107,1197,346,341,5,110,1,0.082111437,0,hg38,CD-0722-4
"H12,D9",580968,673503,429889,243614,388219,210525,3,210661,162686,47975,3.391057843,125166,70656,7342,2844,2749,95,639,5,0.03492179,0,hg38,CD-0722-4
"H12,D10",7647,8796,5515,3281,5297,2789,0,2791,1864,927,2.010787487,1706,1072,313,126,126,0,26,0,0.119047619,0,empty,CD-0722-4
"H12,D11",8529,9380,6486,2894,5742,2747,0,2752,1778,974,1.825462012,1509,3865,1012,390,390,0,84,0,0.079487179,0,empty,CD-0722-4
"H12,D12",11719,13241,8674,4567,7880,3938,16,3960,2617,1343,1.948622487,2310,6323,958,395,389,6,117,2,0.051413882,0,empty,CD-0722-4
"H12,E1",1225747,1392200,917423,474777,718559,383774,6,384057,293026,91031,3.218969362,221844,113087,18189,7249,7133,116,1206,5,0.072900603,0,hg38,CD-0722-4
"H12,E2",9973,11099,7227,3872,6800,3528,22,3550,2183,1367,1.596927579,2090,2302,568,234,234,0,55,0,0.042735043,0,empty,CD-0722-4
"H12,E3",6398,7119,4832,2287,4308,2170,1,2174,1471,703,2.092460882,1203,2895,915,319,318,1,83,1,0.081761006,0,empty,CD-0722-4
"H12,E4",10266,11233,7497,3736,6988,3528,0,3534,2304,1230,1.873170732,2006,2331,479,201,199,2,54,1,0.030150754,0,empty,CD-0722-4
"H12,E5",11619,12641,9027,3614,7586,3527,4,3533,2463,1070,2.301869159,1909,3699,880,324,317,7,77,3,0.009463722,0,empty,CD-0722-4
"H12,E6",15370,17218,11357,5861,10139,5092,22,5126,3354,1772,1.892776524,3017,4192,1195,431,419,12,91,2,0.100238663,0,empty,CD-0722-4
"H12,E7",703514,781535,532980,248555,445636,223578,9,223748,177349,46399,3.8222591,127273,50812,9525,3497,3447,50,683,3,0.019437192,0,hg38,CD-0722-4
"H12,E8",11021,11996,8488,3508,7310,3429,0,3430,2323,1107,2.098464318,1843,3447,722,296,290,6,75,2,0.037931034,0,empty,CD-0722-4
"H12,E9",9541,10667,7247,3420,6388,3101,5,3110,2133,977,2.18321392,1797,6822,893,430,421,9,93,2,0.080760095,0,empty,CD-0722-4
"H12,E10",7756,8550,5789,2761,5098,2488,3,2493,1676,817,2.051407589,1417,2696,711,279,279,0,64,0,0.082437276,0,empty,CD-0722-4
"H12,E11",11300,12181,8331,3850,6994,3517,0,3522,2254,1268,1.777602524,1965,2697,394,187,184,3,49,1,0.059782609,0,empty,CD-0722-4
"H12,E12",12122,13889,8865,5024,8429,4407,18,4431,2887,1544,1.869818653,2653,2859,481,213,211,2,63,1,0.028436019,0,empty,CD-0722-4
"H12,F1",11854,12813,8710,4103,7659,3866,3,3873,2470,1403,1.760513186,2163,2408,634,243,239,4,56,2,0.087866109,0,empty,CD-0722-4
"H12,F2",9185,10029,6813,3216,6173,3128,1,3130,2057,1073,1.917054986,1781,3733,1256,413,410,3,93,2,0.104878049,0,empty,CD-0722-4
"H12,F3",9716,10524,7259,3265,6269,3128,4,3132,2117,1015,2.085714286,1775,3110,723,321,321,0,78,0,0.099688474,0,empty,CD-0722-4
"H12,F4",12598,13375,9578,3797,8256,3911,0,3915,2536,1379,1.839013778,2077,564,56,26,26,0,14,0,0,0,empty,CD-0722-4
"H12,F5",10362,10992,7851,3141,6747,3134,6,3147,2131,1016,2.097440945,1755,3064,700,270,268,2,75,2,0.044776119,0,empty,CD-0722-4
"H12,F6",12831,14247,9431,4816,8880,4599,2,4612,3033,1579,1.920835972,2674,4393,1091,457,452,5,110,2,0.015486726,0,empty,CD-0722-4
"H12,F7",1086999,1235465,826412,409053,713219,365899,1,366200,276296,89904,3.073233671,211472,34781,6445,2548,2507,41,498,3,0.015556442,0,hg38,CD-0722-4
"H12,F8",9148,10240,6857,3383,6221,2959,26,2986,1980,1006,1.968190855,1734,409,15,9,9,0,6,0,0.111111111,0,empty,CD-0722-4
"H12,F9",9926,10754,7570,3184,6540,3095,0,3095,2042,1053,1.939221273,1658,3139,669,274,274,0,98,0,0.142335766,0,empty,CD-0722-4
"H12,F10",13044,14309,9780,4529,8606,4116,0,4119,2754,1365,2.017582418,2284,2075,454,210,209,1,53,1,0.043062201,0,empty,CD-0722-4
"H12,F11",10241,11041,7697,3344,6651,3126,9,3135,2068,1067,1.93814433,1749,2185,619,187,185,2,40,1,0.07027027,0,empty,CD-0722-4
"H12,F12",1540902,1764175,1169715,594460,973129,518616,9,519072,422946,96126,4.399912615,298896,4886,517,229,224,5,57,1,0.089285714,0,hg38,CD-0722-4
"H12,G1",1041521,1207727,781759,425968,690684,371505,1,371809,284112,87697,3.239700332,219283,166211,27116,10536,10346,190,1642,7,0.052387396,0,hg38,CD-0722-4
"H12,G2",5983,6465,4239,2226,4034,2080,0,2080,1298,782,1.659846547,1204,381,76,46,46,0,15,0,0,0,empty,CD-0722-4
"H12,G3",1304923,1563480,961957,601523,880318,503580,22,503975,417515,86460,4.828996068,305129,216847,35327,13982,13734,248,2080,6,0.0509684,0,hg38,CD-0722-4
"H12,G4",21586,24429,15586,8843,14548,8183,0,8184,5065,3119,1.623917922,4715,135,19,15,15,0,6,0,0,0,empty,CD-0722-4
"H12,G5",7253,8045,5434,2611,4899,2439,0,2445,1587,858,1.84965035,1362,2734,650,264,259,5,66,3,0.046332046,0,empty,CD-0722-4
"H12,G6",11676,12885,8803,4082,7511,3749,0,3759,2430,1329,1.828442438,2071,209,25,12,12,0,6,0,0,0,empty,CD-0722-4
"H12,G7",9484,10240,7164,3076,6241,2958,0,2961,1898,1063,1.7855127,1638,3632,789,321,314,7,91,3,0.095541401,0,empty,CD-0722-4
"H12,G8",7163,7732,5237,2495,4823,2378,0,2382,1585,797,1.988707654,1360,1982,454,190,184,6,61,2,0.02173913,0,empty,CD-0722-4
"H12,G9",9780,10824,7305,3519,6571,3329,0,3332,2251,1081,2.082331175,1890,3162,893,379,375,4,99,1,0.061333333,0,empty,CD-0722-4
"H12,G10",10530,12159,7922,4237,7345,3759,0,3760,2416,1344,1.797619048,2192,2876,591,240,234,6,67,2,0.012820513,0,empty,CD-0722-4
"H12,G11",114823,123662,91269,32393,69230,29019,2,29051,21918,7133,3.072760409,15531,5921,1394,552,548,4,168,2,0.023722628,0,empty,CD-0722-4
"H12,G12",7509,8620,5531,3089,5270,2808,0,2809,1850,959,1.929092805,1633,3868,650,296,294,2,67,1,0.017006803,0,empty,CD-0722-4
"H12,H1",10132,11245,7576,3669,6901,3381,19,3402,2284,1118,2.04293381,1995,1351,222,88,88,0,34,0,0.102272727,0,empty,CD-0722-4
"H12,H2",8754,9911,6620,3291,6059,3056,0,3060,1939,1121,1.72970562,1771,2632,684,258,256,2,60,1,0.14453125,0,empty,CD-0722-4
"H12,H3",8810,9912,6498,3414,5982,3152,20,3178,2206,972,2.269547325,1797,1690,319,149,148,1,44,1,0.006756757,0,empty,CD-0722-4
"H12,H4",12820,14202,9577,4625,8238,4068,0,4078,2648,1430,1.851748252,2339,219,101,44,44,0,9,0,0.454545455,0,empty,CD-0722-4
"H12,H5",15557,17446,11642,5804,10333,5242,24,5268,3681,1587,2.319470699,3057,3651,971,334,331,3,72,2,0.102719033,0,empty,CD-0722-4
"H12,H6",8743,10047,6495,3552,6161,3262,0,3264,2227,1037,2.147540984,1891,2125,538,249,247,2,81,1,0.008097166,0,empty,CD-0722-4
"H12,H7",20216,22352,15459,6893,13173,6395,0,6401,4601,1800,2.556111111,3613,2108,442,172,171,1,51,1,0.140350877,0,empty,CD-0722-4
"H12,H8",862927,1002167,647218,354949,572793,303035,2,303241,231897,71344,3.250406481,180248,190219,21164,8127,7915,212,1317,10,0.060644346,0,hg38,CD-0722-4
"H12,H9",7926,8725,5986,2739,5292,2551,0,2552,1719,833,2.06362545,1427,1816,495,195,193,2,55,2,0.03626943,0,empty,CD-0722-4
"H12,H10",6759,7361,4986,2375,4431,2168,0,2168,1439,729,1.9739369,1219,1377,340,124,124,0,32,0,0.024193548,0,empty,CD-0722-4
"H12,H11",9776,11188,6817,4371,6747,4111,12,4129,2211,1918,1.152763295,2425,97,7,5,5,0,2,0,0,0,empty,CD-0722-4
"H12,H12",8463,9585,6119,3466,5709,3008,5,3019,2011,1008,1.995039683,1789,2892,465,186,181,5,44,2,0.027624309,0,empty,CD-0722-4
